,time_between,service_time,arrival_time,start_time,end_time,wait_time,system_time,idle_time
0,0,2,0,0,2,0,2,0
1,5,1,5,5,6,0,1,3
2,4,3,9,9,12,0,3,3
3,6,3,15,15,18,0,3,3
4,5,3,20,20,23,0,3,2
5,3,3,23,23,26,0,3,0
6,5,2,28,28,30,0,2,2
7,2,2,30,30,32,0,2,0
8,4,2,34,34,36,0,2,2
9,1,2,35,36,38,1,3,0
10,6,3,41,41,44,0,3,3
11,4,1,45,45,46,0,1,1
12,2,2,47,47,49,0,2,1
13,6,1,53,53,54,0,1,4
14,6,3,59,59,62,0,3,5
15,1,1,60,62,63,2,3,0
16,5,1,65,65,66,0,1,2
17,5,1,70,70,71,0,1,4
18,1,2,71,71,73,0,2,0
19,5,1,76,76,77,0,1,3
20,2,1,78,78,79,0,1,1
21,2,1,80,80,81,0,1,1
22,1,3,81,81,84,0,3,0
23,5,3,86,86,89,0,3,2
24,2,2,88,89,91,1,3,0
25,4,3,92,92,95,0,3,1
26,3,2,95,95,97,0,2,0
27,5,1,100,100,101,0,1,3
28,4,3,104,104,107,0,3,3
29,5,1,109,109,110,0,1,2
30,4,1,113,113,114,0,1,3
31,1,1,114,114,115,0,1,0
32,5,1,119,119,120,0,1,4
33,5,2,124,124,126,0,2,4
34,1,1,125,126,127,1,2,0
35,6,1,131,131,132,0,1,4
36,6,1,137,137,138,0,1,5
37,2,3,139,139,142,0,3,1
38,6,3,145,145,148,0,3,3
39,1,2,146,148,150,2,4,0
40,2,2,148,150,152,2,4,0
41,4,1,152,152,153,0,1,0
42,3,3,155,155,158,0,3,2
43,6,3,161,161,164,0,3,3
44,3,3,164,164,167,0,3,0
45,6,2,170,170,172,0,2,3
46,2,3,172,172,175,0,3,0
47,3,3,175,175,178,0,3,0
48,6,2,181,181,183,0,2,3
49,6,1,187,187,188,0,1,4
50,5,3,192,192,195,0,3,4
51,6,2,198,198,200,0,2,3
52,5,2,203,203,205,0,2,3
53,5,1,208,208,209,0,1,3
54,1,3,209,209,212,0,3,0
55,1,1,210,212,213,2,3,0
56,2,1,212,213,214,1,2,0
57,2,1,214,214,215,0,1,0
58,1,2,215,215,217,0,2,0
59,6,1,221,221,222,0,1,4
60,6,1,227,227,228,0,1,5
61,6,3,233,233,236,0,3,5
62,3,3,236,236,239,0,3,0
63,5,1,241,241,242,0,1,2
64,3,1,244,244,245,0,1,2
65,6,1,250,250,251,0,1,5
66,3,3,253,253,256,0,3,2
67,2,1,255,256,257,1,2,0
68,2,1,257,257,258,0,1,0
69,5,2,262,262,264,0,2,4
70,2,1,264,264,265,0,1,0
71,5,1,269,269,270,0,1,4
72,4,3,273,273,276,0,3,3
73,1,1,274,276,277,2,3,0
74,1,2,275,277,279,2,4,0
75,4,3,279,279,282,0,3,0
76,2,1,281,282,283,1,2,0
77,1,2,282,283,285,1,3,0
78,5,1,287,287,288,0,1,2
79,3,2,290,290,292,0,2,2
80,1,2,291,292,294,1,3,0
81,1,1,292,294,295,2,3,0
82,5,2,297,297,299,0,2,2
83,5,3,302,302,305,0,3,3
84,1,3,303,305,308,2,5,0
85,4,3,307,308,311,1,4,0
86,5,2,312,312,314,0,2,1
87,5,2,317,317,319,0,2,3
88,6,1,323,323,324,0,1,4
89,4,1,327,327,328,0,1,3
90,3,1,330,330,331,0,1,2
91,4,1,334,334,335,0,1,3
92,6,2,340,340,342,0,2,5
93,4,2,344,344,346,0,2,2
94,6,2,350,350,352,0,2,4
95,1,1,351,352,353,1,2,0
96,3,1,354,354,355,0,1,1
97,3,1,357,357,358,0,1,2
98,1,2,358,358,360,0,2,0
99,3,3,361,361,364,0,3,1
100,2,2,363,364,366,1,3,0
101,1,1,364,366,367,2,3,0
102,4,1,368,368,369,0,1,1
103,3,1,371,371,372,0,1,2
104,4,3,375,375,378,0,3,3
105,5,1,380,380,381,0,1,2
106,6,1,386,386,387,0,1,5
107,4,1,390,390,391,0,1,3
108,2,1,392,392,393,0,1,1
109,3,2,395,395,397,0,2,2
110,4,1,399,399,400,0,1,2
111,1,1,400,400,401,0,1,0
112,1,1,401,401,402,0,1,0
113,4,3,405,405,408,0,3,3
114,5,2,410,410,412,0,2,2
115,3,2,413,413,415,0,2,1
116,5,1,418,418,419,0,1,3
117,1,2,419,419,421,0,2,0
118,2,2,421,421,423,0,2,0
119,2,3,423,423,426,0,3,0
120,2,1,425,426,427,1,2,0
121,6,1,431,431,432,0,1,4
122,3,1,434,434,435,0,1,2
123,6,1,440,440,441,0,1,5
124,4,1,444,444,445,0,1,3
125,5,2,449,449,451,0,2,4
126,3,1,452,452,453,0,1,1
127,6,1,458,458,459,0,1,5
128,1,3,459,459,462,0,3,0
129,6,1,465,465,466,0,1,3
130,4,1,469,469,470,0,1,3
131,1,2,470,470,472,0,2,0
132,1,2,471,472,474,1,3,0
133,3,2,474,474,476,0,2,0
134,5,3,479,479,482,0,3,3
135,5,1,484,484,485,0,1,2
136,5,2,489,489,491,0,2,4
137,5,1,494,494,495,0,1,3
138,3,2,497,497,499,0,2,2
139,5,3,502,502,505,0,3,3
140,5,3,507,507,510,0,3,2
141,2,3,509,510,513,1,4,0
142,5,2,514,514,516,0,2,1
143,1,1,515,516,517,1,2,0
144,2,1,517,517,518,0,1,0
145,5,1,522,522,523,0,1,4
146,1,1,523,523,524,0,1,0
147,4,2,527,527,529,0,2,3
148,3,1,530,530,531,0,1,1
149,6,3,536,536,539,0,3,5
150,6,1,542,542,543,0,1,3
151,4,3,546,546,549,0,3,3
152,5,1,551,551,552,0,1,2
153,5,1,556,556,557,0,1,4
154,6,2,562,562,564,0,2,5
155,1,2,563,564,566,1,3,0
156,3,3,566,566,569,0,3,0
157,1,1,567,569,570,2,3,0
158,1,2,568,570,572,2,4,0
159,1,2,569,572,574,3,5,0
160,4,3,573,574,577,1,4,0
161,1,1,574,577,578,3,4,0
162,5,1,579,579,580,0,1,1
163,3,1,582,582,583,0,1,2
164,4,2,586,586,588,0,2,3
165,5,1,591,591,592,0,1,3
166,6,3,597,597,600,0,3,5
167,2,3,599,600,603,1,4,0
168,2,1,601,603,604,2,3,0
169,2,1,603,604,605,1,2,0
170,5,3,608,608,611,0,3,3
171,5,3,613,613,616,0,3,2
172,4,2,617,617,619,0,2,1
173,4,3,621,621,624,0,3,2
174,4,3,625,625,628,0,3,1
175,6,2,631,631,633,0,2,3
176,5,2,636,636,638,0,2,3
177,3,3,639,639,642,0,3,1
178,1,3,640,642,645,2,5,0
179,6,1,646,646,647,0,1,1
180,6,1,652,652,653,0,1,5
181,1,1,653,653,654,0,1,0
182,6,2,659,659,661,0,2,5
183,6,2,665,665,667,0,2,4
184,3,3,668,668,671,0,3,1
185,5,1,673,673,674,0,1,2
186,1,2,674,674,676,0,2,0
187,5,1,679,679,680,0,1,3
188,3,2,682,682,684,0,2,2
189,4,2,686,686,688,0,2,2
190,6,3,692,692,695,0,3,4
191,3,1,695,695,696,0,1,0
192,2,3,697,697,700,0,3,1
193,5,3,702,702,705,0,3,2
194,3,3,705,705,708,0,3,0
195,5,2,710,710,712,0,2,2
196,4,3,714,714,717,0,3,2
197,1,1,715,717,718,2,3,0
198,2,1,717,718,719,1,2,0
199,1,2,718,719,721,1,3,0
200,1,1,719,721,722,2,3,0
201,6,2,725,725,727,0,2,3
202,5,2,730,730,732,0,2,3
203,2,1,732,732,733,0,1,0
204,2,1,734,734,735,0,1,1
205,2,1,736,736,737,0,1,1
206,6,1,742,742,743,0,1,5
207,2,1,744,744,745,0,1,1
208,1,3,745,745,748,0,3,0
209,1,2,746,748,750,2,4,0
210,6,3,752,752,755,0,3,2
211,6,1,758,758,759,0,1,3
212,3,1,761,761,762,0,1,2
213,5,2,766,766,768,0,2,4
214,3,3,769,769,772,0,3,1
215,1,3,770,772,775,2,5,0
216,5,3,775,775,778,0,3,0
217,5,3,780,780,783,0,3,2
218,1,2,781,783,785,2,4,0
219,1,1,782,785,786,3,4,0
220,4,2,786,786,788,0,2,0
221,1,3,787,788,791,1,4,0
222,5,2,792,792,794,0,2,1
223,2,1,794,794,795,0,1,0
224,6,1,800,800,801,0,1,5
225,1,3,801,801,804,0,3,0
226,5,1,806,806,807,0,1,2
227,1,2,807,807,809,0,2,0
228,5,2,812,812,814,0,2,3
229,6,3,818,818,821,0,3,4
230,1,1,819,821,822,2,3,0
231,5,1,824,824,825,0,1,2
232,4,1,828,828,829,0,1,3
233,5,2,833,833,835,0,2,4
234,2,3,835,835,838,0,3,0
235,2,3,837,838,841,1,4,0
236,4,1,841,841,842,0,1,0
237,3,3,844,844,847,0,3,2
238,4,1,848,848,849,0,1,1
239,5,3,853,853,856,0,3,4
240,3,3,856,856,859,0,3,0
241,5,1,861,861,862,0,1,2
242,5,3,866,866,869,0,3,4
243,4,3,870,870,873,0,3,1
244,5,1,875,875,876,0,1,2
245,4,3,879,879,882,0,3,3
246,5,1,884,884,885,0,1,2
247,3,2,887,887,889,0,2,2
248,1,3,888,889,892,1,4,0
249,6,3,894,894,897,0,3,2
250,6,3,900,900,903,0,3,3
251,2,3,902,903,906,1,4,0
252,5,3,907,907,910,0,3,1
253,1,3,908,910,913,2,5,0
254,5,2,913,913,915,0,2,0
255,1,3,914,915,918,1,4,0
256,2,3,916,918,921,2,5,0
257,3,3,919,921,924,2,5,0
258,1,2,920,924,926,4,6,0
259,3,1,923,926,927,3,4,0
260,1,1,924,927,928,3,4,0
261,3,2,927,928,930,1,3,0
262,6,2,933,933,935,0,2,3
263,2,2,935,935,937,0,2,0
264,6,1,941,941,942,0,1,4
265,6,2,947,947,949,0,2,5
266,3,1,950,950,951,0,1,1
267,6,1,956,956,957,0,1,5
268,2,3,958,958,961,0,3,1
269,1,2,959,961,963,2,4,0
270,2,2,961,963,965,2,4,0
271,3,1,964,965,966,1,2,0
272,6,2,970,970,972,0,2,4
273,6,2,976,976,978,0,2,4
274,5,2,981,981,983,0,2,3
275,1,1,982,983,984,1,2,0
276,4,3,986,986,989,0,3,2
277,3,3,989,989,992,0,3,0
278,1,1,990,992,993,2,3,0
279,5,1,995,995,996,0,1,2
280,5,3,1000,1000,1003,0,3,4
281,3,3,1003,1003,1006,0,3,0
282,3,1,1006,1006,1007,0,1,0
283,5,2,1011,1011,1013,0,2,4
284,3,2,1014,1014,1016,0,2,1
285,2,3,1016,1016,1019,0,3,0
286,6,2,1022,1022,1024,0,2,3
287,2,3,1024,1024,1027,0,3,0
288,3,2,1027,1027,1029,0,2,0
289,1,3,1028,1029,1032,1,4,0
290,1,2,1029,1032,1034,3,5,0
291,2,1,1031,1034,1035,3,4,0
292,5,3,1036,1036,1039,0,3,1
293,5,3,1041,1041,1044,0,3,2
294,5,3,1046,1046,1049,0,3,2
295,1,2,1047,1049,1051,2,4,0
296,5,1,1052,1052,1053,0,1,1
297,5,3,1057,1057,1060,0,3,4
298,4,1,1061,1061,1062,0,1,1
299,2,2,1063,1063,1065,0,2,1
300,5,1,1068,1068,1069,0,1,3
301,6,1,1074,1074,1075,0,1,5
302,3,2,1077,1077,1079,0,2,2
303,4,2,1081,1081,1083,0,2,2
304,5,2,1086,1086,1088,0,2,3
305,2,3,1088,1088,1091,0,3,0
306,1,2,1089,1091,1093,2,4,0
307,3,2,1092,1093,1095,1,3,0
308,2,1,1094,1095,1096,1,2,0
309,6,1,1100,1100,1101,0,1,4
310,1,1,1101,1101,1102,0,1,0
311,3,3,1104,1104,1107,0,3,2
312,6,1,1110,1110,1111,0,1,3
313,1,3,1111,1111,1114,0,3,0
314,6,2,1117,1117,1119,0,2,3
315,4,3,1121,1121,1124,0,3,2
316,5,3,1126,1126,1129,0,3,2
317,3,3,1129,1129,1132,0,3,0
318,6,3,1135,1135,1138,0,3,3
319,2,1,1137,1138,1139,1,2,0
320,5,2,1142,1142,1144,0,2,3
321,6,3,1148,1148,1151,0,3,4
322,1,2,1149,1151,1153,2,4,0
323,4,1,1153,1153,1154,0,1,0
324,3,3,1156,1156,1159,0,3,2
325,3,3,1159,1159,1162,0,3,0
326,2,1,1161,1162,1163,1,2,0
327,2,2,1163,1163,1165,0,2,0
328,2,1,1165,1165,1166,0,1,0
329,3,1,1168,1168,1169,0,1,2
330,6,3,1174,1174,1177,0,3,5
331,2,2,1176,1177,1179,1,3,0
332,6,2,1182,1182,1184,0,2,3
333,1,2,1183,1184,1186,1,3,0
334,2,3,1185,1186,1189,1,4,0
335,2,3,1187,1189,1192,2,5,0
336,1,2,1188,1192,1194,4,6,0
337,6,3,1194,1194,1197,0,3,0
338,6,3,1200,1200,1203,0,3,3
339,6,3,1206,1206,1209,0,3,3
340,3,1,1209,1209,1210,0,1,0
341,1,3,1210,1210,1213,0,3,0
342,5,3,1215,1215,1218,0,3,2
343,3,3,1218,1218,1221,0,3,0
344,4,3,1222,1222,1225,0,3,1
345,3,2,1225,1225,1227,0,2,0
346,6,2,1231,1231,1233,0,2,4
347,3,2,1234,1234,1236,0,2,1
348,2,1,1236,1236,1237,0,1,0
349,3,3,1239,1239,1242,0,3,2
350,2,2,1241,1242,1244,1,3,0
351,4,3,1245,1245,1248,0,3,1
352,3,2,1248,1248,1250,0,2,0
353,1,1,1249,1250,1251,1,2,0
354,2,1,1251,1251,1252,0,1,0
355,3,1,1254,1254,1255,0,1,2
356,4,1,1258,1258,1259,0,1,3
357,6,3,1264,1264,1267,0,3,5
358,2,1,1266,1267,1268,1,2,0
359,6,2,1272,1272,1274,0,2,4
360,6,3,1278,1278,1281,0,3,4
361,3,2,1281,1281,1283,0,2,0
362,6,1,1287,1287,1288,0,1,4
363,5,3,1292,1292,1295,0,3,4
364,2,3,1294,1295,1298,1,4,0
365,5,1,1299,1299,1300,0,1,1
366,4,1,1303,1303,1304,0,1,3
367,4,1,1307,1307,1308,0,1,3
368,2,3,1309,1309,1312,0,3,1
369,4,2,1313,1313,1315,0,2,1
370,1,1,1314,1315,1316,1,2,0
371,1,2,1315,1316,1318,1,3,0
372,3,3,1318,1318,1321,0,3,0
373,6,2,1324,1324,1326,0,2,3
374,6,3,1330,1330,1333,0,3,4
375,6,2,1336,1336,1338,0,2,3
376,1,2,1337,1338,1340,1,3,0
377,6,3,1343,1343,1346,0,3,3
378,2,2,1345,1346,1348,1,3,0
379,1,3,1346,1348,1351,2,5,0
380,5,2,1351,1351,1353,0,2,0
381,2,1,1353,1353,1354,0,1,0
382,4,1,1357,1357,1358,0,1,3
383,4,1,1361,1361,1362,0,1,3
384,1,3,1362,1362,1365,0,3,0
385,3,2,1365,1365,1367,0,2,0
386,5,1,1370,1370,1371,0,1,3
387,4,1,1374,1374,1375,0,1,3
388,2,1,1376,1376,1377,0,1,1
389,3,1,1379,1379,1380,0,1,2
390,3,1,1382,1382,1383,0,1,2
391,5,3,1387,1387,1390,0,3,4
392,5,2,1392,1392,1394,0,2,2
393,3,2,1395,1395,1397,0,2,1
394,3,1,1398,1398,1399,0,1,1
395,4,1,1402,1402,1403,0,1,3
396,3,1,1405,1405,1406,0,1,2
397,6,2,1411,1411,1413,0,2,5
398,1,2,1412,1413,1415,1,3,0
399,5,2,1417,1417,1419,0,2,2
400,5,3,1422,1422,1425,0,3,3
401,6,1,1428,1428,1429,0,1,3
402,6,1,1434,1434,1435,0,1,5
403,4,2,1438,1438,1440,0,2,3
404,5,2,1443,1443,1445,0,2,3
405,2,3,1445,1445,1448,0,3,0
406,3,1,1448,1448,1449,0,1,0
407,6,2,1454,1454,1456,0,2,5
408,2,1,1456,1456,1457,0,1,0
409,4,2,1460,1460,1462,0,2,3
410,2,3,1462,1462,1465,0,3,0
411,2,2,1464,1465,1467,1,3,0
412,4,2,1468,1468,1470,0,2,1
413,6,3,1474,1474,1477,0,3,4
414,3,3,1477,1477,1480,0,3,0
415,2,3,1479,1480,1483,1,4,0
416,6,3,1485,1485,1488,0,3,2
417,5,2,1490,1490,1492,0,2,2
418,6,1,1496,1496,1497,0,1,4
419,3,2,1499,1499,1501,0,2,2
420,5,2,1504,1504,1506,0,2,3
421,2,3,1506,1506,1509,0,3,0
422,2,2,1508,1509,1511,1,3,0
423,1,3,1509,1511,1514,2,5,0
424,2,3,1511,1514,1517,3,6,0
425,5,1,1516,1517,1518,1,2,0
426,5,3,1521,1521,1524,0,3,3
427,2,2,1523,1524,1526,1,3,0
428,6,2,1529,1529,1531,0,2,3
429,5,1,1534,1534,1535,0,1,3
430,5,2,1539,1539,1541,0,2,4
431,4,3,1543,1543,1546,0,3,2
432,3,2,1546,1546,1548,0,2,0
433,6,3,1552,1552,1555,0,3,4
434,6,1,1558,1558,1559,0,1,3
435,5,1,1563,1563,1564,0,1,4
436,5,3,1568,1568,1571,0,3,4
437,2,2,1570,1571,1573,1,3,0
438,1,1,1571,1573,1574,2,3,0
439,3,3,1574,1574,1577,0,3,0
440,2,1,1576,1577,1578,1,2,0
441,4,2,1580,1580,1582,0,2,2
442,4,1,1584,1584,1585,0,1,2
443,6,3,1590,1590,1593,0,3,5
444,4,1,1594,1594,1595,0,1,1
445,4,1,1598,1598,1599,0,1,3
446,1,1,1599,1599,1600,0,1,0
447,1,2,1600,1600,1602,0,2,0
448,1,3,1601,1602,1605,1,4,0
449,1,2,1602,1605,1607,3,5,0
450,1,2,1603,1607,1609,4,6,0
451,2,3,1605,1609,1612,4,7,0
452,3,1,1608,1612,1613,4,5,0
453,6,1,1614,1614,1615,0,1,1
454,1,2,1615,1615,1617,0,2,0
455,4,3,1619,1619,1622,0,3,2
456,3,3,1622,1622,1625,0,3,0
457,4,2,1626,1626,1628,0,2,1
458,3,1,1629,1629,1630,0,1,1
459,3,1,1632,1632,1633,0,1,2
460,6,1,1638,1638,1639,0,1,5
461,6,1,1644,1644,1645,0,1,5
462,4,1,1648,1648,1649,0,1,3
463,6,1,1654,1654,1655,0,1,5
464,3,2,1657,1657,1659,0,2,2
465,5,3,1662,1662,1665,0,3,3
466,4,2,1666,1666,1668,0,2,1
467,5,2,1671,1671,1673,0,2,3
468,3,1,1674,1674,1675,0,1,1
469,2,1,1676,1676,1677,0,1,1
470,3,3,1679,1679,1682,0,3,2
471,4,1,1683,1683,1684,0,1,1
472,1,1,1684,1684,1685,0,1,0
473,1,3,1685,1685,1688,0,3,0
474,2,3,1687,1688,1691,1,4,0
475,1,3,1688,1691,1694,3,6,0
476,6,3,1694,1694,1697,0,3,0
477,1,1,1695,1697,1698,2,3,0
478,3,1,1698,1698,1699,0,1,0
479,1,3,1699,1699,1702,0,3,0
480,2,3,1701,1702,1705,1,4,0
481,5,3,1706,1706,1709,0,3,1
482,5,3,1711,1711,1714,0,3,2
483,3,3,1714,1714,1717,0,3,0
484,5,2,1719,1719,1721,0,2,2
485,1,3,1720,1721,1724,1,4,0
486,5,1,1725,1725,1726,0,1,1
487,5,2,1730,1730,1732,0,2,4
488,1,3,1731,1732,1735,1,4,0
489,2,1,1733,1735,1736,2,3,0
490,2,3,1735,1736,1739,1,4,0
491,3,1,1738,1739,1740,1,2,0
492,2,2,1740,1740,1742,0,2,0
493,4,1,1744,1744,1745,0,1,2
494,2,3,1746,1746,1749,0,3,1
495,3,1,1749,1749,1750,0,1,0
496,2,1,1751,1751,1752,0,1,1
497,5,3,1756,1756,1759,0,3,4
498,1,1,1757,1759,1760,2,3,0
499,1,2,1758,1760,1762,2,4,0
500,5,1,1763,1763,1764,0,1,1
501,1,3,1764,1764,1767,0,3,0
502,2,3,1766,1767,1770,1,4,0
503,5,2,1771,1771,1773,0,2,1
504,1,3,1772,1773,1776,1,4,0
505,1,2,1773,1776,1778,3,5,0
506,2,2,1775,1778,1780,3,5,0
507,1,1,1776,1780,1781,4,5,0
508,5,1,1781,1781,1782,0,1,0
509,4,2,1785,1785,1787,0,2,3
510,4,1,1789,1789,1790,0,1,2
511,6,3,1795,1795,1798,0,3,5
512,3,3,1798,1798,1801,0,3,0
513,2,3,1800,1801,1804,1,4,0
514,2,1,1802,1804,1805,2,3,0
515,1,3,1803,1805,1808,2,5,0
516,4,1,1807,1808,1809,1,2,0
517,6,2,1813,1813,1815,0,2,4
518,5,3,1818,1818,1821,0,3,3
519,2,1,1820,1821,1822,1,2,0
520,2,2,1822,1822,1824,0,2,0
521,5,3,1827,1827,1830,0,3,3
522,3,1,1830,1830,1831,0,1,0
523,6,2,1836,1836,1838,0,2,5
524,6,3,1842,1842,1845,0,3,4
525,5,3,1847,1847,1850,0,3,2
526,2,1,1849,1850,1851,1,2,0
527,4,3,1853,1853,1856,0,3,2
528,5,3,1858,1858,1861,0,3,2
529,2,3,1860,1861,1864,1,4,0
530,6,1,1866,1866,1867,0,1,2
531,2,1,1868,1868,1869,0,1,1
532,1,2,1869,1869,1871,0,2,0
533,2,2,1871,1871,1873,0,2,0
534,3,3,1874,1874,1877,0,3,1
535,2,2,1876,1877,1879,1,3,0
536,2,3,1878,1879,1882,1,4,0
537,4,1,1882,1882,1883,0,1,0
538,1,3,1883,1883,1886,0,3,0
539,6,3,1889,1889,1892,0,3,3
540,3,3,1892,1892,1895,0,3,0
541,5,1,1897,1897,1898,0,1,2
542,6,2,1903,1903,1905,0,2,5
543,3,2,1906,1906,1908,0,2,1
544,6,2,1912,1912,1914,0,2,4
545,4,1,1916,1916,1917,0,1,2
546,3,2,1919,1919,1921,0,2,2
547,5,1,1924,1924,1925,0,1,3
548,3,1,1927,1927,1928,0,1,2
549,5,1,1932,1932,1933,0,1,4
550,1,1,1933,1933,1934,0,1,0
551,2,2,1935,1935,1937,0,2,1
552,1,3,1936,1937,1940,1,4,0
553,2,1,1938,1940,1941,2,3,0
554,6,3,1944,1944,1947,0,3,3
555,4,1,1948,1948,1949,0,1,1
556,5,3,1953,1953,1956,0,3,4
557,6,3,1959,1959,1962,0,3,3
558,3,2,1962,1962,1964,0,2,0
559,1,3,1963,1964,1967,1,4,0
560,4,2,1967,1967,1969,0,2,0
561,6,1,1973,1973,1974,0,1,4
562,6,1,1979,1979,1980,0,1,5
563,3,1,1982,1982,1983,0,1,2
564,5,3,1987,1987,1990,0,3,4
565,1,2,1988,1990,1992,2,4,0
566,3,2,1991,1992,1994,1,3,0
567,4,2,1995,1995,1997,0,2,1
568,3,3,1998,1998,2001,0,3,1
569,5,1,2003,2003,2004,0,1,2
570,1,1,2004,2004,2005,0,1,0
571,5,1,2009,2009,2010,0,1,4
572,5,2,2014,2014,2016,0,2,4
573,1,3,2015,2016,2019,1,4,0
574,1,2,2016,2019,2021,3,5,0
575,5,2,2021,2021,2023,0,2,0
576,6,2,2027,2027,2029,0,2,4
577,1,1,2028,2029,2030,1,2,0
578,6,2,2034,2034,2036,0,2,4
579,6,3,2040,2040,2043,0,3,4
580,6,1,2046,2046,2047,0,1,3
581,4,1,2050,2050,2051,0,1,3
582,5,3,2055,2055,2058,0,3,4
583,4,3,2059,2059,2062,0,3,1
584,1,1,2060,2062,2063,2,3,0
585,5,1,2065,2065,2066,0,1,2
586,1,3,2066,2066,2069,0,3,0
587,3,1,2069,2069,2070,0,1,0
588,5,3,2074,2074,2077,0,3,4
589,1,3,2075,2077,2080,2,5,0
590,4,1,2079,2080,2081,1,2,0
591,6,3,2085,2085,2088,0,3,4
592,1,3,2086,2088,2091,2,5,0
593,5,1,2091,2091,2092,0,1,0
594,6,1,2097,2097,2098,0,1,5
595,5,3,2102,2102,2105,0,3,4
596,5,1,2107,2107,2108,0,1,2
597,6,2,2113,2113,2115,0,2,5
598,2,2,2115,2115,2117,0,2,0
599,2,2,2117,2117,2119,0,2,0
600,5,2,2122,2122,2124,0,2,3
601,5,3,2127,2127,2130,0,3,3
602,1,2,2128,2130,2132,2,4,0
603,1,2,2129,2132,2134,3,5,0
604,1,3,2130,2134,2137,4,7,0
605,3,2,2133,2137,2139,4,6,0
606,3,3,2136,2139,2142,3,6,0
607,6,1,2142,2142,2143,0,1,0
608,4,3,2146,2146,2149,0,3,3
609,3,1,2149,2149,2150,0,1,0
610,6,1,2155,2155,2156,0,1,5
611,6,1,2161,2161,2162,0,1,5
612,1,3,2162,2162,2165,0,3,0
613,1,2,2163,2165,2167,2,4,0
614,5,2,2168,2168,2170,0,2,1
615,2,3,2170,2170,2173,0,3,0
616,5,2,2175,2175,2177,0,2,2
617,3,3,2178,2178,2181,0,3,1
618,3,2,2181,2181,2183,0,2,0
619,2,2,2183,2183,2185,0,2,0
620,3,1,2186,2186,2187,0,1,1
621,3,3,2189,2189,2192,0,3,2
622,1,2,2190,2192,2194,2,4,0
623,5,3,2195,2195,2198,0,3,1
624,3,1,2198,2198,2199,0,1,0
625,1,2,2199,2199,2201,0,2,0
626,5,1,2204,2204,2205,0,1,3
627,1,2,2205,2205,2207,0,2,0
628,5,2,2210,2210,2212,0,2,3
629,6,2,2216,2216,2218,0,2,4
630,5,2,2221,2221,2223,0,2,3
631,3,1,2224,2224,2225,0,1,1
632,3,3,2227,2227,2230,0,3,2
633,5,2,2232,2232,2234,0,2,2
634,5,1,2237,2237,2238,0,1,3
635,3,3,2240,2240,2243,0,3,2
636,3,2,2243,2243,2245,0,2,0
637,1,3,2244,2245,2248,1,4,0
638,1,1,2245,2248,2249,3,4,0
639,3,3,2248,2249,2252,1,4,0
640,2,2,2250,2252,2254,2,4,0
641,2,1,2252,2254,2255,2,3,0
642,5,3,2257,2257,2260,0,3,2
643,6,2,2263,2263,2265,0,2,3
644,5,1,2268,2268,2269,0,1,3
645,4,2,2272,2272,2274,0,2,3
646,5,1,2277,2277,2278,0,1,3
647,4,3,2281,2281,2284,0,3,3
648,6,2,2287,2287,2289,0,2,3
649,1,2,2288,2289,2291,1,3,0
650,3,2,2291,2291,2293,0,2,0
651,1,2,2292,2293,2295,1,3,0
652,6,2,2298,2298,2300,0,2,3
653,2,3,2300,2300,2303,0,3,0
654,6,2,2306,2306,2308,0,2,3
655,5,3,2311,2311,2314,0,3,3
656,2,3,2313,2314,2317,1,4,0
657,3,2,2316,2317,2319,1,3,0
658,5,1,2321,2321,2322,0,1,2
659,5,2,2326,2326,2328,0,2,4
660,2,3,2328,2328,2331,0,3,0
661,5,1,2333,2333,2334,0,1,2
662,1,1,2334,2334,2335,0,1,0
663,6,1,2340,2340,2341,0,1,5
664,3,2,2343,2343,2345,0,2,2
665,4,1,2347,2347,2348,0,1,2
666,6,3,2353,2353,2356,0,3,5
667,5,3,2358,2358,2361,0,3,2
668,3,3,2361,2361,2364,0,3,0
669,1,1,2362,2364,2365,2,3,0
670,4,2,2366,2366,2368,0,2,1
671,1,1,2367,2368,2369,1,2,0
672,4,2,2371,2371,2373,0,2,2
673,3,3,2374,2374,2377,0,3,1
674,5,2,2379,2379,2381,0,2,2
675,3,1,2382,2382,2383,0,1,1
676,5,1,2387,2387,2388,0,1,4
677,2,3,2389,2389,2392,0,3,1
678,2,1,2391,2392,2393,1,2,0
679,6,2,2397,2397,2399,0,2,4
680,6,3,2403,2403,2406,0,3,4
681,3,2,2406,2406,2408,0,2,0
682,4,3,2410,2410,2413,0,3,2
683,6,3,2416,2416,2419,0,3,3
684,4,2,2420,2420,2422,0,2,1
685,6,1,2426,2426,2427,0,1,4
686,5,1,2431,2431,2432,0,1,4
687,3,2,2434,2434,2436,0,2,2
688,5,2,2439,2439,2441,0,2,3
689,5,3,2444,2444,2447,0,3,3
690,5,2,2449,2449,2451,0,2,2
691,4,2,2453,2453,2455,0,2,2
692,1,1,2454,2455,2456,1,2,0
693,6,1,2460,2460,2461,0,1,4
694,1,1,2461,2461,2462,0,1,0
695,3,3,2464,2464,2467,0,3,2
696,4,2,2468,2468,2470,0,2,1
697,1,1,2469,2470,2471,1,2,0
698,3,2,2472,2472,2474,0,2,1
699,3,3,2475,2475,2478,0,3,1
700,3,3,2478,2478,2481,0,3,0
701,1,3,2479,2481,2484,2,5,0
702,2,3,2481,2484,2487,3,6,0
703,6,1,2487,2487,2488,0,1,0
704,6,2,2493,2493,2495,0,2,5
705,6,2,2499,2499,2501,0,2,4
706,4,2,2503,2503,2505,0,2,2
707,6,3,2509,2509,2512,0,3,4
708,6,3,2515,2515,2518,0,3,3
709,4,1,2519,2519,2520,0,1,1
710,3,2,2522,2522,2524,0,2,2
711,3,1,2525,2525,2526,0,1,1
712,3,3,2528,2528,2531,0,3,2
713,2,1,2530,2531,2532,1,2,0
714,5,1,2535,2535,2536,0,1,3
715,2,2,2537,2537,2539,0,2,1
716,3,3,2540,2540,2543,0,3,1
717,3,2,2543,2543,2545,0,2,0
718,5,2,2548,2548,2550,0,2,3
719,5,2,2553,2553,2555,0,2,3
720,4,2,2557,2557,2559,0,2,2
721,6,1,2563,2563,2564,0,1,4
722,2,2,2565,2565,2567,0,2,1
723,1,1,2566,2567,2568,1,2,0
724,2,1,2568,2568,2569,0,1,0
725,4,2,2572,2572,2574,0,2,3
726,4,1,2576,2576,2577,0,1,2
727,1,1,2577,2577,2578,0,1,0
728,4,1,2581,2581,2582,0,1,3
729,3,2,2584,2584,2586,0,2,2
730,6,1,2590,2590,2591,0,1,4
731,3,3,2593,2593,2596,0,3,2
732,5,2,2598,2598,2600,0,2,2
733,3,1,2601,2601,2602,0,1,1
734,5,3,2606,2606,2609,0,3,4
735,1,3,2607,2609,2612,2,5,0
736,2,2,2609,2612,2614,3,5,0
737,5,2,2614,2614,2616,0,2,0
738,1,2,2615,2616,2618,1,3,0
739,4,2,2619,2619,2621,0,2,1
740,5,2,2624,2624,2626,0,2,3
741,5,1,2629,2629,2630,0,1,3
742,1,3,2630,2630,2633,0,3,0
743,6,1,2636,2636,2637,0,1,3
744,6,1,2642,2642,2643,0,1,5
745,5,1,2647,2647,2648,0,1,4
746,1,2,2648,2648,2650,0,2,0
747,5,3,2653,2653,2656,0,3,3
748,5,3,2658,2658,2661,0,3,2
749,1,2,2659,2661,2663,2,4,0
750,3,2,2662,2663,2665,1,3,0
751,6,1,2668,2668,2669,0,1,3
752,4,3,2672,2672,2675,0,3,3
753,1,2,2673,2675,2677,2,4,0
754,2,2,2675,2677,2679,2,4,0
755,1,1,2676,2679,2680,3,4,0
756,2,1,2678,2680,2681,2,3,0
757,6,1,2684,2684,2685,0,1,3
758,5,1,2689,2689,2690,0,1,4
759,5,3,2694,2694,2697,0,3,4
760,3,3,2697,2697,2700,0,3,0
761,2,1,2699,2700,2701,1,2,0
762,5,1,2704,2704,2705,0,1,3
763,4,3,2708,2708,2711,0,3,3
764,1,3,2709,2711,2714,2,5,0
765,2,1,2711,2714,2715,3,4,0
766,1,3,2712,2715,2718,3,6,0
767,6,1,2718,2718,2719,0,1,0
768,1,1,2719,2719,2720,0,1,0
769,4,2,2723,2723,2725,0,2,3
770,1,3,2724,2725,2728,1,4,0
771,1,2,2725,2728,2730,3,5,0
772,4,2,2729,2730,2732,1,3,0
773,2,2,2731,2732,2734,1,3,0
774,4,2,2735,2735,2737,0,2,1
775,3,3,2738,2738,2741,0,3,1
776,1,2,2739,2741,2743,2,4,0
777,2,3,2741,2743,2746,2,5,0
778,1,1,2742,2746,2747,4,5,0
779,1,3,2743,2747,2750,4,7,0
780,1,2,2744,2750,2752,6,8,0
781,4,2,2748,2752,2754,4,6,0
782,6,3,2754,2754,2757,0,3,0
783,3,1,2757,2757,2758,0,1,0
784,2,1,2759,2759,2760,0,1,1
785,6,2,2765,2765,2767,0,2,5
786,1,1,2766,2767,2768,1,2,0
787,2,3,2768,2768,2771,0,3,0
788,2,3,2770,2771,2774,1,4,0
789,5,3,2775,2775,2778,0,3,1
790,6,1,2781,2781,2782,0,1,3
791,6,3,2787,2787,2790,0,3,5
792,4,2,2791,2791,2793,0,2,1
793,3,2,2794,2794,2796,0,2,1
794,6,1,2800,2800,2801,0,1,4
795,6,2,2806,2806,2808,0,2,5
796,1,2,2807,2808,2810,1,3,0
797,2,3,2809,2810,2813,1,4,0
798,1,3,2810,2813,2816,3,6,0
799,1,1,2811,2816,2817,5,6,0
800,1,1,2812,2817,2818,5,6,0
801,5,3,2817,2818,2821,1,4,0
802,3,3,2820,2821,2824,1,4,0
803,2,3,2822,2824,2827,2,5,0
804,2,3,2824,2827,2830,3,6,0
805,5,1,2829,2830,2831,1,2,0
806,3,1,2832,2832,2833,0,1,1
807,6,1,2838,2838,2839,0,1,5
808,5,2,2843,2843,2845,0,2,4
809,5,2,2848,2848,2850,0,2,3
810,5,2,2853,2853,2855,0,2,3
811,2,3,2855,2855,2858,0,3,0
812,4,2,2859,2859,2861,0,2,1
813,1,2,2860,2861,2863,1,3,0
814,6,3,2866,2866,2869,0,3,3
815,2,2,2868,2869,2871,1,3,0
816,5,1,2873,2873,2874,0,1,2
817,4,1,2877,2877,2878,0,1,3
818,5,2,2882,2882,2884,0,2,4
819,6,3,2888,2888,2891,0,3,4
820,5,2,2893,2893,2895,0,2,2
821,4,2,2897,2897,2899,0,2,2
822,4,1,2901,2901,2902,0,1,2
823,4,1,2905,2905,2906,0,1,3
824,4,1,2909,2909,2910,0,1,3
825,1,1,2910,2910,2911,0,1,0
826,1,2,2911,2911,2913,0,2,0
827,1,1,2912,2913,2914,1,2,0
828,5,1,2917,2917,2918,0,1,3
829,1,1,2918,2918,2919,0,1,0
830,4,3,2922,2922,2925,0,3,3
831,3,3,2925,2925,2928,0,3,0
832,6,3,2931,2931,2934,0,3,3
833,2,1,2933,2934,2935,1,2,0
834,4,3,2937,2937,2940,0,3,2
835,5,2,2942,2942,2944,0,2,2
836,1,1,2943,2944,2945,1,2,0
837,2,3,2945,2945,2948,0,3,0
838,3,3,2948,2948,2951,0,3,0
839,3,1,2951,2951,2952,0,1,0
840,6,2,2957,2957,2959,0,2,5
841,2,3,2959,2959,2962,0,3,0
842,5,1,2964,2964,2965,0,1,2
843,6,1,2970,2970,2971,0,1,5
844,4,3,2974,2974,2977,0,3,3
845,3,3,2977,2977,2980,0,3,0
846,1,2,2978,2980,2982,2,4,0
847,6,1,2984,2984,2985,0,1,2
848,3,3,2987,2987,2990,0,3,2
849,3,2,2990,2990,2992,0,2,0
850,1,1,2991,2992,2993,1,2,0
851,6,3,2997,2997,3000,0,3,4
852,6,2,3003,3003,3005,0,2,3
853,6,3,3009,3009,3012,0,3,4
854,3,1,3012,3012,3013,0,1,0
855,1,3,3013,3013,3016,0,3,0
856,1,3,3014,3016,3019,2,5,0
857,5,2,3019,3019,3021,0,2,0
858,4,3,3023,3023,3026,0,3,2
859,6,3,3029,3029,3032,0,3,3
860,6,1,3035,3035,3036,0,1,3
861,5,2,3040,3040,3042,0,2,4
862,4,1,3044,3044,3045,0,1,2
863,3,3,3047,3047,3050,0,3,2
864,6,2,3053,3053,3055,0,2,3
865,1,2,3054,3055,3057,1,3,0
866,5,2,3059,3059,3061,0,2,2
867,1,3,3060,3061,3064,1,4,0
868,3,1,3063,3064,3065,1,2,0
869,2,2,3065,3065,3067,0,2,0
870,4,3,3069,3069,3072,0,3,2
871,2,3,3071,3072,3075,1,4,0
872,6,2,3077,3077,3079,0,2,2
873,3,1,3080,3080,3081,0,1,1
874,2,2,3082,3082,3084,0,2,1
875,3,2,3085,3085,3087,0,2,1
876,3,3,3088,3088,3091,0,3,1
877,4,2,3092,3092,3094,0,2,1
878,6,3,3098,3098,3101,0,3,4
879,5,1,3103,3103,3104,0,1,2
880,1,1,3104,3104,3105,0,1,0
881,3,3,3107,3107,3110,0,3,2
882,4,3,3111,3111,3114,0,3,1
883,5,1,3116,3116,3117,0,1,2
884,2,1,3118,3118,3119,0,1,1
885,4,3,3122,3122,3125,0,3,3
886,4,2,3126,3126,3128,0,2,1
887,4,3,3130,3130,3133,0,3,2
888,6,2,3136,3136,3138,0,2,3
889,5,2,3141,3141,3143,0,2,3
890,1,3,3142,3143,3146,1,4,0
891,5,2,3147,3147,3149,0,2,1
892,2,1,3149,3149,3150,0,1,0
893,4,2,3153,3153,3155,0,2,3
894,5,1,3158,3158,3159,0,1,3
895,5,2,3163,3163,3165,0,2,4
896,4,3,3167,3167,3170,0,3,2
897,4,3,3171,3171,3174,0,3,1
898,6,2,3177,3177,3179,0,2,3
899,4,3,3181,3181,3184,0,3,2
900,2,3,3183,3184,3187,1,4,0
901,4,2,3187,3187,3189,0,2,0
902,2,3,3189,3189,3192,0,3,0
903,4,2,3193,3193,3195,0,2,1
904,2,3,3195,3195,3198,0,3,0
905,1,1,3196,3198,3199,2,3,0
906,5,3,3201,3201,3204,0,3,2
907,2,1,3203,3204,3205,1,2,0
908,6,1,3209,3209,3210,0,1,4
909,5,3,3214,3214,3217,0,3,4
910,3,1,3217,3217,3218,0,1,0
911,3,1,3220,3220,3221,0,1,2
912,2,3,3222,3222,3225,0,3,1
913,4,3,3226,3226,3229,0,3,1
914,5,3,3231,3231,3234,0,3,2
915,4,2,3235,3235,3237,0,2,1
916,1,1,3236,3237,3238,1,2,0
917,5,3,3241,3241,3244,0,3,3
918,6,3,3247,3247,3250,0,3,3
919,6,3,3253,3253,3256,0,3,3
920,6,2,3259,3259,3261,0,2,3
921,3,2,3262,3262,3264,0,2,1
922,1,2,3263,3264,3266,1,3,0
923,6,1,3269,3269,3270,0,1,3
924,4,1,3273,3273,3274,0,1,3
925,1,3,3274,3274,3277,0,3,0
926,2,3,3276,3277,3280,1,4,0
927,2,1,3278,3280,3281,2,3,0
928,2,1,3280,3281,3282,1,2,0
929,6,1,3286,3286,3287,0,1,4
930,2,1,3288,3288,3289,0,1,1
931,3,1,3291,3291,3292,0,1,2
932,1,1,3292,3292,3293,0,1,0
933,6,1,3298,3298,3299,0,1,5
934,5,2,3303,3303,3305,0,2,4
935,2,1,3305,3305,3306,0,1,0
936,3,2,3308,3308,3310,0,2,2
937,3,1,3311,3311,3312,0,1,1
938,1,2,3312,3312,3314,0,2,0
939,4,2,3316,3316,3318,0,2,2
940,5,2,3321,3321,3323,0,2,3
941,1,1,3322,3323,3324,1,2,0
942,6,3,3328,3328,3331,0,3,4
943,6,3,3334,3334,3337,0,3,3
944,6,2,3340,3340,3342,0,2,3
945,3,1,3343,3343,3344,0,1,1
946,2,1,3345,3345,3346,0,1,1
947,1,1,3346,3346,3347,0,1,0
948,2,2,3348,3348,3350,0,2,1
949,3,1,3351,3351,3352,0,1,1
950,3,1,3354,3354,3355,0,1,2
951,6,2,3360,3360,3362,0,2,5
952,1,3,3361,3362,3365,1,4,0
953,4,1,3365,3365,3366,0,1,0
954,4,2,3369,3369,3371,0,2,3
955,2,3,3371,3371,3374,0,3,0
956,1,2,3372,3374,3376,2,4,0
957,2,3,3374,3376,3379,2,5,0
958,4,3,3378,3379,3382,1,4,0
959,2,3,3380,3382,3385,2,5,0
960,5,3,3385,3385,3388,0,3,0
961,3,2,3388,3388,3390,0,2,0
962,3,1,3391,3391,3392,0,1,1
963,3,2,3394,3394,3396,0,2,2
964,3,3,3397,3397,3400,0,3,1
965,4,2,3401,3401,3403,0,2,1
966,4,3,3405,3405,3408,0,3,2
967,1,1,3406,3408,3409,2,3,0
968,1,1,3407,3409,3410,2,3,0
969,6,3,3413,3413,3416,0,3,3
970,5,2,3418,3418,3420,0,2,2
971,4,2,3422,3422,3424,0,2,2
972,6,2,3428,3428,3430,0,2,4
973,6,2,3434,3434,3436,0,2,4
974,5,2,3439,3439,3441,0,2,3
975,5,3,3444,3444,3447,0,3,3
976,3,2,3447,3447,3449,0,2,0
977,5,3,3452,3452,3455,0,3,3
978,2,3,3454,3455,3458,1,4,0
979,3,1,3457,3458,3459,1,2,0
980,3,2,3460,3460,3462,0,2,1
981,4,2,3464,3464,3466,0,2,2
982,2,1,3466,3466,3467,0,1,0
983,5,1,3471,3471,3472,0,1,4
984,1,3,3472,3472,3475,0,3,0
985,1,3,3473,3475,3478,2,5,0
986,3,1,3476,3478,3479,2,3,0
987,3,1,3479,3479,3480,0,1,0
988,2,3,3481,3481,3484,0,3,1
989,4,2,3485,3485,3487,0,2,1
990,4,2,3489,3489,3491,0,2,2
991,6,2,3495,3495,3497,0,2,4
992,2,1,3497,3497,3498,0,1,0
993,4,3,3501,3501,3504,0,3,3
994,5,1,3506,3506,3507,0,1,2
995,3,2,3509,3509,3511,0,2,2
996,3,1,3512,3512,3513,0,1,1
997,2,1,3514,3514,3515,0,1,1
998,1,3,3515,3515,3518,0,3,0
999,4,2,3519,3519,3521,0,2,1
1000,5,3,3524,3524,3527,0,3,3
1001,3,1,3527,3527,3528,0,1,0
1002,3,1,3530,3530,3531,0,1,2
1003,5,3,3535,3535,3538,0,3,4
1004,2,1,3537,3538,3539,1,2,0
1005,1,1,3538,3539,3540,1,2,0
1006,3,3,3541,3541,3544,0,3,1
1007,6,2,3547,3547,3549,0,2,3
1008,3,2,3550,3550,3552,0,2,1
1009,2,3,3552,3552,3555,0,3,0
1010,5,3,3557,3557,3560,0,3,2
1011,5,1,3562,3562,3563,0,1,2
1012,2,1,3564,3564,3565,0,1,1
1013,1,1,3565,3565,3566,0,1,0
1014,2,1,3567,3567,3568,0,1,1
1015,3,1,3570,3570,3571,0,1,2
1016,6,3,3576,3576,3579,0,3,5
1017,5,1,3581,3581,3582,0,1,2
1018,1,1,3582,3582,3583,0,1,0
1019,2,3,3584,3584,3587,0,3,1
1020,5,3,3589,3589,3592,0,3,2
1021,1,2,3590,3592,3594,2,4,0
1022,1,3,3591,3594,3597,3,6,0
1023,3,2,3594,3597,3599,3,5,0
1024,3,3,3597,3599,3602,2,5,0
1025,4,2,3601,3602,3604,1,3,0
1026,5,3,3606,3606,3609,0,3,2
1027,6,1,3612,3612,3613,0,1,3
1028,3,1,3615,3615,3616,0,1,2
1029,1,3,3616,3616,3619,0,3,0
1030,1,2,3617,3619,3621,2,4,0
1031,4,3,3621,3621,3624,0,3,0
1032,3,1,3624,3624,3625,0,1,0
1033,2,1,3626,3626,3627,0,1,1
1034,1,2,3627,3627,3629,0,2,0
1035,6,2,3633,3633,3635,0,2,4
1036,6,2,3639,3639,3641,0,2,4
1037,3,1,3642,3642,3643,0,1,1
1038,5,2,3647,3647,3649,0,2,4
1039,1,1,3648,3649,3650,1,2,0
1040,4,2,3652,3652,3654,0,2,2
1041,6,3,3658,3658,3661,0,3,4
1042,4,3,3662,3662,3665,0,3,1
1043,5,1,3667,3667,3668,0,1,2
1044,2,1,3669,3669,3670,0,1,1
1045,3,2,3672,3672,3674,0,2,2
1046,4,2,3676,3676,3678,0,2,2
1047,1,1,3677,3678,3679,1,2,0
1048,3,3,3680,3680,3683,0,3,1
1049,6,3,3686,3686,3689,0,3,3
1050,6,1,3692,3692,3693,0,1,3
1051,2,2,3694,3694,3696,0,2,1
1052,6,2,3700,3700,3702,0,2,4
1053,6,2,3706,3706,3708,0,2,4
1054,5,3,3711,3711,3714,0,3,3
1055,4,3,3715,3715,3718,0,3,1
1056,3,1,3718,3718,3719,0,1,0
1057,5,3,3723,3723,3726,0,3,4
1058,4,3,3727,3727,3730,0,3,1
1059,4,1,3731,3731,3732,0,1,1
1060,4,2,3735,3735,3737,0,2,3
1061,1,1,3736,3737,3738,1,2,0
1062,3,1,3739,3739,3740,0,1,1
1063,3,2,3742,3742,3744,0,2,2
1064,1,3,3743,3744,3747,1,4,0
1065,3,2,3746,3747,3749,1,3,0
1066,1,1,3747,3749,3750,2,3,0
1067,3,2,3750,3750,3752,0,2,0
1068,3,2,3753,3753,3755,0,2,1
1069,4,3,3757,3757,3760,0,3,2
1070,6,1,3763,3763,3764,0,1,3
1071,3,1,3766,3766,3767,0,1,2
1072,6,2,3772,3772,3774,0,2,5
1073,4,1,3776,3776,3777,0,1,2
1074,5,1,3781,3781,3782,0,1,4
1075,1,2,3782,3782,3784,0,2,0
1076,6,3,3788,3788,3791,0,3,4
1077,4,2,3792,3792,3794,0,2,1
1078,1,3,3793,3794,3797,1,4,0
1079,3,1,3796,3797,3798,1,2,0
1080,2,1,3798,3798,3799,0,1,0
1081,6,2,3804,3804,3806,0,2,5
1082,2,1,3806,3806,3807,0,1,0
1083,5,1,3811,3811,3812,0,1,4
1084,3,1,3814,3814,3815,0,1,2
1085,2,2,3816,3816,3818,0,2,1
1086,1,2,3817,3818,3820,1,3,0
1087,5,3,3822,3822,3825,0,3,2
1088,4,3,3826,3826,3829,0,3,1
1089,3,1,3829,3829,3830,0,1,0
1090,1,2,3830,3830,3832,0,2,0
1091,5,1,3835,3835,3836,0,1,3
1092,6,3,3841,3841,3844,0,3,5
1093,3,2,3844,3844,3846,0,2,0
1094,1,1,3845,3846,3847,1,2,0
1095,6,1,3851,3851,3852,0,1,4
1096,5,1,3856,3856,3857,0,1,4
1097,3,2,3859,3859,3861,0,2,2
1098,4,2,3863,3863,3865,0,2,2
1099,4,1,3867,3867,3868,0,1,2
1100,4,3,3871,3871,3874,0,3,3
1101,5,1,3876,3876,3877,0,1,2
1102,1,2,3877,3877,3879,0,2,0
1103,1,3,3878,3879,3882,1,4,0
1104,4,2,3882,3882,3884,0,2,0
1105,1,3,3883,3884,3887,1,4,0
1106,4,3,3887,3887,3890,0,3,0
1107,2,3,3889,3890,3893,1,4,0
1108,3,1,3892,3893,3894,1,2,0
1109,3,2,3895,3895,3897,0,2,1
1110,2,1,3897,3897,3898,0,1,0
1111,2,1,3899,3899,3900,0,1,1
1112,2,3,3901,3901,3904,0,3,1
1113,5,3,3906,3906,3909,0,3,2
1114,4,1,3910,3910,3911,0,1,1
1115,5,3,3915,3915,3918,0,3,4
1116,1,1,3916,3918,3919,2,3,0
1117,2,2,3918,3919,3921,1,3,0
1118,6,1,3924,3924,3925,0,1,3
1119,2,2,3926,3926,3928,0,2,1
1120,5,1,3931,3931,3932,0,1,3
1121,4,2,3935,3935,3937,0,2,3
1122,5,3,3940,3940,3943,0,3,3
1123,6,1,3946,3946,3947,0,1,3
1124,5,2,3951,3951,3953,0,2,4
1125,4,2,3955,3955,3957,0,2,2
1126,2,1,3957,3957,3958,0,1,0
1127,4,1,3961,3961,3962,0,1,3
1128,4,1,3965,3965,3966,0,1,3
1129,2,2,3967,3967,3969,0,2,1
1130,3,1,3970,3970,3971,0,1,1
1131,6,1,3976,3976,3977,0,1,5
1132,3,3,3979,3979,3982,0,3,2
1133,5,2,3984,3984,3986,0,2,2
1134,5,2,3989,3989,3991,0,2,3
1135,5,2,3994,3994,3996,0,2,3
1136,6,1,4000,4000,4001,0,1,4
1137,2,3,4002,4002,4005,0,3,1
1138,3,2,4005,4005,4007,0,2,0
1139,6,1,4011,4011,4012,0,1,4
1140,5,1,4016,4016,4017,0,1,4
1141,5,3,4021,4021,4024,0,3,4
1142,6,3,4027,4027,4030,0,3,3
1143,1,2,4028,4030,4032,2,4,0
1144,6,1,4034,4034,4035,0,1,2
1145,5,3,4039,4039,4042,0,3,4
1146,6,1,4045,4045,4046,0,1,3
1147,5,2,4050,4050,4052,0,2,4
1148,2,1,4052,4052,4053,0,1,0
1149,2,2,4054,4054,4056,0,2,1
1150,3,2,4057,4057,4059,0,2,1
1151,3,1,4060,4060,4061,0,1,1
1152,3,3,4063,4063,4066,0,3,2
1153,1,2,4064,4066,4068,2,4,0
1154,6,3,4070,4070,4073,0,3,2
1155,3,2,4073,4073,4075,0,2,0
1156,2,2,4075,4075,4077,0,2,0
1157,2,3,4077,4077,4080,0,3,0
1158,4,3,4081,4081,4084,0,3,1
1159,3,3,4084,4084,4087,0,3,0
1160,5,1,4089,4089,4090,0,1,2
1161,1,1,4090,4090,4091,0,1,0
1162,3,1,4093,4093,4094,0,1,2
1163,4,2,4097,4097,4099,0,2,3
1164,3,1,4100,4100,4101,0,1,1
1165,6,3,4106,4106,4109,0,3,5
1166,1,2,4107,4109,4111,2,4,0
1167,3,3,4110,4111,4114,1,4,0
1168,3,2,4113,4114,4116,1,3,0
1169,4,1,4117,4117,4118,0,1,1
1170,3,3,4120,4120,4123,0,3,2
1171,1,2,4121,4123,4125,2,4,0
1172,4,1,4125,4125,4126,0,1,0
1173,1,1,4126,4126,4127,0,1,0
1174,1,1,4127,4127,4128,0,1,0
1175,5,3,4132,4132,4135,0,3,4
1176,6,2,4138,4138,4140,0,2,3
1177,1,1,4139,4140,4141,1,2,0
1178,2,1,4141,4141,4142,0,1,0
1179,3,1,4144,4144,4145,0,1,2
1180,4,2,4148,4148,4150,0,2,3
1181,6,2,4154,4154,4156,0,2,4
1182,3,2,4157,4157,4159,0,2,1
1183,5,1,4162,4162,4163,0,1,3
1184,4,3,4166,4166,4169,0,3,3
1185,2,1,4168,4169,4170,1,2,0
1186,4,1,4172,4172,4173,0,1,2
1187,3,1,4175,4175,4176,0,1,2
1188,6,2,4181,4181,4183,0,2,5
1189,3,2,4184,4184,4186,0,2,1
1190,5,2,4189,4189,4191,0,2,3
1191,6,2,4195,4195,4197,0,2,4
1192,5,3,4200,4200,4203,0,3,3
1193,1,1,4201,4203,4204,2,3,0
1194,5,3,4206,4206,4209,0,3,2
1195,1,3,4207,4209,4212,2,5,0
1196,3,2,4210,4212,4214,2,4,0
1197,2,1,4212,4214,4215,2,3,0
1198,3,2,4215,4215,4217,0,2,0
1199,2,1,4217,4217,4218,0,1,0
1200,1,3,4218,4218,4221,0,3,0
1201,2,3,4220,4221,4224,1,4,0
1202,6,2,4226,4226,4228,0,2,2
1203,1,1,4227,4228,4229,1,2,0
1204,2,2,4229,4229,4231,0,2,0
1205,3,2,4232,4232,4234,0,2,1
1206,6,2,4238,4238,4240,0,2,4
1207,5,3,4243,4243,4246,0,3,3
1208,3,2,4246,4246,4248,0,2,0
1209,1,2,4247,4248,4250,1,3,0
1210,2,2,4249,4250,4252,1,3,0
1211,5,2,4254,4254,4256,0,2,2
1212,5,3,4259,4259,4262,0,3,3
1213,1,3,4260,4262,4265,2,5,0
1214,3,2,4263,4265,4267,2,4,0
1215,5,2,4268,4268,4270,0,2,1
1216,3,3,4271,4271,4274,0,3,1
1217,4,3,4275,4275,4278,0,3,1
1218,4,2,4279,4279,4281,0,2,1
1219,2,1,4281,4281,4282,0,1,0
1220,2,1,4283,4283,4284,0,1,1
1221,3,2,4286,4286,4288,0,2,2
1222,5,1,4291,4291,4292,0,1,3
1223,4,2,4295,4295,4297,0,2,3
1224,5,1,4300,4300,4301,0,1,3
1225,4,1,4304,4304,4305,0,1,3
1226,5,2,4309,4309,4311,0,2,4
1227,2,2,4311,4311,4313,0,2,0
1228,4,1,4315,4315,4316,0,1,2
1229,1,2,4316,4316,4318,0,2,0
1230,3,3,4319,4319,4322,0,3,1
1231,3,3,4322,4322,4325,0,3,0
1232,5,3,4327,4327,4330,0,3,2
1233,2,3,4329,4330,4333,1,4,0
1234,6,1,4335,4335,4336,0,1,2
1235,4,2,4339,4339,4341,0,2,3
1236,5,1,4344,4344,4345,0,1,3
1237,6,1,4350,4350,4351,0,1,5
1238,4,1,4354,4354,4355,0,1,3
1239,3,1,4357,4357,4358,0,1,2
1240,6,3,4363,4363,4366,0,3,5
1241,4,3,4367,4367,4370,0,3,1
1242,3,3,4370,4370,4373,0,3,0
1243,3,3,4373,4373,4376,0,3,0
1244,5,1,4378,4378,4379,0,1,2
1245,3,2,4381,4381,4383,0,2,2
1246,1,1,4382,4383,4384,1,2,0
1247,6,1,4388,4388,4389,0,1,4
1248,5,1,4393,4393,4394,0,1,4
1249,4,2,4397,4397,4399,0,2,3
1250,2,1,4399,4399,4400,0,1,0
1251,6,2,4405,4405,4407,0,2,5
1252,1,3,4406,4407,4410,1,4,0
1253,3,1,4409,4410,4411,1,2,0
1254,2,3,4411,4411,4414,0,3,0
1255,2,2,4413,4414,4416,1,3,0
1256,1,1,4414,4416,4417,2,3,0
1257,3,1,4417,4417,4418,0,1,0
1258,3,2,4420,4420,4422,0,2,2
1259,5,1,4425,4425,4426,0,1,3
1260,3,3,4428,4428,4431,0,3,2
1261,5,1,4433,4433,4434,0,1,2
1262,2,2,4435,4435,4437,0,2,1
1263,5,3,4440,4440,4443,0,3,3
1264,2,2,4442,4443,4445,1,3,0
1265,5,3,4447,4447,4450,0,3,2
1266,4,3,4451,4451,4454,0,3,1
1267,4,3,4455,4455,4458,0,3,1
1268,5,2,4460,4460,4462,0,2,2
1269,4,3,4464,4464,4467,0,3,2
1270,4,3,4468,4468,4471,0,3,1
1271,1,2,4469,4471,4473,2,4,0
1272,3,2,4472,4473,4475,1,3,0
1273,5,1,4477,4477,4478,0,1,2
1274,4,1,4481,4481,4482,0,1,3
1275,2,3,4483,4483,4486,0,3,1
1276,5,1,4488,4488,4489,0,1,2
1277,5,3,4493,4493,4496,0,3,4
1278,1,2,4494,4496,4498,2,4,0
1279,3,1,4497,4498,4499,1,2,0
1280,4,1,4501,4501,4502,0,1,2
1281,3,3,4504,4504,4507,0,3,2
1282,4,2,4508,4508,4510,0,2,1
1283,4,3,4512,4512,4515,0,3,2
1284,6,3,4518,4518,4521,0,3,3
1285,6,2,4524,4524,4526,0,2,3
1286,1,2,4525,4526,4528,1,3,0
1287,1,1,4526,4528,4529,2,3,0
1288,2,3,4528,4529,4532,1,4,0
1289,1,3,4529,4532,4535,3,6,0
1290,6,2,4535,4535,4537,0,2,0
1291,5,3,4540,4540,4543,0,3,3
1292,6,1,4546,4546,4547,0,1,3
1293,6,2,4552,4552,4554,0,2,5
1294,3,1,4555,4555,4556,0,1,1
1295,1,1,4556,4556,4557,0,1,0
1296,2,2,4558,4558,4560,0,2,1
1297,6,3,4564,4564,4567,0,3,4
1298,2,2,4566,4567,4569,1,3,0
1299,1,2,4567,4569,4571,2,4,0
1300,1,2,4568,4571,4573,3,5,0
1301,3,2,4571,4573,4575,2,4,0
1302,6,2,4577,4577,4579,0,2,2
1303,4,1,4581,4581,4582,0,1,2
1304,2,3,4583,4583,4586,0,3,1
1305,3,1,4586,4586,4587,0,1,0
1306,2,3,4588,4588,4591,0,3,1
1307,3,1,4591,4591,4592,0,1,0
1308,1,1,4592,4592,4593,0,1,0
1309,2,2,4594,4594,4596,0,2,1
1310,4,2,4598,4598,4600,0,2,2
1311,2,2,4600,4600,4602,0,2,0
1312,4,1,4604,4604,4605,0,1,2
1313,5,2,4609,4609,4611,0,2,4
1314,2,2,4611,4611,4613,0,2,0
1315,3,3,4614,4614,4617,0,3,1
1316,5,2,4619,4619,4621,0,2,2
1317,5,3,4624,4624,4627,0,3,3
1318,4,1,4628,4628,4629,0,1,1
1319,1,1,4629,4629,4630,0,1,0
1320,2,2,4631,4631,4633,0,2,1
1321,5,3,4636,4636,4639,0,3,3
1322,3,2,4639,4639,4641,0,2,0
1323,6,3,4645,4645,4648,0,3,4
1324,2,1,4647,4648,4649,1,2,0
1325,6,3,4653,4653,4656,0,3,4
1326,6,1,4659,4659,4660,0,1,3
1327,2,2,4661,4661,4663,0,2,1
1328,1,1,4662,4663,4664,1,2,0
1329,4,1,4666,4666,4667,0,1,2
1330,1,2,4667,4667,4669,0,2,0
1331,4,2,4671,4671,4673,0,2,2
1332,4,3,4675,4675,4678,0,3,2
1333,1,1,4676,4678,4679,2,3,0
1334,6,1,4682,4682,4683,0,1,3
1335,6,1,4688,4688,4689,0,1,5
1336,1,1,4689,4689,4690,0,1,0
1337,3,3,4692,4692,4695,0,3,2
1338,2,1,4694,4695,4696,1,2,0
1339,4,1,4698,4698,4699,0,1,2
1340,5,1,4703,4703,4704,0,1,4
1341,4,2,4707,4707,4709,0,2,3
1342,6,3,4713,4713,4716,0,3,4
1343,5,1,4718,4718,4719,0,1,2
1344,2,1,4720,4720,4721,0,1,1
1345,1,1,4721,4721,4722,0,1,0
1346,4,3,4725,4725,4728,0,3,3
1347,3,2,4728,4728,4730,0,2,0
1348,5,3,4733,4733,4736,0,3,3
1349,3,2,4736,4736,4738,0,2,0
1350,5,1,4741,4741,4742,0,1,3
1351,2,2,4743,4743,4745,0,2,1
1352,6,1,4749,4749,4750,0,1,4
1353,5,3,4754,4754,4757,0,3,4
1354,6,3,4760,4760,4763,0,3,3
1355,5,2,4765,4765,4767,0,2,2
1356,6,3,4771,4771,4774,0,3,4
1357,4,3,4775,4775,4778,0,3,1
1358,6,3,4781,4781,4784,0,3,3
1359,1,3,4782,4784,4787,2,5,0
1360,4,3,4786,4787,4790,1,4,0
1361,4,1,4790,4790,4791,0,1,0
1362,2,2,4792,4792,4794,0,2,1
1363,1,2,4793,4794,4796,1,3,0
1364,5,1,4798,4798,4799,0,1,2
1365,4,2,4802,4802,4804,0,2,3
1366,5,2,4807,4807,4809,0,2,3
1367,6,2,4813,4813,4815,0,2,4
1368,3,2,4816,4816,4818,0,2,1
1369,1,2,4817,4818,4820,1,3,0
1370,6,1,4823,4823,4824,0,1,3
1371,1,1,4824,4824,4825,0,1,0
1372,2,2,4826,4826,4828,0,2,1
1373,5,2,4831,4831,4833,0,2,3
1374,6,1,4837,4837,4838,0,1,4
1375,2,3,4839,4839,4842,0,3,1
1376,2,2,4841,4842,4844,1,3,0
1377,3,1,4844,4844,4845,0,1,0
1378,4,1,4848,4848,4849,0,1,3
1379,3,2,4851,4851,4853,0,2,2
1380,6,3,4857,4857,4860,0,3,4
1381,5,1,4862,4862,4863,0,1,2
1382,6,1,4868,4868,4869,0,1,5
1383,1,3,4869,4869,4872,0,3,0
1384,3,2,4872,4872,4874,0,2,0
1385,3,3,4875,4875,4878,0,3,1
1386,1,1,4876,4878,4879,2,3,0
1387,5,1,4881,4881,4882,0,1,2
1388,6,2,4887,4887,4889,0,2,5
1389,6,2,4893,4893,4895,0,2,4
1390,1,2,4894,4895,4897,1,3,0
1391,3,3,4897,4897,4900,0,3,0
1392,1,2,4898,4900,4902,2,4,0
1393,1,1,4899,4902,4903,3,4,0
1394,2,3,4901,4903,4906,2,5,0
1395,5,3,4906,4906,4909,0,3,0
1396,1,1,4907,4909,4910,2,3,0
1397,6,2,4913,4913,4915,0,2,3
1398,2,1,4915,4915,4916,0,1,0
1399,5,1,4920,4920,4921,0,1,4
1400,2,3,4922,4922,4925,0,3,1
1401,5,3,4927,4927,4930,0,3,2
1402,6,2,4933,4933,4935,0,2,3
1403,1,2,4934,4935,4937,1,3,0
1404,4,3,4938,4938,4941,0,3,1
1405,3,1,4941,4941,4942,0,1,0
1406,6,2,4947,4947,4949,0,2,5
1407,1,1,4948,4949,4950,1,2,0
1408,5,1,4953,4953,4954,0,1,3
1409,5,3,4958,4958,4961,0,3,4
1410,5,1,4963,4963,4964,0,1,2
1411,4,2,4967,4967,4969,0,2,3
1412,1,3,4968,4969,4972,1,4,0
1413,3,1,4971,4972,4973,1,2,0
1414,6,2,4977,4977,4979,0,2,4
1415,2,2,4979,4979,4981,0,2,0
1416,2,1,4981,4981,4982,0,1,0
1417,4,1,4985,4985,4986,0,1,3
1418,6,2,4991,4991,4993,0,2,5
1419,2,2,4993,4993,4995,0,2,0
1420,2,2,4995,4995,4997,0,2,0
1421,3,2,4998,4998,5000,0,2,1
1422,5,2,5003,5003,5005,0,2,3
1423,5,3,5008,5008,5011,0,3,3
1424,1,1,5009,5011,5012,2,3,0
1425,3,2,5012,5012,5014,0,2,0
1426,2,3,5014,5014,5017,0,3,0
1427,6,1,5020,5020,5021,0,1,3
1428,1,3,5021,5021,5024,0,3,0
1429,3,2,5024,5024,5026,0,2,0
1430,1,3,5025,5026,5029,1,4,0
1431,6,1,5031,5031,5032,0,1,2
1432,1,2,5032,5032,5034,0,2,0
1433,5,1,5037,5037,5038,0,1,3
1434,5,3,5042,5042,5045,0,3,4
1435,3,3,5045,5045,5048,0,3,0
1436,1,1,5046,5048,5049,2,3,0
1437,6,2,5052,5052,5054,0,2,3
1438,6,2,5058,5058,5060,0,2,4
1439,5,1,5063,5063,5064,0,1,3
1440,3,1,5066,5066,5067,0,1,2
1441,3,2,5069,5069,5071,0,2,2
1442,3,3,5072,5072,5075,0,3,1
1443,6,3,5078,5078,5081,0,3,3
1444,2,3,5080,5081,5084,1,4,0
1445,2,3,5082,5084,5087,2,5,0
1446,5,1,5087,5087,5088,0,1,0
1447,4,3,5091,5091,5094,0,3,3
1448,2,3,5093,5094,5097,1,4,0
1449,5,2,5098,5098,5100,0,2,1
1450,2,2,5100,5100,5102,0,2,0
1451,1,1,5101,5102,5103,1,2,0
1452,4,3,5105,5105,5108,0,3,2
1453,1,2,5106,5108,5110,2,4,0
1454,4,3,5110,5110,5113,0,3,0
1455,2,1,5112,5113,5114,1,2,0
1456,6,2,5118,5118,5120,0,2,4
1457,1,1,5119,5120,5121,1,2,0
1458,5,1,5124,5124,5125,0,1,3
1459,2,3,5126,5126,5129,0,3,1
1460,2,1,5128,5129,5130,1,2,0
1461,3,1,5131,5131,5132,0,1,1
1462,3,1,5134,5134,5135,0,1,2
1463,4,1,5138,5138,5139,0,1,3
1464,2,3,5140,5140,5143,0,3,1
1465,3,3,5143,5143,5146,0,3,0
1466,3,3,5146,5146,5149,0,3,0
1467,1,3,5147,5149,5152,2,5,0
1468,4,2,5151,5152,5154,1,3,0
1469,2,2,5153,5154,5156,1,3,0
1470,4,2,5157,5157,5159,0,2,1
1471,1,3,5158,5159,5162,1,4,0
1472,5,2,5163,5163,5165,0,2,1
1473,3,2,5166,5166,5168,0,2,1
1474,2,1,5168,5168,5169,0,1,0
1475,4,1,5172,5172,5173,0,1,3
1476,2,1,5174,5174,5175,0,1,1
1477,4,2,5178,5178,5180,0,2,3
1478,6,3,5184,5184,5187,0,3,4
1479,2,3,5186,5187,5190,1,4,0
1480,1,1,5187,5190,5191,3,4,0
1481,3,3,5190,5191,5194,1,4,0
1482,5,2,5195,5195,5197,0,2,1
1483,2,1,5197,5197,5198,0,1,0
1484,2,2,5199,5199,5201,0,2,1
1485,1,2,5200,5201,5203,1,3,0
1486,2,1,5202,5203,5204,1,2,0
1487,6,1,5208,5208,5209,0,1,4
1488,3,2,5211,5211,5213,0,2,2
1489,6,3,5217,5217,5220,0,3,4
1490,2,2,5219,5220,5222,1,3,0
1491,4,1,5223,5223,5224,0,1,1
1492,1,1,5224,5224,5225,0,1,0
1493,4,1,5228,5228,5229,0,1,3
1494,3,3,5231,5231,5234,0,3,2
1495,3,2,5234,5234,5236,0,2,0
1496,6,2,5240,5240,5242,0,2,4
1497,5,2,5245,5245,5247,0,2,3
1498,3,1,5248,5248,5249,0,1,1
1499,3,1,5251,5251,5252,0,1,2
1500,1,1,5252,5252,5253,0,1,0
1501,5,1,5257,5257,5258,0,1,4
1502,3,3,5260,5260,5263,0,3,2
1503,1,2,5261,5263,5265,2,4,0
1504,2,3,5263,5265,5268,2,5,0
1505,4,2,5267,5268,5270,1,3,0
1506,4,2,5271,5271,5273,0,2,1
1507,6,2,5277,5277,5279,0,2,4
1508,1,2,5278,5279,5281,1,3,0
1509,1,3,5279,5281,5284,2,5,0
1510,6,2,5285,5285,5287,0,2,1
1511,6,3,5291,5291,5294,0,3,4
1512,3,1,5294,5294,5295,0,1,0
1513,3,2,5297,5297,5299,0,2,2
1514,3,3,5300,5300,5303,0,3,1
1515,1,3,5301,5303,5306,2,5,0
1516,6,3,5307,5307,5310,0,3,1
1517,5,2,5312,5312,5314,0,2,2
1518,5,3,5317,5317,5320,0,3,3
1519,3,3,5320,5320,5323,0,3,0
1520,4,1,5324,5324,5325,0,1,1
1521,2,2,5326,5326,5328,0,2,1
1522,3,3,5329,5329,5332,0,3,1
1523,6,1,5335,5335,5336,0,1,3
1524,1,1,5336,5336,5337,0,1,0
1525,3,2,5339,5339,5341,0,2,2
1526,4,1,5343,5343,5344,0,1,2
1527,6,3,5349,5349,5352,0,3,5
1528,5,1,5354,5354,5355,0,1,2
1529,2,2,5356,5356,5358,0,2,1
1530,1,3,5357,5358,5361,1,4,0
1531,4,3,5361,5361,5364,0,3,0
1532,6,1,5367,5367,5368,0,1,3
1533,6,2,5373,5373,5375,0,2,5
1534,6,1,5379,5379,5380,0,1,4
1535,5,1,5384,5384,5385,0,1,4
1536,2,3,5386,5386,5389,0,3,1
1537,2,1,5388,5389,5390,1,2,0
1538,2,1,5390,5390,5391,0,1,0
1539,5,1,5395,5395,5396,0,1,4
1540,3,3,5398,5398,5401,0,3,2
1541,5,1,5403,5403,5404,0,1,2
1542,6,3,5409,5409,5412,0,3,5
1543,2,2,5411,5412,5414,1,3,0
1544,5,2,5416,5416,5418,0,2,2
1545,4,3,5420,5420,5423,0,3,2
1546,6,2,5426,5426,5428,0,2,3
1547,2,3,5428,5428,5431,0,3,0
1548,4,2,5432,5432,5434,0,2,1
1549,3,1,5435,5435,5436,0,1,1
1550,5,2,5440,5440,5442,0,2,4
1551,4,1,5444,5444,5445,0,1,2
1552,5,3,5449,5449,5452,0,3,4
1553,1,1,5450,5452,5453,2,3,0
1554,5,3,5455,5455,5458,0,3,2
1555,6,3,5461,5461,5464,0,3,3
1556,3,2,5464,5464,5466,0,2,0
1557,5,1,5469,5469,5470,0,1,3
1558,6,3,5475,5475,5478,0,3,5
1559,2,2,5477,5478,5480,1,3,0
1560,2,3,5479,5480,5483,1,4,0
1561,4,1,5483,5483,5484,0,1,0
1562,4,2,5487,5487,5489,0,2,3
1563,3,2,5490,5490,5492,0,2,1
1564,6,3,5496,5496,5499,0,3,4
1565,2,2,5498,5499,5501,1,3,0
1566,1,3,5499,5501,5504,2,5,0
1567,5,1,5504,5504,5505,0,1,0
1568,3,2,5507,5507,5509,0,2,2
1569,3,3,5510,5510,5513,0,3,1
1570,2,3,5512,5513,5516,1,4,0
1571,6,2,5518,5518,5520,0,2,2
1572,6,2,5524,5524,5526,0,2,4
1573,1,3,5525,5526,5529,1,4,0
1574,5,3,5530,5530,5533,0,3,1
1575,5,3,5535,5535,5538,0,3,2
1576,3,1,5538,5538,5539,0,1,0
1577,3,2,5541,5541,5543,0,2,2
1578,6,3,5547,5547,5550,0,3,4
1579,6,3,5553,5553,5556,0,3,3
1580,1,2,5554,5556,5558,2,4,0
1581,2,1,5556,5558,5559,2,3,0
1582,6,2,5562,5562,5564,0,2,3
1583,5,1,5567,5567,5568,0,1,3
1584,3,3,5570,5570,5573,0,3,2
1585,3,3,5573,5573,5576,0,3,0
1586,6,2,5579,5579,5581,0,2,3
1587,5,3,5584,5584,5587,0,3,3
1588,1,2,5585,5587,5589,2,4,0
1589,1,1,5586,5589,5590,3,4,0
1590,6,1,5592,5592,5593,0,1,2
1591,6,2,5598,5598,5600,0,2,5
1592,6,2,5604,5604,5606,0,2,4
1593,3,2,5607,5607,5609,0,2,1
1594,4,1,5611,5611,5612,0,1,2
1595,1,2,5612,5612,5614,0,2,0
1596,2,1,5614,5614,5615,0,1,0
1597,5,1,5619,5619,5620,0,1,4
1598,6,3,5625,5625,5628,0,3,5
1599,4,1,5629,5629,5630,0,1,1
1600,5,3,5634,5634,5637,0,3,4
1601,3,2,5637,5637,5639,0,2,0
1602,6,2,5643,5643,5645,0,2,4
1603,3,2,5646,5646,5648,0,2,1
1604,4,2,5650,5650,5652,0,2,2
1605,4,2,5654,5654,5656,0,2,2
1606,3,3,5657,5657,5660,0,3,1
1607,1,2,5658,5660,5662,2,4,0
1608,2,3,5660,5662,5665,2,5,0
1609,2,3,5662,5665,5668,3,6,0
1610,4,1,5666,5668,5669,2,3,0
1611,1,3,5667,5669,5672,2,5,0
1612,3,2,5670,5672,5674,2,4,0
1613,6,1,5676,5676,5677,0,1,2
1614,5,3,5681,5681,5684,0,3,4
1615,4,3,5685,5685,5688,0,3,1
1616,2,2,5687,5688,5690,1,3,0
1617,2,1,5689,5690,5691,1,2,0
1618,6,3,5695,5695,5698,0,3,4
1619,1,2,5696,5698,5700,2,4,0
1620,2,3,5698,5700,5703,2,5,0
1621,1,2,5699,5703,5705,4,6,0
1622,5,3,5704,5705,5708,1,4,0
1623,1,3,5705,5708,5711,3,6,0
1624,3,1,5708,5711,5712,3,4,0
1625,4,1,5712,5712,5713,0,1,0
1626,5,3,5717,5717,5720,0,3,4
1627,2,2,5719,5720,5722,1,3,0
1628,1,3,5720,5722,5725,2,5,0
1629,4,3,5724,5725,5728,1,4,0
1630,3,2,5727,5728,5730,1,3,0
1631,2,1,5729,5730,5731,1,2,0
1632,5,3,5734,5734,5737,0,3,3
1633,3,2,5737,5737,5739,0,2,0
1634,5,1,5742,5742,5743,0,1,3
1635,4,2,5746,5746,5748,0,2,3
1636,5,2,5751,5751,5753,0,2,3
1637,6,1,5757,5757,5758,0,1,4
1638,6,1,5763,5763,5764,0,1,5
1639,1,2,5764,5764,5766,0,2,0
1640,4,3,5768,5768,5771,0,3,2
1641,4,3,5772,5772,5775,0,3,1
1642,5,2,5777,5777,5779,0,2,2
1643,4,1,5781,5781,5782,0,1,2
1644,2,2,5783,5783,5785,0,2,1
1645,3,1,5786,5786,5787,0,1,1
1646,5,1,5791,5791,5792,0,1,4
1647,5,1,5796,5796,5797,0,1,4
1648,5,1,5801,5801,5802,0,1,4
1649,1,1,5802,5802,5803,0,1,0
1650,5,3,5807,5807,5810,0,3,4
1651,3,1,5810,5810,5811,0,1,0
1652,1,1,5811,5811,5812,0,1,0
1653,2,1,5813,5813,5814,0,1,1
1654,4,2,5817,5817,5819,0,2,3
1655,5,2,5822,5822,5824,0,2,3
1656,2,3,5824,5824,5827,0,3,0
1657,4,3,5828,5828,5831,0,3,1
1658,3,3,5831,5831,5834,0,3,0
1659,3,1,5834,5834,5835,0,1,0
1660,3,2,5837,5837,5839,0,2,2
1661,4,1,5841,5841,5842,0,1,2
1662,1,3,5842,5842,5845,0,3,0
1663,5,3,5847,5847,5850,0,3,2
1664,6,3,5853,5853,5856,0,3,3
1665,3,1,5856,5856,5857,0,1,0
1666,3,2,5859,5859,5861,0,2,2
1667,5,1,5864,5864,5865,0,1,3
1668,5,3,5869,5869,5872,0,3,4
1669,3,3,5872,5872,5875,0,3,0
1670,4,2,5876,5876,5878,0,2,1
1671,3,2,5879,5879,5881,0,2,1
1672,4,3,5883,5883,5886,0,3,2
1673,5,3,5888,5888,5891,0,3,2
1674,1,1,5889,5891,5892,2,3,0
1675,3,2,5892,5892,5894,0,2,0
1676,1,3,5893,5894,5897,1,4,0
1677,3,3,5896,5897,5900,1,4,0
1678,1,1,5897,5900,5901,3,4,0
1679,1,1,5898,5901,5902,3,4,0
1680,1,3,5899,5902,5905,3,6,0
1681,5,3,5904,5905,5908,1,4,0
1682,6,2,5910,5910,5912,0,2,2
1683,1,2,5911,5912,5914,1,3,0
1684,4,3,5915,5915,5918,0,3,1
1685,3,3,5918,5918,5921,0,3,0
1686,4,1,5922,5922,5923,0,1,1
1687,2,2,5924,5924,5926,0,2,1
1688,3,2,5927,5927,5929,0,2,1
1689,4,2,5931,5931,5933,0,2,2
1690,2,2,5933,5933,5935,0,2,0
1691,5,3,5938,5938,5941,0,3,3
1692,2,1,5940,5941,5942,1,2,0
1693,5,3,5945,5945,5948,0,3,3
1694,2,2,5947,5948,5950,1,3,0
1695,4,1,5951,5951,5952,0,1,1
1696,3,3,5954,5954,5957,0,3,2
1697,1,1,5955,5957,5958,2,3,0
1698,3,1,5958,5958,5959,0,1,0
1699,1,2,5959,5959,5961,0,2,0
1700,6,3,5965,5965,5968,0,3,4
1701,1,1,5966,5968,5969,2,3,0
1702,2,1,5968,5969,5970,1,2,0
1703,2,2,5970,5970,5972,0,2,0
1704,3,1,5973,5973,5974,0,1,1
1705,1,3,5974,5974,5977,0,3,0
1706,5,1,5979,5979,5980,0,1,2
1707,6,2,5985,5985,5987,0,2,5
1708,1,2,5986,5987,5989,1,3,0
1709,5,2,5991,5991,5993,0,2,2
1710,2,1,5993,5993,5994,0,1,0
1711,5,2,5998,5998,6000,0,2,4
1712,2,1,6000,6000,6001,0,1,0
1713,6,2,6006,6006,6008,0,2,5
1714,3,3,6009,6009,6012,0,3,1
1715,5,2,6014,6014,6016,0,2,2
1716,3,3,6017,6017,6020,0,3,1
1717,1,2,6018,6020,6022,2,4,0
1718,2,1,6020,6022,6023,2,3,0
1719,5,1,6025,6025,6026,0,1,2
1720,1,1,6026,6026,6027,0,1,0
1721,3,1,6029,6029,6030,0,1,2
1722,6,2,6035,6035,6037,0,2,5
1723,3,3,6038,6038,6041,0,3,1
1724,5,2,6043,6043,6045,0,2,2
1725,1,2,6044,6045,6047,1,3,0
1726,5,3,6049,6049,6052,0,3,2
1727,3,1,6052,6052,6053,0,1,0
1728,2,2,6054,6054,6056,0,2,1
1729,5,3,6059,6059,6062,0,3,3
1730,3,2,6062,6062,6064,0,2,0
1731,4,3,6066,6066,6069,0,3,2
1732,6,3,6072,6072,6075,0,3,3
1733,3,1,6075,6075,6076,0,1,0
1734,3,3,6078,6078,6081,0,3,2
1735,2,1,6080,6081,6082,1,2,0
1736,1,2,6081,6082,6084,1,3,0
1737,3,2,6084,6084,6086,0,2,0
1738,6,2,6090,6090,6092,0,2,4
1739,1,3,6091,6092,6095,1,4,0
1740,1,2,6092,6095,6097,3,5,0
1741,4,3,6096,6097,6100,1,4,0
1742,5,2,6101,6101,6103,0,2,1
1743,5,1,6106,6106,6107,0,1,3
1744,5,3,6111,6111,6114,0,3,4
1745,4,1,6115,6115,6116,0,1,1
1746,4,2,6119,6119,6121,0,2,3
1747,6,3,6125,6125,6128,0,3,4
1748,6,1,6131,6131,6132,0,1,3
1749,1,2,6132,6132,6134,0,2,0
1750,3,2,6135,6135,6137,0,2,1
1751,6,1,6141,6141,6142,0,1,4
1752,1,3,6142,6142,6145,0,3,0
1753,2,2,6144,6145,6147,1,3,0
1754,1,2,6145,6147,6149,2,4,0
1755,5,3,6150,6150,6153,0,3,1
1756,6,2,6156,6156,6158,0,2,3
1757,6,2,6162,6162,6164,0,2,4
1758,1,2,6163,6164,6166,1,3,0
1759,5,2,6168,6168,6170,0,2,2
1760,4,1,6172,6172,6173,0,1,2
1761,1,2,6173,6173,6175,0,2,0
1762,4,2,6177,6177,6179,0,2,2
1763,1,3,6178,6179,6182,1,4,0
1764,3,1,6181,6182,6183,1,2,0
1765,1,3,6182,6183,6186,1,4,0
1766,6,3,6188,6188,6191,0,3,2
1767,4,1,6192,6192,6193,0,1,1
1768,5,1,6197,6197,6198,0,1,4
1769,5,1,6202,6202,6203,0,1,4
1770,2,1,6204,6204,6205,0,1,1
1771,2,2,6206,6206,6208,0,2,1
1772,3,1,6209,6209,6210,0,1,1
1773,3,3,6212,6212,6215,0,3,2
1774,3,3,6215,6215,6218,0,3,0
1775,2,1,6217,6218,6219,1,2,0
1776,6,1,6223,6223,6224,0,1,4
1777,4,3,6227,6227,6230,0,3,3
1778,4,3,6231,6231,6234,0,3,1
1779,1,2,6232,6234,6236,2,4,0
1780,1,3,6233,6236,6239,3,6,0
1781,2,3,6235,6239,6242,4,7,0
1782,5,2,6240,6242,6244,2,4,0
1783,1,2,6241,6244,6246,3,5,0
1784,5,2,6246,6246,6248,0,2,0
1785,1,2,6247,6248,6250,1,3,0
1786,4,3,6251,6251,6254,0,3,1
1787,4,2,6255,6255,6257,0,2,1
1788,5,2,6260,6260,6262,0,2,3
1789,5,1,6265,6265,6266,0,1,3
1790,1,2,6266,6266,6268,0,2,0
1791,3,3,6269,6269,6272,0,3,1
1792,6,3,6275,6275,6278,0,3,3
1793,2,2,6277,6278,6280,1,3,0
1794,2,2,6279,6280,6282,1,3,0
1795,1,2,6280,6282,6284,2,4,0
1796,3,1,6283,6284,6285,1,2,0
1797,4,1,6287,6287,6288,0,1,2
1798,1,1,6288,6288,6289,0,1,0
1799,4,3,6292,6292,6295,0,3,3
1800,5,1,6297,6297,6298,0,1,2
1801,4,3,6301,6301,6304,0,3,3
1802,1,2,6302,6304,6306,2,4,0
1803,4,2,6306,6306,6308,0,2,0
1804,4,3,6310,6310,6313,0,3,2
1805,1,2,6311,6313,6315,2,4,0
1806,1,3,6312,6315,6318,3,6,0
1807,2,1,6314,6318,6319,4,5,0
1808,3,1,6317,6319,6320,2,3,0
1809,2,2,6319,6320,6322,1,3,0
1810,6,1,6325,6325,6326,0,1,3
1811,1,1,6326,6326,6327,0,1,0
1812,5,1,6331,6331,6332,0,1,4
1813,3,2,6334,6334,6336,0,2,2
1814,1,3,6335,6336,6339,1,4,0
1815,6,2,6341,6341,6343,0,2,2
1816,6,2,6347,6347,6349,0,2,4
1817,1,3,6348,6349,6352,1,4,0
1818,4,3,6352,6352,6355,0,3,0
1819,3,3,6355,6355,6358,0,3,0
1820,4,1,6359,6359,6360,0,1,1
1821,1,3,6360,6360,6363,0,3,0
1822,6,2,6366,6366,6368,0,2,3
1823,3,2,6369,6369,6371,0,2,1
1824,3,1,6372,6372,6373,0,1,1
1825,6,1,6378,6378,6379,0,1,5
1826,2,1,6380,6380,6381,0,1,1
1827,4,1,6384,6384,6385,0,1,3
1828,5,1,6389,6389,6390,0,1,4
1829,2,3,6391,6391,6394,0,3,1
1830,1,2,6392,6394,6396,2,4,0
1831,6,3,6398,6398,6401,0,3,2
1832,1,1,6399,6401,6402,2,3,0
1833,2,2,6401,6402,6404,1,3,0
1834,6,2,6407,6407,6409,0,2,3
1835,3,1,6410,6410,6411,0,1,1
1836,2,2,6412,6412,6414,0,2,1
1837,4,1,6416,6416,6417,0,1,2
1838,6,3,6422,6422,6425,0,3,5
1839,5,3,6427,6427,6430,0,3,2
1840,3,2,6430,6430,6432,0,2,0
1841,3,1,6433,6433,6434,0,1,1
1842,6,1,6439,6439,6440,0,1,5
1843,4,2,6443,6443,6445,0,2,3
1844,2,1,6445,6445,6446,0,1,0
1845,2,2,6447,6447,6449,0,2,1
1846,1,3,6448,6449,6452,1,4,0
1847,4,3,6452,6452,6455,0,3,0
1848,6,3,6458,6458,6461,0,3,3
1849,2,3,6460,6461,6464,1,4,0
1850,5,1,6465,6465,6466,0,1,1
1851,6,2,6471,6471,6473,0,2,5
1852,1,1,6472,6473,6474,1,2,0
1853,6,2,6478,6478,6480,0,2,4
1854,2,1,6480,6480,6481,0,1,0
1855,2,2,6482,6482,6484,0,2,1
1856,4,3,6486,6486,6489,0,3,2
1857,4,3,6490,6490,6493,0,3,1
1858,6,3,6496,6496,6499,0,3,3
1859,2,2,6498,6499,6501,1,3,0
1860,2,2,6500,6501,6503,1,3,0
1861,4,3,6504,6504,6507,0,3,1
1862,6,1,6510,6510,6511,0,1,3
1863,5,3,6515,6515,6518,0,3,4
1864,3,3,6518,6518,6521,0,3,0
1865,6,3,6524,6524,6527,0,3,3
1866,5,1,6529,6529,6530,0,1,2
1867,6,1,6535,6535,6536,0,1,5
1868,5,2,6540,6540,6542,0,2,4
1869,4,1,6544,6544,6545,0,1,2
1870,1,1,6545,6545,6546,0,1,0
1871,1,1,6546,6546,6547,0,1,0
1872,6,2,6552,6552,6554,0,2,5
1873,2,3,6554,6554,6557,0,3,0
1874,2,2,6556,6557,6559,1,3,0
1875,6,2,6562,6562,6564,0,2,3
1876,5,2,6567,6567,6569,0,2,3
1877,5,2,6572,6572,6574,0,2,3
1878,3,1,6575,6575,6576,0,1,1
1879,5,1,6580,6580,6581,0,1,4
1880,5,1,6585,6585,6586,0,1,4
1881,4,2,6589,6589,6591,0,2,3
1882,4,3,6593,6593,6596,0,3,2
1883,4,2,6597,6597,6599,0,2,1
1884,6,3,6603,6603,6606,0,3,4
1885,2,3,6605,6606,6609,1,4,0
1886,6,1,6611,6611,6612,0,1,2
1887,3,1,6614,6614,6615,0,1,2
1888,3,1,6617,6617,6618,0,1,2
1889,1,2,6618,6618,6620,0,2,0
1890,5,3,6623,6623,6626,0,3,3
1891,2,1,6625,6626,6627,1,2,0
1892,4,1,6629,6629,6630,0,1,2
1893,4,1,6633,6633,6634,0,1,3
1894,6,3,6639,6639,6642,0,3,5
1895,4,3,6643,6643,6646,0,3,1
1896,5,1,6648,6648,6649,0,1,2
1897,1,2,6649,6649,6651,0,2,0
1898,2,3,6651,6651,6654,0,3,0
1899,2,2,6653,6654,6656,1,3,0
1900,6,2,6659,6659,6661,0,2,3
1901,3,1,6662,6662,6663,0,1,1
1902,5,3,6667,6667,6670,0,3,4
1903,5,3,6672,6672,6675,0,3,2
1904,5,1,6677,6677,6678,0,1,2
1905,1,2,6678,6678,6680,0,2,0
1906,4,3,6682,6682,6685,0,3,2
1907,6,1,6688,6688,6689,0,1,3
1908,6,3,6694,6694,6697,0,3,5
1909,2,1,6696,6697,6698,1,2,0
1910,6,2,6702,6702,6704,0,2,4
1911,2,3,6704,6704,6707,0,3,0
1912,2,2,6706,6707,6709,1,3,0
1913,6,2,6712,6712,6714,0,2,3
1914,2,3,6714,6714,6717,0,3,0
1915,2,1,6716,6717,6718,1,2,0
1916,4,1,6720,6720,6721,0,1,2
1917,1,2,6721,6721,6723,0,2,0
1918,5,2,6726,6726,6728,0,2,3
1919,4,2,6730,6730,6732,0,2,2
1920,1,1,6731,6732,6733,1,2,0
1921,5,1,6736,6736,6737,0,1,3
1922,6,3,6742,6742,6745,0,3,5
1923,2,1,6744,6745,6746,1,2,0
1924,6,3,6750,6750,6753,0,3,4
1925,5,1,6755,6755,6756,0,1,2
1926,4,3,6759,6759,6762,0,3,3
1927,1,2,6760,6762,6764,2,4,0
1928,5,1,6765,6765,6766,0,1,1
1929,4,1,6769,6769,6770,0,1,3
1930,3,2,6772,6772,6774,0,2,2
1931,1,2,6773,6774,6776,1,3,0
1932,4,2,6777,6777,6779,0,2,1
1933,5,2,6782,6782,6784,0,2,3
1934,1,1,6783,6784,6785,1,2,0
1935,4,3,6787,6787,6790,0,3,2
1936,6,1,6793,6793,6794,0,1,3
1937,3,1,6796,6796,6797,0,1,2
1938,6,3,6802,6802,6805,0,3,5
1939,4,3,6806,6806,6809,0,3,1
1940,5,3,6811,6811,6814,0,3,2
1941,2,2,6813,6814,6816,1,3,0
1942,3,3,6816,6816,6819,0,3,0
1943,5,2,6821,6821,6823,0,2,2
1944,1,3,6822,6823,6826,1,4,0
1945,3,3,6825,6826,6829,1,4,0
1946,1,3,6826,6829,6832,3,6,0
1947,6,1,6832,6832,6833,0,1,0
1948,5,3,6837,6837,6840,0,3,4
1949,6,2,6843,6843,6845,0,2,3
1950,6,1,6849,6849,6850,0,1,4
1951,1,3,6850,6850,6853,0,3,0
1952,5,2,6855,6855,6857,0,2,2
1953,1,2,6856,6857,6859,1,3,0
1954,2,2,6858,6859,6861,1,3,0
1955,3,3,6861,6861,6864,0,3,0
1956,4,1,6865,6865,6866,0,1,1
1957,4,2,6869,6869,6871,0,2,3
1958,2,2,6871,6871,6873,0,2,0
1959,2,2,6873,6873,6875,0,2,0
1960,4,3,6877,6877,6880,0,3,2
1961,2,2,6879,6880,6882,1,3,0
1962,2,2,6881,6882,6884,1,3,0
1963,2,2,6883,6884,6886,1,3,0
1964,6,3,6889,6889,6892,0,3,3
1965,6,3,6895,6895,6898,0,3,3
1966,4,3,6899,6899,6902,0,3,1
1967,6,2,6905,6905,6907,0,2,3
1968,3,1,6908,6908,6909,0,1,1
1969,1,2,6909,6909,6911,0,2,0
1970,6,1,6915,6915,6916,0,1,4
1971,1,3,6916,6916,6919,0,3,0
1972,6,1,6922,6922,6923,0,1,3
1973,3,1,6925,6925,6926,0,1,2
1974,1,2,6926,6926,6928,0,2,0
1975,3,1,6929,6929,6930,0,1,1
1976,3,3,6932,6932,6935,0,3,2
1977,1,1,6933,6935,6936,2,3,0
1978,6,3,6939,6939,6942,0,3,3
1979,4,1,6943,6943,6944,0,1,1
1980,3,3,6946,6946,6949,0,3,2
1981,3,2,6949,6949,6951,0,2,0
1982,5,3,6954,6954,6957,0,3,3
1983,1,2,6955,6957,6959,2,4,0
1984,2,3,6957,6959,6962,2,5,0
1985,6,3,6963,6963,6966,0,3,1
1986,3,3,6966,6966,6969,0,3,0
1987,5,1,6971,6971,6972,0,1,2
1988,4,1,6975,6975,6976,0,1,3
1989,3,3,6978,6978,6981,0,3,2
1990,1,1,6979,6981,6982,2,3,0
1991,6,3,6985,6985,6988,0,3,3
1992,2,3,6987,6988,6991,1,4,0
1993,6,1,6993,6993,6994,0,1,2
1994,6,1,6999,6999,7000,0,1,5
1995,1,3,7000,7000,7003,0,3,0
1996,6,2,7006,7006,7008,0,2,3
1997,5,2,7011,7011,7013,0,2,3
1998,6,2,7017,7017,7019,0,2,4
1999,2,2,7019,7019,7021,0,2,0
2000,5,2,7024,7024,7026,0,2,3
2001,4,1,7028,7028,7029,0,1,2
2002,6,3,7034,7034,7037,0,3,5
2003,2,3,7036,7037,7040,1,4,0
2004,4,2,7040,7040,7042,0,2,0
2005,5,3,7045,7045,7048,0,3,3
2006,4,3,7049,7049,7052,0,3,1
2007,3,1,7052,7052,7053,0,1,0
2008,6,2,7058,7058,7060,0,2,5
2009,6,1,7064,7064,7065,0,1,4
2010,4,3,7068,7068,7071,0,3,3
2011,6,2,7074,7074,7076,0,2,3
2012,3,3,7077,7077,7080,0,3,1
2013,4,2,7081,7081,7083,0,2,1
2014,5,1,7086,7086,7087,0,1,3
2015,3,1,7089,7089,7090,0,1,2
2016,4,3,7093,7093,7096,0,3,3
2017,4,2,7097,7097,7099,0,2,1
2018,2,2,7099,7099,7101,0,2,0
2019,5,2,7104,7104,7106,0,2,3
2020,2,1,7106,7106,7107,0,1,0
2021,3,3,7109,7109,7112,0,3,2
2022,2,2,7111,7112,7114,1,3,0
2023,5,3,7116,7116,7119,0,3,2
2024,2,2,7118,7119,7121,1,3,0
2025,1,2,7119,7121,7123,2,4,0
2026,2,1,7121,7123,7124,2,3,0
2027,4,1,7125,7125,7126,0,1,1
2028,6,3,7131,7131,7134,0,3,5
2029,3,2,7134,7134,7136,0,2,0
2030,2,1,7136,7136,7137,0,1,0
2031,4,2,7140,7140,7142,0,2,3
2032,6,1,7146,7146,7147,0,1,4
2033,4,1,7150,7150,7151,0,1,3
2034,5,2,7155,7155,7157,0,2,4
2035,1,1,7156,7157,7158,1,2,0
2036,6,3,7162,7162,7165,0,3,4
2037,4,1,7166,7166,7167,0,1,1
2038,5,2,7171,7171,7173,0,2,4
2039,2,1,7173,7173,7174,0,1,0
2040,5,2,7178,7178,7180,0,2,4
2041,4,2,7182,7182,7184,0,2,2
2042,5,2,7187,7187,7189,0,2,3
2043,3,3,7190,7190,7193,0,3,1
2044,3,2,7193,7193,7195,0,2,0
2045,3,2,7196,7196,7198,0,2,1
2046,3,3,7199,7199,7202,0,3,1
2047,6,2,7205,7205,7207,0,2,3
2048,4,1,7209,7209,7210,0,1,2
2049,4,2,7213,7213,7215,0,2,3
2050,4,3,7217,7217,7220,0,3,2
2051,2,1,7219,7220,7221,1,2,0
2052,2,1,7221,7221,7222,0,1,0
2053,3,3,7224,7224,7227,0,3,2
2054,4,2,7228,7228,7230,0,2,1
2055,5,3,7233,7233,7236,0,3,3
2056,2,1,7235,7236,7237,1,2,0
2057,4,2,7239,7239,7241,0,2,2
2058,3,2,7242,7242,7244,0,2,1
2059,4,1,7246,7246,7247,0,1,2
2060,2,2,7248,7248,7250,0,2,1
2061,4,3,7252,7252,7255,0,3,2
2062,1,2,7253,7255,7257,2,4,0
2063,1,3,7254,7257,7260,3,6,0
2064,1,1,7255,7260,7261,5,6,0
2065,6,1,7261,7261,7262,0,1,0
2066,2,1,7263,7263,7264,0,1,1
2067,3,3,7266,7266,7269,0,3,2
2068,4,1,7270,7270,7271,0,1,1
2069,5,2,7275,7275,7277,0,2,4
2070,4,3,7279,7279,7282,0,3,2
2071,2,3,7281,7282,7285,1,4,0
2072,2,3,7283,7285,7288,2,5,0
2073,2,2,7285,7288,7290,3,5,0
2074,1,2,7286,7290,7292,4,6,0
2075,2,3,7288,7292,7295,4,7,0
2076,2,2,7290,7295,7297,5,7,0
2077,5,1,7295,7297,7298,2,3,0
2078,6,1,7301,7301,7302,0,1,3
2079,6,1,7307,7307,7308,0,1,5
2080,5,2,7312,7312,7314,0,2,4
2081,6,2,7318,7318,7320,0,2,4
2082,6,2,7324,7324,7326,0,2,4
2083,3,1,7327,7327,7328,0,1,1
2084,5,3,7332,7332,7335,0,3,4
2085,3,3,7335,7335,7338,0,3,0
2086,1,1,7336,7338,7339,2,3,0
2087,3,2,7339,7339,7341,0,2,0
2088,1,1,7340,7341,7342,1,2,0
2089,4,3,7344,7344,7347,0,3,2
2090,1,1,7345,7347,7348,2,3,0
2091,5,3,7350,7350,7353,0,3,2
2092,3,3,7353,7353,7356,0,3,0
2093,2,3,7355,7356,7359,1,4,0
2094,5,1,7360,7360,7361,0,1,1
2095,2,3,7362,7362,7365,0,3,1
2096,4,1,7366,7366,7367,0,1,1
2097,2,3,7368,7368,7371,0,3,1
2098,3,1,7371,7371,7372,0,1,0
2099,1,3,7372,7372,7375,0,3,0
2100,3,3,7375,7375,7378,0,3,0
2101,5,2,7380,7380,7382,0,2,2
2102,3,3,7383,7383,7386,0,3,1
2103,3,3,7386,7386,7389,0,3,0
2104,3,2,7389,7389,7391,0,2,0
2105,2,3,7391,7391,7394,0,3,0
2106,6,1,7397,7397,7398,0,1,3
2107,1,1,7398,7398,7399,0,1,0
2108,6,2,7404,7404,7406,0,2,5
2109,4,1,7408,7408,7409,0,1,2
2110,1,2,7409,7409,7411,0,2,0
2111,6,2,7415,7415,7417,0,2,4
2112,1,2,7416,7417,7419,1,3,0
2113,1,2,7417,7419,7421,2,4,0
2114,4,2,7421,7421,7423,0,2,0
2115,6,1,7427,7427,7428,0,1,4
2116,5,1,7432,7432,7433,0,1,4
2117,4,2,7436,7436,7438,0,2,3
2118,2,3,7438,7438,7441,0,3,0
2119,3,2,7441,7441,7443,0,2,0
2120,5,2,7446,7446,7448,0,2,3
2121,2,1,7448,7448,7449,0,1,0
2122,2,2,7450,7450,7452,0,2,1
2123,4,2,7454,7454,7456,0,2,2
2124,6,2,7460,7460,7462,0,2,4
2125,6,3,7466,7466,7469,0,3,4
2126,5,1,7471,7471,7472,0,1,2
2127,5,2,7476,7476,7478,0,2,4
2128,6,1,7482,7482,7483,0,1,4
2129,3,1,7485,7485,7486,0,1,2
2130,1,2,7486,7486,7488,0,2,0
2131,5,2,7491,7491,7493,0,2,3
2132,5,3,7496,7496,7499,0,3,3
2133,1,2,7497,7499,7501,2,4,0
2134,2,2,7499,7501,7503,2,4,0
2135,1,2,7500,7503,7505,3,5,0
2136,6,2,7506,7506,7508,0,2,1
2137,1,2,7507,7508,7510,1,3,0
2138,2,3,7509,7510,7513,1,4,0
2139,2,1,7511,7513,7514,2,3,0
2140,6,2,7517,7517,7519,0,2,3
2141,2,2,7519,7519,7521,0,2,0
2142,3,3,7522,7522,7525,0,3,1
2143,4,1,7526,7526,7527,0,1,1
2144,2,3,7528,7528,7531,0,3,1
2145,6,3,7534,7534,7537,0,3,3
2146,3,2,7537,7537,7539,0,2,0
2147,5,1,7542,7542,7543,0,1,3
2148,2,1,7544,7544,7545,0,1,1
2149,2,3,7546,7546,7549,0,3,1
2150,5,3,7551,7551,7554,0,3,2
2151,1,2,7552,7554,7556,2,4,0
2152,6,3,7558,7558,7561,0,3,2
2153,2,1,7560,7561,7562,1,2,0
2154,6,2,7566,7566,7568,0,2,4
2155,6,3,7572,7572,7575,0,3,4
2156,6,2,7578,7578,7580,0,2,3
2157,6,1,7584,7584,7585,0,1,4
2158,6,2,7590,7590,7592,0,2,5
2159,2,2,7592,7592,7594,0,2,0
2160,1,2,7593,7594,7596,1,3,0
2161,5,1,7598,7598,7599,0,1,2
2162,6,1,7604,7604,7605,0,1,5
2163,2,2,7606,7606,7608,0,2,1
2164,4,2,7610,7610,7612,0,2,2
2165,6,2,7616,7616,7618,0,2,4
2166,2,2,7618,7618,7620,0,2,0
2167,5,2,7623,7623,7625,0,2,3
2168,6,2,7629,7629,7631,0,2,4
2169,1,1,7630,7631,7632,1,2,0
2170,5,2,7635,7635,7637,0,2,3
2171,6,2,7641,7641,7643,0,2,4
2172,3,2,7644,7644,7646,0,2,1
2173,2,1,7646,7646,7647,0,1,0
2174,4,1,7650,7650,7651,0,1,3
2175,1,3,7651,7651,7654,0,3,0
2176,4,1,7655,7655,7656,0,1,1
2177,4,1,7659,7659,7660,0,1,3
2178,2,3,7661,7661,7664,0,3,1
2179,2,2,7663,7664,7666,1,3,0
2180,1,3,7664,7666,7669,2,5,0
2181,4,1,7668,7669,7670,1,2,0
2182,2,3,7670,7670,7673,0,3,0
2183,4,3,7674,7674,7677,0,3,1
2184,5,2,7679,7679,7681,0,2,2
2185,4,3,7683,7683,7686,0,3,2
2186,1,2,7684,7686,7688,2,4,0
2187,3,3,7687,7688,7691,1,4,0
2188,5,1,7692,7692,7693,0,1,1
2189,2,1,7694,7694,7695,0,1,1
2190,1,1,7695,7695,7696,0,1,0
2191,3,3,7698,7698,7701,0,3,2
2192,1,3,7699,7701,7704,2,5,0
2193,6,3,7705,7705,7708,0,3,1
2194,2,3,7707,7708,7711,1,4,0
2195,5,1,7712,7712,7713,0,1,1
2196,3,1,7715,7715,7716,0,1,2
2197,4,2,7719,7719,7721,0,2,3
2198,3,2,7722,7722,7724,0,2,1
2199,3,3,7725,7725,7728,0,3,1
2200,1,3,7726,7728,7731,2,5,0
2201,2,3,7728,7731,7734,3,6,0
2202,5,2,7733,7734,7736,1,3,0
2203,4,3,7737,7737,7740,0,3,1
2204,4,3,7741,7741,7744,0,3,1
2205,2,3,7743,7744,7747,1,4,0
2206,6,2,7749,7749,7751,0,2,2
2207,3,2,7752,7752,7754,0,2,1
2208,4,3,7756,7756,7759,0,3,2
2209,3,2,7759,7759,7761,0,2,0
2210,5,2,7764,7764,7766,0,2,3
2211,1,1,7765,7766,7767,1,2,0
2212,3,2,7768,7768,7770,0,2,1
2213,1,1,7769,7770,7771,1,2,0
2214,5,2,7774,7774,7776,0,2,3
2215,3,3,7777,7777,7780,0,3,1
2216,4,2,7781,7781,7783,0,2,1
2217,6,1,7787,7787,7788,0,1,4
2218,6,3,7793,7793,7796,0,3,5
2219,1,2,7794,7796,7798,2,4,0
2220,5,3,7799,7799,7802,0,3,1
2221,5,3,7804,7804,7807,0,3,2
2222,1,3,7805,7807,7810,2,5,0
2223,5,1,7810,7810,7811,0,1,0
2224,1,2,7811,7811,7813,0,2,0
2225,1,2,7812,7813,7815,1,3,0
2226,4,2,7816,7816,7818,0,2,1
2227,6,1,7822,7822,7823,0,1,4
2228,6,3,7828,7828,7831,0,3,5
2229,6,1,7834,7834,7835,0,1,3
2230,4,1,7838,7838,7839,0,1,3
2231,3,2,7841,7841,7843,0,2,2
2232,4,2,7845,7845,7847,0,2,2
2233,2,3,7847,7847,7850,0,3,0
2234,4,2,7851,7851,7853,0,2,1
2235,1,1,7852,7853,7854,1,2,0
2236,5,1,7857,7857,7858,0,1,3
2237,5,3,7862,7862,7865,0,3,4
2238,5,2,7867,7867,7869,0,2,2
2239,1,1,7868,7869,7870,1,2,0
2240,2,2,7870,7870,7872,0,2,0
2241,2,2,7872,7872,7874,0,2,0
2242,2,3,7874,7874,7877,0,3,0
2243,2,1,7876,7877,7878,1,2,0
2244,2,3,7878,7878,7881,0,3,0
2245,5,2,7883,7883,7885,0,2,2
2246,5,2,7888,7888,7890,0,2,3
2247,5,2,7893,7893,7895,0,2,3
2248,4,2,7897,7897,7899,0,2,2
2249,4,2,7901,7901,7903,0,2,2
2250,6,3,7907,7907,7910,0,3,4
2251,1,3,7908,7910,7913,2,5,0
2252,4,3,7912,7913,7916,1,4,0
2253,3,1,7915,7916,7917,1,2,0
2254,1,3,7916,7917,7920,1,4,0
2255,4,3,7920,7920,7923,0,3,0
2256,1,3,7921,7923,7926,2,5,0
2257,6,1,7927,7927,7928,0,1,1
2258,5,3,7932,7932,7935,0,3,4
2259,4,3,7936,7936,7939,0,3,1
2260,4,3,7940,7940,7943,0,3,1
2261,5,3,7945,7945,7948,0,3,2
2262,4,2,7949,7949,7951,0,2,1
2263,1,1,7950,7951,7952,1,2,0
2264,5,3,7955,7955,7958,0,3,3
2265,4,2,7959,7959,7961,0,2,1
2266,3,1,7962,7962,7963,0,1,1
2267,1,2,7963,7963,7965,0,2,0
2268,5,3,7968,7968,7971,0,3,3
2269,5,3,7973,7973,7976,0,3,2
2270,1,3,7974,7976,7979,2,5,0
2271,1,2,7975,7979,7981,4,6,0
2272,2,2,7977,7981,7983,4,6,0
2273,6,2,7983,7983,7985,0,2,0
2274,4,1,7987,7987,7988,0,1,2
2275,5,3,7992,7992,7995,0,3,4
2276,1,1,7993,7995,7996,2,3,0
2277,5,3,7998,7998,8001,0,3,2
2278,2,1,8000,8001,8002,1,2,0
2279,1,2,8001,8002,8004,1,3,0
2280,4,2,8005,8005,8007,0,2,1
2281,4,2,8009,8009,8011,0,2,2
2282,5,3,8014,8014,8017,0,3,3
2283,5,3,8019,8019,8022,0,3,2
2284,4,2,8023,8023,8025,0,2,1
2285,1,3,8024,8025,8028,1,4,0
2286,6,2,8030,8030,8032,0,2,2
2287,4,3,8034,8034,8037,0,3,2
2288,5,2,8039,8039,8041,0,2,2
2289,6,3,8045,8045,8048,0,3,4
2290,4,1,8049,8049,8050,0,1,1
2291,2,3,8051,8051,8054,0,3,1
2292,6,1,8057,8057,8058,0,1,3
2293,6,2,8063,8063,8065,0,2,5
2294,4,1,8067,8067,8068,0,1,2
2295,5,2,8072,8072,8074,0,2,4
2296,6,2,8078,8078,8080,0,2,4
2297,6,3,8084,8084,8087,0,3,4
2298,3,1,8087,8087,8088,0,1,0
2299,3,3,8090,8090,8093,0,3,2
2300,6,1,8096,8096,8097,0,1,3
2301,4,2,8100,8100,8102,0,2,3
2302,4,1,8104,8104,8105,0,1,2
2303,5,1,8109,8109,8110,0,1,4
2304,1,3,8110,8110,8113,0,3,0
2305,4,3,8114,8114,8117,0,3,1
2306,4,2,8118,8118,8120,0,2,1
2307,2,1,8120,8120,8121,0,1,0
2308,6,2,8126,8126,8128,0,2,5
2309,2,3,8128,8128,8131,0,3,0
2310,3,1,8131,8131,8132,0,1,0
2311,1,2,8132,8132,8134,0,2,0
2312,6,3,8138,8138,8141,0,3,4
2313,5,1,8143,8143,8144,0,1,2
2314,6,2,8149,8149,8151,0,2,5
2315,5,3,8154,8154,8157,0,3,3
2316,2,1,8156,8157,8158,1,2,0
2317,6,2,8162,8162,8164,0,2,4
2318,4,3,8166,8166,8169,0,3,2
2319,2,3,8168,8169,8172,1,4,0
2320,3,3,8171,8172,8175,1,4,0
2321,6,1,8177,8177,8178,0,1,2
2322,2,3,8179,8179,8182,0,3,1
2323,5,1,8184,8184,8185,0,1,2
2324,4,1,8188,8188,8189,0,1,3
2325,5,1,8193,8193,8194,0,1,4
2326,2,1,8195,8195,8196,0,1,1
2327,5,1,8200,8200,8201,0,1,4
2328,5,1,8205,8205,8206,0,1,4
2329,5,1,8210,8210,8211,0,1,4
2330,2,1,8212,8212,8213,0,1,1
2331,2,3,8214,8214,8217,0,3,1
2332,4,3,8218,8218,8221,0,3,1
2333,1,3,8219,8221,8224,2,5,0
2334,6,3,8225,8225,8228,0,3,1
2335,6,3,8231,8231,8234,0,3,3
2336,3,2,8234,8234,8236,0,2,0
2337,1,2,8235,8236,8238,1,3,0
2338,6,1,8241,8241,8242,0,1,3
2339,4,1,8245,8245,8246,0,1,3
2340,4,1,8249,8249,8250,0,1,3
2341,6,1,8255,8255,8256,0,1,5
2342,3,3,8258,8258,8261,0,3,2
2343,4,3,8262,8262,8265,0,3,1
2344,2,2,8264,8265,8267,1,3,0
2345,5,1,8269,8269,8270,0,1,2
2346,4,2,8273,8273,8275,0,2,3
2347,5,1,8278,8278,8279,0,1,3
2348,3,2,8281,8281,8283,0,2,2
2349,2,3,8283,8283,8286,0,3,0
2350,1,2,8284,8286,8288,2,4,0
2351,2,1,8286,8288,8289,2,3,0
2352,1,3,8287,8289,8292,2,5,0
2353,5,2,8292,8292,8294,0,2,0
2354,6,2,8298,8298,8300,0,2,4
2355,1,1,8299,8300,8301,1,2,0
2356,3,1,8302,8302,8303,0,1,1
2357,2,3,8304,8304,8307,0,3,1
2358,3,2,8307,8307,8309,0,2,0
2359,5,2,8312,8312,8314,0,2,3
2360,3,2,8315,8315,8317,0,2,1
2361,2,2,8317,8317,8319,0,2,0
2362,5,1,8322,8322,8323,0,1,3
2363,5,1,8327,8327,8328,0,1,4
2364,1,1,8328,8328,8329,0,1,0
2365,5,1,8333,8333,8334,0,1,4
2366,6,1,8339,8339,8340,0,1,5
2367,5,1,8344,8344,8345,0,1,4
2368,5,3,8349,8349,8352,0,3,4
2369,5,1,8354,8354,8355,0,1,2
2370,5,3,8359,8359,8362,0,3,4
2371,2,3,8361,8362,8365,1,4,0
2372,1,1,8362,8365,8366,3,4,0
2373,1,3,8363,8366,8369,3,6,0
2374,6,3,8369,8369,8372,0,3,0
2375,4,1,8373,8373,8374,0,1,1
2376,6,3,8379,8379,8382,0,3,5
2377,2,3,8381,8382,8385,1,4,0
2378,4,3,8385,8385,8388,0,3,0
2379,6,2,8391,8391,8393,0,2,3
2380,3,2,8394,8394,8396,0,2,1
2381,3,2,8397,8397,8399,0,2,1
2382,3,1,8400,8400,8401,0,1,1
2383,1,1,8401,8401,8402,0,1,0
2384,3,1,8404,8404,8405,0,1,2
2385,1,3,8405,8405,8408,0,3,0
2386,4,2,8409,8409,8411,0,2,1
2387,3,3,8412,8412,8415,0,3,1
2388,4,3,8416,8416,8419,0,3,1
2389,4,2,8420,8420,8422,0,2,1
2390,4,2,8424,8424,8426,0,2,2
2391,6,3,8430,8430,8433,0,3,4
2392,4,2,8434,8434,8436,0,2,1
2393,2,3,8436,8436,8439,0,3,0
2394,3,1,8439,8439,8440,0,1,0
2395,4,3,8443,8443,8446,0,3,3
2396,6,3,8449,8449,8452,0,3,3
2397,1,1,8450,8452,8453,2,3,0
2398,1,3,8451,8453,8456,2,5,0
2399,6,1,8457,8457,8458,0,1,1
2400,2,3,8459,8459,8462,0,3,1
2401,1,2,8460,8462,8464,2,4,0
2402,5,2,8465,8465,8467,0,2,1
2403,3,3,8468,8468,8471,0,3,1
2404,5,1,8473,8473,8474,0,1,2
2405,4,2,8477,8477,8479,0,2,3
2406,6,1,8483,8483,8484,0,1,4
2407,3,2,8486,8486,8488,0,2,2
2408,1,2,8487,8488,8490,1,3,0
2409,6,1,8493,8493,8494,0,1,3
2410,4,1,8497,8497,8498,0,1,3
2411,5,3,8502,8502,8505,0,3,4
2412,1,1,8503,8505,8506,2,3,0
2413,2,3,8505,8506,8509,1,4,0
2414,4,3,8509,8509,8512,0,3,0
2415,3,3,8512,8512,8515,0,3,0
2416,1,3,8513,8515,8518,2,5,0
2417,5,2,8518,8518,8520,0,2,0
2418,3,1,8521,8521,8522,0,1,1
2419,5,1,8526,8526,8527,0,1,4
2420,1,2,8527,8527,8529,0,2,0
2421,5,1,8532,8532,8533,0,1,3
2422,1,3,8533,8533,8536,0,3,0
2423,1,1,8534,8536,8537,2,3,0
2424,3,2,8537,8537,8539,0,2,0
2425,5,3,8542,8542,8545,0,3,3
2426,5,2,8547,8547,8549,0,2,2
2427,5,2,8552,8552,8554,0,2,3
2428,3,2,8555,8555,8557,0,2,1
2429,4,1,8559,8559,8560,0,1,2
2430,1,1,8560,8560,8561,0,1,0
2431,5,2,8565,8565,8567,0,2,4
2432,6,1,8571,8571,8572,0,1,4
2433,5,1,8576,8576,8577,0,1,4
2434,1,1,8577,8577,8578,0,1,0
2435,5,2,8582,8582,8584,0,2,4
2436,1,2,8583,8584,8586,1,3,0
2437,1,1,8584,8586,8587,2,3,0
2438,3,3,8587,8587,8590,0,3,0
2439,6,3,8593,8593,8596,0,3,3
2440,4,1,8597,8597,8598,0,1,1
2441,1,1,8598,8598,8599,0,1,0
2442,3,1,8601,8601,8602,0,1,2
2443,2,3,8603,8603,8606,0,3,1
2444,4,2,8607,8607,8609,0,2,1
2445,5,2,8612,8612,8614,0,2,3
2446,3,2,8615,8615,8617,0,2,1
2447,6,1,8621,8621,8622,0,1,4
2448,6,3,8627,8627,8630,0,3,5
2449,6,1,8633,8633,8634,0,1,3
2450,6,2,8639,8639,8641,0,2,5
2451,2,3,8641,8641,8644,0,3,0
2452,2,2,8643,8644,8646,1,3,0
2453,5,3,8648,8648,8651,0,3,2
2454,3,2,8651,8651,8653,0,2,0
2455,5,1,8656,8656,8657,0,1,3
2456,3,3,8659,8659,8662,0,3,2
2457,6,3,8665,8665,8668,0,3,3
2458,6,2,8671,8671,8673,0,2,3
2459,5,1,8676,8676,8677,0,1,3
2460,1,3,8677,8677,8680,0,3,0
2461,1,2,8678,8680,8682,2,4,0
2462,3,2,8681,8682,8684,1,3,0
2463,4,1,8685,8685,8686,0,1,1
2464,4,1,8689,8689,8690,0,1,3
2465,6,1,8695,8695,8696,0,1,5
2466,2,3,8697,8697,8700,0,3,1
2467,4,1,8701,8701,8702,0,1,1
2468,6,2,8707,8707,8709,0,2,5
2469,3,3,8710,8710,8713,0,3,1
2470,4,3,8714,8714,8717,0,3,1
2471,1,1,8715,8717,8718,2,3,0
2472,2,3,8717,8718,8721,1,4,0
2473,4,1,8721,8721,8722,0,1,0
2474,2,1,8723,8723,8724,0,1,1
2475,2,1,8725,8725,8726,0,1,1
2476,6,1,8731,8731,8732,0,1,5
2477,3,1,8734,8734,8735,0,1,2
2478,2,1,8736,8736,8737,0,1,1
2479,3,2,8739,8739,8741,0,2,2
2480,3,2,8742,8742,8744,0,2,1
2481,2,3,8744,8744,8747,0,3,0
2482,5,2,8749,8749,8751,0,2,2
2483,1,1,8750,8751,8752,1,2,0
2484,2,1,8752,8752,8753,0,1,0
2485,3,3,8755,8755,8758,0,3,2
2486,3,1,8758,8758,8759,0,1,0
2487,5,3,8763,8763,8766,0,3,4
2488,5,2,8768,8768,8770,0,2,2
2489,4,2,8772,8772,8774,0,2,2
2490,5,1,8777,8777,8778,0,1,3
2491,1,3,8778,8778,8781,0,3,0
2492,2,2,8780,8781,8783,1,3,0
2493,3,2,8783,8783,8785,0,2,0
2494,4,1,8787,8787,8788,0,1,2
2495,2,3,8789,8789,8792,0,3,1
2496,4,2,8793,8793,8795,0,2,1
2497,2,3,8795,8795,8798,0,3,0
2498,1,1,8796,8798,8799,2,3,0
2499,3,3,8799,8799,8802,0,3,0
2500,1,1,8800,8802,8803,2,3,0
2501,5,3,8805,8805,8808,0,3,2
2502,4,3,8809,8809,8812,0,3,1
2503,2,1,8811,8812,8813,1,2,0
2504,4,2,8815,8815,8817,0,2,2
2505,3,3,8818,8818,8821,0,3,1
2506,1,3,8819,8821,8824,2,5,0
2507,4,1,8823,8824,8825,1,2,0
2508,4,3,8827,8827,8830,0,3,2
2509,4,2,8831,8831,8833,0,2,1
2510,4,2,8835,8835,8837,0,2,2
2511,3,3,8838,8838,8841,0,3,1
2512,6,2,8844,8844,8846,0,2,3
2513,5,3,8849,8849,8852,0,3,3
2514,3,1,8852,8852,8853,0,1,0
2515,5,3,8857,8857,8860,0,3,4
2516,6,1,8863,8863,8864,0,1,3
2517,3,3,8866,8866,8869,0,3,2
2518,4,2,8870,8870,8872,0,2,1
2519,6,3,8876,8876,8879,0,3,4
2520,6,2,8882,8882,8884,0,2,3
2521,6,1,8888,8888,8889,0,1,4
2522,5,2,8893,8893,8895,0,2,4
2523,5,2,8898,8898,8900,0,2,3
2524,3,2,8901,8901,8903,0,2,1
2525,5,2,8906,8906,8908,0,2,3
2526,5,2,8911,8911,8913,0,2,3
2527,4,3,8915,8915,8918,0,3,2
2528,5,2,8920,8920,8922,0,2,2
2529,6,1,8926,8926,8927,0,1,4
2530,4,2,8930,8930,8932,0,2,3
2531,6,3,8936,8936,8939,0,3,4
2532,2,3,8938,8939,8942,1,4,0
2533,5,2,8943,8943,8945,0,2,1
2534,1,2,8944,8945,8947,1,3,0
2535,1,2,8945,8947,8949,2,4,0
2536,4,3,8949,8949,8952,0,3,0
2537,5,2,8954,8954,8956,0,2,2
2538,3,3,8957,8957,8960,0,3,1
2539,5,2,8962,8962,8964,0,2,2
2540,1,1,8963,8964,8965,1,2,0
2541,4,1,8967,8967,8968,0,1,2
2542,1,2,8968,8968,8970,0,2,0
2543,3,1,8971,8971,8972,0,1,1
2544,4,3,8975,8975,8978,0,3,3
2545,5,1,8980,8980,8981,0,1,2
2546,1,2,8981,8981,8983,0,2,0
2547,3,2,8984,8984,8986,0,2,1
2548,6,1,8990,8990,8991,0,1,4
2549,5,3,8995,8995,8998,0,3,4
2550,2,3,8997,8998,9001,1,4,0
2551,5,2,9002,9002,9004,0,2,1
2552,6,3,9008,9008,9011,0,3,4
2553,2,3,9010,9011,9014,1,4,0
2554,1,1,9011,9014,9015,3,4,0
2555,3,2,9014,9015,9017,1,3,0
2556,3,3,9017,9017,9020,0,3,0
2557,4,1,9021,9021,9022,0,1,1
2558,5,1,9026,9026,9027,0,1,4
2559,3,3,9029,9029,9032,0,3,2
2560,4,2,9033,9033,9035,0,2,1
2561,3,1,9036,9036,9037,0,1,1
2562,4,1,9040,9040,9041,0,1,3
2563,3,3,9043,9043,9046,0,3,2
2564,4,1,9047,9047,9048,0,1,1
2565,4,2,9051,9051,9053,0,2,3
2566,3,2,9054,9054,9056,0,2,1
2567,2,1,9056,9056,9057,0,1,0
2568,2,2,9058,9058,9060,0,2,1
2569,3,2,9061,9061,9063,0,2,1
2570,1,1,9062,9063,9064,1,2,0
2571,2,1,9064,9064,9065,0,1,0
2572,2,1,9066,9066,9067,0,1,1
2573,3,3,9069,9069,9072,0,3,2
2574,2,1,9071,9072,9073,1,2,0
2575,1,1,9072,9073,9074,1,2,0
2576,1,2,9073,9074,9076,1,3,0
2577,5,3,9078,9078,9081,0,3,2
2578,2,3,9080,9081,9084,1,4,0
2579,3,1,9083,9084,9085,1,2,0
2580,3,3,9086,9086,9089,0,3,1
2581,6,1,9092,9092,9093,0,1,3
2582,3,1,9095,9095,9096,0,1,2
2583,3,1,9098,9098,9099,0,1,2
2584,3,2,9101,9101,9103,0,2,2
2585,5,1,9106,9106,9107,0,1,3
2586,5,1,9111,9111,9112,0,1,4
2587,6,3,9117,9117,9120,0,3,5
2588,4,3,9121,9121,9124,0,3,1
2589,5,3,9126,9126,9129,0,3,2
2590,3,1,9129,9129,9130,0,1,0
2591,3,3,9132,9132,9135,0,3,2
2592,3,1,9135,9135,9136,0,1,0
2593,4,3,9139,9139,9142,0,3,3
2594,5,2,9144,9144,9146,0,2,2
2595,6,2,9150,9150,9152,0,2,4
2596,4,1,9154,9154,9155,0,1,2
2597,6,2,9160,9160,9162,0,2,5
2598,2,3,9162,9162,9165,0,3,0
2599,4,2,9166,9166,9168,0,2,1
2600,6,3,9172,9172,9175,0,3,4
2601,2,2,9174,9175,9177,1,3,0
2602,2,1,9176,9177,9178,1,2,0
2603,2,1,9178,9178,9179,0,1,0
2604,6,3,9184,9184,9187,0,3,5
2605,3,3,9187,9187,9190,0,3,0
2606,5,2,9192,9192,9194,0,2,2
2607,6,3,9198,9198,9201,0,3,4
2608,1,2,9199,9201,9203,2,4,0
2609,3,3,9202,9203,9206,1,4,0
2610,2,2,9204,9206,9208,2,4,0
2611,3,3,9207,9208,9211,1,4,0
2612,6,2,9213,9213,9215,0,2,2
2613,2,1,9215,9215,9216,0,1,0
2614,3,3,9218,9218,9221,0,3,2
2615,4,3,9222,9222,9225,0,3,1
2616,4,2,9226,9226,9228,0,2,1
2617,3,3,9229,9229,9232,0,3,1
2618,1,3,9230,9232,9235,2,5,0
2619,1,3,9231,9235,9238,4,7,0
2620,6,2,9237,9238,9240,1,3,0
2621,4,2,9241,9241,9243,0,2,1
2622,5,1,9246,9246,9247,0,1,3
2623,5,2,9251,9251,9253,0,2,4
2624,2,2,9253,9253,9255,0,2,0
2625,5,3,9258,9258,9261,0,3,3
2626,2,2,9260,9261,9263,1,3,0
2627,2,3,9262,9263,9266,1,4,0
2628,3,1,9265,9266,9267,1,2,0
2629,3,3,9268,9268,9271,0,3,1
2630,6,1,9274,9274,9275,0,1,3
2631,3,2,9277,9277,9279,0,2,2
2632,1,3,9278,9279,9282,1,4,0
2633,6,1,9284,9284,9285,0,1,2
2634,3,2,9287,9287,9289,0,2,2
2635,2,1,9289,9289,9290,0,1,0
2636,3,2,9292,9292,9294,0,2,2
2637,3,3,9295,9295,9298,0,3,1
2638,6,1,9301,9301,9302,0,1,3
2639,5,3,9306,9306,9309,0,3,4
2640,4,3,9310,9310,9313,0,3,1
2641,3,1,9313,9313,9314,0,1,0
2642,4,1,9317,9317,9318,0,1,3
2643,3,1,9320,9320,9321,0,1,2
2644,4,2,9324,9324,9326,0,2,3
2645,2,3,9326,9326,9329,0,3,0
2646,1,2,9327,9329,9331,2,4,0
2647,3,3,9330,9331,9334,1,4,0
2648,2,3,9332,9334,9337,2,5,0
2649,5,1,9337,9337,9338,0,1,0
2650,3,3,9340,9340,9343,0,3,2
2651,3,1,9343,9343,9344,0,1,0
2652,1,2,9344,9344,9346,0,2,0
2653,5,2,9349,9349,9351,0,2,3
2654,6,3,9355,9355,9358,0,3,4
2655,4,1,9359,9359,9360,0,1,1
2656,2,1,9361,9361,9362,0,1,1
2657,4,3,9365,9365,9368,0,3,3
2658,6,3,9371,9371,9374,0,3,3
2659,6,1,9377,9377,9378,0,1,3
2660,4,2,9381,9381,9383,0,2,3
2661,5,1,9386,9386,9387,0,1,3
2662,1,3,9387,9387,9390,0,3,0
2663,4,3,9391,9391,9394,0,3,1
2664,5,3,9396,9396,9399,0,3,2
2665,5,2,9401,9401,9403,0,2,2
2666,4,2,9405,9405,9407,0,2,2
2667,4,1,9409,9409,9410,0,1,2
2668,4,1,9413,9413,9414,0,1,3
2669,1,3,9414,9414,9417,0,3,0
2670,5,1,9419,9419,9420,0,1,2
2671,4,3,9423,9423,9426,0,3,3
2672,3,3,9426,9426,9429,0,3,0
2673,3,2,9429,9429,9431,0,2,0
2674,6,3,9435,9435,9438,0,3,4
2675,1,2,9436,9438,9440,2,4,0
2676,2,3,9438,9440,9443,2,5,0
2677,3,3,9441,9443,9446,2,5,0
2678,3,2,9444,9446,9448,2,4,0
2679,3,1,9447,9448,9449,1,2,0
2680,1,2,9448,9449,9451,1,3,0
2681,3,1,9451,9451,9452,0,1,0
2682,1,1,9452,9452,9453,0,1,0
2683,2,3,9454,9454,9457,0,3,1
2684,4,2,9458,9458,9460,0,2,1
2685,2,3,9460,9460,9463,0,3,0
2686,6,1,9466,9466,9467,0,1,3
2687,5,3,9471,9471,9474,0,3,4
2688,1,3,9472,9474,9477,2,5,0
2689,1,1,9473,9477,9478,4,5,0
2690,5,3,9478,9478,9481,0,3,0
2691,4,3,9482,9482,9485,0,3,1
2692,3,3,9485,9485,9488,0,3,0
2693,6,3,9491,9491,9494,0,3,3
2694,1,3,9492,9494,9497,2,5,0
2695,6,3,9498,9498,9501,0,3,1
2696,3,3,9501,9501,9504,0,3,0
2697,3,2,9504,9504,9506,0,2,0
2698,2,1,9506,9506,9507,0,1,0
2699,4,3,9510,9510,9513,0,3,3
2700,2,3,9512,9513,9516,1,4,0
2701,2,2,9514,9516,9518,2,4,0
2702,6,2,9520,9520,9522,0,2,2
2703,6,1,9526,9526,9527,0,1,4
2704,4,2,9530,9530,9532,0,2,3
2705,6,1,9536,9536,9537,0,1,4
2706,5,3,9541,9541,9544,0,3,4
2707,5,1,9546,9546,9547,0,1,2
2708,5,2,9551,9551,9553,0,2,4
2709,4,1,9555,9555,9556,0,1,2
2710,3,1,9558,9558,9559,0,1,2
2711,6,2,9564,9564,9566,0,2,5
2712,6,2,9570,9570,9572,0,2,4
2713,3,2,9573,9573,9575,0,2,1
2714,3,2,9576,9576,9578,0,2,1
2715,1,3,9577,9578,9581,1,4,0
2716,4,1,9581,9581,9582,0,1,0
2717,1,3,9582,9582,9585,0,3,0
2718,6,1,9588,9588,9589,0,1,3
2719,2,2,9590,9590,9592,0,2,1
2720,1,3,9591,9592,9595,1,4,0
2721,1,2,9592,9595,9597,3,5,0
2722,3,1,9595,9597,9598,2,3,0
2723,5,3,9600,9600,9603,0,3,2
2724,3,1,9603,9603,9604,0,1,0
2725,6,3,9609,9609,9612,0,3,5
2726,6,2,9615,9615,9617,0,2,3
2727,2,2,9617,9617,9619,0,2,0
2728,2,1,9619,9619,9620,0,1,0
2729,1,2,9620,9620,9622,0,2,0
2730,2,2,9622,9622,9624,0,2,0
2731,4,2,9626,9626,9628,0,2,2
2732,2,3,9628,9628,9631,0,3,0
2733,4,1,9632,9632,9633,0,1,1
2734,5,2,9637,9637,9639,0,2,4
2735,4,1,9641,9641,9642,0,1,2
2736,1,1,9642,9642,9643,0,1,0
2737,6,2,9648,9648,9650,0,2,5
2738,2,1,9650,9650,9651,0,1,0
2739,2,2,9652,9652,9654,0,2,1
2740,4,1,9656,9656,9657,0,1,2
2741,3,3,9659,9659,9662,0,3,2
2742,5,3,9664,9664,9667,0,3,2
2743,6,1,9670,9670,9671,0,1,3
2744,3,2,9673,9673,9675,0,2,2
2745,1,1,9674,9675,9676,1,2,0
2746,6,3,9680,9680,9683,0,3,4
2747,5,3,9685,9685,9688,0,3,2
2748,5,3,9690,9690,9693,0,3,2
2749,5,1,9695,9695,9696,0,1,2
2750,4,3,9699,9699,9702,0,3,3
2751,6,3,9705,9705,9708,0,3,3
2752,4,2,9709,9709,9711,0,2,1
2753,2,2,9711,9711,9713,0,2,0
2754,5,2,9716,9716,9718,0,2,3
2755,1,3,9717,9718,9721,1,4,0
2756,2,2,9719,9721,9723,2,4,0
2757,1,1,9720,9723,9724,3,4,0
2758,2,2,9722,9724,9726,2,4,0
2759,1,2,9723,9726,9728,3,5,0
2760,5,3,9728,9728,9731,0,3,0
2761,3,1,9731,9731,9732,0,1,0
2762,1,1,9732,9732,9733,0,1,0
2763,2,1,9734,9734,9735,0,1,1
2764,5,2,9739,9739,9741,0,2,4
2765,6,2,9745,9745,9747,0,2,4
2766,3,1,9748,9748,9749,0,1,1
2767,4,1,9752,9752,9753,0,1,3
2768,5,1,9757,9757,9758,0,1,4
2769,4,1,9761,9761,9762,0,1,3
2770,2,1,9763,9763,9764,0,1,1
2771,2,2,9765,9765,9767,0,2,1
2772,1,1,9766,9767,9768,1,2,0
2773,4,1,9770,9770,9771,0,1,2
2774,4,3,9774,9774,9777,0,3,3
2775,3,3,9777,9777,9780,0,3,0
2776,5,2,9782,9782,9784,0,2,2
2777,6,1,9788,9788,9789,0,1,4
2778,6,2,9794,9794,9796,0,2,5
2779,1,2,9795,9796,9798,1,3,0
2780,5,2,9800,9800,9802,0,2,2
2781,6,2,9806,9806,9808,0,2,4
2782,6,3,9812,9812,9815,0,3,4
2783,1,2,9813,9815,9817,2,4,0
2784,5,2,9818,9818,9820,0,2,1
2785,3,2,9821,9821,9823,0,2,1
2786,1,1,9822,9823,9824,1,2,0
2787,4,3,9826,9826,9829,0,3,2
2788,6,2,9832,9832,9834,0,2,3
2789,5,3,9837,9837,9840,0,3,3
2790,1,3,9838,9840,9843,2,5,0
2791,1,1,9839,9843,9844,4,5,0
2792,6,2,9845,9845,9847,0,2,1
2793,6,3,9851,9851,9854,0,3,4
2794,1,2,9852,9854,9856,2,4,0
2795,5,3,9857,9857,9860,0,3,1
2796,4,1,9861,9861,9862,0,1,1
2797,3,2,9864,9864,9866,0,2,2
2798,1,2,9865,9866,9868,1,3,0
2799,2,1,9867,9868,9869,1,2,0
2800,5,3,9872,9872,9875,0,3,3
2801,2,3,9874,9875,9878,1,4,0
2802,6,2,9880,9880,9882,0,2,2
2803,1,2,9881,9882,9884,1,3,0
2804,1,2,9882,9884,9886,2,4,0
2805,4,1,9886,9886,9887,0,1,0
2806,2,2,9888,9888,9890,0,2,1
2807,1,1,9889,9890,9891,1,2,0
2808,3,3,9892,9892,9895,0,3,1
2809,3,3,9895,9895,9898,0,3,0
2810,3,2,9898,9898,9900,0,2,0
2811,1,1,9899,9900,9901,1,2,0
2812,2,3,9901,9901,9904,0,3,0
2813,6,2,9907,9907,9909,0,2,3
2814,4,3,9911,9911,9914,0,3,2
2815,6,1,9917,9917,9918,0,1,3
2816,5,1,9922,9922,9923,0,1,4
2817,4,1,9926,9926,9927,0,1,3
2818,6,1,9932,9932,9933,0,1,5
2819,3,2,9935,9935,9937,0,2,2
2820,2,3,9937,9937,9940,0,3,0
2821,2,1,9939,9940,9941,1,2,0
2822,5,3,9944,9944,9947,0,3,3
2823,6,2,9950,9950,9952,0,2,3
2824,3,1,9953,9953,9954,0,1,1
2825,4,1,9957,9957,9958,0,1,3
2826,3,1,9960,9960,9961,0,1,2
2827,6,2,9966,9966,9968,0,2,5
2828,4,2,9970,9970,9972,0,2,2
2829,3,1,9973,9973,9974,0,1,1
2830,2,2,9975,9975,9977,0,2,1
2831,5,2,9980,9980,9982,0,2,3
2832,6,2,9986,9986,9988,0,2,4
2833,1,1,9987,9988,9989,1,2,0
2834,2,1,9989,9989,9990,0,1,0
2835,4,1,9993,9993,9994,0,1,3
2836,5,1,9998,9998,9999,0,1,4
2837,5,1,10003,10003,10004,0,1,4
2838,4,1,10007,10007,10008,0,1,3
2839,5,1,10012,10012,10013,0,1,4
2840,2,3,10014,10014,10017,0,3,1
2841,1,2,10015,10017,10019,2,4,0
2842,5,2,10020,10020,10022,0,2,1
2843,1,3,10021,10022,10025,1,4,0
2844,4,2,10025,10025,10027,0,2,0
2845,1,1,10026,10027,10028,1,2,0
2846,5,1,10031,10031,10032,0,1,3
2847,1,3,10032,10032,10035,0,3,0
2848,3,2,10035,10035,10037,0,2,0
2849,6,1,10041,10041,10042,0,1,4
2850,3,1,10044,10044,10045,0,1,2
2851,5,2,10049,10049,10051,0,2,4
2852,4,1,10053,10053,10054,0,1,2
2853,1,2,10054,10054,10056,0,2,0
2854,2,2,10056,10056,10058,0,2,0
2855,5,3,10061,10061,10064,0,3,3
2856,6,3,10067,10067,10070,0,3,3
2857,5,2,10072,10072,10074,0,2,2
2858,3,1,10075,10075,10076,0,1,1
2859,2,2,10077,10077,10079,0,2,1
2860,2,1,10079,10079,10080,0,1,0
2861,1,2,10080,10080,10082,0,2,0
2862,6,1,10086,10086,10087,0,1,4
2863,5,1,10091,10091,10092,0,1,4
2864,6,3,10097,10097,10100,0,3,5
2865,5,3,10102,10102,10105,0,3,2
2866,4,2,10106,10106,10108,0,2,1
2867,1,3,10107,10108,10111,1,4,0
2868,6,2,10113,10113,10115,0,2,2
2869,4,3,10117,10117,10120,0,3,2
2870,4,2,10121,10121,10123,0,2,1
2871,4,1,10125,10125,10126,0,1,2
2872,4,2,10129,10129,10131,0,2,3
2873,1,3,10130,10131,10134,1,4,0
2874,5,1,10135,10135,10136,0,1,1
2875,4,3,10139,10139,10142,0,3,3
2876,1,1,10140,10142,10143,2,3,0
2877,3,3,10143,10143,10146,0,3,0
2878,2,1,10145,10146,10147,1,2,0
2879,4,1,10149,10149,10150,0,1,2
2880,3,2,10152,10152,10154,0,2,2
2881,5,3,10157,10157,10160,0,3,3
2882,1,1,10158,10160,10161,2,3,0
2883,4,3,10162,10162,10165,0,3,1
2884,3,2,10165,10165,10167,0,2,0
2885,3,1,10168,10168,10169,0,1,1
2886,3,1,10171,10171,10172,0,1,2
2887,4,2,10175,10175,10177,0,2,3
2888,3,2,10178,10178,10180,0,2,1
2889,2,3,10180,10180,10183,0,3,0
2890,3,3,10183,10183,10186,0,3,0
2891,6,2,10189,10189,10191,0,2,3
2892,6,3,10195,10195,10198,0,3,4
2893,4,1,10199,10199,10200,0,1,1
2894,5,2,10204,10204,10206,0,2,4
2895,5,1,10209,10209,10210,0,1,3
2896,6,1,10215,10215,10216,0,1,5
2897,5,2,10220,10220,10222,0,2,4
2898,6,3,10226,10226,10229,0,3,4
2899,4,3,10230,10230,10233,0,3,1
2900,4,3,10234,10234,10237,0,3,1
2901,2,3,10236,10237,10240,1,4,0
2902,2,2,10238,10240,10242,2,4,0
2903,1,3,10239,10242,10245,3,6,0
2904,5,3,10244,10245,10248,1,4,0
2905,2,1,10246,10248,10249,2,3,0
2906,5,1,10251,10251,10252,0,1,2
2907,6,1,10257,10257,10258,0,1,5
2908,5,1,10262,10262,10263,0,1,4
2909,5,1,10267,10267,10268,0,1,4
2910,4,3,10271,10271,10274,0,3,3
2911,3,2,10274,10274,10276,0,2,0
2912,3,2,10277,10277,10279,0,2,1
2913,1,2,10278,10279,10281,1,3,0
2914,1,2,10279,10281,10283,2,4,0
2915,5,3,10284,10284,10287,0,3,1
2916,3,1,10287,10287,10288,0,1,0
2917,6,3,10293,10293,10296,0,3,5
2918,6,1,10299,10299,10300,0,1,3
2919,3,3,10302,10302,10305,0,3,2
2920,3,3,10305,10305,10308,0,3,0
2921,3,1,10308,10308,10309,0,1,0
2922,6,3,10314,10314,10317,0,3,5
2923,1,1,10315,10317,10318,2,3,0
2924,4,2,10319,10319,10321,0,2,1
2925,4,2,10323,10323,10325,0,2,2
2926,2,2,10325,10325,10327,0,2,0
2927,6,1,10331,10331,10332,0,1,4
2928,5,1,10336,10336,10337,0,1,4
2929,5,2,10341,10341,10343,0,2,4
2930,2,3,10343,10343,10346,0,3,0
2931,6,1,10349,10349,10350,0,1,3
2932,6,3,10355,10355,10358,0,3,5
2933,1,2,10356,10358,10360,2,4,0
2934,5,1,10361,10361,10362,0,1,1
2935,1,3,10362,10362,10365,0,3,0
2936,5,3,10367,10367,10370,0,3,2
2937,4,1,10371,10371,10372,0,1,1
2938,6,1,10377,10377,10378,0,1,5
2939,4,2,10381,10381,10383,0,2,3
2940,3,1,10384,10384,10385,0,1,1
2941,4,3,10388,10388,10391,0,3,3
2942,5,1,10393,10393,10394,0,1,2
2943,5,2,10398,10398,10400,0,2,4
2944,6,3,10404,10404,10407,0,3,4
2945,4,1,10408,10408,10409,0,1,1
2946,3,2,10411,10411,10413,0,2,2
2947,2,3,10413,10413,10416,0,3,0
2948,6,3,10419,10419,10422,0,3,3
2949,1,3,10420,10422,10425,2,5,0
2950,2,3,10422,10425,10428,3,6,0
2951,2,2,10424,10428,10430,4,6,0
2952,3,1,10427,10430,10431,3,4,0
2953,6,3,10433,10433,10436,0,3,2
2954,1,2,10434,10436,10438,2,4,0
2955,3,3,10437,10438,10441,1,4,0
2956,3,3,10440,10441,10444,1,4,0
2957,2,1,10442,10444,10445,2,3,0
2958,4,1,10446,10446,10447,0,1,1
2959,1,2,10447,10447,10449,0,2,0
2960,4,3,10451,10451,10454,0,3,2
2961,3,1,10454,10454,10455,0,1,0
2962,1,3,10455,10455,10458,0,3,0
2963,4,2,10459,10459,10461,0,2,1
2964,2,1,10461,10461,10462,0,1,0
2965,1,1,10462,10462,10463,0,1,0
2966,4,2,10466,10466,10468,0,2,3
2967,6,3,10472,10472,10475,0,3,4
2968,5,2,10477,10477,10479,0,2,2
2969,6,1,10483,10483,10484,0,1,4
2970,3,1,10486,10486,10487,0,1,2
2971,5,3,10491,10491,10494,0,3,4
2972,5,2,10496,10496,10498,0,2,2
2973,1,1,10497,10498,10499,1,2,0
2974,4,2,10501,10501,10503,0,2,2
2975,1,2,10502,10503,10505,1,3,0
2976,1,2,10503,10505,10507,2,4,0
2977,6,3,10509,10509,10512,0,3,2
2978,3,2,10512,10512,10514,0,2,0
2979,4,2,10516,10516,10518,0,2,2
2980,6,2,10522,10522,10524,0,2,4
2981,5,1,10527,10527,10528,0,1,3
2982,2,3,10529,10529,10532,0,3,1
2983,3,3,10532,10532,10535,0,3,0
2984,6,2,10538,10538,10540,0,2,3
2985,1,2,10539,10540,10542,1,3,0
2986,1,1,10540,10542,10543,2,3,0
2987,2,2,10542,10543,10545,1,3,0
2988,3,3,10545,10545,10548,0,3,0
2989,2,3,10547,10548,10551,1,4,0
2990,3,3,10550,10551,10554,1,4,0
2991,6,2,10556,10556,10558,0,2,2
2992,2,1,10558,10558,10559,0,1,0
2993,3,2,10561,10561,10563,0,2,2
2994,2,1,10563,10563,10564,0,1,0
2995,4,1,10567,10567,10568,0,1,3
2996,5,3,10572,10572,10575,0,3,4
2997,3,3,10575,10575,10578,0,3,0
2998,3,3,10578,10578,10581,0,3,0
2999,2,1,10580,10581,10582,1,2,0
3000,2,3,10582,10582,10585,0,3,0
3001,2,3,10584,10585,10588,1,4,0
3002,2,1,10586,10588,10589,2,3,0
3003,2,1,10588,10589,10590,1,2,0
3004,5,3,10593,10593,10596,0,3,3
3005,4,1,10597,10597,10598,0,1,1
3006,1,3,10598,10598,10601,0,3,0
3007,5,3,10603,10603,10606,0,3,2
3008,3,1,10606,10606,10607,0,1,0
3009,1,3,10607,10607,10610,0,3,0
3010,2,1,10609,10610,10611,1,2,0
3011,5,2,10614,10614,10616,0,2,3
3012,6,2,10620,10620,10622,0,2,4
3013,2,2,10622,10622,10624,0,2,0
3014,6,2,10628,10628,10630,0,2,4
3015,3,2,10631,10631,10633,0,2,1
3016,2,2,10633,10633,10635,0,2,0
3017,5,1,10638,10638,10639,0,1,3
3018,2,2,10640,10640,10642,0,2,1
3019,1,2,10641,10642,10644,1,3,0
3020,3,2,10644,10644,10646,0,2,0
3021,4,1,10648,10648,10649,0,1,2
3022,1,2,10649,10649,10651,0,2,0
3023,3,1,10652,10652,10653,0,1,1
3024,2,1,10654,10654,10655,0,1,1
3025,6,3,10660,10660,10663,0,3,5
3026,4,1,10664,10664,10665,0,1,1
3027,3,2,10667,10667,10669,0,2,2
3028,6,3,10673,10673,10676,0,3,4
3029,4,2,10677,10677,10679,0,2,1
3030,1,1,10678,10679,10680,1,2,0
3031,4,1,10682,10682,10683,0,1,2
3032,5,3,10687,10687,10690,0,3,4
3033,5,1,10692,10692,10693,0,1,2
3034,5,2,10697,10697,10699,0,2,4
3035,4,3,10701,10701,10704,0,3,2
3036,6,1,10707,10707,10708,0,1,3
3037,6,1,10713,10713,10714,0,1,5
3038,4,1,10717,10717,10718,0,1,3
3039,2,2,10719,10719,10721,0,2,1
3040,3,2,10722,10722,10724,0,2,1
3041,5,1,10727,10727,10728,0,1,3
3042,3,3,10730,10730,10733,0,3,2
3043,5,1,10735,10735,10736,0,1,2
3044,4,3,10739,10739,10742,0,3,3
3045,4,1,10743,10743,10744,0,1,1
3046,1,1,10744,10744,10745,0,1,0
3047,2,1,10746,10746,10747,0,1,1
3048,6,3,10752,10752,10755,0,3,5
3049,6,2,10758,10758,10760,0,2,3
3050,4,1,10762,10762,10763,0,1,2
3051,3,1,10765,10765,10766,0,1,2
3052,5,1,10770,10770,10771,0,1,4
3053,3,1,10773,10773,10774,0,1,2
3054,6,2,10779,10779,10781,0,2,5
3055,5,1,10784,10784,10785,0,1,3
3056,5,2,10789,10789,10791,0,2,4
3057,5,1,10794,10794,10795,0,1,3
3058,4,3,10798,10798,10801,0,3,3
3059,3,1,10801,10801,10802,0,1,0
3060,3,2,10804,10804,10806,0,2,2
3061,3,2,10807,10807,10809,0,2,1
3062,3,3,10810,10810,10813,0,3,1
3063,6,2,10816,10816,10818,0,2,3
3064,2,1,10818,10818,10819,0,1,0
3065,6,1,10824,10824,10825,0,1,5
3066,1,2,10825,10825,10827,0,2,0
3067,2,1,10827,10827,10828,0,1,0
3068,2,2,10829,10829,10831,0,2,1
3069,6,2,10835,10835,10837,0,2,4
3070,4,3,10839,10839,10842,0,3,2
3071,4,1,10843,10843,10844,0,1,1
3072,6,3,10849,10849,10852,0,3,5
3073,3,1,10852,10852,10853,0,1,0
3074,3,2,10855,10855,10857,0,2,2
3075,4,1,10859,10859,10860,0,1,2
3076,5,1,10864,10864,10865,0,1,4
3077,6,3,10870,10870,10873,0,3,5
3078,1,1,10871,10873,10874,2,3,0
3079,4,3,10875,10875,10878,0,3,1
3080,5,1,10880,10880,10881,0,1,2
3081,2,3,10882,10882,10885,0,3,1
3082,1,3,10883,10885,10888,2,5,0
3083,3,1,10886,10888,10889,2,3,0
3084,2,2,10888,10889,10891,1,3,0
3085,1,1,10889,10891,10892,2,3,0
3086,2,3,10891,10892,10895,1,4,0
3087,2,3,10893,10895,10898,2,5,0
3088,5,2,10898,10898,10900,0,2,0
3089,3,2,10901,10901,10903,0,2,1
3090,1,3,10902,10903,10906,1,4,0
3091,6,1,10908,10908,10909,0,1,2
3092,4,3,10912,10912,10915,0,3,3
3093,4,3,10916,10916,10919,0,3,1
3094,5,2,10921,10921,10923,0,2,2
3095,2,1,10923,10923,10924,0,1,0
3096,6,1,10929,10929,10930,0,1,5
3097,1,1,10930,10930,10931,0,1,0
3098,3,2,10933,10933,10935,0,2,2
3099,4,2,10937,10937,10939,0,2,2
3100,3,3,10940,10940,10943,0,3,1
3101,6,1,10946,10946,10947,0,1,3
3102,2,3,10948,10948,10951,0,3,1
3103,1,3,10949,10951,10954,2,5,0
3104,3,1,10952,10954,10955,2,3,0
3105,6,1,10958,10958,10959,0,1,3
3106,5,1,10963,10963,10964,0,1,4
3107,1,2,10964,10964,10966,0,2,0
3108,3,3,10967,10967,10970,0,3,1
3109,6,2,10973,10973,10975,0,2,3
3110,3,2,10976,10976,10978,0,2,1
3111,3,3,10979,10979,10982,0,3,1
3112,4,2,10983,10983,10985,0,2,1
3113,5,3,10988,10988,10991,0,3,3
3114,6,1,10994,10994,10995,0,1,3
3115,1,1,10995,10995,10996,0,1,0
3116,2,1,10997,10997,10998,0,1,1
3117,3,1,11000,11000,11001,0,1,2
3118,4,2,11004,11004,11006,0,2,3
3119,4,1,11008,11008,11009,0,1,2
3120,6,3,11014,11014,11017,0,3,5
3121,5,3,11019,11019,11022,0,3,2
3122,6,3,11025,11025,11028,0,3,3
3123,4,2,11029,11029,11031,0,2,1
3124,2,3,11031,11031,11034,0,3,0
3125,1,3,11032,11034,11037,2,5,0
3126,6,3,11038,11038,11041,0,3,1
3127,2,1,11040,11041,11042,1,2,0
3128,1,1,11041,11042,11043,1,2,0
3129,4,3,11045,11045,11048,0,3,2
3130,1,3,11046,11048,11051,2,5,0
3131,4,2,11050,11051,11053,1,3,0
3132,3,3,11053,11053,11056,0,3,0
3133,6,3,11059,11059,11062,0,3,3
3134,1,2,11060,11062,11064,2,4,0
3135,4,3,11064,11064,11067,0,3,0
3136,2,2,11066,11067,11069,1,3,0
3137,3,1,11069,11069,11070,0,1,0
3138,3,3,11072,11072,11075,0,3,2
3139,6,3,11078,11078,11081,0,3,3
3140,4,3,11082,11082,11085,0,3,1
3141,2,3,11084,11085,11088,1,4,0
3142,2,1,11086,11088,11089,2,3,0
3143,3,1,11089,11089,11090,0,1,0
3144,2,3,11091,11091,11094,0,3,1
3145,5,2,11096,11096,11098,0,2,2
3146,2,3,11098,11098,11101,0,3,0
3147,1,1,11099,11101,11102,2,3,0
3148,4,3,11103,11103,11106,0,3,1
3149,1,3,11104,11106,11109,2,5,0
3150,2,1,11106,11109,11110,3,4,0
3151,5,2,11111,11111,11113,0,2,1
3152,2,1,11113,11113,11114,0,1,0
3153,2,1,11115,11115,11116,0,1,1
3154,3,1,11118,11118,11119,0,1,2
3155,4,2,11122,11122,11124,0,2,3
3156,3,2,11125,11125,11127,0,2,1
3157,5,1,11130,11130,11131,0,1,3
3158,5,3,11135,11135,11138,0,3,4
3159,6,1,11141,11141,11142,0,1,3
3160,2,3,11143,11143,11146,0,3,1
3161,6,1,11149,11149,11150,0,1,3
3162,1,2,11150,11150,11152,0,2,0
3163,5,3,11155,11155,11158,0,3,3
3164,1,1,11156,11158,11159,2,3,0
3165,1,3,11157,11159,11162,2,5,0
3166,6,1,11163,11163,11164,0,1,1
3167,5,3,11168,11168,11171,0,3,4
3168,4,1,11172,11172,11173,0,1,1
3169,5,1,11177,11177,11178,0,1,4
3170,6,3,11183,11183,11186,0,3,5
3171,5,3,11188,11188,11191,0,3,2
3172,3,2,11191,11191,11193,0,2,0
3173,6,2,11197,11197,11199,0,2,4
3174,6,3,11203,11203,11206,0,3,4
3175,2,2,11205,11206,11208,1,3,0
3176,2,2,11207,11208,11210,1,3,0
3177,2,3,11209,11210,11213,1,4,0
3178,2,1,11211,11213,11214,2,3,0
3179,6,3,11217,11217,11220,0,3,3
3180,2,2,11219,11220,11222,1,3,0
3181,4,1,11223,11223,11224,0,1,1
3182,6,3,11229,11229,11232,0,3,5
3183,4,1,11233,11233,11234,0,1,1
3184,1,3,11234,11234,11237,0,3,0
3185,1,3,11235,11237,11240,2,5,0
3186,4,2,11239,11240,11242,1,3,0
3187,6,1,11245,11245,11246,0,1,3
3188,2,3,11247,11247,11250,0,3,1
3189,1,3,11248,11250,11253,2,5,0
3190,1,2,11249,11253,11255,4,6,0
3191,3,1,11252,11255,11256,3,4,0
3192,2,2,11254,11256,11258,2,4,0
3193,5,1,11259,11259,11260,0,1,1
3194,6,1,11265,11265,11266,0,1,5
3195,3,1,11268,11268,11269,0,1,2
3196,4,2,11272,11272,11274,0,2,3
3197,2,1,11274,11274,11275,0,1,0
3198,3,2,11277,11277,11279,0,2,2
3199,4,1,11281,11281,11282,0,1,2
3200,1,2,11282,11282,11284,0,2,0
3201,5,1,11287,11287,11288,0,1,3
3202,1,2,11288,11288,11290,0,2,0
3203,5,3,11293,11293,11296,0,3,3
3204,4,3,11297,11297,11300,0,3,1
3205,4,1,11301,11301,11302,0,1,1
3206,4,1,11305,11305,11306,0,1,3
3207,6,1,11311,11311,11312,0,1,5
3208,6,1,11317,11317,11318,0,1,5
3209,4,1,11321,11321,11322,0,1,3
3210,3,3,11324,11324,11327,0,3,2
3211,6,1,11330,11330,11331,0,1,3
3212,5,3,11335,11335,11338,0,3,4
3213,1,2,11336,11338,11340,2,4,0
3214,6,2,11342,11342,11344,0,2,2
3215,2,3,11344,11344,11347,0,3,0
3216,5,1,11349,11349,11350,0,1,2
3217,6,2,11355,11355,11357,0,2,5
3218,3,3,11358,11358,11361,0,3,1
3219,1,3,11359,11361,11364,2,5,0
3220,6,3,11365,11365,11368,0,3,1
3221,5,3,11370,11370,11373,0,3,2
3222,1,1,11371,11373,11374,2,3,0
3223,3,2,11374,11374,11376,0,2,0
3224,1,2,11375,11376,11378,1,3,0
3225,1,3,11376,11378,11381,2,5,0
3226,3,1,11379,11381,11382,2,3,0
3227,5,3,11384,11384,11387,0,3,2
3228,1,2,11385,11387,11389,2,4,0
3229,2,3,11387,11389,11392,2,5,0
3230,5,1,11392,11392,11393,0,1,0
3231,5,1,11397,11397,11398,0,1,4
3232,1,2,11398,11398,11400,0,2,0
3233,6,3,11404,11404,11407,0,3,4
3234,1,1,11405,11407,11408,2,3,0
3235,2,1,11407,11408,11409,1,2,0
3236,4,3,11411,11411,11414,0,3,2
3237,4,3,11415,11415,11418,0,3,1
3238,3,1,11418,11418,11419,0,1,0
3239,4,1,11422,11422,11423,0,1,3
3240,2,3,11424,11424,11427,0,3,1
3241,1,3,11425,11427,11430,2,5,0
3242,3,3,11428,11430,11433,2,5,0
3243,2,3,11430,11433,11436,3,6,0
3244,5,1,11435,11436,11437,1,2,0
3245,5,3,11440,11440,11443,0,3,3
3246,6,1,11446,11446,11447,0,1,3
3247,4,3,11450,11450,11453,0,3,3
3248,2,1,11452,11453,11454,1,2,0
3249,6,3,11458,11458,11461,0,3,4
3250,3,1,11461,11461,11462,0,1,0
3251,1,3,11462,11462,11465,0,3,0
3252,5,2,11467,11467,11469,0,2,2
3253,2,2,11469,11469,11471,0,2,0
3254,6,2,11475,11475,11477,0,2,4
3255,3,3,11478,11478,11481,0,3,1
3256,2,2,11480,11481,11483,1,3,0
3257,4,3,11484,11484,11487,0,3,1
3258,1,2,11485,11487,11489,2,4,0
3259,4,2,11489,11489,11491,0,2,0
3260,1,1,11490,11491,11492,1,2,0
3261,2,1,11492,11492,11493,0,1,0
3262,5,2,11497,11497,11499,0,2,4
3263,2,1,11499,11499,11500,0,1,0
3264,2,3,11501,11501,11504,0,3,1
3265,2,3,11503,11504,11507,1,4,0
3266,1,2,11504,11507,11509,3,5,0
3267,2,3,11506,11509,11512,3,6,0
3268,2,1,11508,11512,11513,4,5,0
3269,5,2,11513,11513,11515,0,2,0
3270,1,2,11514,11515,11517,1,3,0
3271,2,3,11516,11517,11520,1,4,0
3272,4,1,11520,11520,11521,0,1,0
3273,5,3,11525,11525,11528,0,3,4
3274,4,1,11529,11529,11530,0,1,1
3275,1,1,11530,11530,11531,0,1,0
3276,1,1,11531,11531,11532,0,1,0
3277,2,1,11533,11533,11534,0,1,1
3278,4,2,11537,11537,11539,0,2,3
3279,1,2,11538,11539,11541,1,3,0
3280,4,2,11542,11542,11544,0,2,1
3281,2,3,11544,11544,11547,0,3,0
3282,5,3,11549,11549,11552,0,3,2
3283,3,3,11552,11552,11555,0,3,0
3284,1,1,11553,11555,11556,2,3,0
3285,6,2,11559,11559,11561,0,2,3
3286,1,2,11560,11561,11563,1,3,0
3287,1,2,11561,11563,11565,2,4,0
3288,2,1,11563,11565,11566,2,3,0
3289,3,3,11566,11566,11569,0,3,0
3290,1,2,11567,11569,11571,2,4,0
3291,5,2,11572,11572,11574,0,2,1
3292,5,3,11577,11577,11580,0,3,3
3293,5,2,11582,11582,11584,0,2,2
3294,3,2,11585,11585,11587,0,2,1
3295,4,3,11589,11589,11592,0,3,2
3296,5,2,11594,11594,11596,0,2,2
3297,1,3,11595,11596,11599,1,4,0
3298,4,2,11599,11599,11601,0,2,0
3299,6,2,11605,11605,11607,0,2,4
3300,2,1,11607,11607,11608,0,1,0
3301,1,1,11608,11608,11609,0,1,0
3302,1,1,11609,11609,11610,0,1,0
3303,3,1,11612,11612,11613,0,1,2
3304,2,2,11614,11614,11616,0,2,1
3305,4,2,11618,11618,11620,0,2,2
3306,6,3,11624,11624,11627,0,3,4
3307,5,1,11629,11629,11630,0,1,2
3308,5,2,11634,11634,11636,0,2,4
3309,3,3,11637,11637,11640,0,3,1
3310,3,1,11640,11640,11641,0,1,0
3311,5,3,11645,11645,11648,0,3,4
3312,2,1,11647,11648,11649,1,2,0
3313,1,3,11648,11649,11652,1,4,0
3314,5,3,11653,11653,11656,0,3,1
3315,2,3,11655,11656,11659,1,4,0
3316,3,2,11658,11659,11661,1,3,0
3317,3,2,11661,11661,11663,0,2,0
3318,2,2,11663,11663,11665,0,2,0
3319,3,2,11666,11666,11668,0,2,1
3320,6,1,11672,11672,11673,0,1,4
3321,3,1,11675,11675,11676,0,1,2
3322,6,3,11681,11681,11684,0,3,5
3323,1,1,11682,11684,11685,2,3,0
3324,2,1,11684,11685,11686,1,2,0
3325,5,3,11689,11689,11692,0,3,3
3326,6,1,11695,11695,11696,0,1,3
3327,2,3,11697,11697,11700,0,3,1
3328,1,1,11698,11700,11701,2,3,0
3329,3,3,11701,11701,11704,0,3,0
3330,3,2,11704,11704,11706,0,2,0
3331,1,2,11705,11706,11708,1,3,0
3332,2,2,11707,11708,11710,1,3,0
3333,4,3,11711,11711,11714,0,3,1
3334,1,1,11712,11714,11715,2,3,0
3335,1,1,11713,11715,11716,2,3,0
3336,2,3,11715,11716,11719,1,4,0
3337,1,3,11716,11719,11722,3,6,0
3338,2,2,11718,11722,11724,4,6,0
3339,5,2,11723,11724,11726,1,3,0
3340,6,3,11729,11729,11732,0,3,3
3341,6,3,11735,11735,11738,0,3,3
3342,4,2,11739,11739,11741,0,2,1
3343,2,3,11741,11741,11744,0,3,0
3344,2,2,11743,11744,11746,1,3,0
3345,4,3,11747,11747,11750,0,3,1
3346,2,1,11749,11750,11751,1,2,0
3347,5,3,11754,11754,11757,0,3,3
3348,2,1,11756,11757,11758,1,2,0
3349,3,2,11759,11759,11761,0,2,1
3350,6,3,11765,11765,11768,0,3,4
3351,2,2,11767,11768,11770,1,3,0
3352,4,2,11771,11771,11773,0,2,1
3353,5,3,11776,11776,11779,0,3,3
3354,5,2,11781,11781,11783,0,2,2
3355,2,3,11783,11783,11786,0,3,0
3356,4,3,11787,11787,11790,0,3,1
3357,2,2,11789,11790,11792,1,3,0
3358,5,2,11794,11794,11796,0,2,2
3359,2,3,11796,11796,11799,0,3,0
3360,2,1,11798,11799,11800,1,2,0
3361,2,2,11800,11800,11802,0,2,0
3362,1,1,11801,11802,11803,1,2,0
3363,1,3,11802,11803,11806,1,4,0
3364,3,3,11805,11806,11809,1,4,0
3365,1,1,11806,11809,11810,3,4,0
3366,4,3,11810,11810,11813,0,3,0
3367,1,3,11811,11813,11816,2,5,0
3368,3,3,11814,11816,11819,2,5,0
3369,5,2,11819,11819,11821,0,2,0
3370,3,3,11822,11822,11825,0,3,1
3371,4,1,11826,11826,11827,0,1,1
3372,3,2,11829,11829,11831,0,2,2
3373,5,3,11834,11834,11837,0,3,3
3374,6,1,11840,11840,11841,0,1,3
3375,4,1,11844,11844,11845,0,1,3
3376,1,1,11845,11845,11846,0,1,0
3377,6,3,11851,11851,11854,0,3,5
3378,4,2,11855,11855,11857,0,2,1
3379,3,3,11858,11858,11861,0,3,1
3380,6,1,11864,11864,11865,0,1,3
3381,2,3,11866,11866,11869,0,3,1
3382,1,3,11867,11869,11872,2,5,0
3383,2,2,11869,11872,11874,3,5,0
3384,5,3,11874,11874,11877,0,3,0
3385,3,3,11877,11877,11880,0,3,0
3386,6,1,11883,11883,11884,0,1,3
3387,1,3,11884,11884,11887,0,3,0
3388,6,2,11890,11890,11892,0,2,3
3389,3,3,11893,11893,11896,0,3,1
3390,6,2,11899,11899,11901,0,2,3
3391,2,2,11901,11901,11903,0,2,0
3392,6,2,11907,11907,11909,0,2,4
3393,4,1,11911,11911,11912,0,1,2
3394,6,1,11917,11917,11918,0,1,5
3395,4,1,11921,11921,11922,0,1,3
3396,6,1,11927,11927,11928,0,1,5
3397,6,1,11933,11933,11934,0,1,5
3398,3,1,11936,11936,11937,0,1,2
3399,3,1,11939,11939,11940,0,1,2
3400,6,3,11945,11945,11948,0,3,5
3401,3,3,11948,11948,11951,0,3,0
3402,1,1,11949,11951,11952,2,3,0
3403,3,2,11952,11952,11954,0,2,0
3404,2,1,11954,11954,11955,0,1,0
3405,1,1,11955,11955,11956,0,1,0
3406,3,1,11958,11958,11959,0,1,2
3407,4,3,11962,11962,11965,0,3,3
3408,5,1,11967,11967,11968,0,1,2
3409,1,3,11968,11968,11971,0,3,0
3410,6,2,11974,11974,11976,0,2,3
3411,2,3,11976,11976,11979,0,3,0
3412,5,2,11981,11981,11983,0,2,2
3413,4,2,11985,11985,11987,0,2,2
3414,3,2,11988,11988,11990,0,2,1
3415,6,2,11994,11994,11996,0,2,4
3416,5,3,11999,11999,12002,0,3,3
3417,3,2,12002,12002,12004,0,2,0
3418,4,3,12006,12006,12009,0,3,2
3419,6,3,12012,12012,12015,0,3,3
3420,6,3,12018,12018,12021,0,3,3
3421,3,1,12021,12021,12022,0,1,0
3422,2,2,12023,12023,12025,0,2,1
3423,6,3,12029,12029,12032,0,3,4
3424,5,1,12034,12034,12035,0,1,2
3425,4,1,12038,12038,12039,0,1,3
3426,6,1,12044,12044,12045,0,1,5
3427,1,1,12045,12045,12046,0,1,0
3428,3,2,12048,12048,12050,0,2,2
3429,5,2,12053,12053,12055,0,2,3
3430,3,3,12056,12056,12059,0,3,1
3431,6,2,12062,12062,12064,0,2,3
3432,4,3,12066,12066,12069,0,3,2
3433,6,2,12072,12072,12074,0,2,3
3434,5,1,12077,12077,12078,0,1,3
3435,1,1,12078,12078,12079,0,1,0
3436,6,1,12084,12084,12085,0,1,5
3437,5,3,12089,12089,12092,0,3,4
3438,2,3,12091,12092,12095,1,4,0
3439,5,2,12096,12096,12098,0,2,1
3440,6,3,12102,12102,12105,0,3,4
3441,2,3,12104,12105,12108,1,4,0
3442,5,1,12109,12109,12110,0,1,1
3443,6,2,12115,12115,12117,0,2,5
3444,5,1,12120,12120,12121,0,1,3
3445,3,1,12123,12123,12124,0,1,2
3446,5,1,12128,12128,12129,0,1,4
3447,4,2,12132,12132,12134,0,2,3
3448,6,2,12138,12138,12140,0,2,4
3449,4,1,12142,12142,12143,0,1,2
3450,5,3,12147,12147,12150,0,3,4
3451,4,3,12151,12151,12154,0,3,1
3452,6,3,12157,12157,12160,0,3,3
3453,4,2,12161,12161,12163,0,2,1
3454,6,1,12167,12167,12168,0,1,4
3455,4,2,12171,12171,12173,0,2,3
3456,5,2,12176,12176,12178,0,2,3
3457,6,2,12182,12182,12184,0,2,4
3458,6,2,12188,12188,12190,0,2,4
3459,4,3,12192,12192,12195,0,3,2
3460,6,1,12198,12198,12199,0,1,3
3461,2,2,12200,12200,12202,0,2,1
3462,3,1,12203,12203,12204,0,1,1
3463,6,1,12209,12209,12210,0,1,5
3464,4,2,12213,12213,12215,0,2,3
3465,5,2,12218,12218,12220,0,2,3
3466,5,2,12223,12223,12225,0,2,3
3467,4,2,12227,12227,12229,0,2,2
3468,4,3,12231,12231,12234,0,3,2
3469,6,2,12237,12237,12239,0,2,3
3470,6,3,12243,12243,12246,0,3,4
3471,1,1,12244,12246,12247,2,3,0
3472,6,1,12250,12250,12251,0,1,3
3473,2,3,12252,12252,12255,0,3,1
3474,3,3,12255,12255,12258,0,3,0
3475,1,2,12256,12258,12260,2,4,0
3476,1,2,12257,12260,12262,3,5,0
3477,3,1,12260,12262,12263,2,3,0
3478,3,2,12263,12263,12265,0,2,0
3479,1,1,12264,12265,12266,1,2,0
3480,4,1,12268,12268,12269,0,1,2
3481,5,2,12273,12273,12275,0,2,4
3482,2,1,12275,12275,12276,0,1,0
3483,2,2,12277,12277,12279,0,2,1
3484,3,3,12280,12280,12283,0,3,1
3485,5,2,12285,12285,12287,0,2,2
3486,5,1,12290,12290,12291,0,1,3
3487,6,1,12296,12296,12297,0,1,5
3488,2,1,12298,12298,12299,0,1,1
3489,1,1,12299,12299,12300,0,1,0
3490,6,2,12305,12305,12307,0,2,5
3491,6,2,12311,12311,12313,0,2,4
3492,4,1,12315,12315,12316,0,1,2
3493,3,2,12318,12318,12320,0,2,2
3494,1,3,12319,12320,12323,1,4,0
3495,3,1,12322,12323,12324,1,2,0
3496,6,3,12328,12328,12331,0,3,4
3497,3,3,12331,12331,12334,0,3,0
3498,1,3,12332,12334,12337,2,5,0
3499,1,1,12333,12337,12338,4,5,0
3500,4,3,12337,12338,12341,1,4,0
3501,5,1,12342,12342,12343,0,1,1
3502,4,3,12346,12346,12349,0,3,3
3503,3,3,12349,12349,12352,0,3,0
3504,5,3,12354,12354,12357,0,3,2
3505,3,3,12357,12357,12360,0,3,0
3506,4,2,12361,12361,12363,0,2,1
3507,2,1,12363,12363,12364,0,1,0
3508,1,2,12364,12364,12366,0,2,0
3509,5,3,12369,12369,12372,0,3,3
3510,1,2,12370,12372,12374,2,4,0
3511,2,3,12372,12374,12377,2,5,0
3512,5,2,12377,12377,12379,0,2,0
3513,3,1,12380,12380,12381,0,1,1
3514,5,1,12385,12385,12386,0,1,4
3515,5,1,12390,12390,12391,0,1,4
3516,5,1,12395,12395,12396,0,1,4
3517,6,2,12401,12401,12403,0,2,5
3518,3,1,12404,12404,12405,0,1,1
3519,3,1,12407,12407,12408,0,1,2
3520,1,1,12408,12408,12409,0,1,0
3521,1,1,12409,12409,12410,0,1,0
3522,3,3,12412,12412,12415,0,3,2
3523,5,3,12417,12417,12420,0,3,2
3524,6,2,12423,12423,12425,0,2,3
3525,4,2,12427,12427,12429,0,2,2
3526,5,1,12432,12432,12433,0,1,3
3527,5,2,12437,12437,12439,0,2,4
3528,2,1,12439,12439,12440,0,1,0
3529,2,2,12441,12441,12443,0,2,1
3530,6,3,12447,12447,12450,0,3,4
3531,6,3,12453,12453,12456,0,3,3
3532,3,3,12456,12456,12459,0,3,0
3533,3,2,12459,12459,12461,0,2,0
3534,1,3,12460,12461,12464,1,4,0
3535,1,1,12461,12464,12465,3,4,0
3536,4,1,12465,12465,12466,0,1,0
3537,2,3,12467,12467,12470,0,3,1
3538,3,3,12470,12470,12473,0,3,0
3539,5,2,12475,12475,12477,0,2,2
3540,6,1,12481,12481,12482,0,1,4
3541,6,2,12487,12487,12489,0,2,5
3542,1,1,12488,12489,12490,1,2,0
3543,4,3,12492,12492,12495,0,3,2
3544,6,1,12498,12498,12499,0,1,3
3545,1,2,12499,12499,12501,0,2,0
3546,2,2,12501,12501,12503,0,2,0
3547,4,3,12505,12505,12508,0,3,2
3548,5,2,12510,12510,12512,0,2,2
3549,3,2,12513,12513,12515,0,2,1
3550,6,2,12519,12519,12521,0,2,4
3551,3,1,12522,12522,12523,0,1,1
3552,3,1,12525,12525,12526,0,1,2
3553,2,2,12527,12527,12529,0,2,1
3554,2,3,12529,12529,12532,0,3,0
3555,3,2,12532,12532,12534,0,2,0
3556,2,2,12534,12534,12536,0,2,0
3557,1,1,12535,12536,12537,1,2,0
3558,1,2,12536,12537,12539,1,3,0
3559,6,2,12542,12542,12544,0,2,3
3560,6,3,12548,12548,12551,0,3,4
3561,6,2,12554,12554,12556,0,2,3
3562,2,2,12556,12556,12558,0,2,0
3563,4,2,12560,12560,12562,0,2,2
3564,4,1,12564,12564,12565,0,1,2
3565,6,3,12570,12570,12573,0,3,5
3566,2,3,12572,12573,12576,1,4,0
3567,3,1,12575,12576,12577,1,2,0
3568,6,1,12581,12581,12582,0,1,4
3569,6,2,12587,12587,12589,0,2,5
3570,3,1,12590,12590,12591,0,1,1
3571,3,2,12593,12593,12595,0,2,2
3572,5,3,12598,12598,12601,0,3,3
3573,5,2,12603,12603,12605,0,2,2
3574,1,3,12604,12605,12608,1,4,0
3575,4,2,12608,12608,12610,0,2,0
3576,4,2,12612,12612,12614,0,2,2
3577,5,3,12617,12617,12620,0,3,3
3578,4,2,12621,12621,12623,0,2,1
3579,2,3,12623,12623,12626,0,3,0
3580,4,1,12627,12627,12628,0,1,1
3581,6,3,12633,12633,12636,0,3,5
3582,3,3,12636,12636,12639,0,3,0
3583,1,1,12637,12639,12640,2,3,0
3584,6,1,12643,12643,12644,0,1,3
3585,1,2,12644,12644,12646,0,2,0
3586,1,2,12645,12646,12648,1,3,0
3587,6,1,12651,12651,12652,0,1,3
3588,6,2,12657,12657,12659,0,2,5
3589,4,3,12661,12661,12664,0,3,2
3590,4,1,12665,12665,12666,0,1,1
3591,4,1,12669,12669,12670,0,1,3
3592,1,3,12670,12670,12673,0,3,0
3593,4,3,12674,12674,12677,0,3,1
3594,1,2,12675,12677,12679,2,4,0
3595,5,2,12680,12680,12682,0,2,1
3596,4,1,12684,12684,12685,0,1,2
3597,1,2,12685,12685,12687,0,2,0
3598,1,3,12686,12687,12690,1,4,0
3599,3,3,12689,12690,12693,1,4,0
3600,4,3,12693,12693,12696,0,3,0
3601,5,2,12698,12698,12700,0,2,2
3602,3,3,12701,12701,12704,0,3,1
3603,6,3,12707,12707,12710,0,3,3
3604,6,3,12713,12713,12716,0,3,3
3605,4,2,12717,12717,12719,0,2,1
3606,6,1,12723,12723,12724,0,1,4
3607,1,1,12724,12724,12725,0,1,0
3608,1,2,12725,12725,12727,0,2,0
3609,3,3,12728,12728,12731,0,3,1
3610,3,3,12731,12731,12734,0,3,0
3611,4,1,12735,12735,12736,0,1,1
3612,2,3,12737,12737,12740,0,3,1
3613,5,2,12742,12742,12744,0,2,2
3614,2,1,12744,12744,12745,0,1,0
3615,1,1,12745,12745,12746,0,1,0
3616,1,2,12746,12746,12748,0,2,0
3617,4,3,12750,12750,12753,0,3,2
3618,5,2,12755,12755,12757,0,2,2
3619,5,2,12760,12760,12762,0,2,3
3620,1,2,12761,12762,12764,1,3,0
3621,3,3,12764,12764,12767,0,3,0
3622,3,1,12767,12767,12768,0,1,0
3623,2,3,12769,12769,12772,0,3,1
3624,3,3,12772,12772,12775,0,3,0
3625,5,3,12777,12777,12780,0,3,2
3626,2,1,12779,12780,12781,1,2,0
3627,5,1,12784,12784,12785,0,1,3
3628,3,3,12787,12787,12790,0,3,2
3629,6,3,12793,12793,12796,0,3,3
3630,4,1,12797,12797,12798,0,1,1
3631,3,1,12800,12800,12801,0,1,2
3632,2,1,12802,12802,12803,0,1,1
3633,4,1,12806,12806,12807,0,1,3
3634,5,1,12811,12811,12812,0,1,4
3635,5,2,12816,12816,12818,0,2,4
3636,3,2,12819,12819,12821,0,2,1
3637,1,3,12820,12821,12824,1,4,0
3638,4,2,12824,12824,12826,0,2,0
3639,6,2,12830,12830,12832,0,2,4
3640,6,2,12836,12836,12838,0,2,4
3641,3,1,12839,12839,12840,0,1,1
3642,6,3,12845,12845,12848,0,3,5
3643,6,1,12851,12851,12852,0,1,3
3644,1,3,12852,12852,12855,0,3,0
3645,6,1,12858,12858,12859,0,1,3
3646,5,1,12863,12863,12864,0,1,4
3647,4,1,12867,12867,12868,0,1,3
3648,3,2,12870,12870,12872,0,2,2
3649,1,3,12871,12872,12875,1,4,0
3650,2,1,12873,12875,12876,2,3,0
3651,3,3,12876,12876,12879,0,3,0
3652,2,1,12878,12879,12880,1,2,0
3653,5,2,12883,12883,12885,0,2,3
3654,3,3,12886,12886,12889,0,3,1
3655,5,2,12891,12891,12893,0,2,2
3656,3,2,12894,12894,12896,0,2,1
3657,3,1,12897,12897,12898,0,1,1
3658,4,2,12901,12901,12903,0,2,3
3659,3,2,12904,12904,12906,0,2,1
3660,5,2,12909,12909,12911,0,2,3
3661,6,1,12915,12915,12916,0,1,4
3662,5,2,12920,12920,12922,0,2,4
3663,5,2,12925,12925,12927,0,2,3
3664,6,1,12931,12931,12932,0,1,4
3665,2,2,12933,12933,12935,0,2,1
3666,4,1,12937,12937,12938,0,1,2
3667,6,2,12943,12943,12945,0,2,5
3668,5,3,12948,12948,12951,0,3,3
3669,4,1,12952,12952,12953,0,1,1
3670,4,3,12956,12956,12959,0,3,3
3671,2,2,12958,12959,12961,1,3,0
3672,1,1,12959,12961,12962,2,3,0
3673,6,1,12965,12965,12966,0,1,3
3674,2,2,12967,12967,12969,0,2,1
3675,2,2,12969,12969,12971,0,2,0
3676,4,2,12973,12973,12975,0,2,2
3677,1,2,12974,12975,12977,1,3,0
3678,5,2,12979,12979,12981,0,2,2
3679,4,2,12983,12983,12985,0,2,2
3680,5,2,12988,12988,12990,0,2,3
3681,6,1,12994,12994,12995,0,1,4
3682,6,3,13000,13000,13003,0,3,5
3683,4,3,13004,13004,13007,0,3,1
3684,5,2,13009,13009,13011,0,2,2
3685,4,3,13013,13013,13016,0,3,2
3686,3,2,13016,13016,13018,0,2,0
3687,3,3,13019,13019,13022,0,3,1
3688,4,3,13023,13023,13026,0,3,1
3689,4,3,13027,13027,13030,0,3,1
3690,3,2,13030,13030,13032,0,2,0
3691,1,1,13031,13032,13033,1,2,0
3692,4,3,13035,13035,13038,0,3,2
3693,2,3,13037,13038,13041,1,4,0
3694,3,3,13040,13041,13044,1,4,0
3695,3,1,13043,13044,13045,1,2,0
3696,4,2,13047,13047,13049,0,2,2
3697,4,3,13051,13051,13054,0,3,2
3698,3,2,13054,13054,13056,0,2,0
3699,4,1,13058,13058,13059,0,1,2
3700,4,2,13062,13062,13064,0,2,3
3701,2,1,13064,13064,13065,0,1,0
3702,1,3,13065,13065,13068,0,3,0
3703,3,2,13068,13068,13070,0,2,0
3704,1,2,13069,13070,13072,1,3,0
3705,2,2,13071,13072,13074,1,3,0
3706,3,1,13074,13074,13075,0,1,0
3707,1,2,13075,13075,13077,0,2,0
3708,2,2,13077,13077,13079,0,2,0
3709,2,1,13079,13079,13080,0,1,0
3710,1,2,13080,13080,13082,0,2,0
3711,2,2,13082,13082,13084,0,2,0
3712,6,2,13088,13088,13090,0,2,4
3713,4,1,13092,13092,13093,0,1,2
3714,3,2,13095,13095,13097,0,2,2
3715,1,2,13096,13097,13099,1,3,0
3716,5,3,13101,13101,13104,0,3,2
3717,6,1,13107,13107,13108,0,1,3
3718,4,3,13111,13111,13114,0,3,3
3719,1,3,13112,13114,13117,2,5,0
3720,2,2,13114,13117,13119,3,5,0
3721,2,3,13116,13119,13122,3,6,0
3722,5,2,13121,13122,13124,1,3,0
3723,3,1,13124,13124,13125,0,1,0
3724,3,3,13127,13127,13130,0,3,2
3725,2,2,13129,13130,13132,1,3,0
3726,3,3,13132,13132,13135,0,3,0
3727,2,2,13134,13135,13137,1,3,0
3728,6,3,13140,13140,13143,0,3,3
3729,2,1,13142,13143,13144,1,2,0
3730,2,1,13144,13144,13145,0,1,0
3731,6,3,13150,13150,13153,0,3,5
3732,5,3,13155,13155,13158,0,3,2
3733,4,3,13159,13159,13162,0,3,1
3734,5,3,13164,13164,13167,0,3,2
3735,5,1,13169,13169,13170,0,1,2
3736,5,2,13174,13174,13176,0,2,4
3737,1,1,13175,13176,13177,1,2,0
3738,2,3,13177,13177,13180,0,3,0
3739,4,3,13181,13181,13184,0,3,1
3740,2,1,13183,13184,13185,1,2,0
3741,4,2,13187,13187,13189,0,2,2
3742,2,2,13189,13189,13191,0,2,0
3743,3,2,13192,13192,13194,0,2,1
3744,3,1,13195,13195,13196,0,1,1
3745,1,3,13196,13196,13199,0,3,0
3746,5,3,13201,13201,13204,0,3,2
3747,1,1,13202,13204,13205,2,3,0
3748,3,3,13205,13205,13208,0,3,0
3749,4,2,13209,13209,13211,0,2,1
3750,1,2,13210,13211,13213,1,3,0
3751,5,2,13215,13215,13217,0,2,2
3752,3,2,13218,13218,13220,0,2,1
3753,2,1,13220,13220,13221,0,1,0
3754,5,3,13225,13225,13228,0,3,4
3755,4,1,13229,13229,13230,0,1,1
3756,3,3,13232,13232,13235,0,3,2
3757,1,1,13233,13235,13236,2,3,0
3758,1,2,13234,13236,13238,2,4,0
3759,4,3,13238,13238,13241,0,3,0
3760,6,1,13244,13244,13245,0,1,3
3761,2,1,13246,13246,13247,0,1,1
3762,1,2,13247,13247,13249,0,2,0
3763,6,1,13253,13253,13254,0,1,4
3764,1,1,13254,13254,13255,0,1,0
3765,3,1,13257,13257,13258,0,1,2
3766,3,2,13260,13260,13262,0,2,2
3767,6,1,13266,13266,13267,0,1,4
3768,3,2,13269,13269,13271,0,2,2
3769,5,1,13274,13274,13275,0,1,3
3770,6,1,13280,13280,13281,0,1,5
3771,5,3,13285,13285,13288,0,3,4
3772,4,3,13289,13289,13292,0,3,1
3773,1,3,13290,13292,13295,2,5,0
3774,2,1,13292,13295,13296,3,4,0
3775,6,3,13298,13298,13301,0,3,2
3776,1,2,13299,13301,13303,2,4,0
3777,1,3,13300,13303,13306,3,6,0
3778,4,3,13304,13306,13309,2,5,0
3779,2,1,13306,13309,13310,3,4,0
3780,4,2,13310,13310,13312,0,2,0
3781,2,3,13312,13312,13315,0,3,0
3782,2,3,13314,13315,13318,1,4,0
3783,4,2,13318,13318,13320,0,2,0
3784,1,3,13319,13320,13323,1,4,0
3785,1,2,13320,13323,13325,3,5,0
3786,5,2,13325,13325,13327,0,2,0
3787,1,1,13326,13327,13328,1,2,0
3788,5,1,13331,13331,13332,0,1,3
3789,6,2,13337,13337,13339,0,2,5
3790,3,2,13340,13340,13342,0,2,1
3791,2,3,13342,13342,13345,0,3,0
3792,6,1,13348,13348,13349,0,1,3
3793,3,3,13351,13351,13354,0,3,2
3794,4,1,13355,13355,13356,0,1,1
3795,2,2,13357,13357,13359,0,2,1
3796,5,3,13362,13362,13365,0,3,3
3797,5,3,13367,13367,13370,0,3,2
3798,4,2,13371,13371,13373,0,2,1
3799,2,1,13373,13373,13374,0,1,0
3800,4,3,13377,13377,13380,0,3,3
3801,4,2,13381,13381,13383,0,2,1
3802,4,1,13385,13385,13386,0,1,2
3803,6,3,13391,13391,13394,0,3,5
3804,3,2,13394,13394,13396,0,2,0
3805,2,1,13396,13396,13397,0,1,0
3806,1,2,13397,13397,13399,0,2,0
3807,2,2,13399,13399,13401,0,2,0
3808,5,3,13404,13404,13407,0,3,3
3809,1,2,13405,13407,13409,2,4,0
3810,3,1,13408,13409,13410,1,2,0
3811,1,1,13409,13410,13411,1,2,0
3812,4,2,13413,13413,13415,0,2,2
3813,4,1,13417,13417,13418,0,1,2
3814,1,2,13418,13418,13420,0,2,0
3815,2,1,13420,13420,13421,0,1,0
3816,4,3,13424,13424,13427,0,3,3
3817,4,2,13428,13428,13430,0,2,1
3818,3,1,13431,13431,13432,0,1,1
3819,5,3,13436,13436,13439,0,3,4
3820,4,2,13440,13440,13442,0,2,1
3821,5,1,13445,13445,13446,0,1,3
3822,5,3,13450,13450,13453,0,3,4
3823,1,2,13451,13453,13455,2,4,0
3824,4,3,13455,13455,13458,0,3,0
3825,4,2,13459,13459,13461,0,2,1
3826,5,3,13464,13464,13467,0,3,3
3827,2,2,13466,13467,13469,1,3,0
3828,4,2,13470,13470,13472,0,2,1
3829,4,3,13474,13474,13477,0,3,2
3830,6,2,13480,13480,13482,0,2,3
3831,2,2,13482,13482,13484,0,2,0
3832,4,2,13486,13486,13488,0,2,2
3833,2,1,13488,13488,13489,0,1,0
3834,4,2,13492,13492,13494,0,2,3
3835,5,2,13497,13497,13499,0,2,3
3836,2,3,13499,13499,13502,0,3,0
3837,1,3,13500,13502,13505,2,5,0
3838,3,1,13503,13505,13506,2,3,0
3839,1,1,13504,13506,13507,2,3,0
3840,4,1,13508,13508,13509,0,1,1
3841,4,3,13512,13512,13515,0,3,3
3842,3,3,13515,13515,13518,0,3,0
3843,4,2,13519,13519,13521,0,2,1
3844,2,3,13521,13521,13524,0,3,0
3845,5,1,13526,13526,13527,0,1,2
3846,4,3,13530,13530,13533,0,3,3
3847,4,2,13534,13534,13536,0,2,1
3848,2,3,13536,13536,13539,0,3,0
3849,5,2,13541,13541,13543,0,2,2
3850,2,2,13543,13543,13545,0,2,0
3851,6,3,13549,13549,13552,0,3,4
3852,3,3,13552,13552,13555,0,3,0
3853,5,2,13557,13557,13559,0,2,2
3854,2,2,13559,13559,13561,0,2,0
3855,2,1,13561,13561,13562,0,1,0
3856,5,3,13566,13566,13569,0,3,4
3857,5,3,13571,13571,13574,0,3,2
3858,6,1,13577,13577,13578,0,1,3
3859,1,3,13578,13578,13581,0,3,0
3860,2,3,13580,13581,13584,1,4,0
3861,3,1,13583,13584,13585,1,2,0
3862,3,3,13586,13586,13589,0,3,1
3863,3,1,13589,13589,13590,0,1,0
3864,4,1,13593,13593,13594,0,1,3
3865,3,3,13596,13596,13599,0,3,2
3866,4,1,13600,13600,13601,0,1,1
3867,6,3,13606,13606,13609,0,3,5
3868,2,3,13608,13609,13612,1,4,0
3869,3,2,13611,13612,13614,1,3,0
3870,3,2,13614,13614,13616,0,2,0
3871,5,1,13619,13619,13620,0,1,3
3872,3,1,13622,13622,13623,0,1,2
3873,5,3,13627,13627,13630,0,3,4
3874,6,1,13633,13633,13634,0,1,3
3875,1,2,13634,13634,13636,0,2,0
3876,3,3,13637,13637,13640,0,3,1
3877,1,3,13638,13640,13643,2,5,0
3878,3,2,13641,13643,13645,2,4,0
3879,6,2,13647,13647,13649,0,2,2
3880,4,3,13651,13651,13654,0,3,2
3881,2,1,13653,13654,13655,1,2,0
3882,5,3,13658,13658,13661,0,3,3
3883,2,2,13660,13661,13663,1,3,0
3884,6,3,13666,13666,13669,0,3,3
3885,4,1,13670,13670,13671,0,1,1
3886,3,2,13673,13673,13675,0,2,2
3887,4,2,13677,13677,13679,0,2,2
3888,3,2,13680,13680,13682,0,2,1
3889,2,3,13682,13682,13685,0,3,0
3890,2,2,13684,13685,13687,1,3,0
3891,4,2,13688,13688,13690,0,2,1
3892,1,1,13689,13690,13691,1,2,0
3893,3,3,13692,13692,13695,0,3,1
3894,4,3,13696,13696,13699,0,3,1
3895,3,2,13699,13699,13701,0,2,0
3896,5,3,13704,13704,13707,0,3,3
3897,5,1,13709,13709,13710,0,1,2
3898,4,2,13713,13713,13715,0,2,3
3899,4,1,13717,13717,13718,0,1,2
3900,2,2,13719,13719,13721,0,2,1
3901,5,1,13724,13724,13725,0,1,3
3902,2,2,13726,13726,13728,0,2,1
3903,5,3,13731,13731,13734,0,3,3
3904,4,3,13735,13735,13738,0,3,1
3905,2,1,13737,13738,13739,1,2,0
3906,5,1,13742,13742,13743,0,1,3
3907,2,2,13744,13744,13746,0,2,1
3908,6,1,13750,13750,13751,0,1,4
3909,4,2,13754,13754,13756,0,2,3
3910,4,3,13758,13758,13761,0,3,2
3911,5,3,13763,13763,13766,0,3,2
3912,6,1,13769,13769,13770,0,1,3
3913,3,1,13772,13772,13773,0,1,2
3914,1,1,13773,13773,13774,0,1,0
3915,4,1,13777,13777,13778,0,1,3
3916,6,2,13783,13783,13785,0,2,5
3917,3,1,13786,13786,13787,0,1,1
3918,1,2,13787,13787,13789,0,2,0
3919,1,3,13788,13789,13792,1,4,0
3920,2,3,13790,13792,13795,2,5,0
3921,4,3,13794,13795,13798,1,4,0
3922,3,3,13797,13798,13801,1,4,0
3923,4,2,13801,13801,13803,0,2,0
3924,1,3,13802,13803,13806,1,4,0
3925,3,2,13805,13806,13808,1,3,0
3926,1,3,13806,13808,13811,2,5,0
3927,6,1,13812,13812,13813,0,1,1
3928,6,3,13818,13818,13821,0,3,5
3929,1,2,13819,13821,13823,2,4,0
3930,6,3,13825,13825,13828,0,3,2
3931,2,1,13827,13828,13829,1,2,0
3932,1,2,13828,13829,13831,1,3,0
3933,1,1,13829,13831,13832,2,3,0
3934,2,3,13831,13832,13835,1,4,0
3935,4,2,13835,13835,13837,0,2,0
3936,3,1,13838,13838,13839,0,1,1
3937,3,3,13841,13841,13844,0,3,2
3938,1,1,13842,13844,13845,2,3,0
3939,5,1,13847,13847,13848,0,1,2
3940,5,1,13852,13852,13853,0,1,4
3941,3,3,13855,13855,13858,0,3,2
3942,6,1,13861,13861,13862,0,1,3
3943,2,1,13863,13863,13864,0,1,1
3944,5,1,13868,13868,13869,0,1,4
3945,1,2,13869,13869,13871,0,2,0
3946,4,2,13873,13873,13875,0,2,2
3947,3,2,13876,13876,13878,0,2,1
3948,4,3,13880,13880,13883,0,3,2
3949,1,1,13881,13883,13884,2,3,0
3950,2,1,13883,13884,13885,1,2,0
3951,3,2,13886,13886,13888,0,2,1
3952,4,2,13890,13890,13892,0,2,2
3953,1,3,13891,13892,13895,1,4,0
3954,1,2,13892,13895,13897,3,5,0
3955,4,3,13896,13897,13900,1,4,0
3956,1,3,13897,13900,13903,3,6,0
3957,6,2,13903,13903,13905,0,2,0
3958,4,1,13907,13907,13908,0,1,2
3959,6,3,13913,13913,13916,0,3,5
3960,4,2,13917,13917,13919,0,2,1
3961,5,1,13922,13922,13923,0,1,3
3962,3,2,13925,13925,13927,0,2,2
3963,2,2,13927,13927,13929,0,2,0
3964,3,2,13930,13930,13932,0,2,1
3965,6,3,13936,13936,13939,0,3,4
3966,3,3,13939,13939,13942,0,3,0
3967,6,1,13945,13945,13946,0,1,3
3968,5,1,13950,13950,13951,0,1,4
3969,4,2,13954,13954,13956,0,2,3
3970,3,2,13957,13957,13959,0,2,1
3971,3,3,13960,13960,13963,0,3,1
3972,1,3,13961,13963,13966,2,5,0
3973,1,2,13962,13966,13968,4,6,0
3974,6,2,13968,13968,13970,0,2,0
3975,2,3,13970,13970,13973,0,3,0
3976,4,3,13974,13974,13977,0,3,1
3977,3,1,13977,13977,13978,0,1,0
3978,1,3,13978,13978,13981,0,3,0
3979,6,1,13984,13984,13985,0,1,3
3980,4,3,13988,13988,13991,0,3,3
3981,5,3,13993,13993,13996,0,3,2
3982,6,2,13999,13999,14001,0,2,3
3983,5,2,14004,14004,14006,0,2,3
3984,4,1,14008,14008,14009,0,1,2
3985,6,1,14014,14014,14015,0,1,5
3986,3,3,14017,14017,14020,0,3,2
3987,4,3,14021,14021,14024,0,3,1
3988,4,2,14025,14025,14027,0,2,1
3989,5,3,14030,14030,14033,0,3,3
3990,6,1,14036,14036,14037,0,1,3
3991,6,2,14042,14042,14044,0,2,5
3992,5,2,14047,14047,14049,0,2,3
3993,2,3,14049,14049,14052,0,3,0
3994,4,2,14053,14053,14055,0,2,1
3995,2,1,14055,14055,14056,0,1,0
3996,5,3,14060,14060,14063,0,3,4
3997,6,2,14066,14066,14068,0,2,3
3998,6,3,14072,14072,14075,0,3,4
3999,4,3,14076,14076,14079,0,3,1
4000,6,1,14082,14082,14083,0,1,3
4001,3,1,14085,14085,14086,0,1,2
4002,4,3,14089,14089,14092,0,3,3
4003,2,1,14091,14092,14093,1,2,0
4004,4,2,14095,14095,14097,0,2,2
4005,2,1,14097,14097,14098,0,1,0
4006,6,2,14103,14103,14105,0,2,5
4007,1,2,14104,14105,14107,1,3,0
4008,4,3,14108,14108,14111,0,3,1
4009,2,2,14110,14111,14113,1,3,0
4010,4,3,14114,14114,14117,0,3,1
4011,1,3,14115,14117,14120,2,5,0
4012,6,3,14121,14121,14124,0,3,1
4013,4,3,14125,14125,14128,0,3,1
4014,6,1,14131,14131,14132,0,1,3
4015,5,1,14136,14136,14137,0,1,4
4016,6,1,14142,14142,14143,0,1,5
4017,1,2,14143,14143,14145,0,2,0
4018,1,2,14144,14145,14147,1,3,0
4019,6,1,14150,14150,14151,0,1,3
4020,5,2,14155,14155,14157,0,2,4
4021,4,1,14159,14159,14160,0,1,2
4022,4,1,14163,14163,14164,0,1,3
4023,5,3,14168,14168,14171,0,3,4
4024,4,2,14172,14172,14174,0,2,1
4025,1,2,14173,14174,14176,1,3,0
4026,4,3,14177,14177,14180,0,3,1
4027,6,3,14183,14183,14186,0,3,3
4028,6,3,14189,14189,14192,0,3,3
4029,1,1,14190,14192,14193,2,3,0
4030,1,1,14191,14193,14194,2,3,0
4031,6,2,14197,14197,14199,0,2,3
4032,2,3,14199,14199,14202,0,3,0
4033,2,1,14201,14202,14203,1,2,0
4034,3,3,14204,14204,14207,0,3,1
4035,4,3,14208,14208,14211,0,3,1
4036,1,3,14209,14211,14214,2,5,0
4037,5,1,14214,14214,14215,0,1,0
4038,3,3,14217,14217,14220,0,3,2
4039,5,2,14222,14222,14224,0,2,2
4040,2,2,14224,14224,14226,0,2,0
4041,1,2,14225,14226,14228,1,3,0
4042,6,1,14231,14231,14232,0,1,3
4043,3,2,14234,14234,14236,0,2,2
4044,6,2,14240,14240,14242,0,2,4
4045,6,1,14246,14246,14247,0,1,4
4046,4,3,14250,14250,14253,0,3,3
4047,2,2,14252,14253,14255,1,3,0
4048,4,3,14256,14256,14259,0,3,1
4049,4,2,14260,14260,14262,0,2,1
4050,5,1,14265,14265,14266,0,1,3
4051,6,2,14271,14271,14273,0,2,5
4052,3,2,14274,14274,14276,0,2,1
4053,5,2,14279,14279,14281,0,2,3
4054,3,2,14282,14282,14284,0,2,1
4055,3,1,14285,14285,14286,0,1,1
4056,6,1,14291,14291,14292,0,1,5
4057,6,3,14297,14297,14300,0,3,5
4058,6,3,14303,14303,14306,0,3,3
4059,5,2,14308,14308,14310,0,2,2
4060,2,3,14310,14310,14313,0,3,0
4061,1,3,14311,14313,14316,2,5,0
4062,1,3,14312,14316,14319,4,7,0
4063,4,1,14316,14319,14320,3,4,0
4064,4,1,14320,14320,14321,0,1,0
4065,4,2,14324,14324,14326,0,2,3
4066,4,1,14328,14328,14329,0,1,2
4067,2,1,14330,14330,14331,0,1,1
4068,6,1,14336,14336,14337,0,1,5
4069,3,3,14339,14339,14342,0,3,2
4070,1,3,14340,14342,14345,2,5,0
4071,3,1,14343,14345,14346,2,3,0
4072,5,2,14348,14348,14350,0,2,2
4073,2,1,14350,14350,14351,0,1,0
4074,2,2,14352,14352,14354,0,2,1
4075,6,1,14358,14358,14359,0,1,4
4076,1,3,14359,14359,14362,0,3,0
4077,2,1,14361,14362,14363,1,2,0
4078,1,3,14362,14363,14366,1,4,0
4079,2,1,14364,14366,14367,2,3,0
4080,3,1,14367,14367,14368,0,1,0
4081,6,3,14373,14373,14376,0,3,5
4082,2,1,14375,14376,14377,1,2,0
4083,5,1,14380,14380,14381,0,1,3
4084,5,2,14385,14385,14387,0,2,4
4085,1,3,14386,14387,14390,1,4,0
4086,4,3,14390,14390,14393,0,3,0
4087,5,1,14395,14395,14396,0,1,2
4088,1,1,14396,14396,14397,0,1,0
4089,5,2,14401,14401,14403,0,2,4
4090,5,3,14406,14406,14409,0,3,3
4091,2,2,14408,14409,14411,1,3,0
4092,6,3,14414,14414,14417,0,3,3
4093,1,1,14415,14417,14418,2,3,0
4094,1,2,14416,14418,14420,2,4,0
4095,1,2,14417,14420,14422,3,5,0
4096,4,3,14421,14422,14425,1,4,0
4097,1,2,14422,14425,14427,3,5,0
4098,5,2,14427,14427,14429,0,2,0
4099,4,2,14431,14431,14433,0,2,2
4100,4,2,14435,14435,14437,0,2,2
4101,6,2,14441,14441,14443,0,2,4
4102,3,3,14444,14444,14447,0,3,1
4103,5,2,14449,14449,14451,0,2,2
4104,3,3,14452,14452,14455,0,3,1
4105,6,2,14458,14458,14460,0,2,3
4106,2,2,14460,14460,14462,0,2,0
4107,2,1,14462,14462,14463,0,1,0
4108,2,2,14464,14464,14466,0,2,1
4109,1,1,14465,14466,14467,1,2,0
4110,2,2,14467,14467,14469,0,2,0
4111,6,1,14473,14473,14474,0,1,4
4112,1,3,14474,14474,14477,0,3,0
4113,3,2,14477,14477,14479,0,2,0
4114,4,2,14481,14481,14483,0,2,2
4115,6,1,14487,14487,14488,0,1,4
4116,5,3,14492,14492,14495,0,3,4
4117,6,1,14498,14498,14499,0,1,3
4118,3,1,14501,14501,14502,0,1,2
4119,3,2,14504,14504,14506,0,2,2
4120,5,3,14509,14509,14512,0,3,3
4121,4,1,14513,14513,14514,0,1,1
4122,6,1,14519,14519,14520,0,1,5
4123,3,2,14522,14522,14524,0,2,2
4124,1,1,14523,14524,14525,1,2,0
4125,2,3,14525,14525,14528,0,3,0
4126,4,1,14529,14529,14530,0,1,1
4127,2,1,14531,14531,14532,0,1,1
4128,5,1,14536,14536,14537,0,1,4
4129,3,2,14539,14539,14541,0,2,2
4130,6,1,14545,14545,14546,0,1,4
4131,2,3,14547,14547,14550,0,3,1
4132,6,1,14553,14553,14554,0,1,3
4133,5,3,14558,14558,14561,0,3,4
4134,3,2,14561,14561,14563,0,2,0
4135,1,1,14562,14563,14564,1,2,0
4136,3,2,14565,14565,14567,0,2,1
4137,2,1,14567,14567,14568,0,1,0
4138,4,2,14571,14571,14573,0,2,3
4139,3,1,14574,14574,14575,0,1,1
4140,1,3,14575,14575,14578,0,3,0
4141,2,2,14577,14578,14580,1,3,0
4142,3,1,14580,14580,14581,0,1,0
4143,3,3,14583,14583,14586,0,3,2
4144,1,2,14584,14586,14588,2,4,0
4145,1,2,14585,14588,14590,3,5,0
4146,3,3,14588,14590,14593,2,5,0
4147,2,1,14590,14593,14594,3,4,0
4148,5,1,14595,14595,14596,0,1,1
4149,6,1,14601,14601,14602,0,1,5
4150,4,2,14605,14605,14607,0,2,3
4151,2,2,14607,14607,14609,0,2,0
4152,6,2,14613,14613,14615,0,2,4
4153,6,2,14619,14619,14621,0,2,4
4154,4,2,14623,14623,14625,0,2,2
4155,5,1,14628,14628,14629,0,1,3
4156,2,1,14630,14630,14631,0,1,1
4157,4,2,14634,14634,14636,0,2,3
4158,3,3,14637,14637,14640,0,3,1
4159,5,1,14642,14642,14643,0,1,2
4160,2,2,14644,14644,14646,0,2,1
4161,1,2,14645,14646,14648,1,3,0
4162,3,3,14648,14648,14651,0,3,0
4163,6,3,14654,14654,14657,0,3,3
4164,5,2,14659,14659,14661,0,2,2
4165,6,2,14665,14665,14667,0,2,4
4166,6,3,14671,14671,14674,0,3,4
4167,2,2,14673,14674,14676,1,3,0
4168,3,2,14676,14676,14678,0,2,0
4169,3,1,14679,14679,14680,0,1,1
4170,4,2,14683,14683,14685,0,2,3
4171,5,2,14688,14688,14690,0,2,3
4172,5,3,14693,14693,14696,0,3,3
4173,2,3,14695,14696,14699,1,4,0
4174,1,3,14696,14699,14702,3,6,0
4175,1,3,14697,14702,14705,5,8,0
4176,5,1,14702,14705,14706,3,4,0
4177,3,3,14705,14706,14709,1,4,0
4178,3,3,14708,14709,14712,1,4,0
4179,1,3,14709,14712,14715,3,6,0
4180,4,3,14713,14715,14718,2,5,0
4181,5,3,14718,14718,14721,0,3,0
4182,1,1,14719,14721,14722,2,3,0
4183,2,3,14721,14722,14725,1,4,0
4184,4,3,14725,14725,14728,0,3,0
4185,3,2,14728,14728,14730,0,2,0
4186,4,2,14732,14732,14734,0,2,2
4187,4,1,14736,14736,14737,0,1,2
4188,4,3,14740,14740,14743,0,3,3
4189,2,1,14742,14743,14744,1,2,0
4190,3,3,14745,14745,14748,0,3,1
4191,3,2,14748,14748,14750,0,2,0
4192,1,1,14749,14750,14751,1,2,0
4193,2,1,14751,14751,14752,0,1,0
4194,1,1,14752,14752,14753,0,1,0
4195,5,1,14757,14757,14758,0,1,4
4196,4,2,14761,14761,14763,0,2,3
4197,5,3,14766,14766,14769,0,3,3
4198,4,2,14770,14770,14772,0,2,1
4199,6,1,14776,14776,14777,0,1,4
4200,4,1,14780,14780,14781,0,1,3
4201,1,2,14781,14781,14783,0,2,0
4202,2,3,14783,14783,14786,0,3,0
4203,6,3,14789,14789,14792,0,3,3
4204,3,1,14792,14792,14793,0,1,0
4205,5,2,14797,14797,14799,0,2,4
4206,3,2,14800,14800,14802,0,2,1
4207,2,3,14802,14802,14805,0,3,0
4208,5,1,14807,14807,14808,0,1,2
4209,5,1,14812,14812,14813,0,1,4
4210,2,3,14814,14814,14817,0,3,1
4211,3,3,14817,14817,14820,0,3,0
4212,3,3,14820,14820,14823,0,3,0
4213,1,2,14821,14823,14825,2,4,0
4214,6,1,14827,14827,14828,0,1,2
4215,2,1,14829,14829,14830,0,1,1
4216,1,1,14830,14830,14831,0,1,0
4217,5,2,14835,14835,14837,0,2,4
4218,1,1,14836,14837,14838,1,2,0
4219,2,2,14838,14838,14840,0,2,0
4220,3,3,14841,14841,14844,0,3,1
4221,6,1,14847,14847,14848,0,1,3
4222,5,2,14852,14852,14854,0,2,4
4223,1,1,14853,14854,14855,1,2,0
4224,6,3,14859,14859,14862,0,3,4
4225,1,1,14860,14862,14863,2,3,0
4226,6,2,14866,14866,14868,0,2,3
4227,5,2,14871,14871,14873,0,2,3
4228,6,1,14877,14877,14878,0,1,4
4229,6,3,14883,14883,14886,0,3,5
4230,3,2,14886,14886,14888,0,2,0
4231,6,3,14892,14892,14895,0,3,4
4232,6,3,14898,14898,14901,0,3,3
4233,5,2,14903,14903,14905,0,2,2
4234,2,1,14905,14905,14906,0,1,0
4235,3,2,14908,14908,14910,0,2,2
4236,3,2,14911,14911,14913,0,2,1
4237,5,3,14916,14916,14919,0,3,3
4238,5,1,14921,14921,14922,0,1,2
4239,6,3,14927,14927,14930,0,3,5
4240,6,3,14933,14933,14936,0,3,3
4241,1,2,14934,14936,14938,2,4,0
4242,4,3,14938,14938,14941,0,3,0
4243,2,2,14940,14941,14943,1,3,0
4244,6,2,14946,14946,14948,0,2,3
4245,1,3,14947,14948,14951,1,4,0
4246,1,1,14948,14951,14952,3,4,0
4247,6,3,14954,14954,14957,0,3,2
4248,5,2,14959,14959,14961,0,2,2
4249,5,3,14964,14964,14967,0,3,3
4250,4,2,14968,14968,14970,0,2,1
4251,3,2,14971,14971,14973,0,2,1
4252,4,2,14975,14975,14977,0,2,2
4253,3,1,14978,14978,14979,0,1,1
4254,2,2,14980,14980,14982,0,2,1
4255,4,1,14984,14984,14985,0,1,2
4256,4,3,14988,14988,14991,0,3,3
4257,1,3,14989,14991,14994,2,5,0
4258,1,1,14990,14994,14995,4,5,0
4259,1,3,14991,14995,14998,4,7,0
4260,2,1,14993,14998,14999,5,6,0
4261,4,1,14997,14999,15000,2,3,0
4262,5,1,15002,15002,15003,0,1,2
4263,1,3,15003,15003,15006,0,3,0
4264,2,2,15005,15006,15008,1,3,0
4265,2,1,15007,15008,15009,1,2,0
4266,2,3,15009,15009,15012,0,3,0
4267,2,1,15011,15012,15013,1,2,0
4268,5,3,15016,15016,15019,0,3,3
4269,2,2,15018,15019,15021,1,3,0
4270,1,1,15019,15021,15022,2,3,0
4271,2,3,15021,15022,15025,1,4,0
4272,5,2,15026,15026,15028,0,2,1
4273,4,3,15030,15030,15033,0,3,2
4274,3,1,15033,15033,15034,0,1,0
4275,3,1,15036,15036,15037,0,1,2
4276,6,1,15042,15042,15043,0,1,5
4277,6,2,15048,15048,15050,0,2,5
4278,6,3,15054,15054,15057,0,3,4
4279,2,3,15056,15057,15060,1,4,0
4280,1,1,15057,15060,15061,3,4,0
4281,1,2,15058,15061,15063,3,5,0
4282,1,3,15059,15063,15066,4,7,0
4283,5,2,15064,15066,15068,2,4,0
4284,3,3,15067,15068,15071,1,4,0
4285,5,3,15072,15072,15075,0,3,1
4286,5,1,15077,15077,15078,0,1,2
4287,2,3,15079,15079,15082,0,3,1
4288,1,2,15080,15082,15084,2,4,0
4289,3,2,15083,15084,15086,1,3,0
4290,4,2,15087,15087,15089,0,2,1
4291,1,2,15088,15089,15091,1,3,0
4292,4,1,15092,15092,15093,0,1,1
4293,2,2,15094,15094,15096,0,2,1
4294,4,2,15098,15098,15100,0,2,2
4295,4,3,15102,15102,15105,0,3,2
4296,2,3,15104,15105,15108,1,4,0
4297,4,3,15108,15108,15111,0,3,0
4298,6,2,15114,15114,15116,0,2,3
4299,3,1,15117,15117,15118,0,1,1
4300,4,3,15121,15121,15124,0,3,3
4301,4,1,15125,15125,15126,0,1,1
4302,5,1,15130,15130,15131,0,1,4
4303,6,2,15136,15136,15138,0,2,5
4304,2,1,15138,15138,15139,0,1,0
4305,6,1,15144,15144,15145,0,1,5
4306,5,1,15149,15149,15150,0,1,4
4307,1,1,15150,15150,15151,0,1,0
4308,6,1,15156,15156,15157,0,1,5
4309,3,3,15159,15159,15162,0,3,2
4310,3,2,15162,15162,15164,0,2,0
4311,4,2,15166,15166,15168,0,2,2
4312,3,2,15169,15169,15171,0,2,1
4313,1,2,15170,15171,15173,1,3,0
4314,2,2,15172,15173,15175,1,3,0
4315,2,1,15174,15175,15176,1,2,0
4316,4,1,15178,15178,15179,0,1,2
4317,5,2,15183,15183,15185,0,2,4
4318,1,2,15184,15185,15187,1,3,0
4319,5,1,15189,15189,15190,0,1,2
4320,2,2,15191,15191,15193,0,2,1
4321,1,2,15192,15193,15195,1,3,0
4322,3,1,15195,15195,15196,0,1,0
4323,5,1,15200,15200,15201,0,1,4
4324,2,2,15202,15202,15204,0,2,1
4325,1,2,15203,15204,15206,1,3,0
4326,1,1,15204,15206,15207,2,3,0
4327,6,2,15210,15210,15212,0,2,3
4328,6,2,15216,15216,15218,0,2,4
4329,5,1,15221,15221,15222,0,1,3
4330,4,3,15225,15225,15228,0,3,3
4331,3,1,15228,15228,15229,0,1,0
4332,1,1,15229,15229,15230,0,1,0
4333,1,3,15230,15230,15233,0,3,0
4334,5,2,15235,15235,15237,0,2,2
4335,6,3,15241,15241,15244,0,3,4
4336,3,3,15244,15244,15247,0,3,0
4337,3,1,15247,15247,15248,0,1,0
4338,2,1,15249,15249,15250,0,1,1
4339,2,1,15251,15251,15252,0,1,1
4340,1,2,15252,15252,15254,0,2,0
4341,2,3,15254,15254,15257,0,3,0
4342,1,3,15255,15257,15260,2,5,0
4343,2,1,15257,15260,15261,3,4,0
4344,1,1,15258,15261,15262,3,4,0
4345,5,2,15263,15263,15265,0,2,1
4346,6,3,15269,15269,15272,0,3,4
4347,2,1,15271,15272,15273,1,2,0
4348,3,3,15274,15274,15277,0,3,1
4349,4,1,15278,15278,15279,0,1,1
4350,1,2,15279,15279,15281,0,2,0
4351,3,3,15282,15282,15285,0,3,1
4352,3,2,15285,15285,15287,0,2,0
4353,1,3,15286,15287,15290,1,4,0
4354,5,3,15291,15291,15294,0,3,1
4355,2,2,15293,15294,15296,1,3,0
4356,1,3,15294,15296,15299,2,5,0
4357,5,1,15299,15299,15300,0,1,0
4358,4,3,15303,15303,15306,0,3,3
4359,6,2,15309,15309,15311,0,2,3
4360,6,2,15315,15315,15317,0,2,4
4361,2,1,15317,15317,15318,0,1,0
4362,2,1,15319,15319,15320,0,1,1
4363,6,3,15325,15325,15328,0,3,5
4364,5,1,15330,15330,15331,0,1,2
4365,2,3,15332,15332,15335,0,3,1
4366,1,2,15333,15335,15337,2,4,0
4367,5,2,15338,15338,15340,0,2,1
4368,2,3,15340,15340,15343,0,3,0
4369,6,2,15346,15346,15348,0,2,3
4370,6,1,15352,15352,15353,0,1,4
4371,4,2,15356,15356,15358,0,2,3
4372,1,3,15357,15358,15361,1,4,0
4373,2,2,15359,15361,15363,2,4,0
4374,6,1,15365,15365,15366,0,1,2
4375,3,3,15368,15368,15371,0,3,2
4376,6,3,15374,15374,15377,0,3,3
4377,6,2,15380,15380,15382,0,2,3
4378,1,1,15381,15382,15383,1,2,0
4379,5,3,15386,15386,15389,0,3,3
4380,1,1,15387,15389,15390,2,3,0
4381,2,1,15389,15390,15391,1,2,0
4382,3,3,15392,15392,15395,0,3,1
4383,2,2,15394,15395,15397,1,3,0
4384,3,3,15397,15397,15400,0,3,0
4385,6,2,15403,15403,15405,0,2,3
4386,4,3,15407,15407,15410,0,3,2
4387,1,3,15408,15410,15413,2,5,0
4388,6,3,15414,15414,15417,0,3,1
4389,5,1,15419,15419,15420,0,1,2
4390,4,3,15423,15423,15426,0,3,3
4391,1,1,15424,15426,15427,2,3,0
4392,1,2,15425,15427,15429,2,4,0
4393,3,1,15428,15429,15430,1,2,0
4394,6,2,15434,15434,15436,0,2,4
4395,3,3,15437,15437,15440,0,3,1
4396,2,1,15439,15440,15441,1,2,0
4397,5,3,15444,15444,15447,0,3,3
4398,3,1,15447,15447,15448,0,1,0
4399,3,1,15450,15450,15451,0,1,2
4400,5,2,15455,15455,15457,0,2,4
4401,2,2,15457,15457,15459,0,2,0
4402,6,2,15463,15463,15465,0,2,4
4403,2,1,15465,15465,15466,0,1,0
4404,4,1,15469,15469,15470,0,1,3
4405,5,3,15474,15474,15477,0,3,4
4406,5,3,15479,15479,15482,0,3,2
4407,4,1,15483,15483,15484,0,1,1
4408,1,2,15484,15484,15486,0,2,0
4409,4,3,15488,15488,15491,0,3,2
4410,5,2,15493,15493,15495,0,2,2
4411,4,1,15497,15497,15498,0,1,2
4412,4,3,15501,15501,15504,0,3,3
4413,5,3,15506,15506,15509,0,3,2
4414,6,2,15512,15512,15514,0,2,3
4415,6,1,15518,15518,15519,0,1,4
4416,1,2,15519,15519,15521,0,2,0
4417,2,1,15521,15521,15522,0,1,0
4418,6,1,15527,15527,15528,0,1,5
4419,2,1,15529,15529,15530,0,1,1
4420,2,2,15531,15531,15533,0,2,1
4421,2,2,15533,15533,15535,0,2,0
4422,2,1,15535,15535,15536,0,1,0
4423,3,1,15538,15538,15539,0,1,2
4424,1,1,15539,15539,15540,0,1,0
4425,3,2,15542,15542,15544,0,2,2
4426,1,3,15543,15544,15547,1,4,0
4427,6,1,15549,15549,15550,0,1,2
4428,5,2,15554,15554,15556,0,2,4
4429,1,1,15555,15556,15557,1,2,0
4430,6,1,15561,15561,15562,0,1,4
4431,1,1,15562,15562,15563,0,1,0
4432,1,1,15563,15563,15564,0,1,0
4433,2,2,15565,15565,15567,0,2,1
4434,4,2,15569,15569,15571,0,2,2
4435,3,2,15572,15572,15574,0,2,1
4436,3,3,15575,15575,15578,0,3,1
4437,6,2,15581,15581,15583,0,2,3
4438,3,3,15584,15584,15587,0,3,1
4439,4,2,15588,15588,15590,0,2,1
4440,2,2,15590,15590,15592,0,2,0
4441,1,1,15591,15592,15593,1,2,0
4442,6,3,15597,15597,15600,0,3,4
4443,6,1,15603,15603,15604,0,1,3
4444,6,3,15609,15609,15612,0,3,5
4445,3,1,15612,15612,15613,0,1,0
4446,1,1,15613,15613,15614,0,1,0
4447,1,1,15614,15614,15615,0,1,0
4448,1,3,15615,15615,15618,0,3,0
4449,5,1,15620,15620,15621,0,1,2
4450,1,3,15621,15621,15624,0,3,0
4451,2,2,15623,15624,15626,1,3,0
4452,2,1,15625,15626,15627,1,2,0
4453,2,2,15627,15627,15629,0,2,0
4454,2,3,15629,15629,15632,0,3,0
4455,6,3,15635,15635,15638,0,3,3
4456,5,3,15640,15640,15643,0,3,2
4457,5,3,15645,15645,15648,0,3,2
4458,1,3,15646,15648,15651,2,5,0
4459,1,3,15647,15651,15654,4,7,0
4460,5,1,15652,15654,15655,2,3,0
4461,5,1,15657,15657,15658,0,1,2
4462,1,2,15658,15658,15660,0,2,0
4463,2,2,15660,15660,15662,0,2,0
4464,1,2,15661,15662,15664,1,3,0
4465,2,2,15663,15664,15666,1,3,0
4466,5,1,15668,15668,15669,0,1,2
4467,3,1,15671,15671,15672,0,1,2
4468,2,3,15673,15673,15676,0,3,1
4469,6,3,15679,15679,15682,0,3,3
4470,5,1,15684,15684,15685,0,1,2
4471,3,3,15687,15687,15690,0,3,2
4472,5,3,15692,15692,15695,0,3,2
4473,4,3,15696,15696,15699,0,3,1
4474,2,3,15698,15699,15702,1,4,0
4475,4,1,15702,15702,15703,0,1,0
4476,1,2,15703,15703,15705,0,2,0
4477,1,2,15704,15705,15707,1,3,0
4478,5,3,15709,15709,15712,0,3,2
4479,3,3,15712,15712,15715,0,3,0
4480,2,2,15714,15715,15717,1,3,0
4481,2,3,15716,15717,15720,1,4,0
4482,1,3,15717,15720,15723,3,6,0
4483,2,1,15719,15723,15724,4,5,0
4484,2,3,15721,15724,15727,3,6,0
4485,1,1,15722,15727,15728,5,6,0
4486,1,3,15723,15728,15731,5,8,0
4487,5,1,15728,15731,15732,3,4,0
4488,2,3,15730,15732,15735,2,5,0
4489,3,2,15733,15735,15737,2,4,0
4490,2,2,15735,15737,15739,2,4,0
4491,2,1,15737,15739,15740,2,3,0
4492,5,2,15742,15742,15744,0,2,2
4493,6,1,15748,15748,15749,0,1,4
4494,1,2,15749,15749,15751,0,2,0
4495,6,2,15755,15755,15757,0,2,4
4496,3,3,15758,15758,15761,0,3,1
4497,5,3,15763,15763,15766,0,3,2
4498,1,1,15764,15766,15767,2,3,0
4499,3,1,15767,15767,15768,0,1,0
4500,4,1,15771,15771,15772,0,1,3
4501,1,3,15772,15772,15775,0,3,0
4502,5,1,15777,15777,15778,0,1,2
4503,2,3,15779,15779,15782,0,3,1
4504,3,1,15782,15782,15783,0,1,0
4505,1,3,15783,15783,15786,0,3,0
4506,1,1,15784,15786,15787,2,3,0
4507,6,3,15790,15790,15793,0,3,3
4508,2,1,15792,15793,15794,1,2,0
4509,1,2,15793,15794,15796,1,3,0
4510,3,3,15796,15796,15799,0,3,0
4511,1,3,15797,15799,15802,2,5,0
4512,5,2,15802,15802,15804,0,2,0
4513,2,2,15804,15804,15806,0,2,0
4514,1,2,15805,15806,15808,1,3,0
4515,4,1,15809,15809,15810,0,1,1
4516,4,1,15813,15813,15814,0,1,3
4517,1,1,15814,15814,15815,0,1,0
4518,3,1,15817,15817,15818,0,1,2
4519,5,3,15822,15822,15825,0,3,4
4520,2,3,15824,15825,15828,1,4,0
4521,6,2,15830,15830,15832,0,2,2
4522,4,1,15834,15834,15835,0,1,2
4523,2,1,15836,15836,15837,0,1,1
4524,4,2,15840,15840,15842,0,2,3
4525,4,1,15844,15844,15845,0,1,2
4526,5,3,15849,15849,15852,0,3,4
4527,1,3,15850,15852,15855,2,5,0
4528,2,1,15852,15855,15856,3,4,0
4529,3,1,15855,15856,15857,1,2,0
4530,5,3,15860,15860,15863,0,3,3
4531,6,2,15866,15866,15868,0,2,3
4532,4,2,15870,15870,15872,0,2,2
4533,2,1,15872,15872,15873,0,1,0
4534,6,2,15878,15878,15880,0,2,5
4535,5,3,15883,15883,15886,0,3,3
4536,2,1,15885,15886,15887,1,2,0
4537,5,3,15890,15890,15893,0,3,3
4538,1,2,15891,15893,15895,2,4,0
4539,3,3,15894,15895,15898,1,4,0
4540,6,1,15900,15900,15901,0,1,2
4541,2,1,15902,15902,15903,0,1,1
4542,6,1,15908,15908,15909,0,1,5
4543,5,2,15913,15913,15915,0,2,4
4544,2,1,15915,15915,15916,0,1,0
4545,5,3,15920,15920,15923,0,3,4
4546,3,3,15923,15923,15926,0,3,0
4547,3,2,15926,15926,15928,0,2,0
4548,2,3,15928,15928,15931,0,3,0
4549,2,3,15930,15931,15934,1,4,0
4550,5,3,15935,15935,15938,0,3,1
4551,3,3,15938,15938,15941,0,3,0
4552,4,3,15942,15942,15945,0,3,1
4553,5,3,15947,15947,15950,0,3,2
4554,6,2,15953,15953,15955,0,2,3
4555,4,3,15957,15957,15960,0,3,2
4556,3,2,15960,15960,15962,0,2,0
4557,1,1,15961,15962,15963,1,2,0
4558,5,1,15966,15966,15967,0,1,3
4559,5,3,15971,15971,15974,0,3,4
4560,1,3,15972,15974,15977,2,5,0
4561,5,3,15977,15977,15980,0,3,0
4562,3,2,15980,15980,15982,0,2,0
4563,3,2,15983,15983,15985,0,2,1
4564,4,1,15987,15987,15988,0,1,2
4565,2,2,15989,15989,15991,0,2,1
4566,4,3,15993,15993,15996,0,3,2
4567,4,1,15997,15997,15998,0,1,1
4568,2,3,15999,15999,16002,0,3,1
4569,1,3,16000,16002,16005,2,5,0
4570,3,2,16003,16005,16007,2,4,0
4571,6,1,16009,16009,16010,0,1,2
4572,6,1,16015,16015,16016,0,1,5
4573,3,1,16018,16018,16019,0,1,2
4574,6,3,16024,16024,16027,0,3,5
4575,3,3,16027,16027,16030,0,3,0
4576,2,1,16029,16030,16031,1,2,0
4577,2,2,16031,16031,16033,0,2,0
4578,1,3,16032,16033,16036,1,4,0
4579,5,1,16037,16037,16038,0,1,1
4580,1,1,16038,16038,16039,0,1,0
4581,4,1,16042,16042,16043,0,1,3
4582,1,1,16043,16043,16044,0,1,0
4583,5,3,16048,16048,16051,0,3,4
4584,6,1,16054,16054,16055,0,1,3
4585,1,3,16055,16055,16058,0,3,0
4586,3,1,16058,16058,16059,0,1,0
4587,4,2,16062,16062,16064,0,2,3
4588,1,1,16063,16064,16065,1,2,0
4589,4,2,16067,16067,16069,0,2,2
4590,2,2,16069,16069,16071,0,2,0
4591,1,1,16070,16071,16072,1,2,0
4592,1,1,16071,16072,16073,1,2,0
4593,3,1,16074,16074,16075,0,1,1
4594,4,3,16078,16078,16081,0,3,3
4595,4,2,16082,16082,16084,0,2,1
4596,5,3,16087,16087,16090,0,3,3
4597,5,1,16092,16092,16093,0,1,2
4598,6,3,16098,16098,16101,0,3,5
4599,3,1,16101,16101,16102,0,1,0
4600,3,3,16104,16104,16107,0,3,2
4601,1,2,16105,16107,16109,2,4,0
4602,3,2,16108,16109,16111,1,3,0
4603,5,2,16113,16113,16115,0,2,2
4604,3,2,16116,16116,16118,0,2,1
4605,6,2,16122,16122,16124,0,2,4
4606,3,1,16125,16125,16126,0,1,1
4607,2,1,16127,16127,16128,0,1,1
4608,5,1,16132,16132,16133,0,1,4
4609,2,3,16134,16134,16137,0,3,1
4610,2,3,16136,16137,16140,1,4,0
4611,1,2,16137,16140,16142,3,5,0
4612,3,3,16140,16142,16145,2,5,0
4613,6,1,16146,16146,16147,0,1,1
4614,1,2,16147,16147,16149,0,2,0
4615,2,3,16149,16149,16152,0,3,0
4616,4,1,16153,16153,16154,0,1,1
4617,3,3,16156,16156,16159,0,3,2
4618,4,3,16160,16160,16163,0,3,1
4619,5,3,16165,16165,16168,0,3,2
4620,6,2,16171,16171,16173,0,2,3
4621,4,1,16175,16175,16176,0,1,2
4622,5,2,16180,16180,16182,0,2,4
4623,3,3,16183,16183,16186,0,3,1
4624,5,3,16188,16188,16191,0,3,2
4625,5,2,16193,16193,16195,0,2,2
4626,6,2,16199,16199,16201,0,2,4
4627,4,1,16203,16203,16204,0,1,2
4628,6,1,16209,16209,16210,0,1,5
4629,1,3,16210,16210,16213,0,3,0
4630,2,1,16212,16213,16214,1,2,0
4631,2,2,16214,16214,16216,0,2,0
4632,6,2,16220,16220,16222,0,2,4
4633,6,2,16226,16226,16228,0,2,4
4634,5,3,16231,16231,16234,0,3,3
4635,3,1,16234,16234,16235,0,1,0
4636,3,2,16237,16237,16239,0,2,2
4637,4,3,16241,16241,16244,0,3,2
4638,4,2,16245,16245,16247,0,2,1
4639,5,3,16250,16250,16253,0,3,3
4640,1,2,16251,16253,16255,2,4,0
4641,3,1,16254,16255,16256,1,2,0
4642,4,3,16258,16258,16261,0,3,2
4643,3,1,16261,16261,16262,0,1,0
4644,2,2,16263,16263,16265,0,2,1
4645,2,1,16265,16265,16266,0,1,0
4646,3,1,16268,16268,16269,0,1,2
4647,4,1,16272,16272,16273,0,1,3
4648,4,1,16276,16276,16277,0,1,3
4649,2,2,16278,16278,16280,0,2,1
4650,5,2,16283,16283,16285,0,2,3
4651,4,2,16287,16287,16289,0,2,2
4652,2,2,16289,16289,16291,0,2,0
4653,1,2,16290,16291,16293,1,3,0
4654,5,2,16295,16295,16297,0,2,2
4655,5,1,16300,16300,16301,0,1,3
4656,4,1,16304,16304,16305,0,1,3
4657,4,3,16308,16308,16311,0,3,3
4658,6,3,16314,16314,16317,0,3,3
4659,6,2,16320,16320,16322,0,2,3
4660,1,2,16321,16322,16324,1,3,0
4661,3,1,16324,16324,16325,0,1,0
4662,1,2,16325,16325,16327,0,2,0
4663,2,3,16327,16327,16330,0,3,0
4664,4,1,16331,16331,16332,0,1,1
4665,3,2,16334,16334,16336,0,2,2
4666,4,3,16338,16338,16341,0,3,2
4667,4,3,16342,16342,16345,0,3,1
4668,4,1,16346,16346,16347,0,1,1
4669,6,2,16352,16352,16354,0,2,5
4670,6,1,16358,16358,16359,0,1,4
4671,3,1,16361,16361,16362,0,1,2
4672,2,1,16363,16363,16364,0,1,1
4673,4,3,16367,16367,16370,0,3,3
4674,3,1,16370,16370,16371,0,1,0
4675,5,2,16375,16375,16377,0,2,4
4676,5,3,16380,16380,16383,0,3,3
4677,1,1,16381,16383,16384,2,3,0
4678,2,1,16383,16384,16385,1,2,0
4679,2,3,16385,16385,16388,0,3,0
4680,5,3,16390,16390,16393,0,3,2
4681,6,3,16396,16396,16399,0,3,3
4682,3,2,16399,16399,16401,0,2,0
4683,1,2,16400,16401,16403,1,3,0
4684,2,3,16402,16403,16406,1,4,0
4685,4,1,16406,16406,16407,0,1,0
4686,6,2,16412,16412,16414,0,2,5
4687,2,2,16414,16414,16416,0,2,0
4688,5,1,16419,16419,16420,0,1,3
4689,1,3,16420,16420,16423,0,3,0
4690,3,2,16423,16423,16425,0,2,0
4691,6,1,16429,16429,16430,0,1,4
4692,6,3,16435,16435,16438,0,3,5
4693,6,3,16441,16441,16444,0,3,3
4694,1,1,16442,16444,16445,2,3,0
4695,5,1,16447,16447,16448,0,1,2
4696,2,3,16449,16449,16452,0,3,1
4697,1,3,16450,16452,16455,2,5,0
4698,2,3,16452,16455,16458,3,6,0
4699,5,1,16457,16458,16459,1,2,0
4700,6,3,16463,16463,16466,0,3,4
4701,6,3,16469,16469,16472,0,3,3
4702,4,3,16473,16473,16476,0,3,1
4703,1,1,16474,16476,16477,2,3,0
4704,5,1,16479,16479,16480,0,1,2
4705,4,1,16483,16483,16484,0,1,3
4706,1,1,16484,16484,16485,0,1,0
4707,6,2,16490,16490,16492,0,2,5
4708,6,3,16496,16496,16499,0,3,4
4709,5,3,16501,16501,16504,0,3,2
4710,4,2,16505,16505,16507,0,2,1
4711,1,1,16506,16507,16508,1,2,0
4712,2,1,16508,16508,16509,0,1,0
4713,6,3,16514,16514,16517,0,3,5
4714,2,1,16516,16517,16518,1,2,0
4715,6,2,16522,16522,16524,0,2,4
4716,6,2,16528,16528,16530,0,2,4
4717,1,2,16529,16530,16532,1,3,0
4718,6,2,16535,16535,16537,0,2,3
4719,1,2,16536,16537,16539,1,3,0
4720,4,2,16540,16540,16542,0,2,1
4721,6,1,16546,16546,16547,0,1,4
4722,5,1,16551,16551,16552,0,1,4
4723,5,1,16556,16556,16557,0,1,4
4724,2,1,16558,16558,16559,0,1,1
4725,5,1,16563,16563,16564,0,1,4
4726,4,1,16567,16567,16568,0,1,3
4727,5,2,16572,16572,16574,0,2,4
4728,3,2,16575,16575,16577,0,2,1
4729,6,1,16581,16581,16582,0,1,4
4730,5,3,16586,16586,16589,0,3,4
4731,2,3,16588,16589,16592,1,4,0
4732,2,2,16590,16592,16594,2,4,0
4733,5,3,16595,16595,16598,0,3,1
4734,1,3,16596,16598,16601,2,5,0
4735,4,3,16600,16601,16604,1,4,0
4736,2,3,16602,16604,16607,2,5,0
4737,5,1,16607,16607,16608,0,1,0
4738,3,2,16610,16610,16612,0,2,2
4739,2,2,16612,16612,16614,0,2,0
4740,2,2,16614,16614,16616,0,2,0
4741,2,2,16616,16616,16618,0,2,0
4742,1,1,16617,16618,16619,1,2,0
4743,3,2,16620,16620,16622,0,2,1
4744,4,1,16624,16624,16625,0,1,2
4745,1,3,16625,16625,16628,0,3,0
4746,5,3,16630,16630,16633,0,3,2
4747,5,3,16635,16635,16638,0,3,2
4748,3,3,16638,16638,16641,0,3,0
4749,6,2,16644,16644,16646,0,2,3
4750,6,3,16650,16650,16653,0,3,4
4751,5,3,16655,16655,16658,0,3,2
4752,2,3,16657,16658,16661,1,4,0
4753,6,2,16663,16663,16665,0,2,2
4754,5,2,16668,16668,16670,0,2,3
4755,4,1,16672,16672,16673,0,1,2
4756,1,3,16673,16673,16676,0,3,0
4757,1,2,16674,16676,16678,2,4,0
4758,1,2,16675,16678,16680,3,5,0
4759,2,1,16677,16680,16681,3,4,0
4760,5,1,16682,16682,16683,0,1,1
4761,4,2,16686,16686,16688,0,2,3
4762,6,3,16692,16692,16695,0,3,4
4763,5,3,16697,16697,16700,0,3,2
4764,3,1,16700,16700,16701,0,1,0
4765,4,2,16704,16704,16706,0,2,3
4766,2,1,16706,16706,16707,0,1,0
4767,2,2,16708,16708,16710,0,2,1
4768,1,3,16709,16710,16713,1,4,0
4769,3,1,16712,16713,16714,1,2,0
4770,5,2,16717,16717,16719,0,2,3
4771,2,2,16719,16719,16721,0,2,0
4772,1,2,16720,16721,16723,1,3,0
4773,1,1,16721,16723,16724,2,3,0
4774,5,1,16726,16726,16727,0,1,2
4775,2,3,16728,16728,16731,0,3,1
4776,3,3,16731,16731,16734,0,3,0
4777,6,1,16737,16737,16738,0,1,3
4778,6,1,16743,16743,16744,0,1,5
4779,3,1,16746,16746,16747,0,1,2
4780,2,3,16748,16748,16751,0,3,1
4781,5,3,16753,16753,16756,0,3,2
4782,1,2,16754,16756,16758,2,4,0
4783,4,1,16758,16758,16759,0,1,0
4784,5,2,16763,16763,16765,0,2,4
4785,1,3,16764,16765,16768,1,4,0
4786,4,1,16768,16768,16769,0,1,0
4787,3,3,16771,16771,16774,0,3,2
4788,4,1,16775,16775,16776,0,1,1
4789,4,2,16779,16779,16781,0,2,3
4790,5,1,16784,16784,16785,0,1,3
4791,6,3,16790,16790,16793,0,3,5
4792,4,3,16794,16794,16797,0,3,1
4793,5,2,16799,16799,16801,0,2,2
4794,5,3,16804,16804,16807,0,3,3
4795,3,2,16807,16807,16809,0,2,0
4796,2,1,16809,16809,16810,0,1,0
4797,5,2,16814,16814,16816,0,2,4
4798,2,2,16816,16816,16818,0,2,0
4799,6,2,16822,16822,16824,0,2,4
4800,5,2,16827,16827,16829,0,2,3
4801,3,3,16830,16830,16833,0,3,1
4802,1,3,16831,16833,16836,2,5,0
4803,5,1,16836,16836,16837,0,1,0
4804,3,1,16839,16839,16840,0,1,2
4805,1,2,16840,16840,16842,0,2,0
4806,1,1,16841,16842,16843,1,2,0
4807,5,3,16846,16846,16849,0,3,3
4808,4,2,16850,16850,16852,0,2,1
4809,2,2,16852,16852,16854,0,2,0
4810,2,3,16854,16854,16857,0,3,0
4811,1,2,16855,16857,16859,2,4,0
4812,5,1,16860,16860,16861,0,1,1
4813,5,2,16865,16865,16867,0,2,4
4814,1,2,16866,16867,16869,1,3,0
4815,5,3,16871,16871,16874,0,3,2
4816,6,1,16877,16877,16878,0,1,3
4817,6,2,16883,16883,16885,0,2,5
4818,6,3,16889,16889,16892,0,3,4
4819,4,3,16893,16893,16896,0,3,1
4820,2,1,16895,16896,16897,1,2,0
4821,6,3,16901,16901,16904,0,3,4
4822,4,1,16905,16905,16906,0,1,1
4823,5,2,16910,16910,16912,0,2,4
4824,3,2,16913,16913,16915,0,2,1
4825,4,3,16917,16917,16920,0,3,2
4826,3,2,16920,16920,16922,0,2,0
4827,1,3,16921,16922,16925,1,4,0
4828,3,1,16924,16925,16926,1,2,0
4829,1,1,16925,16926,16927,1,2,0
4830,1,1,16926,16927,16928,1,2,0
4831,6,2,16932,16932,16934,0,2,4
4832,6,2,16938,16938,16940,0,2,4
4833,6,2,16944,16944,16946,0,2,4
4834,3,1,16947,16947,16948,0,1,1
4835,1,2,16948,16948,16950,0,2,0
4836,2,1,16950,16950,16951,0,1,0
4837,6,3,16956,16956,16959,0,3,5
4838,1,1,16957,16959,16960,2,3,0
4839,5,1,16962,16962,16963,0,1,2
4840,5,2,16967,16967,16969,0,2,4
4841,2,1,16969,16969,16970,0,1,0
4842,6,1,16975,16975,16976,0,1,5
4843,4,3,16979,16979,16982,0,3,3
4844,6,2,16985,16985,16987,0,2,3
4845,4,2,16989,16989,16991,0,2,2
4846,6,3,16995,16995,16998,0,3,4
4847,2,1,16997,16998,16999,1,2,0
4848,2,1,16999,16999,17000,0,1,0
4849,4,1,17003,17003,17004,0,1,3
4850,1,2,17004,17004,17006,0,2,0
4851,6,3,17010,17010,17013,0,3,4
4852,6,1,17016,17016,17017,0,1,3
4853,2,1,17018,17018,17019,0,1,1
4854,2,1,17020,17020,17021,0,1,1
4855,1,1,17021,17021,17022,0,1,0
4856,4,2,17025,17025,17027,0,2,3
4857,6,3,17031,17031,17034,0,3,4
4858,1,2,17032,17034,17036,2,4,0
4859,1,2,17033,17036,17038,3,5,0
4860,3,2,17036,17038,17040,2,4,0
4861,6,1,17042,17042,17043,0,1,2
4862,6,1,17048,17048,17049,0,1,5
4863,4,1,17052,17052,17053,0,1,3
4864,5,1,17057,17057,17058,0,1,4
4865,4,3,17061,17061,17064,0,3,3
4866,1,1,17062,17064,17065,2,3,0
4867,5,1,17067,17067,17068,0,1,2
4868,2,1,17069,17069,17070,0,1,1
4869,4,2,17073,17073,17075,0,2,3
4870,1,3,17074,17075,17078,1,4,0
4871,1,3,17075,17078,17081,3,6,0
4872,6,2,17081,17081,17083,0,2,0
4873,1,1,17082,17083,17084,1,2,0
4874,1,3,17083,17084,17087,1,4,0
4875,3,3,17086,17087,17090,1,4,0
4876,5,1,17091,17091,17092,0,1,1
4877,2,2,17093,17093,17095,0,2,1
4878,2,3,17095,17095,17098,0,3,0
4879,4,3,17099,17099,17102,0,3,1
4880,2,1,17101,17102,17103,1,2,0
4881,4,2,17105,17105,17107,0,2,2
4882,3,2,17108,17108,17110,0,2,1
4883,4,2,17112,17112,17114,0,2,2
4884,5,2,17117,17117,17119,0,2,3
4885,3,1,17120,17120,17121,0,1,1
4886,2,1,17122,17122,17123,0,1,1
4887,2,3,17124,17124,17127,0,3,1
4888,4,2,17128,17128,17130,0,2,1
4889,6,3,17134,17134,17137,0,3,4
4890,4,3,17138,17138,17141,0,3,1
4891,3,1,17141,17141,17142,0,1,0
4892,2,1,17143,17143,17144,0,1,1
4893,6,2,17149,17149,17151,0,2,5
4894,1,3,17150,17151,17154,1,4,0
4895,6,3,17156,17156,17159,0,3,2
4896,5,3,17161,17161,17164,0,3,2
4897,4,3,17165,17165,17168,0,3,1
4898,1,1,17166,17168,17169,2,3,0
4899,2,1,17168,17169,17170,1,2,0
4900,3,2,17171,17171,17173,0,2,1
4901,2,3,17173,17173,17176,0,3,0
4902,1,1,17174,17176,17177,2,3,0
4903,1,1,17175,17177,17178,2,3,0
4904,2,3,17177,17178,17181,1,4,0
4905,6,1,17183,17183,17184,0,1,2
4906,3,1,17186,17186,17187,0,1,2
4907,2,3,17188,17188,17191,0,3,1
4908,6,2,17194,17194,17196,0,2,3
4909,1,1,17195,17196,17197,1,2,0
4910,4,1,17199,17199,17200,0,1,2
4911,1,1,17200,17200,17201,0,1,0
4912,3,3,17203,17203,17206,0,3,2
4913,1,3,17204,17206,17209,2,5,0
4914,4,2,17208,17209,17211,1,3,0
4915,5,1,17213,17213,17214,0,1,2
4916,2,2,17215,17215,17217,0,2,1
4917,2,2,17217,17217,17219,0,2,0
4918,5,3,17222,17222,17225,0,3,3
4919,5,3,17227,17227,17230,0,3,2
4920,5,3,17232,17232,17235,0,3,2
4921,4,1,17236,17236,17237,0,1,1
4922,6,2,17242,17242,17244,0,2,5
4923,5,3,17247,17247,17250,0,3,3
4924,1,2,17248,17250,17252,2,4,0
4925,2,3,17250,17252,17255,2,5,0
4926,2,1,17252,17255,17256,3,4,0
4927,1,3,17253,17256,17259,3,6,0
4928,1,1,17254,17259,17260,5,6,0
4929,2,2,17256,17260,17262,4,6,0
4930,1,2,17257,17262,17264,5,7,0
4931,2,3,17259,17264,17267,5,8,0
4932,1,3,17260,17267,17270,7,10,0
4933,6,1,17266,17270,17271,4,5,0
4934,1,2,17267,17271,17273,4,6,0
4935,4,2,17271,17273,17275,2,4,0
4936,3,2,17274,17275,17277,1,3,0
4937,3,3,17277,17277,17280,0,3,0
4938,2,1,17279,17280,17281,1,2,0
4939,4,2,17283,17283,17285,0,2,2
4940,5,2,17288,17288,17290,0,2,3
4941,4,3,17292,17292,17295,0,3,2
4942,4,3,17296,17296,17299,0,3,1
4943,3,3,17299,17299,17302,0,3,0
4944,1,1,17300,17302,17303,2,3,0
4945,4,3,17304,17304,17307,0,3,1
4946,4,3,17308,17308,17311,0,3,1
4947,3,2,17311,17311,17313,0,2,0
4948,6,3,17317,17317,17320,0,3,4
4949,1,3,17318,17320,17323,2,5,0
4950,1,1,17319,17323,17324,4,5,0
4951,1,1,17320,17324,17325,4,5,0
4952,5,3,17325,17325,17328,0,3,0
4953,5,1,17330,17330,17331,0,1,2
4954,2,1,17332,17332,17333,0,1,1
4955,4,1,17336,17336,17337,0,1,3
4956,5,1,17341,17341,17342,0,1,4
4957,4,2,17345,17345,17347,0,2,3
4958,2,1,17347,17347,17348,0,1,0
4959,2,2,17349,17349,17351,0,2,1
4960,1,2,17350,17351,17353,1,3,0
4961,3,1,17353,17353,17354,0,1,0
4962,1,3,17354,17354,17357,0,3,0
4963,3,2,17357,17357,17359,0,2,0
4964,1,2,17358,17359,17361,1,3,0
4965,3,1,17361,17361,17362,0,1,0
4966,4,1,17365,17365,17366,0,1,3
4967,3,3,17368,17368,17371,0,3,2
4968,4,3,17372,17372,17375,0,3,1
4969,3,1,17375,17375,17376,0,1,0
4970,3,3,17378,17378,17381,0,3,2
4971,5,2,17383,17383,17385,0,2,2
4972,2,3,17385,17385,17388,0,3,0
4973,5,1,17390,17390,17391,0,1,2
4974,3,2,17393,17393,17395,0,2,2
4975,4,3,17397,17397,17400,0,3,2
4976,2,2,17399,17400,17402,1,3,0
4977,5,2,17404,17404,17406,0,2,2
4978,4,3,17408,17408,17411,0,3,2
4979,3,2,17411,17411,17413,0,2,0
4980,2,1,17413,17413,17414,0,1,0
4981,5,1,17418,17418,17419,0,1,4
4982,5,1,17423,17423,17424,0,1,4
4983,1,1,17424,17424,17425,0,1,0
4984,3,3,17427,17427,17430,0,3,2
4985,4,3,17431,17431,17434,0,3,1
4986,6,1,17437,17437,17438,0,1,3
4987,2,1,17439,17439,17440,0,1,1
4988,3,3,17442,17442,17445,0,3,2
4989,1,3,17443,17445,17448,2,5,0
4990,3,1,17446,17448,17449,2,3,0
4991,1,3,17447,17449,17452,2,5,0
4992,6,2,17453,17453,17455,0,2,1
4993,4,2,17457,17457,17459,0,2,2
4994,3,3,17460,17460,17463,0,3,1
4995,3,3,17463,17463,17466,0,3,0
4996,4,2,17467,17467,17469,0,2,1
4997,1,1,17468,17469,17470,1,2,0
4998,4,3,17472,17472,17475,0,3,2
4999,4,2,17476,17476,17478,0,2,1
5000,5,2,17481,17481,17483,0,2,3
5001,5,2,17486,17486,17488,0,2,3
5002,6,2,17492,17492,17494,0,2,4
5003,3,1,17495,17495,17496,0,1,1
5004,1,2,17496,17496,17498,0,2,0
5005,1,3,17497,17498,17501,1,4,0
5006,5,1,17502,17502,17503,0,1,1
5007,2,2,17504,17504,17506,0,2,1
5008,2,1,17506,17506,17507,0,1,0
5009,4,2,17510,17510,17512,0,2,3
5010,1,2,17511,17512,17514,1,3,0
5011,1,1,17512,17514,17515,2,3,0
5012,3,3,17515,17515,17518,0,3,0
5013,6,3,17521,17521,17524,0,3,3
5014,2,3,17523,17524,17527,1,4,0
5015,6,2,17529,17529,17531,0,2,2
5016,3,3,17532,17532,17535,0,3,1
5017,4,3,17536,17536,17539,0,3,1
5018,1,3,17537,17539,17542,2,5,0
5019,6,1,17543,17543,17544,0,1,1
5020,2,1,17545,17545,17546,0,1,1
5021,2,2,17547,17547,17549,0,2,1
5022,5,3,17552,17552,17555,0,3,3
5023,2,3,17554,17555,17558,1,4,0
5024,1,1,17555,17558,17559,3,4,0
5025,3,3,17558,17559,17562,1,4,0
5026,3,3,17561,17562,17565,1,4,0
5027,1,3,17562,17565,17568,3,6,0
5028,3,2,17565,17568,17570,3,5,0
5029,2,3,17567,17570,17573,3,6,0
5030,5,2,17572,17573,17575,1,3,0
5031,3,1,17575,17575,17576,0,1,0
5032,3,2,17578,17578,17580,0,2,2
5033,2,3,17580,17580,17583,0,3,0
5034,2,1,17582,17583,17584,1,2,0
5035,1,1,17583,17584,17585,1,2,0
5036,4,3,17587,17587,17590,0,3,2
5037,4,3,17591,17591,17594,0,3,1
5038,5,2,17596,17596,17598,0,2,2
5039,3,2,17599,17599,17601,0,2,1
5040,2,3,17601,17601,17604,0,3,0
5041,4,3,17605,17605,17608,0,3,1
5042,2,1,17607,17608,17609,1,2,0
5043,6,1,17613,17613,17614,0,1,4
5044,2,2,17615,17615,17617,0,2,1
5045,5,3,17620,17620,17623,0,3,3
5046,4,2,17624,17624,17626,0,2,1
5047,3,3,17627,17627,17630,0,3,1
5048,3,3,17630,17630,17633,0,3,0
5049,1,1,17631,17633,17634,2,3,0
5050,5,2,17636,17636,17638,0,2,2
5051,4,2,17640,17640,17642,0,2,2
5052,5,2,17645,17645,17647,0,2,3
5053,4,3,17649,17649,17652,0,3,2
5054,5,2,17654,17654,17656,0,2,2
5055,2,3,17656,17656,17659,0,3,0
5056,1,1,17657,17659,17660,2,3,0
5057,4,1,17661,17661,17662,0,1,1
5058,4,2,17665,17665,17667,0,2,3
5059,3,2,17668,17668,17670,0,2,1
5060,3,3,17671,17671,17674,0,3,1
5061,2,3,17673,17674,17677,1,4,0
5062,4,3,17677,17677,17680,0,3,0
5063,2,3,17679,17680,17683,1,4,0
5064,1,2,17680,17683,17685,3,5,0
5065,2,2,17682,17685,17687,3,5,0
5066,2,2,17684,17687,17689,3,5,0
5067,6,2,17690,17690,17692,0,2,1
5068,3,1,17693,17693,17694,0,1,1
5069,6,3,17699,17699,17702,0,3,5
5070,1,1,17700,17702,17703,2,3,0
5071,6,1,17706,17706,17707,0,1,3
5072,2,3,17708,17708,17711,0,3,1
5073,3,1,17711,17711,17712,0,1,0
5074,6,2,17717,17717,17719,0,2,5
5075,6,2,17723,17723,17725,0,2,4
5076,1,2,17724,17725,17727,1,3,0
5077,4,2,17728,17728,17730,0,2,1
5078,4,2,17732,17732,17734,0,2,2
5079,3,3,17735,17735,17738,0,3,1
5080,1,1,17736,17738,17739,2,3,0
5081,2,3,17738,17739,17742,1,4,0
5082,6,2,17744,17744,17746,0,2,2
5083,4,3,17748,17748,17751,0,3,2
5084,2,3,17750,17751,17754,1,4,0
5085,3,1,17753,17754,17755,1,2,0
5086,6,3,17759,17759,17762,0,3,4
5087,4,1,17763,17763,17764,0,1,1
5088,4,2,17767,17767,17769,0,2,3
5089,3,3,17770,17770,17773,0,3,1
5090,5,1,17775,17775,17776,0,1,2
5091,3,2,17778,17778,17780,0,2,2
5092,1,1,17779,17780,17781,1,2,0
5093,5,1,17784,17784,17785,0,1,3
5094,3,3,17787,17787,17790,0,3,2
5095,3,1,17790,17790,17791,0,1,0
5096,6,1,17796,17796,17797,0,1,5
5097,4,3,17800,17800,17803,0,3,3
5098,6,2,17806,17806,17808,0,2,3
5099,2,1,17808,17808,17809,0,1,0
5100,3,3,17811,17811,17814,0,3,2
5101,4,3,17815,17815,17818,0,3,1
5102,2,3,17817,17818,17821,1,4,0
5103,1,3,17818,17821,17824,3,6,0
5104,2,3,17820,17824,17827,4,7,0
5105,2,2,17822,17827,17829,5,7,0
5106,5,1,17827,17829,17830,2,3,0
5107,1,1,17828,17830,17831,2,3,0
5108,1,3,17829,17831,17834,2,5,0
5109,3,3,17832,17834,17837,2,5,0
5110,5,1,17837,17837,17838,0,1,0
5111,3,2,17840,17840,17842,0,2,2
5112,5,1,17845,17845,17846,0,1,3
5113,2,2,17847,17847,17849,0,2,1
5114,3,1,17850,17850,17851,0,1,1
5115,3,2,17853,17853,17855,0,2,2
5116,6,3,17859,17859,17862,0,3,4
5117,1,3,17860,17862,17865,2,5,0
5118,4,1,17864,17865,17866,1,2,0
5119,4,2,17868,17868,17870,0,2,2
5120,6,3,17874,17874,17877,0,3,4
5121,6,3,17880,17880,17883,0,3,3
5122,2,2,17882,17883,17885,1,3,0
5123,1,3,17883,17885,17888,2,5,0
5124,3,3,17886,17888,17891,2,5,0
5125,3,2,17889,17891,17893,2,4,0
5126,5,3,17894,17894,17897,0,3,1
5127,1,1,17895,17897,17898,2,3,0
5128,3,2,17898,17898,17900,0,2,0
5129,4,1,17902,17902,17903,0,1,2
5130,4,3,17906,17906,17909,0,3,3
5131,3,2,17909,17909,17911,0,2,0
5132,3,3,17912,17912,17915,0,3,1
5133,3,2,17915,17915,17917,0,2,0
5134,2,2,17917,17917,17919,0,2,0
5135,1,3,17918,17919,17922,1,4,0
5136,3,2,17921,17922,17924,1,3,0
5137,2,3,17923,17924,17927,1,4,0
5138,1,2,17924,17927,17929,3,5,0
5139,6,3,17930,17930,17933,0,3,1
5140,3,3,17933,17933,17936,0,3,0
5141,1,3,17934,17936,17939,2,5,0
5142,2,3,17936,17939,17942,3,6,0
5143,4,2,17940,17942,17944,2,4,0
5144,2,3,17942,17944,17947,2,5,0
5145,5,2,17947,17947,17949,0,2,0
5146,5,1,17952,17952,17953,0,1,3
5147,3,2,17955,17955,17957,0,2,2
5148,6,2,17961,17961,17963,0,2,4
5149,2,3,17963,17963,17966,0,3,0
5150,1,1,17964,17966,17967,2,3,0
5151,5,1,17969,17969,17970,0,1,2
5152,2,1,17971,17971,17972,0,1,1
5153,4,3,17975,17975,17978,0,3,3
5154,5,1,17980,17980,17981,0,1,2
5155,4,1,17984,17984,17985,0,1,3
5156,6,1,17990,17990,17991,0,1,5
5157,6,2,17996,17996,17998,0,2,5
5158,4,1,18000,18000,18001,0,1,2
5159,1,3,18001,18001,18004,0,3,0
5160,5,2,18006,18006,18008,0,2,2
5161,6,3,18012,18012,18015,0,3,4
5162,6,3,18018,18018,18021,0,3,3
5163,4,3,18022,18022,18025,0,3,1
5164,6,1,18028,18028,18029,0,1,3
5165,3,3,18031,18031,18034,0,3,2
5166,4,3,18035,18035,18038,0,3,1
5167,3,2,18038,18038,18040,0,2,0
5168,5,2,18043,18043,18045,0,2,3
5169,6,1,18049,18049,18050,0,1,4
5170,1,2,18050,18050,18052,0,2,0
5171,6,3,18056,18056,18059,0,3,4
5172,5,3,18061,18061,18064,0,3,2
5173,2,3,18063,18064,18067,1,4,0
5174,5,3,18068,18068,18071,0,3,1
5175,6,3,18074,18074,18077,0,3,3
5176,1,3,18075,18077,18080,2,5,0
5177,3,2,18078,18080,18082,2,4,0
5178,1,2,18079,18082,18084,3,5,0
5179,5,3,18084,18084,18087,0,3,0
5180,5,1,18089,18089,18090,0,1,2
5181,4,3,18093,18093,18096,0,3,3
5182,6,2,18099,18099,18101,0,2,3
5183,2,1,18101,18101,18102,0,1,0
5184,5,3,18106,18106,18109,0,3,4
5185,4,3,18110,18110,18113,0,3,1
5186,4,1,18114,18114,18115,0,1,1
5187,5,1,18119,18119,18120,0,1,4
5188,5,2,18124,18124,18126,0,2,4
5189,2,1,18126,18126,18127,0,1,0
5190,6,3,18132,18132,18135,0,3,5
5191,2,2,18134,18135,18137,1,3,0
5192,5,2,18139,18139,18141,0,2,2
5193,4,3,18143,18143,18146,0,3,2
5194,6,1,18149,18149,18150,0,1,3
5195,5,3,18154,18154,18157,0,3,4
5196,4,1,18158,18158,18159,0,1,1
5197,5,2,18163,18163,18165,0,2,4
5198,3,1,18166,18166,18167,0,1,1
5199,4,3,18170,18170,18173,0,3,3
5200,4,1,18174,18174,18175,0,1,1
5201,5,3,18179,18179,18182,0,3,4
5202,5,3,18184,18184,18187,0,3,2
5203,3,2,18187,18187,18189,0,2,0
5204,6,2,18193,18193,18195,0,2,4
5205,5,3,18198,18198,18201,0,3,3
5206,1,3,18199,18201,18204,2,5,0
5207,1,1,18200,18204,18205,4,5,0
5208,2,2,18202,18205,18207,3,5,0
5209,3,3,18205,18207,18210,2,5,0
5210,5,2,18210,18210,18212,0,2,0
5211,3,3,18213,18213,18216,0,3,1
5212,3,1,18216,18216,18217,0,1,0
5213,2,2,18218,18218,18220,0,2,1
5214,3,2,18221,18221,18223,0,2,1
5215,6,2,18227,18227,18229,0,2,4
5216,4,3,18231,18231,18234,0,3,2
5217,2,1,18233,18234,18235,1,2,0
5218,4,3,18237,18237,18240,0,3,2
5219,5,2,18242,18242,18244,0,2,2
5220,3,3,18245,18245,18248,0,3,1
5221,4,2,18249,18249,18251,0,2,1
5222,2,1,18251,18251,18252,0,1,0
5223,1,3,18252,18252,18255,0,3,0
5224,4,1,18256,18256,18257,0,1,1
5225,3,2,18259,18259,18261,0,2,2
5226,2,1,18261,18261,18262,0,1,0
5227,6,2,18267,18267,18269,0,2,5
5228,1,2,18268,18269,18271,1,3,0
5229,4,2,18272,18272,18274,0,2,1
5230,2,2,18274,18274,18276,0,2,0
5231,4,3,18278,18278,18281,0,3,2
5232,1,3,18279,18281,18284,2,5,0
5233,3,2,18282,18284,18286,2,4,0
5234,5,1,18287,18287,18288,0,1,1
5235,3,2,18290,18290,18292,0,2,2
5236,5,3,18295,18295,18298,0,3,3
5237,6,1,18301,18301,18302,0,1,3
5238,3,3,18304,18304,18307,0,3,2
5239,4,3,18308,18308,18311,0,3,1
5240,1,1,18309,18311,18312,2,3,0
5241,6,1,18315,18315,18316,0,1,3
5242,6,2,18321,18321,18323,0,2,5
5243,4,2,18325,18325,18327,0,2,2
5244,2,1,18327,18327,18328,0,1,0
5245,3,1,18330,18330,18331,0,1,2
5246,6,1,18336,18336,18337,0,1,5
5247,2,3,18338,18338,18341,0,3,1
5248,1,1,18339,18341,18342,2,3,0
5249,3,3,18342,18342,18345,0,3,0
5250,4,1,18346,18346,18347,0,1,1
5251,5,3,18351,18351,18354,0,3,4
5252,1,2,18352,18354,18356,2,4,0
5253,3,1,18355,18356,18357,1,2,0
5254,6,2,18361,18361,18363,0,2,4
5255,2,3,18363,18363,18366,0,3,0
5256,5,1,18368,18368,18369,0,1,2
5257,5,1,18373,18373,18374,0,1,4
5258,1,1,18374,18374,18375,0,1,0
5259,3,3,18377,18377,18380,0,3,2
5260,1,3,18378,18380,18383,2,5,0
5261,4,2,18382,18383,18385,1,3,0
5262,6,3,18388,18388,18391,0,3,3
5263,2,1,18390,18391,18392,1,2,0
5264,3,1,18393,18393,18394,0,1,1
5265,6,2,18399,18399,18401,0,2,5
5266,1,2,18400,18401,18403,1,3,0
5267,1,1,18401,18403,18404,2,3,0
5268,6,2,18407,18407,18409,0,2,3
5269,1,1,18408,18409,18410,1,2,0
5270,2,3,18410,18410,18413,0,3,0
5271,5,3,18415,18415,18418,0,3,2
5272,2,1,18417,18418,18419,1,2,0
5273,5,2,18422,18422,18424,0,2,3
5274,3,1,18425,18425,18426,0,1,1
5275,5,1,18430,18430,18431,0,1,4
5276,6,3,18436,18436,18439,0,3,5
5277,4,3,18440,18440,18443,0,3,1
5278,1,3,18441,18443,18446,2,5,0
5279,1,3,18442,18446,18449,4,7,0
5280,6,1,18448,18449,18450,1,2,0
5281,3,2,18451,18451,18453,0,2,1
5282,6,1,18457,18457,18458,0,1,4
5283,2,2,18459,18459,18461,0,2,1
5284,6,3,18465,18465,18468,0,3,4
5285,4,1,18469,18469,18470,0,1,1
5286,4,2,18473,18473,18475,0,2,3
5287,1,2,18474,18475,18477,1,3,0
5288,3,2,18477,18477,18479,0,2,0
5289,6,3,18483,18483,18486,0,3,4
5290,2,3,18485,18486,18489,1,4,0
5291,2,2,18487,18489,18491,2,4,0
5292,6,1,18493,18493,18494,0,1,2
5293,1,2,18494,18494,18496,0,2,0
5294,6,2,18500,18500,18502,0,2,4
5295,4,2,18504,18504,18506,0,2,2
5296,4,2,18508,18508,18510,0,2,2
5297,5,3,18513,18513,18516,0,3,3
5298,3,1,18516,18516,18517,0,1,0
5299,5,2,18521,18521,18523,0,2,4
5300,4,1,18525,18525,18526,0,1,2
5301,4,2,18529,18529,18531,0,2,3
5302,5,2,18534,18534,18536,0,2,3
5303,5,3,18539,18539,18542,0,3,3
5304,2,2,18541,18542,18544,1,3,0
5305,3,2,18544,18544,18546,0,2,0
5306,6,1,18550,18550,18551,0,1,4
5307,1,3,18551,18551,18554,0,3,0
5308,4,3,18555,18555,18558,0,3,1
5309,4,3,18559,18559,18562,0,3,1
5310,3,2,18562,18562,18564,0,2,0
5311,5,3,18567,18567,18570,0,3,3
5312,4,2,18571,18571,18573,0,2,1
5313,3,1,18574,18574,18575,0,1,1
5314,2,2,18576,18576,18578,0,2,1
5315,6,1,18582,18582,18583,0,1,4
5316,6,3,18588,18588,18591,0,3,5
5317,6,1,18594,18594,18595,0,1,3
5318,6,2,18600,18600,18602,0,2,5
5319,3,1,18603,18603,18604,0,1,1
5320,5,1,18608,18608,18609,0,1,4
5321,2,3,18610,18610,18613,0,3,1
5322,2,2,18612,18613,18615,1,3,0
5323,3,1,18615,18615,18616,0,1,0
5324,3,2,18618,18618,18620,0,2,2
5325,4,1,18622,18622,18623,0,1,2
5326,2,1,18624,18624,18625,0,1,1
5327,4,1,18628,18628,18629,0,1,3
5328,2,2,18630,18630,18632,0,2,1
5329,5,2,18635,18635,18637,0,2,3
5330,4,1,18639,18639,18640,0,1,2
5331,6,2,18645,18645,18647,0,2,5
5332,5,2,18650,18650,18652,0,2,3
5333,6,3,18656,18656,18659,0,3,4
5334,2,1,18658,18659,18660,1,2,0
5335,1,1,18659,18660,18661,1,2,0
5336,5,2,18664,18664,18666,0,2,3
5337,1,3,18665,18666,18669,1,4,0
5338,5,1,18670,18670,18671,0,1,1
5339,1,1,18671,18671,18672,0,1,0
5340,1,2,18672,18672,18674,0,2,0
5341,1,3,18673,18674,18677,1,4,0
5342,2,1,18675,18677,18678,2,3,0
5343,3,1,18678,18678,18679,0,1,0
5344,4,1,18682,18682,18683,0,1,3
5345,1,3,18683,18683,18686,0,3,0
5346,1,2,18684,18686,18688,2,4,0
5347,1,3,18685,18688,18691,3,6,0
5348,6,1,18691,18691,18692,0,1,0
5349,6,1,18697,18697,18698,0,1,5
5350,3,2,18700,18700,18702,0,2,2
5351,2,1,18702,18702,18703,0,1,0
5352,2,2,18704,18704,18706,0,2,1
5353,5,2,18709,18709,18711,0,2,3
5354,3,2,18712,18712,18714,0,2,1
5355,2,1,18714,18714,18715,0,1,0
5356,5,1,18719,18719,18720,0,1,4
5357,2,1,18721,18721,18722,0,1,1
5358,2,2,18723,18723,18725,0,2,1
5359,6,2,18729,18729,18731,0,2,4
5360,2,3,18731,18731,18734,0,3,0
5361,4,1,18735,18735,18736,0,1,1
5362,3,3,18738,18738,18741,0,3,2
5363,3,2,18741,18741,18743,0,2,0
5364,4,1,18745,18745,18746,0,1,2
5365,1,1,18746,18746,18747,0,1,0
5366,4,3,18750,18750,18753,0,3,3
5367,3,2,18753,18753,18755,0,2,0
5368,6,2,18759,18759,18761,0,2,4
5369,5,1,18764,18764,18765,0,1,3
5370,3,1,18767,18767,18768,0,1,2
5371,3,1,18770,18770,18771,0,1,2
5372,1,3,18771,18771,18774,0,3,0
5373,3,3,18774,18774,18777,0,3,0
5374,1,3,18775,18777,18780,2,5,0
5375,5,1,18780,18780,18781,0,1,0
5376,6,3,18786,18786,18789,0,3,5
5377,6,2,18792,18792,18794,0,2,3
5378,1,1,18793,18794,18795,1,2,0
5379,2,2,18795,18795,18797,0,2,0
5380,3,3,18798,18798,18801,0,3,1
5381,2,1,18800,18801,18802,1,2,0
5382,5,2,18805,18805,18807,0,2,3
5383,3,3,18808,18808,18811,0,3,1
5384,5,3,18813,18813,18816,0,3,2
5385,5,3,18818,18818,18821,0,3,2
5386,4,2,18822,18822,18824,0,2,1
5387,2,3,18824,18824,18827,0,3,0
5388,3,1,18827,18827,18828,0,1,0
5389,2,1,18829,18829,18830,0,1,1
5390,6,2,18835,18835,18837,0,2,5
5391,3,2,18838,18838,18840,0,2,1
5392,4,1,18842,18842,18843,0,1,2
5393,3,3,18845,18845,18848,0,3,2
5394,2,1,18847,18848,18849,1,2,0
5395,5,3,18852,18852,18855,0,3,3
5396,2,1,18854,18855,18856,1,2,0
5397,5,1,18859,18859,18860,0,1,3
5398,1,3,18860,18860,18863,0,3,0
5399,4,2,18864,18864,18866,0,2,1
5400,6,3,18870,18870,18873,0,3,4
5401,5,3,18875,18875,18878,0,3,2
5402,5,2,18880,18880,18882,0,2,2
5403,6,1,18886,18886,18887,0,1,4
5404,1,2,18887,18887,18889,0,2,0
5405,1,2,18888,18889,18891,1,3,0
5406,2,2,18890,18891,18893,1,3,0
5407,6,1,18896,18896,18897,0,1,3
5408,2,3,18898,18898,18901,0,3,1
5409,6,1,18904,18904,18905,0,1,3
5410,5,1,18909,18909,18910,0,1,4
5411,5,1,18914,18914,18915,0,1,4
5412,2,2,18916,18916,18918,0,2,1
5413,6,3,18922,18922,18925,0,3,4
5414,4,2,18926,18926,18928,0,2,1
5415,6,2,18932,18932,18934,0,2,4
5416,6,3,18938,18938,18941,0,3,4
5417,4,3,18942,18942,18945,0,3,1
5418,5,3,18947,18947,18950,0,3,2
5419,5,3,18952,18952,18955,0,3,2
5420,1,3,18953,18955,18958,2,5,0
5421,1,1,18954,18958,18959,4,5,0
5422,6,2,18960,18960,18962,0,2,1
5423,6,2,18966,18966,18968,0,2,4
5424,5,1,18971,18971,18972,0,1,3
5425,4,1,18975,18975,18976,0,1,3
5426,3,1,18978,18978,18979,0,1,2
5427,6,1,18984,18984,18985,0,1,5
5428,2,3,18986,18986,18989,0,3,1
5429,5,2,18991,18991,18993,0,2,2
5430,4,2,18995,18995,18997,0,2,2
5431,5,3,19000,19000,19003,0,3,3
5432,6,3,19006,19006,19009,0,3,3
5433,3,2,19009,19009,19011,0,2,0
5434,2,1,19011,19011,19012,0,1,0
5435,4,2,19015,19015,19017,0,2,3
5436,1,3,19016,19017,19020,1,4,0
5437,5,3,19021,19021,19024,0,3,1
5438,2,1,19023,19024,19025,1,2,0
5439,6,2,19029,19029,19031,0,2,4
5440,5,2,19034,19034,19036,0,2,3
5441,2,1,19036,19036,19037,0,1,0
5442,2,3,19038,19038,19041,0,3,1
5443,3,3,19041,19041,19044,0,3,0
5444,4,2,19045,19045,19047,0,2,1
5445,3,1,19048,19048,19049,0,1,1
5446,3,2,19051,19051,19053,0,2,2
5447,1,2,19052,19053,19055,1,3,0
5448,2,2,19054,19055,19057,1,3,0
5449,5,2,19059,19059,19061,0,2,2
5450,3,1,19062,19062,19063,0,1,1
5451,3,3,19065,19065,19068,0,3,2
5452,1,2,19066,19068,19070,2,4,0
5453,3,3,19069,19070,19073,1,4,0
5454,5,1,19074,19074,19075,0,1,1
5455,5,3,19079,19079,19082,0,3,4
5456,4,3,19083,19083,19086,0,3,1
5457,1,1,19084,19086,19087,2,3,0
5458,1,2,19085,19087,19089,2,4,0
5459,4,1,19089,19089,19090,0,1,0
5460,2,1,19091,19091,19092,0,1,1
5461,3,3,19094,19094,19097,0,3,2
5462,4,2,19098,19098,19100,0,2,1
5463,3,2,19101,19101,19103,0,2,1
5464,5,1,19106,19106,19107,0,1,3
5465,1,3,19107,19107,19110,0,3,0
5466,4,3,19111,19111,19114,0,3,1
5467,1,2,19112,19114,19116,2,4,0
5468,6,3,19118,19118,19121,0,3,2
5469,4,3,19122,19122,19125,0,3,1
5470,6,2,19128,19128,19130,0,2,3
5471,6,3,19134,19134,19137,0,3,4
5472,6,1,19140,19140,19141,0,1,3
5473,5,2,19145,19145,19147,0,2,4
5474,1,2,19146,19147,19149,1,3,0
5475,1,3,19147,19149,19152,2,5,0
5476,5,3,19152,19152,19155,0,3,0
5477,6,2,19158,19158,19160,0,2,3
5478,4,2,19162,19162,19164,0,2,2
5479,1,2,19163,19164,19166,1,3,0
5480,5,3,19168,19168,19171,0,3,2
5481,4,3,19172,19172,19175,0,3,1
5482,6,1,19178,19178,19179,0,1,3
5483,2,1,19180,19180,19181,0,1,1
5484,6,2,19186,19186,19188,0,2,5
5485,4,3,19190,19190,19193,0,3,2
5486,5,1,19195,19195,19196,0,1,2
5487,4,2,19199,19199,19201,0,2,3
5488,1,2,19200,19201,19203,1,3,0
5489,1,1,19201,19203,19204,2,3,0
5490,1,3,19202,19204,19207,2,5,0
5491,6,2,19208,19208,19210,0,2,1
5492,1,3,19209,19210,19213,1,4,0
5493,2,2,19211,19213,19215,2,4,0
5494,6,3,19217,19217,19220,0,3,2
5495,3,1,19220,19220,19221,0,1,0
5496,5,1,19225,19225,19226,0,1,4
5497,6,3,19231,19231,19234,0,3,5
5498,3,1,19234,19234,19235,0,1,0
5499,6,1,19240,19240,19241,0,1,5
5500,3,3,19243,19243,19246,0,3,2
5501,1,2,19244,19246,19248,2,4,0
5502,3,1,19247,19248,19249,1,2,0
5503,2,1,19249,19249,19250,0,1,0
5504,4,3,19253,19253,19256,0,3,3
5505,1,3,19254,19256,19259,2,5,0
5506,5,1,19259,19259,19260,0,1,0
5507,4,2,19263,19263,19265,0,2,3
5508,6,1,19269,19269,19270,0,1,4
5509,4,1,19273,19273,19274,0,1,3
5510,1,3,19274,19274,19277,0,3,0
5511,6,1,19280,19280,19281,0,1,3
5512,1,1,19281,19281,19282,0,1,0
5513,5,2,19286,19286,19288,0,2,4
5514,5,3,19291,19291,19294,0,3,3
5515,2,2,19293,19294,19296,1,3,0
5516,4,3,19297,19297,19300,0,3,1
5517,4,3,19301,19301,19304,0,3,1
5518,3,3,19304,19304,19307,0,3,0
5519,6,3,19310,19310,19313,0,3,3
5520,1,2,19311,19313,19315,2,4,0
5521,4,2,19315,19315,19317,0,2,0
5522,5,2,19320,19320,19322,0,2,3
5523,3,1,19323,19323,19324,0,1,1
5524,5,3,19328,19328,19331,0,3,4
5525,6,2,19334,19334,19336,0,2,3
5526,5,3,19339,19339,19342,0,3,3
5527,4,3,19343,19343,19346,0,3,1
5528,4,1,19347,19347,19348,0,1,1
5529,6,2,19353,19353,19355,0,2,5
5530,3,3,19356,19356,19359,0,3,1
5531,3,1,19359,19359,19360,0,1,0
5532,6,3,19365,19365,19368,0,3,5
5533,5,3,19370,19370,19373,0,3,2
5534,3,3,19373,19373,19376,0,3,0
5535,1,1,19374,19376,19377,2,3,0
5536,2,3,19376,19377,19380,1,4,0
5537,1,2,19377,19380,19382,3,5,0
5538,5,1,19382,19382,19383,0,1,0
5539,2,2,19384,19384,19386,0,2,1
5540,3,1,19387,19387,19388,0,1,1
5541,5,2,19392,19392,19394,0,2,4
5542,4,1,19396,19396,19397,0,1,2
5543,1,2,19397,19397,19399,0,2,0
5544,3,2,19400,19400,19402,0,2,1
5545,3,3,19403,19403,19406,0,3,1
5546,4,1,19407,19407,19408,0,1,1
5547,1,1,19408,19408,19409,0,1,0
5548,1,3,19409,19409,19412,0,3,0
5549,1,2,19410,19412,19414,2,4,0
5550,6,3,19416,19416,19419,0,3,2
5551,1,2,19417,19419,19421,2,4,0
5552,6,2,19423,19423,19425,0,2,2
5553,6,1,19429,19429,19430,0,1,4
5554,2,1,19431,19431,19432,0,1,1
5555,5,1,19436,19436,19437,0,1,4
5556,6,1,19442,19442,19443,0,1,5
5557,1,2,19443,19443,19445,0,2,0
5558,6,2,19449,19449,19451,0,2,4
5559,4,3,19453,19453,19456,0,3,2
5560,6,3,19459,19459,19462,0,3,3
5561,6,1,19465,19465,19466,0,1,3
5562,1,1,19466,19466,19467,0,1,0
5563,3,1,19469,19469,19470,0,1,2
5564,1,3,19470,19470,19473,0,3,0
5565,6,3,19476,19476,19479,0,3,3
5566,3,3,19479,19479,19482,0,3,0
5567,6,2,19485,19485,19487,0,2,3
5568,5,3,19490,19490,19493,0,3,3
5569,6,3,19496,19496,19499,0,3,3
5570,6,2,19502,19502,19504,0,2,3
5571,4,2,19506,19506,19508,0,2,2
5572,3,2,19509,19509,19511,0,2,1
5573,2,3,19511,19511,19514,0,3,0
5574,4,3,19515,19515,19518,0,3,1
5575,4,3,19519,19519,19522,0,3,1
5576,2,2,19521,19522,19524,1,3,0
5577,2,3,19523,19524,19527,1,4,0
5578,1,2,19524,19527,19529,3,5,0
5579,1,1,19525,19529,19530,4,5,0
5580,1,3,19526,19530,19533,4,7,0
5581,4,3,19530,19533,19536,3,6,0
5582,2,2,19532,19536,19538,4,6,0
5583,4,3,19536,19538,19541,2,5,0
5584,6,3,19542,19542,19545,0,3,1
5585,5,2,19547,19547,19549,0,2,2
5586,4,2,19551,19551,19553,0,2,2
5587,3,3,19554,19554,19557,0,3,1
5588,4,3,19558,19558,19561,0,3,1
5589,2,1,19560,19561,19562,1,2,0
5590,6,2,19566,19566,19568,0,2,4
5591,1,3,19567,19568,19571,1,4,0
5592,3,1,19570,19571,19572,1,2,0
5593,4,2,19574,19574,19576,0,2,2
5594,6,1,19580,19580,19581,0,1,4
5595,5,1,19585,19585,19586,0,1,4
5596,6,3,19591,19591,19594,0,3,5
5597,2,3,19593,19594,19597,1,4,0
5598,2,3,19595,19597,19600,2,5,0
5599,1,1,19596,19600,19601,4,5,0
5600,3,1,19599,19601,19602,2,3,0
5601,6,1,19605,19605,19606,0,1,3
5602,2,1,19607,19607,19608,0,1,1
5603,5,2,19612,19612,19614,0,2,4
5604,3,3,19615,19615,19618,0,3,1
5605,2,1,19617,19618,19619,1,2,0
5606,4,1,19621,19621,19622,0,1,2
5607,5,1,19626,19626,19627,0,1,4
5608,6,2,19632,19632,19634,0,2,5
5609,6,2,19638,19638,19640,0,2,4
5610,3,1,19641,19641,19642,0,1,1
5611,6,3,19647,19647,19650,0,3,5
5612,3,2,19650,19650,19652,0,2,0
5613,1,1,19651,19652,19653,1,2,0
5614,6,1,19657,19657,19658,0,1,4
5615,2,2,19659,19659,19661,0,2,1
5616,3,3,19662,19662,19665,0,3,1
5617,2,3,19664,19665,19668,1,4,0
5618,3,3,19667,19668,19671,1,4,0
5619,1,3,19668,19671,19674,3,6,0
5620,3,2,19671,19674,19676,3,5,0
5621,2,2,19673,19676,19678,3,5,0
5622,4,3,19677,19678,19681,1,4,0
5623,4,1,19681,19681,19682,0,1,0
5624,6,3,19687,19687,19690,0,3,5
5625,6,3,19693,19693,19696,0,3,3
5626,5,3,19698,19698,19701,0,3,2
5627,6,2,19704,19704,19706,0,2,3
5628,2,3,19706,19706,19709,0,3,0
5629,3,2,19709,19709,19711,0,2,0
5630,2,1,19711,19711,19712,0,1,0
5631,1,2,19712,19712,19714,0,2,0
5632,3,3,19715,19715,19718,0,3,1
5633,5,2,19720,19720,19722,0,2,2
5634,4,2,19724,19724,19726,0,2,2
5635,5,2,19729,19729,19731,0,2,3
5636,1,2,19730,19731,19733,1,3,0
5637,1,2,19731,19733,19735,2,4,0
5638,5,2,19736,19736,19738,0,2,1
5639,6,1,19742,19742,19743,0,1,4
5640,4,3,19746,19746,19749,0,3,3
5641,4,1,19750,19750,19751,0,1,1
5642,4,1,19754,19754,19755,0,1,3
5643,6,2,19760,19760,19762,0,2,5
5644,2,3,19762,19762,19765,0,3,0
5645,6,3,19768,19768,19771,0,3,3
5646,6,2,19774,19774,19776,0,2,3
5647,6,3,19780,19780,19783,0,3,4
5648,5,2,19785,19785,19787,0,2,2
5649,3,3,19788,19788,19791,0,3,1
5650,4,2,19792,19792,19794,0,2,1
5651,3,1,19795,19795,19796,0,1,1
5652,6,1,19801,19801,19802,0,1,5
5653,4,3,19805,19805,19808,0,3,3
5654,2,2,19807,19808,19810,1,3,0
5655,2,3,19809,19810,19813,1,4,0
5656,2,3,19811,19813,19816,2,5,0
5657,2,1,19813,19816,19817,3,4,0
5658,1,2,19814,19817,19819,3,5,0
5659,6,2,19820,19820,19822,0,2,1
5660,5,1,19825,19825,19826,0,1,3
5661,1,3,19826,19826,19829,0,3,0
5662,1,1,19827,19829,19830,2,3,0
5663,4,1,19831,19831,19832,0,1,1
5664,6,2,19837,19837,19839,0,2,5
5665,3,2,19840,19840,19842,0,2,1
5666,2,3,19842,19842,19845,0,3,0
5667,1,3,19843,19845,19848,2,5,0
5668,5,1,19848,19848,19849,0,1,0
5669,4,1,19852,19852,19853,0,1,3
5670,1,1,19853,19853,19854,0,1,0
5671,4,3,19857,19857,19860,0,3,3
5672,1,3,19858,19860,19863,2,5,0
5673,1,1,19859,19863,19864,4,5,0
5674,2,3,19861,19864,19867,3,6,0
5675,6,3,19867,19867,19870,0,3,0
5676,4,3,19871,19871,19874,0,3,1
5677,3,2,19874,19874,19876,0,2,0
5678,5,3,19879,19879,19882,0,3,3
5679,3,2,19882,19882,19884,0,2,0
5680,6,1,19888,19888,19889,0,1,4
5681,5,3,19893,19893,19896,0,3,4
5682,5,3,19898,19898,19901,0,3,2
5683,1,3,19899,19901,19904,2,5,0
5684,2,3,19901,19904,19907,3,6,0
5685,6,3,19907,19907,19910,0,3,0
5686,6,3,19913,19913,19916,0,3,3
5687,4,2,19917,19917,19919,0,2,1
5688,6,2,19923,19923,19925,0,2,4
5689,2,3,19925,19925,19928,0,3,0
5690,6,3,19931,19931,19934,0,3,3
5691,2,1,19933,19934,19935,1,2,0
5692,1,1,19934,19935,19936,1,2,0
5693,6,1,19940,19940,19941,0,1,4
5694,6,1,19946,19946,19947,0,1,5
5695,2,2,19948,19948,19950,0,2,1
5696,5,3,19953,19953,19956,0,3,3
5697,2,1,19955,19956,19957,1,2,0
5698,5,3,19960,19960,19963,0,3,3
5699,1,1,19961,19963,19964,2,3,0
5700,2,3,19963,19964,19967,1,4,0
5701,4,2,19967,19967,19969,0,2,0
5702,5,2,19972,19972,19974,0,2,3
5703,2,3,19974,19974,19977,0,3,0
5704,5,1,19979,19979,19980,0,1,2
5705,6,1,19985,19985,19986,0,1,5
5706,6,1,19991,19991,19992,0,1,5
5707,6,1,19997,19997,19998,0,1,5
5708,6,3,20003,20003,20006,0,3,5
5709,5,3,20008,20008,20011,0,3,2
5710,2,3,20010,20011,20014,1,4,0
5711,3,1,20013,20014,20015,1,2,0
5712,1,2,20014,20015,20017,1,3,0
5713,4,2,20018,20018,20020,0,2,1
5714,4,1,20022,20022,20023,0,1,2
5715,1,2,20023,20023,20025,0,2,0
5716,1,3,20024,20025,20028,1,4,0
5717,5,2,20029,20029,20031,0,2,1
5718,6,3,20035,20035,20038,0,3,4
5719,4,1,20039,20039,20040,0,1,1
5720,1,3,20040,20040,20043,0,3,0
5721,6,1,20046,20046,20047,0,1,3
5722,5,2,20051,20051,20053,0,2,4
5723,5,2,20056,20056,20058,0,2,3
5724,2,2,20058,20058,20060,0,2,0
5725,2,1,20060,20060,20061,0,1,0
5726,3,3,20063,20063,20066,0,3,2
5727,5,2,20068,20068,20070,0,2,2
5728,1,3,20069,20070,20073,1,4,0
5729,2,2,20071,20073,20075,2,4,0
5730,1,3,20072,20075,20078,3,6,0
5731,4,1,20076,20078,20079,2,3,0
5732,5,3,20081,20081,20084,0,3,2
5733,3,2,20084,20084,20086,0,2,0
5734,5,3,20089,20089,20092,0,3,3
5735,3,3,20092,20092,20095,0,3,0
5736,2,3,20094,20095,20098,1,4,0
5737,3,2,20097,20098,20100,1,3,0
5738,1,3,20098,20100,20103,2,5,0
5739,6,1,20104,20104,20105,0,1,1
5740,4,2,20108,20108,20110,0,2,3
5741,2,2,20110,20110,20112,0,2,0
5742,6,2,20116,20116,20118,0,2,4
5743,1,2,20117,20118,20120,1,3,0
5744,2,1,20119,20120,20121,1,2,0
5745,2,3,20121,20121,20124,0,3,0
5746,5,3,20126,20126,20129,0,3,2
5747,5,2,20131,20131,20133,0,2,2
5748,1,3,20132,20133,20136,1,4,0
5749,1,3,20133,20136,20139,3,6,0
5750,3,1,20136,20139,20140,3,4,0
5751,5,2,20141,20141,20143,0,2,1
5752,6,2,20147,20147,20149,0,2,4
5753,5,1,20152,20152,20153,0,1,3
5754,4,1,20156,20156,20157,0,1,3
5755,1,2,20157,20157,20159,0,2,0
5756,2,2,20159,20159,20161,0,2,0
5757,4,2,20163,20163,20165,0,2,2
5758,4,3,20167,20167,20170,0,3,2
5759,5,1,20172,20172,20173,0,1,2
5760,3,2,20175,20175,20177,0,2,2
5761,4,1,20179,20179,20180,0,1,2
5762,3,1,20182,20182,20183,0,1,2
5763,2,2,20184,20184,20186,0,2,1
5764,1,3,20185,20186,20189,1,4,0
5765,3,1,20188,20189,20190,1,2,0
5766,3,2,20191,20191,20193,0,2,1
5767,3,3,20194,20194,20197,0,3,1
5768,4,3,20198,20198,20201,0,3,1
5769,5,1,20203,20203,20204,0,1,2
5770,4,3,20207,20207,20210,0,3,3
5771,1,2,20208,20210,20212,2,4,0
5772,5,3,20213,20213,20216,0,3,1
5773,4,1,20217,20217,20218,0,1,1
5774,2,1,20219,20219,20220,0,1,1
5775,4,1,20223,20223,20224,0,1,3
5776,2,1,20225,20225,20226,0,1,1
5777,1,3,20226,20226,20229,0,3,0
5778,5,2,20231,20231,20233,0,2,2
5779,6,1,20237,20237,20238,0,1,4
5780,6,3,20243,20243,20246,0,3,5
5781,6,3,20249,20249,20252,0,3,3
5782,3,2,20252,20252,20254,0,2,0
5783,1,1,20253,20254,20255,1,2,0
5784,4,3,20257,20257,20260,0,3,2
5785,2,1,20259,20260,20261,1,2,0
5786,6,1,20265,20265,20266,0,1,4
5787,5,1,20270,20270,20271,0,1,4
5788,6,2,20276,20276,20278,0,2,5
5789,1,3,20277,20278,20281,1,4,0
5790,4,2,20281,20281,20283,0,2,0
5791,2,1,20283,20283,20284,0,1,0
5792,6,1,20289,20289,20290,0,1,5
5793,2,1,20291,20291,20292,0,1,1
5794,6,3,20297,20297,20300,0,3,5
5795,5,1,20302,20302,20303,0,1,2
5796,3,1,20305,20305,20306,0,1,2
5797,6,3,20311,20311,20314,0,3,5
5798,4,2,20315,20315,20317,0,2,1
5799,3,3,20318,20318,20321,0,3,1
5800,3,3,20321,20321,20324,0,3,0
5801,5,1,20326,20326,20327,0,1,2
5802,1,3,20327,20327,20330,0,3,0
5803,4,3,20331,20331,20334,0,3,1
5804,5,3,20336,20336,20339,0,3,2
5805,4,3,20340,20340,20343,0,3,1
5806,6,1,20346,20346,20347,0,1,3
5807,1,2,20347,20347,20349,0,2,0
5808,5,1,20352,20352,20353,0,1,3
5809,3,2,20355,20355,20357,0,2,2
5810,4,3,20359,20359,20362,0,3,2
5811,5,1,20364,20364,20365,0,1,2
5812,6,1,20370,20370,20371,0,1,5
5813,4,2,20374,20374,20376,0,2,3
5814,3,3,20377,20377,20380,0,3,1
5815,4,2,20381,20381,20383,0,2,1
5816,6,1,20387,20387,20388,0,1,4
5817,6,3,20393,20393,20396,0,3,5
5818,3,2,20396,20396,20398,0,2,0
5819,6,3,20402,20402,20405,0,3,4
5820,6,1,20408,20408,20409,0,1,3
5821,5,1,20413,20413,20414,0,1,4
5822,3,2,20416,20416,20418,0,2,2
5823,2,3,20418,20418,20421,0,3,0
5824,5,1,20423,20423,20424,0,1,2
5825,2,3,20425,20425,20428,0,3,1
5826,3,2,20428,20428,20430,0,2,0
5827,5,1,20433,20433,20434,0,1,3
5828,3,3,20436,20436,20439,0,3,2
5829,3,2,20439,20439,20441,0,2,0
5830,5,1,20444,20444,20445,0,1,3
5831,6,2,20450,20450,20452,0,2,5
5832,5,2,20455,20455,20457,0,2,3
5833,3,2,20458,20458,20460,0,2,1
5834,6,2,20464,20464,20466,0,2,4
5835,6,1,20470,20470,20471,0,1,4
5836,5,1,20475,20475,20476,0,1,4
5837,6,3,20481,20481,20484,0,3,5
5838,5,1,20486,20486,20487,0,1,2
5839,2,3,20488,20488,20491,0,3,1
5840,2,2,20490,20491,20493,1,3,0
5841,2,3,20492,20493,20496,1,4,0
5842,4,1,20496,20496,20497,0,1,0
5843,5,2,20501,20501,20503,0,2,4
5844,2,2,20503,20503,20505,0,2,0
5845,6,2,20509,20509,20511,0,2,4
5846,6,1,20515,20515,20516,0,1,4
5847,5,3,20520,20520,20523,0,3,4
5848,6,1,20526,20526,20527,0,1,3
5849,1,2,20527,20527,20529,0,2,0
5850,2,1,20529,20529,20530,0,1,0
5851,1,2,20530,20530,20532,0,2,0
5852,5,2,20535,20535,20537,0,2,3
5853,1,3,20536,20537,20540,1,4,0
5854,6,1,20542,20542,20543,0,1,2
5855,6,1,20548,20548,20549,0,1,5
5856,5,1,20553,20553,20554,0,1,4
5857,6,3,20559,20559,20562,0,3,5
5858,5,2,20564,20564,20566,0,2,2
5859,6,3,20570,20570,20573,0,3,4
5860,2,3,20572,20573,20576,1,4,0
5861,4,1,20576,20576,20577,0,1,0
5862,4,2,20580,20580,20582,0,2,3
5863,4,2,20584,20584,20586,0,2,2
5864,3,3,20587,20587,20590,0,3,1
5865,6,3,20593,20593,20596,0,3,3
5866,6,1,20599,20599,20600,0,1,3
5867,2,3,20601,20601,20604,0,3,1
5868,3,3,20604,20604,20607,0,3,0
5869,1,2,20605,20607,20609,2,4,0
5870,4,2,20609,20609,20611,0,2,0
5871,3,3,20612,20612,20615,0,3,1
5872,3,3,20615,20615,20618,0,3,0
5873,6,2,20621,20621,20623,0,2,3
5874,3,1,20624,20624,20625,0,1,1
5875,1,1,20625,20625,20626,0,1,0
5876,6,3,20631,20631,20634,0,3,5
5877,3,2,20634,20634,20636,0,2,0
5878,3,3,20637,20637,20640,0,3,1
5879,2,3,20639,20640,20643,1,4,0
5880,6,3,20645,20645,20648,0,3,2
5881,2,3,20647,20648,20651,1,4,0
5882,5,1,20652,20652,20653,0,1,1
5883,6,3,20658,20658,20661,0,3,5
5884,2,3,20660,20661,20664,1,4,0
5885,1,3,20661,20664,20667,3,6,0
5886,2,1,20663,20667,20668,4,5,0
5887,6,1,20669,20669,20670,0,1,1
5888,5,2,20674,20674,20676,0,2,4
5889,4,1,20678,20678,20679,0,1,2
5890,4,1,20682,20682,20683,0,1,3
5891,4,2,20686,20686,20688,0,2,3
5892,3,2,20689,20689,20691,0,2,1
5893,3,3,20692,20692,20695,0,3,1
5894,5,2,20697,20697,20699,0,2,2
5895,2,2,20699,20699,20701,0,2,0
5896,3,1,20702,20702,20703,0,1,1
5897,3,2,20705,20705,20707,0,2,2
5898,3,1,20708,20708,20709,0,1,1
5899,1,1,20709,20709,20710,0,1,0
5900,1,2,20710,20710,20712,0,2,0
5901,5,3,20715,20715,20718,0,3,3
5902,6,2,20721,20721,20723,0,2,3
5903,1,3,20722,20723,20726,1,4,0
5904,6,2,20728,20728,20730,0,2,2
5905,4,1,20732,20732,20733,0,1,2
5906,4,3,20736,20736,20739,0,3,3
5907,4,1,20740,20740,20741,0,1,1
5908,5,1,20745,20745,20746,0,1,4
5909,2,3,20747,20747,20750,0,3,1
5910,4,2,20751,20751,20753,0,2,1
5911,3,3,20754,20754,20757,0,3,1
5912,6,1,20760,20760,20761,0,1,3
5913,2,1,20762,20762,20763,0,1,1
5914,6,3,20768,20768,20771,0,3,5
5915,6,2,20774,20774,20776,0,2,3
5916,2,1,20776,20776,20777,0,1,0
5917,5,2,20781,20781,20783,0,2,4
5918,3,3,20784,20784,20787,0,3,1
5919,4,2,20788,20788,20790,0,2,1
5920,1,1,20789,20790,20791,1,2,0
5921,1,1,20790,20791,20792,1,2,0
5922,3,2,20793,20793,20795,0,2,1
5923,6,1,20799,20799,20800,0,1,4
5924,1,3,20800,20800,20803,0,3,0
5925,5,2,20805,20805,20807,0,2,2
5926,1,3,20806,20807,20810,1,4,0
5927,2,3,20808,20810,20813,2,5,0
5928,3,1,20811,20813,20814,2,3,0
5929,3,2,20814,20814,20816,0,2,0
5930,5,1,20819,20819,20820,0,1,3
5931,1,1,20820,20820,20821,0,1,0
5932,5,3,20825,20825,20828,0,3,4
5933,6,2,20831,20831,20833,0,2,3
5934,2,1,20833,20833,20834,0,1,0
5935,4,1,20837,20837,20838,0,1,3
5936,1,3,20838,20838,20841,0,3,0
5937,5,2,20843,20843,20845,0,2,2
5938,2,2,20845,20845,20847,0,2,0
5939,1,3,20846,20847,20850,1,4,0
5940,2,2,20848,20850,20852,2,4,0
5941,4,2,20852,20852,20854,0,2,0
5942,3,2,20855,20855,20857,0,2,1
5943,6,3,20861,20861,20864,0,3,4
5944,4,2,20865,20865,20867,0,2,1
5945,4,2,20869,20869,20871,0,2,2
5946,2,1,20871,20871,20872,0,1,0
5947,3,3,20874,20874,20877,0,3,2
5948,4,3,20878,20878,20881,0,3,1
5949,2,1,20880,20881,20882,1,2,0
5950,1,2,20881,20882,20884,1,3,0
5951,4,1,20885,20885,20886,0,1,1
5952,3,1,20888,20888,20889,0,1,2
5953,3,1,20891,20891,20892,0,1,2
5954,5,3,20896,20896,20899,0,3,4
5955,3,1,20899,20899,20900,0,1,0
5956,4,2,20903,20903,20905,0,2,3
5957,4,3,20907,20907,20910,0,3,2
5958,3,2,20910,20910,20912,0,2,0
5959,6,1,20916,20916,20917,0,1,4
5960,6,2,20922,20922,20924,0,2,5
5961,1,1,20923,20924,20925,1,2,0
5962,6,2,20929,20929,20931,0,2,4
5963,2,3,20931,20931,20934,0,3,0
5964,1,2,20932,20934,20936,2,4,0
5965,2,1,20934,20936,20937,2,3,0
5966,5,2,20939,20939,20941,0,2,2
5967,3,3,20942,20942,20945,0,3,1
5968,3,3,20945,20945,20948,0,3,0
5969,6,1,20951,20951,20952,0,1,3
5970,5,2,20956,20956,20958,0,2,4
5971,3,1,20959,20959,20960,0,1,1
5972,4,2,20963,20963,20965,0,2,3
5973,6,3,20969,20969,20972,0,3,4
5974,4,2,20973,20973,20975,0,2,1
5975,6,1,20979,20979,20980,0,1,4
5976,4,3,20983,20983,20986,0,3,3
5977,1,2,20984,20986,20988,2,4,0
5978,4,1,20988,20988,20989,0,1,0
5979,6,1,20994,20994,20995,0,1,5
5980,4,3,20998,20998,21001,0,3,3
5981,4,3,21002,21002,21005,0,3,1
5982,2,2,21004,21005,21007,1,3,0
5983,3,1,21007,21007,21008,0,1,0
5984,2,1,21009,21009,21010,0,1,1
5985,5,2,21014,21014,21016,0,2,4
5986,4,3,21018,21018,21021,0,3,2
5987,6,1,21024,21024,21025,0,1,3
5988,4,1,21028,21028,21029,0,1,3
5989,2,2,21030,21030,21032,0,2,1
5990,6,1,21036,21036,21037,0,1,4
5991,5,1,21041,21041,21042,0,1,4
5992,2,2,21043,21043,21045,0,2,1
5993,2,3,21045,21045,21048,0,3,0
5994,5,2,21050,21050,21052,0,2,2
5995,2,2,21052,21052,21054,0,2,0
5996,6,1,21058,21058,21059,0,1,4
5997,3,3,21061,21061,21064,0,3,2
5998,6,1,21067,21067,21068,0,1,3
5999,1,2,21068,21068,21070,0,2,0
6000,3,2,21071,21071,21073,0,2,1
6001,5,3,21076,21076,21079,0,3,3
6002,4,1,21080,21080,21081,0,1,1
6003,5,3,21085,21085,21088,0,3,4
6004,5,3,21090,21090,21093,0,3,2
6005,1,2,21091,21093,21095,2,4,0
6006,5,1,21096,21096,21097,0,1,1
6007,3,3,21099,21099,21102,0,3,2
6008,4,1,21103,21103,21104,0,1,1
6009,2,3,21105,21105,21108,0,3,1
6010,1,3,21106,21108,21111,2,5,0
6011,4,2,21110,21111,21113,1,3,0
6012,4,2,21114,21114,21116,0,2,1
6013,3,1,21117,21117,21118,0,1,1
6014,4,2,21121,21121,21123,0,2,3
6015,3,1,21124,21124,21125,0,1,1
6016,2,1,21126,21126,21127,0,1,1
6017,3,3,21129,21129,21132,0,3,2
6018,3,2,21132,21132,21134,0,2,0
6019,3,1,21135,21135,21136,0,1,1
6020,5,1,21140,21140,21141,0,1,4
6021,4,3,21144,21144,21147,0,3,3
6022,5,2,21149,21149,21151,0,2,2
6023,5,1,21154,21154,21155,0,1,3
6024,1,1,21155,21155,21156,0,1,0
6025,3,3,21158,21158,21161,0,3,2
6026,4,1,21162,21162,21163,0,1,1
6027,4,3,21166,21166,21169,0,3,3
6028,1,3,21167,21169,21172,2,5,0
6029,4,1,21171,21172,21173,1,2,0
6030,4,2,21175,21175,21177,0,2,2
6031,6,1,21181,21181,21182,0,1,4
6032,5,2,21186,21186,21188,0,2,4
6033,1,2,21187,21188,21190,1,3,0
6034,4,2,21191,21191,21193,0,2,1
6035,4,2,21195,21195,21197,0,2,2
6036,6,3,21201,21201,21204,0,3,4
6037,4,3,21205,21205,21208,0,3,1
6038,6,1,21211,21211,21212,0,1,3
6039,5,3,21216,21216,21219,0,3,4
6040,5,1,21221,21221,21222,0,1,2
6041,3,3,21224,21224,21227,0,3,2
6042,4,2,21228,21228,21230,0,2,1
6043,5,3,21233,21233,21236,0,3,3
6044,2,1,21235,21236,21237,1,2,0
6045,2,1,21237,21237,21238,0,1,0
6046,5,2,21242,21242,21244,0,2,4
6047,3,3,21245,21245,21248,0,3,1
6048,3,2,21248,21248,21250,0,2,0
6049,4,3,21252,21252,21255,0,3,2
6050,3,3,21255,21255,21258,0,3,0
6051,4,3,21259,21259,21262,0,3,1
6052,2,1,21261,21262,21263,1,2,0
6053,1,3,21262,21263,21266,1,4,0
6054,3,3,21265,21266,21269,1,4,0
6055,5,3,21270,21270,21273,0,3,1
6056,2,3,21272,21273,21276,1,4,0
6057,3,3,21275,21276,21279,1,4,0
6058,4,1,21279,21279,21280,0,1,0
6059,2,1,21281,21281,21282,0,1,1
6060,2,1,21283,21283,21284,0,1,1
6061,3,2,21286,21286,21288,0,2,2
6062,6,1,21292,21292,21293,0,1,4
6063,2,1,21294,21294,21295,0,1,1
6064,5,1,21299,21299,21300,0,1,4
6065,5,1,21304,21304,21305,0,1,4
6066,6,3,21310,21310,21313,0,3,5
6067,2,1,21312,21313,21314,1,2,0
6068,2,1,21314,21314,21315,0,1,0
6069,1,1,21315,21315,21316,0,1,0
6070,1,1,21316,21316,21317,0,1,0
6071,5,1,21321,21321,21322,0,1,4
6072,3,2,21324,21324,21326,0,2,2
6073,4,2,21328,21328,21330,0,2,2
6074,3,1,21331,21331,21332,0,1,1
6075,3,1,21334,21334,21335,0,1,2
6076,5,1,21339,21339,21340,0,1,4
6077,4,2,21343,21343,21345,0,2,3
6078,1,3,21344,21345,21348,1,4,0
6079,1,1,21345,21348,21349,3,4,0
6080,1,1,21346,21349,21350,3,4,0
6081,3,1,21349,21350,21351,1,2,0
6082,5,3,21354,21354,21357,0,3,3
6083,2,1,21356,21357,21358,1,2,0
6084,3,3,21359,21359,21362,0,3,1
6085,4,3,21363,21363,21366,0,3,1
6086,6,3,21369,21369,21372,0,3,3
6087,3,1,21372,21372,21373,0,1,0
6088,2,2,21374,21374,21376,0,2,1
6089,1,1,21375,21376,21377,1,2,0
6090,3,2,21378,21378,21380,0,2,1
6091,3,1,21381,21381,21382,0,1,1
6092,3,1,21384,21384,21385,0,1,2
6093,5,1,21389,21389,21390,0,1,4
6094,5,2,21394,21394,21396,0,2,4
6095,1,3,21395,21396,21399,1,4,0
6096,6,1,21401,21401,21402,0,1,2
6097,2,1,21403,21403,21404,0,1,1
6098,3,2,21406,21406,21408,0,2,2
6099,4,1,21410,21410,21411,0,1,2
6100,6,3,21416,21416,21419,0,3,5
6101,3,2,21419,21419,21421,0,2,0
6102,6,2,21425,21425,21427,0,2,4
6103,2,3,21427,21427,21430,0,3,0
6104,1,1,21428,21430,21431,2,3,0
6105,6,1,21434,21434,21435,0,1,3
6106,1,2,21435,21435,21437,0,2,0
6107,1,1,21436,21437,21438,1,2,0
6108,6,3,21442,21442,21445,0,3,4
6109,5,1,21447,21447,21448,0,1,2
6110,4,1,21451,21451,21452,0,1,3
6111,5,2,21456,21456,21458,0,2,4
6112,2,2,21458,21458,21460,0,2,0
6113,5,3,21463,21463,21466,0,3,3
6114,4,3,21467,21467,21470,0,3,1
6115,3,1,21470,21470,21471,0,1,0
6116,4,2,21474,21474,21476,0,2,3
6117,4,1,21478,21478,21479,0,1,2
6118,1,2,21479,21479,21481,0,2,0
6119,6,2,21485,21485,21487,0,2,4
6120,6,2,21491,21491,21493,0,2,4
6121,4,1,21495,21495,21496,0,1,2
6122,1,2,21496,21496,21498,0,2,0
6123,1,1,21497,21498,21499,1,2,0
6124,6,2,21503,21503,21505,0,2,4
6125,6,3,21509,21509,21512,0,3,4
6126,2,3,21511,21512,21515,1,4,0
6127,3,2,21514,21515,21517,1,3,0
6128,5,3,21519,21519,21522,0,3,2
6129,3,1,21522,21522,21523,0,1,0
6130,6,2,21528,21528,21530,0,2,5
6131,1,2,21529,21530,21532,1,3,0
6132,3,3,21532,21532,21535,0,3,0
6133,5,2,21537,21537,21539,0,2,2
6134,5,2,21542,21542,21544,0,2,3
6135,3,2,21545,21545,21547,0,2,1
6136,1,3,21546,21547,21550,1,4,0
6137,6,2,21552,21552,21554,0,2,2
6138,6,3,21558,21558,21561,0,3,4
6139,2,2,21560,21561,21563,1,3,0
6140,3,2,21563,21563,21565,0,2,0
6141,6,1,21569,21569,21570,0,1,4
6142,4,1,21573,21573,21574,0,1,3
6143,3,1,21576,21576,21577,0,1,2
6144,6,3,21582,21582,21585,0,3,5
6145,6,1,21588,21588,21589,0,1,3
6146,2,3,21590,21590,21593,0,3,1
6147,1,2,21591,21593,21595,2,4,0
6148,5,2,21596,21596,21598,0,2,1
6149,5,2,21601,21601,21603,0,2,3
6150,5,1,21606,21606,21607,0,1,3
6151,1,2,21607,21607,21609,0,2,0
6152,3,1,21610,21610,21611,0,1,1
6153,4,3,21614,21614,21617,0,3,3
6154,1,1,21615,21617,21618,2,3,0
6155,3,3,21618,21618,21621,0,3,0
6156,3,2,21621,21621,21623,0,2,0
6157,5,1,21626,21626,21627,0,1,3
6158,6,3,21632,21632,21635,0,3,5
6159,6,2,21638,21638,21640,0,2,3
6160,5,3,21643,21643,21646,0,3,3
6161,5,3,21648,21648,21651,0,3,2
6162,5,3,21653,21653,21656,0,3,2
6163,6,3,21659,21659,21662,0,3,3
6164,6,3,21665,21665,21668,0,3,3
6165,4,3,21669,21669,21672,0,3,1
6166,6,1,21675,21675,21676,0,1,3
6167,4,3,21679,21679,21682,0,3,3
6168,2,1,21681,21682,21683,1,2,0
6169,5,2,21686,21686,21688,0,2,3
6170,3,2,21689,21689,21691,0,2,1
6171,4,3,21693,21693,21696,0,3,2
6172,4,1,21697,21697,21698,0,1,1
6173,1,2,21698,21698,21700,0,2,0
6174,3,2,21701,21701,21703,0,2,1
6175,4,3,21705,21705,21708,0,3,2
6176,6,3,21711,21711,21714,0,3,3
6177,6,2,21717,21717,21719,0,2,3
6178,4,3,21721,21721,21724,0,3,2
6179,2,3,21723,21724,21727,1,4,0
6180,3,3,21726,21727,21730,1,4,0
6181,1,3,21727,21730,21733,3,6,0
6182,3,2,21730,21733,21735,3,5,0
6183,4,1,21734,21735,21736,1,2,0
6184,3,1,21737,21737,21738,0,1,1
6185,2,3,21739,21739,21742,0,3,1
6186,1,2,21740,21742,21744,2,4,0
6187,2,1,21742,21744,21745,2,3,0
6188,6,1,21748,21748,21749,0,1,3
6189,3,2,21751,21751,21753,0,2,2
6190,3,3,21754,21754,21757,0,3,1
6191,3,1,21757,21757,21758,0,1,0
6192,1,3,21758,21758,21761,0,3,0
6193,2,2,21760,21761,21763,1,3,0
6194,1,2,21761,21763,21765,2,4,0
6195,4,1,21765,21765,21766,0,1,0
6196,6,2,21771,21771,21773,0,2,5
6197,6,3,21777,21777,21780,0,3,4
6198,5,2,21782,21782,21784,0,2,2
6199,1,2,21783,21784,21786,1,3,0
6200,4,1,21787,21787,21788,0,1,1
6201,3,3,21790,21790,21793,0,3,2
6202,1,2,21791,21793,21795,2,4,0
6203,6,1,21797,21797,21798,0,1,2
6204,1,3,21798,21798,21801,0,3,0
6205,6,2,21804,21804,21806,0,2,3
6206,6,1,21810,21810,21811,0,1,4
6207,6,1,21816,21816,21817,0,1,5
6208,6,2,21822,21822,21824,0,2,5
6209,1,2,21823,21824,21826,1,3,0
6210,1,2,21824,21826,21828,2,4,0
6211,6,2,21830,21830,21832,0,2,2
6212,6,3,21836,21836,21839,0,3,4
6213,1,2,21837,21839,21841,2,4,0
6214,1,1,21838,21841,21842,3,4,0
6215,5,3,21843,21843,21846,0,3,1
6216,4,3,21847,21847,21850,0,3,1
6217,3,2,21850,21850,21852,0,2,0
6218,6,1,21856,21856,21857,0,1,4
6219,6,2,21862,21862,21864,0,2,5
6220,1,2,21863,21864,21866,1,3,0
6221,1,2,21864,21866,21868,2,4,0
6222,4,3,21868,21868,21871,0,3,0
6223,5,3,21873,21873,21876,0,3,2
6224,1,1,21874,21876,21877,2,3,0
6225,4,3,21878,21878,21881,0,3,1
6226,1,1,21879,21881,21882,2,3,0
6227,4,2,21883,21883,21885,0,2,1
6228,4,1,21887,21887,21888,0,1,2
6229,2,3,21889,21889,21892,0,3,1
6230,5,3,21894,21894,21897,0,3,2
6231,5,3,21899,21899,21902,0,3,2
6232,5,3,21904,21904,21907,0,3,2
6233,5,1,21909,21909,21910,0,1,2
6234,3,2,21912,21912,21914,0,2,2
6235,3,2,21915,21915,21917,0,2,1
6236,1,2,21916,21917,21919,1,3,0
6237,6,1,21922,21922,21923,0,1,3
6238,1,3,21923,21923,21926,0,3,0
6239,3,1,21926,21926,21927,0,1,0
6240,4,3,21930,21930,21933,0,3,3
6241,1,2,21931,21933,21935,2,4,0
6242,3,3,21934,21935,21938,1,4,0
6243,3,3,21937,21938,21941,1,4,0
6244,4,2,21941,21941,21943,0,2,0
6245,2,1,21943,21943,21944,0,1,0
6246,4,3,21947,21947,21950,0,3,3
6247,4,3,21951,21951,21954,0,3,1
6248,5,3,21956,21956,21959,0,3,2
6249,5,3,21961,21961,21964,0,3,2
6250,1,3,21962,21964,21967,2,5,0
6251,6,3,21968,21968,21971,0,3,1
6252,3,2,21971,21971,21973,0,2,0
6253,5,1,21976,21976,21977,0,1,3
6254,6,3,21982,21982,21985,0,3,5
6255,3,1,21985,21985,21986,0,1,0
6256,5,3,21990,21990,21993,0,3,4
6257,3,1,21993,21993,21994,0,1,0
6258,5,3,21998,21998,22001,0,3,4
6259,3,3,22001,22001,22004,0,3,0
6260,4,1,22005,22005,22006,0,1,1
6261,1,1,22006,22006,22007,0,1,0
6262,5,2,22011,22011,22013,0,2,4
6263,5,2,22016,22016,22018,0,2,3
6264,1,3,22017,22018,22021,1,4,0
6265,3,3,22020,22021,22024,1,4,0
6266,3,1,22023,22024,22025,1,2,0
6267,2,2,22025,22025,22027,0,2,0
6268,6,2,22031,22031,22033,0,2,4
6269,2,2,22033,22033,22035,0,2,0
6270,5,3,22038,22038,22041,0,3,3
6271,1,1,22039,22041,22042,2,3,0
6272,4,3,22043,22043,22046,0,3,1
6273,5,3,22048,22048,22051,0,3,2
6274,3,1,22051,22051,22052,0,1,0
6275,6,3,22057,22057,22060,0,3,5
6276,4,2,22061,22061,22063,0,2,1
6277,1,3,22062,22063,22066,1,4,0
6278,3,1,22065,22066,22067,1,2,0
6279,4,3,22069,22069,22072,0,3,2
6280,6,2,22075,22075,22077,0,2,3
6281,3,1,22078,22078,22079,0,1,1
6282,3,1,22081,22081,22082,0,1,2
6283,5,3,22086,22086,22089,0,3,4
6284,5,3,22091,22091,22094,0,3,2
6285,2,1,22093,22094,22095,1,2,0
6286,4,1,22097,22097,22098,0,1,2
6287,4,2,22101,22101,22103,0,2,3
6288,3,3,22104,22104,22107,0,3,1
6289,6,1,22110,22110,22111,0,1,3
6290,1,1,22111,22111,22112,0,1,0
6291,3,3,22114,22114,22117,0,3,2
6292,4,3,22118,22118,22121,0,3,1
6293,1,3,22119,22121,22124,2,5,0
6294,3,1,22122,22124,22125,2,3,0
6295,6,1,22128,22128,22129,0,1,3
6296,5,2,22133,22133,22135,0,2,4
6297,6,2,22139,22139,22141,0,2,4
6298,2,3,22141,22141,22144,0,3,0
6299,4,2,22145,22145,22147,0,2,1
6300,6,1,22151,22151,22152,0,1,4
6301,6,3,22157,22157,22160,0,3,5
6302,5,1,22162,22162,22163,0,1,2
6303,1,2,22163,22163,22165,0,2,0
6304,4,3,22167,22167,22170,0,3,2
6305,3,2,22170,22170,22172,0,2,0
6306,2,3,22172,22172,22175,0,3,0
6307,2,3,22174,22175,22178,1,4,0
6308,4,1,22178,22178,22179,0,1,0
6309,6,1,22184,22184,22185,0,1,5
6310,4,1,22188,22188,22189,0,1,3
6311,4,1,22192,22192,22193,0,1,3
6312,5,2,22197,22197,22199,0,2,4
6313,1,3,22198,22199,22202,1,4,0
6314,5,2,22203,22203,22205,0,2,1
6315,3,2,22206,22206,22208,0,2,1
6316,2,1,22208,22208,22209,0,1,0
6317,6,2,22214,22214,22216,0,2,5
6318,6,2,22220,22220,22222,0,2,4
6319,4,2,22224,22224,22226,0,2,2
6320,3,3,22227,22227,22230,0,3,1
6321,6,2,22233,22233,22235,0,2,3
6322,5,2,22238,22238,22240,0,2,3
6323,1,3,22239,22240,22243,1,4,0
6324,3,2,22242,22243,22245,1,3,0
6325,2,1,22244,22245,22246,1,2,0
6326,1,1,22245,22246,22247,1,2,0
6327,4,3,22249,22249,22252,0,3,2
6328,4,2,22253,22253,22255,0,2,1
6329,3,2,22256,22256,22258,0,2,1
6330,3,2,22259,22259,22261,0,2,1
6331,4,3,22263,22263,22266,0,3,2
6332,6,2,22269,22269,22271,0,2,3
6333,4,1,22273,22273,22274,0,1,2
6334,2,2,22275,22275,22277,0,2,1
6335,1,2,22276,22277,22279,1,3,0
6336,3,3,22279,22279,22282,0,3,0
6337,4,2,22283,22283,22285,0,2,1
6338,5,3,22288,22288,22291,0,3,3
6339,6,2,22294,22294,22296,0,2,3
6340,6,1,22300,22300,22301,0,1,4
6341,2,3,22302,22302,22305,0,3,1
6342,5,2,22307,22307,22309,0,2,2
6343,2,1,22309,22309,22310,0,1,0
6344,5,2,22314,22314,22316,0,2,4
6345,4,1,22318,22318,22319,0,1,2
6346,6,3,22324,22324,22327,0,3,5
6347,2,3,22326,22327,22330,1,4,0
6348,5,3,22331,22331,22334,0,3,1
6349,6,3,22337,22337,22340,0,3,3
6350,1,3,22338,22340,22343,2,5,0
6351,4,1,22342,22343,22344,1,2,0
6352,1,3,22343,22344,22347,1,4,0
6353,4,2,22347,22347,22349,0,2,0
6354,3,3,22350,22350,22353,0,3,1
6355,1,1,22351,22353,22354,2,3,0
6356,2,2,22353,22354,22356,1,3,0
6357,5,2,22358,22358,22360,0,2,2
6358,3,3,22361,22361,22364,0,3,1
6359,5,3,22366,22366,22369,0,3,2
6360,3,3,22369,22369,22372,0,3,0
6361,2,3,22371,22372,22375,1,4,0
6362,5,1,22376,22376,22377,0,1,1
6363,2,1,22378,22378,22379,0,1,1
6364,5,2,22383,22383,22385,0,2,4
6365,1,2,22384,22385,22387,1,3,0
6366,6,3,22390,22390,22393,0,3,3
6367,1,1,22391,22393,22394,2,3,0
6368,3,1,22394,22394,22395,0,1,0
6369,6,2,22400,22400,22402,0,2,5
6370,3,1,22403,22403,22404,0,1,1
6371,5,2,22408,22408,22410,0,2,4
6372,5,2,22413,22413,22415,0,2,3
6373,3,2,22416,22416,22418,0,2,1
6374,1,1,22417,22418,22419,1,2,0
6375,6,2,22423,22423,22425,0,2,4
6376,4,1,22427,22427,22428,0,1,2
6377,1,3,22428,22428,22431,0,3,0
6378,4,3,22432,22432,22435,0,3,1
6379,3,2,22435,22435,22437,0,2,0
6380,3,2,22438,22438,22440,0,2,1
6381,1,2,22439,22440,22442,1,3,0
6382,2,3,22441,22442,22445,1,4,0
6383,3,3,22444,22445,22448,1,4,0
6384,4,2,22448,22448,22450,0,2,0
6385,1,2,22449,22450,22452,1,3,0
6386,1,2,22450,22452,22454,2,4,0
6387,5,3,22455,22455,22458,0,3,1
6388,5,1,22460,22460,22461,0,1,2
6389,2,3,22462,22462,22465,0,3,1
6390,2,3,22464,22465,22468,1,4,0
6391,4,2,22468,22468,22470,0,2,0
6392,4,3,22472,22472,22475,0,3,2
6393,1,2,22473,22475,22477,2,4,0
6394,3,3,22476,22477,22480,1,4,0
6395,3,2,22479,22480,22482,1,3,0
6396,6,2,22485,22485,22487,0,2,3
6397,5,3,22490,22490,22493,0,3,3
6398,4,2,22494,22494,22496,0,2,1
6399,3,1,22497,22497,22498,0,1,1
6400,1,1,22498,22498,22499,0,1,0
6401,6,1,22504,22504,22505,0,1,5
6402,2,1,22506,22506,22507,0,1,1
6403,4,2,22510,22510,22512,0,2,3
6404,5,1,22515,22515,22516,0,1,3
6405,4,1,22519,22519,22520,0,1,3
6406,5,3,22524,22524,22527,0,3,4
6407,3,2,22527,22527,22529,0,2,0
6408,3,2,22530,22530,22532,0,2,1
6409,6,2,22536,22536,22538,0,2,4
6410,4,2,22540,22540,22542,0,2,2
6411,3,3,22543,22543,22546,0,3,1
6412,2,3,22545,22546,22549,1,4,0
6413,5,1,22550,22550,22551,0,1,1
6414,5,3,22555,22555,22558,0,3,4
6415,4,2,22559,22559,22561,0,2,1
6416,6,1,22565,22565,22566,0,1,4
6417,5,2,22570,22570,22572,0,2,4
6418,1,2,22571,22572,22574,1,3,0
6419,4,3,22575,22575,22578,0,3,1
6420,3,3,22578,22578,22581,0,3,0
6421,6,1,22584,22584,22585,0,1,3
6422,3,2,22587,22587,22589,0,2,2
6423,2,2,22589,22589,22591,0,2,0
6424,6,1,22595,22595,22596,0,1,4
6425,3,1,22598,22598,22599,0,1,2
6426,5,3,22603,22603,22606,0,3,4
6427,3,3,22606,22606,22609,0,3,0
6428,1,1,22607,22609,22610,2,3,0
6429,1,3,22608,22610,22613,2,5,0
6430,4,2,22612,22613,22615,1,3,0
6431,6,2,22618,22618,22620,0,2,3
6432,2,3,22620,22620,22623,0,3,0
6433,6,2,22626,22626,22628,0,2,3
6434,6,2,22632,22632,22634,0,2,4
6435,1,1,22633,22634,22635,1,2,0
6436,1,1,22634,22635,22636,1,2,0
6437,3,1,22637,22637,22638,0,1,1
6438,2,3,22639,22639,22642,0,3,1
6439,6,3,22645,22645,22648,0,3,3
6440,2,2,22647,22648,22650,1,3,0
6441,4,3,22651,22651,22654,0,3,1
6442,5,2,22656,22656,22658,0,2,2
6443,1,3,22657,22658,22661,1,4,0
6444,3,2,22660,22661,22663,1,3,0
6445,3,3,22663,22663,22666,0,3,0
6446,6,1,22669,22669,22670,0,1,3
6447,1,2,22670,22670,22672,0,2,0
6448,1,2,22671,22672,22674,1,3,0
6449,6,3,22677,22677,22680,0,3,3
6450,3,2,22680,22680,22682,0,2,0
6451,3,1,22683,22683,22684,0,1,1
6452,2,1,22685,22685,22686,0,1,1
6453,5,3,22690,22690,22693,0,3,4
6454,6,3,22696,22696,22699,0,3,3
6455,6,2,22702,22702,22704,0,2,3
6456,2,1,22704,22704,22705,0,1,0
6457,3,2,22707,22707,22709,0,2,2
6458,1,2,22708,22709,22711,1,3,0
6459,4,2,22712,22712,22714,0,2,1
6460,4,1,22716,22716,22717,0,1,2
6461,1,2,22717,22717,22719,0,2,0
6462,6,2,22723,22723,22725,0,2,4
6463,3,3,22726,22726,22729,0,3,1
6464,5,1,22731,22731,22732,0,1,2
6465,3,3,22734,22734,22737,0,3,2
6466,5,2,22739,22739,22741,0,2,2
6467,4,2,22743,22743,22745,0,2,2
6468,6,1,22749,22749,22750,0,1,4
6469,6,2,22755,22755,22757,0,2,5
6470,4,1,22759,22759,22760,0,1,2
6471,4,2,22763,22763,22765,0,2,3
6472,3,2,22766,22766,22768,0,2,1
6473,2,2,22768,22768,22770,0,2,0
6474,6,2,22774,22774,22776,0,2,4
6475,4,1,22778,22778,22779,0,1,2
6476,6,2,22784,22784,22786,0,2,5
6477,3,2,22787,22787,22789,0,2,1
6478,4,3,22791,22791,22794,0,3,2
6479,6,2,22797,22797,22799,0,2,3
6480,5,1,22802,22802,22803,0,1,3
6481,5,3,22807,22807,22810,0,3,4
6482,3,3,22810,22810,22813,0,3,0
6483,5,1,22815,22815,22816,0,1,2
6484,6,1,22821,22821,22822,0,1,5
6485,2,3,22823,22823,22826,0,3,1
6486,6,3,22829,22829,22832,0,3,3
6487,6,1,22835,22835,22836,0,1,3
6488,6,2,22841,22841,22843,0,2,5
6489,6,2,22847,22847,22849,0,2,4
6490,2,1,22849,22849,22850,0,1,0
6491,1,1,22850,22850,22851,0,1,0
6492,4,3,22854,22854,22857,0,3,3
6493,5,2,22859,22859,22861,0,2,2
6494,3,2,22862,22862,22864,0,2,1
6495,2,3,22864,22864,22867,0,3,0
6496,1,1,22865,22867,22868,2,3,0
6497,2,1,22867,22868,22869,1,2,0
6498,2,3,22869,22869,22872,0,3,0
6499,5,2,22874,22874,22876,0,2,2
6500,5,2,22879,22879,22881,0,2,3
6501,1,1,22880,22881,22882,1,2,0
6502,5,1,22885,22885,22886,0,1,3
6503,1,1,22886,22886,22887,0,1,0
6504,1,1,22887,22887,22888,0,1,0
6505,6,2,22893,22893,22895,0,2,5
6506,4,2,22897,22897,22899,0,2,2
6507,4,2,22901,22901,22903,0,2,2
6508,2,1,22903,22903,22904,0,1,0
6509,6,2,22909,22909,22911,0,2,5
6510,3,1,22912,22912,22913,0,1,1
6511,5,3,22917,22917,22920,0,3,4
6512,3,2,22920,22920,22922,0,2,0
6513,4,3,22924,22924,22927,0,3,2
6514,2,3,22926,22927,22930,1,4,0
6515,6,1,22932,22932,22933,0,1,2
6516,4,2,22936,22936,22938,0,2,3
6517,2,1,22938,22938,22939,0,1,0
6518,5,2,22943,22943,22945,0,2,4
6519,3,1,22946,22946,22947,0,1,1
6520,5,3,22951,22951,22954,0,3,4
6521,1,3,22952,22954,22957,2,5,0
6522,6,3,22958,22958,22961,0,3,1
6523,6,3,22964,22964,22967,0,3,3
6524,5,3,22969,22969,22972,0,3,2
6525,5,1,22974,22974,22975,0,1,2
6526,5,2,22979,22979,22981,0,2,4
6527,1,3,22980,22981,22984,1,4,0
6528,1,1,22981,22984,22985,3,4,0
6529,6,1,22987,22987,22988,0,1,2
6530,3,1,22990,22990,22991,0,1,2
6531,5,1,22995,22995,22996,0,1,4
6532,2,3,22997,22997,23000,0,3,1
6533,6,1,23003,23003,23004,0,1,3
6534,5,3,23008,23008,23011,0,3,4
6535,1,2,23009,23011,23013,2,4,0
6536,4,2,23013,23013,23015,0,2,0
6537,5,2,23018,23018,23020,0,2,3
6538,1,3,23019,23020,23023,1,4,0
6539,1,1,23020,23023,23024,3,4,0
6540,3,2,23023,23024,23026,1,3,0
6541,6,2,23029,23029,23031,0,2,3
6542,6,1,23035,23035,23036,0,1,4
6543,3,3,23038,23038,23041,0,3,2
6544,6,1,23044,23044,23045,0,1,3
6545,1,2,23045,23045,23047,0,2,0
6546,5,3,23050,23050,23053,0,3,3
6547,2,1,23052,23053,23054,1,2,0
6548,2,1,23054,23054,23055,0,1,0
6549,6,2,23060,23060,23062,0,2,5
6550,4,1,23064,23064,23065,0,1,2
6551,1,2,23065,23065,23067,0,2,0
6552,4,3,23069,23069,23072,0,3,2
6553,3,2,23072,23072,23074,0,2,0
6554,4,3,23076,23076,23079,0,3,2
6555,3,1,23079,23079,23080,0,1,0
6556,2,3,23081,23081,23084,0,3,1
6557,4,3,23085,23085,23088,0,3,1
6558,1,3,23086,23088,23091,2,5,0
6559,4,2,23090,23091,23093,1,3,0
6560,5,2,23095,23095,23097,0,2,2
6561,1,2,23096,23097,23099,1,3,0
6562,3,1,23099,23099,23100,0,1,0
6563,2,2,23101,23101,23103,0,2,1
6564,2,2,23103,23103,23105,0,2,0
6565,6,2,23109,23109,23111,0,2,4
6566,5,2,23114,23114,23116,0,2,3
6567,3,1,23117,23117,23118,0,1,1
6568,4,1,23121,23121,23122,0,1,3
6569,4,3,23125,23125,23128,0,3,3
6570,4,2,23129,23129,23131,0,2,1
6571,4,1,23133,23133,23134,0,1,2
6572,1,2,23134,23134,23136,0,2,0
6573,3,3,23137,23137,23140,0,3,1
6574,5,3,23142,23142,23145,0,3,2
6575,1,1,23143,23145,23146,2,3,0
6576,2,1,23145,23146,23147,1,2,0
6577,2,1,23147,23147,23148,0,1,0
6578,5,2,23152,23152,23154,0,2,4
6579,4,3,23156,23156,23159,0,3,2
6580,5,3,23161,23161,23164,0,3,2
6581,2,3,23163,23164,23167,1,4,0
6582,2,3,23165,23167,23170,2,5,0
6583,2,1,23167,23170,23171,3,4,0
6584,4,1,23171,23171,23172,0,1,0
6585,4,1,23175,23175,23176,0,1,3
6586,3,3,23178,23178,23181,0,3,2
6587,1,2,23179,23181,23183,2,4,0
6588,4,3,23183,23183,23186,0,3,0
6589,4,3,23187,23187,23190,0,3,1
6590,1,2,23188,23190,23192,2,4,0
6591,1,1,23189,23192,23193,3,4,0
6592,6,2,23195,23195,23197,0,2,2
6593,2,3,23197,23197,23200,0,3,0
6594,4,1,23201,23201,23202,0,1,1
6595,3,1,23204,23204,23205,0,1,2
6596,4,2,23208,23208,23210,0,2,3
6597,6,3,23214,23214,23217,0,3,4
6598,3,1,23217,23217,23218,0,1,0
6599,3,3,23220,23220,23223,0,3,2
6600,3,3,23223,23223,23226,0,3,0
6601,2,1,23225,23226,23227,1,2,0
6602,2,1,23227,23227,23228,0,1,0
6603,2,2,23229,23229,23231,0,2,1
6604,6,1,23235,23235,23236,0,1,4
6605,4,1,23239,23239,23240,0,1,3
6606,4,1,23243,23243,23244,0,1,3
6607,5,2,23248,23248,23250,0,2,4
6608,6,1,23254,23254,23255,0,1,4
6609,3,1,23257,23257,23258,0,1,2
6610,4,2,23261,23261,23263,0,2,3
6611,2,1,23263,23263,23264,0,1,0
6612,6,3,23269,23269,23272,0,3,5
6613,1,1,23270,23272,23273,2,3,0
6614,3,3,23273,23273,23276,0,3,0
6615,6,1,23279,23279,23280,0,1,3
6616,4,1,23283,23283,23284,0,1,3
6617,1,2,23284,23284,23286,0,2,0
6618,5,2,23289,23289,23291,0,2,3
6619,5,3,23294,23294,23297,0,3,3
6620,3,1,23297,23297,23298,0,1,0
6621,4,3,23301,23301,23304,0,3,3
6622,4,2,23305,23305,23307,0,2,1
6623,4,1,23309,23309,23310,0,1,2
6624,3,3,23312,23312,23315,0,3,2
6625,5,2,23317,23317,23319,0,2,2
6626,3,2,23320,23320,23322,0,2,1
6627,6,3,23326,23326,23329,0,3,4
6628,2,1,23328,23329,23330,1,2,0
6629,3,2,23331,23331,23333,0,2,1
6630,1,3,23332,23333,23336,1,4,0
6631,2,2,23334,23336,23338,2,4,0
6632,1,3,23335,23338,23341,3,6,0
6633,3,3,23338,23341,23344,3,6,0
6634,6,3,23344,23344,23347,0,3,0
6635,1,1,23345,23347,23348,2,3,0
6636,1,3,23346,23348,23351,2,5,0
6637,3,2,23349,23351,23353,2,4,0
6638,6,2,23355,23355,23357,0,2,2
6639,1,3,23356,23357,23360,1,4,0
6640,3,3,23359,23360,23363,1,4,0
6641,1,1,23360,23363,23364,3,4,0
6642,6,2,23366,23366,23368,0,2,2
6643,2,3,23368,23368,23371,0,3,0
6644,6,3,23374,23374,23377,0,3,3
6645,4,2,23378,23378,23380,0,2,1
6646,5,3,23383,23383,23386,0,3,3
6647,5,1,23388,23388,23389,0,1,2
6648,6,1,23394,23394,23395,0,1,5
6649,4,2,23398,23398,23400,0,2,3
6650,2,1,23400,23400,23401,0,1,0
6651,4,1,23404,23404,23405,0,1,3
6652,4,1,23408,23408,23409,0,1,3
6653,5,1,23413,23413,23414,0,1,4
6654,3,1,23416,23416,23417,0,1,2
6655,2,2,23418,23418,23420,0,2,1
6656,3,1,23421,23421,23422,0,1,1
6657,3,1,23424,23424,23425,0,1,2
6658,1,3,23425,23425,23428,0,3,0
6659,6,2,23431,23431,23433,0,2,3
6660,5,1,23436,23436,23437,0,1,3
6661,4,1,23440,23440,23441,0,1,3
6662,1,3,23441,23441,23444,0,3,0
6663,1,1,23442,23444,23445,2,3,0
6664,1,2,23443,23445,23447,2,4,0
6665,5,1,23448,23448,23449,0,1,1
6666,4,2,23452,23452,23454,0,2,3
6667,6,3,23458,23458,23461,0,3,4
6668,2,2,23460,23461,23463,1,3,0
6669,6,1,23466,23466,23467,0,1,3
6670,6,1,23472,23472,23473,0,1,5
6671,1,1,23473,23473,23474,0,1,0
6672,2,3,23475,23475,23478,0,3,1
6673,6,1,23481,23481,23482,0,1,3
6674,4,2,23485,23485,23487,0,2,3
6675,6,3,23491,23491,23494,0,3,4
6676,4,3,23495,23495,23498,0,3,1
6677,5,2,23500,23500,23502,0,2,2
6678,2,3,23502,23502,23505,0,3,0
6679,1,3,23503,23505,23508,2,5,0
6680,3,3,23506,23508,23511,2,5,0
6681,5,3,23511,23511,23514,0,3,0
6682,3,3,23514,23514,23517,0,3,0
6683,5,2,23519,23519,23521,0,2,2
6684,1,2,23520,23521,23523,1,3,0
6685,1,2,23521,23523,23525,2,4,0
6686,4,1,23525,23525,23526,0,1,0
6687,6,3,23531,23531,23534,0,3,5
6688,6,2,23537,23537,23539,0,2,3
6689,4,1,23541,23541,23542,0,1,2
6690,6,1,23547,23547,23548,0,1,5
6691,3,2,23550,23550,23552,0,2,2
6692,6,2,23556,23556,23558,0,2,4
6693,3,2,23559,23559,23561,0,2,1
6694,6,3,23565,23565,23568,0,3,4
6695,1,1,23566,23568,23569,2,3,0
6696,4,3,23570,23570,23573,0,3,1
6697,1,2,23571,23573,23575,2,4,0
6698,6,3,23577,23577,23580,0,3,2
6699,3,1,23580,23580,23581,0,1,0
6700,5,3,23585,23585,23588,0,3,4
6701,3,1,23588,23588,23589,0,1,0
6702,3,2,23591,23591,23593,0,2,2
6703,4,2,23595,23595,23597,0,2,2
6704,4,3,23599,23599,23602,0,3,2
6705,5,2,23604,23604,23606,0,2,2
6706,3,3,23607,23607,23610,0,3,1
6707,4,2,23611,23611,23613,0,2,1
6708,2,3,23613,23613,23616,0,3,0
6709,4,3,23617,23617,23620,0,3,1
6710,2,1,23619,23620,23621,1,2,0
6711,4,1,23623,23623,23624,0,1,2
6712,6,1,23629,23629,23630,0,1,5
6713,4,1,23633,23633,23634,0,1,3
6714,2,1,23635,23635,23636,0,1,1
6715,4,3,23639,23639,23642,0,3,3
6716,3,3,23642,23642,23645,0,3,0
6717,6,3,23648,23648,23651,0,3,3
6718,4,3,23652,23652,23655,0,3,1
6719,5,2,23657,23657,23659,0,2,2
6720,5,3,23662,23662,23665,0,3,3
6721,6,3,23668,23668,23671,0,3,3
6722,2,1,23670,23671,23672,1,2,0
6723,3,1,23673,23673,23674,0,1,1
6724,6,1,23679,23679,23680,0,1,5
6725,4,3,23683,23683,23686,0,3,3
6726,6,3,23689,23689,23692,0,3,3
6727,3,2,23692,23692,23694,0,2,0
6728,2,1,23694,23694,23695,0,1,0
6729,1,3,23695,23695,23698,0,3,0
6730,4,2,23699,23699,23701,0,2,1
6731,2,1,23701,23701,23702,0,1,0
6732,4,2,23705,23705,23707,0,2,3
6733,6,1,23711,23711,23712,0,1,4
6734,6,3,23717,23717,23720,0,3,5
6735,2,2,23719,23720,23722,1,3,0
6736,1,3,23720,23722,23725,2,5,0
6737,1,2,23721,23725,23727,4,6,0
6738,3,2,23724,23727,23729,3,5,0
6739,5,2,23729,23729,23731,0,2,0
6740,3,1,23732,23732,23733,0,1,1
6741,1,3,23733,23733,23736,0,3,0
6742,3,1,23736,23736,23737,0,1,0
6743,2,1,23738,23738,23739,0,1,1
6744,6,3,23744,23744,23747,0,3,5
6745,6,2,23750,23750,23752,0,2,3
6746,6,3,23756,23756,23759,0,3,4
6747,6,3,23762,23762,23765,0,3,3
6748,5,3,23767,23767,23770,0,3,2
6749,5,3,23772,23772,23775,0,3,2
6750,3,1,23775,23775,23776,0,1,0
6751,2,2,23777,23777,23779,0,2,1
6752,5,1,23782,23782,23783,0,1,3
6753,4,3,23786,23786,23789,0,3,3
6754,2,1,23788,23789,23790,1,2,0
6755,6,3,23794,23794,23797,0,3,4
6756,3,1,23797,23797,23798,0,1,0
6757,3,2,23800,23800,23802,0,2,2
6758,1,3,23801,23802,23805,1,4,0
6759,4,1,23805,23805,23806,0,1,0
6760,6,2,23811,23811,23813,0,2,5
6761,1,2,23812,23813,23815,1,3,0
6762,5,3,23817,23817,23820,0,3,2
6763,4,3,23821,23821,23824,0,3,1
6764,6,3,23827,23827,23830,0,3,3
6765,4,3,23831,23831,23834,0,3,1
6766,4,1,23835,23835,23836,0,1,1
6767,4,2,23839,23839,23841,0,2,3
6768,4,1,23843,23843,23844,0,1,2
6769,6,2,23849,23849,23851,0,2,5
6770,1,2,23850,23851,23853,1,3,0
6771,3,3,23853,23853,23856,0,3,0
6772,2,3,23855,23856,23859,1,4,0
6773,1,2,23856,23859,23861,3,5,0
6774,2,1,23858,23861,23862,3,4,0
6775,3,1,23861,23862,23863,1,2,0
6776,2,1,23863,23863,23864,0,1,0
6777,4,2,23867,23867,23869,0,2,3
6778,4,2,23871,23871,23873,0,2,2
6779,3,1,23874,23874,23875,0,1,1
6780,4,2,23878,23878,23880,0,2,3
6781,6,1,23884,23884,23885,0,1,4
6782,6,3,23890,23890,23893,0,3,5
6783,2,2,23892,23893,23895,1,3,0
6784,2,1,23894,23895,23896,1,2,0
6785,2,1,23896,23896,23897,0,1,0
6786,3,3,23899,23899,23902,0,3,2
6787,4,3,23903,23903,23906,0,3,1
6788,4,1,23907,23907,23908,0,1,1
6789,5,1,23912,23912,23913,0,1,4
6790,1,3,23913,23913,23916,0,3,0
6791,1,1,23914,23916,23917,2,3,0
6792,6,2,23920,23920,23922,0,2,3
6793,3,3,23923,23923,23926,0,3,1
6794,2,2,23925,23926,23928,1,3,0
6795,3,2,23928,23928,23930,0,2,0
6796,6,1,23934,23934,23935,0,1,4
6797,3,1,23937,23937,23938,0,1,2
6798,6,1,23943,23943,23944,0,1,5
6799,6,2,23949,23949,23951,0,2,5
6800,1,3,23950,23951,23954,1,4,0
6801,1,1,23951,23954,23955,3,4,0
6802,5,1,23956,23956,23957,0,1,1
6803,2,1,23958,23958,23959,0,1,1
6804,5,1,23963,23963,23964,0,1,4
6805,5,1,23968,23968,23969,0,1,4
6806,4,3,23972,23972,23975,0,3,3
6807,5,3,23977,23977,23980,0,3,2
6808,3,2,23980,23980,23982,0,2,0
6809,5,3,23985,23985,23988,0,3,3
6810,2,2,23987,23988,23990,1,3,0
6811,4,1,23991,23991,23992,0,1,1
6812,1,3,23992,23992,23995,0,3,0
6813,3,3,23995,23995,23998,0,3,0
6814,2,2,23997,23998,24000,1,3,0
6815,3,3,24000,24000,24003,0,3,0
6816,4,1,24004,24004,24005,0,1,1
6817,4,1,24008,24008,24009,0,1,3
6818,4,1,24012,24012,24013,0,1,3
6819,2,2,24014,24014,24016,0,2,1
6820,2,3,24016,24016,24019,0,3,0
6821,3,1,24019,24019,24020,0,1,0
6822,6,1,24025,24025,24026,0,1,5
6823,6,3,24031,24031,24034,0,3,5
6824,5,1,24036,24036,24037,0,1,2
6825,1,2,24037,24037,24039,0,2,0
6826,6,1,24043,24043,24044,0,1,4
6827,4,3,24047,24047,24050,0,3,3
6828,2,2,24049,24050,24052,1,3,0
6829,4,3,24053,24053,24056,0,3,1
6830,5,2,24058,24058,24060,0,2,2
6831,1,3,24059,24060,24063,1,4,0
6832,6,3,24065,24065,24068,0,3,2
6833,5,3,24070,24070,24073,0,3,2
6834,6,2,24076,24076,24078,0,2,3
6835,1,1,24077,24078,24079,1,2,0
6836,6,1,24083,24083,24084,0,1,4
6837,6,1,24089,24089,24090,0,1,5
6838,1,1,24090,24090,24091,0,1,0
6839,2,1,24092,24092,24093,0,1,1
6840,2,2,24094,24094,24096,0,2,1
6841,3,3,24097,24097,24100,0,3,1
6842,2,3,24099,24100,24103,1,4,0
6843,3,3,24102,24103,24106,1,4,0
6844,4,1,24106,24106,24107,0,1,0
6845,5,1,24111,24111,24112,0,1,4
6846,5,2,24116,24116,24118,0,2,4
6847,1,1,24117,24118,24119,1,2,0
6848,6,2,24123,24123,24125,0,2,4
6849,5,2,24128,24128,24130,0,2,3
6850,4,1,24132,24132,24133,0,1,2
6851,4,1,24136,24136,24137,0,1,3
6852,6,1,24142,24142,24143,0,1,5
6853,3,1,24145,24145,24146,0,1,2
6854,2,2,24147,24147,24149,0,2,1
6855,6,1,24153,24153,24154,0,1,4
6856,1,3,24154,24154,24157,0,3,0
6857,4,2,24158,24158,24160,0,2,1
6858,4,3,24162,24162,24165,0,3,2
6859,5,3,24167,24167,24170,0,3,2
6860,6,3,24173,24173,24176,0,3,3
6861,5,3,24178,24178,24181,0,3,2
6862,1,3,24179,24181,24184,2,5,0
6863,3,3,24182,24184,24187,2,5,0
6864,3,3,24185,24187,24190,2,5,0
6865,5,1,24190,24190,24191,0,1,0
6866,5,3,24195,24195,24198,0,3,4
6867,1,3,24196,24198,24201,2,5,0
6868,3,1,24199,24201,24202,2,3,0
6869,4,1,24203,24203,24204,0,1,1
6870,4,3,24207,24207,24210,0,3,3
6871,6,2,24213,24213,24215,0,2,3
6872,2,1,24215,24215,24216,0,1,0
6873,6,1,24221,24221,24222,0,1,5
6874,6,3,24227,24227,24230,0,3,5
6875,4,3,24231,24231,24234,0,3,1
6876,4,2,24235,24235,24237,0,2,1
6877,4,3,24239,24239,24242,0,3,2
6878,1,1,24240,24242,24243,2,3,0
6879,1,2,24241,24243,24245,2,4,0
6880,4,2,24245,24245,24247,0,2,0
6881,3,3,24248,24248,24251,0,3,1
6882,3,3,24251,24251,24254,0,3,0
6883,6,3,24257,24257,24260,0,3,3
6884,6,1,24263,24263,24264,0,1,3
6885,6,3,24269,24269,24272,0,3,5
6886,5,3,24274,24274,24277,0,3,2
6887,3,3,24277,24277,24280,0,3,0
6888,2,1,24279,24280,24281,1,2,0
6889,1,1,24280,24281,24282,1,2,0
6890,3,1,24283,24283,24284,0,1,1
6891,5,1,24288,24288,24289,0,1,4
6892,3,1,24291,24291,24292,0,1,2
6893,1,1,24292,24292,24293,0,1,0
6894,3,2,24295,24295,24297,0,2,2
6895,5,1,24300,24300,24301,0,1,3
6896,4,1,24304,24304,24305,0,1,3
6897,6,3,24310,24310,24313,0,3,5
6898,3,1,24313,24313,24314,0,1,0
6899,1,1,24314,24314,24315,0,1,0
6900,1,3,24315,24315,24318,0,3,0
6901,2,2,24317,24318,24320,1,3,0
6902,1,3,24318,24320,24323,2,5,0
6903,1,1,24319,24323,24324,4,5,0
6904,1,2,24320,24324,24326,4,6,0
6905,3,1,24323,24326,24327,3,4,0
6906,5,3,24328,24328,24331,0,3,1
6907,5,3,24333,24333,24336,0,3,2
6908,5,1,24338,24338,24339,0,1,2
6909,1,1,24339,24339,24340,0,1,0
6910,4,2,24343,24343,24345,0,2,3
6911,5,1,24348,24348,24349,0,1,3
6912,6,1,24354,24354,24355,0,1,5
6913,3,1,24357,24357,24358,0,1,2
6914,2,2,24359,24359,24361,0,2,1
6915,6,1,24365,24365,24366,0,1,4
6916,3,2,24368,24368,24370,0,2,2
6917,4,3,24372,24372,24375,0,3,2
6918,3,1,24375,24375,24376,0,1,0
6919,4,2,24379,24379,24381,0,2,3
6920,3,3,24382,24382,24385,0,3,1
6921,6,2,24388,24388,24390,0,2,3
6922,3,3,24391,24391,24394,0,3,1
6923,2,3,24393,24394,24397,1,4,0
6924,5,2,24398,24398,24400,0,2,1
6925,5,2,24403,24403,24405,0,2,3
6926,4,2,24407,24407,24409,0,2,2
6927,2,1,24409,24409,24410,0,1,0
6928,3,1,24412,24412,24413,0,1,2
6929,6,2,24418,24418,24420,0,2,5
6930,5,1,24423,24423,24424,0,1,3
6931,2,2,24425,24425,24427,0,2,1
6932,6,2,24431,24431,24433,0,2,4
6933,6,1,24437,24437,24438,0,1,4
6934,6,1,24443,24443,24444,0,1,5
6935,5,2,24448,24448,24450,0,2,4
6936,4,3,24452,24452,24455,0,3,2
6937,4,3,24456,24456,24459,0,3,1
6938,3,2,24459,24459,24461,0,2,0
6939,3,1,24462,24462,24463,0,1,1
6940,6,3,24468,24468,24471,0,3,5
6941,3,3,24471,24471,24474,0,3,0
6942,3,3,24474,24474,24477,0,3,0
6943,3,2,24477,24477,24479,0,2,0
6944,6,2,24483,24483,24485,0,2,4
6945,4,3,24487,24487,24490,0,3,2
6946,6,2,24493,24493,24495,0,2,3
6947,4,1,24497,24497,24498,0,1,2
6948,4,2,24501,24501,24503,0,2,3
6949,4,2,24505,24505,24507,0,2,2
6950,5,1,24510,24510,24511,0,1,3
6951,2,3,24512,24512,24515,0,3,1
6952,1,2,24513,24515,24517,2,4,0
6953,4,2,24517,24517,24519,0,2,0
6954,3,2,24520,24520,24522,0,2,1
6955,3,2,24523,24523,24525,0,2,1
6956,2,1,24525,24525,24526,0,1,0
6957,2,3,24527,24527,24530,0,3,1
6958,4,3,24531,24531,24534,0,3,1
6959,4,1,24535,24535,24536,0,1,1
6960,1,1,24536,24536,24537,0,1,0
6961,1,1,24537,24537,24538,0,1,0
6962,1,3,24538,24538,24541,0,3,0
6963,1,3,24539,24541,24544,2,5,0
6964,3,3,24542,24544,24547,2,5,0
6965,5,2,24547,24547,24549,0,2,0
6966,5,3,24552,24552,24555,0,3,3
6967,3,1,24555,24555,24556,0,1,0
6968,3,3,24558,24558,24561,0,3,2
6969,5,3,24563,24563,24566,0,3,2
6970,2,3,24565,24566,24569,1,4,0
6971,5,2,24570,24570,24572,0,2,1
6972,6,1,24576,24576,24577,0,1,4
6973,4,3,24580,24580,24583,0,3,3
6974,3,3,24583,24583,24586,0,3,0
6975,6,3,24589,24589,24592,0,3,3
6976,3,3,24592,24592,24595,0,3,0
6977,1,1,24593,24595,24596,2,3,0
6978,6,3,24599,24599,24602,0,3,3
6979,2,1,24601,24602,24603,1,2,0
6980,2,1,24603,24603,24604,0,1,0
6981,5,1,24608,24608,24609,0,1,4
6982,6,3,24614,24614,24617,0,3,5
6983,5,3,24619,24619,24622,0,3,2
6984,4,3,24623,24623,24626,0,3,1
6985,1,3,24624,24626,24629,2,5,0
6986,1,3,24625,24629,24632,4,7,0
6987,6,2,24631,24632,24634,1,3,0
6988,1,3,24632,24634,24637,2,5,0
6989,4,3,24636,24637,24640,1,4,0
6990,1,2,24637,24640,24642,3,5,0
6991,4,2,24641,24642,24644,1,3,0
6992,2,1,24643,24644,24645,1,2,0
6993,6,3,24649,24649,24652,0,3,4
6994,4,3,24653,24653,24656,0,3,1
6995,3,3,24656,24656,24659,0,3,0
6996,4,2,24660,24660,24662,0,2,1
6997,2,1,24662,24662,24663,0,1,0
6998,5,3,24667,24667,24670,0,3,4
6999,6,2,24673,24673,24675,0,2,3
7000,1,1,24674,24675,24676,1,2,0
7001,4,2,24678,24678,24680,0,2,2
7002,6,2,24684,24684,24686,0,2,4
7003,4,3,24688,24688,24691,0,3,2
7004,6,2,24694,24694,24696,0,2,3
7005,3,2,24697,24697,24699,0,2,1
7006,5,2,24702,24702,24704,0,2,3
7007,5,3,24707,24707,24710,0,3,3
7008,5,1,24712,24712,24713,0,1,2
7009,6,3,24718,24718,24721,0,3,5
7010,4,2,24722,24722,24724,0,2,1
7011,2,3,24724,24724,24727,0,3,0
7012,3,1,24727,24727,24728,0,1,0
7013,1,1,24728,24728,24729,0,1,0
7014,6,3,24734,24734,24737,0,3,5
7015,6,1,24740,24740,24741,0,1,3
7016,3,3,24743,24743,24746,0,3,2
7017,2,1,24745,24746,24747,1,2,0
7018,1,1,24746,24747,24748,1,2,0
7019,3,2,24749,24749,24751,0,2,1
7020,1,1,24750,24751,24752,1,2,0
7021,3,3,24753,24753,24756,0,3,1
7022,6,2,24759,24759,24761,0,2,3
7023,4,3,24763,24763,24766,0,3,2
7024,5,2,24768,24768,24770,0,2,2
7025,6,1,24774,24774,24775,0,1,4
7026,2,1,24776,24776,24777,0,1,1
7027,5,2,24781,24781,24783,0,2,4
7028,6,3,24787,24787,24790,0,3,4
7029,4,2,24791,24791,24793,0,2,1
7030,6,2,24797,24797,24799,0,2,4
7031,1,3,24798,24799,24802,1,4,0
7032,5,2,24803,24803,24805,0,2,1
7033,1,2,24804,24805,24807,1,3,0
7034,3,3,24807,24807,24810,0,3,0
7035,6,2,24813,24813,24815,0,2,3
7036,4,2,24817,24817,24819,0,2,2
7037,6,2,24823,24823,24825,0,2,4
7038,4,1,24827,24827,24828,0,1,2
7039,4,2,24831,24831,24833,0,2,3
7040,6,2,24837,24837,24839,0,2,4
7041,3,1,24840,24840,24841,0,1,1
7042,5,2,24845,24845,24847,0,2,4
7043,2,3,24847,24847,24850,0,3,0
7044,3,1,24850,24850,24851,0,1,0
7045,6,1,24856,24856,24857,0,1,5
7046,5,1,24861,24861,24862,0,1,4
7047,3,1,24864,24864,24865,0,1,2
7048,1,3,24865,24865,24868,0,3,0
7049,3,1,24868,24868,24869,0,1,0
7050,4,1,24872,24872,24873,0,1,3
7051,2,1,24874,24874,24875,0,1,1
7052,1,3,24875,24875,24878,0,3,0
7053,1,3,24876,24878,24881,2,5,0
7054,2,2,24878,24881,24883,3,5,0
7055,6,2,24884,24884,24886,0,2,1
7056,4,3,24888,24888,24891,0,3,2
7057,5,2,24893,24893,24895,0,2,2
7058,2,2,24895,24895,24897,0,2,0
7059,4,3,24899,24899,24902,0,3,2
7060,6,1,24905,24905,24906,0,1,3
7061,1,1,24906,24906,24907,0,1,0
7062,5,2,24911,24911,24913,0,2,4
7063,3,2,24914,24914,24916,0,2,1
7064,2,1,24916,24916,24917,0,1,0
7065,6,2,24922,24922,24924,0,2,5
7066,2,1,24924,24924,24925,0,1,0
7067,4,3,24928,24928,24931,0,3,3
7068,6,1,24934,24934,24935,0,1,3
7069,2,3,24936,24936,24939,0,3,1
7070,2,1,24938,24939,24940,1,2,0
7071,5,2,24943,24943,24945,0,2,3
7072,4,3,24947,24947,24950,0,3,2
7073,4,3,24951,24951,24954,0,3,1
7074,3,3,24954,24954,24957,0,3,0
7075,2,1,24956,24957,24958,1,2,0
7076,2,2,24958,24958,24960,0,2,0
7077,4,3,24962,24962,24965,0,3,2
7078,6,3,24968,24968,24971,0,3,3
7079,2,3,24970,24971,24974,1,4,0
7080,3,2,24973,24974,24976,1,3,0
7081,5,2,24978,24978,24980,0,2,2
7082,4,2,24982,24982,24984,0,2,2
7083,4,2,24986,24986,24988,0,2,2
7084,6,1,24992,24992,24993,0,1,4
7085,4,3,24996,24996,24999,0,3,3
7086,1,2,24997,24999,25001,2,4,0
7087,1,1,24998,25001,25002,3,4,0
7088,5,1,25003,25003,25004,0,1,1
7089,4,2,25007,25007,25009,0,2,3
7090,6,2,25013,25013,25015,0,2,4
7091,2,3,25015,25015,25018,0,3,0
7092,2,2,25017,25018,25020,1,3,0
7093,4,3,25021,25021,25024,0,3,1
7094,5,3,25026,25026,25029,0,3,2
7095,3,2,25029,25029,25031,0,2,0
7096,2,3,25031,25031,25034,0,3,0
7097,1,3,25032,25034,25037,2,5,0
7098,6,2,25038,25038,25040,0,2,1
7099,2,3,25040,25040,25043,0,3,0
7100,2,3,25042,25043,25046,1,4,0
7101,2,1,25044,25046,25047,2,3,0
7102,4,1,25048,25048,25049,0,1,1
7103,4,1,25052,25052,25053,0,1,3
7104,1,1,25053,25053,25054,0,1,0
7105,4,1,25057,25057,25058,0,1,3
7106,6,1,25063,25063,25064,0,1,5
7107,4,1,25067,25067,25068,0,1,3
7108,3,2,25070,25070,25072,0,2,2
7109,1,2,25071,25072,25074,1,3,0
7110,5,2,25076,25076,25078,0,2,2
7111,1,3,25077,25078,25081,1,4,0
7112,6,2,25083,25083,25085,0,2,2
7113,4,2,25087,25087,25089,0,2,2
7114,6,1,25093,25093,25094,0,1,4
7115,5,2,25098,25098,25100,0,2,4
7116,3,3,25101,25101,25104,0,3,1
7117,1,3,25102,25104,25107,2,5,0
7118,3,2,25105,25107,25109,2,4,0
7119,1,3,25106,25109,25112,3,6,0
7120,5,3,25111,25112,25115,1,4,0
7121,3,1,25114,25115,25116,1,2,0
7122,1,2,25115,25116,25118,1,3,0
7123,6,3,25121,25121,25124,0,3,3
7124,1,3,25122,25124,25127,2,5,0
7125,2,1,25124,25127,25128,3,4,0
7126,1,1,25125,25128,25129,3,4,0
7127,6,3,25131,25131,25134,0,3,2
7128,3,2,25134,25134,25136,0,2,0
7129,1,3,25135,25136,25139,1,4,0
7130,5,2,25140,25140,25142,0,2,1
7131,2,1,25142,25142,25143,0,1,0
7132,3,3,25145,25145,25148,0,3,2
7133,4,1,25149,25149,25150,0,1,1
7134,2,1,25151,25151,25152,0,1,1
7135,6,1,25157,25157,25158,0,1,5
7136,1,2,25158,25158,25160,0,2,0
7137,5,2,25163,25163,25165,0,2,3
7138,3,3,25166,25166,25169,0,3,1
7139,1,2,25167,25169,25171,2,4,0
7140,5,3,25172,25172,25175,0,3,1
7141,3,1,25175,25175,25176,0,1,0
7142,6,2,25181,25181,25183,0,2,5
7143,2,1,25183,25183,25184,0,1,0
7144,6,2,25189,25189,25191,0,2,5
7145,5,3,25194,25194,25197,0,3,3
7146,2,2,25196,25197,25199,1,3,0
7147,2,2,25198,25199,25201,1,3,0
7148,4,1,25202,25202,25203,0,1,1
7149,5,1,25207,25207,25208,0,1,4
7150,1,2,25208,25208,25210,0,2,0
7151,1,1,25209,25210,25211,1,2,0
7152,4,3,25213,25213,25216,0,3,2
7153,1,3,25214,25216,25219,2,5,0
7154,4,2,25218,25219,25221,1,3,0
7155,6,1,25224,25224,25225,0,1,3
7156,2,3,25226,25226,25229,0,3,1
7157,4,2,25230,25230,25232,0,2,1
7158,5,3,25235,25235,25238,0,3,3
7159,2,1,25237,25238,25239,1,2,0
7160,3,3,25240,25240,25243,0,3,1
7161,6,3,25246,25246,25249,0,3,3
7162,4,2,25250,25250,25252,0,2,1
7163,4,1,25254,25254,25255,0,1,2
7164,4,2,25258,25258,25260,0,2,3
7165,1,3,25259,25260,25263,1,4,0
7166,4,3,25263,25263,25266,0,3,0
7167,4,2,25267,25267,25269,0,2,1
7168,3,1,25270,25270,25271,0,1,1
7169,5,2,25275,25275,25277,0,2,4
7170,4,2,25279,25279,25281,0,2,2
7171,2,1,25281,25281,25282,0,1,0
7172,2,3,25283,25283,25286,0,3,1
7173,5,2,25288,25288,25290,0,2,2
7174,2,1,25290,25290,25291,0,1,0
7175,1,3,25291,25291,25294,0,3,0
7176,2,1,25293,25294,25295,1,2,0
7177,2,3,25295,25295,25298,0,3,0
7178,3,1,25298,25298,25299,0,1,0
7179,4,3,25302,25302,25305,0,3,3
7180,3,3,25305,25305,25308,0,3,0
7181,6,3,25311,25311,25314,0,3,3
7182,2,3,25313,25314,25317,1,4,0
7183,2,2,25315,25317,25319,2,4,0
7184,2,3,25317,25319,25322,2,5,0
7185,5,1,25322,25322,25323,0,1,0
7186,6,3,25328,25328,25331,0,3,5
7187,6,1,25334,25334,25335,0,1,3
7188,2,3,25336,25336,25339,0,3,1
7189,2,2,25338,25339,25341,1,3,0
7190,3,1,25341,25341,25342,0,1,0
7191,6,3,25347,25347,25350,0,3,5
7192,4,2,25351,25351,25353,0,2,1
7193,1,2,25352,25353,25355,1,3,0
7194,6,3,25358,25358,25361,0,3,3
7195,2,2,25360,25361,25363,1,3,0
7196,6,2,25366,25366,25368,0,2,3
7197,1,3,25367,25368,25371,1,4,0
7198,5,2,25372,25372,25374,0,2,1
7199,4,2,25376,25376,25378,0,2,2
7200,6,2,25382,25382,25384,0,2,4
7201,2,3,25384,25384,25387,0,3,0
7202,5,2,25389,25389,25391,0,2,2
7203,3,1,25392,25392,25393,0,1,1
7204,6,2,25398,25398,25400,0,2,5
7205,4,2,25402,25402,25404,0,2,2
7206,2,3,25404,25404,25407,0,3,0
7207,5,2,25409,25409,25411,0,2,2
7208,5,3,25414,25414,25417,0,3,3
7209,2,2,25416,25417,25419,1,3,0
7210,5,2,25421,25421,25423,0,2,2
7211,5,1,25426,25426,25427,0,1,3
7212,1,1,25427,25427,25428,0,1,0
7213,1,3,25428,25428,25431,0,3,0
7214,2,1,25430,25431,25432,1,2,0
7215,2,1,25432,25432,25433,0,1,0
7216,4,1,25436,25436,25437,0,1,3
7217,1,3,25437,25437,25440,0,3,0
7218,4,3,25441,25441,25444,0,3,1
7219,2,3,25443,25444,25447,1,4,0
7220,5,2,25448,25448,25450,0,2,1
7221,4,3,25452,25452,25455,0,3,2
7222,6,3,25458,25458,25461,0,3,3
7223,3,3,25461,25461,25464,0,3,0
7224,2,3,25463,25464,25467,1,4,0
7225,5,3,25468,25468,25471,0,3,1
7226,6,2,25474,25474,25476,0,2,3
7227,5,2,25479,25479,25481,0,2,3
7228,1,1,25480,25481,25482,1,2,0
7229,2,2,25482,25482,25484,0,2,0
7230,5,2,25487,25487,25489,0,2,3
7231,5,2,25492,25492,25494,0,2,3
7232,5,2,25497,25497,25499,0,2,3
7233,4,3,25501,25501,25504,0,3,2
7234,6,3,25507,25507,25510,0,3,3
7235,3,2,25510,25510,25512,0,2,0
7236,2,1,25512,25512,25513,0,1,0
7237,6,2,25518,25518,25520,0,2,5
7238,2,1,25520,25520,25521,0,1,0
7239,2,2,25522,25522,25524,0,2,1
7240,3,1,25525,25525,25526,0,1,1
7241,5,3,25530,25530,25533,0,3,4
7242,2,3,25532,25533,25536,1,4,0
7243,2,2,25534,25536,25538,2,4,0
7244,2,3,25536,25538,25541,2,5,0
7245,5,3,25541,25541,25544,0,3,0
7246,6,2,25547,25547,25549,0,2,3
7247,4,3,25551,25551,25554,0,3,2
7248,5,2,25556,25556,25558,0,2,2
7249,2,3,25558,25558,25561,0,3,0
7250,2,2,25560,25561,25563,1,3,0
7251,2,3,25562,25563,25566,1,4,0
7252,5,1,25567,25567,25568,0,1,1
7253,4,3,25571,25571,25574,0,3,3
7254,3,1,25574,25574,25575,0,1,0
7255,4,1,25578,25578,25579,0,1,3
7256,4,1,25582,25582,25583,0,1,3
7257,5,1,25587,25587,25588,0,1,4
7258,1,3,25588,25588,25591,0,3,0
7259,2,1,25590,25591,25592,1,2,0
7260,6,2,25596,25596,25598,0,2,4
7261,5,3,25601,25601,25604,0,3,3
7262,5,3,25606,25606,25609,0,3,2
7263,2,3,25608,25609,25612,1,4,0
7264,1,1,25609,25612,25613,3,4,0
7265,1,2,25610,25613,25615,3,5,0
7266,5,1,25615,25615,25616,0,1,0
7267,5,3,25620,25620,25623,0,3,4
7268,2,3,25622,25623,25626,1,4,0
7269,3,1,25625,25626,25627,1,2,0
7270,4,3,25629,25629,25632,0,3,2
7271,2,3,25631,25632,25635,1,4,0
7272,1,1,25632,25635,25636,3,4,0
7273,3,3,25635,25636,25639,1,4,0
7274,1,2,25636,25639,25641,3,5,0
7275,2,1,25638,25641,25642,3,4,0
7276,6,1,25644,25644,25645,0,1,2
7277,5,1,25649,25649,25650,0,1,4
7278,5,2,25654,25654,25656,0,2,4
7279,6,3,25660,25660,25663,0,3,4
7280,4,2,25664,25664,25666,0,2,1
7281,6,2,25670,25670,25672,0,2,4
7282,5,2,25675,25675,25677,0,2,3
7283,3,1,25678,25678,25679,0,1,1
7284,6,2,25684,25684,25686,0,2,5
7285,2,1,25686,25686,25687,0,1,0
7286,4,3,25690,25690,25693,0,3,3
7287,1,2,25691,25693,25695,2,4,0
7288,4,1,25695,25695,25696,0,1,0
7289,1,3,25696,25696,25699,0,3,0
7290,5,1,25701,25701,25702,0,1,2
7291,6,1,25707,25707,25708,0,1,5
7292,6,1,25713,25713,25714,0,1,5
7293,1,2,25714,25714,25716,0,2,0
7294,2,2,25716,25716,25718,0,2,0
7295,3,2,25719,25719,25721,0,2,1
7296,1,1,25720,25721,25722,1,2,0
7297,1,3,25721,25722,25725,1,4,0
7298,5,1,25726,25726,25727,0,1,1
7299,6,2,25732,25732,25734,0,2,5
7300,5,2,25737,25737,25739,0,2,3
7301,1,3,25738,25739,25742,1,4,0
7302,2,1,25740,25742,25743,2,3,0
7303,3,2,25743,25743,25745,0,2,0
7304,5,3,25748,25748,25751,0,3,3
7305,3,1,25751,25751,25752,0,1,0
7306,5,3,25756,25756,25759,0,3,4
7307,6,2,25762,25762,25764,0,2,3
7308,4,3,25766,25766,25769,0,3,2
7309,2,3,25768,25769,25772,1,4,0
7310,1,3,25769,25772,25775,3,6,0
7311,2,1,25771,25775,25776,4,5,0
7312,2,3,25773,25776,25779,3,6,0
7313,3,3,25776,25779,25782,3,6,0
7314,1,2,25777,25782,25784,5,7,0
7315,4,2,25781,25784,25786,3,5,0
7316,6,1,25787,25787,25788,0,1,1
7317,4,1,25791,25791,25792,0,1,3
7318,3,2,25794,25794,25796,0,2,2
7319,6,3,25800,25800,25803,0,3,4
7320,6,1,25806,25806,25807,0,1,3
7321,1,1,25807,25807,25808,0,1,0
7322,1,1,25808,25808,25809,0,1,0
7323,6,1,25814,25814,25815,0,1,5
7324,5,2,25819,25819,25821,0,2,4
7325,3,3,25822,25822,25825,0,3,1
7326,3,3,25825,25825,25828,0,3,0
7327,1,2,25826,25828,25830,2,4,0
7328,6,1,25832,25832,25833,0,1,2
7329,1,3,25833,25833,25836,0,3,0
7330,4,3,25837,25837,25840,0,3,1
7331,4,1,25841,25841,25842,0,1,1
7332,1,1,25842,25842,25843,0,1,0
7333,1,3,25843,25843,25846,0,3,0
7334,2,2,25845,25846,25848,1,3,0
7335,3,1,25848,25848,25849,0,1,0
7336,5,1,25853,25853,25854,0,1,4
7337,4,1,25857,25857,25858,0,1,3
7338,4,1,25861,25861,25862,0,1,3
7339,2,2,25863,25863,25865,0,2,1
7340,1,1,25864,25865,25866,1,2,0
7341,3,2,25867,25867,25869,0,2,1
7342,2,3,25869,25869,25872,0,3,0
7343,3,2,25872,25872,25874,0,2,0
7344,6,2,25878,25878,25880,0,2,4
7345,3,1,25881,25881,25882,0,1,1
7346,4,1,25885,25885,25886,0,1,3
7347,6,3,25891,25891,25894,0,3,5
7348,3,2,25894,25894,25896,0,2,0
7349,2,1,25896,25896,25897,0,1,0
7350,3,1,25899,25899,25900,0,1,2
7351,4,1,25903,25903,25904,0,1,3
7352,4,3,25907,25907,25910,0,3,3
7353,4,2,25911,25911,25913,0,2,1
7354,2,3,25913,25913,25916,0,3,0
7355,2,1,25915,25916,25917,1,2,0
7356,3,2,25918,25918,25920,0,2,1
7357,6,1,25924,25924,25925,0,1,4
7358,5,3,25929,25929,25932,0,3,4
7359,2,3,25931,25932,25935,1,4,0
7360,1,3,25932,25935,25938,3,6,0
7361,4,3,25936,25938,25941,2,5,0
7362,5,2,25941,25941,25943,0,2,0
7363,2,1,25943,25943,25944,0,1,0
7364,1,1,25944,25944,25945,0,1,0
7365,1,2,25945,25945,25947,0,2,0
7366,3,2,25948,25948,25950,0,2,1
7367,5,2,25953,25953,25955,0,2,3
7368,6,2,25959,25959,25961,0,2,4
7369,1,1,25960,25961,25962,1,2,0
7370,3,3,25963,25963,25966,0,3,1
7371,1,3,25964,25966,25969,2,5,0
7372,6,3,25970,25970,25973,0,3,1
7373,4,2,25974,25974,25976,0,2,1
7374,2,2,25976,25976,25978,0,2,0
7375,3,2,25979,25979,25981,0,2,1
7376,5,2,25984,25984,25986,0,2,3
7377,3,3,25987,25987,25990,0,3,1
7378,1,1,25988,25990,25991,2,3,0
7379,1,3,25989,25991,25994,2,5,0
7380,5,2,25994,25994,25996,0,2,0
7381,5,3,25999,25999,26002,0,3,3
7382,1,3,26000,26002,26005,2,5,0
7383,6,2,26006,26006,26008,0,2,1
7384,4,1,26010,26010,26011,0,1,2
7385,3,1,26013,26013,26014,0,1,2
7386,1,2,26014,26014,26016,0,2,0
7387,1,3,26015,26016,26019,1,4,0
7388,4,2,26019,26019,26021,0,2,0
7389,3,3,26022,26022,26025,0,3,1
7390,1,3,26023,26025,26028,2,5,0
7391,3,1,26026,26028,26029,2,3,0
7392,4,1,26030,26030,26031,0,1,1
7393,1,3,26031,26031,26034,0,3,0
7394,2,3,26033,26034,26037,1,4,0
7395,1,3,26034,26037,26040,3,6,0
7396,4,2,26038,26040,26042,2,4,0
7397,4,2,26042,26042,26044,0,2,0
7398,2,1,26044,26044,26045,0,1,0
7399,2,1,26046,26046,26047,0,1,1
7400,4,1,26050,26050,26051,0,1,3
7401,3,3,26053,26053,26056,0,3,2
7402,4,2,26057,26057,26059,0,2,1
7403,4,1,26061,26061,26062,0,1,2
7404,1,2,26062,26062,26064,0,2,0
7405,5,3,26067,26067,26070,0,3,3
7406,5,1,26072,26072,26073,0,1,2
7407,3,2,26075,26075,26077,0,2,2
7408,6,2,26081,26081,26083,0,2,4
7409,5,1,26086,26086,26087,0,1,3
7410,4,1,26090,26090,26091,0,1,3
7411,3,1,26093,26093,26094,0,1,2
7412,2,3,26095,26095,26098,0,3,1
7413,3,3,26098,26098,26101,0,3,0
7414,3,1,26101,26101,26102,0,1,0
7415,5,2,26106,26106,26108,0,2,4
7416,2,3,26108,26108,26111,0,3,0
7417,2,2,26110,26111,26113,1,3,0
7418,3,3,26113,26113,26116,0,3,0
7419,6,1,26119,26119,26120,0,1,3
7420,5,1,26124,26124,26125,0,1,4
7421,1,2,26125,26125,26127,0,2,0
7422,5,2,26130,26130,26132,0,2,3
7423,3,1,26133,26133,26134,0,1,1
7424,5,2,26138,26138,26140,0,2,4
7425,3,2,26141,26141,26143,0,2,1
7426,1,1,26142,26143,26144,1,2,0
7427,6,1,26148,26148,26149,0,1,4
7428,6,1,26154,26154,26155,0,1,5
7429,1,1,26155,26155,26156,0,1,0
7430,2,1,26157,26157,26158,0,1,1
7431,4,2,26161,26161,26163,0,2,3
7432,5,2,26166,26166,26168,0,2,3
7433,6,3,26172,26172,26175,0,3,4
7434,1,1,26173,26175,26176,2,3,0
7435,6,2,26179,26179,26181,0,2,3
7436,1,3,26180,26181,26184,1,4,0
7437,4,3,26184,26184,26187,0,3,0
7438,4,1,26188,26188,26189,0,1,1
7439,6,3,26194,26194,26197,0,3,5
7440,5,2,26199,26199,26201,0,2,2
7441,2,1,26201,26201,26202,0,1,0
7442,1,1,26202,26202,26203,0,1,0
7443,4,2,26206,26206,26208,0,2,3
7444,1,1,26207,26208,26209,1,2,0
7445,1,2,26208,26209,26211,1,3,0
7446,4,2,26212,26212,26214,0,2,1
7447,6,2,26218,26218,26220,0,2,4
7448,2,3,26220,26220,26223,0,3,0
7449,5,3,26225,26225,26228,0,3,2
7450,1,3,26226,26228,26231,2,5,0
7451,6,1,26232,26232,26233,0,1,1
7452,1,1,26233,26233,26234,0,1,0
7453,1,2,26234,26234,26236,0,2,0
7454,4,2,26238,26238,26240,0,2,2
7455,4,2,26242,26242,26244,0,2,2
7456,6,2,26248,26248,26250,0,2,4
7457,1,3,26249,26250,26253,1,4,0
7458,4,3,26253,26253,26256,0,3,0
7459,1,3,26254,26256,26259,2,5,0
7460,4,3,26258,26259,26262,1,4,0
7461,6,1,26264,26264,26265,0,1,2
7462,6,3,26270,26270,26273,0,3,5
7463,2,2,26272,26273,26275,1,3,0
7464,2,3,26274,26275,26278,1,4,0
7465,2,2,26276,26278,26280,2,4,0
7466,2,2,26278,26280,26282,2,4,0
7467,2,1,26280,26282,26283,2,3,0
7468,3,3,26283,26283,26286,0,3,0
7469,2,3,26285,26286,26289,1,4,0
7470,4,1,26289,26289,26290,0,1,0
7471,4,1,26293,26293,26294,0,1,3
7472,1,1,26294,26294,26295,0,1,0
7473,1,2,26295,26295,26297,0,2,0
7474,5,2,26300,26300,26302,0,2,3
7475,2,3,26302,26302,26305,0,3,0
7476,3,3,26305,26305,26308,0,3,0
7477,6,1,26311,26311,26312,0,1,3
7478,1,2,26312,26312,26314,0,2,0
7479,6,2,26318,26318,26320,0,2,4
7480,4,3,26322,26322,26325,0,3,2
7481,6,1,26328,26328,26329,0,1,3
7482,4,3,26332,26332,26335,0,3,3
7483,5,2,26337,26337,26339,0,2,2
7484,3,1,26340,26340,26341,0,1,1
7485,3,2,26343,26343,26345,0,2,2
7486,1,2,26344,26345,26347,1,3,0
7487,2,2,26346,26347,26349,1,3,0
7488,4,3,26350,26350,26353,0,3,1
7489,5,1,26355,26355,26356,0,1,2
7490,4,2,26359,26359,26361,0,2,3
7491,5,2,26364,26364,26366,0,2,3
7492,1,3,26365,26366,26369,1,4,0
7493,6,3,26371,26371,26374,0,3,2
7494,2,3,26373,26374,26377,1,4,0
7495,2,2,26375,26377,26379,2,4,0
7496,4,2,26379,26379,26381,0,2,0
7497,4,1,26383,26383,26384,0,1,2
7498,3,3,26386,26386,26389,0,3,2
7499,5,2,26391,26391,26393,0,2,2
7500,4,1,26395,26395,26396,0,1,2
7501,4,1,26399,26399,26400,0,1,3
7502,5,1,26404,26404,26405,0,1,4
7503,6,3,26410,26410,26413,0,3,5
7504,2,3,26412,26413,26416,1,4,0
7505,1,3,26413,26416,26419,3,6,0
7506,2,3,26415,26419,26422,4,7,0
7507,1,2,26416,26422,26424,6,8,0
7508,1,3,26417,26424,26427,7,10,0
7509,3,1,26420,26427,26428,7,8,0
7510,6,2,26426,26428,26430,2,4,0
7511,2,3,26428,26430,26433,2,5,0
7512,1,2,26429,26433,26435,4,6,0
7513,4,3,26433,26435,26438,2,5,0
7514,4,1,26437,26438,26439,1,2,0
7515,4,3,26441,26441,26444,0,3,2
7516,1,2,26442,26444,26446,2,4,0
7517,4,1,26446,26446,26447,0,1,0
7518,1,1,26447,26447,26448,0,1,0
7519,3,3,26450,26450,26453,0,3,2
7520,1,2,26451,26453,26455,2,4,0
7521,3,1,26454,26455,26456,1,2,0
7522,4,2,26458,26458,26460,0,2,2
7523,5,1,26463,26463,26464,0,1,3
7524,5,2,26468,26468,26470,0,2,4
7525,6,2,26474,26474,26476,0,2,4
7526,4,1,26478,26478,26479,0,1,2
7527,1,1,26479,26479,26480,0,1,0
7528,6,3,26485,26485,26488,0,3,5
7529,4,2,26489,26489,26491,0,2,1
7530,6,2,26495,26495,26497,0,2,4
7531,3,1,26498,26498,26499,0,1,1
7532,1,1,26499,26499,26500,0,1,0
7533,3,3,26502,26502,26505,0,3,2
7534,1,2,26503,26505,26507,2,4,0
7535,3,1,26506,26507,26508,1,2,0
7536,6,3,26512,26512,26515,0,3,4
7537,6,3,26518,26518,26521,0,3,3
7538,4,2,26522,26522,26524,0,2,1
7539,4,2,26526,26526,26528,0,2,2
7540,1,2,26527,26528,26530,1,3,0
7541,2,1,26529,26530,26531,1,2,0
7542,6,3,26535,26535,26538,0,3,4
7543,4,1,26539,26539,26540,0,1,1
7544,2,2,26541,26541,26543,0,2,1
7545,2,1,26543,26543,26544,0,1,0
7546,2,2,26545,26545,26547,0,2,1
7547,1,1,26546,26547,26548,1,2,0
7548,5,3,26551,26551,26554,0,3,3
7549,4,3,26555,26555,26558,0,3,1
7550,3,2,26558,26558,26560,0,2,0
7551,2,2,26560,26560,26562,0,2,0
7552,6,3,26566,26566,26569,0,3,4
7553,2,3,26568,26569,26572,1,4,0
7554,6,1,26574,26574,26575,0,1,2
7555,3,2,26577,26577,26579,0,2,2
7556,3,3,26580,26580,26583,0,3,1
7557,2,2,26582,26583,26585,1,3,0
7558,6,1,26588,26588,26589,0,1,3
7559,6,1,26594,26594,26595,0,1,5
7560,5,2,26599,26599,26601,0,2,4
7561,1,3,26600,26601,26604,1,4,0
7562,5,1,26605,26605,26606,0,1,1
7563,6,1,26611,26611,26612,0,1,5
7564,4,2,26615,26615,26617,0,2,3
7565,6,2,26621,26621,26623,0,2,4
7566,1,2,26622,26623,26625,1,3,0
7567,6,1,26628,26628,26629,0,1,3
7568,1,1,26629,26629,26630,0,1,0
7569,4,2,26633,26633,26635,0,2,3
7570,5,3,26638,26638,26641,0,3,3
7571,5,2,26643,26643,26645,0,2,2
7572,1,3,26644,26645,26648,1,4,0
7573,2,2,26646,26648,26650,2,4,0
7574,5,1,26651,26651,26652,0,1,1
7575,4,1,26655,26655,26656,0,1,3
7576,6,1,26661,26661,26662,0,1,5
7577,5,1,26666,26666,26667,0,1,4
7578,6,3,26672,26672,26675,0,3,5
7579,3,2,26675,26675,26677,0,2,0
7580,5,2,26680,26680,26682,0,2,3
7581,5,2,26685,26685,26687,0,2,3
7582,3,1,26688,26688,26689,0,1,1
7583,4,1,26692,26692,26693,0,1,3
7584,2,2,26694,26694,26696,0,2,1
7585,4,1,26698,26698,26699,0,1,2
7586,6,2,26704,26704,26706,0,2,5
7587,2,3,26706,26706,26709,0,3,0
7588,4,2,26710,26710,26712,0,2,1
7589,5,1,26715,26715,26716,0,1,3
7590,2,1,26717,26717,26718,0,1,1
7591,1,2,26718,26718,26720,0,2,0
7592,1,2,26719,26720,26722,1,3,0
7593,4,1,26723,26723,26724,0,1,1
7594,2,1,26725,26725,26726,0,1,1
7595,4,3,26729,26729,26732,0,3,3
7596,4,3,26733,26733,26736,0,3,1
7597,2,1,26735,26736,26737,1,2,0
7598,5,3,26740,26740,26743,0,3,3
7599,5,3,26745,26745,26748,0,3,2
7600,1,3,26746,26748,26751,2,5,0
7601,5,1,26751,26751,26752,0,1,0
7602,6,2,26757,26757,26759,0,2,5
7603,4,3,26761,26761,26764,0,3,2
7604,5,3,26766,26766,26769,0,3,2
7605,3,3,26769,26769,26772,0,3,0
7606,2,1,26771,26772,26773,1,2,0
7607,3,2,26774,26774,26776,0,2,1
7608,1,3,26775,26776,26779,1,4,0
7609,4,1,26779,26779,26780,0,1,0
7610,2,2,26781,26781,26783,0,2,1
7611,1,2,26782,26783,26785,1,3,0
7612,4,3,26786,26786,26789,0,3,1
7613,4,3,26790,26790,26793,0,3,1
7614,5,1,26795,26795,26796,0,1,2
7615,4,1,26799,26799,26800,0,1,3
7616,1,1,26800,26800,26801,0,1,0
7617,2,3,26802,26802,26805,0,3,1
7618,5,2,26807,26807,26809,0,2,2
7619,6,2,26813,26813,26815,0,2,4
7620,4,2,26817,26817,26819,0,2,2
7621,3,1,26820,26820,26821,0,1,1
7622,1,3,26821,26821,26824,0,3,0
7623,2,1,26823,26824,26825,1,2,0
7624,4,3,26827,26827,26830,0,3,2
7625,5,2,26832,26832,26834,0,2,2
7626,6,2,26838,26838,26840,0,2,4
7627,6,1,26844,26844,26845,0,1,4
7628,3,3,26847,26847,26850,0,3,2
7629,2,3,26849,26850,26853,1,4,0
7630,6,1,26855,26855,26856,0,1,2
7631,4,2,26859,26859,26861,0,2,3
7632,4,3,26863,26863,26866,0,3,2
7633,4,2,26867,26867,26869,0,2,1
7634,3,3,26870,26870,26873,0,3,1
7635,5,3,26875,26875,26878,0,3,2
7636,3,1,26878,26878,26879,0,1,0
7637,1,1,26879,26879,26880,0,1,0
7638,5,3,26884,26884,26887,0,3,4
7639,3,3,26887,26887,26890,0,3,0
7640,2,3,26889,26890,26893,1,4,0
7641,1,2,26890,26893,26895,3,5,0
7642,3,1,26893,26895,26896,2,3,0
7643,1,3,26894,26896,26899,2,5,0
7644,4,1,26898,26899,26900,1,2,0
7645,6,2,26904,26904,26906,0,2,4
7646,4,2,26908,26908,26910,0,2,2
7647,5,3,26913,26913,26916,0,3,3
7648,3,2,26916,26916,26918,0,2,0
7649,4,3,26920,26920,26923,0,3,2
7650,4,3,26924,26924,26927,0,3,1
7651,2,3,26926,26927,26930,1,4,0
7652,3,1,26929,26930,26931,1,2,0
7653,3,1,26932,26932,26933,0,1,1
7654,1,2,26933,26933,26935,0,2,0
7655,2,2,26935,26935,26937,0,2,0
7656,3,2,26938,26938,26940,0,2,1
7657,6,1,26944,26944,26945,0,1,4
7658,2,3,26946,26946,26949,0,3,1
7659,1,2,26947,26949,26951,2,4,0
7660,2,2,26949,26951,26953,2,4,0
7661,4,3,26953,26953,26956,0,3,0
7662,2,2,26955,26956,26958,1,3,0
7663,5,1,26960,26960,26961,0,1,2
7664,2,2,26962,26962,26964,0,2,1
7665,3,1,26965,26965,26966,0,1,1
7666,2,3,26967,26967,26970,0,3,1
7667,5,3,26972,26972,26975,0,3,2
7668,5,2,26977,26977,26979,0,2,2
7669,1,2,26978,26979,26981,1,3,0
7670,5,1,26983,26983,26984,0,1,2
7671,4,2,26987,26987,26989,0,2,3
7672,3,1,26990,26990,26991,0,1,1
7673,5,1,26995,26995,26996,0,1,4
7674,5,3,27000,27000,27003,0,3,4
7675,3,1,27003,27003,27004,0,1,0
7676,6,2,27009,27009,27011,0,2,5
7677,3,1,27012,27012,27013,0,1,1
7678,1,3,27013,27013,27016,0,3,0
7679,5,1,27018,27018,27019,0,1,2
7680,5,2,27023,27023,27025,0,2,4
7681,2,1,27025,27025,27026,0,1,0
7682,2,1,27027,27027,27028,0,1,1
7683,5,1,27032,27032,27033,0,1,4
7684,2,1,27034,27034,27035,0,1,1
7685,2,2,27036,27036,27038,0,2,1
7686,6,2,27042,27042,27044,0,2,4
7687,3,1,27045,27045,27046,0,1,1
7688,3,1,27048,27048,27049,0,1,2
7689,5,2,27053,27053,27055,0,2,4
7690,4,1,27057,27057,27058,0,1,2
7691,5,2,27062,27062,27064,0,2,4
7692,6,1,27068,27068,27069,0,1,4
7693,4,2,27072,27072,27074,0,2,3
7694,4,1,27076,27076,27077,0,1,2
7695,5,1,27081,27081,27082,0,1,4
7696,3,3,27084,27084,27087,0,3,2
7697,3,2,27087,27087,27089,0,2,0
7698,3,3,27090,27090,27093,0,3,1
7699,4,2,27094,27094,27096,0,2,1
7700,6,2,27100,27100,27102,0,2,4
7701,5,2,27105,27105,27107,0,2,3
7702,6,2,27111,27111,27113,0,2,4
7703,4,3,27115,27115,27118,0,3,2
7704,1,2,27116,27118,27120,2,4,0
7705,2,1,27118,27120,27121,2,3,0
7706,3,3,27121,27121,27124,0,3,0
7707,3,1,27124,27124,27125,0,1,0
7708,4,1,27128,27128,27129,0,1,3
7709,3,3,27131,27131,27134,0,3,2
7710,4,1,27135,27135,27136,0,1,1
7711,2,1,27137,27137,27138,0,1,1
7712,2,3,27139,27139,27142,0,3,1
7713,1,2,27140,27142,27144,2,4,0
7714,4,3,27144,27144,27147,0,3,0
7715,6,3,27150,27150,27153,0,3,3
7716,5,1,27155,27155,27156,0,1,2
7717,5,1,27160,27160,27161,0,1,4
7718,4,3,27164,27164,27167,0,3,3
7719,5,2,27169,27169,27171,0,2,2
7720,3,3,27172,27172,27175,0,3,1
7721,1,1,27173,27175,27176,2,3,0
7722,4,2,27177,27177,27179,0,2,1
7723,1,3,27178,27179,27182,1,4,0
7724,2,2,27180,27182,27184,2,4,0
7725,6,1,27186,27186,27187,0,1,2
7726,4,3,27190,27190,27193,0,3,3
7727,1,2,27191,27193,27195,2,4,0
7728,3,3,27194,27195,27198,1,4,0
7729,6,3,27200,27200,27203,0,3,2
7730,4,1,27204,27204,27205,0,1,1
7731,3,2,27207,27207,27209,0,2,2
7732,3,3,27210,27210,27213,0,3,1
7733,5,3,27215,27215,27218,0,3,2
7734,6,1,27221,27221,27222,0,1,3
7735,6,2,27227,27227,27229,0,2,5
7736,4,1,27231,27231,27232,0,1,2
7737,2,1,27233,27233,27234,0,1,1
7738,6,3,27239,27239,27242,0,3,5
7739,2,1,27241,27242,27243,1,2,0
7740,4,2,27245,27245,27247,0,2,2
7741,6,2,27251,27251,27253,0,2,4
7742,1,1,27252,27253,27254,1,2,0
7743,6,1,27258,27258,27259,0,1,4
7744,1,2,27259,27259,27261,0,2,0
7745,6,2,27265,27265,27267,0,2,4
7746,4,1,27269,27269,27270,0,1,2
7747,2,2,27271,27271,27273,0,2,1
7748,5,2,27276,27276,27278,0,2,3
7749,5,3,27281,27281,27284,0,3,3
7750,5,1,27286,27286,27287,0,1,2
7751,5,3,27291,27291,27294,0,3,4
7752,2,3,27293,27294,27297,1,4,0
7753,3,2,27296,27297,27299,1,3,0
7754,1,2,27297,27299,27301,2,4,0
7755,2,1,27299,27301,27302,2,3,0
7756,2,1,27301,27302,27303,1,2,0
7757,1,1,27302,27303,27304,1,2,0
7758,6,2,27308,27308,27310,0,2,4
7759,6,1,27314,27314,27315,0,1,4
7760,4,2,27318,27318,27320,0,2,3
7761,2,2,27320,27320,27322,0,2,0
7762,3,1,27323,27323,27324,0,1,1
7763,4,1,27327,27327,27328,0,1,3
7764,4,2,27331,27331,27333,0,2,3
7765,2,3,27333,27333,27336,0,3,0
7766,6,3,27339,27339,27342,0,3,3
7767,1,3,27340,27342,27345,2,5,0
7768,2,3,27342,27345,27348,3,6,0
7769,6,2,27348,27348,27350,0,2,0
7770,2,3,27350,27350,27353,0,3,0
7771,4,2,27354,27354,27356,0,2,1
7772,3,1,27357,27357,27358,0,1,1
7773,2,1,27359,27359,27360,0,1,1
7774,6,2,27365,27365,27367,0,2,5
7775,3,3,27368,27368,27371,0,3,1
7776,6,1,27374,27374,27375,0,1,3
7777,3,2,27377,27377,27379,0,2,2
7778,1,1,27378,27379,27380,1,2,0
7779,4,1,27382,27382,27383,0,1,2
7780,5,3,27387,27387,27390,0,3,4
7781,6,3,27393,27393,27396,0,3,3
7782,2,3,27395,27396,27399,1,4,0
7783,5,1,27400,27400,27401,0,1,1
7784,5,3,27405,27405,27408,0,3,4
7785,5,1,27410,27410,27411,0,1,2
7786,5,2,27415,27415,27417,0,2,4
7787,4,1,27419,27419,27420,0,1,2
7788,2,2,27421,27421,27423,0,2,1
7789,4,3,27425,27425,27428,0,3,2
7790,5,2,27430,27430,27432,0,2,2
7791,4,3,27434,27434,27437,0,3,2
7792,5,2,27439,27439,27441,0,2,2
7793,5,3,27444,27444,27447,0,3,3
7794,5,1,27449,27449,27450,0,1,2
7795,1,2,27450,27450,27452,0,2,0
7796,3,3,27453,27453,27456,0,3,1
7797,3,1,27456,27456,27457,0,1,0
7798,3,1,27459,27459,27460,0,1,2
7799,1,1,27460,27460,27461,0,1,0
7800,2,2,27462,27462,27464,0,2,1
7801,5,3,27467,27467,27470,0,3,3
7802,6,3,27473,27473,27476,0,3,3
7803,3,2,27476,27476,27478,0,2,0
7804,1,2,27477,27478,27480,1,3,0
7805,1,3,27478,27480,27483,2,5,0
7806,5,3,27483,27483,27486,0,3,0
7807,6,1,27489,27489,27490,0,1,3
7808,5,1,27494,27494,27495,0,1,4
7809,4,1,27498,27498,27499,0,1,3
7810,4,2,27502,27502,27504,0,2,3
7811,1,2,27503,27504,27506,1,3,0
7812,2,3,27505,27506,27509,1,4,0
7813,4,3,27509,27509,27512,0,3,0
7814,3,3,27512,27512,27515,0,3,0
7815,1,2,27513,27515,27517,2,4,0
7816,2,3,27515,27517,27520,2,5,0
7817,1,1,27516,27520,27521,4,5,0
7818,2,3,27518,27521,27524,3,6,0
7819,3,1,27521,27524,27525,3,4,0
7820,1,1,27522,27525,27526,3,4,0
7821,2,1,27524,27526,27527,2,3,0
7822,2,3,27526,27527,27530,1,4,0
7823,6,1,27532,27532,27533,0,1,2
7824,4,3,27536,27536,27539,0,3,3
7825,1,2,27537,27539,27541,2,4,0
7826,6,1,27543,27543,27544,0,1,2
7827,1,1,27544,27544,27545,0,1,0
7828,4,2,27548,27548,27550,0,2,3
7829,2,1,27550,27550,27551,0,1,0
7830,4,1,27554,27554,27555,0,1,3
7831,1,1,27555,27555,27556,0,1,0
7832,5,3,27560,27560,27563,0,3,4
7833,3,1,27563,27563,27564,0,1,0
7834,6,2,27569,27569,27571,0,2,5
7835,6,1,27575,27575,27576,0,1,4
7836,4,1,27579,27579,27580,0,1,3
7837,1,1,27580,27580,27581,0,1,0
7838,4,3,27584,27584,27587,0,3,3
7839,5,2,27589,27589,27591,0,2,2
7840,2,3,27591,27591,27594,0,3,0
7841,3,3,27594,27594,27597,0,3,0
7842,1,3,27595,27597,27600,2,5,0
7843,5,3,27600,27600,27603,0,3,0
7844,1,1,27601,27603,27604,2,3,0
7845,3,2,27604,27604,27606,0,2,0
7846,1,3,27605,27606,27609,1,4,0
7847,1,2,27606,27609,27611,3,5,0
7848,1,2,27607,27611,27613,4,6,0
7849,5,2,27612,27613,27615,1,3,0
7850,2,2,27614,27615,27617,1,3,0
7851,2,1,27616,27617,27618,1,2,0
7852,3,3,27619,27619,27622,0,3,1
7853,2,3,27621,27622,27625,1,4,0
7854,2,3,27623,27625,27628,2,5,0
7855,3,1,27626,27628,27629,2,3,0
7856,5,1,27631,27631,27632,0,1,2
7857,5,3,27636,27636,27639,0,3,4
7858,4,3,27640,27640,27643,0,3,1
7859,5,2,27645,27645,27647,0,2,2
7860,5,2,27650,27650,27652,0,2,3
7861,5,3,27655,27655,27658,0,3,3
7862,6,2,27661,27661,27663,0,2,3
7863,3,1,27664,27664,27665,0,1,1
7864,2,3,27666,27666,27669,0,3,1
7865,3,2,27669,27669,27671,0,2,0
7866,5,2,27674,27674,27676,0,2,3
7867,1,2,27675,27676,27678,1,3,0
7868,5,1,27680,27680,27681,0,1,2
7869,2,2,27682,27682,27684,0,2,1
7870,2,2,27684,27684,27686,0,2,0
7871,4,2,27688,27688,27690,0,2,2
7872,4,1,27692,27692,27693,0,1,2
7873,3,1,27695,27695,27696,0,1,2
7874,4,1,27699,27699,27700,0,1,3
7875,5,1,27704,27704,27705,0,1,4
7876,1,2,27705,27705,27707,0,2,0
7877,6,2,27711,27711,27713,0,2,4
7878,3,3,27714,27714,27717,0,3,1
7879,5,3,27719,27719,27722,0,3,2
7880,2,1,27721,27722,27723,1,2,0
7881,2,2,27723,27723,27725,0,2,0
7882,4,1,27727,27727,27728,0,1,2
7883,3,1,27730,27730,27731,0,1,2
7884,4,1,27734,27734,27735,0,1,3
7885,5,3,27739,27739,27742,0,3,4
7886,5,2,27744,27744,27746,0,2,2
7887,4,3,27748,27748,27751,0,3,2
7888,6,3,27754,27754,27757,0,3,3
7889,2,2,27756,27757,27759,1,3,0
7890,4,2,27760,27760,27762,0,2,1
7891,6,1,27766,27766,27767,0,1,4
7892,5,1,27771,27771,27772,0,1,4
7893,2,1,27773,27773,27774,0,1,1
7894,5,3,27778,27778,27781,0,3,4
7895,2,3,27780,27781,27784,1,4,0
7896,3,3,27783,27784,27787,1,4,0
7897,5,2,27788,27788,27790,0,2,1
7898,1,3,27789,27790,27793,1,4,0
7899,2,1,27791,27793,27794,2,3,0
7900,1,3,27792,27794,27797,2,5,0
7901,4,1,27796,27797,27798,1,2,0
7902,4,3,27800,27800,27803,0,3,2
7903,5,2,27805,27805,27807,0,2,2
7904,1,1,27806,27807,27808,1,2,0
7905,3,3,27809,27809,27812,0,3,1
7906,6,2,27815,27815,27817,0,2,3
7907,1,1,27816,27817,27818,1,2,0
7908,2,2,27818,27818,27820,0,2,0
7909,4,2,27822,27822,27824,0,2,2
7910,3,3,27825,27825,27828,0,3,1
7911,5,1,27830,27830,27831,0,1,2
7912,4,1,27834,27834,27835,0,1,3
7913,4,3,27838,27838,27841,0,3,3
7914,3,2,27841,27841,27843,0,2,0
7915,5,2,27846,27846,27848,0,2,3
7916,5,1,27851,27851,27852,0,1,3
7917,3,3,27854,27854,27857,0,3,2
7918,2,1,27856,27857,27858,1,2,0
7919,4,1,27860,27860,27861,0,1,2
7920,1,3,27861,27861,27864,0,3,0
7921,4,2,27865,27865,27867,0,2,1
7922,6,1,27871,27871,27872,0,1,4
7923,5,1,27876,27876,27877,0,1,4
7924,1,3,27877,27877,27880,0,3,0
7925,5,2,27882,27882,27884,0,2,2
7926,1,2,27883,27884,27886,1,3,0
7927,2,2,27885,27886,27888,1,3,0
7928,5,1,27890,27890,27891,0,1,2
7929,4,2,27894,27894,27896,0,2,3
7930,6,1,27900,27900,27901,0,1,4
7931,4,3,27904,27904,27907,0,3,3
7932,6,3,27910,27910,27913,0,3,3
7933,6,1,27916,27916,27917,0,1,3
7934,6,3,27922,27922,27925,0,3,5
7935,1,2,27923,27925,27927,2,4,0
7936,3,1,27926,27927,27928,1,2,0
7937,1,3,27927,27928,27931,1,4,0
7938,3,2,27930,27931,27933,1,3,0
7939,1,1,27931,27933,27934,2,3,0
7940,1,3,27932,27934,27937,2,5,0
7941,5,1,27937,27937,27938,0,1,0
7942,1,3,27938,27938,27941,0,3,0
7943,4,2,27942,27942,27944,0,2,1
7944,6,2,27948,27948,27950,0,2,4
7945,5,2,27953,27953,27955,0,2,3
7946,1,3,27954,27955,27958,1,4,0
7947,6,3,27960,27960,27963,0,3,2
7948,1,1,27961,27963,27964,2,3,0
7949,2,1,27963,27964,27965,1,2,0
7950,4,3,27967,27967,27970,0,3,2
7951,5,1,27972,27972,27973,0,1,2
7952,3,2,27975,27975,27977,0,2,2
7953,3,1,27978,27978,27979,0,1,1
7954,5,3,27983,27983,27986,0,3,4
7955,2,3,27985,27986,27989,1,4,0
7956,4,3,27989,27989,27992,0,3,0
7957,1,2,27990,27992,27994,2,4,0
7958,1,1,27991,27994,27995,3,4,0
7959,4,2,27995,27995,27997,0,2,0
7960,5,1,28000,28000,28001,0,1,3
7961,5,2,28005,28005,28007,0,2,4
7962,1,3,28006,28007,28010,1,4,0
7963,2,2,28008,28010,28012,2,4,0
7964,6,1,28014,28014,28015,0,1,2
7965,2,3,28016,28016,28019,0,3,1
7966,1,3,28017,28019,28022,2,5,0
7967,3,2,28020,28022,28024,2,4,0
7968,3,2,28023,28024,28026,1,3,0
7969,4,2,28027,28027,28029,0,2,1
7970,2,3,28029,28029,28032,0,3,0
7971,6,2,28035,28035,28037,0,2,3
7972,1,2,28036,28037,28039,1,3,0
7973,4,1,28040,28040,28041,0,1,1
7974,2,1,28042,28042,28043,0,1,1
7975,2,2,28044,28044,28046,0,2,1
7976,4,3,28048,28048,28051,0,3,2
7977,6,2,28054,28054,28056,0,2,3
7978,6,3,28060,28060,28063,0,3,4
7979,5,3,28065,28065,28068,0,3,2
7980,3,3,28068,28068,28071,0,3,0
7981,5,3,28073,28073,28076,0,3,2
7982,5,1,28078,28078,28079,0,1,2
7983,6,3,28084,28084,28087,0,3,5
7984,6,3,28090,28090,28093,0,3,3
7985,3,3,28093,28093,28096,0,3,0
7986,5,2,28098,28098,28100,0,2,2
7987,1,1,28099,28100,28101,1,2,0
7988,1,3,28100,28101,28104,1,4,0
7989,1,3,28101,28104,28107,3,6,0
7990,1,2,28102,28107,28109,5,7,0
7991,6,1,28108,28109,28110,1,2,0
7992,5,1,28113,28113,28114,0,1,3
7993,4,2,28117,28117,28119,0,2,3
7994,3,3,28120,28120,28123,0,3,1
7995,3,2,28123,28123,28125,0,2,0
7996,5,3,28128,28128,28131,0,3,3
7997,5,3,28133,28133,28136,0,3,2
7998,1,3,28134,28136,28139,2,5,0
7999,6,2,28140,28140,28142,0,2,1
8000,1,2,28141,28142,28144,1,3,0
8001,2,1,28143,28144,28145,1,2,0
8002,6,2,28149,28149,28151,0,2,4
8003,1,1,28150,28151,28152,1,2,0
8004,1,2,28151,28152,28154,1,3,0
8005,5,2,28156,28156,28158,0,2,2
8006,3,2,28159,28159,28161,0,2,1
8007,1,3,28160,28161,28164,1,4,0
8008,6,2,28166,28166,28168,0,2,2
8009,3,1,28169,28169,28170,0,1,1
8010,4,1,28173,28173,28174,0,1,3
8011,3,2,28176,28176,28178,0,2,2
8012,3,2,28179,28179,28181,0,2,1
8013,1,3,28180,28181,28184,1,4,0
8014,2,1,28182,28184,28185,2,3,0
8015,4,2,28186,28186,28188,0,2,1
8016,5,1,28191,28191,28192,0,1,3
8017,5,2,28196,28196,28198,0,2,4
8018,1,3,28197,28198,28201,1,4,0
8019,5,2,28202,28202,28204,0,2,1
8020,6,1,28208,28208,28209,0,1,4
8021,6,1,28214,28214,28215,0,1,5
8022,5,2,28219,28219,28221,0,2,4
8023,4,1,28223,28223,28224,0,1,2
8024,2,1,28225,28225,28226,0,1,1
8025,2,1,28227,28227,28228,0,1,1
8026,4,3,28231,28231,28234,0,3,3
8027,5,3,28236,28236,28239,0,3,2
8028,6,3,28242,28242,28245,0,3,3
8029,4,2,28246,28246,28248,0,2,1
8030,5,1,28251,28251,28252,0,1,3
8031,5,1,28256,28256,28257,0,1,4
8032,2,2,28258,28258,28260,0,2,1
8033,1,3,28259,28260,28263,1,4,0
8034,1,2,28260,28263,28265,3,5,0
8035,4,3,28264,28265,28268,1,4,0
8036,5,1,28269,28269,28270,0,1,1
8037,2,1,28271,28271,28272,0,1,1
8038,2,3,28273,28273,28276,0,3,1
8039,4,2,28277,28277,28279,0,2,1
8040,6,1,28283,28283,28284,0,1,4
8041,1,3,28284,28284,28287,0,3,0
8042,4,3,28288,28288,28291,0,3,1
8043,2,3,28290,28291,28294,1,4,0
8044,2,3,28292,28294,28297,2,5,0
8045,5,3,28297,28297,28300,0,3,0
8046,1,1,28298,28300,28301,2,3,0
8047,2,1,28300,28301,28302,1,2,0
8048,2,2,28302,28302,28304,0,2,0
8049,6,2,28308,28308,28310,0,2,4
8050,6,1,28314,28314,28315,0,1,4
8051,6,1,28320,28320,28321,0,1,5
8052,6,3,28326,28326,28329,0,3,5
8053,6,2,28332,28332,28334,0,2,3
8054,1,2,28333,28334,28336,1,3,0
8055,5,2,28338,28338,28340,0,2,2
8056,5,2,28343,28343,28345,0,2,3
8057,4,1,28347,28347,28348,0,1,2
8058,5,1,28352,28352,28353,0,1,4
8059,1,2,28353,28353,28355,0,2,0
8060,6,2,28359,28359,28361,0,2,4
8061,1,3,28360,28361,28364,1,4,0
8062,1,2,28361,28364,28366,3,5,0
8063,6,3,28367,28367,28370,0,3,1
8064,2,2,28369,28370,28372,1,3,0
8065,1,3,28370,28372,28375,2,5,0
8066,4,3,28374,28375,28378,1,4,0
8067,5,2,28379,28379,28381,0,2,1
8068,5,1,28384,28384,28385,0,1,3
8069,4,3,28388,28388,28391,0,3,3
8070,3,2,28391,28391,28393,0,2,0
8071,6,1,28397,28397,28398,0,1,4
8072,2,2,28399,28399,28401,0,2,1
8073,2,1,28401,28401,28402,0,1,0
8074,2,3,28403,28403,28406,0,3,1
8075,3,1,28406,28406,28407,0,1,0
8076,2,3,28408,28408,28411,0,3,1
8077,3,2,28411,28411,28413,0,2,0
8078,1,2,28412,28413,28415,1,3,0
8079,3,2,28415,28415,28417,0,2,0
8080,6,3,28421,28421,28424,0,3,4
8081,3,2,28424,28424,28426,0,2,0
8082,2,1,28426,28426,28427,0,1,0
8083,2,1,28428,28428,28429,0,1,1
8084,4,2,28432,28432,28434,0,2,3
8085,4,1,28436,28436,28437,0,1,2
8086,1,2,28437,28437,28439,0,2,0
8087,6,2,28443,28443,28445,0,2,4
8088,3,1,28446,28446,28447,0,1,1
8089,4,1,28450,28450,28451,0,1,3
8090,1,1,28451,28451,28452,0,1,0
8091,1,3,28452,28452,28455,0,3,0
8092,2,2,28454,28455,28457,1,3,0
8093,4,1,28458,28458,28459,0,1,1
8094,3,3,28461,28461,28464,0,3,2
8095,6,1,28467,28467,28468,0,1,3
8096,4,1,28471,28471,28472,0,1,3
8097,6,1,28477,28477,28478,0,1,5
8098,6,1,28483,28483,28484,0,1,5
8099,1,2,28484,28484,28486,0,2,0
8100,2,2,28486,28486,28488,0,2,0
8101,2,3,28488,28488,28491,0,3,0
8102,6,1,28494,28494,28495,0,1,3
8103,3,3,28497,28497,28500,0,3,2
8104,3,1,28500,28500,28501,0,1,0
8105,4,2,28504,28504,28506,0,2,3
8106,4,1,28508,28508,28509,0,1,2
8107,4,1,28512,28512,28513,0,1,3
8108,5,1,28517,28517,28518,0,1,4
8109,6,1,28523,28523,28524,0,1,5
8110,3,3,28526,28526,28529,0,3,2
8111,1,2,28527,28529,28531,2,4,0
8112,6,2,28533,28533,28535,0,2,2
8113,1,1,28534,28535,28536,1,2,0
8114,5,1,28539,28539,28540,0,1,3
8115,4,3,28543,28543,28546,0,3,3
8116,6,2,28549,28549,28551,0,2,3
8117,3,2,28552,28552,28554,0,2,1
8118,1,1,28553,28554,28555,1,2,0
8119,6,1,28559,28559,28560,0,1,4
8120,1,3,28560,28560,28563,0,3,0
8121,6,2,28566,28566,28568,0,2,3
8122,3,3,28569,28569,28572,0,3,1
8123,5,3,28574,28574,28577,0,3,2
8124,2,2,28576,28577,28579,1,3,0
8125,4,2,28580,28580,28582,0,2,1
8126,5,1,28585,28585,28586,0,1,3
8127,3,2,28588,28588,28590,0,2,2
8128,6,3,28594,28594,28597,0,3,4
8129,2,1,28596,28597,28598,1,2,0
8130,2,3,28598,28598,28601,0,3,0
8131,2,2,28600,28601,28603,1,3,0
8132,5,2,28605,28605,28607,0,2,2
8133,2,2,28607,28607,28609,0,2,0
8134,4,3,28611,28611,28614,0,3,2
8135,6,2,28617,28617,28619,0,2,3
8136,6,2,28623,28623,28625,0,2,4
8137,5,1,28628,28628,28629,0,1,3
8138,2,3,28630,28630,28633,0,3,1
8139,4,1,28634,28634,28635,0,1,1
8140,2,3,28636,28636,28639,0,3,1
8141,4,2,28640,28640,28642,0,2,1
8142,6,3,28646,28646,28649,0,3,4
8143,2,3,28648,28649,28652,1,4,0
8144,1,1,28649,28652,28653,3,4,0
8145,5,1,28654,28654,28655,0,1,1
8146,2,2,28656,28656,28658,0,2,1
8147,6,1,28662,28662,28663,0,1,4
8148,5,2,28667,28667,28669,0,2,4
8149,1,3,28668,28669,28672,1,4,0
8150,1,3,28669,28672,28675,3,6,0
8151,5,2,28674,28675,28677,1,3,0
8152,6,2,28680,28680,28682,0,2,3
8153,4,1,28684,28684,28685,0,1,2
8154,1,2,28685,28685,28687,0,2,0
8155,6,1,28691,28691,28692,0,1,4
8156,5,3,28696,28696,28699,0,3,4
8157,5,2,28701,28701,28703,0,2,2
8158,1,1,28702,28703,28704,1,2,0
8159,3,2,28705,28705,28707,0,2,1
8160,4,3,28709,28709,28712,0,3,2
8161,5,1,28714,28714,28715,0,1,2
8162,5,2,28719,28719,28721,0,2,4
8163,3,1,28722,28722,28723,0,1,1
8164,5,2,28727,28727,28729,0,2,4
8165,2,2,28729,28729,28731,0,2,0
8166,4,1,28733,28733,28734,0,1,2
8167,5,3,28738,28738,28741,0,3,4
8168,6,3,28744,28744,28747,0,3,3
8169,3,2,28747,28747,28749,0,2,0
8170,1,3,28748,28749,28752,1,4,0
8171,4,1,28752,28752,28753,0,1,0
8172,2,2,28754,28754,28756,0,2,1
8173,1,3,28755,28756,28759,1,4,0
8174,4,3,28759,28759,28762,0,3,0
8175,3,3,28762,28762,28765,0,3,0
8176,2,3,28764,28765,28768,1,4,0
8177,1,3,28765,28768,28771,3,6,0
8178,4,3,28769,28771,28774,2,5,0
8179,5,2,28774,28774,28776,0,2,0
8180,2,3,28776,28776,28779,0,3,0
8181,2,2,28778,28779,28781,1,3,0
8182,5,1,28783,28783,28784,0,1,2
8183,5,1,28788,28788,28789,0,1,4
8184,1,2,28789,28789,28791,0,2,0
8185,3,2,28792,28792,28794,0,2,1
8186,3,2,28795,28795,28797,0,2,1
8187,2,2,28797,28797,28799,0,2,0
8188,3,2,28800,28800,28802,0,2,1
8189,6,1,28806,28806,28807,0,1,4
8190,5,2,28811,28811,28813,0,2,4
8191,1,3,28812,28813,28816,1,4,0
8192,3,1,28815,28816,28817,1,2,0
8193,1,2,28816,28817,28819,1,3,0
8194,2,2,28818,28819,28821,1,3,0
8195,1,3,28819,28821,28824,2,5,0
8196,6,1,28825,28825,28826,0,1,1
8197,6,1,28831,28831,28832,0,1,5
8198,6,1,28837,28837,28838,0,1,5
8199,1,1,28838,28838,28839,0,1,0
8200,2,2,28840,28840,28842,0,2,1
8201,1,1,28841,28842,28843,1,2,0
8202,3,1,28844,28844,28845,0,1,1
8203,3,3,28847,28847,28850,0,3,2
8204,3,3,28850,28850,28853,0,3,0
8205,6,2,28856,28856,28858,0,2,3
8206,3,1,28859,28859,28860,0,1,1
8207,6,3,28865,28865,28868,0,3,5
8208,2,3,28867,28868,28871,1,4,0
8209,6,3,28873,28873,28876,0,3,2
8210,4,3,28877,28877,28880,0,3,1
8211,6,2,28883,28883,28885,0,2,3
8212,6,2,28889,28889,28891,0,2,4
8213,5,3,28894,28894,28897,0,3,3
8214,4,3,28898,28898,28901,0,3,1
8215,5,1,28903,28903,28904,0,1,2
8216,6,3,28909,28909,28912,0,3,5
8217,1,2,28910,28912,28914,2,4,0
8218,2,3,28912,28914,28917,2,5,0
8219,4,2,28916,28917,28919,1,3,0
8220,5,1,28921,28921,28922,0,1,2
8221,6,3,28927,28927,28930,0,3,5
8222,3,3,28930,28930,28933,0,3,0
8223,6,3,28936,28936,28939,0,3,3
8224,6,2,28942,28942,28944,0,2,3
8225,3,1,28945,28945,28946,0,1,1
8226,6,2,28951,28951,28953,0,2,5
8227,4,1,28955,28955,28956,0,1,2
8228,2,2,28957,28957,28959,0,2,1
8229,6,3,28963,28963,28966,0,3,4
8230,4,2,28967,28967,28969,0,2,1
8231,3,3,28970,28970,28973,0,3,1
8232,2,3,28972,28973,28976,1,4,0
8233,1,3,28973,28976,28979,3,6,0
8234,2,2,28975,28979,28981,4,6,0
8235,1,3,28976,28981,28984,5,8,0
8236,4,3,28980,28984,28987,4,7,0
8237,6,2,28986,28987,28989,1,3,0
8238,4,3,28990,28990,28993,0,3,1
8239,5,1,28995,28995,28996,0,1,2
8240,4,1,28999,28999,29000,0,1,3
8241,5,3,29004,29004,29007,0,3,4
8242,1,2,29005,29007,29009,2,4,0
8243,6,3,29011,29011,29014,0,3,2
8244,2,3,29013,29014,29017,1,4,0
8245,5,2,29018,29018,29020,0,2,1
8246,6,2,29024,29024,29026,0,2,4
8247,5,1,29029,29029,29030,0,1,3
8248,3,3,29032,29032,29035,0,3,2
8249,6,3,29038,29038,29041,0,3,3
8250,2,1,29040,29041,29042,1,2,0
8251,3,3,29043,29043,29046,0,3,1
8252,1,2,29044,29046,29048,2,4,0
8253,4,1,29048,29048,29049,0,1,0
8254,1,2,29049,29049,29051,0,2,0
8255,6,3,29055,29055,29058,0,3,4
8256,4,1,29059,29059,29060,0,1,1
8257,2,3,29061,29061,29064,0,3,1
8258,6,2,29067,29067,29069,0,2,3
8259,2,1,29069,29069,29070,0,1,0
8260,2,2,29071,29071,29073,0,2,1
8261,2,3,29073,29073,29076,0,3,0
8262,3,2,29076,29076,29078,0,2,0
8263,2,1,29078,29078,29079,0,1,0
8264,2,3,29080,29080,29083,0,3,1
8265,3,2,29083,29083,29085,0,2,0
8266,6,3,29089,29089,29092,0,3,4
8267,2,1,29091,29092,29093,1,2,0
8268,5,3,29096,29096,29099,0,3,3
8269,2,3,29098,29099,29102,1,4,0
8270,5,2,29103,29103,29105,0,2,1
8271,3,3,29106,29106,29109,0,3,1
8272,3,2,29109,29109,29111,0,2,0
8273,4,2,29113,29113,29115,0,2,2
8274,1,1,29114,29115,29116,1,2,0
8275,5,3,29119,29119,29122,0,3,3
8276,5,1,29124,29124,29125,0,1,2
8277,1,2,29125,29125,29127,0,2,0
8278,1,2,29126,29127,29129,1,3,0
8279,6,2,29132,29132,29134,0,2,3
8280,5,3,29137,29137,29140,0,3,3
8281,2,2,29139,29140,29142,1,3,0
8282,3,1,29142,29142,29143,0,1,0
8283,5,2,29147,29147,29149,0,2,4
8284,5,3,29152,29152,29155,0,3,3
8285,4,1,29156,29156,29157,0,1,1
8286,6,3,29162,29162,29165,0,3,5
8287,3,2,29165,29165,29167,0,2,0
8288,4,1,29169,29169,29170,0,1,2
8289,2,1,29171,29171,29172,0,1,1
8290,5,3,29176,29176,29179,0,3,4
8291,2,2,29178,29179,29181,1,3,0
8292,1,2,29179,29181,29183,2,4,0
8293,4,2,29183,29183,29185,0,2,0
8294,4,2,29187,29187,29189,0,2,2
8295,4,3,29191,29191,29194,0,3,2
8296,2,2,29193,29194,29196,1,3,0
8297,3,1,29196,29196,29197,0,1,0
8298,3,1,29199,29199,29200,0,1,2
8299,1,1,29200,29200,29201,0,1,0
8300,1,2,29201,29201,29203,0,2,0
8301,2,1,29203,29203,29204,0,1,0
8302,3,2,29206,29206,29208,0,2,2
8303,6,1,29212,29212,29213,0,1,4
8304,1,1,29213,29213,29214,0,1,0
8305,1,1,29214,29214,29215,0,1,0
8306,2,1,29216,29216,29217,0,1,1
8307,2,1,29218,29218,29219,0,1,1
8308,5,3,29223,29223,29226,0,3,4
8309,3,2,29226,29226,29228,0,2,0
8310,2,3,29228,29228,29231,0,3,0
8311,2,2,29230,29231,29233,1,3,0
8312,2,1,29232,29233,29234,1,2,0
8313,1,3,29233,29234,29237,1,4,0
8314,5,1,29238,29238,29239,0,1,1
8315,3,3,29241,29241,29244,0,3,2
8316,4,3,29245,29245,29248,0,3,1
8317,4,2,29249,29249,29251,0,2,1
8318,2,2,29251,29251,29253,0,2,0
8319,6,2,29257,29257,29259,0,2,4
8320,2,2,29259,29259,29261,0,2,0
8321,5,1,29264,29264,29265,0,1,3
8322,4,1,29268,29268,29269,0,1,3
8323,5,3,29273,29273,29276,0,3,4
8324,5,1,29278,29278,29279,0,1,2
8325,2,1,29280,29280,29281,0,1,1
8326,6,2,29286,29286,29288,0,2,5
8327,2,3,29288,29288,29291,0,3,0
8328,3,3,29291,29291,29294,0,3,0
8329,3,3,29294,29294,29297,0,3,0
8330,5,1,29299,29299,29300,0,1,2
8331,1,3,29300,29300,29303,0,3,0
8332,4,1,29304,29304,29305,0,1,1
8333,4,2,29308,29308,29310,0,2,3
8334,2,2,29310,29310,29312,0,2,0
8335,1,2,29311,29312,29314,1,3,0
8336,5,2,29316,29316,29318,0,2,2
8337,2,2,29318,29318,29320,0,2,0
8338,6,1,29324,29324,29325,0,1,4
8339,3,2,29327,29327,29329,0,2,2
8340,6,3,29333,29333,29336,0,3,4
8341,4,3,29337,29337,29340,0,3,1
8342,1,2,29338,29340,29342,2,4,0
8343,3,1,29341,29342,29343,1,2,0
8344,3,3,29344,29344,29347,0,3,1
8345,2,1,29346,29347,29348,1,2,0
8346,6,1,29352,29352,29353,0,1,4
8347,5,3,29357,29357,29360,0,3,4
8348,3,1,29360,29360,29361,0,1,0
8349,2,2,29362,29362,29364,0,2,1
8350,2,2,29364,29364,29366,0,2,0
8351,6,3,29370,29370,29373,0,3,4
8352,3,1,29373,29373,29374,0,1,0
8353,4,3,29377,29377,29380,0,3,3
8354,1,1,29378,29380,29381,2,3,0
8355,6,2,29384,29384,29386,0,2,3
8356,2,2,29386,29386,29388,0,2,0
8357,3,2,29389,29389,29391,0,2,1
8358,1,2,29390,29391,29393,1,3,0
8359,4,1,29394,29394,29395,0,1,1
8360,3,1,29397,29397,29398,0,1,2
8361,5,2,29402,29402,29404,0,2,4
8362,4,3,29406,29406,29409,0,3,2
8363,1,1,29407,29409,29410,2,3,0
8364,2,2,29409,29410,29412,1,3,0
8365,6,2,29415,29415,29417,0,2,3
8366,3,1,29418,29418,29419,0,1,1
8367,4,3,29422,29422,29425,0,3,3
8368,2,3,29424,29425,29428,1,4,0
8369,5,3,29429,29429,29432,0,3,1
8370,2,2,29431,29432,29434,1,3,0
8371,1,3,29432,29434,29437,2,5,0
8372,5,2,29437,29437,29439,0,2,0
8373,5,2,29442,29442,29444,0,2,3
8374,1,2,29443,29444,29446,1,3,0
8375,5,1,29448,29448,29449,0,1,2
8376,2,3,29450,29450,29453,0,3,1
8377,6,2,29456,29456,29458,0,2,3
8378,1,3,29457,29458,29461,1,4,0
8379,6,1,29463,29463,29464,0,1,2
8380,3,1,29466,29466,29467,0,1,2
8381,4,2,29470,29470,29472,0,2,3
8382,6,1,29476,29476,29477,0,1,4
8383,6,2,29482,29482,29484,0,2,5
8384,6,3,29488,29488,29491,0,3,4
8385,4,1,29492,29492,29493,0,1,1
8386,2,3,29494,29494,29497,0,3,1
8387,1,2,29495,29497,29499,2,4,0
8388,3,2,29498,29499,29501,1,3,0
8389,2,1,29500,29501,29502,1,2,0
8390,6,1,29506,29506,29507,0,1,4
8391,2,1,29508,29508,29509,0,1,1
8392,6,2,29514,29514,29516,0,2,5
8393,6,3,29520,29520,29523,0,3,4
8394,1,3,29521,29523,29526,2,5,0
8395,5,3,29526,29526,29529,0,3,0
8396,5,3,29531,29531,29534,0,3,2
8397,4,2,29535,29535,29537,0,2,1
8398,1,2,29536,29537,29539,1,3,0
8399,4,2,29540,29540,29542,0,2,1
8400,5,1,29545,29545,29546,0,1,3
8401,3,2,29548,29548,29550,0,2,2
8402,1,2,29549,29550,29552,1,3,0
8403,5,3,29554,29554,29557,0,3,2
8404,3,3,29557,29557,29560,0,3,0
8405,2,3,29559,29560,29563,1,4,0
8406,6,1,29565,29565,29566,0,1,2
8407,5,1,29570,29570,29571,0,1,4
8408,6,2,29576,29576,29578,0,2,5
8409,2,3,29578,29578,29581,0,3,0
8410,3,1,29581,29581,29582,0,1,0
8411,3,1,29584,29584,29585,0,1,2
8412,5,2,29589,29589,29591,0,2,4
8413,1,1,29590,29591,29592,1,2,0
8414,1,1,29591,29592,29593,1,2,0
8415,1,2,29592,29593,29595,1,3,0
8416,1,2,29593,29595,29597,2,4,0
8417,5,2,29598,29598,29600,0,2,1
8418,5,2,29603,29603,29605,0,2,3
8419,2,2,29605,29605,29607,0,2,0
8420,2,3,29607,29607,29610,0,3,0
8421,1,3,29608,29610,29613,2,5,0
8422,3,1,29611,29613,29614,2,3,0
8423,3,1,29614,29614,29615,0,1,0
8424,5,1,29619,29619,29620,0,1,4
8425,4,2,29623,29623,29625,0,2,3
8426,4,2,29627,29627,29629,0,2,2
8427,1,1,29628,29629,29630,1,2,0
8428,3,1,29631,29631,29632,0,1,1
8429,3,3,29634,29634,29637,0,3,2
8430,3,3,29637,29637,29640,0,3,0
8431,4,2,29641,29641,29643,0,2,1
8432,5,3,29646,29646,29649,0,3,3
8433,4,2,29650,29650,29652,0,2,1
8434,4,3,29654,29654,29657,0,3,2
8435,2,1,29656,29657,29658,1,2,0
8436,2,1,29658,29658,29659,0,1,0
8437,5,2,29663,29663,29665,0,2,4
8438,5,1,29668,29668,29669,0,1,3
8439,3,2,29671,29671,29673,0,2,2
8440,1,2,29672,29673,29675,1,3,0
8441,4,1,29676,29676,29677,0,1,1
8442,5,1,29681,29681,29682,0,1,4
8443,2,3,29683,29683,29686,0,3,1
8444,6,1,29689,29689,29690,0,1,3
8445,2,2,29691,29691,29693,0,2,1
8446,2,2,29693,29693,29695,0,2,0
8447,3,2,29696,29696,29698,0,2,1
8448,6,2,29702,29702,29704,0,2,4
8449,6,1,29708,29708,29709,0,1,4
8450,5,3,29713,29713,29716,0,3,4
8451,1,3,29714,29716,29719,2,5,0
8452,4,1,29718,29719,29720,1,2,0
8453,5,1,29723,29723,29724,0,1,3
8454,6,2,29729,29729,29731,0,2,5
8455,6,1,29735,29735,29736,0,1,4
8456,5,2,29740,29740,29742,0,2,4
8457,6,3,29746,29746,29749,0,3,4
8458,4,3,29750,29750,29753,0,3,1
8459,4,3,29754,29754,29757,0,3,1
8460,3,1,29757,29757,29758,0,1,0
8461,3,1,29760,29760,29761,0,1,2
8462,2,2,29762,29762,29764,0,2,1
8463,5,2,29767,29767,29769,0,2,3
8464,3,3,29770,29770,29773,0,3,1
8465,2,3,29772,29773,29776,1,4,0
8466,2,3,29774,29776,29779,2,5,0
8467,1,1,29775,29779,29780,4,5,0
8468,6,2,29781,29781,29783,0,2,1
8469,2,1,29783,29783,29784,0,1,0
8470,1,3,29784,29784,29787,0,3,0
8471,5,2,29789,29789,29791,0,2,2
8472,6,2,29795,29795,29797,0,2,4
8473,5,2,29800,29800,29802,0,2,3
8474,4,1,29804,29804,29805,0,1,2
8475,3,1,29807,29807,29808,0,1,2
8476,6,2,29813,29813,29815,0,2,5
8477,2,2,29815,29815,29817,0,2,0
8478,3,3,29818,29818,29821,0,3,1
8479,4,2,29822,29822,29824,0,2,1
8480,3,2,29825,29825,29827,0,2,1
8481,2,1,29827,29827,29828,0,1,0
8482,2,2,29829,29829,29831,0,2,1
8483,3,3,29832,29832,29835,0,3,1
8484,3,2,29835,29835,29837,0,2,0
8485,3,3,29838,29838,29841,0,3,1
8486,6,1,29844,29844,29845,0,1,3
8487,5,2,29849,29849,29851,0,2,4
8488,5,2,29854,29854,29856,0,2,3
8489,5,2,29859,29859,29861,0,2,3
8490,5,2,29864,29864,29866,0,2,3
8491,2,1,29866,29866,29867,0,1,0
8492,6,3,29872,29872,29875,0,3,5
8493,4,1,29876,29876,29877,0,1,1
8494,6,3,29882,29882,29885,0,3,5
8495,3,3,29885,29885,29888,0,3,0
8496,2,3,29887,29888,29891,1,4,0
8497,6,2,29893,29893,29895,0,2,2
8498,2,2,29895,29895,29897,0,2,0
8499,2,1,29897,29897,29898,0,1,0
8500,4,2,29901,29901,29903,0,2,3
8501,3,2,29904,29904,29906,0,2,1
8502,2,2,29906,29906,29908,0,2,0
8503,4,1,29910,29910,29911,0,1,2
8504,4,2,29914,29914,29916,0,2,3
8505,3,2,29917,29917,29919,0,2,1
8506,1,2,29918,29919,29921,1,3,0
8507,5,2,29923,29923,29925,0,2,2
8508,3,3,29926,29926,29929,0,3,1
8509,6,3,29932,29932,29935,0,3,3
8510,6,1,29938,29938,29939,0,1,3
8511,4,1,29942,29942,29943,0,1,3
8512,6,2,29948,29948,29950,0,2,5
8513,3,1,29951,29951,29952,0,1,1
8514,4,2,29955,29955,29957,0,2,3
8515,1,1,29956,29957,29958,1,2,0
8516,1,1,29957,29958,29959,1,2,0
8517,3,3,29960,29960,29963,0,3,1
8518,5,3,29965,29965,29968,0,3,2
8519,4,1,29969,29969,29970,0,1,1
8520,5,2,29974,29974,29976,0,2,4
8521,4,2,29978,29978,29980,0,2,2
8522,3,3,29981,29981,29984,0,3,1
8523,2,3,29983,29984,29987,1,4,0
8524,1,3,29984,29987,29990,3,6,0
8525,2,2,29986,29990,29992,4,6,0
8526,3,2,29989,29992,29994,3,5,0
8527,5,1,29994,29994,29995,0,1,0
8528,1,2,29995,29995,29997,0,2,0
8529,6,3,30001,30001,30004,0,3,4
8530,6,1,30007,30007,30008,0,1,3
8531,5,1,30012,30012,30013,0,1,4
8532,3,3,30015,30015,30018,0,3,2
8533,2,3,30017,30018,30021,1,4,0
8534,5,1,30022,30022,30023,0,1,1
8535,4,2,30026,30026,30028,0,2,3
8536,1,1,30027,30028,30029,1,2,0
8537,5,1,30032,30032,30033,0,1,3
8538,4,3,30036,30036,30039,0,3,3
8539,1,3,30037,30039,30042,2,5,0
8540,1,2,30038,30042,30044,4,6,0
8541,3,1,30041,30044,30045,3,4,0
8542,1,1,30042,30045,30046,3,4,0
8543,6,2,30048,30048,30050,0,2,2
8544,3,2,30051,30051,30053,0,2,1
8545,4,3,30055,30055,30058,0,3,2
8546,3,3,30058,30058,30061,0,3,0
8547,2,2,30060,30061,30063,1,3,0
8548,1,3,30061,30063,30066,2,5,0
8549,2,3,30063,30066,30069,3,6,0
8550,1,1,30064,30069,30070,5,6,0
8551,1,2,30065,30070,30072,5,7,0
8552,2,3,30067,30072,30075,5,8,0
8553,4,1,30071,30075,30076,4,5,0
8554,5,1,30076,30076,30077,0,1,0
8555,3,3,30079,30079,30082,0,3,2
8556,1,1,30080,30082,30083,2,3,0
8557,1,1,30081,30083,30084,2,3,0
8558,4,3,30085,30085,30088,0,3,1
8559,5,3,30090,30090,30093,0,3,2
8560,2,2,30092,30093,30095,1,3,0
8561,6,3,30098,30098,30101,0,3,3
8562,1,3,30099,30101,30104,2,5,0
8563,1,1,30100,30104,30105,4,5,0
8564,6,1,30106,30106,30107,0,1,1
8565,2,2,30108,30108,30110,0,2,1
8566,1,3,30109,30110,30113,1,4,0
8567,5,3,30114,30114,30117,0,3,1
8568,5,2,30119,30119,30121,0,2,2
8569,6,2,30125,30125,30127,0,2,4
8570,5,1,30130,30130,30131,0,1,3
8571,5,3,30135,30135,30138,0,3,4
8572,4,1,30139,30139,30140,0,1,1
8573,6,1,30145,30145,30146,0,1,5
8574,3,1,30148,30148,30149,0,1,2
8575,5,1,30153,30153,30154,0,1,4
8576,1,1,30154,30154,30155,0,1,0
8577,2,3,30156,30156,30159,0,3,1
8578,2,1,30158,30159,30160,1,2,0
8579,2,2,30160,30160,30162,0,2,0
8580,4,2,30164,30164,30166,0,2,2
8581,2,2,30166,30166,30168,0,2,0
8582,3,1,30169,30169,30170,0,1,1
8583,3,2,30172,30172,30174,0,2,2
8584,2,1,30174,30174,30175,0,1,0
8585,3,3,30177,30177,30180,0,3,2
8586,6,1,30183,30183,30184,0,1,3
8587,3,2,30186,30186,30188,0,2,2
8588,3,2,30189,30189,30191,0,2,1
8589,5,3,30194,30194,30197,0,3,3
8590,1,2,30195,30197,30199,2,4,0
8591,6,3,30201,30201,30204,0,3,2
8592,5,1,30206,30206,30207,0,1,2
8593,1,2,30207,30207,30209,0,2,0
8594,6,1,30213,30213,30214,0,1,4
8595,4,1,30217,30217,30218,0,1,3
8596,4,2,30221,30221,30223,0,2,3
8597,2,2,30223,30223,30225,0,2,0
8598,3,3,30226,30226,30229,0,3,1
8599,1,2,30227,30229,30231,2,4,0
8600,3,2,30230,30231,30233,1,3,0
8601,3,2,30233,30233,30235,0,2,0
8602,5,1,30238,30238,30239,0,1,3
8603,6,1,30244,30244,30245,0,1,5
8604,5,3,30249,30249,30252,0,3,4
8605,3,1,30252,30252,30253,0,1,0
8606,2,3,30254,30254,30257,0,3,1
8607,1,2,30255,30257,30259,2,4,0
8608,6,3,30261,30261,30264,0,3,2
8609,1,2,30262,30264,30266,2,4,0
8610,6,2,30268,30268,30270,0,2,2
8611,4,2,30272,30272,30274,0,2,2
8612,6,1,30278,30278,30279,0,1,4
8613,1,2,30279,30279,30281,0,2,0
8614,6,1,30285,30285,30286,0,1,4
8615,5,1,30290,30290,30291,0,1,4
8616,4,1,30294,30294,30295,0,1,3
8617,5,3,30299,30299,30302,0,3,4
8618,1,3,30300,30302,30305,2,5,0
8619,6,1,30306,30306,30307,0,1,1
8620,4,1,30310,30310,30311,0,1,3
8621,1,1,30311,30311,30312,0,1,0
8622,6,2,30317,30317,30319,0,2,5
8623,2,3,30319,30319,30322,0,3,0
8624,5,2,30324,30324,30326,0,2,2
8625,6,1,30330,30330,30331,0,1,4
8626,1,1,30331,30331,30332,0,1,0
8627,1,3,30332,30332,30335,0,3,0
8628,4,1,30336,30336,30337,0,1,1
8629,5,3,30341,30341,30344,0,3,4
8630,6,1,30347,30347,30348,0,1,3
8631,3,1,30350,30350,30351,0,1,2
8632,2,3,30352,30352,30355,0,3,1
8633,2,1,30354,30355,30356,1,2,0
8634,3,1,30357,30357,30358,0,1,1
8635,1,2,30358,30358,30360,0,2,0
8636,3,3,30361,30361,30364,0,3,1
8637,1,1,30362,30364,30365,2,3,0
8638,4,1,30366,30366,30367,0,1,1
8639,2,3,30368,30368,30371,0,3,1
8640,3,2,30371,30371,30373,0,2,0
8641,1,1,30372,30373,30374,1,2,0
8642,2,2,30374,30374,30376,0,2,0
8643,4,1,30378,30378,30379,0,1,2
8644,2,1,30380,30380,30381,0,1,1
8645,1,2,30381,30381,30383,0,2,0
8646,1,1,30382,30383,30384,1,2,0
8647,4,3,30386,30386,30389,0,3,2
8648,4,2,30390,30390,30392,0,2,1
8649,2,3,30392,30392,30395,0,3,0
8650,3,3,30395,30395,30398,0,3,0
8651,5,3,30400,30400,30403,0,3,2
8652,3,3,30403,30403,30406,0,3,0
8653,1,3,30404,30406,30409,2,5,0
8654,2,2,30406,30409,30411,3,5,0
8655,4,3,30410,30411,30414,1,4,0
8656,5,2,30415,30415,30417,0,2,1
8657,3,1,30418,30418,30419,0,1,1
8658,4,3,30422,30422,30425,0,3,3
8659,6,1,30428,30428,30429,0,1,3
8660,4,1,30432,30432,30433,0,1,3
8661,6,1,30438,30438,30439,0,1,5
8662,5,1,30443,30443,30444,0,1,4
8663,6,1,30449,30449,30450,0,1,5
8664,3,1,30452,30452,30453,0,1,2
8665,3,3,30455,30455,30458,0,3,2
8666,1,3,30456,30458,30461,2,5,0
8667,5,1,30461,30461,30462,0,1,0
8668,5,1,30466,30466,30467,0,1,4
8669,4,2,30470,30470,30472,0,2,3
8670,3,2,30473,30473,30475,0,2,1
8671,4,1,30477,30477,30478,0,1,2
8672,5,1,30482,30482,30483,0,1,4
8673,1,1,30483,30483,30484,0,1,0
8674,2,1,30485,30485,30486,0,1,1
8675,5,1,30490,30490,30491,0,1,4
8676,5,3,30495,30495,30498,0,3,4
8677,2,1,30497,30498,30499,1,2,0
8678,1,2,30498,30499,30501,1,3,0
8679,1,1,30499,30501,30502,2,3,0
8680,5,3,30504,30504,30507,0,3,2
8681,6,2,30510,30510,30512,0,2,3
8682,2,3,30512,30512,30515,0,3,0
8683,1,3,30513,30515,30518,2,5,0
8684,6,3,30519,30519,30522,0,3,1
8685,5,2,30524,30524,30526,0,2,2
8686,3,1,30527,30527,30528,0,1,1
8687,6,3,30533,30533,30536,0,3,5
8688,1,2,30534,30536,30538,2,4,0
8689,1,3,30535,30538,30541,3,6,0
8690,6,2,30541,30541,30543,0,2,0
8691,2,2,30543,30543,30545,0,2,0
8692,4,3,30547,30547,30550,0,3,2
8693,4,1,30551,30551,30552,0,1,1
8694,3,2,30554,30554,30556,0,2,2
8695,6,3,30560,30560,30563,0,3,4
8696,6,3,30566,30566,30569,0,3,3
8697,3,1,30569,30569,30570,0,1,0
8698,3,1,30572,30572,30573,0,1,2
8699,6,1,30578,30578,30579,0,1,5
8700,5,2,30583,30583,30585,0,2,4
8701,2,2,30585,30585,30587,0,2,0
8702,4,1,30589,30589,30590,0,1,2
8703,1,2,30590,30590,30592,0,2,0
8704,2,3,30592,30592,30595,0,3,0
8705,4,3,30596,30596,30599,0,3,1
8706,5,2,30601,30601,30603,0,2,2
8707,4,2,30605,30605,30607,0,2,2
8708,3,3,30608,30608,30611,0,3,1
8709,5,2,30613,30613,30615,0,2,2
8710,6,1,30619,30619,30620,0,1,4
8711,1,2,30620,30620,30622,0,2,0
8712,3,2,30623,30623,30625,0,2,1
8713,4,3,30627,30627,30630,0,3,2
8714,4,2,30631,30631,30633,0,2,1
8715,6,2,30637,30637,30639,0,2,4
8716,1,1,30638,30639,30640,1,2,0
8717,3,2,30641,30641,30643,0,2,1
8718,6,2,30647,30647,30649,0,2,4
8719,2,2,30649,30649,30651,0,2,0
8720,6,2,30655,30655,30657,0,2,4
8721,2,3,30657,30657,30660,0,3,0
8722,4,3,30661,30661,30664,0,3,1
8723,5,3,30666,30666,30669,0,3,2
8724,1,3,30667,30669,30672,2,5,0
8725,6,1,30673,30673,30674,0,1,1
8726,2,3,30675,30675,30678,0,3,1
8727,2,1,30677,30678,30679,1,2,0
8728,5,2,30682,30682,30684,0,2,3
8729,4,2,30686,30686,30688,0,2,2
8730,4,2,30690,30690,30692,0,2,2
8731,3,1,30693,30693,30694,0,1,1
8732,1,1,30694,30694,30695,0,1,0
8733,1,2,30695,30695,30697,0,2,0
8734,1,2,30696,30697,30699,1,3,0
8735,3,1,30699,30699,30700,0,1,0
8736,3,1,30702,30702,30703,0,1,2
8737,3,3,30705,30705,30708,0,3,2
8738,4,3,30709,30709,30712,0,3,1
8739,6,1,30715,30715,30716,0,1,3
8740,3,2,30718,30718,30720,0,2,2
8741,1,2,30719,30720,30722,1,3,0
8742,6,3,30725,30725,30728,0,3,3
8743,5,3,30730,30730,30733,0,3,2
8744,5,3,30735,30735,30738,0,3,2
8745,3,1,30738,30738,30739,0,1,0
8746,3,1,30741,30741,30742,0,1,2
8747,4,2,30745,30745,30747,0,2,3
8748,5,1,30750,30750,30751,0,1,3
8749,2,2,30752,30752,30754,0,2,1
8750,3,2,30755,30755,30757,0,2,1
8751,3,1,30758,30758,30759,0,1,1
8752,4,2,30762,30762,30764,0,2,3
8753,4,1,30766,30766,30767,0,1,2
8754,5,1,30771,30771,30772,0,1,4
8755,4,2,30775,30775,30777,0,2,3
8756,5,3,30780,30780,30783,0,3,3
8757,6,2,30786,30786,30788,0,2,3
8758,3,3,30789,30789,30792,0,3,1
8759,2,3,30791,30792,30795,1,4,0
8760,2,1,30793,30795,30796,2,3,0
8761,1,1,30794,30796,30797,2,3,0
8762,3,2,30797,30797,30799,0,2,0
8763,5,3,30802,30802,30805,0,3,3
8764,6,3,30808,30808,30811,0,3,3
8765,1,3,30809,30811,30814,2,5,0
8766,4,3,30813,30814,30817,1,4,0
8767,5,1,30818,30818,30819,0,1,1
8768,2,2,30820,30820,30822,0,2,1
8769,5,1,30825,30825,30826,0,1,3
8770,5,3,30830,30830,30833,0,3,4
8771,1,2,30831,30833,30835,2,4,0
8772,5,3,30836,30836,30839,0,3,1
8773,3,2,30839,30839,30841,0,2,0
8774,4,1,30843,30843,30844,0,1,2
8775,1,3,30844,30844,30847,0,3,0
8776,2,3,30846,30847,30850,1,4,0
8777,2,1,30848,30850,30851,2,3,0
8778,4,1,30852,30852,30853,0,1,1
8779,6,2,30858,30858,30860,0,2,5
8780,5,3,30863,30863,30866,0,3,3
8781,5,3,30868,30868,30871,0,3,2
8782,3,1,30871,30871,30872,0,1,0
8783,3,3,30874,30874,30877,0,3,2
8784,6,2,30880,30880,30882,0,2,3
8785,2,2,30882,30882,30884,0,2,0
8786,4,1,30886,30886,30887,0,1,2
8787,4,2,30890,30890,30892,0,2,3
8788,5,2,30895,30895,30897,0,2,3
8789,4,3,30899,30899,30902,0,3,2
8790,5,3,30904,30904,30907,0,3,2
8791,5,1,30909,30909,30910,0,1,2
8792,1,2,30910,30910,30912,0,2,0
8793,2,1,30912,30912,30913,0,1,0
8794,2,2,30914,30914,30916,0,2,1
8795,3,3,30917,30917,30920,0,3,1
8796,5,3,30922,30922,30925,0,3,2
8797,4,3,30926,30926,30929,0,3,1
8798,6,2,30932,30932,30934,0,2,3
8799,1,1,30933,30934,30935,1,2,0
8800,3,2,30936,30936,30938,0,2,1
8801,3,2,30939,30939,30941,0,2,1
8802,3,1,30942,30942,30943,0,1,1
8803,6,3,30948,30948,30951,0,3,5
8804,3,1,30951,30951,30952,0,1,0
8805,3,3,30954,30954,30957,0,3,2
8806,4,2,30958,30958,30960,0,2,1
8807,1,1,30959,30960,30961,1,2,0
8808,1,3,30960,30961,30964,1,4,0
8809,6,1,30966,30966,30967,0,1,2
8810,6,2,30972,30972,30974,0,2,5
8811,5,3,30977,30977,30980,0,3,3
8812,1,3,30978,30980,30983,2,5,0
8813,6,1,30984,30984,30985,0,1,1
8814,6,3,30990,30990,30993,0,3,5
8815,6,2,30996,30996,30998,0,2,3
8816,5,3,31001,31001,31004,0,3,3
8817,2,3,31003,31004,31007,1,4,0
8818,1,1,31004,31007,31008,3,4,0
8819,1,1,31005,31008,31009,3,4,0
8820,3,3,31008,31009,31012,1,4,0
8821,5,2,31013,31013,31015,0,2,1
8822,5,1,31018,31018,31019,0,1,3
8823,1,2,31019,31019,31021,0,2,0
8824,2,2,31021,31021,31023,0,2,0
8825,4,2,31025,31025,31027,0,2,2
8826,1,2,31026,31027,31029,1,3,0
8827,1,3,31027,31029,31032,2,5,0
8828,1,1,31028,31032,31033,4,5,0
8829,5,2,31033,31033,31035,0,2,0
8830,2,3,31035,31035,31038,0,3,0
8831,2,3,31037,31038,31041,1,4,0
8832,4,2,31041,31041,31043,0,2,0
8833,5,3,31046,31046,31049,0,3,3
8834,4,1,31050,31050,31051,0,1,1
8835,1,1,31051,31051,31052,0,1,0
8836,3,3,31054,31054,31057,0,3,2
8837,2,2,31056,31057,31059,1,3,0
8838,3,2,31059,31059,31061,0,2,0
8839,5,1,31064,31064,31065,0,1,3
8840,3,1,31067,31067,31068,0,1,2
8841,4,3,31071,31071,31074,0,3,3
8842,4,2,31075,31075,31077,0,2,1
8843,2,2,31077,31077,31079,0,2,0
8844,6,1,31083,31083,31084,0,1,4
8845,5,2,31088,31088,31090,0,2,4
8846,3,2,31091,31091,31093,0,2,1
8847,2,3,31093,31093,31096,0,3,0
8848,2,3,31095,31096,31099,1,4,0
8849,1,3,31096,31099,31102,3,6,0
8850,6,1,31102,31102,31103,0,1,0
8851,4,1,31106,31106,31107,0,1,3
8852,6,2,31112,31112,31114,0,2,5
8853,3,1,31115,31115,31116,0,1,1
8854,6,1,31121,31121,31122,0,1,5
8855,1,3,31122,31122,31125,0,3,0
8856,3,3,31125,31125,31128,0,3,0
8857,5,3,31130,31130,31133,0,3,2
8858,1,3,31131,31133,31136,2,5,0
8859,4,2,31135,31136,31138,1,3,0
8860,1,3,31136,31138,31141,2,5,0
8861,1,2,31137,31141,31143,4,6,0
8862,5,2,31142,31143,31145,1,3,0
8863,5,2,31147,31147,31149,0,2,2
8864,1,3,31148,31149,31152,1,4,0
8865,1,1,31149,31152,31153,3,4,0
8866,2,2,31151,31153,31155,2,4,0
8867,6,3,31157,31157,31160,0,3,2
8868,6,3,31163,31163,31166,0,3,3
8869,2,1,31165,31166,31167,1,2,0
8870,6,3,31171,31171,31174,0,3,4
8871,4,2,31175,31175,31177,0,2,1
8872,1,1,31176,31177,31178,1,2,0
8873,2,2,31178,31178,31180,0,2,0
8874,5,3,31183,31183,31186,0,3,3
8875,4,1,31187,31187,31188,0,1,1
8876,4,2,31191,31191,31193,0,2,3
8877,6,3,31197,31197,31200,0,3,4
8878,1,1,31198,31200,31201,2,3,0
8879,2,2,31200,31201,31203,1,3,0
8880,3,3,31203,31203,31206,0,3,0
8881,3,1,31206,31206,31207,0,1,0
8882,3,1,31209,31209,31210,0,1,2
8883,1,2,31210,31210,31212,0,2,0
8884,5,3,31215,31215,31218,0,3,3
8885,6,3,31221,31221,31224,0,3,3
8886,4,2,31225,31225,31227,0,2,1
8887,4,1,31229,31229,31230,0,1,2
8888,4,1,31233,31233,31234,0,1,3
8889,3,3,31236,31236,31239,0,3,2
8890,1,2,31237,31239,31241,2,4,0
8891,6,1,31243,31243,31244,0,1,2
8892,2,2,31245,31245,31247,0,2,1
8893,2,3,31247,31247,31250,0,3,0
8894,1,2,31248,31250,31252,2,4,0
8895,3,3,31251,31252,31255,1,4,0
8896,4,3,31255,31255,31258,0,3,0
8897,6,1,31261,31261,31262,0,1,3
8898,6,1,31267,31267,31268,0,1,5
8899,3,1,31270,31270,31271,0,1,2
8900,4,2,31274,31274,31276,0,2,3
8901,1,1,31275,31276,31277,1,2,0
8902,3,3,31278,31278,31281,0,3,1
8903,5,2,31283,31283,31285,0,2,2
8904,6,3,31289,31289,31292,0,3,4
8905,3,2,31292,31292,31294,0,2,0
8906,5,3,31297,31297,31300,0,3,3
8907,2,1,31299,31300,31301,1,2,0
8908,4,3,31303,31303,31306,0,3,2
8909,4,3,31307,31307,31310,0,3,1
8910,5,1,31312,31312,31313,0,1,2
8911,1,3,31313,31313,31316,0,3,0
8912,5,3,31318,31318,31321,0,3,2
8913,1,1,31319,31321,31322,2,3,0
8914,6,2,31325,31325,31327,0,2,3
8915,4,1,31329,31329,31330,0,1,2
8916,4,2,31333,31333,31335,0,2,3
8917,1,1,31334,31335,31336,1,2,0
8918,1,3,31335,31336,31339,1,4,0
8919,3,1,31338,31339,31340,1,2,0
8920,4,2,31342,31342,31344,0,2,2
8921,1,2,31343,31344,31346,1,3,0
8922,1,1,31344,31346,31347,2,3,0
8923,6,3,31350,31350,31353,0,3,3
8924,4,3,31354,31354,31357,0,3,1
8925,4,1,31358,31358,31359,0,1,1
8926,5,3,31363,31363,31366,0,3,4
8927,5,1,31368,31368,31369,0,1,2
8928,1,2,31369,31369,31371,0,2,0
8929,4,1,31373,31373,31374,0,1,2
8930,5,3,31378,31378,31381,0,3,4
8931,5,1,31383,31383,31384,0,1,2
8932,6,1,31389,31389,31390,0,1,5
8933,1,2,31390,31390,31392,0,2,0
8934,1,1,31391,31392,31393,1,2,0
8935,3,2,31394,31394,31396,0,2,1
8936,1,1,31395,31396,31397,1,2,0
8937,6,2,31401,31401,31403,0,2,4
8938,3,1,31404,31404,31405,0,1,1
8939,1,3,31405,31405,31408,0,3,0
8940,4,1,31409,31409,31410,0,1,1
8941,2,3,31411,31411,31414,0,3,1
8942,4,3,31415,31415,31418,0,3,1
8943,3,3,31418,31418,31421,0,3,0
8944,3,2,31421,31421,31423,0,2,0
8945,4,1,31425,31425,31426,0,1,2
8946,5,2,31430,31430,31432,0,2,4
8947,4,2,31434,31434,31436,0,2,2
8948,1,3,31435,31436,31439,1,4,0
8949,3,1,31438,31439,31440,1,2,0
8950,4,3,31442,31442,31445,0,3,2
8951,1,3,31443,31445,31448,2,5,0
8952,6,1,31449,31449,31450,0,1,1
8953,3,1,31452,31452,31453,0,1,2
8954,6,1,31458,31458,31459,0,1,5
8955,1,3,31459,31459,31462,0,3,0
8956,4,3,31463,31463,31466,0,3,1
8957,5,1,31468,31468,31469,0,1,2
8958,5,2,31473,31473,31475,0,2,4
8959,4,2,31477,31477,31479,0,2,2
8960,6,3,31483,31483,31486,0,3,4
8961,3,1,31486,31486,31487,0,1,0
8962,4,3,31490,31490,31493,0,3,3
8963,4,2,31494,31494,31496,0,2,1
8964,3,3,31497,31497,31500,0,3,1
8965,1,2,31498,31500,31502,2,4,0
8966,5,3,31503,31503,31506,0,3,1
8967,5,1,31508,31508,31509,0,1,2
8968,1,3,31509,31509,31512,0,3,0
8969,6,3,31515,31515,31518,0,3,3
8970,5,3,31520,31520,31523,0,3,2
8971,2,1,31522,31523,31524,1,2,0
8972,2,3,31524,31524,31527,0,3,0
8973,2,2,31526,31527,31529,1,3,0
8974,1,1,31527,31529,31530,2,3,0
8975,6,3,31533,31533,31536,0,3,3
8976,5,3,31538,31538,31541,0,3,2
8977,3,2,31541,31541,31543,0,2,0
8978,5,3,31546,31546,31549,0,3,3
8979,6,1,31552,31552,31553,0,1,3
8980,2,1,31554,31554,31555,0,1,1
8981,2,3,31556,31556,31559,0,3,1
8982,6,1,31562,31562,31563,0,1,3
8983,3,1,31565,31565,31566,0,1,2
8984,2,2,31567,31567,31569,0,2,1
8985,6,2,31573,31573,31575,0,2,4
8986,6,1,31579,31579,31580,0,1,4
8987,1,2,31580,31580,31582,0,2,0
8988,2,3,31582,31582,31585,0,3,0
8989,2,2,31584,31585,31587,1,3,0
8990,3,2,31587,31587,31589,0,2,0
8991,1,2,31588,31589,31591,1,3,0
8992,3,2,31591,31591,31593,0,2,0
8993,6,1,31597,31597,31598,0,1,4
8994,3,3,31600,31600,31603,0,3,2
8995,6,1,31606,31606,31607,0,1,3
8996,5,1,31611,31611,31612,0,1,4
8997,6,3,31617,31617,31620,0,3,5
8998,5,1,31622,31622,31623,0,1,2
8999,5,2,31627,31627,31629,0,2,4
9000,5,1,31632,31632,31633,0,1,3
9001,5,3,31637,31637,31640,0,3,4
9002,5,3,31642,31642,31645,0,3,2
9003,2,3,31644,31645,31648,1,4,0
9004,3,2,31647,31648,31650,1,3,0
9005,6,2,31653,31653,31655,0,2,3
9006,3,2,31656,31656,31658,0,2,1
9007,1,3,31657,31658,31661,1,4,0
9008,1,3,31658,31661,31664,3,6,0
9009,5,3,31663,31664,31667,1,4,0
9010,2,1,31665,31667,31668,2,3,0
9011,2,1,31667,31668,31669,1,2,0
9012,5,3,31672,31672,31675,0,3,3
9013,4,2,31676,31676,31678,0,2,1
9014,1,1,31677,31678,31679,1,2,0
9015,5,1,31682,31682,31683,0,1,3
9016,2,2,31684,31684,31686,0,2,1
9017,2,2,31686,31686,31688,0,2,0
9018,6,2,31692,31692,31694,0,2,4
9019,6,3,31698,31698,31701,0,3,4
9020,3,2,31701,31701,31703,0,2,0
9021,5,1,31706,31706,31707,0,1,3
9022,2,1,31708,31708,31709,0,1,1
9023,4,2,31712,31712,31714,0,2,3
9024,6,3,31718,31718,31721,0,3,4
9025,1,2,31719,31721,31723,2,4,0
9026,2,2,31721,31723,31725,2,4,0
9027,4,2,31725,31725,31727,0,2,0
9028,5,3,31730,31730,31733,0,3,3
9029,3,1,31733,31733,31734,0,1,0
9030,2,3,31735,31735,31738,0,3,1
9031,2,1,31737,31738,31739,1,2,0
9032,5,3,31742,31742,31745,0,3,3
9033,2,2,31744,31745,31747,1,3,0
9034,3,2,31747,31747,31749,0,2,0
9035,3,3,31750,31750,31753,0,3,1
9036,5,2,31755,31755,31757,0,2,2
9037,6,3,31761,31761,31764,0,3,4
9038,5,1,31766,31766,31767,0,1,2
9039,2,2,31768,31768,31770,0,2,1
9040,6,2,31774,31774,31776,0,2,4
9041,2,1,31776,31776,31777,0,1,0
9042,1,2,31777,31777,31779,0,2,0
9043,5,3,31782,31782,31785,0,3,3
9044,4,3,31786,31786,31789,0,3,1
9045,3,1,31789,31789,31790,0,1,0
9046,6,3,31795,31795,31798,0,3,5
9047,5,3,31800,31800,31803,0,3,2
9048,6,3,31806,31806,31809,0,3,3
9049,1,2,31807,31809,31811,2,4,0
9050,5,1,31812,31812,31813,0,1,1
9051,4,2,31816,31816,31818,0,2,3
9052,2,3,31818,31818,31821,0,3,0
9053,6,1,31824,31824,31825,0,1,3
9054,2,2,31826,31826,31828,0,2,1
9055,4,1,31830,31830,31831,0,1,2
9056,2,1,31832,31832,31833,0,1,1
9057,6,1,31838,31838,31839,0,1,5
9058,3,1,31841,31841,31842,0,1,2
9059,6,1,31847,31847,31848,0,1,5
9060,1,3,31848,31848,31851,0,3,0
9061,2,2,31850,31851,31853,1,3,0
9062,5,3,31855,31855,31858,0,3,2
9063,3,1,31858,31858,31859,0,1,0
9064,6,3,31864,31864,31867,0,3,5
9065,3,1,31867,31867,31868,0,1,0
9066,4,1,31871,31871,31872,0,1,3
9067,3,1,31874,31874,31875,0,1,2
9068,5,2,31879,31879,31881,0,2,4
9069,3,1,31882,31882,31883,0,1,1
9070,1,1,31883,31883,31884,0,1,0
9071,1,2,31884,31884,31886,0,2,0
9072,6,2,31890,31890,31892,0,2,4
9073,2,2,31892,31892,31894,0,2,0
9074,4,2,31896,31896,31898,0,2,2
9075,2,2,31898,31898,31900,0,2,0
9076,4,2,31902,31902,31904,0,2,2
9077,5,2,31907,31907,31909,0,2,3
9078,6,1,31913,31913,31914,0,1,4
9079,4,3,31917,31917,31920,0,3,3
9080,5,2,31922,31922,31924,0,2,2
9081,4,3,31926,31926,31929,0,3,2
9082,4,1,31930,31930,31931,0,1,1
9083,6,3,31936,31936,31939,0,3,5
9084,5,1,31941,31941,31942,0,1,2
9085,4,1,31945,31945,31946,0,1,3
9086,5,2,31950,31950,31952,0,2,4
9087,2,2,31952,31952,31954,0,2,0
9088,4,2,31956,31956,31958,0,2,2
9089,5,2,31961,31961,31963,0,2,3
9090,3,1,31964,31964,31965,0,1,1
9091,5,1,31969,31969,31970,0,1,4
9092,2,3,31971,31971,31974,0,3,1
9093,6,1,31977,31977,31978,0,1,3
9094,6,1,31983,31983,31984,0,1,5
9095,1,3,31984,31984,31987,0,3,0
9096,6,3,31990,31990,31993,0,3,3
9097,4,2,31994,31994,31996,0,2,1
9098,4,2,31998,31998,32000,0,2,2
9099,6,1,32004,32004,32005,0,1,4
9100,2,1,32006,32006,32007,0,1,1
9101,2,1,32008,32008,32009,0,1,1
9102,2,3,32010,32010,32013,0,3,1
9103,1,3,32011,32013,32016,2,5,0
9104,5,1,32016,32016,32017,0,1,0
9105,1,3,32017,32017,32020,0,3,0
9106,4,1,32021,32021,32022,0,1,1
9107,5,3,32026,32026,32029,0,3,4
9108,5,2,32031,32031,32033,0,2,2
9109,3,3,32034,32034,32037,0,3,1
9110,2,1,32036,32037,32038,1,2,0
9111,5,2,32041,32041,32043,0,2,3
9112,3,1,32044,32044,32045,0,1,1
9113,5,1,32049,32049,32050,0,1,4
9114,2,2,32051,32051,32053,0,2,1
9115,3,3,32054,32054,32057,0,3,1
9116,3,2,32057,32057,32059,0,2,0
9117,4,1,32061,32061,32062,0,1,2
9118,1,1,32062,32062,32063,0,1,0
9119,6,1,32068,32068,32069,0,1,5
9120,1,3,32069,32069,32072,0,3,0
9121,3,1,32072,32072,32073,0,1,0
9122,5,2,32077,32077,32079,0,2,4
9123,6,1,32083,32083,32084,0,1,4
9124,4,2,32087,32087,32089,0,2,3
9125,2,1,32089,32089,32090,0,1,0
9126,6,2,32095,32095,32097,0,2,5
9127,4,2,32099,32099,32101,0,2,2
9128,3,3,32102,32102,32105,0,3,1
9129,5,2,32107,32107,32109,0,2,2
9130,6,3,32113,32113,32116,0,3,4
9131,5,2,32118,32118,32120,0,2,2
9132,3,1,32121,32121,32122,0,1,1
9133,6,2,32127,32127,32129,0,2,5
9134,3,3,32130,32130,32133,0,3,1
9135,2,1,32132,32133,32134,1,2,0
9136,4,3,32136,32136,32139,0,3,2
9137,3,2,32139,32139,32141,0,2,0
9138,2,1,32141,32141,32142,0,1,0
9139,5,3,32146,32146,32149,0,3,4
9140,2,1,32148,32149,32150,1,2,0
9141,2,3,32150,32150,32153,0,3,0
9142,3,1,32153,32153,32154,0,1,0
9143,6,1,32159,32159,32160,0,1,5
9144,6,1,32165,32165,32166,0,1,5
9145,1,3,32166,32166,32169,0,3,0
9146,5,2,32171,32171,32173,0,2,2
9147,3,2,32174,32174,32176,0,2,1
9148,2,1,32176,32176,32177,0,1,0
9149,3,2,32179,32179,32181,0,2,2
9150,1,2,32180,32181,32183,1,3,0
9151,6,3,32186,32186,32189,0,3,3
9152,4,1,32190,32190,32191,0,1,1
9153,4,3,32194,32194,32197,0,3,3
9154,6,2,32200,32200,32202,0,2,3
9155,5,2,32205,32205,32207,0,2,3
9156,2,2,32207,32207,32209,0,2,0
9157,4,3,32211,32211,32214,0,3,2
9158,3,2,32214,32214,32216,0,2,0
9159,2,1,32216,32216,32217,0,1,0
9160,6,1,32222,32222,32223,0,1,5
9161,2,3,32224,32224,32227,0,3,1
9162,4,3,32228,32228,32231,0,3,1
9163,1,1,32229,32231,32232,2,3,0
9164,5,1,32234,32234,32235,0,1,2
9165,5,3,32239,32239,32242,0,3,4
9166,4,1,32243,32243,32244,0,1,1
9167,6,3,32249,32249,32252,0,3,5
9168,6,3,32255,32255,32258,0,3,3
9169,5,3,32260,32260,32263,0,3,2
9170,2,1,32262,32263,32264,1,2,0
9171,4,3,32266,32266,32269,0,3,2
9172,6,2,32272,32272,32274,0,2,3
9173,3,2,32275,32275,32277,0,2,1
9174,2,2,32277,32277,32279,0,2,0
9175,5,3,32282,32282,32285,0,3,3
9176,6,1,32288,32288,32289,0,1,3
9177,2,3,32290,32290,32293,0,3,1
9178,2,1,32292,32293,32294,1,2,0
9179,5,3,32297,32297,32300,0,3,3
9180,2,3,32299,32300,32303,1,4,0
9181,4,3,32303,32303,32306,0,3,0
9182,4,2,32307,32307,32309,0,2,1
9183,2,2,32309,32309,32311,0,2,0
9184,1,1,32310,32311,32312,1,2,0
9185,5,3,32315,32315,32318,0,3,3
9186,4,3,32319,32319,32322,0,3,1
9187,3,3,32322,32322,32325,0,3,0
9188,5,1,32327,32327,32328,0,1,2
9189,4,3,32331,32331,32334,0,3,3
9190,6,1,32337,32337,32338,0,1,3
9191,1,3,32338,32338,32341,0,3,0
9192,4,2,32342,32342,32344,0,2,1
9193,4,2,32346,32346,32348,0,2,2
9194,3,1,32349,32349,32350,0,1,1
9195,1,3,32350,32350,32353,0,3,0
9196,1,1,32351,32353,32354,2,3,0
9197,3,3,32354,32354,32357,0,3,0
9198,2,1,32356,32357,32358,1,2,0
9199,3,1,32359,32359,32360,0,1,1
9200,6,1,32365,32365,32366,0,1,5
9201,6,2,32371,32371,32373,0,2,5
9202,4,1,32375,32375,32376,0,1,2
9203,5,2,32380,32380,32382,0,2,4
9204,1,2,32381,32382,32384,1,3,0
9205,3,1,32384,32384,32385,0,1,0
9206,5,1,32389,32389,32390,0,1,4
9207,1,1,32390,32390,32391,0,1,0
9208,3,2,32393,32393,32395,0,2,2
9209,3,1,32396,32396,32397,0,1,1
9210,2,2,32398,32398,32400,0,2,1
9211,4,2,32402,32402,32404,0,2,2
9212,3,1,32405,32405,32406,0,1,1
9213,1,2,32406,32406,32408,0,2,0
9214,2,1,32408,32408,32409,0,1,0
9215,1,2,32409,32409,32411,0,2,0
9216,2,3,32411,32411,32414,0,3,0
9217,1,3,32412,32414,32417,2,5,0
9218,5,1,32417,32417,32418,0,1,0
9219,6,2,32423,32423,32425,0,2,5
9220,1,1,32424,32425,32426,1,2,0
9221,4,1,32428,32428,32429,0,1,2
9222,5,2,32433,32433,32435,0,2,4
9223,3,1,32436,32436,32437,0,1,1
9224,3,1,32439,32439,32440,0,1,2
9225,6,2,32445,32445,32447,0,2,5
9226,4,3,32449,32449,32452,0,3,2
9227,1,3,32450,32452,32455,2,5,0
9228,3,3,32453,32455,32458,2,5,0
9229,1,3,32454,32458,32461,4,7,0
9230,6,3,32460,32461,32464,1,4,0
9231,3,1,32463,32464,32465,1,2,0
9232,4,3,32467,32467,32470,0,3,2
9233,5,2,32472,32472,32474,0,2,2
9234,3,1,32475,32475,32476,0,1,1
9235,6,2,32481,32481,32483,0,2,5
9236,6,3,32487,32487,32490,0,3,4
9237,3,2,32490,32490,32492,0,2,0
9238,1,1,32491,32492,32493,1,2,0
9239,6,1,32497,32497,32498,0,1,4
9240,5,2,32502,32502,32504,0,2,4
9241,1,1,32503,32504,32505,1,2,0
9242,6,3,32509,32509,32512,0,3,4
9243,3,3,32512,32512,32515,0,3,0
9244,5,2,32517,32517,32519,0,2,2
9245,1,3,32518,32519,32522,1,4,0
9246,4,1,32522,32522,32523,0,1,0
9247,2,1,32524,32524,32525,0,1,1
9248,3,1,32527,32527,32528,0,1,2
9249,5,2,32532,32532,32534,0,2,4
9250,4,3,32536,32536,32539,0,3,2
9251,1,3,32537,32539,32542,2,5,0
9252,5,2,32542,32542,32544,0,2,0
9253,4,2,32546,32546,32548,0,2,2
9254,2,1,32548,32548,32549,0,1,0
9255,5,1,32553,32553,32554,0,1,4
9256,1,2,32554,32554,32556,0,2,0
9257,1,2,32555,32556,32558,1,3,0
9258,3,1,32558,32558,32559,0,1,0
9259,5,2,32563,32563,32565,0,2,4
9260,1,1,32564,32565,32566,1,2,0
9261,6,2,32570,32570,32572,0,2,4
9262,3,3,32573,32573,32576,0,3,1
9263,1,1,32574,32576,32577,2,3,0
9264,3,3,32577,32577,32580,0,3,0
9265,4,2,32581,32581,32583,0,2,1
9266,4,1,32585,32585,32586,0,1,2
9267,4,1,32589,32589,32590,0,1,3
9268,6,2,32595,32595,32597,0,2,5
9269,3,3,32598,32598,32601,0,3,1
9270,2,1,32600,32601,32602,1,2,0
9271,2,2,32602,32602,32604,0,2,0
9272,2,2,32604,32604,32606,0,2,0
9273,3,1,32607,32607,32608,0,1,1
9274,4,3,32611,32611,32614,0,3,3
9275,4,3,32615,32615,32618,0,3,1
9276,4,1,32619,32619,32620,0,1,1
9277,6,3,32625,32625,32628,0,3,5
9278,4,3,32629,32629,32632,0,3,1
9279,5,1,32634,32634,32635,0,1,2
9280,5,3,32639,32639,32642,0,3,4
9281,5,2,32644,32644,32646,0,2,2
9282,4,1,32648,32648,32649,0,1,2
9283,1,1,32649,32649,32650,0,1,0
9284,1,2,32650,32650,32652,0,2,0
9285,1,3,32651,32652,32655,1,4,0
9286,6,2,32657,32657,32659,0,2,2
9287,2,2,32659,32659,32661,0,2,0
9288,5,1,32664,32664,32665,0,1,3
9289,5,1,32669,32669,32670,0,1,4
9290,3,2,32672,32672,32674,0,2,2
9291,4,1,32676,32676,32677,0,1,2
9292,3,2,32679,32679,32681,0,2,2
9293,2,1,32681,32681,32682,0,1,0
9294,1,2,32682,32682,32684,0,2,0
9295,3,3,32685,32685,32688,0,3,1
9296,1,1,32686,32688,32689,2,3,0
9297,3,2,32689,32689,32691,0,2,0
9298,4,3,32693,32693,32696,0,3,2
9299,3,1,32696,32696,32697,0,1,0
9300,2,2,32698,32698,32700,0,2,1
9301,5,3,32703,32703,32706,0,3,3
9302,3,3,32706,32706,32709,0,3,0
9303,4,2,32710,32710,32712,0,2,1
9304,2,3,32712,32712,32715,0,3,0
9305,5,2,32717,32717,32719,0,2,2
9306,4,3,32721,32721,32724,0,3,2
9307,4,2,32725,32725,32727,0,2,1
9308,5,2,32730,32730,32732,0,2,3
9309,3,2,32733,32733,32735,0,2,1
9310,6,1,32739,32739,32740,0,1,4
9311,2,2,32741,32741,32743,0,2,1
9312,5,2,32746,32746,32748,0,2,3
9313,2,2,32748,32748,32750,0,2,0
9314,3,2,32751,32751,32753,0,2,1
9315,2,1,32753,32753,32754,0,1,0
9316,3,3,32756,32756,32759,0,3,2
9317,1,2,32757,32759,32761,2,4,0
9318,6,2,32763,32763,32765,0,2,2
9319,5,1,32768,32768,32769,0,1,3
9320,2,3,32770,32770,32773,0,3,1
9321,2,3,32772,32773,32776,1,4,0
9322,5,1,32777,32777,32778,0,1,1
9323,6,3,32783,32783,32786,0,3,5
9324,5,2,32788,32788,32790,0,2,2
9325,4,2,32792,32792,32794,0,2,2
9326,2,3,32794,32794,32797,0,3,0
9327,3,2,32797,32797,32799,0,2,0
9328,5,2,32802,32802,32804,0,2,3
9329,1,1,32803,32804,32805,1,2,0
9330,6,1,32809,32809,32810,0,1,4
9331,4,2,32813,32813,32815,0,2,3
9332,1,3,32814,32815,32818,1,4,0
9333,6,2,32820,32820,32822,0,2,2
9334,4,1,32824,32824,32825,0,1,2
9335,5,3,32829,32829,32832,0,3,4
9336,5,2,32834,32834,32836,0,2,2
9337,2,2,32836,32836,32838,0,2,0
9338,3,3,32839,32839,32842,0,3,1
9339,4,3,32843,32843,32846,0,3,1
9340,3,1,32846,32846,32847,0,1,0
9341,6,1,32852,32852,32853,0,1,5
9342,6,3,32858,32858,32861,0,3,5
9343,5,2,32863,32863,32865,0,2,2
9344,1,1,32864,32865,32866,1,2,0
9345,3,2,32867,32867,32869,0,2,1
9346,4,3,32871,32871,32874,0,3,2
9347,1,1,32872,32874,32875,2,3,0
9348,5,2,32877,32877,32879,0,2,2
9349,6,3,32883,32883,32886,0,3,4
9350,5,3,32888,32888,32891,0,3,2
9351,2,1,32890,32891,32892,1,2,0
9352,6,3,32896,32896,32899,0,3,4
9353,1,1,32897,32899,32900,2,3,0
9354,4,3,32901,32901,32904,0,3,1
9355,1,1,32902,32904,32905,2,3,0
9356,5,1,32907,32907,32908,0,1,2
9357,1,1,32908,32908,32909,0,1,0
9358,4,1,32912,32912,32913,0,1,3
9359,5,1,32917,32917,32918,0,1,4
9360,6,2,32923,32923,32925,0,2,5
9361,3,3,32926,32926,32929,0,3,1
9362,2,2,32928,32929,32931,1,3,0
9363,1,3,32929,32931,32934,2,5,0
9364,5,1,32934,32934,32935,0,1,0
9365,5,3,32939,32939,32942,0,3,4
9366,2,3,32941,32942,32945,1,4,0
9367,3,2,32944,32945,32947,1,3,0
9368,2,2,32946,32947,32949,1,3,0
9369,2,3,32948,32949,32952,1,4,0
9370,5,3,32953,32953,32956,0,3,1
9371,4,3,32957,32957,32960,0,3,1
9372,4,3,32961,32961,32964,0,3,1
9373,1,1,32962,32964,32965,2,3,0
9374,6,2,32968,32968,32970,0,2,3
9375,1,3,32969,32970,32973,1,4,0
9376,5,3,32974,32974,32977,0,3,1
9377,4,2,32978,32978,32980,0,2,1
9378,2,2,32980,32980,32982,0,2,0
9379,3,2,32983,32983,32985,0,2,1
9380,4,3,32987,32987,32990,0,3,2
9381,3,3,32990,32990,32993,0,3,0
9382,4,2,32994,32994,32996,0,2,1
9383,4,3,32998,32998,33001,0,3,2
9384,1,2,32999,33001,33003,2,4,0
9385,4,2,33003,33003,33005,0,2,0
9386,6,2,33009,33009,33011,0,2,4
9387,5,3,33014,33014,33017,0,3,3
9388,6,2,33020,33020,33022,0,2,3
9389,4,1,33024,33024,33025,0,1,2
9390,3,3,33027,33027,33030,0,3,2
9391,2,1,33029,33030,33031,1,2,0
9392,1,3,33030,33031,33034,1,4,0
9393,5,3,33035,33035,33038,0,3,1
9394,6,2,33041,33041,33043,0,2,3
9395,3,1,33044,33044,33045,0,1,1
9396,3,1,33047,33047,33048,0,1,2
9397,6,3,33053,33053,33056,0,3,5
9398,3,1,33056,33056,33057,0,1,0
9399,3,1,33059,33059,33060,0,1,2
9400,5,2,33064,33064,33066,0,2,4
9401,3,1,33067,33067,33068,0,1,1
9402,6,1,33073,33073,33074,0,1,5
9403,5,2,33078,33078,33080,0,2,4
9404,1,2,33079,33080,33082,1,3,0
9405,2,3,33081,33082,33085,1,4,0
9406,3,3,33084,33085,33088,1,4,0
9407,3,2,33087,33088,33090,1,3,0
9408,6,1,33093,33093,33094,0,1,3
9409,3,1,33096,33096,33097,0,1,2
9410,2,1,33098,33098,33099,0,1,1
9411,1,1,33099,33099,33100,0,1,0
9412,3,3,33102,33102,33105,0,3,2
9413,2,1,33104,33105,33106,1,2,0
9414,2,2,33106,33106,33108,0,2,0
9415,2,1,33108,33108,33109,0,1,0
9416,6,1,33114,33114,33115,0,1,5
9417,2,2,33116,33116,33118,0,2,1
9418,1,1,33117,33118,33119,1,2,0
9419,2,3,33119,33119,33122,0,3,0
9420,2,2,33121,33122,33124,1,3,0
9421,6,1,33127,33127,33128,0,1,3
9422,5,1,33132,33132,33133,0,1,4
9423,6,2,33138,33138,33140,0,2,5
9424,1,3,33139,33140,33143,1,4,0
9425,3,2,33142,33143,33145,1,3,0
9426,5,2,33147,33147,33149,0,2,2
9427,1,1,33148,33149,33150,1,2,0
9428,6,1,33154,33154,33155,0,1,4
9429,4,1,33158,33158,33159,0,1,3
9430,6,1,33164,33164,33165,0,1,5
9431,6,3,33170,33170,33173,0,3,5
9432,4,1,33174,33174,33175,0,1,1
9433,2,1,33176,33176,33177,0,1,1
9434,2,1,33178,33178,33179,0,1,1
9435,6,3,33184,33184,33187,0,3,5
9436,2,3,33186,33187,33190,1,4,0
9437,3,2,33189,33190,33192,1,3,0
9438,6,3,33195,33195,33198,0,3,3
9439,6,2,33201,33201,33203,0,2,3
9440,5,3,33206,33206,33209,0,3,3
9441,6,3,33212,33212,33215,0,3,3
9442,1,1,33213,33215,33216,2,3,0
9443,6,1,33219,33219,33220,0,1,3
9444,3,2,33222,33222,33224,0,2,2
9445,1,3,33223,33224,33227,1,4,0
9446,4,1,33227,33227,33228,0,1,0
9447,4,2,33231,33231,33233,0,2,3
9448,6,3,33237,33237,33240,0,3,4
9449,4,3,33241,33241,33244,0,3,1
9450,4,1,33245,33245,33246,0,1,1
9451,6,2,33251,33251,33253,0,2,5
9452,6,2,33257,33257,33259,0,2,4
9453,4,2,33261,33261,33263,0,2,2
9454,2,2,33263,33263,33265,0,2,0
9455,3,2,33266,33266,33268,0,2,1
9456,4,3,33270,33270,33273,0,3,2
9457,4,2,33274,33274,33276,0,2,1
9458,3,3,33277,33277,33280,0,3,1
9459,6,3,33283,33283,33286,0,3,3
9460,6,2,33289,33289,33291,0,2,3
9461,4,2,33293,33293,33295,0,2,2
9462,4,2,33297,33297,33299,0,2,2
9463,5,1,33302,33302,33303,0,1,3
9464,5,1,33307,33307,33308,0,1,4
9465,5,2,33312,33312,33314,0,2,4
9466,5,1,33317,33317,33318,0,1,3
9467,6,1,33323,33323,33324,0,1,5
9468,6,2,33329,33329,33331,0,2,5
9469,3,1,33332,33332,33333,0,1,1
9470,6,1,33338,33338,33339,0,1,5
9471,4,1,33342,33342,33343,0,1,3
9472,2,1,33344,33344,33345,0,1,1
9473,5,3,33349,33349,33352,0,3,4
9474,3,2,33352,33352,33354,0,2,0
9475,4,2,33356,33356,33358,0,2,2
9476,5,1,33361,33361,33362,0,1,3
9477,2,3,33363,33363,33366,0,3,1
9478,5,1,33368,33368,33369,0,1,2
9479,3,1,33371,33371,33372,0,1,2
9480,4,2,33375,33375,33377,0,2,3
9481,2,2,33377,33377,33379,0,2,0
9482,3,1,33380,33380,33381,0,1,1
9483,2,2,33382,33382,33384,0,2,1
9484,3,2,33385,33385,33387,0,2,1
9485,6,3,33391,33391,33394,0,3,4
9486,6,2,33397,33397,33399,0,2,3
9487,3,3,33400,33400,33403,0,3,1
9488,2,2,33402,33403,33405,1,3,0
9489,1,2,33403,33405,33407,2,4,0
9490,1,1,33404,33407,33408,3,4,0
9491,4,3,33408,33408,33411,0,3,0
9492,2,2,33410,33411,33413,1,3,0
9493,1,3,33411,33413,33416,2,5,0
9494,1,3,33412,33416,33419,4,7,0
9495,3,2,33415,33419,33421,4,6,0
9496,1,3,33416,33421,33424,5,8,0
9497,5,3,33421,33424,33427,3,6,0
9498,4,3,33425,33427,33430,2,5,0
9499,6,1,33431,33431,33432,0,1,1
9500,5,2,33436,33436,33438,0,2,4
9501,2,2,33438,33438,33440,0,2,0
9502,6,2,33444,33444,33446,0,2,4
9503,5,3,33449,33449,33452,0,3,3
9504,1,2,33450,33452,33454,2,4,0
9505,3,3,33453,33454,33457,1,4,0
9506,4,1,33457,33457,33458,0,1,0
9507,3,2,33460,33460,33462,0,2,2
9508,5,1,33465,33465,33466,0,1,3
9509,5,2,33470,33470,33472,0,2,4
9510,6,3,33476,33476,33479,0,3,4
9511,2,2,33478,33479,33481,1,3,0
9512,5,1,33483,33483,33484,0,1,2
9513,4,3,33487,33487,33490,0,3,3
9514,3,1,33490,33490,33491,0,1,0
9515,1,2,33491,33491,33493,0,2,0
9516,4,3,33495,33495,33498,0,3,2
9517,6,1,33501,33501,33502,0,1,3
9518,5,3,33506,33506,33509,0,3,4
9519,1,2,33507,33509,33511,2,4,0
9520,3,2,33510,33511,33513,1,3,0
9521,3,2,33513,33513,33515,0,2,0
9522,2,3,33515,33515,33518,0,3,0
9523,2,2,33517,33518,33520,1,3,0
9524,5,2,33522,33522,33524,0,2,2
9525,3,2,33525,33525,33527,0,2,1
9526,2,2,33527,33527,33529,0,2,0
9527,6,3,33533,33533,33536,0,3,4
9528,1,2,33534,33536,33538,2,4,0
9529,1,1,33535,33538,33539,3,4,0
9530,6,3,33541,33541,33544,0,3,2
9531,2,3,33543,33544,33547,1,4,0
9532,5,1,33548,33548,33549,0,1,1
9533,6,1,33554,33554,33555,0,1,5
9534,6,3,33560,33560,33563,0,3,5
9535,1,3,33561,33563,33566,2,5,0
9536,2,3,33563,33566,33569,3,6,0
9537,4,1,33567,33569,33570,2,3,0
9538,3,3,33570,33570,33573,0,3,0
9539,6,3,33576,33576,33579,0,3,3
9540,6,3,33582,33582,33585,0,3,3
9541,3,2,33585,33585,33587,0,2,0
9542,1,3,33586,33587,33590,1,4,0
9543,4,2,33590,33590,33592,0,2,0
9544,6,3,33596,33596,33599,0,3,4
9545,2,1,33598,33599,33600,1,2,0
9546,2,3,33600,33600,33603,0,3,0
9547,3,3,33603,33603,33606,0,3,0
9548,2,3,33605,33606,33609,1,4,0
9549,5,2,33610,33610,33612,0,2,1
9550,6,2,33616,33616,33618,0,2,4
9551,3,3,33619,33619,33622,0,3,1
9552,4,1,33623,33623,33624,0,1,1
9553,2,3,33625,33625,33628,0,3,1
9554,4,1,33629,33629,33630,0,1,1
9555,3,3,33632,33632,33635,0,3,2
9556,2,3,33634,33635,33638,1,4,0
9557,5,3,33639,33639,33642,0,3,1
9558,5,1,33644,33644,33645,0,1,2
9559,2,3,33646,33646,33649,0,3,1
9560,1,3,33647,33649,33652,2,5,0
9561,6,2,33653,33653,33655,0,2,1
9562,6,3,33659,33659,33662,0,3,4
9563,3,3,33662,33662,33665,0,3,0
9564,4,3,33666,33666,33669,0,3,1
9565,5,2,33671,33671,33673,0,2,2
9566,2,2,33673,33673,33675,0,2,0
9567,4,3,33677,33677,33680,0,3,2
9568,2,2,33679,33680,33682,1,3,0
9569,1,3,33680,33682,33685,2,5,0
9570,3,3,33683,33685,33688,2,5,0
9571,6,3,33689,33689,33692,0,3,1
9572,5,2,33694,33694,33696,0,2,2
9573,3,3,33697,33697,33700,0,3,1
9574,5,3,33702,33702,33705,0,3,2
9575,5,3,33707,33707,33710,0,3,2
9576,3,2,33710,33710,33712,0,2,0
9577,3,3,33713,33713,33716,0,3,1
9578,4,1,33717,33717,33718,0,1,1
9579,3,3,33720,33720,33723,0,3,2
9580,5,1,33725,33725,33726,0,1,2
9581,4,1,33729,33729,33730,0,1,3
9582,2,3,33731,33731,33734,0,3,1
9583,6,2,33737,33737,33739,0,2,3
9584,5,1,33742,33742,33743,0,1,3
9585,6,1,33748,33748,33749,0,1,5
9586,5,3,33753,33753,33756,0,3,4
9587,4,3,33757,33757,33760,0,3,1
9588,2,1,33759,33760,33761,1,2,0
9589,4,2,33763,33763,33765,0,2,2
9590,5,3,33768,33768,33771,0,3,3
9591,2,3,33770,33771,33774,1,4,0
9592,2,1,33772,33774,33775,2,3,0
9593,1,1,33773,33775,33776,2,3,0
9594,1,1,33774,33776,33777,2,3,0
9595,3,2,33777,33777,33779,0,2,0
9596,3,2,33780,33780,33782,0,2,1
9597,4,3,33784,33784,33787,0,3,2
9598,5,1,33789,33789,33790,0,1,2
9599,1,2,33790,33790,33792,0,2,0
9600,1,1,33791,33792,33793,1,2,0
9601,2,2,33793,33793,33795,0,2,0
9602,6,1,33799,33799,33800,0,1,4
9603,6,3,33805,33805,33808,0,3,5
9604,1,2,33806,33808,33810,2,4,0
9605,3,2,33809,33810,33812,1,3,0
9606,4,2,33813,33813,33815,0,2,1
9607,3,1,33816,33816,33817,0,1,1
9608,2,3,33818,33818,33821,0,3,1
9609,6,3,33824,33824,33827,0,3,3
9610,3,3,33827,33827,33830,0,3,0
9611,1,1,33828,33830,33831,2,3,0
9612,2,2,33830,33831,33833,1,3,0
9613,1,2,33831,33833,33835,2,4,0
9614,5,3,33836,33836,33839,0,3,1
9615,2,2,33838,33839,33841,1,3,0
9616,2,1,33840,33841,33842,1,2,0
9617,1,1,33841,33842,33843,1,2,0
9618,6,3,33847,33847,33850,0,3,4
9619,1,1,33848,33850,33851,2,3,0
9620,4,3,33852,33852,33855,0,3,1
9621,2,2,33854,33855,33857,1,3,0
9622,1,3,33855,33857,33860,2,5,0
9623,5,3,33860,33860,33863,0,3,0
9624,3,3,33863,33863,33866,0,3,0
9625,4,1,33867,33867,33868,0,1,1
9626,5,2,33872,33872,33874,0,2,4
9627,2,3,33874,33874,33877,0,3,0
9628,5,2,33879,33879,33881,0,2,2
9629,4,1,33883,33883,33884,0,1,2
9630,5,3,33888,33888,33891,0,3,4
9631,3,1,33891,33891,33892,0,1,0
9632,4,2,33895,33895,33897,0,2,3
9633,6,2,33901,33901,33903,0,2,4
9634,1,1,33902,33903,33904,1,2,0
9635,4,3,33906,33906,33909,0,3,2
9636,1,3,33907,33909,33912,2,5,0
9637,5,1,33912,33912,33913,0,1,0
9638,2,1,33914,33914,33915,0,1,1
9639,4,1,33918,33918,33919,0,1,3
9640,6,2,33924,33924,33926,0,2,5
9641,2,2,33926,33926,33928,0,2,0
9642,4,1,33930,33930,33931,0,1,2
9643,3,3,33933,33933,33936,0,3,2
9644,3,2,33936,33936,33938,0,2,0
9645,5,3,33941,33941,33944,0,3,3
9646,5,3,33946,33946,33949,0,3,2
9647,3,2,33949,33949,33951,0,2,0
9648,5,3,33954,33954,33957,0,3,3
9649,1,3,33955,33957,33960,2,5,0
9650,3,2,33958,33960,33962,2,4,0
9651,1,1,33959,33962,33963,3,4,0
9652,2,2,33961,33963,33965,2,4,0
9653,5,2,33966,33966,33968,0,2,1
9654,6,3,33972,33972,33975,0,3,4
9655,4,1,33976,33976,33977,0,1,1
9656,6,1,33982,33982,33983,0,1,5
9657,2,2,33984,33984,33986,0,2,1
9658,5,2,33989,33989,33991,0,2,3
9659,2,2,33991,33991,33993,0,2,0
9660,4,3,33995,33995,33998,0,3,2
9661,5,3,34000,34000,34003,0,3,2
9662,1,3,34001,34003,34006,2,5,0
9663,1,1,34002,34006,34007,4,5,0
9664,3,1,34005,34007,34008,2,3,0
9665,3,2,34008,34008,34010,0,2,0
9666,2,2,34010,34010,34012,0,2,0
9667,1,2,34011,34012,34014,1,3,0
9668,2,1,34013,34014,34015,1,2,0
9669,4,1,34017,34017,34018,0,1,2
9670,5,3,34022,34022,34025,0,3,4
9671,3,2,34025,34025,34027,0,2,0
9672,2,2,34027,34027,34029,0,2,0
9673,1,2,34028,34029,34031,1,3,0
9674,6,2,34034,34034,34036,0,2,3
9675,4,1,34038,34038,34039,0,1,2
9676,6,3,34044,34044,34047,0,3,5
9677,2,3,34046,34047,34050,1,4,0
9678,1,1,34047,34050,34051,3,4,0
9679,6,2,34053,34053,34055,0,2,2
9680,6,1,34059,34059,34060,0,1,4
9681,1,3,34060,34060,34063,0,3,0
9682,1,1,34061,34063,34064,2,3,0
9683,5,1,34066,34066,34067,0,1,2
9684,4,1,34070,34070,34071,0,1,3
9685,2,1,34072,34072,34073,0,1,1
9686,2,2,34074,34074,34076,0,2,1
9687,1,1,34075,34076,34077,1,2,0
9688,2,2,34077,34077,34079,0,2,0
9689,5,1,34082,34082,34083,0,1,3
9690,1,2,34083,34083,34085,0,2,0
9691,6,2,34089,34089,34091,0,2,4
9692,3,1,34092,34092,34093,0,1,1
9693,5,1,34097,34097,34098,0,1,4
9694,1,3,34098,34098,34101,0,3,0
9695,3,1,34101,34101,34102,0,1,0
9696,3,2,34104,34104,34106,0,2,2
9697,6,3,34110,34110,34113,0,3,4
9698,6,3,34116,34116,34119,0,3,3
9699,4,3,34120,34120,34123,0,3,1
9700,4,2,34124,34124,34126,0,2,1
9701,4,2,34128,34128,34130,0,2,2
9702,2,3,34130,34130,34133,0,3,0
9703,4,3,34134,34134,34137,0,3,1
9704,4,3,34138,34138,34141,0,3,1
9705,6,2,34144,34144,34146,0,2,3
9706,2,2,34146,34146,34148,0,2,0
9707,5,3,34151,34151,34154,0,3,3
9708,2,1,34153,34154,34155,1,2,0
9709,6,3,34159,34159,34162,0,3,4
9710,6,3,34165,34165,34168,0,3,3
9711,6,2,34171,34171,34173,0,2,3
9712,6,2,34177,34177,34179,0,2,4
9713,1,3,34178,34179,34182,1,4,0
9714,6,2,34184,34184,34186,0,2,2
9715,3,2,34187,34187,34189,0,2,1
9716,5,1,34192,34192,34193,0,1,3
9717,4,2,34196,34196,34198,0,2,3
9718,5,2,34201,34201,34203,0,2,3
9719,6,3,34207,34207,34210,0,3,4
9720,1,1,34208,34210,34211,2,3,0
9721,4,3,34212,34212,34215,0,3,1
9722,1,2,34213,34215,34217,2,4,0
9723,1,1,34214,34217,34218,3,4,0
9724,1,3,34215,34218,34221,3,6,0
9725,5,2,34220,34221,34223,1,3,0
9726,1,3,34221,34223,34226,2,5,0
9727,4,1,34225,34226,34227,1,2,0
9728,3,1,34228,34228,34229,0,1,1
9729,1,1,34229,34229,34230,0,1,0
9730,5,3,34234,34234,34237,0,3,4
9731,5,2,34239,34239,34241,0,2,2
9732,4,1,34243,34243,34244,0,1,2
9733,3,2,34246,34246,34248,0,2,2
9734,6,1,34252,34252,34253,0,1,4
9735,3,1,34255,34255,34256,0,1,2
9736,3,3,34258,34258,34261,0,3,2
9737,4,2,34262,34262,34264,0,2,1
9738,3,3,34265,34265,34268,0,3,1
9739,3,1,34268,34268,34269,0,1,0
9740,6,2,34274,34274,34276,0,2,5
9741,1,1,34275,34276,34277,1,2,0
9742,6,2,34281,34281,34283,0,2,4
9743,2,1,34283,34283,34284,0,1,0
9744,1,1,34284,34284,34285,0,1,0
9745,5,1,34289,34289,34290,0,1,4
9746,3,1,34292,34292,34293,0,1,2
9747,6,1,34298,34298,34299,0,1,5
9748,1,3,34299,34299,34302,0,3,0
9749,3,2,34302,34302,34304,0,2,0
9750,4,3,34306,34306,34309,0,3,2
9751,1,1,34307,34309,34310,2,3,0
9752,2,2,34309,34310,34312,1,3,0
9753,5,1,34314,34314,34315,0,1,2
9754,4,3,34318,34318,34321,0,3,3
9755,5,2,34323,34323,34325,0,2,2
9756,2,3,34325,34325,34328,0,3,0
9757,2,3,34327,34328,34331,1,4,0
9758,6,2,34333,34333,34335,0,2,2
9759,6,1,34339,34339,34340,0,1,4
9760,6,3,34345,34345,34348,0,3,5
9761,2,2,34347,34348,34350,1,3,0
9762,2,3,34349,34350,34353,1,4,0
9763,2,3,34351,34353,34356,2,5,0
9764,2,3,34353,34356,34359,3,6,0
9765,3,3,34356,34359,34362,3,6,0
9766,2,1,34358,34362,34363,4,5,0
9767,4,3,34362,34363,34366,1,4,0
9768,6,1,34368,34368,34369,0,1,2
9769,4,2,34372,34372,34374,0,2,3
9770,5,2,34377,34377,34379,0,2,3
9771,3,3,34380,34380,34383,0,3,1
9772,3,2,34383,34383,34385,0,2,0
9773,5,1,34388,34388,34389,0,1,3
9774,4,3,34392,34392,34395,0,3,3
9775,6,1,34398,34398,34399,0,1,3
9776,2,3,34400,34400,34403,0,3,1
9777,6,2,34406,34406,34408,0,2,3
9778,3,3,34409,34409,34412,0,3,1
9779,1,3,34410,34412,34415,2,5,0
9780,4,2,34414,34415,34417,1,3,0
9781,2,1,34416,34417,34418,1,2,0
9782,6,3,34422,34422,34425,0,3,4
9783,1,1,34423,34425,34426,2,3,0
9784,4,2,34427,34427,34429,0,2,1
9785,6,3,34433,34433,34436,0,3,4
9786,6,1,34439,34439,34440,0,1,3
9787,1,1,34440,34440,34441,0,1,0
9788,4,3,34444,34444,34447,0,3,3
9789,5,3,34449,34449,34452,0,3,2
9790,6,3,34455,34455,34458,0,3,3
9791,5,2,34460,34460,34462,0,2,2
9792,1,2,34461,34462,34464,1,3,0
9793,3,3,34464,34464,34467,0,3,0
9794,6,2,34470,34470,34472,0,2,3
9795,3,3,34473,34473,34476,0,3,1
9796,5,2,34478,34478,34480,0,2,2
9797,2,1,34480,34480,34481,0,1,0
9798,5,3,34485,34485,34488,0,3,4
9799,4,3,34489,34489,34492,0,3,1
9800,2,3,34491,34492,34495,1,4,0
9801,1,1,34492,34495,34496,3,4,0
9802,1,2,34493,34496,34498,3,5,0
9803,5,3,34498,34498,34501,0,3,0
9804,4,1,34502,34502,34503,0,1,1
9805,5,2,34507,34507,34509,0,2,4
9806,5,1,34512,34512,34513,0,1,3
9807,5,2,34517,34517,34519,0,2,4
9808,1,1,34518,34519,34520,1,2,0
9809,5,1,34523,34523,34524,0,1,3
9810,6,2,34529,34529,34531,0,2,5
9811,5,2,34534,34534,34536,0,2,3
9812,2,3,34536,34536,34539,0,3,0
9813,2,1,34538,34539,34540,1,2,0
9814,3,3,34541,34541,34544,0,3,1
9815,5,2,34546,34546,34548,0,2,2
9816,4,3,34550,34550,34553,0,3,2
9817,3,2,34553,34553,34555,0,2,0
9818,6,2,34559,34559,34561,0,2,4
9819,3,2,34562,34562,34564,0,2,1
9820,2,3,34564,34564,34567,0,3,0
9821,3,2,34567,34567,34569,0,2,0
9822,1,2,34568,34569,34571,1,3,0
9823,5,3,34573,34573,34576,0,3,2
9824,3,3,34576,34576,34579,0,3,0
9825,5,1,34581,34581,34582,0,1,2
9826,6,3,34587,34587,34590,0,3,5
9827,5,1,34592,34592,34593,0,1,2
9828,3,1,34595,34595,34596,0,1,2
9829,2,3,34597,34597,34600,0,3,1
9830,2,2,34599,34600,34602,1,3,0
9831,3,1,34602,34602,34603,0,1,0
9832,6,1,34608,34608,34609,0,1,5
9833,1,2,34609,34609,34611,0,2,0
9834,3,2,34612,34612,34614,0,2,1
9835,4,3,34616,34616,34619,0,3,2
9836,3,2,34619,34619,34621,0,2,0
9837,3,1,34622,34622,34623,0,1,1
9838,3,1,34625,34625,34626,0,1,2
9839,1,2,34626,34626,34628,0,2,0
9840,3,2,34629,34629,34631,0,2,1
9841,1,3,34630,34631,34634,1,4,0
9842,3,2,34633,34634,34636,1,3,0
9843,4,3,34637,34637,34640,0,3,1
9844,2,1,34639,34640,34641,1,2,0
9845,2,2,34641,34641,34643,0,2,0
9846,4,1,34645,34645,34646,0,1,2
9847,1,2,34646,34646,34648,0,2,0
9848,5,1,34651,34651,34652,0,1,3
9849,6,1,34657,34657,34658,0,1,5
9850,1,1,34658,34658,34659,0,1,0
9851,6,3,34664,34664,34667,0,3,5
9852,2,2,34666,34667,34669,1,3,0
9853,2,1,34668,34669,34670,1,2,0
9854,6,1,34674,34674,34675,0,1,4
9855,6,2,34680,34680,34682,0,2,5
9856,1,2,34681,34682,34684,1,3,0
9857,1,2,34682,34684,34686,2,4,0
9858,5,2,34687,34687,34689,0,2,1
9859,6,3,34693,34693,34696,0,3,4
9860,5,3,34698,34698,34701,0,3,2
9861,1,2,34699,34701,34703,2,4,0
9862,2,3,34701,34703,34706,2,5,0
9863,6,3,34707,34707,34710,0,3,1
9864,5,3,34712,34712,34715,0,3,2
9865,1,2,34713,34715,34717,2,4,0
9866,6,2,34719,34719,34721,0,2,2
9867,1,1,34720,34721,34722,1,2,0
9868,5,3,34725,34725,34728,0,3,3
9869,5,3,34730,34730,34733,0,3,2
9870,2,3,34732,34733,34736,1,4,0
9871,1,3,34733,34736,34739,3,6,0
9872,3,1,34736,34739,34740,3,4,0
9873,1,1,34737,34740,34741,3,4,0
9874,1,3,34738,34741,34744,3,6,0
9875,3,2,34741,34744,34746,3,5,0
9876,2,2,34743,34746,34748,3,5,0
9877,4,1,34747,34748,34749,1,2,0
9878,4,1,34751,34751,34752,0,1,2
9879,5,1,34756,34756,34757,0,1,4
9880,3,1,34759,34759,34760,0,1,2
9881,1,3,34760,34760,34763,0,3,0
9882,5,2,34765,34765,34767,0,2,2
9883,3,2,34768,34768,34770,0,2,1
9884,1,3,34769,34770,34773,1,4,0
9885,5,2,34774,34774,34776,0,2,1
9886,5,1,34779,34779,34780,0,1,3
9887,2,2,34781,34781,34783,0,2,1
9888,2,1,34783,34783,34784,0,1,0
9889,2,1,34785,34785,34786,0,1,1
9890,6,2,34791,34791,34793,0,2,5
9891,6,1,34797,34797,34798,0,1,4
9892,2,1,34799,34799,34800,0,1,1
9893,1,1,34800,34800,34801,0,1,0
9894,1,2,34801,34801,34803,0,2,0
9895,5,2,34806,34806,34808,0,2,3
9896,2,2,34808,34808,34810,0,2,0
9897,1,2,34809,34810,34812,1,3,0
9898,2,3,34811,34812,34815,1,4,0
9899,6,3,34817,34817,34820,0,3,2
9900,2,1,34819,34820,34821,1,2,0
9901,3,1,34822,34822,34823,0,1,1
9902,1,3,34823,34823,34826,0,3,0
9903,6,2,34829,34829,34831,0,2,3
9904,3,1,34832,34832,34833,0,1,1
9905,1,3,34833,34833,34836,0,3,0
9906,2,1,34835,34836,34837,1,2,0
9907,2,3,34837,34837,34840,0,3,0
9908,3,2,34840,34840,34842,0,2,0
9909,1,2,34841,34842,34844,1,3,0
9910,4,2,34845,34845,34847,0,2,1
9911,4,1,34849,34849,34850,0,1,2
9912,5,2,34854,34854,34856,0,2,4
9913,5,2,34859,34859,34861,0,2,3
9914,1,2,34860,34861,34863,1,3,0
9915,3,1,34863,34863,34864,0,1,0
9916,2,2,34865,34865,34867,0,2,1
9917,1,2,34866,34867,34869,1,3,0
9918,6,3,34872,34872,34875,0,3,3
9919,3,1,34875,34875,34876,0,1,0
9920,1,3,34876,34876,34879,0,3,0
9921,3,2,34879,34879,34881,0,2,0
9922,3,2,34882,34882,34884,0,2,1
9923,6,2,34888,34888,34890,0,2,4
9924,6,3,34894,34894,34897,0,3,4
9925,3,3,34897,34897,34900,0,3,0
9926,4,1,34901,34901,34902,0,1,1
9927,2,1,34903,34903,34904,0,1,1
9928,5,3,34908,34908,34911,0,3,4
9929,1,2,34909,34911,34913,2,4,0
9930,1,1,34910,34913,34914,3,4,0
9931,5,2,34915,34915,34917,0,2,1
9932,2,1,34917,34917,34918,0,1,0
9933,1,3,34918,34918,34921,0,3,0
9934,1,3,34919,34921,34924,2,5,0
9935,2,1,34921,34924,34925,3,4,0
9936,2,1,34923,34925,34926,2,3,0
9937,2,1,34925,34926,34927,1,2,0
9938,3,1,34928,34928,34929,0,1,1
9939,2,3,34930,34930,34933,0,3,1
9940,5,3,34935,34935,34938,0,3,2
9941,3,2,34938,34938,34940,0,2,0
9942,5,1,34943,34943,34944,0,1,3
9943,1,3,34944,34944,34947,0,3,0
9944,5,1,34949,34949,34950,0,1,2
9945,3,1,34952,34952,34953,0,1,2
9946,5,2,34957,34957,34959,0,2,4
9947,2,1,34959,34959,34960,0,1,0
9948,2,3,34961,34961,34964,0,3,1
9949,1,2,34962,34964,34966,2,4,0
9950,1,1,34963,34966,34967,3,4,0
9951,1,1,34964,34967,34968,3,4,0
9952,6,2,34970,34970,34972,0,2,2
9953,3,2,34973,34973,34975,0,2,1
9954,4,3,34977,34977,34980,0,3,2
9955,5,3,34982,34982,34985,0,3,2
9956,4,1,34986,34986,34987,0,1,1
9957,6,2,34992,34992,34994,0,2,5
9958,1,2,34993,34994,34996,1,3,0
9959,4,2,34997,34997,34999,0,2,1
9960,3,2,35000,35000,35002,0,2,1
9961,2,1,35002,35002,35003,0,1,0
9962,5,2,35007,35007,35009,0,2,4
9963,3,3,35010,35010,35013,0,3,1
9964,3,1,35013,35013,35014,0,1,0
9965,4,2,35017,35017,35019,0,2,3
9966,2,1,35019,35019,35020,0,1,0
9967,4,3,35023,35023,35026,0,3,3
9968,6,1,35029,35029,35030,0,1,3
9969,4,1,35033,35033,35034,0,1,3
9970,3,2,35036,35036,35038,0,2,2
9971,6,3,35042,35042,35045,0,3,4
9972,1,2,35043,35045,35047,2,4,0
9973,4,2,35047,35047,35049,0,2,0
9974,2,3,35049,35049,35052,0,3,0
9975,2,2,35051,35052,35054,1,3,0
9976,4,2,35055,35055,35057,0,2,1
9977,5,1,35060,35060,35061,0,1,3
9978,4,2,35064,35064,35066,0,2,3
9979,1,2,35065,35066,35068,1,3,0
9980,3,1,35068,35068,35069,0,1,0
9981,4,1,35072,35072,35073,0,1,3
9982,6,1,35078,35078,35079,0,1,5
9983,6,3,35084,35084,35087,0,3,5
9984,6,3,35090,35090,35093,0,3,3
9985,5,2,35095,35095,35097,0,2,2
9986,5,1,35100,35100,35101,0,1,3
9987,6,1,35106,35106,35107,0,1,5
9988,2,1,35108,35108,35109,0,1,1
9989,2,1,35110,35110,35111,0,1,1
9990,3,2,35113,35113,35115,0,2,2
9991,6,1,35119,35119,35120,0,1,4
9992,6,2,35125,35125,35127,0,2,5
9993,4,1,35129,35129,35130,0,1,2
9994,5,1,35134,35134,35135,0,1,4
9995,6,2,35140,35140,35142,0,2,5
9996,5,3,35145,35145,35148,0,3,3
9997,2,1,35147,35148,35149,1,2,0
9998,5,1,35152,35152,35153,0,1,3
9999,4,2,35156,35156,35158,0,2,3
10000,5,1,35161,35161,35162,0,1,3
10001,3,2,35164,35164,35166,0,2,2
10002,6,3,35170,35170,35173,0,3,4
10003,2,2,35172,35173,35175,1,3,0
10004,3,2,35175,35175,35177,0,2,0
10005,2,1,35177,35177,35178,0,1,0
10006,4,3,35181,35181,35184,0,3,3
10007,1,1,35182,35184,35185,2,3,0
10008,6,1,35188,35188,35189,0,1,3
10009,3,3,35191,35191,35194,0,3,2
10010,2,1,35193,35194,35195,1,2,0
10011,5,1,35198,35198,35199,0,1,3
10012,6,2,35204,35204,35206,0,2,5
10013,3,2,35207,35207,35209,0,2,1
10014,2,2,35209,35209,35211,0,2,0
10015,1,2,35210,35211,35213,1,3,0
10016,3,1,35213,35213,35214,0,1,0
10017,6,2,35219,35219,35221,0,2,5
10018,3,1,35222,35222,35223,0,1,1
10019,5,3,35227,35227,35230,0,3,4
10020,4,3,35231,35231,35234,0,3,1
10021,2,3,35233,35234,35237,1,4,0
10022,3,1,35236,35237,35238,1,2,0
10023,6,1,35242,35242,35243,0,1,4
10024,1,2,35243,35243,35245,0,2,0
10025,1,3,35244,35245,35248,1,4,0
10026,2,3,35246,35248,35251,2,5,0
10027,1,2,35247,35251,35253,4,6,0
10028,2,1,35249,35253,35254,4,5,0
10029,4,2,35253,35254,35256,1,3,0
10030,4,3,35257,35257,35260,0,3,1
10031,6,3,35263,35263,35266,0,3,3
10032,1,1,35264,35266,35267,2,3,0
10033,6,1,35270,35270,35271,0,1,3
10034,6,1,35276,35276,35277,0,1,5
10035,4,3,35280,35280,35283,0,3,3
10036,2,2,35282,35283,35285,1,3,0
10037,2,3,35284,35285,35288,1,4,0
10038,2,2,35286,35288,35290,2,4,0
10039,4,2,35290,35290,35292,0,2,0
10040,6,3,35296,35296,35299,0,3,4
10041,6,3,35302,35302,35305,0,3,3
10042,5,3,35307,35307,35310,0,3,2
10043,1,1,35308,35310,35311,2,3,0
10044,1,2,35309,35311,35313,2,4,0
10045,2,3,35311,35313,35316,2,5,0
10046,3,1,35314,35316,35317,2,3,0
10047,2,3,35316,35317,35320,1,4,0
10048,4,3,35320,35320,35323,0,3,0
10049,6,1,35326,35326,35327,0,1,3
10050,1,1,35327,35327,35328,0,1,0
10051,2,2,35329,35329,35331,0,2,1
10052,2,1,35331,35331,35332,0,1,0
10053,5,3,35336,35336,35339,0,3,4
10054,5,3,35341,35341,35344,0,3,2
10055,2,2,35343,35344,35346,1,3,0
10056,2,3,35345,35346,35349,1,4,0
10057,5,3,35350,35350,35353,0,3,1
10058,1,3,35351,35353,35356,2,5,0
10059,4,3,35355,35356,35359,1,4,0
10060,2,2,35357,35359,35361,2,4,0
10061,2,2,35359,35361,35363,2,4,0
10062,2,1,35361,35363,35364,2,3,0
10063,6,1,35367,35367,35368,0,1,3
10064,4,2,35371,35371,35373,0,2,3
10065,4,3,35375,35375,35378,0,3,2
10066,4,2,35379,35379,35381,0,2,1
10067,5,2,35384,35384,35386,0,2,3
10068,2,3,35386,35386,35389,0,3,0
10069,4,1,35390,35390,35391,0,1,1
10070,5,3,35395,35395,35398,0,3,4
10071,2,3,35397,35398,35401,1,4,0
10072,2,3,35399,35401,35404,2,5,0
10073,2,3,35401,35404,35407,3,6,0
10074,6,1,35407,35407,35408,0,1,0
10075,4,2,35411,35411,35413,0,2,3
10076,2,3,35413,35413,35416,0,3,0
10077,1,2,35414,35416,35418,2,4,0
10078,5,2,35419,35419,35421,0,2,1
10079,6,2,35425,35425,35427,0,2,4
10080,6,1,35431,35431,35432,0,1,4
10081,4,3,35435,35435,35438,0,3,3
10082,5,3,35440,35440,35443,0,3,2
10083,3,2,35443,35443,35445,0,2,0
10084,3,3,35446,35446,35449,0,3,1
10085,6,3,35452,35452,35455,0,3,3
10086,3,2,35455,35455,35457,0,2,0
10087,3,1,35458,35458,35459,0,1,1
10088,6,3,35464,35464,35467,0,3,5
10089,1,3,35465,35467,35470,2,5,0
10090,5,2,35470,35470,35472,0,2,0
10091,6,1,35476,35476,35477,0,1,4
10092,1,3,35477,35477,35480,0,3,0
10093,3,3,35480,35480,35483,0,3,0
10094,1,2,35481,35483,35485,2,4,0
10095,6,1,35487,35487,35488,0,1,2
10096,3,3,35490,35490,35493,0,3,2
10097,2,1,35492,35493,35494,1,2,0
10098,6,3,35498,35498,35501,0,3,4
10099,1,1,35499,35501,35502,2,3,0
10100,5,3,35504,35504,35507,0,3,2
10101,4,2,35508,35508,35510,0,2,1
10102,4,2,35512,35512,35514,0,2,2
10103,4,2,35516,35516,35518,0,2,2
10104,1,1,35517,35518,35519,1,2,0
10105,4,1,35521,35521,35522,0,1,2
10106,4,3,35525,35525,35528,0,3,3
10107,6,2,35531,35531,35533,0,2,3
10108,1,3,35532,35533,35536,1,4,0
10109,1,2,35533,35536,35538,3,5,0
10110,1,2,35534,35538,35540,4,6,0
10111,5,2,35539,35540,35542,1,3,0
10112,5,1,35544,35544,35545,0,1,2
10113,6,2,35550,35550,35552,0,2,5
10114,5,3,35555,35555,35558,0,3,3
10115,4,1,35559,35559,35560,0,1,1
10116,5,3,35564,35564,35567,0,3,4
10117,6,2,35570,35570,35572,0,2,3
10118,2,2,35572,35572,35574,0,2,0
10119,2,1,35574,35574,35575,0,1,0
10120,1,3,35575,35575,35578,0,3,0
10121,2,3,35577,35578,35581,1,4,0
10122,5,2,35582,35582,35584,0,2,1
10123,4,3,35586,35586,35589,0,3,2
10124,2,2,35588,35589,35591,1,3,0
10125,5,3,35593,35593,35596,0,3,2
10126,5,1,35598,35598,35599,0,1,2
10127,2,1,35600,35600,35601,0,1,1
10128,6,3,35606,35606,35609,0,3,5
10129,5,2,35611,35611,35613,0,2,2
10130,6,1,35617,35617,35618,0,1,4
10131,5,3,35622,35622,35625,0,3,4
10132,6,3,35628,35628,35631,0,3,3
10133,4,1,35632,35632,35633,0,1,1
10134,3,2,35635,35635,35637,0,2,2
10135,3,3,35638,35638,35641,0,3,1
10136,5,3,35643,35643,35646,0,3,2
10137,4,3,35647,35647,35650,0,3,1
10138,1,3,35648,35650,35653,2,5,0
10139,4,2,35652,35653,35655,1,3,0
10140,3,1,35655,35655,35656,0,1,0
10141,4,1,35659,35659,35660,0,1,3
10142,5,2,35664,35664,35666,0,2,4
10143,1,1,35665,35666,35667,1,2,0
10144,4,1,35669,35669,35670,0,1,2
10145,6,2,35675,35675,35677,0,2,5
10146,1,2,35676,35677,35679,1,3,0
10147,4,3,35680,35680,35683,0,3,1
10148,1,3,35681,35683,35686,2,5,0
10149,2,1,35683,35686,35687,3,4,0
10150,1,3,35684,35687,35690,3,6,0
10151,6,1,35690,35690,35691,0,1,0
10152,4,2,35694,35694,35696,0,2,3
10153,3,3,35697,35697,35700,0,3,1
10154,1,3,35698,35700,35703,2,5,0
10155,4,3,35702,35703,35706,1,4,0
10156,4,2,35706,35706,35708,0,2,0
10157,4,2,35710,35710,35712,0,2,2
10158,1,2,35711,35712,35714,1,3,0
10159,5,2,35716,35716,35718,0,2,2
10160,4,3,35720,35720,35723,0,3,2
10161,5,2,35725,35725,35727,0,2,2
10162,4,2,35729,35729,35731,0,2,2
10163,1,1,35730,35731,35732,1,2,0
10164,1,1,35731,35732,35733,1,2,0
10165,6,2,35737,35737,35739,0,2,4
10166,1,1,35738,35739,35740,1,2,0
10167,5,2,35743,35743,35745,0,2,3
10168,2,1,35745,35745,35746,0,1,0
10169,2,3,35747,35747,35750,0,3,1
10170,4,2,35751,35751,35753,0,2,1
10171,2,1,35753,35753,35754,0,1,0
10172,1,1,35754,35754,35755,0,1,0
10173,2,3,35756,35756,35759,0,3,1
10174,6,2,35762,35762,35764,0,2,3
10175,2,3,35764,35764,35767,0,3,0
10176,4,1,35768,35768,35769,0,1,1
10177,4,2,35772,35772,35774,0,2,3
10178,2,2,35774,35774,35776,0,2,0
10179,1,3,35775,35776,35779,1,4,0
10180,3,2,35778,35779,35781,1,3,0
10181,5,1,35783,35783,35784,0,1,2
10182,4,1,35787,35787,35788,0,1,3
10183,5,2,35792,35792,35794,0,2,4
10184,6,3,35798,35798,35801,0,3,4
10185,6,1,35804,35804,35805,0,1,3
10186,2,1,35806,35806,35807,0,1,1
10187,6,2,35812,35812,35814,0,2,5
10188,3,2,35815,35815,35817,0,2,1
10189,4,1,35819,35819,35820,0,1,2
10190,5,2,35824,35824,35826,0,2,4
10191,2,1,35826,35826,35827,0,1,0
10192,2,2,35828,35828,35830,0,2,1
10193,6,3,35834,35834,35837,0,3,4
10194,2,1,35836,35837,35838,1,2,0
10195,3,3,35839,35839,35842,0,3,1
10196,1,2,35840,35842,35844,2,4,0
10197,3,2,35843,35844,35846,1,3,0
10198,5,2,35848,35848,35850,0,2,2
10199,3,3,35851,35851,35854,0,3,1
10200,1,3,35852,35854,35857,2,5,0
10201,3,3,35855,35857,35860,2,5,0
10202,6,1,35861,35861,35862,0,1,1
10203,4,1,35865,35865,35866,0,1,3
10204,1,2,35866,35866,35868,0,2,0
10205,6,3,35872,35872,35875,0,3,4
10206,3,3,35875,35875,35878,0,3,0
10207,1,3,35876,35878,35881,2,5,0
10208,1,1,35877,35881,35882,4,5,0
10209,3,2,35880,35882,35884,2,4,0
10210,5,3,35885,35885,35888,0,3,1
10211,6,2,35891,35891,35893,0,2,3
10212,3,3,35894,35894,35897,0,3,1
10213,3,1,35897,35897,35898,0,1,0
10214,4,3,35901,35901,35904,0,3,3
10215,3,3,35904,35904,35907,0,3,0
10216,3,2,35907,35907,35909,0,2,0
10217,6,1,35913,35913,35914,0,1,4
10218,3,3,35916,35916,35919,0,3,2
10219,1,3,35917,35919,35922,2,5,0
10220,2,3,35919,35922,35925,3,6,0
10221,6,1,35925,35925,35926,0,1,0
10222,3,2,35928,35928,35930,0,2,2
10223,4,1,35932,35932,35933,0,1,2
10224,6,3,35938,35938,35941,0,3,5
10225,3,3,35941,35941,35944,0,3,0
10226,1,3,35942,35944,35947,2,5,0
10227,4,2,35946,35947,35949,1,3,0
10228,3,1,35949,35949,35950,0,1,0
10229,1,3,35950,35950,35953,0,3,0
10230,2,2,35952,35953,35955,1,3,0
10231,3,1,35955,35955,35956,0,1,0
10232,1,1,35956,35956,35957,0,1,0
10233,6,2,35962,35962,35964,0,2,5
10234,4,1,35966,35966,35967,0,1,2
10235,1,3,35967,35967,35970,0,3,0
10236,6,2,35973,35973,35975,0,2,3
10237,3,1,35976,35976,35977,0,1,1
10238,2,2,35978,35978,35980,0,2,1
10239,1,1,35979,35980,35981,1,2,0
10240,6,3,35985,35985,35988,0,3,4
10241,1,1,35986,35988,35989,2,3,0
10242,3,3,35989,35989,35992,0,3,0
10243,4,1,35993,35993,35994,0,1,1
10244,4,3,35997,35997,36000,0,3,3
10245,2,1,35999,36000,36001,1,2,0
10246,4,3,36003,36003,36006,0,3,2
10247,4,2,36007,36007,36009,0,2,1
10248,2,3,36009,36009,36012,0,3,0
10249,2,2,36011,36012,36014,1,3,0
10250,5,2,36016,36016,36018,0,2,2
10251,5,2,36021,36021,36023,0,2,3
10252,2,3,36023,36023,36026,0,3,0
10253,1,3,36024,36026,36029,2,5,0
10254,2,2,36026,36029,36031,3,5,0
10255,2,2,36028,36031,36033,3,5,0
10256,1,3,36029,36033,36036,4,7,0
10257,4,2,36033,36036,36038,3,5,0
10258,3,3,36036,36038,36041,2,5,0
10259,5,1,36041,36041,36042,0,1,0
10260,1,2,36042,36042,36044,0,2,0
10261,1,1,36043,36044,36045,1,2,0
10262,3,2,36046,36046,36048,0,2,1
10263,2,2,36048,36048,36050,0,2,0
10264,1,1,36049,36050,36051,1,2,0
10265,6,1,36055,36055,36056,0,1,4
10266,6,1,36061,36061,36062,0,1,5
10267,3,2,36064,36064,36066,0,2,2
10268,3,1,36067,36067,36068,0,1,1
10269,4,2,36071,36071,36073,0,2,3
10270,1,3,36072,36073,36076,1,4,0
10271,5,1,36077,36077,36078,0,1,1
10272,3,3,36080,36080,36083,0,3,2
10273,5,3,36085,36085,36088,0,3,2
10274,2,3,36087,36088,36091,1,4,0
10275,1,2,36088,36091,36093,3,5,0
10276,1,1,36089,36093,36094,4,5,0
10277,1,2,36090,36094,36096,4,6,0
10278,3,3,36093,36096,36099,3,6,0
10279,3,1,36096,36099,36100,3,4,0
10280,1,3,36097,36100,36103,3,6,0
10281,4,3,36101,36103,36106,2,5,0
10282,5,1,36106,36106,36107,0,1,0
10283,1,3,36107,36107,36110,0,3,0
10284,2,1,36109,36110,36111,1,2,0
10285,3,3,36112,36112,36115,0,3,1
10286,2,2,36114,36115,36117,1,3,0
10287,4,3,36118,36118,36121,0,3,1
10288,1,3,36119,36121,36124,2,5,0
10289,2,3,36121,36124,36127,3,6,0
10290,2,3,36123,36127,36130,4,7,0
10291,5,1,36128,36130,36131,2,3,0
10292,5,3,36133,36133,36136,0,3,2
10293,5,2,36138,36138,36140,0,2,2
10294,5,3,36143,36143,36146,0,3,3
10295,5,1,36148,36148,36149,0,1,2
10296,4,1,36152,36152,36153,0,1,3
10297,2,2,36154,36154,36156,0,2,1
10298,5,2,36159,36159,36161,0,2,3
10299,6,2,36165,36165,36167,0,2,4
10300,2,2,36167,36167,36169,0,2,0
10301,1,2,36168,36169,36171,1,3,0
10302,2,3,36170,36171,36174,1,4,0
10303,2,3,36172,36174,36177,2,5,0
10304,1,3,36173,36177,36180,4,7,0
10305,2,2,36175,36180,36182,5,7,0
10306,3,1,36178,36182,36183,4,5,0
10307,3,1,36181,36183,36184,2,3,0
10308,2,2,36183,36184,36186,1,3,0
10309,4,1,36187,36187,36188,0,1,1
10310,4,3,36191,36191,36194,0,3,3
10311,3,2,36194,36194,36196,0,2,0
10312,4,1,36198,36198,36199,0,1,2
10313,2,1,36200,36200,36201,0,1,1
10314,3,1,36203,36203,36204,0,1,2
10315,4,2,36207,36207,36209,0,2,3
10316,4,2,36211,36211,36213,0,2,2
10317,2,3,36213,36213,36216,0,3,0
10318,3,3,36216,36216,36219,0,3,0
10319,5,3,36221,36221,36224,0,3,2
10320,2,2,36223,36224,36226,1,3,0
10321,1,1,36224,36226,36227,2,3,0
10322,3,1,36227,36227,36228,0,1,0
10323,2,2,36229,36229,36231,0,2,1
10324,5,1,36234,36234,36235,0,1,3
10325,1,2,36235,36235,36237,0,2,0
10326,4,1,36239,36239,36240,0,1,2
10327,6,2,36245,36245,36247,0,2,5
10328,6,1,36251,36251,36252,0,1,4
10329,5,2,36256,36256,36258,0,2,4
10330,1,1,36257,36258,36259,1,2,0
10331,1,1,36258,36259,36260,1,2,0
10332,2,2,36260,36260,36262,0,2,0
10333,1,2,36261,36262,36264,1,3,0
10334,2,2,36263,36264,36266,1,3,0
10335,5,3,36268,36268,36271,0,3,2
10336,5,2,36273,36273,36275,0,2,2
10337,3,1,36276,36276,36277,0,1,1
10338,2,3,36278,36278,36281,0,3,1
10339,2,3,36280,36281,36284,1,4,0
10340,6,2,36286,36286,36288,0,2,2
10341,4,3,36290,36290,36293,0,3,2
10342,3,3,36293,36293,36296,0,3,0
10343,5,2,36298,36298,36300,0,2,2
10344,5,1,36303,36303,36304,0,1,3
10345,1,3,36304,36304,36307,0,3,0
10346,3,2,36307,36307,36309,0,2,0
10347,2,2,36309,36309,36311,0,2,0
10348,3,1,36312,36312,36313,0,1,1
10349,4,3,36316,36316,36319,0,3,3
10350,3,3,36319,36319,36322,0,3,0
10351,5,2,36324,36324,36326,0,2,2
10352,1,1,36325,36326,36327,1,2,0
10353,6,3,36331,36331,36334,0,3,4
10354,1,1,36332,36334,36335,2,3,0
10355,2,1,36334,36335,36336,1,2,0
10356,3,1,36337,36337,36338,0,1,1
10357,1,3,36338,36338,36341,0,3,0
10358,5,2,36343,36343,36345,0,2,2
10359,1,3,36344,36345,36348,1,4,0
10360,6,3,36350,36350,36353,0,3,2
10361,3,2,36353,36353,36355,0,2,0
10362,3,1,36356,36356,36357,0,1,1
10363,1,3,36357,36357,36360,0,3,0
10364,5,3,36362,36362,36365,0,3,2
10365,3,2,36365,36365,36367,0,2,0
10366,5,3,36370,36370,36373,0,3,3
10367,2,1,36372,36373,36374,1,2,0
10368,2,3,36374,36374,36377,0,3,0
10369,4,1,36378,36378,36379,0,1,1
10370,3,2,36381,36381,36383,0,2,2
10371,1,2,36382,36383,36385,1,3,0
10372,1,3,36383,36385,36388,2,5,0
10373,3,1,36386,36388,36389,2,3,0
10374,3,3,36389,36389,36392,0,3,0
10375,4,1,36393,36393,36394,0,1,1
10376,3,1,36396,36396,36397,0,1,2
10377,4,1,36400,36400,36401,0,1,3
10378,1,1,36401,36401,36402,0,1,0
10379,3,2,36404,36404,36406,0,2,2
10380,6,3,36410,36410,36413,0,3,4
10381,4,2,36414,36414,36416,0,2,1
10382,4,1,36418,36418,36419,0,1,2
10383,6,1,36424,36424,36425,0,1,5
10384,2,1,36426,36426,36427,0,1,1
10385,1,3,36427,36427,36430,0,3,0
10386,4,3,36431,36431,36434,0,3,1
10387,4,3,36435,36435,36438,0,3,1
10388,3,2,36438,36438,36440,0,2,0
10389,1,2,36439,36440,36442,1,3,0
10390,4,1,36443,36443,36444,0,1,1
10391,6,1,36449,36449,36450,0,1,5
10392,2,1,36451,36451,36452,0,1,1
10393,1,2,36452,36452,36454,0,2,0
10394,1,2,36453,36454,36456,1,3,0
10395,3,3,36456,36456,36459,0,3,0
10396,2,2,36458,36459,36461,1,3,0
10397,1,3,36459,36461,36464,2,5,0
10398,1,2,36460,36464,36466,4,6,0
10399,4,3,36464,36466,36469,2,5,0
10400,5,3,36469,36469,36472,0,3,0
10401,4,2,36473,36473,36475,0,2,1
10402,5,2,36478,36478,36480,0,2,3
10403,4,3,36482,36482,36485,0,3,2
10404,3,1,36485,36485,36486,0,1,0
10405,6,2,36491,36491,36493,0,2,5
10406,6,2,36497,36497,36499,0,2,4
10407,1,2,36498,36499,36501,1,3,0
10408,5,2,36503,36503,36505,0,2,2
10409,3,3,36506,36506,36509,0,3,1
10410,1,2,36507,36509,36511,2,4,0
10411,2,3,36509,36511,36514,2,5,0
10412,6,2,36515,36515,36517,0,2,1
10413,4,3,36519,36519,36522,0,3,2
10414,3,1,36522,36522,36523,0,1,0
10415,6,3,36528,36528,36531,0,3,5
10416,4,2,36532,36532,36534,0,2,1
10417,4,2,36536,36536,36538,0,2,2
10418,1,3,36537,36538,36541,1,4,0
10419,2,1,36539,36541,36542,2,3,0
10420,4,1,36543,36543,36544,0,1,1
10421,3,3,36546,36546,36549,0,3,2
10422,6,3,36552,36552,36555,0,3,3
10423,4,3,36556,36556,36559,0,3,1
10424,4,3,36560,36560,36563,0,3,1
10425,3,1,36563,36563,36564,0,1,0
10426,2,1,36565,36565,36566,0,1,1
10427,3,3,36568,36568,36571,0,3,2
10428,1,3,36569,36571,36574,2,5,0
10429,3,1,36572,36574,36575,2,3,0
10430,3,1,36575,36575,36576,0,1,0
10431,3,3,36578,36578,36581,0,3,2
10432,4,3,36582,36582,36585,0,3,1
10433,6,1,36588,36588,36589,0,1,3
10434,1,2,36589,36589,36591,0,2,0
10435,5,1,36594,36594,36595,0,1,3
10436,4,2,36598,36598,36600,0,2,3
10437,3,2,36601,36601,36603,0,2,1
10438,4,1,36605,36605,36606,0,1,2
10439,1,3,36606,36606,36609,0,3,0
10440,6,2,36612,36612,36614,0,2,3
10441,4,1,36616,36616,36617,0,1,2
10442,6,3,36622,36622,36625,0,3,5
10443,6,3,36628,36628,36631,0,3,3
10444,5,2,36633,36633,36635,0,2,2
10445,6,3,36639,36639,36642,0,3,4
10446,1,1,36640,36642,36643,2,3,0
10447,2,2,36642,36643,36645,1,3,0
10448,5,3,36647,36647,36650,0,3,2
10449,2,1,36649,36650,36651,1,2,0
10450,1,3,36650,36651,36654,1,4,0
10451,5,2,36655,36655,36657,0,2,1
10452,5,3,36660,36660,36663,0,3,3
10453,4,3,36664,36664,36667,0,3,1
10454,2,1,36666,36667,36668,1,2,0
10455,1,1,36667,36668,36669,1,2,0
10456,2,3,36669,36669,36672,0,3,0
10457,5,1,36674,36674,36675,0,1,2
10458,2,2,36676,36676,36678,0,2,1
10459,1,3,36677,36678,36681,1,4,0
10460,1,1,36678,36681,36682,3,4,0
10461,4,2,36682,36682,36684,0,2,0
10462,4,1,36686,36686,36687,0,1,2
10463,1,1,36687,36687,36688,0,1,0
10464,5,3,36692,36692,36695,0,3,4
10465,6,1,36698,36698,36699,0,1,3
10466,4,2,36702,36702,36704,0,2,3
10467,3,3,36705,36705,36708,0,3,1
10468,4,3,36709,36709,36712,0,3,1
10469,3,3,36712,36712,36715,0,3,0
10470,3,3,36715,36715,36718,0,3,0
10471,6,1,36721,36721,36722,0,1,3
10472,6,3,36727,36727,36730,0,3,5
10473,3,2,36730,36730,36732,0,2,0
10474,6,3,36736,36736,36739,0,3,4
10475,1,2,36737,36739,36741,2,4,0
10476,6,3,36743,36743,36746,0,3,2
10477,4,1,36747,36747,36748,0,1,1
10478,2,3,36749,36749,36752,0,3,1
10479,4,3,36753,36753,36756,0,3,1
10480,3,1,36756,36756,36757,0,1,0
10481,6,2,36762,36762,36764,0,2,5
10482,6,3,36768,36768,36771,0,3,4
10483,6,1,36774,36774,36775,0,1,3
10484,4,3,36778,36778,36781,0,3,3
10485,1,3,36779,36781,36784,2,5,0
10486,6,2,36785,36785,36787,0,2,1
10487,2,3,36787,36787,36790,0,3,0
10488,4,2,36791,36791,36793,0,2,1
10489,6,3,36797,36797,36800,0,3,4
10490,6,3,36803,36803,36806,0,3,3
10491,4,2,36807,36807,36809,0,2,1
10492,3,1,36810,36810,36811,0,1,1
10493,3,1,36813,36813,36814,0,1,2
10494,4,3,36817,36817,36820,0,3,3
10495,1,1,36818,36820,36821,2,3,0
10496,5,3,36823,36823,36826,0,3,2
10497,3,2,36826,36826,36828,0,2,0
10498,3,1,36829,36829,36830,0,1,1
10499,4,1,36833,36833,36834,0,1,3
10500,3,3,36836,36836,36839,0,3,2
10501,1,2,36837,36839,36841,2,4,0
10502,5,1,36842,36842,36843,0,1,1
10503,6,2,36848,36848,36850,0,2,5
10504,3,1,36851,36851,36852,0,1,1
10505,6,1,36857,36857,36858,0,1,5
10506,3,3,36860,36860,36863,0,3,2
10507,6,1,36866,36866,36867,0,1,3
10508,4,2,36870,36870,36872,0,2,3
10509,5,3,36875,36875,36878,0,3,3
10510,2,2,36877,36878,36880,1,3,0
10511,4,2,36881,36881,36883,0,2,1
10512,4,2,36885,36885,36887,0,2,2
10513,3,3,36888,36888,36891,0,3,1
10514,1,1,36889,36891,36892,2,3,0
10515,3,3,36892,36892,36895,0,3,0
10516,3,1,36895,36895,36896,0,1,0
10517,2,3,36897,36897,36900,0,3,1
10518,1,3,36898,36900,36903,2,5,0
10519,2,2,36900,36903,36905,3,5,0
10520,2,2,36902,36905,36907,3,5,0
10521,1,2,36903,36907,36909,4,6,0
10522,6,1,36909,36909,36910,0,1,0
10523,3,1,36912,36912,36913,0,1,2
10524,6,1,36918,36918,36919,0,1,5
10525,6,3,36924,36924,36927,0,3,5
10526,2,3,36926,36927,36930,1,4,0
10527,6,1,36932,36932,36933,0,1,2
10528,4,2,36936,36936,36938,0,2,3
10529,3,2,36939,36939,36941,0,2,1
10530,1,1,36940,36941,36942,1,2,0
10531,4,3,36944,36944,36947,0,3,2
10532,6,3,36950,36950,36953,0,3,3
10533,4,1,36954,36954,36955,0,1,1
10534,6,1,36960,36960,36961,0,1,5
10535,6,3,36966,36966,36969,0,3,5
10536,1,1,36967,36969,36970,2,3,0
10537,4,3,36971,36971,36974,0,3,1
10538,4,1,36975,36975,36976,0,1,1
10539,4,1,36979,36979,36980,0,1,3
10540,6,3,36985,36985,36988,0,3,5
10541,4,3,36989,36989,36992,0,3,1
10542,4,1,36993,36993,36994,0,1,1
10543,1,2,36994,36994,36996,0,2,0
10544,6,2,37000,37000,37002,0,2,4
10545,3,1,37003,37003,37004,0,1,1
10546,4,3,37007,37007,37010,0,3,3
10547,5,1,37012,37012,37013,0,1,2
10548,5,2,37017,37017,37019,0,2,4
10549,5,3,37022,37022,37025,0,3,3
10550,3,1,37025,37025,37026,0,1,0
10551,2,2,37027,37027,37029,0,2,1
10552,3,1,37030,37030,37031,0,1,1
10553,5,3,37035,37035,37038,0,3,4
10554,6,1,37041,37041,37042,0,1,3
10555,3,2,37044,37044,37046,0,2,2
10556,2,1,37046,37046,37047,0,1,0
10557,1,1,37047,37047,37048,0,1,0
10558,6,2,37053,37053,37055,0,2,5
10559,4,1,37057,37057,37058,0,1,2
10560,6,3,37063,37063,37066,0,3,5
10561,2,2,37065,37066,37068,1,3,0
10562,5,3,37070,37070,37073,0,3,2
10563,1,2,37071,37073,37075,2,4,0
10564,3,2,37074,37075,37077,1,3,0
10565,3,2,37077,37077,37079,0,2,0
10566,4,2,37081,37081,37083,0,2,2
10567,5,3,37086,37086,37089,0,3,3
10568,2,3,37088,37089,37092,1,4,0
10569,6,1,37094,37094,37095,0,1,2
10570,1,1,37095,37095,37096,0,1,0
10571,1,2,37096,37096,37098,0,2,0
10572,1,2,37097,37098,37100,1,3,0
10573,6,3,37103,37103,37106,0,3,3
10574,3,2,37106,37106,37108,0,2,0
10575,4,3,37110,37110,37113,0,3,2
10576,5,3,37115,37115,37118,0,3,2
10577,2,3,37117,37118,37121,1,4,0
10578,6,2,37123,37123,37125,0,2,2
10579,5,2,37128,37128,37130,0,2,3
10580,5,2,37133,37133,37135,0,2,3
10581,4,2,37137,37137,37139,0,2,2
10582,1,2,37138,37139,37141,1,3,0
10583,3,1,37141,37141,37142,0,1,0
10584,3,3,37144,37144,37147,0,3,2
10585,2,2,37146,37147,37149,1,3,0
10586,6,2,37152,37152,37154,0,2,3
10587,4,1,37156,37156,37157,0,1,2
10588,5,2,37161,37161,37163,0,2,4
10589,3,1,37164,37164,37165,0,1,1
10590,5,3,37169,37169,37172,0,3,4
10591,6,1,37175,37175,37176,0,1,3
10592,1,3,37176,37176,37179,0,3,0
10593,6,3,37182,37182,37185,0,3,3
10594,2,1,37184,37185,37186,1,2,0
10595,5,1,37189,37189,37190,0,1,3
10596,5,3,37194,37194,37197,0,3,4
10597,4,3,37198,37198,37201,0,3,1
10598,4,2,37202,37202,37204,0,2,1
10599,6,2,37208,37208,37210,0,2,4
10600,5,3,37213,37213,37216,0,3,3
10601,3,1,37216,37216,37217,0,1,0
10602,6,2,37222,37222,37224,0,2,5
10603,6,1,37228,37228,37229,0,1,4
10604,4,2,37232,37232,37234,0,2,3
10605,1,1,37233,37234,37235,1,2,0
10606,4,3,37237,37237,37240,0,3,2
10607,5,1,37242,37242,37243,0,1,2
10608,5,1,37247,37247,37248,0,1,4
10609,6,2,37253,37253,37255,0,2,5
10610,3,1,37256,37256,37257,0,1,1
10611,1,1,37257,37257,37258,0,1,0
10612,6,2,37263,37263,37265,0,2,5
10613,3,3,37266,37266,37269,0,3,1
10614,3,3,37269,37269,37272,0,3,0
10615,5,3,37274,37274,37277,0,3,2
10616,3,2,37277,37277,37279,0,2,0
10617,1,3,37278,37279,37282,1,4,0
10618,6,3,37284,37284,37287,0,3,2
10619,5,3,37289,37289,37292,0,3,2
10620,3,1,37292,37292,37293,0,1,0
10621,5,2,37297,37297,37299,0,2,4
10622,4,1,37301,37301,37302,0,1,2
10623,6,2,37307,37307,37309,0,2,5
10624,5,1,37312,37312,37313,0,1,3
10625,2,1,37314,37314,37315,0,1,1
10626,2,2,37316,37316,37318,0,2,1
10627,5,1,37321,37321,37322,0,1,3
10628,4,1,37325,37325,37326,0,1,3
10629,6,1,37331,37331,37332,0,1,5
10630,6,3,37337,37337,37340,0,3,5
10631,1,3,37338,37340,37343,2,5,0
10632,6,3,37344,37344,37347,0,3,1
10633,1,1,37345,37347,37348,2,3,0
10634,4,1,37349,37349,37350,0,1,1
10635,3,3,37352,37352,37355,0,3,2
10636,5,1,37357,37357,37358,0,1,2
10637,3,1,37360,37360,37361,0,1,2
10638,4,1,37364,37364,37365,0,1,3
10639,2,1,37366,37366,37367,0,1,1
10640,2,1,37368,37368,37369,0,1,1
10641,6,2,37374,37374,37376,0,2,5
10642,5,3,37379,37379,37382,0,3,3
10643,3,1,37382,37382,37383,0,1,0
10644,1,3,37383,37383,37386,0,3,0
10645,5,2,37388,37388,37390,0,2,2
10646,1,3,37389,37390,37393,1,4,0
10647,5,3,37394,37394,37397,0,3,1
10648,1,3,37395,37397,37400,2,5,0
10649,1,2,37396,37400,37402,4,6,0
10650,6,1,37402,37402,37403,0,1,0
10651,2,1,37404,37404,37405,0,1,1
10652,2,2,37406,37406,37408,0,2,1
10653,6,1,37412,37412,37413,0,1,4
10654,6,3,37418,37418,37421,0,3,5
10655,2,3,37420,37421,37424,1,4,0
10656,1,3,37421,37424,37427,3,6,0
10657,1,1,37422,37427,37428,5,6,0
10658,6,2,37428,37428,37430,0,2,0
10659,2,1,37430,37430,37431,0,1,0
10660,2,1,37432,37432,37433,0,1,1
10661,4,2,37436,37436,37438,0,2,3
10662,5,1,37441,37441,37442,0,1,3
10663,6,2,37447,37447,37449,0,2,5
10664,6,2,37453,37453,37455,0,2,4
10665,2,1,37455,37455,37456,0,1,0
10666,1,3,37456,37456,37459,0,3,0
10667,3,3,37459,37459,37462,0,3,0
10668,6,2,37465,37465,37467,0,2,3
10669,4,3,37469,37469,37472,0,3,2
10670,2,2,37471,37472,37474,1,3,0
10671,3,1,37474,37474,37475,0,1,0
10672,2,1,37476,37476,37477,0,1,1
10673,5,2,37481,37481,37483,0,2,4
10674,3,1,37484,37484,37485,0,1,1
10675,1,2,37485,37485,37487,0,2,0
10676,1,3,37486,37487,37490,1,4,0
10677,5,3,37491,37491,37494,0,3,1
10678,3,2,37494,37494,37496,0,2,0
10679,5,3,37499,37499,37502,0,3,3
10680,2,2,37501,37502,37504,1,3,0
10681,6,2,37507,37507,37509,0,2,3
10682,3,3,37510,37510,37513,0,3,1
10683,5,1,37515,37515,37516,0,1,2
10684,5,1,37520,37520,37521,0,1,4
10685,3,2,37523,37523,37525,0,2,2
10686,1,2,37524,37525,37527,1,3,0
10687,6,3,37530,37530,37533,0,3,3
10688,4,3,37534,37534,37537,0,3,1
10689,4,1,37538,37538,37539,0,1,1
10690,1,3,37539,37539,37542,0,3,0
10691,2,1,37541,37542,37543,1,2,0
10692,5,1,37546,37546,37547,0,1,3
10693,4,3,37550,37550,37553,0,3,3
10694,4,2,37554,37554,37556,0,2,1
10695,4,3,37558,37558,37561,0,3,2
10696,3,1,37561,37561,37562,0,1,0
10697,2,3,37563,37563,37566,0,3,1
10698,3,3,37566,37566,37569,0,3,0
10699,6,3,37572,37572,37575,0,3,3
10700,5,3,37577,37577,37580,0,3,2
10701,6,2,37583,37583,37585,0,2,3
10702,1,3,37584,37585,37588,1,4,0
10703,1,2,37585,37588,37590,3,5,0
10704,3,3,37588,37590,37593,2,5,0
10705,3,3,37591,37593,37596,2,5,0
10706,1,1,37592,37596,37597,4,5,0
10707,3,1,37595,37597,37598,2,3,0
10708,4,2,37599,37599,37601,0,2,1
10709,6,2,37605,37605,37607,0,2,4
10710,6,1,37611,37611,37612,0,1,4
10711,5,2,37616,37616,37618,0,2,4
10712,2,1,37618,37618,37619,0,1,0
10713,1,3,37619,37619,37622,0,3,0
10714,6,3,37625,37625,37628,0,3,3
10715,5,2,37630,37630,37632,0,2,2
10716,5,2,37635,37635,37637,0,2,3
10717,6,2,37641,37641,37643,0,2,4
10718,5,1,37646,37646,37647,0,1,3
10719,6,2,37652,37652,37654,0,2,5
10720,2,3,37654,37654,37657,0,3,0
10721,5,2,37659,37659,37661,0,2,2
10722,2,3,37661,37661,37664,0,3,0
10723,4,2,37665,37665,37667,0,2,1
10724,1,2,37666,37667,37669,1,3,0
10725,6,2,37672,37672,37674,0,2,3
10726,6,1,37678,37678,37679,0,1,4
10727,5,1,37683,37683,37684,0,1,4
10728,2,2,37685,37685,37687,0,2,1
10729,4,2,37689,37689,37691,0,2,2
10730,4,3,37693,37693,37696,0,3,2
10731,1,3,37694,37696,37699,2,5,0
10732,4,2,37698,37699,37701,1,3,0
10733,4,3,37702,37702,37705,0,3,1
10734,6,3,37708,37708,37711,0,3,3
10735,1,2,37709,37711,37713,2,4,0
10736,5,1,37714,37714,37715,0,1,1
10737,1,3,37715,37715,37718,0,3,0
10738,3,1,37718,37718,37719,0,1,0
10739,3,2,37721,37721,37723,0,2,2
10740,5,1,37726,37726,37727,0,1,3
10741,6,3,37732,37732,37735,0,3,5
10742,5,1,37737,37737,37738,0,1,2
10743,3,2,37740,37740,37742,0,2,2
10744,3,3,37743,37743,37746,0,3,1
10745,1,3,37744,37746,37749,2,5,0
10746,6,2,37750,37750,37752,0,2,1
10747,2,1,37752,37752,37753,0,1,0
10748,4,3,37756,37756,37759,0,3,3
10749,3,2,37759,37759,37761,0,2,0
10750,4,1,37763,37763,37764,0,1,2
10751,5,2,37768,37768,37770,0,2,4
10752,5,3,37773,37773,37776,0,3,3
10753,4,2,37777,37777,37779,0,2,1
10754,1,3,37778,37779,37782,1,4,0
10755,1,2,37779,37782,37784,3,5,0
10756,1,3,37780,37784,37787,4,7,0
10757,5,2,37785,37787,37789,2,4,0
10758,4,1,37789,37789,37790,0,1,0
10759,1,1,37790,37790,37791,0,1,0
10760,3,1,37793,37793,37794,0,1,2
10761,6,3,37799,37799,37802,0,3,5
10762,3,2,37802,37802,37804,0,2,0
10763,1,1,37803,37804,37805,1,2,0
10764,3,3,37806,37806,37809,0,3,1
10765,2,3,37808,37809,37812,1,4,0
10766,3,2,37811,37812,37814,1,3,0
10767,3,3,37814,37814,37817,0,3,0
10768,6,2,37820,37820,37822,0,2,3
10769,3,2,37823,37823,37825,0,2,1
10770,1,1,37824,37825,37826,1,2,0
10771,5,1,37829,37829,37830,0,1,3
10772,6,1,37835,37835,37836,0,1,5
10773,2,2,37837,37837,37839,0,2,1
10774,6,3,37843,37843,37846,0,3,4
10775,6,1,37849,37849,37850,0,1,3
10776,2,3,37851,37851,37854,0,3,1
10777,5,3,37856,37856,37859,0,3,2
10778,1,1,37857,37859,37860,2,3,0
10779,5,3,37862,37862,37865,0,3,2
10780,2,2,37864,37865,37867,1,3,0
10781,3,1,37867,37867,37868,0,1,0
10782,3,1,37870,37870,37871,0,1,2
10783,5,1,37875,37875,37876,0,1,4
10784,2,3,37877,37877,37880,0,3,1
10785,3,3,37880,37880,37883,0,3,0
10786,1,1,37881,37883,37884,2,3,0
10787,4,1,37885,37885,37886,0,1,1
10788,6,3,37891,37891,37894,0,3,5
10789,4,3,37895,37895,37898,0,3,1
10790,4,1,37899,37899,37900,0,1,1
10791,1,2,37900,37900,37902,0,2,0
10792,1,3,37901,37902,37905,1,4,0
10793,5,2,37906,37906,37908,0,2,1
10794,3,1,37909,37909,37910,0,1,1
10795,3,3,37912,37912,37915,0,3,2
10796,5,3,37917,37917,37920,0,3,2
10797,3,3,37920,37920,37923,0,3,0
10798,3,2,37923,37923,37925,0,2,0
10799,6,1,37929,37929,37930,0,1,4
10800,5,3,37934,37934,37937,0,3,4
10801,4,2,37938,37938,37940,0,2,1
10802,4,2,37942,37942,37944,0,2,2
10803,4,1,37946,37946,37947,0,1,2
10804,4,1,37950,37950,37951,0,1,3
10805,4,1,37954,37954,37955,0,1,3
10806,1,2,37955,37955,37957,0,2,0
10807,3,3,37958,37958,37961,0,3,1
10808,2,3,37960,37961,37964,1,4,0
10809,4,1,37964,37964,37965,0,1,0
10810,1,1,37965,37965,37966,0,1,0
10811,4,1,37969,37969,37970,0,1,3
10812,6,2,37975,37975,37977,0,2,5
10813,4,2,37979,37979,37981,0,2,2
10814,1,1,37980,37981,37982,1,2,0
10815,4,2,37984,37984,37986,0,2,2
10816,2,1,37986,37986,37987,0,1,0
10817,1,3,37987,37987,37990,0,3,0
10818,1,3,37988,37990,37993,2,5,0
10819,3,2,37991,37993,37995,2,4,0
10820,1,1,37992,37995,37996,3,4,0
10821,6,3,37998,37998,38001,0,3,2
10822,2,3,38000,38001,38004,1,4,0
10823,3,3,38003,38004,38007,1,4,0
10824,2,1,38005,38007,38008,2,3,0
10825,1,3,38006,38008,38011,2,5,0
10826,5,2,38011,38011,38013,0,2,0
10827,4,1,38015,38015,38016,0,1,2
10828,6,3,38021,38021,38024,0,3,5
10829,2,2,38023,38024,38026,1,3,0
10830,4,3,38027,38027,38030,0,3,1
10831,2,1,38029,38030,38031,1,2,0
10832,6,2,38035,38035,38037,0,2,4
10833,1,3,38036,38037,38040,1,4,0
10834,1,3,38037,38040,38043,3,6,0
10835,5,3,38042,38043,38046,1,4,0
10836,3,1,38045,38046,38047,1,2,0
10837,1,3,38046,38047,38050,1,4,0
10838,1,2,38047,38050,38052,3,5,0
10839,6,2,38053,38053,38055,0,2,1
10840,1,3,38054,38055,38058,1,4,0
10841,1,3,38055,38058,38061,3,6,0
10842,5,2,38060,38061,38063,1,3,0
10843,4,3,38064,38064,38067,0,3,1
10844,1,2,38065,38067,38069,2,4,0
10845,1,3,38066,38069,38072,3,6,0
10846,2,3,38068,38072,38075,4,7,0
10847,2,1,38070,38075,38076,5,6,0
10848,1,3,38071,38076,38079,5,8,0
10849,2,3,38073,38079,38082,6,9,0
10850,2,2,38075,38082,38084,7,9,0
10851,4,1,38079,38084,38085,5,6,0
10852,3,2,38082,38085,38087,3,5,0
10853,1,3,38083,38087,38090,4,7,0
10854,4,1,38087,38090,38091,3,4,0
10855,4,3,38091,38091,38094,0,3,0
10856,1,3,38092,38094,38097,2,5,0
10857,3,2,38095,38097,38099,2,4,0
10858,1,1,38096,38099,38100,3,4,0
10859,2,3,38098,38100,38103,2,5,0
10860,1,1,38099,38103,38104,4,5,0
10861,1,1,38100,38104,38105,4,5,0
10862,1,2,38101,38105,38107,4,6,0
10863,1,1,38102,38107,38108,5,6,0
10864,1,3,38103,38108,38111,5,8,0
10865,6,3,38109,38111,38114,2,5,0
10866,5,1,38114,38114,38115,0,1,0
10867,2,2,38116,38116,38118,0,2,1
10868,4,3,38120,38120,38123,0,3,2
10869,2,1,38122,38123,38124,1,2,0
10870,6,1,38128,38128,38129,0,1,4
10871,6,2,38134,38134,38136,0,2,5
10872,1,2,38135,38136,38138,1,3,0
10873,6,3,38141,38141,38144,0,3,3
10874,6,2,38147,38147,38149,0,2,3
10875,3,3,38150,38150,38153,0,3,1
10876,1,3,38151,38153,38156,2,5,0
10877,1,2,38152,38156,38158,4,6,0
10878,3,2,38155,38158,38160,3,5,0
10879,2,2,38157,38160,38162,3,5,0
10880,4,2,38161,38162,38164,1,3,0
10881,4,3,38165,38165,38168,0,3,1
10882,6,3,38171,38171,38174,0,3,3
10883,2,2,38173,38174,38176,1,3,0
10884,6,2,38179,38179,38181,0,2,3
10885,6,1,38185,38185,38186,0,1,4
10886,6,2,38191,38191,38193,0,2,5
10887,1,2,38192,38193,38195,1,3,0
10888,2,2,38194,38195,38197,1,3,0
10889,5,2,38199,38199,38201,0,2,2
10890,5,3,38204,38204,38207,0,3,3
10891,4,1,38208,38208,38209,0,1,1
10892,6,2,38214,38214,38216,0,2,5
10893,4,3,38218,38218,38221,0,3,2
10894,1,1,38219,38221,38222,2,3,0
10895,1,1,38220,38222,38223,2,3,0
10896,1,3,38221,38223,38226,2,5,0
10897,4,2,38225,38226,38228,1,3,0
10898,2,1,38227,38228,38229,1,2,0
10899,4,1,38231,38231,38232,0,1,2
10900,5,2,38236,38236,38238,0,2,4
10901,1,3,38237,38238,38241,1,4,0
10902,4,1,38241,38241,38242,0,1,0
10903,5,2,38246,38246,38248,0,2,4
10904,5,2,38251,38251,38253,0,2,3
10905,1,3,38252,38253,38256,1,4,0
10906,3,2,38255,38256,38258,1,3,0
10907,4,1,38259,38259,38260,0,1,1
10908,5,1,38264,38264,38265,0,1,4
10909,5,2,38269,38269,38271,0,2,4
10910,5,1,38274,38274,38275,0,1,3
10911,6,3,38280,38280,38283,0,3,5
10912,5,1,38285,38285,38286,0,1,2
10913,1,3,38286,38286,38289,0,3,0
10914,1,1,38287,38289,38290,2,3,0
10915,6,1,38293,38293,38294,0,1,3
10916,3,1,38296,38296,38297,0,1,2
10917,3,3,38299,38299,38302,0,3,2
10918,3,1,38302,38302,38303,0,1,0
10919,2,3,38304,38304,38307,0,3,1
10920,1,2,38305,38307,38309,2,4,0
10921,6,3,38311,38311,38314,0,3,2
10922,4,1,38315,38315,38316,0,1,1
10923,3,3,38318,38318,38321,0,3,2
10924,5,3,38323,38323,38326,0,3,2
10925,5,1,38328,38328,38329,0,1,2
10926,5,2,38333,38333,38335,0,2,4
10927,4,1,38337,38337,38338,0,1,2
10928,1,3,38338,38338,38341,0,3,0
10929,1,2,38339,38341,38343,2,4,0
10930,4,3,38343,38343,38346,0,3,0
10931,6,3,38349,38349,38352,0,3,3
10932,4,1,38353,38353,38354,0,1,1
10933,2,1,38355,38355,38356,0,1,1
10934,2,1,38357,38357,38358,0,1,1
10935,2,2,38359,38359,38361,0,2,1
10936,4,1,38363,38363,38364,0,1,2
10937,6,3,38369,38369,38372,0,3,5
10938,2,1,38371,38372,38373,1,2,0
10939,5,1,38376,38376,38377,0,1,3
10940,5,2,38381,38381,38383,0,2,4
10941,1,2,38382,38383,38385,1,3,0
10942,6,3,38388,38388,38391,0,3,3
10943,2,1,38390,38391,38392,1,2,0
10944,4,2,38394,38394,38396,0,2,2
10945,4,3,38398,38398,38401,0,3,2
10946,1,1,38399,38401,38402,2,3,0
10947,5,1,38404,38404,38405,0,1,2
10948,1,1,38405,38405,38406,0,1,0
10949,6,1,38411,38411,38412,0,1,5
10950,5,1,38416,38416,38417,0,1,4
10951,4,2,38420,38420,38422,0,2,3
10952,4,3,38424,38424,38427,0,3,2
10953,4,2,38428,38428,38430,0,2,1
10954,1,2,38429,38430,38432,1,3,0
10955,2,2,38431,38432,38434,1,3,0
10956,2,2,38433,38434,38436,1,3,0
10957,4,1,38437,38437,38438,0,1,1
10958,1,1,38438,38438,38439,0,1,0
10959,6,2,38444,38444,38446,0,2,5
10960,1,3,38445,38446,38449,1,4,0
10961,4,3,38449,38449,38452,0,3,0
10962,3,2,38452,38452,38454,0,2,0
10963,3,1,38455,38455,38456,0,1,1
10964,1,2,38456,38456,38458,0,2,0
10965,3,3,38459,38459,38462,0,3,1
10966,6,1,38465,38465,38466,0,1,3
10967,2,1,38467,38467,38468,0,1,1
10968,5,3,38472,38472,38475,0,3,4
10969,2,1,38474,38475,38476,1,2,0
10970,1,3,38475,38476,38479,1,4,0
10971,6,1,38481,38481,38482,0,1,2
10972,2,1,38483,38483,38484,0,1,1
10973,4,3,38487,38487,38490,0,3,3
10974,4,2,38491,38491,38493,0,2,1
10975,5,2,38496,38496,38498,0,2,3
10976,4,3,38500,38500,38503,0,3,2
10977,3,1,38503,38503,38504,0,1,0
10978,6,3,38509,38509,38512,0,3,5
10979,1,2,38510,38512,38514,2,4,0
10980,4,3,38514,38514,38517,0,3,0
10981,1,3,38515,38517,38520,2,5,0
10982,6,2,38521,38521,38523,0,2,1
10983,2,3,38523,38523,38526,0,3,0
10984,4,2,38527,38527,38529,0,2,1
10985,5,1,38532,38532,38533,0,1,3
10986,4,2,38536,38536,38538,0,2,3
10987,3,1,38539,38539,38540,0,1,1
10988,2,3,38541,38541,38544,0,3,1
10989,2,2,38543,38544,38546,1,3,0
10990,5,1,38548,38548,38549,0,1,2
10991,1,3,38549,38549,38552,0,3,0
10992,4,1,38553,38553,38554,0,1,1
10993,4,2,38557,38557,38559,0,2,3
10994,1,2,38558,38559,38561,1,3,0
10995,5,3,38563,38563,38566,0,3,2
10996,1,3,38564,38566,38569,2,5,0
10997,1,3,38565,38569,38572,4,7,0
10998,5,1,38570,38572,38573,2,3,0
10999,5,1,38575,38575,38576,0,1,2
11000,1,1,38576,38576,38577,0,1,0
11001,3,3,38579,38579,38582,0,3,2
11002,3,1,38582,38582,38583,0,1,0
11003,2,3,38584,38584,38587,0,3,1
11004,6,3,38590,38590,38593,0,3,3
11005,4,1,38594,38594,38595,0,1,1
11006,3,3,38597,38597,38600,0,3,2
11007,1,1,38598,38600,38601,2,3,0
11008,2,3,38600,38601,38604,1,4,0
11009,6,1,38606,38606,38607,0,1,2
11010,6,3,38612,38612,38615,0,3,5
11011,5,1,38617,38617,38618,0,1,2
11012,1,1,38618,38618,38619,0,1,0
11013,5,2,38623,38623,38625,0,2,4
11014,2,1,38625,38625,38626,0,1,0
11015,1,1,38626,38626,38627,0,1,0
11016,1,1,38627,38627,38628,0,1,0
11017,6,3,38633,38633,38636,0,3,5
11018,2,3,38635,38636,38639,1,4,0
11019,4,2,38639,38639,38641,0,2,0
11020,6,3,38645,38645,38648,0,3,4
11021,4,3,38649,38649,38652,0,3,1
11022,5,3,38654,38654,38657,0,3,2
11023,6,3,38660,38660,38663,0,3,3
11024,1,2,38661,38663,38665,2,4,0
11025,4,3,38665,38665,38668,0,3,0
11026,3,3,38668,38668,38671,0,3,0
11027,4,2,38672,38672,38674,0,2,1
11028,2,1,38674,38674,38675,0,1,0
11029,6,3,38680,38680,38683,0,3,5
11030,2,1,38682,38683,38684,1,2,0
11031,2,1,38684,38684,38685,0,1,0
11032,2,3,38686,38686,38689,0,3,1
11033,6,1,38692,38692,38693,0,1,3
11034,2,2,38694,38694,38696,0,2,1
11035,2,3,38696,38696,38699,0,3,0
11036,6,2,38702,38702,38704,0,2,3
11037,1,2,38703,38704,38706,1,3,0
11038,4,1,38707,38707,38708,0,1,1
11039,6,2,38713,38713,38715,0,2,5
11040,4,1,38717,38717,38718,0,1,2
11041,1,1,38718,38718,38719,0,1,0
11042,4,1,38722,38722,38723,0,1,3
11043,4,2,38726,38726,38728,0,2,3
11044,1,1,38727,38728,38729,1,2,0
11045,6,3,38733,38733,38736,0,3,4
11046,5,2,38738,38738,38740,0,2,2
11047,5,1,38743,38743,38744,0,1,3
11048,4,2,38747,38747,38749,0,2,3
11049,5,1,38752,38752,38753,0,1,3
11050,3,3,38755,38755,38758,0,3,2
11051,2,2,38757,38758,38760,1,3,0
11052,3,1,38760,38760,38761,0,1,0
11053,5,2,38765,38765,38767,0,2,4
11054,3,2,38768,38768,38770,0,2,1
11055,4,2,38772,38772,38774,0,2,2
11056,6,3,38778,38778,38781,0,3,4
11057,4,3,38782,38782,38785,0,3,1
11058,2,1,38784,38785,38786,1,2,0
11059,4,2,38788,38788,38790,0,2,2
11060,4,3,38792,38792,38795,0,3,2
11061,3,3,38795,38795,38798,0,3,0
11062,6,3,38801,38801,38804,0,3,3
11063,4,3,38805,38805,38808,0,3,1
11064,4,3,38809,38809,38812,0,3,1
11065,1,2,38810,38812,38814,2,4,0
11066,6,2,38816,38816,38818,0,2,2
11067,5,1,38821,38821,38822,0,1,3
11068,1,1,38822,38822,38823,0,1,0
11069,6,1,38828,38828,38829,0,1,5
11070,1,1,38829,38829,38830,0,1,0
11071,4,3,38833,38833,38836,0,3,3
11072,5,3,38838,38838,38841,0,3,2
11073,6,1,38844,38844,38845,0,1,3
11074,1,2,38845,38845,38847,0,2,0
11075,4,2,38849,38849,38851,0,2,2
11076,3,2,38852,38852,38854,0,2,1
11077,3,1,38855,38855,38856,0,1,1
11078,3,2,38858,38858,38860,0,2,2
11079,5,2,38863,38863,38865,0,2,3
11080,5,2,38868,38868,38870,0,2,3
11081,4,3,38872,38872,38875,0,3,2
11082,1,1,38873,38875,38876,2,3,0
11083,3,1,38876,38876,38877,0,1,0
11084,1,2,38877,38877,38879,0,2,0
11085,5,1,38882,38882,38883,0,1,3
11086,5,2,38887,38887,38889,0,2,4
11087,3,3,38890,38890,38893,0,3,1
11088,2,1,38892,38893,38894,1,2,0
11089,5,1,38897,38897,38898,0,1,3
11090,1,1,38898,38898,38899,0,1,0
11091,6,3,38904,38904,38907,0,3,5
11092,6,2,38910,38910,38912,0,2,3
11093,1,2,38911,38912,38914,1,3,0
11094,6,3,38917,38917,38920,0,3,3
11095,5,3,38922,38922,38925,0,3,2
11096,1,3,38923,38925,38928,2,5,0
11097,1,3,38924,38928,38931,4,7,0
11098,5,3,38929,38931,38934,2,5,0
11099,1,2,38930,38934,38936,4,6,0
11100,3,2,38933,38936,38938,3,5,0
11101,6,2,38939,38939,38941,0,2,1
11102,4,1,38943,38943,38944,0,1,2
11103,1,1,38944,38944,38945,0,1,0
11104,5,1,38949,38949,38950,0,1,4
11105,6,3,38955,38955,38958,0,3,5
11106,4,2,38959,38959,38961,0,2,1
11107,6,3,38965,38965,38968,0,3,4
11108,6,2,38971,38971,38973,0,2,3
11109,1,3,38972,38973,38976,1,4,0
11110,1,2,38973,38976,38978,3,5,0
11111,1,3,38974,38978,38981,4,7,0
11112,4,3,38978,38981,38984,3,6,0
11113,1,2,38979,38984,38986,5,7,0
11114,2,1,38981,38986,38987,5,6,0
11115,2,3,38983,38987,38990,4,7,0
11116,6,2,38989,38990,38992,1,3,0
11117,1,3,38990,38992,38995,2,5,0
11118,1,1,38991,38995,38996,4,5,0
11119,1,2,38992,38996,38998,4,6,0
11120,3,2,38995,38998,39000,3,5,0
11121,1,3,38996,39000,39003,4,7,0
11122,6,3,39002,39003,39006,1,4,0
11123,4,1,39006,39006,39007,0,1,0
11124,2,1,39008,39008,39009,0,1,1
11125,6,1,39014,39014,39015,0,1,5
11126,5,1,39019,39019,39020,0,1,4
11127,3,1,39022,39022,39023,0,1,2
11128,3,3,39025,39025,39028,0,3,2
11129,1,3,39026,39028,39031,2,5,0
11130,6,3,39032,39032,39035,0,3,1
11131,5,2,39037,39037,39039,0,2,2
11132,1,2,39038,39039,39041,1,3,0
11133,4,2,39042,39042,39044,0,2,1
11134,3,1,39045,39045,39046,0,1,1
11135,3,3,39048,39048,39051,0,3,2
11136,6,1,39054,39054,39055,0,1,3
11137,1,2,39055,39055,39057,0,2,0
11138,4,3,39059,39059,39062,0,3,2
11139,3,3,39062,39062,39065,0,3,0
11140,5,2,39067,39067,39069,0,2,2
11141,6,2,39073,39073,39075,0,2,4
11142,3,3,39076,39076,39079,0,3,1
11143,1,1,39077,39079,39080,2,3,0
11144,4,1,39081,39081,39082,0,1,1
11145,5,2,39086,39086,39088,0,2,4
11146,6,1,39092,39092,39093,0,1,4
11147,1,2,39093,39093,39095,0,2,0
11148,3,3,39096,39096,39099,0,3,1
11149,5,1,39101,39101,39102,0,1,2
11150,6,1,39107,39107,39108,0,1,5
11151,2,3,39109,39109,39112,0,3,1
11152,4,2,39113,39113,39115,0,2,1
11153,3,1,39116,39116,39117,0,1,1
11154,5,1,39121,39121,39122,0,1,4
11155,3,1,39124,39124,39125,0,1,2
11156,5,1,39129,39129,39130,0,1,4
11157,1,3,39130,39130,39133,0,3,0
11158,1,1,39131,39133,39134,2,3,0
11159,5,2,39136,39136,39138,0,2,2
11160,2,2,39138,39138,39140,0,2,0
11161,4,3,39142,39142,39145,0,3,2
11162,3,2,39145,39145,39147,0,2,0
11163,2,3,39147,39147,39150,0,3,0
11164,6,2,39153,39153,39155,0,2,3
11165,1,3,39154,39155,39158,1,4,0
11166,6,2,39160,39160,39162,0,2,2
11167,4,1,39164,39164,39165,0,1,2
11168,6,1,39170,39170,39171,0,1,5
11169,5,2,39175,39175,39177,0,2,4
11170,2,2,39177,39177,39179,0,2,0
11171,5,1,39182,39182,39183,0,1,3
11172,5,2,39187,39187,39189,0,2,4
11173,6,3,39193,39193,39196,0,3,4
11174,6,2,39199,39199,39201,0,2,3
11175,3,3,39202,39202,39205,0,3,1
11176,2,2,39204,39205,39207,1,3,0
11177,5,3,39209,39209,39212,0,3,2
11178,3,1,39212,39212,39213,0,1,0
11179,6,1,39218,39218,39219,0,1,5
11180,2,1,39220,39220,39221,0,1,1
11181,6,2,39226,39226,39228,0,2,5
11182,4,3,39230,39230,39233,0,3,2
11183,6,2,39236,39236,39238,0,2,3
11184,4,1,39240,39240,39241,0,1,2
11185,4,3,39244,39244,39247,0,3,3
11186,3,3,39247,39247,39250,0,3,0
11187,1,2,39248,39250,39252,2,4,0
11188,4,3,39252,39252,39255,0,3,0
11189,3,3,39255,39255,39258,0,3,0
11190,3,3,39258,39258,39261,0,3,0
11191,4,2,39262,39262,39264,0,2,1
11192,5,3,39267,39267,39270,0,3,3
11193,1,2,39268,39270,39272,2,4,0
11194,5,2,39273,39273,39275,0,2,1
11195,2,1,39275,39275,39276,0,1,0
11196,6,2,39281,39281,39283,0,2,5
11197,2,3,39283,39283,39286,0,3,0
11198,4,3,39287,39287,39290,0,3,1
11199,4,2,39291,39291,39293,0,2,1
11200,3,3,39294,39294,39297,0,3,1
11201,4,1,39298,39298,39299,0,1,1
11202,5,1,39303,39303,39304,0,1,4
11203,4,2,39307,39307,39309,0,2,3
11204,3,3,39310,39310,39313,0,3,1
11205,5,3,39315,39315,39318,0,3,2
11206,2,3,39317,39318,39321,1,4,0
11207,3,3,39320,39321,39324,1,4,0
11208,6,3,39326,39326,39329,0,3,2
11209,4,1,39330,39330,39331,0,1,1
11210,4,1,39334,39334,39335,0,1,3
11211,4,2,39338,39338,39340,0,2,3
11212,6,2,39344,39344,39346,0,2,4
11213,2,2,39346,39346,39348,0,2,0
11214,5,2,39351,39351,39353,0,2,3
11215,6,3,39357,39357,39360,0,3,4
11216,5,1,39362,39362,39363,0,1,2
11217,5,2,39367,39367,39369,0,2,4
11218,2,2,39369,39369,39371,0,2,0
11219,1,3,39370,39371,39374,1,4,0
11220,6,3,39376,39376,39379,0,3,2
11221,4,2,39380,39380,39382,0,2,1
11222,5,2,39385,39385,39387,0,2,3
11223,4,2,39389,39389,39391,0,2,2
11224,5,2,39394,39394,39396,0,2,3
11225,2,3,39396,39396,39399,0,3,0
11226,4,2,39400,39400,39402,0,2,1
11227,3,2,39403,39403,39405,0,2,1
11228,3,3,39406,39406,39409,0,3,1
11229,6,3,39412,39412,39415,0,3,3
11230,5,3,39417,39417,39420,0,3,2
11231,5,3,39422,39422,39425,0,3,2
11232,6,1,39428,39428,39429,0,1,3
11233,1,2,39429,39429,39431,0,2,0
11234,6,2,39435,39435,39437,0,2,4
11235,5,2,39440,39440,39442,0,2,3
11236,4,2,39444,39444,39446,0,2,2
11237,1,3,39445,39446,39449,1,4,0
11238,1,2,39446,39449,39451,3,5,0
11239,1,1,39447,39451,39452,4,5,0
11240,4,3,39451,39452,39455,1,4,0
11241,1,2,39452,39455,39457,3,5,0
11242,6,1,39458,39458,39459,0,1,1
11243,6,2,39464,39464,39466,0,2,5
11244,4,2,39468,39468,39470,0,2,2
11245,5,2,39473,39473,39475,0,2,3
11246,1,1,39474,39475,39476,1,2,0
11247,1,3,39475,39476,39479,1,4,0
11248,6,3,39481,39481,39484,0,3,2
11249,2,1,39483,39484,39485,1,2,0
11250,1,3,39484,39485,39488,1,4,0
11251,5,1,39489,39489,39490,0,1,1
11252,5,1,39494,39494,39495,0,1,4
11253,1,1,39495,39495,39496,0,1,0
11254,5,1,39500,39500,39501,0,1,4
11255,3,3,39503,39503,39506,0,3,2
11256,5,2,39508,39508,39510,0,2,2
11257,1,2,39509,39510,39512,1,3,0
11258,4,1,39513,39513,39514,0,1,1
11259,6,2,39519,39519,39521,0,2,5
11260,6,1,39525,39525,39526,0,1,4
11261,5,3,39530,39530,39533,0,3,4
11262,3,3,39533,39533,39536,0,3,0
11263,1,2,39534,39536,39538,2,4,0
11264,5,3,39539,39539,39542,0,3,1
11265,4,3,39543,39543,39546,0,3,1
11266,6,1,39549,39549,39550,0,1,3
11267,6,3,39555,39555,39558,0,3,5
11268,5,1,39560,39560,39561,0,1,2
11269,6,2,39566,39566,39568,0,2,5
11270,5,2,39571,39571,39573,0,2,3
11271,4,1,39575,39575,39576,0,1,2
11272,2,1,39577,39577,39578,0,1,1
11273,4,3,39581,39581,39584,0,3,3
11274,5,2,39586,39586,39588,0,2,2
11275,4,2,39590,39590,39592,0,2,2
11276,5,2,39595,39595,39597,0,2,3
11277,3,2,39598,39598,39600,0,2,1
11278,4,3,39602,39602,39605,0,3,2
11279,5,1,39607,39607,39608,0,1,2
11280,6,2,39613,39613,39615,0,2,5
11281,4,1,39617,39617,39618,0,1,2
11282,4,2,39621,39621,39623,0,2,3
11283,4,3,39625,39625,39628,0,3,2
11284,5,2,39630,39630,39632,0,2,2
11285,1,2,39631,39632,39634,1,3,0
11286,4,1,39635,39635,39636,0,1,1
11287,3,3,39638,39638,39641,0,3,2
11288,1,2,39639,39641,39643,2,4,0
11289,6,1,39645,39645,39646,0,1,2
11290,4,3,39649,39649,39652,0,3,3
11291,3,3,39652,39652,39655,0,3,0
11292,1,3,39653,39655,39658,2,5,0
11293,1,3,39654,39658,39661,4,7,0
11294,4,3,39658,39661,39664,3,6,0
11295,5,1,39663,39664,39665,1,2,0
11296,3,2,39666,39666,39668,0,2,1
11297,2,1,39668,39668,39669,0,1,0
11298,5,3,39673,39673,39676,0,3,4
11299,4,1,39677,39677,39678,0,1,1
11300,1,1,39678,39678,39679,0,1,0
11301,1,2,39679,39679,39681,0,2,0
11302,2,2,39681,39681,39683,0,2,0
11303,4,2,39685,39685,39687,0,2,2
11304,6,1,39691,39691,39692,0,1,4
11305,6,3,39697,39697,39700,0,3,5
11306,1,2,39698,39700,39702,2,4,0
11307,1,1,39699,39702,39703,3,4,0
11308,6,3,39705,39705,39708,0,3,2
11309,1,1,39706,39708,39709,2,3,0
11310,5,3,39711,39711,39714,0,3,2
11311,5,3,39716,39716,39719,0,3,2
11312,3,1,39719,39719,39720,0,1,0
11313,3,1,39722,39722,39723,0,1,2
11314,6,1,39728,39728,39729,0,1,5
11315,4,2,39732,39732,39734,0,2,3
11316,5,2,39737,39737,39739,0,2,3
11317,3,1,39740,39740,39741,0,1,1
11318,4,1,39744,39744,39745,0,1,3
11319,4,2,39748,39748,39750,0,2,3
11320,4,1,39752,39752,39753,0,1,2
11321,4,2,39756,39756,39758,0,2,3
11322,6,1,39762,39762,39763,0,1,4
11323,1,3,39763,39763,39766,0,3,0
11324,5,3,39768,39768,39771,0,3,2
11325,3,1,39771,39771,39772,0,1,0
11326,1,2,39772,39772,39774,0,2,0
11327,6,3,39778,39778,39781,0,3,4
11328,1,3,39779,39781,39784,2,5,0
11329,5,1,39784,39784,39785,0,1,0
11330,3,1,39787,39787,39788,0,1,2
11331,1,1,39788,39788,39789,0,1,0
11332,1,2,39789,39789,39791,0,2,0
11333,6,3,39795,39795,39798,0,3,4
11334,3,1,39798,39798,39799,0,1,0
11335,5,1,39803,39803,39804,0,1,4
11336,6,1,39809,39809,39810,0,1,5
11337,5,3,39814,39814,39817,0,3,4
11338,4,3,39818,39818,39821,0,3,1
11339,6,3,39824,39824,39827,0,3,3
11340,6,1,39830,39830,39831,0,1,3
11341,6,3,39836,39836,39839,0,3,5
11342,3,1,39839,39839,39840,0,1,0
11343,4,2,39843,39843,39845,0,2,3
11344,1,3,39844,39845,39848,1,4,0
11345,1,1,39845,39848,39849,3,4,0
11346,4,1,39849,39849,39850,0,1,0
11347,4,2,39853,39853,39855,0,2,3
11348,2,1,39855,39855,39856,0,1,0
11349,2,2,39857,39857,39859,0,2,1
11350,5,1,39862,39862,39863,0,1,3
11351,1,1,39863,39863,39864,0,1,0
11352,1,1,39864,39864,39865,0,1,0
11353,6,2,39870,39870,39872,0,2,5
11354,4,3,39874,39874,39877,0,3,2
11355,3,2,39877,39877,39879,0,2,0
11356,1,3,39878,39879,39882,1,4,0
11357,1,2,39879,39882,39884,3,5,0
11358,3,2,39882,39884,39886,2,4,0
11359,4,1,39886,39886,39887,0,1,0
11360,1,2,39887,39887,39889,0,2,0
11361,2,2,39889,39889,39891,0,2,0
11362,2,1,39891,39891,39892,0,1,0
11363,1,2,39892,39892,39894,0,2,0
11364,6,1,39898,39898,39899,0,1,4
11365,3,1,39901,39901,39902,0,1,2
11366,1,1,39902,39902,39903,0,1,0
11367,3,2,39905,39905,39907,0,2,2
11368,4,3,39909,39909,39912,0,3,2
11369,1,3,39910,39912,39915,2,5,0
11370,1,1,39911,39915,39916,4,5,0
11371,3,1,39914,39916,39917,2,3,0
11372,3,2,39917,39917,39919,0,2,0
11373,4,1,39921,39921,39922,0,1,2
11374,6,2,39927,39927,39929,0,2,5
11375,1,1,39928,39929,39930,1,2,0
11376,2,1,39930,39930,39931,0,1,0
11377,2,2,39932,39932,39934,0,2,1
11378,6,3,39938,39938,39941,0,3,4
11379,5,3,39943,39943,39946,0,3,2
11380,4,1,39947,39947,39948,0,1,1
11381,5,1,39952,39952,39953,0,1,4
11382,2,3,39954,39954,39957,0,3,1
11383,6,3,39960,39960,39963,0,3,3
11384,6,2,39966,39966,39968,0,2,3
11385,1,1,39967,39968,39969,1,2,0
11386,2,1,39969,39969,39970,0,1,0
11387,1,1,39970,39970,39971,0,1,0
11388,5,2,39975,39975,39977,0,2,4
11389,5,1,39980,39980,39981,0,1,3
11390,3,2,39983,39983,39985,0,2,2
11391,4,2,39987,39987,39989,0,2,2
11392,1,3,39988,39989,39992,1,4,0
11393,3,3,39991,39992,39995,1,4,0
11394,4,1,39995,39995,39996,0,1,0
11395,6,3,40001,40001,40004,0,3,5
11396,5,2,40006,40006,40008,0,2,2
11397,2,3,40008,40008,40011,0,3,0
11398,6,1,40014,40014,40015,0,1,3
11399,2,1,40016,40016,40017,0,1,1
11400,6,2,40022,40022,40024,0,2,5
11401,4,3,40026,40026,40029,0,3,2
11402,6,2,40032,40032,40034,0,2,3
11403,4,2,40036,40036,40038,0,2,2
11404,2,3,40038,40038,40041,0,3,0
11405,1,2,40039,40041,40043,2,4,0
11406,1,1,40040,40043,40044,3,4,0
11407,3,2,40043,40044,40046,1,3,0
11408,4,2,40047,40047,40049,0,2,1
11409,6,1,40053,40053,40054,0,1,4
11410,3,1,40056,40056,40057,0,1,2
11411,4,2,40060,40060,40062,0,2,3
11412,5,3,40065,40065,40068,0,3,3
11413,3,1,40068,40068,40069,0,1,0
11414,6,3,40074,40074,40077,0,3,5
11415,2,3,40076,40077,40080,1,4,0
11416,6,1,40082,40082,40083,0,1,2
11417,1,1,40083,40083,40084,0,1,0
11418,4,1,40087,40087,40088,0,1,3
11419,6,1,40093,40093,40094,0,1,5
11420,3,2,40096,40096,40098,0,2,2
11421,4,2,40100,40100,40102,0,2,2
11422,1,3,40101,40102,40105,1,4,0
11423,2,2,40103,40105,40107,2,4,0
11424,6,1,40109,40109,40110,0,1,2
11425,5,3,40114,40114,40117,0,3,4
11426,5,1,40119,40119,40120,0,1,2
11427,6,3,40125,40125,40128,0,3,5
11428,5,1,40130,40130,40131,0,1,2
11429,3,3,40133,40133,40136,0,3,2
11430,2,2,40135,40136,40138,1,3,0
11431,1,1,40136,40138,40139,2,3,0
11432,4,3,40140,40140,40143,0,3,1
11433,1,2,40141,40143,40145,2,4,0
11434,2,3,40143,40145,40148,2,5,0
11435,3,3,40146,40148,40151,2,5,0
11436,3,2,40149,40151,40153,2,4,0
11437,2,2,40151,40153,40155,2,4,0
11438,5,1,40156,40156,40157,0,1,1
11439,6,2,40162,40162,40164,0,2,5
11440,6,2,40168,40168,40170,0,2,4
11441,6,1,40174,40174,40175,0,1,4
11442,1,3,40175,40175,40178,0,3,0
11443,6,1,40181,40181,40182,0,1,3
11444,1,1,40182,40182,40183,0,1,0
11445,5,3,40187,40187,40190,0,3,4
11446,1,3,40188,40190,40193,2,5,0
11447,3,1,40191,40193,40194,2,3,0
11448,2,1,40193,40194,40195,1,2,0
11449,3,1,40196,40196,40197,0,1,1
11450,5,2,40201,40201,40203,0,2,4
11451,2,1,40203,40203,40204,0,1,0
11452,5,2,40208,40208,40210,0,2,4
11453,4,3,40212,40212,40215,0,3,2
11454,5,1,40217,40217,40218,0,1,2
11455,6,2,40223,40223,40225,0,2,5
11456,2,3,40225,40225,40228,0,3,0
11457,4,1,40229,40229,40230,0,1,1
11458,1,3,40230,40230,40233,0,3,0
11459,4,3,40234,40234,40237,0,3,1
11460,1,1,40235,40237,40238,2,3,0
11461,3,1,40238,40238,40239,0,1,0
11462,6,1,40244,40244,40245,0,1,5
11463,3,3,40247,40247,40250,0,3,2
11464,1,1,40248,40250,40251,2,3,0
11465,5,3,40253,40253,40256,0,3,2
11466,1,1,40254,40256,40257,2,3,0
11467,3,2,40257,40257,40259,0,2,0
11468,4,1,40261,40261,40262,0,1,2
11469,4,1,40265,40265,40266,0,1,3
11470,2,1,40267,40267,40268,0,1,1
11471,4,2,40271,40271,40273,0,2,3
11472,6,2,40277,40277,40279,0,2,4
11473,3,1,40280,40280,40281,0,1,1
11474,6,3,40286,40286,40289,0,3,5
11475,5,1,40291,40291,40292,0,1,2
11476,2,1,40293,40293,40294,0,1,1
11477,5,2,40298,40298,40300,0,2,4
11478,5,3,40303,40303,40306,0,3,3
11479,6,3,40309,40309,40312,0,3,3
11480,3,2,40312,40312,40314,0,2,0
11481,3,3,40315,40315,40318,0,3,1
11482,3,2,40318,40318,40320,0,2,0
11483,5,3,40323,40323,40326,0,3,3
11484,1,2,40324,40326,40328,2,4,0
11485,6,3,40330,40330,40333,0,3,2
11486,1,2,40331,40333,40335,2,4,0
11487,6,1,40337,40337,40338,0,1,2
11488,3,1,40340,40340,40341,0,1,2
11489,4,1,40344,40344,40345,0,1,3
11490,6,2,40350,40350,40352,0,2,5
11491,2,1,40352,40352,40353,0,1,0
11492,5,3,40357,40357,40360,0,3,4
11493,6,3,40363,40363,40366,0,3,3
11494,5,3,40368,40368,40371,0,3,2
11495,6,3,40374,40374,40377,0,3,3
11496,5,2,40379,40379,40381,0,2,2
11497,1,1,40380,40381,40382,1,2,0
11498,1,1,40381,40382,40383,1,2,0
11499,2,2,40383,40383,40385,0,2,0
11500,5,3,40388,40388,40391,0,3,3
11501,6,3,40394,40394,40397,0,3,3
11502,4,1,40398,40398,40399,0,1,1
11503,6,1,40404,40404,40405,0,1,5
11504,5,1,40409,40409,40410,0,1,4
11505,4,1,40413,40413,40414,0,1,3
11506,1,1,40414,40414,40415,0,1,0
11507,2,3,40416,40416,40419,0,3,1
11508,5,1,40421,40421,40422,0,1,2
11509,6,2,40427,40427,40429,0,2,5
11510,4,1,40431,40431,40432,0,1,2
11511,5,3,40436,40436,40439,0,3,4
11512,3,2,40439,40439,40441,0,2,0
11513,3,1,40442,40442,40443,0,1,1
11514,2,1,40444,40444,40445,0,1,1
11515,1,2,40445,40445,40447,0,2,0
11516,1,1,40446,40447,40448,1,2,0
11517,4,2,40450,40450,40452,0,2,2
11518,2,3,40452,40452,40455,0,3,0
11519,5,1,40457,40457,40458,0,1,2
11520,6,2,40463,40463,40465,0,2,5
11521,5,1,40468,40468,40469,0,1,3
11522,1,1,40469,40469,40470,0,1,0
11523,2,1,40471,40471,40472,0,1,1
11524,6,3,40477,40477,40480,0,3,5
11525,1,2,40478,40480,40482,2,4,0
11526,6,2,40484,40484,40486,0,2,2
11527,3,1,40487,40487,40488,0,1,1
11528,2,3,40489,40489,40492,0,3,1
11529,1,3,40490,40492,40495,2,5,0
11530,4,1,40494,40495,40496,1,2,0
11531,3,3,40497,40497,40500,0,3,1
11532,1,3,40498,40500,40503,2,5,0
11533,3,2,40501,40503,40505,2,4,0
11534,2,1,40503,40505,40506,2,3,0
11535,3,3,40506,40506,40509,0,3,0
11536,6,3,40512,40512,40515,0,3,3
11537,2,1,40514,40515,40516,1,2,0
11538,3,1,40517,40517,40518,0,1,1
11539,5,3,40522,40522,40525,0,3,4
11540,1,3,40523,40525,40528,2,5,0
11541,6,1,40529,40529,40530,0,1,1
11542,5,1,40534,40534,40535,0,1,4
11543,5,1,40539,40539,40540,0,1,4
11544,2,3,40541,40541,40544,0,3,1
11545,6,1,40547,40547,40548,0,1,3
11546,1,2,40548,40548,40550,0,2,0
11547,4,2,40552,40552,40554,0,2,2
11548,2,1,40554,40554,40555,0,1,0
11549,5,1,40559,40559,40560,0,1,4
11550,1,3,40560,40560,40563,0,3,0
11551,5,3,40565,40565,40568,0,3,2
11552,4,2,40569,40569,40571,0,2,1
11553,2,2,40571,40571,40573,0,2,0
11554,2,3,40573,40573,40576,0,3,0
11555,1,1,40574,40576,40577,2,3,0
11556,6,2,40580,40580,40582,0,2,3
11557,6,2,40586,40586,40588,0,2,4
11558,3,1,40589,40589,40590,0,1,1
11559,4,1,40593,40593,40594,0,1,3
11560,3,3,40596,40596,40599,0,3,2
11561,6,1,40602,40602,40603,0,1,3
11562,3,1,40605,40605,40606,0,1,2
11563,1,2,40606,40606,40608,0,2,0
11564,4,3,40610,40610,40613,0,3,2
11565,6,2,40616,40616,40618,0,2,3
11566,6,2,40622,40622,40624,0,2,4
11567,5,1,40627,40627,40628,0,1,3
11568,5,2,40632,40632,40634,0,2,4
11569,6,1,40638,40638,40639,0,1,4
11570,3,1,40641,40641,40642,0,1,2
11571,1,1,40642,40642,40643,0,1,0
11572,2,3,40644,40644,40647,0,3,1
11573,3,1,40647,40647,40648,0,1,0
11574,1,2,40648,40648,40650,0,2,0
11575,3,1,40651,40651,40652,0,1,1
11576,1,1,40652,40652,40653,0,1,0
11577,2,1,40654,40654,40655,0,1,1
11578,1,1,40655,40655,40656,0,1,0
11579,3,3,40658,40658,40661,0,3,2
11580,6,1,40664,40664,40665,0,1,3
11581,3,2,40667,40667,40669,0,2,2
11582,5,2,40672,40672,40674,0,2,3
11583,6,2,40678,40678,40680,0,2,4
11584,4,2,40682,40682,40684,0,2,2
11585,6,3,40688,40688,40691,0,3,4
11586,6,1,40694,40694,40695,0,1,3
11587,4,3,40698,40698,40701,0,3,3
11588,2,1,40700,40701,40702,1,2,0
11589,5,1,40705,40705,40706,0,1,3
11590,3,1,40708,40708,40709,0,1,2
11591,2,2,40710,40710,40712,0,2,1
11592,6,2,40716,40716,40718,0,2,4
11593,4,3,40720,40720,40723,0,3,2
11594,1,1,40721,40723,40724,2,3,0
11595,1,1,40722,40724,40725,2,3,0
11596,3,1,40725,40725,40726,0,1,0
11597,1,2,40726,40726,40728,0,2,0
11598,4,2,40730,40730,40732,0,2,2
11599,2,1,40732,40732,40733,0,1,0
11600,6,2,40738,40738,40740,0,2,5
11601,2,1,40740,40740,40741,0,1,0
11602,4,3,40744,40744,40747,0,3,3
11603,4,3,40748,40748,40751,0,3,1
11604,4,1,40752,40752,40753,0,1,1
11605,1,1,40753,40753,40754,0,1,0
11606,1,2,40754,40754,40756,0,2,0
11607,3,2,40757,40757,40759,0,2,1
11608,4,3,40761,40761,40764,0,3,2
11609,6,2,40767,40767,40769,0,2,3
11610,1,1,40768,40769,40770,1,2,0
11611,6,3,40774,40774,40777,0,3,4
11612,3,1,40777,40777,40778,0,1,0
11613,2,2,40779,40779,40781,0,2,1
11614,2,2,40781,40781,40783,0,2,0
11615,4,2,40785,40785,40787,0,2,2
11616,5,2,40790,40790,40792,0,2,3
11617,4,1,40794,40794,40795,0,1,2
11618,5,2,40799,40799,40801,0,2,4
11619,4,2,40803,40803,40805,0,2,2
11620,3,1,40806,40806,40807,0,1,1
11621,5,3,40811,40811,40814,0,3,4
11622,3,2,40814,40814,40816,0,2,0
11623,6,2,40820,40820,40822,0,2,4
11624,2,1,40822,40822,40823,0,1,0
11625,4,3,40826,40826,40829,0,3,3
11626,4,3,40830,40830,40833,0,3,1
11627,6,2,40836,40836,40838,0,2,3
11628,5,1,40841,40841,40842,0,1,3
11629,4,2,40845,40845,40847,0,2,3
11630,4,3,40849,40849,40852,0,3,2
11631,1,2,40850,40852,40854,2,4,0
11632,3,3,40853,40854,40857,1,4,0
11633,5,2,40858,40858,40860,0,2,1
11634,5,1,40863,40863,40864,0,1,3
11635,6,3,40869,40869,40872,0,3,5
11636,4,1,40873,40873,40874,0,1,1
11637,5,3,40878,40878,40881,0,3,4
11638,6,3,40884,40884,40887,0,3,3
11639,4,2,40888,40888,40890,0,2,1
11640,5,2,40893,40893,40895,0,2,3
11641,1,3,40894,40895,40898,1,4,0
11642,3,2,40897,40898,40900,1,3,0
11643,1,2,40898,40900,40902,2,4,0
11644,2,2,40900,40902,40904,2,4,0
11645,2,3,40902,40904,40907,2,5,0
11646,5,2,40907,40907,40909,0,2,0
11647,4,1,40911,40911,40912,0,1,2
11648,5,1,40916,40916,40917,0,1,4
11649,3,1,40919,40919,40920,0,1,2
11650,3,3,40922,40922,40925,0,3,2
11651,2,2,40924,40925,40927,1,3,0
11652,4,3,40928,40928,40931,0,3,1
11653,5,2,40933,40933,40935,0,2,2
11654,4,1,40937,40937,40938,0,1,2
11655,2,1,40939,40939,40940,0,1,1
11656,6,1,40945,40945,40946,0,1,5
11657,5,3,40950,40950,40953,0,3,4
11658,2,2,40952,40953,40955,1,3,0
11659,6,1,40958,40958,40959,0,1,3
11660,3,2,40961,40961,40963,0,2,2
11661,1,2,40962,40963,40965,1,3,0
11662,3,3,40965,40965,40968,0,3,0
11663,4,2,40969,40969,40971,0,2,1
11664,6,3,40975,40975,40978,0,3,4
11665,3,2,40978,40978,40980,0,2,0
11666,4,2,40982,40982,40984,0,2,2
11667,1,3,40983,40984,40987,1,4,0
11668,4,3,40987,40987,40990,0,3,0
11669,1,1,40988,40990,40991,2,3,0
11670,3,2,40991,40991,40993,0,2,0
11671,1,2,40992,40993,40995,1,3,0
11672,3,3,40995,40995,40998,0,3,0
11673,5,3,41000,41000,41003,0,3,2
11674,3,2,41003,41003,41005,0,2,0
11675,2,1,41005,41005,41006,0,1,0
11676,4,2,41009,41009,41011,0,2,3
11677,3,1,41012,41012,41013,0,1,1
11678,4,3,41016,41016,41019,0,3,3
11679,5,1,41021,41021,41022,0,1,2
11680,2,1,41023,41023,41024,0,1,1
11681,6,1,41029,41029,41030,0,1,5
11682,4,3,41033,41033,41036,0,3,3
11683,4,2,41037,41037,41039,0,2,1
11684,2,1,41039,41039,41040,0,1,0
11685,1,2,41040,41040,41042,0,2,0
11686,6,3,41046,41046,41049,0,3,4
11687,5,3,41051,41051,41054,0,3,2
11688,3,3,41054,41054,41057,0,3,0
11689,2,2,41056,41057,41059,1,3,0
11690,5,1,41061,41061,41062,0,1,2
11691,2,2,41063,41063,41065,0,2,1
11692,3,1,41066,41066,41067,0,1,1
11693,3,3,41069,41069,41072,0,3,2
11694,3,1,41072,41072,41073,0,1,0
11695,5,1,41077,41077,41078,0,1,4
11696,1,2,41078,41078,41080,0,2,0
11697,4,1,41082,41082,41083,0,1,2
11698,2,3,41084,41084,41087,0,3,1
11699,3,1,41087,41087,41088,0,1,0
11700,6,1,41093,41093,41094,0,1,5
11701,4,1,41097,41097,41098,0,1,3
11702,1,1,41098,41098,41099,0,1,0
11703,1,1,41099,41099,41100,0,1,0
11704,2,1,41101,41101,41102,0,1,1
11705,6,2,41107,41107,41109,0,2,5
11706,1,2,41108,41109,41111,1,3,0
11707,2,2,41110,41111,41113,1,3,0
11708,2,3,41112,41113,41116,1,4,0
11709,5,2,41117,41117,41119,0,2,1
11710,2,2,41119,41119,41121,0,2,0
11711,4,1,41123,41123,41124,0,1,2
11712,6,1,41129,41129,41130,0,1,5
11713,3,2,41132,41132,41134,0,2,2
11714,3,2,41135,41135,41137,0,2,1
11715,6,1,41141,41141,41142,0,1,4
11716,5,1,41146,41146,41147,0,1,4
11717,2,2,41148,41148,41150,0,2,1
11718,2,2,41150,41150,41152,0,2,0
11719,2,3,41152,41152,41155,0,3,0
11720,2,3,41154,41155,41158,1,4,0
11721,3,1,41157,41158,41159,1,2,0
11722,4,3,41161,41161,41164,0,3,2
11723,5,2,41166,41166,41168,0,2,2
11724,6,3,41172,41172,41175,0,3,4
11725,2,3,41174,41175,41178,1,4,0
11726,6,2,41180,41180,41182,0,2,2
11727,4,1,41184,41184,41185,0,1,2
11728,1,3,41185,41185,41188,0,3,0
11729,2,1,41187,41188,41189,1,2,0
11730,5,3,41192,41192,41195,0,3,3
11731,1,2,41193,41195,41197,2,4,0
11732,2,2,41195,41197,41199,2,4,0
11733,5,2,41200,41200,41202,0,2,1
11734,3,1,41203,41203,41204,0,1,1
11735,4,2,41207,41207,41209,0,2,3
11736,4,2,41211,41211,41213,0,2,2
11737,1,1,41212,41213,41214,1,2,0
11738,3,1,41215,41215,41216,0,1,1
11739,5,1,41220,41220,41221,0,1,4
11740,6,2,41226,41226,41228,0,2,5
11741,6,2,41232,41232,41234,0,2,4
11742,4,2,41236,41236,41238,0,2,2
11743,5,1,41241,41241,41242,0,1,3
11744,2,2,41243,41243,41245,0,2,1
11745,6,3,41249,41249,41252,0,3,4
11746,5,1,41254,41254,41255,0,1,2
11747,3,1,41257,41257,41258,0,1,2
11748,4,3,41261,41261,41264,0,3,3
11749,2,1,41263,41264,41265,1,2,0
11750,5,3,41268,41268,41271,0,3,3
11751,2,2,41270,41271,41273,1,3,0
11752,4,3,41274,41274,41277,0,3,1
11753,2,1,41276,41277,41278,1,2,0
11754,2,2,41278,41278,41280,0,2,0
11755,4,2,41282,41282,41284,0,2,2
11756,6,3,41288,41288,41291,0,3,4
11757,5,3,41293,41293,41296,0,3,2
11758,5,1,41298,41298,41299,0,1,2
11759,3,1,41301,41301,41302,0,1,2
11760,2,1,41303,41303,41304,0,1,1
11761,5,2,41308,41308,41310,0,2,4
11762,3,2,41311,41311,41313,0,2,1
11763,3,1,41314,41314,41315,0,1,1
11764,3,1,41317,41317,41318,0,1,2
11765,4,2,41321,41321,41323,0,2,3
11766,5,2,41326,41326,41328,0,2,3
11767,6,2,41332,41332,41334,0,2,4
11768,5,2,41337,41337,41339,0,2,3
11769,3,1,41340,41340,41341,0,1,1
11770,3,1,41343,41343,41344,0,1,2
11771,2,1,41345,41345,41346,0,1,1
11772,4,3,41349,41349,41352,0,3,3
11773,2,3,41351,41352,41355,1,4,0
11774,1,2,41352,41355,41357,3,5,0
11775,5,1,41357,41357,41358,0,1,0
11776,4,3,41361,41361,41364,0,3,3
11777,1,1,41362,41364,41365,2,3,0
11778,1,1,41363,41365,41366,2,3,0
11779,1,2,41364,41366,41368,2,4,0
11780,6,3,41370,41370,41373,0,3,2
11781,3,1,41373,41373,41374,0,1,0
11782,5,2,41378,41378,41380,0,2,4
11783,2,1,41380,41380,41381,0,1,0
11784,5,3,41385,41385,41388,0,3,4
11785,1,1,41386,41388,41389,2,3,0
11786,1,1,41387,41389,41390,2,3,0
11787,5,1,41392,41392,41393,0,1,2
11788,5,2,41397,41397,41399,0,2,4
11789,6,1,41403,41403,41404,0,1,4
11790,2,2,41405,41405,41407,0,2,1
11791,3,1,41408,41408,41409,0,1,1
11792,2,3,41410,41410,41413,0,3,1
11793,3,3,41413,41413,41416,0,3,0
11794,2,3,41415,41416,41419,1,4,0
11795,2,1,41417,41419,41420,2,3,0
11796,4,3,41421,41421,41424,0,3,1
11797,2,1,41423,41424,41425,1,2,0
11798,1,3,41424,41425,41428,1,4,0
11799,6,2,41430,41430,41432,0,2,2
11800,4,3,41434,41434,41437,0,3,2
11801,5,2,41439,41439,41441,0,2,2
11802,1,3,41440,41441,41444,1,4,0
11803,3,3,41443,41444,41447,1,4,0
11804,6,2,41449,41449,41451,0,2,2
11805,5,3,41454,41454,41457,0,3,3
11806,1,3,41455,41457,41460,2,5,0
11807,5,1,41460,41460,41461,0,1,0
11808,4,1,41464,41464,41465,0,1,3
11809,5,1,41469,41469,41470,0,1,4
11810,1,1,41470,41470,41471,0,1,0
11811,4,3,41474,41474,41477,0,3,3
11812,6,2,41480,41480,41482,0,2,3
11813,1,1,41481,41482,41483,1,2,0
11814,6,3,41487,41487,41490,0,3,4
11815,3,3,41490,41490,41493,0,3,0
11816,4,2,41494,41494,41496,0,2,1
11817,1,1,41495,41496,41497,1,2,0
11818,4,2,41499,41499,41501,0,2,2
11819,2,2,41501,41501,41503,0,2,0
11820,1,2,41502,41503,41505,1,3,0
11821,6,1,41508,41508,41509,0,1,3
11822,6,1,41514,41514,41515,0,1,5
11823,1,3,41515,41515,41518,0,3,0
11824,4,1,41519,41519,41520,0,1,1
11825,6,1,41525,41525,41526,0,1,5
11826,3,2,41528,41528,41530,0,2,2
11827,5,1,41533,41533,41534,0,1,3
11828,6,1,41539,41539,41540,0,1,5
11829,3,1,41542,41542,41543,0,1,2
11830,3,3,41545,41545,41548,0,3,2
11831,2,3,41547,41548,41551,1,4,0
11832,1,3,41548,41551,41554,3,6,0
11833,1,1,41549,41554,41555,5,6,0
11834,2,2,41551,41555,41557,4,6,0
11835,2,1,41553,41557,41558,4,5,0
11836,5,2,41558,41558,41560,0,2,0
11837,3,3,41561,41561,41564,0,3,1
11838,2,1,41563,41564,41565,1,2,0
11839,3,1,41566,41566,41567,0,1,1
11840,1,3,41567,41567,41570,0,3,0
11841,3,3,41570,41570,41573,0,3,0
11842,1,1,41571,41573,41574,2,3,0
11843,6,3,41577,41577,41580,0,3,3
11844,3,1,41580,41580,41581,0,1,0
11845,1,3,41581,41581,41584,0,3,0
11846,4,1,41585,41585,41586,0,1,1
11847,1,1,41586,41586,41587,0,1,0
11848,1,3,41587,41587,41590,0,3,0
11849,3,1,41590,41590,41591,0,1,0
11850,4,3,41594,41594,41597,0,3,3
11851,6,2,41600,41600,41602,0,2,3
11852,5,2,41605,41605,41607,0,2,3
11853,2,2,41607,41607,41609,0,2,0
11854,4,2,41611,41611,41613,0,2,2
11855,4,2,41615,41615,41617,0,2,2
11856,1,2,41616,41617,41619,1,3,0
11857,5,3,41621,41621,41624,0,3,2
11858,1,1,41622,41624,41625,2,3,0
11859,3,3,41625,41625,41628,0,3,0
11860,2,2,41627,41628,41630,1,3,0
11861,5,2,41632,41632,41634,0,2,2
11862,3,2,41635,41635,41637,0,2,1
11863,2,1,41637,41637,41638,0,1,0
11864,5,2,41642,41642,41644,0,2,4
11865,2,2,41644,41644,41646,0,2,0
11866,2,2,41646,41646,41648,0,2,0
11867,1,2,41647,41648,41650,1,3,0
11868,3,1,41650,41650,41651,0,1,0
11869,2,2,41652,41652,41654,0,2,1
11870,4,2,41656,41656,41658,0,2,2
11871,4,2,41660,41660,41662,0,2,2
11872,5,1,41665,41665,41666,0,1,3
11873,4,2,41669,41669,41671,0,2,3
11874,4,3,41673,41673,41676,0,3,2
11875,2,2,41675,41676,41678,1,3,0
11876,5,1,41680,41680,41681,0,1,2
11877,1,2,41681,41681,41683,0,2,0
11878,4,3,41685,41685,41688,0,3,2
11879,3,1,41688,41688,41689,0,1,0
11880,5,1,41693,41693,41694,0,1,4
11881,3,2,41696,41696,41698,0,2,2
11882,4,1,41700,41700,41701,0,1,2
11883,3,1,41703,41703,41704,0,1,2
11884,3,2,41706,41706,41708,0,2,2
11885,5,1,41711,41711,41712,0,1,3
11886,3,1,41714,41714,41715,0,1,2
11887,3,3,41717,41717,41720,0,3,2
11888,5,3,41722,41722,41725,0,3,2
11889,1,3,41723,41725,41728,2,5,0
11890,1,2,41724,41728,41730,4,6,0
11891,4,2,41728,41730,41732,2,4,0
11892,1,2,41729,41732,41734,3,5,0
11893,4,3,41733,41734,41737,1,4,0
11894,6,3,41739,41739,41742,0,3,2
11895,2,2,41741,41742,41744,1,3,0
11896,1,1,41742,41744,41745,2,3,0
11897,3,1,41745,41745,41746,0,1,0
11898,6,2,41751,41751,41753,0,2,5
11899,3,3,41754,41754,41757,0,3,1
11900,4,2,41758,41758,41760,0,2,1
11901,5,3,41763,41763,41766,0,3,3
11902,3,2,41766,41766,41768,0,2,0
11903,2,2,41768,41768,41770,0,2,0
11904,4,3,41772,41772,41775,0,3,2
11905,1,1,41773,41775,41776,2,3,0
11906,1,2,41774,41776,41778,2,4,0
11907,3,3,41777,41778,41781,1,4,0
11908,4,3,41781,41781,41784,0,3,0
11909,1,1,41782,41784,41785,2,3,0
11910,5,3,41787,41787,41790,0,3,2
11911,4,1,41791,41791,41792,0,1,1
11912,4,3,41795,41795,41798,0,3,3
11913,4,1,41799,41799,41800,0,1,1
11914,2,3,41801,41801,41804,0,3,1
11915,2,1,41803,41804,41805,1,2,0
11916,2,1,41805,41805,41806,0,1,0
11917,3,3,41808,41808,41811,0,3,2
11918,6,2,41814,41814,41816,0,2,3
11919,1,2,41815,41816,41818,1,3,0
11920,2,2,41817,41818,41820,1,3,0
11921,1,3,41818,41820,41823,2,5,0
11922,6,3,41824,41824,41827,0,3,1
11923,1,1,41825,41827,41828,2,3,0
11924,5,3,41830,41830,41833,0,3,2
11925,3,2,41833,41833,41835,0,2,0
11926,4,2,41837,41837,41839,0,2,2
11927,2,3,41839,41839,41842,0,3,0
11928,1,2,41840,41842,41844,2,4,0
11929,2,3,41842,41844,41847,2,5,0
11930,5,3,41847,41847,41850,0,3,0
11931,3,2,41850,41850,41852,0,2,0
11932,5,2,41855,41855,41857,0,2,3
11933,5,2,41860,41860,41862,0,2,3
11934,5,2,41865,41865,41867,0,2,3
11935,3,1,41868,41868,41869,0,1,1
11936,5,2,41873,41873,41875,0,2,4
11937,3,3,41876,41876,41879,0,3,1
11938,2,3,41878,41879,41882,1,4,0
11939,1,3,41879,41882,41885,3,6,0
11940,5,3,41884,41885,41888,1,4,0
11941,4,2,41888,41888,41890,0,2,0
11942,4,2,41892,41892,41894,0,2,2
11943,2,3,41894,41894,41897,0,3,0
11944,3,2,41897,41897,41899,0,2,0
11945,4,3,41901,41901,41904,0,3,2
11946,4,1,41905,41905,41906,0,1,1
11947,5,1,41910,41910,41911,0,1,4
11948,2,2,41912,41912,41914,0,2,1
11949,1,1,41913,41914,41915,1,2,0
11950,6,3,41919,41919,41922,0,3,4
11951,6,3,41925,41925,41928,0,3,3
11952,3,1,41928,41928,41929,0,1,0
11953,4,1,41932,41932,41933,0,1,3
11954,2,3,41934,41934,41937,0,3,1
11955,2,2,41936,41937,41939,1,3,0
11956,6,3,41942,41942,41945,0,3,3
11957,2,2,41944,41945,41947,1,3,0
11958,6,1,41950,41950,41951,0,1,3
11959,5,2,41955,41955,41957,0,2,4
11960,4,3,41959,41959,41962,0,3,2
11961,4,1,41963,41963,41964,0,1,1
11962,2,2,41965,41965,41967,0,2,1
11963,3,1,41968,41968,41969,0,1,1
11964,6,1,41974,41974,41975,0,1,5
11965,3,1,41977,41977,41978,0,1,2
11966,4,2,41981,41981,41983,0,2,3
11967,3,1,41984,41984,41985,0,1,1
11968,2,3,41986,41986,41989,0,3,1
11969,1,2,41987,41989,41991,2,4,0
11970,1,1,41988,41991,41992,3,4,0
11971,5,2,41993,41993,41995,0,2,1
11972,3,2,41996,41996,41998,0,2,1
11973,5,1,42001,42001,42002,0,1,3
11974,2,1,42003,42003,42004,0,1,1
11975,1,3,42004,42004,42007,0,3,0
11976,4,2,42008,42008,42010,0,2,1
11977,5,3,42013,42013,42016,0,3,3
11978,2,2,42015,42016,42018,1,3,0
11979,5,2,42020,42020,42022,0,2,2
11980,4,3,42024,42024,42027,0,3,2
11981,2,3,42026,42027,42030,1,4,0
11982,6,3,42032,42032,42035,0,3,2
11983,1,1,42033,42035,42036,2,3,0
11984,6,1,42039,42039,42040,0,1,3
11985,5,2,42044,42044,42046,0,2,4
11986,1,3,42045,42046,42049,1,4,0
11987,2,3,42047,42049,42052,2,5,0
11988,1,1,42048,42052,42053,4,5,0
11989,1,3,42049,42053,42056,4,7,0
11990,3,1,42052,42056,42057,4,5,0
11991,6,2,42058,42058,42060,0,2,1
11992,6,1,42064,42064,42065,0,1,4
11993,2,1,42066,42066,42067,0,1,1
11994,4,2,42070,42070,42072,0,2,3
11995,1,1,42071,42072,42073,1,2,0
11996,3,2,42074,42074,42076,0,2,1
11997,2,3,42076,42076,42079,0,3,0
11998,1,3,42077,42079,42082,2,5,0
11999,6,3,42083,42083,42086,0,3,1
12000,5,2,42088,42088,42090,0,2,2
12001,3,1,42091,42091,42092,0,1,1
12002,5,2,42096,42096,42098,0,2,4
12003,5,3,42101,42101,42104,0,3,3
12004,6,1,42107,42107,42108,0,1,3
12005,4,3,42111,42111,42114,0,3,3
12006,4,3,42115,42115,42118,0,3,1
12007,4,2,42119,42119,42121,0,2,1
12008,4,2,42123,42123,42125,0,2,2
12009,5,2,42128,42128,42130,0,2,3
12010,5,3,42133,42133,42136,0,3,3
12011,1,1,42134,42136,42137,2,3,0
12012,4,3,42138,42138,42141,0,3,1
12013,5,3,42143,42143,42146,0,3,2
12014,5,2,42148,42148,42150,0,2,2
12015,5,1,42153,42153,42154,0,1,3
12016,6,3,42159,42159,42162,0,3,5
12017,4,1,42163,42163,42164,0,1,1
12018,2,1,42165,42165,42166,0,1,1
12019,3,2,42168,42168,42170,0,2,2
12020,3,2,42171,42171,42173,0,2,1
12021,6,2,42177,42177,42179,0,2,4
12022,2,3,42179,42179,42182,0,3,0
12023,6,2,42185,42185,42187,0,2,3
12024,2,2,42187,42187,42189,0,2,0
12025,2,2,42189,42189,42191,0,2,0
12026,1,2,42190,42191,42193,1,3,0
12027,2,2,42192,42193,42195,1,3,0
12028,2,3,42194,42195,42198,1,4,0
12029,3,3,42197,42198,42201,1,4,0
12030,6,2,42203,42203,42205,0,2,2
12031,4,3,42207,42207,42210,0,3,2
12032,2,1,42209,42210,42211,1,2,0
12033,6,3,42215,42215,42218,0,3,4
12034,4,3,42219,42219,42222,0,3,1
12035,5,1,42224,42224,42225,0,1,2
12036,5,1,42229,42229,42230,0,1,4
12037,6,3,42235,42235,42238,0,3,5
12038,4,3,42239,42239,42242,0,3,1
12039,4,2,42243,42243,42245,0,2,1
12040,2,2,42245,42245,42247,0,2,0
12041,2,3,42247,42247,42250,0,3,0
12042,4,3,42251,42251,42254,0,3,1
12043,2,2,42253,42254,42256,1,3,0
12044,6,3,42259,42259,42262,0,3,3
12045,5,3,42264,42264,42267,0,3,2
12046,4,1,42268,42268,42269,0,1,1
12047,6,3,42274,42274,42277,0,3,5
12048,6,2,42280,42280,42282,0,2,3
12049,4,1,42284,42284,42285,0,1,2
12050,2,1,42286,42286,42287,0,1,1
12051,6,3,42292,42292,42295,0,3,5
12052,5,1,42297,42297,42298,0,1,2
12053,3,1,42300,42300,42301,0,1,2
12054,6,1,42306,42306,42307,0,1,5
12055,4,1,42310,42310,42311,0,1,3
12056,2,1,42312,42312,42313,0,1,1
12057,3,2,42315,42315,42317,0,2,2
12058,2,2,42317,42317,42319,0,2,0
12059,4,3,42321,42321,42324,0,3,2
12060,3,1,42324,42324,42325,0,1,0
12061,5,3,42329,42329,42332,0,3,4
12062,1,3,42330,42332,42335,2,5,0
12063,1,3,42331,42335,42338,4,7,0
12064,4,2,42335,42338,42340,3,5,0
12065,6,1,42341,42341,42342,0,1,1
12066,1,3,42342,42342,42345,0,3,0
12067,3,1,42345,42345,42346,0,1,0
12068,5,3,42350,42350,42353,0,3,4
12069,2,2,42352,42353,42355,1,3,0
12070,6,3,42358,42358,42361,0,3,3
12071,3,2,42361,42361,42363,0,2,0
12072,2,1,42363,42363,42364,0,1,0
12073,1,1,42364,42364,42365,0,1,0
12074,1,3,42365,42365,42368,0,3,0
12075,5,3,42370,42370,42373,0,3,2
12076,4,2,42374,42374,42376,0,2,1
12077,6,3,42380,42380,42383,0,3,4
12078,1,1,42381,42383,42384,2,3,0
12079,1,1,42382,42384,42385,2,3,0
12080,2,3,42384,42385,42388,1,4,0
12081,1,3,42385,42388,42391,3,6,0
12082,4,2,42389,42391,42393,2,4,0
12083,3,2,42392,42393,42395,1,3,0
12084,6,1,42398,42398,42399,0,1,3
12085,6,3,42404,42404,42407,0,3,5
12086,2,1,42406,42407,42408,1,2,0
12087,4,1,42410,42410,42411,0,1,2
12088,2,3,42412,42412,42415,0,3,1
12089,4,2,42416,42416,42418,0,2,1
12090,1,1,42417,42418,42419,1,2,0
12091,6,3,42423,42423,42426,0,3,4
12092,2,3,42425,42426,42429,1,4,0
12093,5,1,42430,42430,42431,0,1,1
12094,1,1,42431,42431,42432,0,1,0
12095,5,2,42436,42436,42438,0,2,4
12096,6,3,42442,42442,42445,0,3,4
12097,5,2,42447,42447,42449,0,2,2
12098,4,2,42451,42451,42453,0,2,2
12099,2,3,42453,42453,42456,0,3,0
12100,3,3,42456,42456,42459,0,3,0
12101,2,3,42458,42459,42462,1,4,0
12102,5,1,42463,42463,42464,0,1,1
12103,1,2,42464,42464,42466,0,2,0
12104,5,1,42469,42469,42470,0,1,3
12105,3,3,42472,42472,42475,0,3,2
12106,5,1,42477,42477,42478,0,1,2
12107,4,2,42481,42481,42483,0,2,3
12108,1,2,42482,42483,42485,1,3,0
12109,6,1,42488,42488,42489,0,1,3
12110,2,1,42490,42490,42491,0,1,1
12111,4,2,42494,42494,42496,0,2,3
12112,2,2,42496,42496,42498,0,2,0
12113,1,2,42497,42498,42500,1,3,0
12114,1,3,42498,42500,42503,2,5,0
12115,5,1,42503,42503,42504,0,1,0
12116,3,3,42506,42506,42509,0,3,2
12117,2,1,42508,42509,42510,1,2,0
12118,6,2,42514,42514,42516,0,2,4
12119,2,2,42516,42516,42518,0,2,0
12120,6,2,42522,42522,42524,0,2,4
12121,2,2,42524,42524,42526,0,2,0
12122,1,3,42525,42526,42529,1,4,0
12123,2,2,42527,42529,42531,2,4,0
12124,6,3,42533,42533,42536,0,3,2
12125,2,2,42535,42536,42538,1,3,0
12126,4,1,42539,42539,42540,0,1,1
12127,1,1,42540,42540,42541,0,1,0
12128,6,2,42546,42546,42548,0,2,5
12129,4,2,42550,42550,42552,0,2,2
12130,1,2,42551,42552,42554,1,3,0
12131,2,3,42553,42554,42557,1,4,0
12132,1,1,42554,42557,42558,3,4,0
12133,1,1,42555,42558,42559,3,4,0
12134,1,1,42556,42559,42560,3,4,0
12135,6,2,42562,42562,42564,0,2,2
12136,4,1,42566,42566,42567,0,1,2
12137,6,3,42572,42572,42575,0,3,5
12138,4,3,42576,42576,42579,0,3,1
12139,1,1,42577,42579,42580,2,3,0
12140,1,2,42578,42580,42582,2,4,0
12141,2,3,42580,42582,42585,2,5,0
12142,4,3,42584,42585,42588,1,4,0
12143,5,3,42589,42589,42592,0,3,1
12144,3,1,42592,42592,42593,0,1,0
12145,1,2,42593,42593,42595,0,2,0
12146,4,2,42597,42597,42599,0,2,2
12147,3,1,42600,42600,42601,0,1,1
12148,5,2,42605,42605,42607,0,2,4
12149,5,1,42610,42610,42611,0,1,3
12150,1,2,42611,42611,42613,0,2,0
12151,6,1,42617,42617,42618,0,1,4
12152,2,1,42619,42619,42620,0,1,1
12153,4,1,42623,42623,42624,0,1,3
12154,4,1,42627,42627,42628,0,1,3
12155,5,2,42632,42632,42634,0,2,4
12156,5,3,42637,42637,42640,0,3,3
12157,2,3,42639,42640,42643,1,4,0
12158,4,1,42643,42643,42644,0,1,0
12159,1,2,42644,42644,42646,0,2,0
12160,5,1,42649,42649,42650,0,1,3
12161,5,1,42654,42654,42655,0,1,4
12162,4,2,42658,42658,42660,0,2,3
12163,1,2,42659,42660,42662,1,3,0
12164,4,2,42663,42663,42665,0,2,1
12165,2,3,42665,42665,42668,0,3,0
12166,5,3,42670,42670,42673,0,3,2
12167,1,2,42671,42673,42675,2,4,0
12168,5,1,42676,42676,42677,0,1,1
12169,6,3,42682,42682,42685,0,3,5
12170,4,3,42686,42686,42689,0,3,1
12171,3,2,42689,42689,42691,0,2,0
12172,6,1,42695,42695,42696,0,1,4
12173,5,3,42700,42700,42703,0,3,4
12174,6,1,42706,42706,42707,0,1,3
12175,4,2,42710,42710,42712,0,2,3
12176,6,2,42716,42716,42718,0,2,4
12177,2,1,42718,42718,42719,0,1,0
12178,4,3,42722,42722,42725,0,3,3
12179,2,1,42724,42725,42726,1,2,0
12180,5,3,42729,42729,42732,0,3,3
12181,5,3,42734,42734,42737,0,3,2
12182,1,3,42735,42737,42740,2,5,0
12183,3,2,42738,42740,42742,2,4,0
12184,4,1,42742,42742,42743,0,1,0
12185,5,1,42747,42747,42748,0,1,4
12186,5,2,42752,42752,42754,0,2,4
12187,3,1,42755,42755,42756,0,1,1
12188,2,3,42757,42757,42760,0,3,1
12189,4,3,42761,42761,42764,0,3,1
12190,2,1,42763,42764,42765,1,2,0
12191,6,3,42769,42769,42772,0,3,4
12192,5,1,42774,42774,42775,0,1,2
12193,4,2,42778,42778,42780,0,2,3
12194,1,1,42779,42780,42781,1,2,0
12195,6,2,42785,42785,42787,0,2,4
12196,6,1,42791,42791,42792,0,1,4
12197,1,1,42792,42792,42793,0,1,0
12198,4,2,42796,42796,42798,0,2,3
12199,3,3,42799,42799,42802,0,3,1
12200,3,2,42802,42802,42804,0,2,0
12201,6,2,42808,42808,42810,0,2,4
12202,5,2,42813,42813,42815,0,2,3
12203,3,3,42816,42816,42819,0,3,1
12204,6,3,42822,42822,42825,0,3,3
12205,5,1,42827,42827,42828,0,1,2
12206,5,2,42832,42832,42834,0,2,4
12207,4,3,42836,42836,42839,0,3,2
12208,6,2,42842,42842,42844,0,2,3
12209,2,1,42844,42844,42845,0,1,0
12210,1,3,42845,42845,42848,0,3,0
12211,3,3,42848,42848,42851,0,3,0
12212,4,1,42852,42852,42853,0,1,1
12213,1,1,42853,42853,42854,0,1,0
12214,5,3,42858,42858,42861,0,3,4
12215,6,2,42864,42864,42866,0,2,3
12216,4,3,42868,42868,42871,0,3,2
12217,1,1,42869,42871,42872,2,3,0
12218,6,1,42875,42875,42876,0,1,3
12219,4,3,42879,42879,42882,0,3,3
12220,4,1,42883,42883,42884,0,1,1
12221,4,3,42887,42887,42890,0,3,3
12222,6,3,42893,42893,42896,0,3,3
12223,2,2,42895,42896,42898,1,3,0
12224,5,3,42900,42900,42903,0,3,2
12225,1,3,42901,42903,42906,2,5,0
12226,6,3,42907,42907,42910,0,3,1
12227,6,2,42913,42913,42915,0,2,3
12228,3,1,42916,42916,42917,0,1,1
12229,3,1,42919,42919,42920,0,1,2
12230,3,1,42922,42922,42923,0,1,2
12231,1,2,42923,42923,42925,0,2,0
12232,2,1,42925,42925,42926,0,1,0
12233,2,1,42927,42927,42928,0,1,1
12234,3,1,42930,42930,42931,0,1,2
12235,3,1,42933,42933,42934,0,1,2
12236,2,2,42935,42935,42937,0,2,1
12237,3,3,42938,42938,42941,0,3,1
12238,3,3,42941,42941,42944,0,3,0
12239,5,2,42946,42946,42948,0,2,2
12240,6,2,42952,42952,42954,0,2,4
12241,5,3,42957,42957,42960,0,3,3
12242,5,3,42962,42962,42965,0,3,2
12243,5,2,42967,42967,42969,0,2,2
12244,1,1,42968,42969,42970,1,2,0
12245,2,2,42970,42970,42972,0,2,0
12246,6,3,42976,42976,42979,0,3,4
12247,6,3,42982,42982,42985,0,3,3
12248,1,1,42983,42985,42986,2,3,0
12249,1,2,42984,42986,42988,2,4,0
12250,4,2,42988,42988,42990,0,2,0
12251,2,3,42990,42990,42993,0,3,0
12252,6,1,42996,42996,42997,0,1,3
12253,3,2,42999,42999,43001,0,2,2
12254,1,1,43000,43001,43002,1,2,0
12255,6,1,43006,43006,43007,0,1,4
12256,1,1,43007,43007,43008,0,1,0
12257,5,3,43012,43012,43015,0,3,4
12258,5,3,43017,43017,43020,0,3,2
12259,1,2,43018,43020,43022,2,4,0
12260,2,1,43020,43022,43023,2,3,0
12261,3,2,43023,43023,43025,0,2,0
12262,4,3,43027,43027,43030,0,3,2
12263,3,1,43030,43030,43031,0,1,0
12264,4,2,43034,43034,43036,0,2,3
12265,2,2,43036,43036,43038,0,2,0
12266,6,3,43042,43042,43045,0,3,4
12267,4,3,43046,43046,43049,0,3,1
12268,4,2,43050,43050,43052,0,2,1
12269,1,2,43051,43052,43054,1,3,0
12270,6,3,43057,43057,43060,0,3,3
12271,4,3,43061,43061,43064,0,3,1
12272,5,1,43066,43066,43067,0,1,2
12273,4,2,43070,43070,43072,0,2,3
12274,4,3,43074,43074,43077,0,3,2
12275,3,1,43077,43077,43078,0,1,0
12276,5,3,43082,43082,43085,0,3,4
12277,5,2,43087,43087,43089,0,2,2
12278,5,2,43092,43092,43094,0,2,3
12279,2,1,43094,43094,43095,0,1,0
12280,6,3,43100,43100,43103,0,3,5
12281,2,3,43102,43103,43106,1,4,0
12282,4,2,43106,43106,43108,0,2,0
12283,1,1,43107,43108,43109,1,2,0
12284,6,2,43113,43113,43115,0,2,4
12285,3,1,43116,43116,43117,0,1,1
12286,3,2,43119,43119,43121,0,2,2
12287,1,2,43120,43121,43123,1,3,0
12288,5,2,43125,43125,43127,0,2,2
12289,6,3,43131,43131,43134,0,3,4
12290,6,3,43137,43137,43140,0,3,3
12291,3,1,43140,43140,43141,0,1,0
12292,6,3,43146,43146,43149,0,3,5
12293,2,2,43148,43149,43151,1,3,0
12294,6,3,43154,43154,43157,0,3,3
12295,5,1,43159,43159,43160,0,1,2
12296,1,2,43160,43160,43162,0,2,0
12297,5,1,43165,43165,43166,0,1,3
12298,4,1,43169,43169,43170,0,1,3
12299,3,1,43172,43172,43173,0,1,2
12300,4,2,43176,43176,43178,0,2,3
12301,3,2,43179,43179,43181,0,2,1
12302,1,2,43180,43181,43183,1,3,0
12303,2,3,43182,43183,43186,1,4,0
12304,6,2,43188,43188,43190,0,2,2
12305,5,3,43193,43193,43196,0,3,3
12306,6,2,43199,43199,43201,0,2,3
12307,2,2,43201,43201,43203,0,2,0
12308,3,1,43204,43204,43205,0,1,1
12309,4,2,43208,43208,43210,0,2,3
12310,2,1,43210,43210,43211,0,1,0
12311,2,1,43212,43212,43213,0,1,1
12312,4,2,43216,43216,43218,0,2,3
12313,6,2,43222,43222,43224,0,2,4
12314,5,2,43227,43227,43229,0,2,3
12315,2,3,43229,43229,43232,0,3,0
12316,5,3,43234,43234,43237,0,3,2
12317,5,1,43239,43239,43240,0,1,2
12318,4,3,43243,43243,43246,0,3,3
12319,1,2,43244,43246,43248,2,4,0
12320,3,2,43247,43248,43250,1,3,0
12321,5,3,43252,43252,43255,0,3,2
12322,1,3,43253,43255,43258,2,5,0
12323,2,3,43255,43258,43261,3,6,0
12324,4,1,43259,43261,43262,2,3,0
12325,4,1,43263,43263,43264,0,1,1
12326,3,1,43266,43266,43267,0,1,2
12327,6,3,43272,43272,43275,0,3,5
12328,4,1,43276,43276,43277,0,1,1
12329,4,1,43280,43280,43281,0,1,3
12330,4,1,43284,43284,43285,0,1,3
12331,4,1,43288,43288,43289,0,1,3
12332,1,3,43289,43289,43292,0,3,0
12333,2,1,43291,43292,43293,1,2,0
12334,1,1,43292,43293,43294,1,2,0
12335,4,1,43296,43296,43297,0,1,2
12336,1,3,43297,43297,43300,0,3,0
12337,1,1,43298,43300,43301,2,3,0
12338,3,3,43301,43301,43304,0,3,0
12339,6,1,43307,43307,43308,0,1,3
12340,2,3,43309,43309,43312,0,3,1
12341,2,3,43311,43312,43315,1,4,0
12342,2,2,43313,43315,43317,2,4,0
12343,3,2,43316,43317,43319,1,3,0
12344,2,1,43318,43319,43320,1,2,0
12345,4,3,43322,43322,43325,0,3,2
12346,5,3,43327,43327,43330,0,3,2
12347,5,1,43332,43332,43333,0,1,2
12348,2,2,43334,43334,43336,0,2,1
12349,3,2,43337,43337,43339,0,2,1
12350,3,2,43340,43340,43342,0,2,1
12351,4,2,43344,43344,43346,0,2,2
12352,1,2,43345,43346,43348,1,3,0
12353,5,1,43350,43350,43351,0,1,2
12354,3,3,43353,43353,43356,0,3,2
12355,4,2,43357,43357,43359,0,2,1
12356,4,3,43361,43361,43364,0,3,2
12357,5,3,43366,43366,43369,0,3,2
12358,6,2,43372,43372,43374,0,2,3
12359,3,1,43375,43375,43376,0,1,1
12360,2,3,43377,43377,43380,0,3,1
12361,3,3,43380,43380,43383,0,3,0
12362,2,3,43382,43383,43386,1,4,0
12363,1,1,43383,43386,43387,3,4,0
12364,1,2,43384,43387,43389,3,5,0
12365,3,2,43387,43389,43391,2,4,0
12366,4,1,43391,43391,43392,0,1,0
12367,6,1,43397,43397,43398,0,1,5
12368,3,1,43400,43400,43401,0,1,2
12369,1,1,43401,43401,43402,0,1,0
12370,6,3,43407,43407,43410,0,3,5
12371,4,2,43411,43411,43413,0,2,1
12372,5,1,43416,43416,43417,0,1,3
12373,5,3,43421,43421,43424,0,3,4
12374,1,3,43422,43424,43427,2,5,0
12375,1,3,43423,43427,43430,4,7,0
12376,5,2,43428,43430,43432,2,4,0
12377,4,3,43432,43432,43435,0,3,0
12378,3,1,43435,43435,43436,0,1,0
12379,1,2,43436,43436,43438,0,2,0
12380,4,3,43440,43440,43443,0,3,2
12381,3,3,43443,43443,43446,0,3,0
12382,5,3,43448,43448,43451,0,3,2
12383,3,2,43451,43451,43453,0,2,0
12384,6,3,43457,43457,43460,0,3,4
12385,3,2,43460,43460,43462,0,2,0
12386,2,1,43462,43462,43463,0,1,0
12387,5,1,43467,43467,43468,0,1,4
12388,2,2,43469,43469,43471,0,2,1
12389,6,2,43475,43475,43477,0,2,4
12390,4,2,43479,43479,43481,0,2,2
12391,3,2,43482,43482,43484,0,2,1
12392,3,2,43485,43485,43487,0,2,1
12393,5,1,43490,43490,43491,0,1,3
12394,1,3,43491,43491,43494,0,3,0
12395,3,3,43494,43494,43497,0,3,0
12396,6,1,43500,43500,43501,0,1,3
12397,1,3,43501,43501,43504,0,3,0
12398,5,1,43506,43506,43507,0,1,2
12399,3,1,43509,43509,43510,0,1,2
12400,6,2,43515,43515,43517,0,2,5
12401,5,1,43520,43520,43521,0,1,3
12402,2,2,43522,43522,43524,0,2,1
12403,3,3,43525,43525,43528,0,3,1
12404,2,2,43527,43528,43530,1,3,0
12405,6,2,43533,43533,43535,0,2,3
12406,4,2,43537,43537,43539,0,2,2
12407,3,3,43540,43540,43543,0,3,1
12408,3,3,43543,43543,43546,0,3,0
12409,5,3,43548,43548,43551,0,3,2
12410,2,2,43550,43551,43553,1,3,0
12411,5,2,43555,43555,43557,0,2,2
12412,1,2,43556,43557,43559,1,3,0
12413,1,1,43557,43559,43560,2,3,0
12414,3,1,43560,43560,43561,0,1,0
12415,4,3,43564,43564,43567,0,3,3
12416,2,3,43566,43567,43570,1,4,0
12417,5,1,43571,43571,43572,0,1,1
12418,4,2,43575,43575,43577,0,2,3
12419,6,1,43581,43581,43582,0,1,4
12420,2,2,43583,43583,43585,0,2,1
12421,4,3,43587,43587,43590,0,3,2
12422,2,3,43589,43590,43593,1,4,0
12423,3,2,43592,43593,43595,1,3,0
12424,4,1,43596,43596,43597,0,1,1
12425,2,2,43598,43598,43600,0,2,1
12426,5,3,43603,43603,43606,0,3,3
12427,3,2,43606,43606,43608,0,2,0
12428,6,2,43612,43612,43614,0,2,4
12429,2,2,43614,43614,43616,0,2,0
12430,2,1,43616,43616,43617,0,1,0
12431,3,2,43619,43619,43621,0,2,2
12432,6,1,43625,43625,43626,0,1,4
12433,6,2,43631,43631,43633,0,2,5
12434,4,1,43635,43635,43636,0,1,2
12435,2,1,43637,43637,43638,0,1,1
12436,5,1,43642,43642,43643,0,1,4
12437,6,3,43648,43648,43651,0,3,5
12438,6,3,43654,43654,43657,0,3,3
12439,5,1,43659,43659,43660,0,1,2
12440,1,1,43660,43660,43661,0,1,0
12441,6,1,43666,43666,43667,0,1,5
12442,6,3,43672,43672,43675,0,3,5
12443,2,1,43674,43675,43676,1,2,0
12444,4,3,43678,43678,43681,0,3,2
12445,4,1,43682,43682,43683,0,1,1
12446,3,1,43685,43685,43686,0,1,2
12447,6,2,43691,43691,43693,0,2,5
12448,6,2,43697,43697,43699,0,2,4
12449,1,2,43698,43699,43701,1,3,0
12450,5,1,43703,43703,43704,0,1,2
12451,1,1,43704,43704,43705,0,1,0
12452,4,3,43708,43708,43711,0,3,3
12453,1,3,43709,43711,43714,2,5,0
12454,4,1,43713,43714,43715,1,2,0
12455,3,1,43716,43716,43717,0,1,1
12456,3,3,43719,43719,43722,0,3,2
12457,6,1,43725,43725,43726,0,1,3
12458,2,2,43727,43727,43729,0,2,1
12459,6,2,43733,43733,43735,0,2,4
12460,6,2,43739,43739,43741,0,2,4
12461,1,1,43740,43741,43742,1,2,0
12462,5,2,43745,43745,43747,0,2,3
12463,4,3,43749,43749,43752,0,3,2
12464,2,1,43751,43752,43753,1,2,0
12465,4,3,43755,43755,43758,0,3,2
12466,6,1,43761,43761,43762,0,1,3
12467,2,1,43763,43763,43764,0,1,1
12468,6,1,43769,43769,43770,0,1,5
12469,6,1,43775,43775,43776,0,1,5
12470,1,2,43776,43776,43778,0,2,0
12471,2,3,43778,43778,43781,0,3,0
12472,1,1,43779,43781,43782,2,3,0
12473,2,2,43781,43782,43784,1,3,0
12474,2,2,43783,43784,43786,1,3,0
12475,6,3,43789,43789,43792,0,3,3
12476,1,3,43790,43792,43795,2,5,0
12477,4,3,43794,43795,43798,1,4,0
12478,6,3,43800,43800,43803,0,3,2
12479,1,2,43801,43803,43805,2,4,0
12480,2,2,43803,43805,43807,2,4,0
12481,2,1,43805,43807,43808,2,3,0
12482,5,1,43810,43810,43811,0,1,2
12483,5,1,43815,43815,43816,0,1,4
12484,5,1,43820,43820,43821,0,1,4
12485,1,1,43821,43821,43822,0,1,0
12486,4,3,43825,43825,43828,0,3,3
12487,5,2,43830,43830,43832,0,2,2
12488,4,3,43834,43834,43837,0,3,2
12489,3,1,43837,43837,43838,0,1,0
12490,5,2,43842,43842,43844,0,2,4
12491,5,1,43847,43847,43848,0,1,3
12492,3,2,43850,43850,43852,0,2,2
12493,5,2,43855,43855,43857,0,2,3
12494,4,1,43859,43859,43860,0,1,2
12495,1,1,43860,43860,43861,0,1,0
12496,4,3,43864,43864,43867,0,3,3
12497,1,1,43865,43867,43868,2,3,0
12498,3,3,43868,43868,43871,0,3,0
12499,4,1,43872,43872,43873,0,1,1
12500,6,1,43878,43878,43879,0,1,5
12501,1,1,43879,43879,43880,0,1,0
12502,1,2,43880,43880,43882,0,2,0
12503,5,3,43885,43885,43888,0,3,3
12504,5,2,43890,43890,43892,0,2,2
12505,4,2,43894,43894,43896,0,2,2
12506,1,1,43895,43896,43897,1,2,0
12507,6,3,43901,43901,43904,0,3,4
12508,1,2,43902,43904,43906,2,4,0
12509,2,1,43904,43906,43907,2,3,0
12510,3,2,43907,43907,43909,0,2,0
12511,5,2,43912,43912,43914,0,2,3
12512,3,1,43915,43915,43916,0,1,1
12513,1,2,43916,43916,43918,0,2,0
12514,1,3,43917,43918,43921,1,4,0
12515,2,3,43919,43921,43924,2,5,0
12516,6,2,43925,43925,43927,0,2,1
12517,4,1,43929,43929,43930,0,1,2
12518,2,3,43931,43931,43934,0,3,1
12519,6,3,43937,43937,43940,0,3,3
12520,1,1,43938,43940,43941,2,3,0
12521,3,3,43941,43941,43944,0,3,0
12522,3,2,43944,43944,43946,0,2,0
12523,4,3,43948,43948,43951,0,3,2
12524,4,1,43952,43952,43953,0,1,1
12525,5,1,43957,43957,43958,0,1,4
12526,6,1,43963,43963,43964,0,1,5
12527,2,2,43965,43965,43967,0,2,1
12528,3,2,43968,43968,43970,0,2,1
12529,3,2,43971,43971,43973,0,2,1
12530,2,2,43973,43973,43975,0,2,0
12531,6,2,43979,43979,43981,0,2,4
12532,3,2,43982,43982,43984,0,2,1
12533,4,1,43986,43986,43987,0,1,2
12534,4,3,43990,43990,43993,0,3,3
12535,1,1,43991,43993,43994,2,3,0
12536,3,1,43994,43994,43995,0,1,0
12537,1,2,43995,43995,43997,0,2,0
12538,2,3,43997,43997,44000,0,3,0
12539,1,1,43998,44000,44001,2,3,0
12540,2,2,44000,44001,44003,1,3,0
12541,1,3,44001,44003,44006,2,5,0
12542,1,2,44002,44006,44008,4,6,0
12543,5,2,44007,44008,44010,1,3,0
12544,2,1,44009,44010,44011,1,2,0
12545,4,2,44013,44013,44015,0,2,2
12546,6,2,44019,44019,44021,0,2,4
12547,2,1,44021,44021,44022,0,1,0
12548,5,3,44026,44026,44029,0,3,4
12549,3,3,44029,44029,44032,0,3,0
12550,2,1,44031,44032,44033,1,2,0
12551,3,1,44034,44034,44035,0,1,1
12552,5,3,44039,44039,44042,0,3,4
12553,2,1,44041,44042,44043,1,2,0
12554,3,3,44044,44044,44047,0,3,1
12555,3,3,44047,44047,44050,0,3,0
12556,6,2,44053,44053,44055,0,2,3
12557,4,3,44057,44057,44060,0,3,2
12558,3,2,44060,44060,44062,0,2,0
12559,2,2,44062,44062,44064,0,2,0
12560,4,2,44066,44066,44068,0,2,2
12561,3,3,44069,44069,44072,0,3,1
12562,4,1,44073,44073,44074,0,1,1
12563,2,3,44075,44075,44078,0,3,1
12564,6,3,44081,44081,44084,0,3,3
12565,5,3,44086,44086,44089,0,3,2
12566,2,3,44088,44089,44092,1,4,0
12567,2,2,44090,44092,44094,2,4,0
12568,5,1,44095,44095,44096,0,1,1
12569,1,2,44096,44096,44098,0,2,0
12570,3,1,44099,44099,44100,0,1,1
12571,2,2,44101,44101,44103,0,2,1
12572,6,3,44107,44107,44110,0,3,4
12573,4,2,44111,44111,44113,0,2,1
12574,5,2,44116,44116,44118,0,2,3
12575,3,2,44119,44119,44121,0,2,1
12576,6,1,44125,44125,44126,0,1,4
12577,4,1,44129,44129,44130,0,1,3
12578,6,3,44135,44135,44138,0,3,5
12579,2,3,44137,44138,44141,1,4,0
12580,1,2,44138,44141,44143,3,5,0
12581,2,3,44140,44143,44146,3,6,0
12582,4,1,44144,44146,44147,2,3,0
12583,6,2,44150,44150,44152,0,2,3
12584,1,1,44151,44152,44153,1,2,0
12585,4,1,44155,44155,44156,0,1,2
12586,4,1,44159,44159,44160,0,1,3
12587,3,1,44162,44162,44163,0,1,2
12588,5,3,44167,44167,44170,0,3,4
12589,5,1,44172,44172,44173,0,1,2
12590,5,3,44177,44177,44180,0,3,4
12591,6,1,44183,44183,44184,0,1,3
12592,4,1,44187,44187,44188,0,1,3
12593,5,1,44192,44192,44193,0,1,4
12594,4,1,44196,44196,44197,0,1,3
12595,3,3,44199,44199,44202,0,3,2
12596,4,3,44203,44203,44206,0,3,1
12597,4,3,44207,44207,44210,0,3,1
12598,4,1,44211,44211,44212,0,1,1
12599,3,2,44214,44214,44216,0,2,2
12600,1,1,44215,44216,44217,1,2,0
12601,5,3,44220,44220,44223,0,3,3
12602,2,3,44222,44223,44226,1,4,0
12603,3,2,44225,44226,44228,1,3,0
12604,3,1,44228,44228,44229,0,1,0
12605,3,2,44231,44231,44233,0,2,2
12606,6,3,44237,44237,44240,0,3,4
12607,1,1,44238,44240,44241,2,3,0
12608,6,1,44244,44244,44245,0,1,3
12609,4,1,44248,44248,44249,0,1,3
12610,1,2,44249,44249,44251,0,2,0
12611,4,3,44253,44253,44256,0,3,2
12612,1,3,44254,44256,44259,2,5,0
12613,1,1,44255,44259,44260,4,5,0
12614,1,3,44256,44260,44263,4,7,0
12615,4,2,44260,44263,44265,3,5,0
12616,4,3,44264,44265,44268,1,4,0
12617,4,2,44268,44268,44270,0,2,0
12618,5,3,44273,44273,44276,0,3,3
12619,2,3,44275,44276,44279,1,4,0
12620,5,1,44280,44280,44281,0,1,1
12621,3,2,44283,44283,44285,0,2,2
12622,4,2,44287,44287,44289,0,2,2
12623,5,3,44292,44292,44295,0,3,3
12624,4,1,44296,44296,44297,0,1,1
12625,6,2,44302,44302,44304,0,2,5
12626,5,3,44307,44307,44310,0,3,3
12627,6,2,44313,44313,44315,0,2,3
12628,2,1,44315,44315,44316,0,1,0
12629,4,3,44319,44319,44322,0,3,3
12630,5,1,44324,44324,44325,0,1,2
12631,3,1,44327,44327,44328,0,1,2
12632,3,1,44330,44330,44331,0,1,2
12633,3,2,44333,44333,44335,0,2,2
12634,5,3,44338,44338,44341,0,3,3
12635,3,2,44341,44341,44343,0,2,0
12636,6,3,44347,44347,44350,0,3,4
12637,2,3,44349,44350,44353,1,4,0
12638,4,2,44353,44353,44355,0,2,0
12639,4,2,44357,44357,44359,0,2,2
12640,3,3,44360,44360,44363,0,3,1
12641,5,3,44365,44365,44368,0,3,2
12642,4,2,44369,44369,44371,0,2,1
12643,5,3,44374,44374,44377,0,3,3
12644,4,2,44378,44378,44380,0,2,1
12645,2,1,44380,44380,44381,0,1,0
12646,3,3,44383,44383,44386,0,3,2
12647,3,3,44386,44386,44389,0,3,0
12648,4,1,44390,44390,44391,0,1,1
12649,2,1,44392,44392,44393,0,1,1
12650,2,1,44394,44394,44395,0,1,1
12651,3,3,44397,44397,44400,0,3,2
12652,5,1,44402,44402,44403,0,1,2
12653,4,1,44406,44406,44407,0,1,3
12654,5,3,44411,44411,44414,0,3,4
12655,5,2,44416,44416,44418,0,2,2
12656,1,3,44417,44418,44421,1,4,0
12657,4,1,44421,44421,44422,0,1,0
12658,5,3,44426,44426,44429,0,3,4
12659,5,3,44431,44431,44434,0,3,2
12660,6,1,44437,44437,44438,0,1,3
12661,6,2,44443,44443,44445,0,2,5
12662,4,2,44447,44447,44449,0,2,2
12663,3,1,44450,44450,44451,0,1,1
12664,1,2,44451,44451,44453,0,2,0
12665,3,1,44454,44454,44455,0,1,1
12666,2,3,44456,44456,44459,0,3,1
12667,4,3,44460,44460,44463,0,3,1
12668,1,2,44461,44463,44465,2,4,0
12669,3,3,44464,44465,44468,1,4,0
12670,3,1,44467,44468,44469,1,2,0
12671,6,3,44473,44473,44476,0,3,4
12672,4,3,44477,44477,44480,0,3,1
12673,6,2,44483,44483,44485,0,2,3
12674,5,2,44488,44488,44490,0,2,3
12675,3,3,44491,44491,44494,0,3,1
12676,4,3,44495,44495,44498,0,3,1
12677,6,1,44501,44501,44502,0,1,3
12678,1,3,44502,44502,44505,0,3,0
12679,3,3,44505,44505,44508,0,3,0
12680,1,2,44506,44508,44510,2,4,0
12681,2,3,44508,44510,44513,2,5,0
12682,4,1,44512,44513,44514,1,2,0
12683,4,1,44516,44516,44517,0,1,2
12684,3,2,44519,44519,44521,0,2,2
12685,1,2,44520,44521,44523,1,3,0
12686,1,2,44521,44523,44525,2,4,0
12687,6,2,44527,44527,44529,0,2,2
12688,4,2,44531,44531,44533,0,2,2
12689,3,2,44534,44534,44536,0,2,1
12690,5,3,44539,44539,44542,0,3,3
12691,2,2,44541,44542,44544,1,3,0
12692,5,2,44546,44546,44548,0,2,2
12693,1,2,44547,44548,44550,1,3,0
12694,4,1,44551,44551,44552,0,1,1
12695,5,1,44556,44556,44557,0,1,4
12696,3,1,44559,44559,44560,0,1,2
12697,1,1,44560,44560,44561,0,1,0
12698,6,1,44566,44566,44567,0,1,5
12699,3,1,44569,44569,44570,0,1,2
12700,1,3,44570,44570,44573,0,3,0
12701,2,1,44572,44573,44574,1,2,0
12702,5,2,44577,44577,44579,0,2,3
12703,6,3,44583,44583,44586,0,3,4
12704,6,2,44589,44589,44591,0,2,3
12705,3,2,44592,44592,44594,0,2,1
12706,2,2,44594,44594,44596,0,2,0
12707,6,3,44600,44600,44603,0,3,4
12708,3,1,44603,44603,44604,0,1,0
12709,3,1,44606,44606,44607,0,1,2
12710,5,1,44611,44611,44612,0,1,4
12711,3,3,44614,44614,44617,0,3,2
12712,5,2,44619,44619,44621,0,2,2
12713,5,3,44624,44624,44627,0,3,3
12714,2,2,44626,44627,44629,1,3,0
12715,3,1,44629,44629,44630,0,1,0
12716,4,2,44633,44633,44635,0,2,3
12717,4,1,44637,44637,44638,0,1,2
12718,3,3,44640,44640,44643,0,3,2
12719,4,3,44644,44644,44647,0,3,1
12720,3,3,44647,44647,44650,0,3,0
12721,5,2,44652,44652,44654,0,2,2
12722,5,3,44657,44657,44660,0,3,3
12723,5,3,44662,44662,44665,0,3,2
12724,1,3,44663,44665,44668,2,5,0
12725,5,2,44668,44668,44670,0,2,0
12726,1,2,44669,44670,44672,1,3,0
12727,2,1,44671,44672,44673,1,2,0
12728,5,1,44676,44676,44677,0,1,3
12729,2,1,44678,44678,44679,0,1,1
12730,1,3,44679,44679,44682,0,3,0
12731,4,2,44683,44683,44685,0,2,1
12732,4,2,44687,44687,44689,0,2,2
12733,2,3,44689,44689,44692,0,3,0
12734,4,1,44693,44693,44694,0,1,1
12735,4,1,44697,44697,44698,0,1,3
12736,4,1,44701,44701,44702,0,1,3
12737,4,2,44705,44705,44707,0,2,3
12738,4,1,44709,44709,44710,0,1,2
12739,2,3,44711,44711,44714,0,3,1
12740,3,1,44714,44714,44715,0,1,0
12741,5,3,44719,44719,44722,0,3,4
12742,1,2,44720,44722,44724,2,4,0
12743,1,2,44721,44724,44726,3,5,0
12744,1,3,44722,44726,44729,4,7,0
12745,6,3,44728,44729,44732,1,4,0
12746,3,3,44731,44732,44735,1,4,0
12747,3,3,44734,44735,44738,1,4,0
12748,3,1,44737,44738,44739,1,2,0
12749,6,3,44743,44743,44746,0,3,4
12750,1,3,44744,44746,44749,2,5,0
12751,5,2,44749,44749,44751,0,2,0
12752,5,2,44754,44754,44756,0,2,3
12753,1,2,44755,44756,44758,1,3,0
12754,6,3,44761,44761,44764,0,3,3
12755,2,2,44763,44764,44766,1,3,0
12756,2,3,44765,44766,44769,1,4,0
12757,5,2,44770,44770,44772,0,2,1
12758,3,1,44773,44773,44774,0,1,1
12759,3,2,44776,44776,44778,0,2,2
12760,2,2,44778,44778,44780,0,2,0
12761,3,2,44781,44781,44783,0,2,1
12762,4,1,44785,44785,44786,0,1,2
12763,1,2,44786,44786,44788,0,2,0
12764,6,2,44792,44792,44794,0,2,4
12765,6,2,44798,44798,44800,0,2,4
12766,6,1,44804,44804,44805,0,1,4
12767,2,1,44806,44806,44807,0,1,1
12768,3,2,44809,44809,44811,0,2,2
12769,3,2,44812,44812,44814,0,2,1
12770,5,3,44817,44817,44820,0,3,3
12771,4,3,44821,44821,44824,0,3,1
12772,5,3,44826,44826,44829,0,3,2
12773,1,3,44827,44829,44832,2,5,0
12774,3,2,44830,44832,44834,2,4,0
12775,5,2,44835,44835,44837,0,2,1
12776,5,3,44840,44840,44843,0,3,3
12777,1,2,44841,44843,44845,2,4,0
12778,4,2,44845,44845,44847,0,2,0
12779,5,1,44850,44850,44851,0,1,3
12780,1,2,44851,44851,44853,0,2,0
12781,2,3,44853,44853,44856,0,3,0
12782,3,3,44856,44856,44859,0,3,0
12783,4,1,44860,44860,44861,0,1,1
12784,1,2,44861,44861,44863,0,2,0
12785,3,2,44864,44864,44866,0,2,1
12786,3,1,44867,44867,44868,0,1,1
12787,1,3,44868,44868,44871,0,3,0
12788,3,2,44871,44871,44873,0,2,0
12789,1,2,44872,44873,44875,1,3,0
12790,1,2,44873,44875,44877,2,4,0
12791,1,2,44874,44877,44879,3,5,0
12792,6,3,44880,44880,44883,0,3,1
12793,5,2,44885,44885,44887,0,2,2
12794,6,2,44891,44891,44893,0,2,4
12795,5,2,44896,44896,44898,0,2,3
12796,1,2,44897,44898,44900,1,3,0
12797,4,2,44901,44901,44903,0,2,1
12798,4,2,44905,44905,44907,0,2,2
12799,4,2,44909,44909,44911,0,2,2
12800,6,2,44915,44915,44917,0,2,4
12801,4,1,44919,44919,44920,0,1,2
12802,4,2,44923,44923,44925,0,2,3
12803,3,2,44926,44926,44928,0,2,1
12804,2,3,44928,44928,44931,0,3,0
12805,3,2,44931,44931,44933,0,2,0
12806,3,3,44934,44934,44937,0,3,1
12807,2,3,44936,44937,44940,1,4,0
12808,1,1,44937,44940,44941,3,4,0
12809,3,3,44940,44941,44944,1,4,0
12810,3,1,44943,44944,44945,1,2,0
12811,1,3,44944,44945,44948,1,4,0
12812,1,3,44945,44948,44951,3,6,0
12813,5,2,44950,44951,44953,1,3,0
12814,1,3,44951,44953,44956,2,5,0
12815,6,3,44957,44957,44960,0,3,1
12816,3,3,44960,44960,44963,0,3,0
12817,5,3,44965,44965,44968,0,3,2
12818,2,3,44967,44968,44971,1,4,0
12819,5,1,44972,44972,44973,0,1,1
12820,5,3,44977,44977,44980,0,3,4
12821,3,1,44980,44980,44981,0,1,0
12822,5,3,44985,44985,44988,0,3,4
12823,2,3,44987,44988,44991,1,4,0
12824,6,2,44993,44993,44995,0,2,2
12825,2,2,44995,44995,44997,0,2,0
12826,3,2,44998,44998,45000,0,2,1
12827,3,3,45001,45001,45004,0,3,1
12828,6,3,45007,45007,45010,0,3,3
12829,4,3,45011,45011,45014,0,3,1
12830,3,3,45014,45014,45017,0,3,0
12831,5,1,45019,45019,45020,0,1,2
12832,4,2,45023,45023,45025,0,2,3
12833,3,3,45026,45026,45029,0,3,1
12834,4,2,45030,45030,45032,0,2,1
12835,6,1,45036,45036,45037,0,1,4
12836,2,2,45038,45038,45040,0,2,1
12837,2,1,45040,45040,45041,0,1,0
12838,3,3,45043,45043,45046,0,3,2
12839,3,3,45046,45046,45049,0,3,0
12840,1,3,45047,45049,45052,2,5,0
12841,5,3,45052,45052,45055,0,3,0
12842,3,1,45055,45055,45056,0,1,0
12843,1,1,45056,45056,45057,0,1,0
12844,3,3,45059,45059,45062,0,3,2
12845,4,2,45063,45063,45065,0,2,1
12846,2,1,45065,45065,45066,0,1,0
12847,1,1,45066,45066,45067,0,1,0
12848,1,1,45067,45067,45068,0,1,0
12849,5,2,45072,45072,45074,0,2,4
12850,4,3,45076,45076,45079,0,3,2
12851,5,1,45081,45081,45082,0,1,2
12852,6,2,45087,45087,45089,0,2,5
12853,5,2,45092,45092,45094,0,2,3
12854,1,1,45093,45094,45095,1,2,0
12855,5,1,45098,45098,45099,0,1,3
12856,5,2,45103,45103,45105,0,2,4
12857,2,2,45105,45105,45107,0,2,0
12858,6,1,45111,45111,45112,0,1,4
12859,4,2,45115,45115,45117,0,2,3
12860,3,3,45118,45118,45121,0,3,1
12861,6,2,45124,45124,45126,0,2,3
12862,4,1,45128,45128,45129,0,1,2
12863,2,3,45130,45130,45133,0,3,1
12864,6,2,45136,45136,45138,0,2,3
12865,6,2,45142,45142,45144,0,2,4
12866,2,1,45144,45144,45145,0,1,0
12867,5,2,45149,45149,45151,0,2,4
12868,4,1,45153,45153,45154,0,1,2
12869,1,3,45154,45154,45157,0,3,0
12870,2,2,45156,45157,45159,1,3,0
12871,3,1,45159,45159,45160,0,1,0
12872,5,2,45164,45164,45166,0,2,4
12873,6,2,45170,45170,45172,0,2,4
12874,6,3,45176,45176,45179,0,3,4
12875,6,3,45182,45182,45185,0,3,3
12876,6,1,45188,45188,45189,0,1,3
12877,4,1,45192,45192,45193,0,1,3
12878,6,1,45198,45198,45199,0,1,5
12879,2,3,45200,45200,45203,0,3,1
12880,4,2,45204,45204,45206,0,2,1
12881,2,2,45206,45206,45208,0,2,0
12882,1,1,45207,45208,45209,1,2,0
12883,3,2,45210,45210,45212,0,2,1
12884,4,3,45214,45214,45217,0,3,2
12885,2,1,45216,45217,45218,1,2,0
12886,3,3,45219,45219,45222,0,3,1
12887,1,2,45220,45222,45224,2,4,0
12888,3,2,45223,45224,45226,1,3,0
12889,2,3,45225,45226,45229,1,4,0
12890,1,2,45226,45229,45231,3,5,0
12891,6,2,45232,45232,45234,0,2,1
12892,1,2,45233,45234,45236,1,3,0
12893,1,2,45234,45236,45238,2,4,0
12894,1,2,45235,45238,45240,3,5,0
12895,6,3,45241,45241,45244,0,3,1
12896,2,2,45243,45244,45246,1,3,0
12897,2,1,45245,45246,45247,1,2,0
12898,6,1,45251,45251,45252,0,1,4
12899,2,3,45253,45253,45256,0,3,1
12900,1,1,45254,45256,45257,2,3,0
12901,5,2,45259,45259,45261,0,2,2
12902,1,2,45260,45261,45263,1,3,0
12903,4,3,45264,45264,45267,0,3,1
12904,1,3,45265,45267,45270,2,5,0
12905,3,1,45268,45270,45271,2,3,0
12906,5,2,45273,45273,45275,0,2,2
12907,2,3,45275,45275,45278,0,3,0
12908,1,1,45276,45278,45279,2,3,0
12909,4,2,45280,45280,45282,0,2,1
12910,2,2,45282,45282,45284,0,2,0
12911,2,2,45284,45284,45286,0,2,0
12912,4,3,45288,45288,45291,0,3,2
12913,2,1,45290,45291,45292,1,2,0
12914,2,2,45292,45292,45294,0,2,0
12915,2,2,45294,45294,45296,0,2,0
12916,1,3,45295,45296,45299,1,4,0
12917,3,2,45298,45299,45301,1,3,0
12918,4,1,45302,45302,45303,0,1,1
12919,3,3,45305,45305,45308,0,3,2
12920,2,3,45307,45308,45311,1,4,0
12921,3,2,45310,45311,45313,1,3,0
12922,6,1,45316,45316,45317,0,1,3
12923,4,1,45320,45320,45321,0,1,3
12924,5,3,45325,45325,45328,0,3,4
12925,6,1,45331,45331,45332,0,1,3
12926,6,3,45337,45337,45340,0,3,5
12927,6,1,45343,45343,45344,0,1,3
12928,1,3,45344,45344,45347,0,3,0
12929,1,1,45345,45347,45348,2,3,0
12930,1,3,45346,45348,45351,2,5,0
12931,1,3,45347,45351,45354,4,7,0
12932,4,3,45351,45354,45357,3,6,0
12933,3,2,45354,45357,45359,3,5,0
12934,5,2,45359,45359,45361,0,2,0
12935,4,3,45363,45363,45366,0,3,2
12936,2,2,45365,45366,45368,1,3,0
12937,3,3,45368,45368,45371,0,3,0
12938,1,2,45369,45371,45373,2,4,0
12939,5,1,45374,45374,45375,0,1,1
12940,5,3,45379,45379,45382,0,3,4
12941,6,2,45385,45385,45387,0,2,3
12942,4,2,45389,45389,45391,0,2,2
12943,2,3,45391,45391,45394,0,3,0
12944,3,2,45394,45394,45396,0,2,0
12945,4,2,45398,45398,45400,0,2,2
12946,4,2,45402,45402,45404,0,2,2
12947,3,3,45405,45405,45408,0,3,1
12948,3,3,45408,45408,45411,0,3,0
12949,2,3,45410,45411,45414,1,4,0
12950,1,3,45411,45414,45417,3,6,0
12951,2,2,45413,45417,45419,4,6,0
12952,4,3,45417,45419,45422,2,5,0
12953,2,2,45419,45422,45424,3,5,0
12954,6,1,45425,45425,45426,0,1,1
12955,1,1,45426,45426,45427,0,1,0
12956,2,3,45428,45428,45431,0,3,1
12957,6,2,45434,45434,45436,0,2,3
12958,1,2,45435,45436,45438,1,3,0
12959,6,1,45441,45441,45442,0,1,3
12960,6,3,45447,45447,45450,0,3,5
12961,5,3,45452,45452,45455,0,3,2
12962,6,3,45458,45458,45461,0,3,3
12963,1,1,45459,45461,45462,2,3,0
12964,5,1,45464,45464,45465,0,1,2
12965,3,3,45467,45467,45470,0,3,2
12966,4,2,45471,45471,45473,0,2,1
12967,1,2,45472,45473,45475,1,3,0
12968,6,1,45478,45478,45479,0,1,3
12969,5,3,45483,45483,45486,0,3,4
12970,1,1,45484,45486,45487,2,3,0
12971,6,2,45490,45490,45492,0,2,3
12972,4,3,45494,45494,45497,0,3,2
12973,1,3,45495,45497,45500,2,5,0
12974,5,3,45500,45500,45503,0,3,0
12975,5,1,45505,45505,45506,0,1,2
12976,2,1,45507,45507,45508,0,1,1
12977,3,2,45510,45510,45512,0,2,2
12978,3,3,45513,45513,45516,0,3,1
12979,6,3,45519,45519,45522,0,3,3
12980,3,3,45522,45522,45525,0,3,0
12981,5,3,45527,45527,45530,0,3,2
12982,5,2,45532,45532,45534,0,2,2
12983,4,2,45536,45536,45538,0,2,2
12984,5,3,45541,45541,45544,0,3,3
12985,2,1,45543,45544,45545,1,2,0
12986,4,3,45547,45547,45550,0,3,2
12987,2,1,45549,45550,45551,1,2,0
12988,1,2,45550,45551,45553,1,3,0
12989,3,3,45553,45553,45556,0,3,0
12990,3,3,45556,45556,45559,0,3,0
12991,2,2,45558,45559,45561,1,3,0
12992,1,2,45559,45561,45563,2,4,0
12993,6,2,45565,45565,45567,0,2,2
12994,4,1,45569,45569,45570,0,1,2
12995,4,2,45573,45573,45575,0,2,3
12996,4,3,45577,45577,45580,0,3,2
12997,1,2,45578,45580,45582,2,4,0
12998,1,2,45579,45582,45584,3,5,0
12999,5,2,45584,45584,45586,0,2,0
13000,3,1,45587,45587,45588,0,1,1
13001,5,3,45592,45592,45595,0,3,4
13002,6,3,45598,45598,45601,0,3,3
13003,4,3,45602,45602,45605,0,3,1
13004,5,1,45607,45607,45608,0,1,2
13005,4,2,45611,45611,45613,0,2,3
13006,2,2,45613,45613,45615,0,2,0
13007,1,3,45614,45615,45618,1,4,0
13008,6,3,45620,45620,45623,0,3,2
13009,5,1,45625,45625,45626,0,1,2
13010,2,1,45627,45627,45628,0,1,1
13011,1,2,45628,45628,45630,0,2,0
13012,2,1,45630,45630,45631,0,1,0
13013,1,2,45631,45631,45633,0,2,0
13014,6,3,45637,45637,45640,0,3,4
13015,1,3,45638,45640,45643,2,5,0
13016,3,2,45641,45643,45645,2,4,0
13017,6,3,45647,45647,45650,0,3,2
13018,5,2,45652,45652,45654,0,2,2
13019,6,1,45658,45658,45659,0,1,4
13020,2,1,45660,45660,45661,0,1,1
13021,3,3,45663,45663,45666,0,3,2
13022,5,2,45668,45668,45670,0,2,2
13023,1,3,45669,45670,45673,1,4,0
13024,3,1,45672,45673,45674,1,2,0
13025,1,2,45673,45674,45676,1,3,0
13026,5,3,45678,45678,45681,0,3,2
13027,1,3,45679,45681,45684,2,5,0
13028,2,2,45681,45684,45686,3,5,0
13029,6,3,45687,45687,45690,0,3,1
13030,2,2,45689,45690,45692,1,3,0
13031,4,2,45693,45693,45695,0,2,1
13032,1,3,45694,45695,45698,1,4,0
13033,1,3,45695,45698,45701,3,6,0
13034,1,3,45696,45701,45704,5,8,0
13035,6,3,45702,45704,45707,2,5,0
13036,5,2,45707,45707,45709,0,2,0
13037,2,3,45709,45709,45712,0,3,0
13038,1,3,45710,45712,45715,2,5,0
13039,3,3,45713,45715,45718,2,5,0
13040,2,3,45715,45718,45721,3,6,0
13041,1,3,45716,45721,45724,5,8,0
13042,4,3,45720,45724,45727,4,7,0
13043,5,2,45725,45727,45729,2,4,0
13044,5,1,45730,45730,45731,0,1,1
13045,2,1,45732,45732,45733,0,1,1
13046,1,3,45733,45733,45736,0,3,0
13047,6,3,45739,45739,45742,0,3,3
13048,2,2,45741,45742,45744,1,3,0
13049,1,3,45742,45744,45747,2,5,0
13050,5,3,45747,45747,45750,0,3,0
13051,2,1,45749,45750,45751,1,2,0
13052,2,2,45751,45751,45753,0,2,0
13053,5,3,45756,45756,45759,0,3,3
13054,4,1,45760,45760,45761,0,1,1
13055,5,1,45765,45765,45766,0,1,4
13056,1,1,45766,45766,45767,0,1,0
13057,6,2,45772,45772,45774,0,2,5
13058,4,1,45776,45776,45777,0,1,2
13059,2,1,45778,45778,45779,0,1,1
13060,1,1,45779,45779,45780,0,1,0
13061,1,1,45780,45780,45781,0,1,0
13062,6,3,45786,45786,45789,0,3,5
13063,3,1,45789,45789,45790,0,1,0
13064,4,1,45793,45793,45794,0,1,3
13065,5,3,45798,45798,45801,0,3,4
13066,6,1,45804,45804,45805,0,1,3
13067,2,2,45806,45806,45808,0,2,1
13068,5,3,45811,45811,45814,0,3,3
13069,4,1,45815,45815,45816,0,1,1
13070,1,2,45816,45816,45818,0,2,0
13071,2,3,45818,45818,45821,0,3,0
13072,3,2,45821,45821,45823,0,2,0
13073,1,2,45822,45823,45825,1,3,0
13074,2,1,45824,45825,45826,1,2,0
13075,3,1,45827,45827,45828,0,1,1
13076,4,1,45831,45831,45832,0,1,3
13077,5,3,45836,45836,45839,0,3,4
13078,3,3,45839,45839,45842,0,3,0
13079,4,1,45843,45843,45844,0,1,1
13080,5,3,45848,45848,45851,0,3,4
13081,5,2,45853,45853,45855,0,2,2
13082,1,1,45854,45855,45856,1,2,0
13083,5,3,45859,45859,45862,0,3,3
13084,5,2,45864,45864,45866,0,2,2
13085,6,2,45870,45870,45872,0,2,4
13086,5,3,45875,45875,45878,0,3,3
13087,3,3,45878,45878,45881,0,3,0
13088,1,1,45879,45881,45882,2,3,0
13089,4,3,45883,45883,45886,0,3,1
13090,3,3,45886,45886,45889,0,3,0
13091,4,2,45890,45890,45892,0,2,1
13092,5,3,45895,45895,45898,0,3,3
13093,6,2,45901,45901,45903,0,2,3
13094,5,2,45906,45906,45908,0,2,3
13095,4,2,45910,45910,45912,0,2,2
13096,1,2,45911,45912,45914,1,3,0
13097,5,1,45916,45916,45917,0,1,2
13098,3,3,45919,45919,45922,0,3,2
13099,4,1,45923,45923,45924,0,1,1
13100,4,1,45927,45927,45928,0,1,3
13101,2,2,45929,45929,45931,0,2,1
13102,2,3,45931,45931,45934,0,3,0
13103,1,3,45932,45934,45937,2,5,0
13104,6,3,45938,45938,45941,0,3,1
13105,5,2,45943,45943,45945,0,2,2
13106,6,3,45949,45949,45952,0,3,4
13107,1,3,45950,45952,45955,2,5,0
13108,1,3,45951,45955,45958,4,7,0
13109,4,3,45955,45958,45961,3,6,0
13110,1,2,45956,45961,45963,5,7,0
13111,6,3,45962,45963,45966,1,4,0
13112,4,3,45966,45966,45969,0,3,0
13113,3,1,45969,45969,45970,0,1,0
13114,6,2,45975,45975,45977,0,2,5
13115,3,1,45978,45978,45979,0,1,1
13116,3,3,45981,45981,45984,0,3,2
13117,2,1,45983,45984,45985,1,2,0
13118,2,2,45985,45985,45987,0,2,0
13119,3,1,45988,45988,45989,0,1,1
13120,5,3,45993,45993,45996,0,3,4
13121,4,2,45997,45997,45999,0,2,1
13122,5,1,46002,46002,46003,0,1,3
13123,3,3,46005,46005,46008,0,3,2
13124,2,3,46007,46008,46011,1,4,0
13125,5,1,46012,46012,46013,0,1,1
13126,5,2,46017,46017,46019,0,2,4
13127,1,1,46018,46019,46020,1,2,0
13128,5,2,46023,46023,46025,0,2,3
13129,4,3,46027,46027,46030,0,3,2
13130,1,2,46028,46030,46032,2,4,0
13131,4,2,46032,46032,46034,0,2,0
13132,1,2,46033,46034,46036,1,3,0
13133,1,2,46034,46036,46038,2,4,0
13134,6,1,46040,46040,46041,0,1,2
13135,5,3,46045,46045,46048,0,3,4
13136,2,3,46047,46048,46051,1,4,0
13137,1,3,46048,46051,46054,3,6,0
13138,1,3,46049,46054,46057,5,8,0
13139,1,2,46050,46057,46059,7,9,0
13140,5,1,46055,46059,46060,4,5,0
13141,5,1,46060,46060,46061,0,1,0
13142,6,2,46066,46066,46068,0,2,5
13143,6,2,46072,46072,46074,0,2,4
13144,5,2,46077,46077,46079,0,2,3
13145,2,1,46079,46079,46080,0,1,0
13146,2,3,46081,46081,46084,0,3,1
13147,3,3,46084,46084,46087,0,3,0
13148,6,2,46090,46090,46092,0,2,3
13149,4,3,46094,46094,46097,0,3,2
13150,3,3,46097,46097,46100,0,3,0
13151,5,3,46102,46102,46105,0,3,2
13152,5,2,46107,46107,46109,0,2,2
13153,1,1,46108,46109,46110,1,2,0
13154,5,1,46113,46113,46114,0,1,3
13155,1,2,46114,46114,46116,0,2,0
13156,6,1,46120,46120,46121,0,1,4
13157,6,1,46126,46126,46127,0,1,5
13158,6,2,46132,46132,46134,0,2,5
13159,3,1,46135,46135,46136,0,1,1
13160,6,2,46141,46141,46143,0,2,5
13161,5,2,46146,46146,46148,0,2,3
13162,1,2,46147,46148,46150,1,3,0
13163,4,1,46151,46151,46152,0,1,1
13164,6,2,46157,46157,46159,0,2,5
13165,3,1,46160,46160,46161,0,1,1
13166,5,3,46165,46165,46168,0,3,4
13167,4,2,46169,46169,46171,0,2,1
13168,6,2,46175,46175,46177,0,2,4
13169,6,2,46181,46181,46183,0,2,4
13170,6,2,46187,46187,46189,0,2,4
13171,1,3,46188,46189,46192,1,4,0
13172,4,3,46192,46192,46195,0,3,0
13173,5,2,46197,46197,46199,0,2,2
13174,4,1,46201,46201,46202,0,1,2
13175,3,1,46204,46204,46205,0,1,2
13176,6,1,46210,46210,46211,0,1,5
13177,6,3,46216,46216,46219,0,3,5
13178,4,3,46220,46220,46223,0,3,1
13179,4,2,46224,46224,46226,0,2,1
13180,3,3,46227,46227,46230,0,3,1
13181,4,2,46231,46231,46233,0,2,1
13182,5,3,46236,46236,46239,0,3,3
13183,5,1,46241,46241,46242,0,1,2
13184,4,1,46245,46245,46246,0,1,3
13185,1,2,46246,46246,46248,0,2,0
13186,6,1,46252,46252,46253,0,1,4
13187,3,3,46255,46255,46258,0,3,2
13188,2,1,46257,46258,46259,1,2,0
13189,1,2,46258,46259,46261,1,3,0
13190,1,1,46259,46261,46262,2,3,0
13191,6,1,46265,46265,46266,0,1,3
13192,3,3,46268,46268,46271,0,3,2
13193,6,1,46274,46274,46275,0,1,3
13194,1,1,46275,46275,46276,0,1,0
13195,3,3,46278,46278,46281,0,3,2
13196,4,1,46282,46282,46283,0,1,1
13197,1,2,46283,46283,46285,0,2,0
13198,4,1,46287,46287,46288,0,1,2
13199,4,2,46291,46291,46293,0,2,3
13200,3,2,46294,46294,46296,0,2,1
13201,2,2,46296,46296,46298,0,2,0
13202,5,2,46301,46301,46303,0,2,3
13203,2,2,46303,46303,46305,0,2,0
13204,6,3,46309,46309,46312,0,3,4
13205,4,3,46313,46313,46316,0,3,1
13206,3,3,46316,46316,46319,0,3,0
13207,5,2,46321,46321,46323,0,2,2
13208,3,3,46324,46324,46327,0,3,1
13209,4,3,46328,46328,46331,0,3,1
13210,6,3,46334,46334,46337,0,3,3
13211,3,1,46337,46337,46338,0,1,0
13212,5,1,46342,46342,46343,0,1,4
13213,2,1,46344,46344,46345,0,1,1
13214,6,1,46350,46350,46351,0,1,5
13215,4,2,46354,46354,46356,0,2,3
13216,6,3,46360,46360,46363,0,3,4
13217,1,2,46361,46363,46365,2,4,0
13218,3,2,46364,46365,46367,1,3,0
13219,4,1,46368,46368,46369,0,1,1
13220,6,2,46374,46374,46376,0,2,5
13221,6,1,46380,46380,46381,0,1,4
13222,4,1,46384,46384,46385,0,1,3
13223,2,2,46386,46386,46388,0,2,1
13224,6,3,46392,46392,46395,0,3,4
13225,5,1,46397,46397,46398,0,1,2
13226,3,3,46400,46400,46403,0,3,2
13227,1,3,46401,46403,46406,2,5,0
13228,6,3,46407,46407,46410,0,3,1
13229,1,2,46408,46410,46412,2,4,0
13230,5,3,46413,46413,46416,0,3,1
13231,6,3,46419,46419,46422,0,3,3
13232,5,1,46424,46424,46425,0,1,2
13233,3,1,46427,46427,46428,0,1,2
13234,5,2,46432,46432,46434,0,2,4
13235,6,1,46438,46438,46439,0,1,4
13236,5,2,46443,46443,46445,0,2,4
13237,1,2,46444,46445,46447,1,3,0
13238,1,3,46445,46447,46450,2,5,0
13239,4,2,46449,46450,46452,1,3,0
13240,2,2,46451,46452,46454,1,3,0
13241,6,3,46457,46457,46460,0,3,3
13242,6,2,46463,46463,46465,0,2,3
13243,2,3,46465,46465,46468,0,3,0
13244,2,2,46467,46468,46470,1,3,0
13245,3,2,46470,46470,46472,0,2,0
13246,6,1,46476,46476,46477,0,1,4
13247,4,3,46480,46480,46483,0,3,3
13248,2,1,46482,46483,46484,1,2,0
13249,4,2,46486,46486,46488,0,2,2
13250,6,3,46492,46492,46495,0,3,4
13251,2,1,46494,46495,46496,1,2,0
13252,4,3,46498,46498,46501,0,3,2
13253,2,1,46500,46501,46502,1,2,0
13254,2,3,46502,46502,46505,0,3,0
13255,3,3,46505,46505,46508,0,3,0
13256,5,1,46510,46510,46511,0,1,2
13257,1,3,46511,46511,46514,0,3,0
13258,4,3,46515,46515,46518,0,3,1
13259,1,2,46516,46518,46520,2,4,0
13260,5,1,46521,46521,46522,0,1,1
13261,1,2,46522,46522,46524,0,2,0
13262,2,3,46524,46524,46527,0,3,0
13263,3,1,46527,46527,46528,0,1,0
13264,4,2,46531,46531,46533,0,2,3
13265,2,1,46533,46533,46534,0,1,0
13266,6,1,46539,46539,46540,0,1,5
13267,6,2,46545,46545,46547,0,2,5
13268,2,2,46547,46547,46549,0,2,0
13269,6,3,46553,46553,46556,0,3,4
13270,4,1,46557,46557,46558,0,1,1
13271,6,3,46563,46563,46566,0,3,5
13272,4,2,46567,46567,46569,0,2,1
13273,6,3,46573,46573,46576,0,3,4
13274,3,1,46576,46576,46577,0,1,0
13275,2,3,46578,46578,46581,0,3,1
13276,6,3,46584,46584,46587,0,3,3
13277,4,3,46588,46588,46591,0,3,1
13278,2,3,46590,46591,46594,1,4,0
13279,6,1,46596,46596,46597,0,1,2
13280,6,3,46602,46602,46605,0,3,5
13281,4,3,46606,46606,46609,0,3,1
13282,2,2,46608,46609,46611,1,3,0
13283,3,3,46611,46611,46614,0,3,0
13284,4,2,46615,46615,46617,0,2,1
13285,3,2,46618,46618,46620,0,2,1
13286,2,2,46620,46620,46622,0,2,0
13287,3,2,46623,46623,46625,0,2,1
13288,6,1,46629,46629,46630,0,1,4
13289,2,1,46631,46631,46632,0,1,1
13290,2,2,46633,46633,46635,0,2,1
13291,1,3,46634,46635,46638,1,4,0
13292,2,2,46636,46638,46640,2,4,0
13293,6,1,46642,46642,46643,0,1,2
13294,6,2,46648,46648,46650,0,2,5
13295,2,3,46650,46650,46653,0,3,0
13296,3,2,46653,46653,46655,0,2,0
13297,2,1,46655,46655,46656,0,1,0
13298,6,3,46661,46661,46664,0,3,5
13299,3,3,46664,46664,46667,0,3,0
13300,5,1,46669,46669,46670,0,1,2
13301,5,1,46674,46674,46675,0,1,4
13302,4,3,46678,46678,46681,0,3,3
13303,2,1,46680,46681,46682,1,2,0
13304,2,1,46682,46682,46683,0,1,0
13305,2,1,46684,46684,46685,0,1,1
13306,5,1,46689,46689,46690,0,1,4
13307,4,1,46693,46693,46694,0,1,3
13308,2,2,46695,46695,46697,0,2,1
13309,4,1,46699,46699,46700,0,1,2
13310,2,1,46701,46701,46702,0,1,1
13311,1,2,46702,46702,46704,0,2,0
13312,2,2,46704,46704,46706,0,2,0
13313,2,1,46706,46706,46707,0,1,0
13314,2,3,46708,46708,46711,0,3,1
13315,1,2,46709,46711,46713,2,4,0
13316,3,2,46712,46713,46715,1,3,0
13317,5,2,46717,46717,46719,0,2,2
13318,5,2,46722,46722,46724,0,2,3
13319,3,1,46725,46725,46726,0,1,1
13320,5,1,46730,46730,46731,0,1,4
13321,3,2,46733,46733,46735,0,2,2
13322,1,2,46734,46735,46737,1,3,0
13323,5,3,46739,46739,46742,0,3,2
13324,5,3,46744,46744,46747,0,3,2
13325,4,2,46748,46748,46750,0,2,1
13326,6,1,46754,46754,46755,0,1,4
13327,4,1,46758,46758,46759,0,1,3
13328,1,2,46759,46759,46761,0,2,0
13329,6,1,46765,46765,46766,0,1,4
13330,4,1,46769,46769,46770,0,1,3
13331,2,2,46771,46771,46773,0,2,1
13332,1,2,46772,46773,46775,1,3,0
13333,2,1,46774,46775,46776,1,2,0
13334,2,1,46776,46776,46777,0,1,0
13335,6,1,46782,46782,46783,0,1,5
13336,3,1,46785,46785,46786,0,1,2
13337,1,1,46786,46786,46787,0,1,0
13338,6,1,46792,46792,46793,0,1,5
13339,5,2,46797,46797,46799,0,2,4
13340,2,3,46799,46799,46802,0,3,0
13341,3,3,46802,46802,46805,0,3,0
13342,6,2,46808,46808,46810,0,2,3
13343,3,1,46811,46811,46812,0,1,1
13344,5,1,46816,46816,46817,0,1,4
13345,2,2,46818,46818,46820,0,2,1
13346,2,1,46820,46820,46821,0,1,0
13347,6,1,46826,46826,46827,0,1,5
13348,5,3,46831,46831,46834,0,3,4
13349,2,1,46833,46834,46835,1,2,0
13350,1,1,46834,46835,46836,1,2,0
13351,2,2,46836,46836,46838,0,2,0
13352,2,2,46838,46838,46840,0,2,0
13353,3,3,46841,46841,46844,0,3,1
13354,1,3,46842,46844,46847,2,5,0
13355,6,2,46848,46848,46850,0,2,1
13356,2,1,46850,46850,46851,0,1,0
13357,4,3,46854,46854,46857,0,3,3
13358,5,2,46859,46859,46861,0,2,2
13359,2,3,46861,46861,46864,0,3,0
13360,5,2,46866,46866,46868,0,2,2
13361,1,3,46867,46868,46871,1,4,0
13362,4,1,46871,46871,46872,0,1,0
13363,5,3,46876,46876,46879,0,3,4
13364,4,2,46880,46880,46882,0,2,1
13365,1,2,46881,46882,46884,1,3,0
13366,4,2,46885,46885,46887,0,2,1
13367,5,3,46890,46890,46893,0,3,3
13368,4,3,46894,46894,46897,0,3,1
13369,5,1,46899,46899,46900,0,1,2
13370,6,3,46905,46905,46908,0,3,5
13371,4,3,46909,46909,46912,0,3,1
13372,2,1,46911,46912,46913,1,2,0
13373,2,1,46913,46913,46914,0,1,0
13374,6,2,46919,46919,46921,0,2,5
13375,3,2,46922,46922,46924,0,2,1
13376,4,2,46926,46926,46928,0,2,2
13377,1,2,46927,46928,46930,1,3,0
13378,5,1,46932,46932,46933,0,1,2
13379,1,1,46933,46933,46934,0,1,0
13380,3,3,46936,46936,46939,0,3,2
13381,3,1,46939,46939,46940,0,1,0
13382,3,2,46942,46942,46944,0,2,2
13383,5,2,46947,46947,46949,0,2,3
13384,5,3,46952,46952,46955,0,3,3
13385,4,2,46956,46956,46958,0,2,1
13386,3,2,46959,46959,46961,0,2,1
13387,5,1,46964,46964,46965,0,1,3
13388,1,3,46965,46965,46968,0,3,0
13389,4,2,46969,46969,46971,0,2,1
13390,5,1,46974,46974,46975,0,1,3
13391,3,2,46977,46977,46979,0,2,2
13392,6,2,46983,46983,46985,0,2,4
13393,1,2,46984,46985,46987,1,3,0
13394,5,2,46989,46989,46991,0,2,2
13395,4,3,46993,46993,46996,0,3,2
13396,4,3,46997,46997,47000,0,3,1
13397,5,3,47002,47002,47005,0,3,2
13398,4,2,47006,47006,47008,0,2,1
13399,6,3,47012,47012,47015,0,3,4
13400,6,1,47018,47018,47019,0,1,3
13401,2,3,47020,47020,47023,0,3,1
13402,1,3,47021,47023,47026,2,5,0
13403,1,3,47022,47026,47029,4,7,0
13404,3,1,47025,47029,47030,4,5,0
13405,6,2,47031,47031,47033,0,2,1
13406,2,1,47033,47033,47034,0,1,0
13407,3,3,47036,47036,47039,0,3,2
13408,6,2,47042,47042,47044,0,2,3
13409,1,2,47043,47044,47046,1,3,0
13410,4,3,47047,47047,47050,0,3,1
13411,5,2,47052,47052,47054,0,2,2
13412,5,2,47057,47057,47059,0,2,3
13413,1,2,47058,47059,47061,1,3,0
13414,4,3,47062,47062,47065,0,3,1
13415,6,3,47068,47068,47071,0,3,3
13416,6,3,47074,47074,47077,0,3,3
13417,5,3,47079,47079,47082,0,3,2
13418,6,2,47085,47085,47087,0,2,3
13419,3,2,47088,47088,47090,0,2,1
13420,6,3,47094,47094,47097,0,3,4
13421,4,3,47098,47098,47101,0,3,1
13422,1,2,47099,47101,47103,2,4,0
13423,6,1,47105,47105,47106,0,1,2
13424,4,1,47109,47109,47110,0,1,3
13425,1,3,47110,47110,47113,0,3,0
13426,1,1,47111,47113,47114,2,3,0
13427,5,3,47116,47116,47119,0,3,2
13428,1,2,47117,47119,47121,2,4,0
13429,2,2,47119,47121,47123,2,4,0
13430,6,1,47125,47125,47126,0,1,2
13431,3,1,47128,47128,47129,0,1,2
13432,3,3,47131,47131,47134,0,3,2
13433,2,2,47133,47134,47136,1,3,0
13434,6,2,47139,47139,47141,0,2,3
13435,6,1,47145,47145,47146,0,1,4
13436,1,1,47146,47146,47147,0,1,0
13437,3,3,47149,47149,47152,0,3,2
13438,5,1,47154,47154,47155,0,1,2
13439,3,2,47157,47157,47159,0,2,2
13440,5,1,47162,47162,47163,0,1,3
13441,4,2,47166,47166,47168,0,2,3
13442,5,1,47171,47171,47172,0,1,3
13443,4,2,47175,47175,47177,0,2,3
13444,5,3,47180,47180,47183,0,3,3
13445,6,3,47186,47186,47189,0,3,3
13446,5,2,47191,47191,47193,0,2,2
13447,2,1,47193,47193,47194,0,1,0
13448,3,1,47196,47196,47197,0,1,2
13449,6,1,47202,47202,47203,0,1,5
13450,3,1,47205,47205,47206,0,1,2
13451,2,2,47207,47207,47209,0,2,1
13452,5,2,47212,47212,47214,0,2,3
13453,4,2,47216,47216,47218,0,2,2
13454,5,3,47221,47221,47224,0,3,3
13455,4,2,47225,47225,47227,0,2,1
13456,1,3,47226,47227,47230,1,4,0
13457,6,1,47232,47232,47233,0,1,2
13458,6,1,47238,47238,47239,0,1,5
13459,3,3,47241,47241,47244,0,3,2
13460,1,3,47242,47244,47247,2,5,0
13461,6,3,47248,47248,47251,0,3,1
13462,6,3,47254,47254,47257,0,3,3
13463,4,1,47258,47258,47259,0,1,1
13464,1,3,47259,47259,47262,0,3,0
13465,2,3,47261,47262,47265,1,4,0
13466,5,2,47266,47266,47268,0,2,1
13467,4,1,47270,47270,47271,0,1,2
13468,5,1,47275,47275,47276,0,1,4
13469,1,3,47276,47276,47279,0,3,0
13470,4,3,47280,47280,47283,0,3,1
13471,6,3,47286,47286,47289,0,3,3
13472,4,3,47290,47290,47293,0,3,1
13473,2,3,47292,47293,47296,1,4,0
13474,3,1,47295,47296,47297,1,2,0
13475,4,2,47299,47299,47301,0,2,2
13476,5,1,47304,47304,47305,0,1,3
13477,5,3,47309,47309,47312,0,3,4
13478,4,2,47313,47313,47315,0,2,1
13479,6,2,47319,47319,47321,0,2,4
13480,2,1,47321,47321,47322,0,1,0
13481,5,2,47326,47326,47328,0,2,4
13482,6,1,47332,47332,47333,0,1,4
13483,2,1,47334,47334,47335,0,1,1
13484,1,3,47335,47335,47338,0,3,0
13485,2,2,47337,47338,47340,1,3,0
13486,6,3,47343,47343,47346,0,3,3
13487,4,3,47347,47347,47350,0,3,1
13488,3,2,47350,47350,47352,0,2,0
13489,5,2,47355,47355,47357,0,2,3
13490,6,3,47361,47361,47364,0,3,4
13491,5,1,47366,47366,47367,0,1,2
13492,3,1,47369,47369,47370,0,1,2
13493,5,2,47374,47374,47376,0,2,4
13494,2,1,47376,47376,47377,0,1,0
13495,2,3,47378,47378,47381,0,3,1
13496,5,3,47383,47383,47386,0,3,2
13497,5,2,47388,47388,47390,0,2,2
13498,1,3,47389,47390,47393,1,4,0
13499,3,2,47392,47393,47395,1,3,0
13500,1,1,47393,47395,47396,2,3,0
13501,2,1,47395,47396,47397,1,2,0
13502,5,3,47400,47400,47403,0,3,3
13503,4,3,47404,47404,47407,0,3,1
13504,3,1,47407,47407,47408,0,1,0
13505,6,3,47413,47413,47416,0,3,5
13506,2,3,47415,47416,47419,1,4,0
13507,4,1,47419,47419,47420,0,1,0
13508,3,1,47422,47422,47423,0,1,2
13509,5,3,47427,47427,47430,0,3,4
13510,4,3,47431,47431,47434,0,3,1
13511,6,2,47437,47437,47439,0,2,3
13512,5,3,47442,47442,47445,0,3,3
13513,2,1,47444,47445,47446,1,2,0
13514,1,2,47445,47446,47448,1,3,0
13515,4,3,47449,47449,47452,0,3,1
13516,1,2,47450,47452,47454,2,4,0
13517,1,3,47451,47454,47457,3,6,0
13518,3,3,47454,47457,47460,3,6,0
13519,3,3,47457,47460,47463,3,6,0
13520,4,3,47461,47463,47466,2,5,0
13521,2,3,47463,47466,47469,3,6,0
13522,6,1,47469,47469,47470,0,1,0
13523,4,2,47473,47473,47475,0,2,3
13524,3,1,47476,47476,47477,0,1,1
13525,4,2,47480,47480,47482,0,2,3
13526,4,3,47484,47484,47487,0,3,2
13527,3,2,47487,47487,47489,0,2,0
13528,1,1,47488,47489,47490,1,2,0
13529,1,2,47489,47490,47492,1,3,0
13530,1,3,47490,47492,47495,2,5,0
13531,4,2,47494,47495,47497,1,3,0
13532,3,3,47497,47497,47500,0,3,0
13533,3,3,47500,47500,47503,0,3,0
13534,2,3,47502,47503,47506,1,4,0
13535,4,3,47506,47506,47509,0,3,0
13536,2,2,47508,47509,47511,1,3,0
13537,2,2,47510,47511,47513,1,3,0
13538,3,1,47513,47513,47514,0,1,0
13539,3,3,47516,47516,47519,0,3,2
13540,4,2,47520,47520,47522,0,2,1
13541,5,1,47525,47525,47526,0,1,3
13542,6,3,47531,47531,47534,0,3,5
13543,5,2,47536,47536,47538,0,2,2
13544,5,2,47541,47541,47543,0,2,3
13545,3,2,47544,47544,47546,0,2,1
13546,6,3,47550,47550,47553,0,3,4
13547,4,2,47554,47554,47556,0,2,1
13548,5,1,47559,47559,47560,0,1,3
13549,4,3,47563,47563,47566,0,3,3
13550,3,3,47566,47566,47569,0,3,0
13551,4,1,47570,47570,47571,0,1,1
13552,6,2,47576,47576,47578,0,2,5
13553,4,3,47580,47580,47583,0,3,2
13554,4,3,47584,47584,47587,0,3,1
13555,6,3,47590,47590,47593,0,3,3
13556,5,2,47595,47595,47597,0,2,2
13557,1,1,47596,47597,47598,1,2,0
13558,4,2,47600,47600,47602,0,2,2
13559,2,1,47602,47602,47603,0,1,0
13560,5,3,47607,47607,47610,0,3,4
13561,4,2,47611,47611,47613,0,2,1
13562,5,1,47616,47616,47617,0,1,3
13563,5,2,47621,47621,47623,0,2,4
13564,5,1,47626,47626,47627,0,1,3
13565,6,3,47632,47632,47635,0,3,5
13566,2,1,47634,47635,47636,1,2,0
13567,2,2,47636,47636,47638,0,2,0
13568,1,3,47637,47638,47641,1,4,0
13569,5,1,47642,47642,47643,0,1,1
13570,2,1,47644,47644,47645,0,1,1
13571,1,3,47645,47645,47648,0,3,0
13572,1,2,47646,47648,47650,2,4,0
13573,2,1,47648,47650,47651,2,3,0
13574,4,2,47652,47652,47654,0,2,1
13575,6,1,47658,47658,47659,0,1,4
13576,4,1,47662,47662,47663,0,1,3
13577,1,1,47663,47663,47664,0,1,0
13578,2,1,47665,47665,47666,0,1,1
13579,4,2,47669,47669,47671,0,2,3
13580,5,2,47674,47674,47676,0,2,3
13581,5,2,47679,47679,47681,0,2,3
13582,4,1,47683,47683,47684,0,1,2
13583,2,3,47685,47685,47688,0,3,1
13584,5,1,47690,47690,47691,0,1,2
13585,4,3,47694,47694,47697,0,3,3
13586,1,2,47695,47697,47699,2,4,0
13587,5,3,47700,47700,47703,0,3,1
13588,1,3,47701,47703,47706,2,5,0
13589,2,1,47703,47706,47707,3,4,0
13590,1,3,47704,47707,47710,3,6,0
13591,1,2,47705,47710,47712,5,7,0
13592,6,2,47711,47712,47714,1,3,0
13593,3,3,47714,47714,47717,0,3,0
13594,1,1,47715,47717,47718,2,3,0
13595,4,3,47719,47719,47722,0,3,1
13596,6,3,47725,47725,47728,0,3,3
13597,2,1,47727,47728,47729,1,2,0
13598,3,1,47730,47730,47731,0,1,1
13599,3,1,47733,47733,47734,0,1,2
13600,5,2,47738,47738,47740,0,2,4
13601,5,2,47743,47743,47745,0,2,3
13602,4,2,47747,47747,47749,0,2,2
13603,6,1,47753,47753,47754,0,1,4
13604,6,3,47759,47759,47762,0,3,5
13605,6,1,47765,47765,47766,0,1,3
13606,2,2,47767,47767,47769,0,2,1
13607,3,3,47770,47770,47773,0,3,1
13608,5,1,47775,47775,47776,0,1,2
13609,4,2,47779,47779,47781,0,2,3
13610,3,3,47782,47782,47785,0,3,1
13611,5,2,47787,47787,47789,0,2,2
13612,5,1,47792,47792,47793,0,1,3
13613,1,1,47793,47793,47794,0,1,0
13614,2,2,47795,47795,47797,0,2,1
13615,4,2,47799,47799,47801,0,2,2
13616,6,3,47805,47805,47808,0,3,4
13617,3,1,47808,47808,47809,0,1,0
13618,6,1,47814,47814,47815,0,1,5
13619,4,2,47818,47818,47820,0,2,3
13620,6,3,47824,47824,47827,0,3,4
13621,3,2,47827,47827,47829,0,2,0
13622,5,1,47832,47832,47833,0,1,3
13623,6,1,47838,47838,47839,0,1,5
13624,4,2,47842,47842,47844,0,2,3
13625,2,3,47844,47844,47847,0,3,0
13626,5,3,47849,47849,47852,0,3,2
13627,2,1,47851,47852,47853,1,2,0
13628,3,2,47854,47854,47856,0,2,1
13629,3,1,47857,47857,47858,0,1,1
13630,2,2,47859,47859,47861,0,2,1
13631,4,3,47863,47863,47866,0,3,2
13632,5,2,47868,47868,47870,0,2,2
13633,3,1,47871,47871,47872,0,1,1
13634,4,3,47875,47875,47878,0,3,3
13635,2,1,47877,47878,47879,1,2,0
13636,2,1,47879,47879,47880,0,1,0
13637,6,2,47885,47885,47887,0,2,5
13638,1,3,47886,47887,47890,1,4,0
13639,1,2,47887,47890,47892,3,5,0
13640,6,2,47893,47893,47895,0,2,1
13641,4,3,47897,47897,47900,0,3,2
13642,5,1,47902,47902,47903,0,1,2
13643,5,2,47907,47907,47909,0,2,4
13644,5,2,47912,47912,47914,0,2,3
13645,5,2,47917,47917,47919,0,2,3
13646,2,3,47919,47919,47922,0,3,0
13647,6,3,47925,47925,47928,0,3,3
13648,5,1,47930,47930,47931,0,1,2
13649,3,1,47933,47933,47934,0,1,2
13650,1,2,47934,47934,47936,0,2,0
13651,2,2,47936,47936,47938,0,2,0
13652,6,1,47942,47942,47943,0,1,4
13653,5,1,47947,47947,47948,0,1,4
13654,3,1,47950,47950,47951,0,1,2
13655,5,3,47955,47955,47958,0,3,4
13656,6,3,47961,47961,47964,0,3,3
13657,5,3,47966,47966,47969,0,3,2
13658,6,1,47972,47972,47973,0,1,3
13659,4,3,47976,47976,47979,0,3,3
13660,6,1,47982,47982,47983,0,1,3
13661,3,2,47985,47985,47987,0,2,2
13662,1,2,47986,47987,47989,1,3,0
13663,2,1,47988,47989,47990,1,2,0
13664,3,2,47991,47991,47993,0,2,1
13665,3,2,47994,47994,47996,0,2,1
13666,2,2,47996,47996,47998,0,2,0
13667,4,1,48000,48000,48001,0,1,2
13668,3,3,48003,48003,48006,0,3,2
13669,6,1,48009,48009,48010,0,1,3
13670,3,1,48012,48012,48013,0,1,2
13671,3,1,48015,48015,48016,0,1,2
13672,4,1,48019,48019,48020,0,1,3
13673,2,2,48021,48021,48023,0,2,1
13674,5,3,48026,48026,48029,0,3,3
13675,4,3,48030,48030,48033,0,3,1
13676,4,2,48034,48034,48036,0,2,1
13677,3,2,48037,48037,48039,0,2,1
13678,1,3,48038,48039,48042,1,4,0
13679,6,1,48044,48044,48045,0,1,2
13680,4,3,48048,48048,48051,0,3,3
13681,4,1,48052,48052,48053,0,1,1
13682,3,1,48055,48055,48056,0,1,2
13683,6,2,48061,48061,48063,0,2,5
13684,2,3,48063,48063,48066,0,3,0
13685,1,1,48064,48066,48067,2,3,0
13686,6,1,48070,48070,48071,0,1,3
13687,6,1,48076,48076,48077,0,1,5
13688,1,2,48077,48077,48079,0,2,0
13689,4,2,48081,48081,48083,0,2,2
13690,3,1,48084,48084,48085,0,1,1
13691,6,2,48090,48090,48092,0,2,5
13692,1,1,48091,48092,48093,1,2,0
13693,3,2,48094,48094,48096,0,2,1
13694,6,2,48100,48100,48102,0,2,4
13695,4,1,48104,48104,48105,0,1,2
13696,6,3,48110,48110,48113,0,3,5
13697,3,2,48113,48113,48115,0,2,0
13698,2,3,48115,48115,48118,0,3,0
13699,6,2,48121,48121,48123,0,2,3
13700,3,2,48124,48124,48126,0,2,1
13701,4,2,48128,48128,48130,0,2,2
13702,6,3,48134,48134,48137,0,3,4
13703,2,2,48136,48137,48139,1,3,0
13704,2,3,48138,48139,48142,1,4,0
13705,5,2,48143,48143,48145,0,2,1
13706,5,2,48148,48148,48150,0,2,3
13707,4,2,48152,48152,48154,0,2,2
13708,5,3,48157,48157,48160,0,3,3
13709,5,1,48162,48162,48163,0,1,2
13710,4,1,48166,48166,48167,0,1,3
13711,2,1,48168,48168,48169,0,1,1
13712,2,2,48170,48170,48172,0,2,1
13713,6,3,48176,48176,48179,0,3,4
13714,6,3,48182,48182,48185,0,3,3
13715,3,2,48185,48185,48187,0,2,0
13716,2,1,48187,48187,48188,0,1,0
13717,6,3,48193,48193,48196,0,3,5
13718,4,1,48197,48197,48198,0,1,1
13719,3,1,48200,48200,48201,0,1,2
13720,6,2,48206,48206,48208,0,2,5
13721,2,1,48208,48208,48209,0,1,0
13722,1,2,48209,48209,48211,0,2,0
13723,6,1,48215,48215,48216,0,1,4
13724,6,3,48221,48221,48224,0,3,5
13725,2,2,48223,48224,48226,1,3,0
13726,2,1,48225,48226,48227,1,2,0
13727,3,1,48228,48228,48229,0,1,1
13728,2,2,48230,48230,48232,0,2,1
13729,3,3,48233,48233,48236,0,3,1
13730,5,3,48238,48238,48241,0,3,2
13731,6,3,48244,48244,48247,0,3,3
13732,5,3,48249,48249,48252,0,3,2
13733,1,1,48250,48252,48253,2,3,0
13734,4,1,48254,48254,48255,0,1,1
13735,6,1,48260,48260,48261,0,1,5
13736,6,1,48266,48266,48267,0,1,5
13737,2,1,48268,48268,48269,0,1,1
13738,1,3,48269,48269,48272,0,3,0
13739,6,2,48275,48275,48277,0,2,3
13740,4,2,48279,48279,48281,0,2,2
13741,6,2,48285,48285,48287,0,2,4
13742,1,2,48286,48287,48289,1,3,0
13743,2,3,48288,48289,48292,1,4,0
13744,5,3,48293,48293,48296,0,3,1
13745,4,2,48297,48297,48299,0,2,1
13746,5,1,48302,48302,48303,0,1,3
13747,6,2,48308,48308,48310,0,2,5
13748,4,2,48312,48312,48314,0,2,2
13749,2,2,48314,48314,48316,0,2,0
13750,5,1,48319,48319,48320,0,1,3
13751,6,1,48325,48325,48326,0,1,5
13752,4,1,48329,48329,48330,0,1,3
13753,2,3,48331,48331,48334,0,3,1
13754,1,2,48332,48334,48336,2,4,0
13755,2,2,48334,48336,48338,2,4,0
13756,3,1,48337,48338,48339,1,2,0
13757,6,2,48343,48343,48345,0,2,4
13758,6,1,48349,48349,48350,0,1,4
13759,3,1,48352,48352,48353,0,1,2
13760,5,1,48357,48357,48358,0,1,4
13761,5,2,48362,48362,48364,0,2,4
13762,5,1,48367,48367,48368,0,1,3
13763,6,2,48373,48373,48375,0,2,5
13764,6,1,48379,48379,48380,0,1,4
13765,4,3,48383,48383,48386,0,3,3
13766,5,1,48388,48388,48389,0,1,2
13767,4,2,48392,48392,48394,0,2,3
13768,5,1,48397,48397,48398,0,1,3
13769,4,1,48401,48401,48402,0,1,3
13770,5,3,48406,48406,48409,0,3,4
13771,2,2,48408,48409,48411,1,3,0
13772,2,2,48410,48411,48413,1,3,0
13773,1,3,48411,48413,48416,2,5,0
13774,3,2,48414,48416,48418,2,4,0
13775,1,1,48415,48418,48419,3,4,0
13776,5,3,48420,48420,48423,0,3,1
13777,6,1,48426,48426,48427,0,1,3
13778,4,1,48430,48430,48431,0,1,3
13779,3,1,48433,48433,48434,0,1,2
13780,3,2,48436,48436,48438,0,2,2
13781,5,2,48441,48441,48443,0,2,3
13782,2,2,48443,48443,48445,0,2,0
13783,6,2,48449,48449,48451,0,2,4
13784,5,2,48454,48454,48456,0,2,3
13785,4,2,48458,48458,48460,0,2,2
13786,5,3,48463,48463,48466,0,3,3
13787,2,1,48465,48466,48467,1,2,0
13788,2,1,48467,48467,48468,0,1,0
13789,2,3,48469,48469,48472,0,3,1
13790,4,1,48473,48473,48474,0,1,1
13791,5,3,48478,48478,48481,0,3,4
13792,5,3,48483,48483,48486,0,3,2
13793,4,2,48487,48487,48489,0,2,1
13794,2,2,48489,48489,48491,0,2,0
13795,3,2,48492,48492,48494,0,2,1
13796,5,2,48497,48497,48499,0,2,3
13797,1,3,48498,48499,48502,1,4,0
13798,6,1,48504,48504,48505,0,1,2
13799,2,2,48506,48506,48508,0,2,1
13800,5,2,48511,48511,48513,0,2,3
13801,3,1,48514,48514,48515,0,1,1
13802,5,2,48519,48519,48521,0,2,4
13803,3,3,48522,48522,48525,0,3,1
13804,5,2,48527,48527,48529,0,2,2
13805,3,1,48530,48530,48531,0,1,1
13806,2,2,48532,48532,48534,0,2,1
13807,4,3,48536,48536,48539,0,3,2
13808,3,3,48539,48539,48542,0,3,0
13809,1,3,48540,48542,48545,2,5,0
13810,3,2,48543,48545,48547,2,4,0
13811,3,2,48546,48547,48549,1,3,0
13812,4,3,48550,48550,48553,0,3,1
13813,4,1,48554,48554,48555,0,1,1
13814,6,2,48560,48560,48562,0,2,5
13815,4,1,48564,48564,48565,0,1,2
13816,3,1,48567,48567,48568,0,1,2
13817,3,3,48570,48570,48573,0,3,2
13818,6,1,48576,48576,48577,0,1,3
13819,3,2,48579,48579,48581,0,2,2
13820,2,1,48581,48581,48582,0,1,0
13821,1,2,48582,48582,48584,0,2,0
13822,2,2,48584,48584,48586,0,2,0
13823,6,3,48590,48590,48593,0,3,4
13824,5,1,48595,48595,48596,0,1,2
13825,5,1,48600,48600,48601,0,1,4
13826,6,3,48606,48606,48609,0,3,5
13827,3,3,48609,48609,48612,0,3,0
13828,2,2,48611,48612,48614,1,3,0
13829,2,2,48613,48614,48616,1,3,0
13830,4,3,48617,48617,48620,0,3,1
13831,4,2,48621,48621,48623,0,2,1
13832,5,3,48626,48626,48629,0,3,3
13833,2,1,48628,48629,48630,1,2,0
13834,1,2,48629,48630,48632,1,3,0
13835,3,2,48632,48632,48634,0,2,0
13836,3,2,48635,48635,48637,0,2,1
13837,3,2,48638,48638,48640,0,2,1
13838,4,1,48642,48642,48643,0,1,2
13839,6,2,48648,48648,48650,0,2,5
13840,2,2,48650,48650,48652,0,2,0
13841,2,3,48652,48652,48655,0,3,0
13842,6,1,48658,48658,48659,0,1,3
13843,6,2,48664,48664,48666,0,2,5
13844,4,3,48668,48668,48671,0,3,2
13845,3,1,48671,48671,48672,0,1,0
13846,2,1,48673,48673,48674,0,1,1
13847,5,2,48678,48678,48680,0,2,4
13848,1,1,48679,48680,48681,1,2,0
13849,5,1,48684,48684,48685,0,1,3
13850,3,3,48687,48687,48690,0,3,2
13851,4,1,48691,48691,48692,0,1,1
13852,3,2,48694,48694,48696,0,2,2
13853,4,1,48698,48698,48699,0,1,2
13854,5,3,48703,48703,48706,0,3,4
13855,5,2,48708,48708,48710,0,2,2
13856,2,3,48710,48710,48713,0,3,0
13857,2,1,48712,48713,48714,1,2,0
13858,3,2,48715,48715,48717,0,2,1
13859,6,1,48721,48721,48722,0,1,4
13860,6,1,48727,48727,48728,0,1,5
13861,6,3,48733,48733,48736,0,3,5
13862,3,2,48736,48736,48738,0,2,0
13863,4,3,48740,48740,48743,0,3,2
13864,5,1,48745,48745,48746,0,1,2
13865,2,3,48747,48747,48750,0,3,1
13866,3,3,48750,48750,48753,0,3,0
13867,3,1,48753,48753,48754,0,1,0
13868,6,1,48759,48759,48760,0,1,5
13869,1,1,48760,48760,48761,0,1,0
13870,3,2,48763,48763,48765,0,2,2
13871,6,2,48769,48769,48771,0,2,4
13872,1,2,48770,48771,48773,1,3,0
13873,4,3,48774,48774,48777,0,3,1
13874,1,3,48775,48777,48780,2,5,0
13875,2,2,48777,48780,48782,3,5,0
13876,3,3,48780,48782,48785,2,5,0
13877,4,3,48784,48785,48788,1,4,0
13878,5,3,48789,48789,48792,0,3,1
13879,1,1,48790,48792,48793,2,3,0
13880,2,3,48792,48793,48796,1,4,0
13881,1,1,48793,48796,48797,3,4,0
13882,1,3,48794,48797,48800,3,6,0
13883,4,3,48798,48800,48803,2,5,0
13884,3,3,48801,48803,48806,2,5,0
13885,5,1,48806,48806,48807,0,1,0
13886,4,2,48810,48810,48812,0,2,3
13887,5,1,48815,48815,48816,0,1,3
13888,3,1,48818,48818,48819,0,1,2
13889,6,1,48824,48824,48825,0,1,5
13890,2,2,48826,48826,48828,0,2,1
13891,3,3,48829,48829,48832,0,3,1
13892,4,2,48833,48833,48835,0,2,1
13893,5,1,48838,48838,48839,0,1,3
13894,3,1,48841,48841,48842,0,1,2
13895,3,1,48844,48844,48845,0,1,2
13896,5,2,48849,48849,48851,0,2,4
13897,1,3,48850,48851,48854,1,4,0
13898,6,3,48856,48856,48859,0,3,2
13899,5,2,48861,48861,48863,0,2,2
13900,6,1,48867,48867,48868,0,1,4
13901,6,1,48873,48873,48874,0,1,5
13902,3,3,48876,48876,48879,0,3,2
13903,4,3,48880,48880,48883,0,3,1
13904,1,3,48881,48883,48886,2,5,0
13905,2,1,48883,48886,48887,3,4,0
13906,1,1,48884,48887,48888,3,4,0
13907,5,2,48889,48889,48891,0,2,1
13908,4,2,48893,48893,48895,0,2,2
13909,5,3,48898,48898,48901,0,3,3
13910,1,2,48899,48901,48903,2,4,0
13911,5,2,48904,48904,48906,0,2,1
13912,4,3,48908,48908,48911,0,3,2
13913,1,3,48909,48911,48914,2,5,0
13914,3,3,48912,48914,48917,2,5,0
13915,3,2,48915,48917,48919,2,4,0
13916,4,2,48919,48919,48921,0,2,0
13917,2,2,48921,48921,48923,0,2,0
13918,3,1,48924,48924,48925,0,1,1
13919,5,2,48929,48929,48931,0,2,4
13920,5,3,48934,48934,48937,0,3,3
13921,2,2,48936,48937,48939,1,3,0
13922,2,3,48938,48939,48942,1,4,0
13923,2,1,48940,48942,48943,2,3,0
13924,2,2,48942,48943,48945,1,3,0
13925,2,3,48944,48945,48948,1,4,0
13926,3,1,48947,48948,48949,1,2,0
13927,5,2,48952,48952,48954,0,2,3
13928,3,2,48955,48955,48957,0,2,1
13929,2,3,48957,48957,48960,0,3,0
13930,5,2,48962,48962,48964,0,2,2
13931,4,2,48966,48966,48968,0,2,2
13932,3,1,48969,48969,48970,0,1,1
13933,4,1,48973,48973,48974,0,1,3
13934,1,3,48974,48974,48977,0,3,0
13935,1,1,48975,48977,48978,2,3,0
13936,4,1,48979,48979,48980,0,1,1
13937,4,3,48983,48983,48986,0,3,3
13938,3,1,48986,48986,48987,0,1,0
13939,3,1,48989,48989,48990,0,1,2
13940,4,2,48993,48993,48995,0,2,3
13941,2,1,48995,48995,48996,0,1,0
13942,3,1,48998,48998,48999,0,1,2
13943,5,3,49003,49003,49006,0,3,4
13944,1,1,49004,49006,49007,2,3,0
13945,1,1,49005,49007,49008,2,3,0
13946,6,3,49011,49011,49014,0,3,3
13947,4,3,49015,49015,49018,0,3,1
13948,2,3,49017,49018,49021,1,4,0
13949,2,2,49019,49021,49023,2,4,0
13950,5,3,49024,49024,49027,0,3,1
13951,4,2,49028,49028,49030,0,2,1
13952,1,1,49029,49030,49031,1,2,0
13953,1,1,49030,49031,49032,1,2,0
13954,6,2,49036,49036,49038,0,2,4
13955,1,3,49037,49038,49041,1,4,0
13956,5,3,49042,49042,49045,0,3,1
13957,6,1,49048,49048,49049,0,1,3
13958,5,2,49053,49053,49055,0,2,4
13959,2,2,49055,49055,49057,0,2,0
13960,5,2,49060,49060,49062,0,2,3
13961,2,3,49062,49062,49065,0,3,0
13962,3,3,49065,49065,49068,0,3,0
13963,6,3,49071,49071,49074,0,3,3
13964,6,3,49077,49077,49080,0,3,3
13965,5,1,49082,49082,49083,0,1,2
13966,1,2,49083,49083,49085,0,2,0
13967,4,3,49087,49087,49090,0,3,2
13968,5,2,49092,49092,49094,0,2,2
13969,1,1,49093,49094,49095,1,2,0
13970,4,2,49097,49097,49099,0,2,2
13971,5,2,49102,49102,49104,0,2,3
13972,6,1,49108,49108,49109,0,1,4
13973,1,3,49109,49109,49112,0,3,0
13974,3,2,49112,49112,49114,0,2,0
13975,2,2,49114,49114,49116,0,2,0
13976,1,1,49115,49116,49117,1,2,0
13977,6,2,49121,49121,49123,0,2,4
13978,2,3,49123,49123,49126,0,3,0
13979,2,1,49125,49126,49127,1,2,0
13980,3,2,49128,49128,49130,0,2,1
13981,2,1,49130,49130,49131,0,1,0
13982,3,1,49133,49133,49134,0,1,2
13983,5,3,49138,49138,49141,0,3,4
13984,1,3,49139,49141,49144,2,5,0
13985,2,2,49141,49144,49146,3,5,0
13986,5,1,49146,49146,49147,0,1,0
13987,6,2,49152,49152,49154,0,2,5
13988,1,3,49153,49154,49157,1,4,0
13989,3,1,49156,49157,49158,1,2,0
13990,4,3,49160,49160,49163,0,3,2
13991,4,1,49164,49164,49165,0,1,1
13992,4,3,49168,49168,49171,0,3,3
13993,4,1,49172,49172,49173,0,1,1
13994,2,1,49174,49174,49175,0,1,1
13995,5,2,49179,49179,49181,0,2,4
13996,4,2,49183,49183,49185,0,2,2
13997,5,3,49188,49188,49191,0,3,3
13998,2,1,49190,49191,49192,1,2,0
13999,3,1,49193,49193,49194,0,1,1
14000,2,3,49195,49195,49198,0,3,1
14001,3,2,49198,49198,49200,0,2,0
14002,6,3,49204,49204,49207,0,3,4
14003,1,1,49205,49207,49208,2,3,0
14004,1,3,49206,49208,49211,2,5,0
14005,3,3,49209,49211,49214,2,5,0
14006,6,3,49215,49215,49218,0,3,1
14007,2,3,49217,49218,49221,1,4,0
14008,5,2,49222,49222,49224,0,2,1
14009,1,2,49223,49224,49226,1,3,0
14010,2,3,49225,49226,49229,1,4,0
14011,2,3,49227,49229,49232,2,5,0
14012,4,3,49231,49232,49235,1,4,0
14013,2,1,49233,49235,49236,2,3,0
14014,2,2,49235,49236,49238,1,3,0
14015,3,1,49238,49238,49239,0,1,0
14016,1,3,49239,49239,49242,0,3,0
14017,1,2,49240,49242,49244,2,4,0
14018,5,3,49245,49245,49248,0,3,1
14019,1,3,49246,49248,49251,2,5,0
14020,5,3,49251,49251,49254,0,3,0
14021,1,1,49252,49254,49255,2,3,0
14022,6,1,49258,49258,49259,0,1,3
14023,6,3,49264,49264,49267,0,3,5
14024,4,1,49268,49268,49269,0,1,1
14025,6,3,49274,49274,49277,0,3,5
14026,1,2,49275,49277,49279,2,4,0
14027,4,3,49279,49279,49282,0,3,0
14028,6,3,49285,49285,49288,0,3,3
14029,2,2,49287,49288,49290,1,3,0
14030,2,2,49289,49290,49292,1,3,0
14031,3,3,49292,49292,49295,0,3,0
14032,5,1,49297,49297,49298,0,1,2
14033,2,3,49299,49299,49302,0,3,1
14034,4,3,49303,49303,49306,0,3,1
14035,2,1,49305,49306,49307,1,2,0
14036,6,3,49311,49311,49314,0,3,4
14037,2,3,49313,49314,49317,1,4,0
14038,6,2,49319,49319,49321,0,2,2
14039,4,1,49323,49323,49324,0,1,2
14040,1,1,49324,49324,49325,0,1,0
14041,1,1,49325,49325,49326,0,1,0
14042,2,3,49327,49327,49330,0,3,1
14043,6,1,49333,49333,49334,0,1,3
14044,2,1,49335,49335,49336,0,1,1
14045,2,3,49337,49337,49340,0,3,1
14046,4,2,49341,49341,49343,0,2,1
14047,3,1,49344,49344,49345,0,1,1
14048,2,2,49346,49346,49348,0,2,1
14049,4,1,49350,49350,49351,0,1,2
14050,3,2,49353,49353,49355,0,2,2
14051,2,1,49355,49355,49356,0,1,0
14052,5,2,49360,49360,49362,0,2,4
14053,5,2,49365,49365,49367,0,2,3
14054,2,2,49367,49367,49369,0,2,0
14055,6,1,49373,49373,49374,0,1,4
14056,6,1,49379,49379,49380,0,1,5
14057,6,3,49385,49385,49388,0,3,5
14058,6,3,49391,49391,49394,0,3,3
14059,2,2,49393,49394,49396,1,3,0
14060,4,3,49397,49397,49400,0,3,1
14061,5,2,49402,49402,49404,0,2,2
14062,2,2,49404,49404,49406,0,2,0
14063,1,3,49405,49406,49409,1,4,0
14064,1,1,49406,49409,49410,3,4,0
14065,5,1,49411,49411,49412,0,1,1
14066,4,3,49415,49415,49418,0,3,3
14067,4,3,49419,49419,49422,0,3,1
14068,1,1,49420,49422,49423,2,3,0
14069,4,2,49424,49424,49426,0,2,1
14070,1,2,49425,49426,49428,1,3,0
14071,6,2,49431,49431,49433,0,2,3
14072,6,2,49437,49437,49439,0,2,4
14073,1,3,49438,49439,49442,1,4,0
14074,5,2,49443,49443,49445,0,2,1
14075,4,1,49447,49447,49448,0,1,2
14076,3,1,49450,49450,49451,0,1,2
14077,2,2,49452,49452,49454,0,2,1
14078,6,1,49458,49458,49459,0,1,4
14079,2,1,49460,49460,49461,0,1,1
14080,4,2,49464,49464,49466,0,2,3
14081,1,1,49465,49466,49467,1,2,0
14082,6,1,49471,49471,49472,0,1,4
14083,4,2,49475,49475,49477,0,2,3
14084,2,1,49477,49477,49478,0,1,0
14085,4,1,49481,49481,49482,0,1,3
14086,4,1,49485,49485,49486,0,1,3
14087,6,3,49491,49491,49494,0,3,5
14088,5,2,49496,49496,49498,0,2,2
14089,5,2,49501,49501,49503,0,2,3
14090,5,3,49506,49506,49509,0,3,3
14091,3,2,49509,49509,49511,0,2,0
14092,6,2,49515,49515,49517,0,2,4
14093,2,3,49517,49517,49520,0,3,0
14094,1,1,49518,49520,49521,2,3,0
14095,3,3,49521,49521,49524,0,3,0
14096,3,1,49524,49524,49525,0,1,0
14097,6,1,49530,49530,49531,0,1,5
14098,5,1,49535,49535,49536,0,1,4
14099,1,1,49536,49536,49537,0,1,0
14100,1,2,49537,49537,49539,0,2,0
14101,4,2,49541,49541,49543,0,2,2
14102,5,3,49546,49546,49549,0,3,3
14103,6,1,49552,49552,49553,0,1,3
14104,2,3,49554,49554,49557,0,3,1
14105,1,3,49555,49557,49560,2,5,0
14106,4,3,49559,49560,49563,1,4,0
14107,5,2,49564,49564,49566,0,2,1
14108,1,3,49565,49566,49569,1,4,0
14109,4,1,49569,49569,49570,0,1,0
14110,5,3,49574,49574,49577,0,3,4
14111,4,1,49578,49578,49579,0,1,1
14112,6,3,49584,49584,49587,0,3,5
14113,3,1,49587,49587,49588,0,1,0
14114,1,2,49588,49588,49590,0,2,0
14115,3,2,49591,49591,49593,0,2,1
14116,5,1,49596,49596,49597,0,1,3
14117,4,3,49600,49600,49603,0,3,3
14118,3,3,49603,49603,49606,0,3,0
14119,1,3,49604,49606,49609,2,5,0
14120,2,2,49606,49609,49611,3,5,0
14121,6,1,49612,49612,49613,0,1,1
14122,1,2,49613,49613,49615,0,2,0
14123,1,3,49614,49615,49618,1,4,0
14124,5,2,49619,49619,49621,0,2,1
14125,2,1,49621,49621,49622,0,1,0
14126,4,2,49625,49625,49627,0,2,3
14127,5,2,49630,49630,49632,0,2,3
14128,6,3,49636,49636,49639,0,3,4
14129,6,1,49642,49642,49643,0,1,3
14130,1,3,49643,49643,49646,0,3,0
14131,1,2,49644,49646,49648,2,4,0
14132,3,1,49647,49648,49649,1,2,0
14133,5,1,49652,49652,49653,0,1,3
14134,4,2,49656,49656,49658,0,2,3
14135,6,3,49662,49662,49665,0,3,4
14136,5,2,49667,49667,49669,0,2,2
14137,1,3,49668,49669,49672,1,4,0
14138,5,1,49673,49673,49674,0,1,1
14139,3,3,49676,49676,49679,0,3,2
14140,2,1,49678,49679,49680,1,2,0
14141,1,3,49679,49680,49683,1,4,0
14142,1,1,49680,49683,49684,3,4,0
14143,2,1,49682,49684,49685,2,3,0
14144,3,2,49685,49685,49687,0,2,0
14145,4,3,49689,49689,49692,0,3,2
14146,5,1,49694,49694,49695,0,1,2
14147,6,2,49700,49700,49702,0,2,5
14148,6,1,49706,49706,49707,0,1,4
14149,5,2,49711,49711,49713,0,2,4
14150,2,3,49713,49713,49716,0,3,0
14151,1,3,49714,49716,49719,2,5,0
14152,4,2,49718,49719,49721,1,3,0
14153,1,2,49719,49721,49723,2,4,0
14154,6,1,49725,49725,49726,0,1,2
14155,3,3,49728,49728,49731,0,3,2
14156,5,3,49733,49733,49736,0,3,2
14157,6,1,49739,49739,49740,0,1,3
14158,1,3,49740,49740,49743,0,3,0
14159,4,3,49744,49744,49747,0,3,1
14160,5,3,49749,49749,49752,0,3,2
14161,2,2,49751,49752,49754,1,3,0
14162,3,3,49754,49754,49757,0,3,0
14163,5,2,49759,49759,49761,0,2,2
14164,4,3,49763,49763,49766,0,3,2
14165,1,2,49764,49766,49768,2,4,0
14166,2,2,49766,49768,49770,2,4,0
14167,5,2,49771,49771,49773,0,2,1
14168,5,1,49776,49776,49777,0,1,3
14169,6,2,49782,49782,49784,0,2,5
14170,5,3,49787,49787,49790,0,3,3
14171,6,2,49793,49793,49795,0,2,3
14172,5,2,49798,49798,49800,0,2,3
14173,4,1,49802,49802,49803,0,1,2
14174,6,1,49808,49808,49809,0,1,5
14175,6,1,49814,49814,49815,0,1,5
14176,3,2,49817,49817,49819,0,2,2
14177,5,1,49822,49822,49823,0,1,3
14178,5,3,49827,49827,49830,0,3,4
14179,1,2,49828,49830,49832,2,4,0
14180,4,2,49832,49832,49834,0,2,0
14181,1,1,49833,49834,49835,1,2,0
14182,3,3,49836,49836,49839,0,3,1
14183,4,2,49840,49840,49842,0,2,1
14184,6,1,49846,49846,49847,0,1,4
14185,1,1,49847,49847,49848,0,1,0
14186,5,3,49852,49852,49855,0,3,4
14187,4,1,49856,49856,49857,0,1,1
14188,5,1,49861,49861,49862,0,1,4
14189,6,2,49867,49867,49869,0,2,5
14190,1,2,49868,49869,49871,1,3,0
14191,6,2,49874,49874,49876,0,2,3
14192,4,1,49878,49878,49879,0,1,2
14193,2,2,49880,49880,49882,0,2,1
14194,4,2,49884,49884,49886,0,2,2
14195,6,3,49890,49890,49893,0,3,4
14196,2,2,49892,49893,49895,1,3,0
14197,2,3,49894,49895,49898,1,4,0
14198,2,3,49896,49898,49901,2,5,0
14199,3,1,49899,49901,49902,2,3,0
14200,3,1,49902,49902,49903,0,1,0
14201,6,1,49908,49908,49909,0,1,5
14202,6,3,49914,49914,49917,0,3,5
14203,6,3,49920,49920,49923,0,3,3
14204,2,2,49922,49923,49925,1,3,0
14205,6,3,49928,49928,49931,0,3,3
14206,4,2,49932,49932,49934,0,2,1
14207,1,1,49933,49934,49935,1,2,0
14208,4,1,49937,49937,49938,0,1,2
14209,2,1,49939,49939,49940,0,1,1
14210,2,1,49941,49941,49942,0,1,1
14211,3,3,49944,49944,49947,0,3,2
14212,6,2,49950,49950,49952,0,2,3
14213,4,3,49954,49954,49957,0,3,2
14214,1,1,49955,49957,49958,2,3,0
14215,1,1,49956,49958,49959,2,3,0
14216,5,1,49961,49961,49962,0,1,2
14217,6,2,49967,49967,49969,0,2,5
14218,6,1,49973,49973,49974,0,1,4
14219,1,3,49974,49974,49977,0,3,0
14220,1,2,49975,49977,49979,2,4,0
14221,2,3,49977,49979,49982,2,5,0
14222,6,2,49983,49983,49985,0,2,1
14223,3,3,49986,49986,49989,0,3,1
14224,4,3,49990,49990,49993,0,3,1
14225,6,3,49996,49996,49999,0,3,3
14226,3,2,49999,49999,50001,0,2,0
14227,2,1,50001,50001,50002,0,1,0
14228,3,3,50004,50004,50007,0,3,2
14229,4,3,50008,50008,50011,0,3,1
14230,1,1,50009,50011,50012,2,3,0
14231,1,1,50010,50012,50013,2,3,0
14232,1,2,50011,50013,50015,2,4,0
14233,5,2,50016,50016,50018,0,2,1
14234,1,2,50017,50018,50020,1,3,0
14235,4,1,50021,50021,50022,0,1,1
14236,2,1,50023,50023,50024,0,1,1
14237,3,3,50026,50026,50029,0,3,2
14238,6,1,50032,50032,50033,0,1,3
14239,6,3,50038,50038,50041,0,3,5
14240,1,3,50039,50041,50044,2,5,0
14241,6,2,50045,50045,50047,0,2,1
14242,1,2,50046,50047,50049,1,3,0
14243,4,3,50050,50050,50053,0,3,1
14244,5,1,50055,50055,50056,0,1,2
14245,6,1,50061,50061,50062,0,1,5
14246,2,2,50063,50063,50065,0,2,1
14247,1,1,50064,50065,50066,1,2,0
14248,3,1,50067,50067,50068,0,1,1
14249,3,2,50070,50070,50072,0,2,2
14250,5,1,50075,50075,50076,0,1,3
14251,1,3,50076,50076,50079,0,3,0
14252,4,3,50080,50080,50083,0,3,1
14253,2,2,50082,50083,50085,1,3,0
14254,6,3,50088,50088,50091,0,3,3
14255,5,2,50093,50093,50095,0,2,2
14256,6,3,50099,50099,50102,0,3,4
14257,6,1,50105,50105,50106,0,1,3
14258,3,2,50108,50108,50110,0,2,2
14259,5,2,50113,50113,50115,0,2,3
14260,5,3,50118,50118,50121,0,3,3
14261,1,3,50119,50121,50124,2,5,0
14262,5,1,50124,50124,50125,0,1,0
14263,5,3,50129,50129,50132,0,3,4
14264,2,3,50131,50132,50135,1,4,0
14265,3,1,50134,50135,50136,1,2,0
14266,1,3,50135,50136,50139,1,4,0
14267,3,1,50138,50139,50140,1,2,0
14268,3,2,50141,50141,50143,0,2,1
14269,6,1,50147,50147,50148,0,1,4
14270,1,1,50148,50148,50149,0,1,0
14271,3,2,50151,50151,50153,0,2,2
14272,3,3,50154,50154,50157,0,3,1
14273,1,2,50155,50157,50159,2,4,0
14274,5,2,50160,50160,50162,0,2,1
14275,2,3,50162,50162,50165,0,3,0
14276,2,1,50164,50165,50166,1,2,0
14277,5,2,50169,50169,50171,0,2,3
14278,2,3,50171,50171,50174,0,3,0
14279,1,1,50172,50174,50175,2,3,0
14280,5,3,50177,50177,50180,0,3,2
14281,4,1,50181,50181,50182,0,1,1
14282,4,2,50185,50185,50187,0,2,3
14283,2,2,50187,50187,50189,0,2,0
14284,2,1,50189,50189,50190,0,1,0
14285,3,3,50192,50192,50195,0,3,2
14286,2,1,50194,50195,50196,1,2,0
14287,2,1,50196,50196,50197,0,1,0
14288,1,2,50197,50197,50199,0,2,0
14289,6,3,50203,50203,50206,0,3,4
14290,1,3,50204,50206,50209,2,5,0
14291,3,1,50207,50209,50210,2,3,0
14292,3,1,50210,50210,50211,0,1,0
14293,3,3,50213,50213,50216,0,3,2
14294,2,2,50215,50216,50218,1,3,0
14295,3,1,50218,50218,50219,0,1,0
14296,5,3,50223,50223,50226,0,3,4
14297,4,3,50227,50227,50230,0,3,1
14298,4,3,50231,50231,50234,0,3,1
14299,4,2,50235,50235,50237,0,2,1
14300,6,2,50241,50241,50243,0,2,4
14301,3,2,50244,50244,50246,0,2,1
14302,2,1,50246,50246,50247,0,1,0
14303,4,2,50250,50250,50252,0,2,3
14304,6,3,50256,50256,50259,0,3,4
14305,3,1,50259,50259,50260,0,1,0
14306,5,1,50264,50264,50265,0,1,4
14307,1,2,50265,50265,50267,0,2,0
14308,5,2,50270,50270,50272,0,2,3
14309,6,2,50276,50276,50278,0,2,4
14310,2,2,50278,50278,50280,0,2,0
14311,1,2,50279,50280,50282,1,3,0
14312,1,2,50280,50282,50284,2,4,0
14313,4,3,50284,50284,50287,0,3,0
14314,1,3,50285,50287,50290,2,5,0
14315,3,3,50288,50290,50293,2,5,0
14316,6,2,50294,50294,50296,0,2,1
14317,4,1,50298,50298,50299,0,1,2
14318,5,2,50303,50303,50305,0,2,4
14319,6,2,50309,50309,50311,0,2,4
14320,2,2,50311,50311,50313,0,2,0
14321,1,3,50312,50313,50316,1,4,0
14322,3,2,50315,50316,50318,1,3,0
14323,3,2,50318,50318,50320,0,2,0
14324,1,3,50319,50320,50323,1,4,0
14325,2,1,50321,50323,50324,2,3,0
14326,2,2,50323,50324,50326,1,3,0
14327,1,3,50324,50326,50329,2,5,0
14328,2,2,50326,50329,50331,3,5,0
14329,1,1,50327,50331,50332,4,5,0
14330,6,3,50333,50333,50336,0,3,1
14331,5,1,50338,50338,50339,0,1,2
14332,5,2,50343,50343,50345,0,2,4
14333,5,1,50348,50348,50349,0,1,3
14334,4,1,50352,50352,50353,0,1,3
14335,6,2,50358,50358,50360,0,2,5
14336,3,3,50361,50361,50364,0,3,1
14337,3,3,50364,50364,50367,0,3,0
14338,2,3,50366,50367,50370,1,4,0
14339,3,1,50369,50370,50371,1,2,0
14340,4,3,50373,50373,50376,0,3,2
14341,1,2,50374,50376,50378,2,4,0
14342,1,3,50375,50378,50381,3,6,0
14343,6,1,50381,50381,50382,0,1,0
14344,5,1,50386,50386,50387,0,1,4
14345,6,2,50392,50392,50394,0,2,5
14346,3,1,50395,50395,50396,0,1,1
14347,1,1,50396,50396,50397,0,1,0
14348,5,3,50401,50401,50404,0,3,4
14349,3,1,50404,50404,50405,0,1,0
14350,2,1,50406,50406,50407,0,1,1
14351,1,3,50407,50407,50410,0,3,0
14352,1,3,50408,50410,50413,2,5,0
14353,1,1,50409,50413,50414,4,5,0
14354,6,2,50415,50415,50417,0,2,1
14355,2,3,50417,50417,50420,0,3,0
14356,4,1,50421,50421,50422,0,1,1
14357,3,1,50424,50424,50425,0,1,2
14358,3,1,50427,50427,50428,0,1,2
14359,4,3,50431,50431,50434,0,3,3
14360,5,3,50436,50436,50439,0,3,2
14361,4,3,50440,50440,50443,0,3,1
14362,5,1,50445,50445,50446,0,1,2
14363,5,2,50450,50450,50452,0,2,4
14364,1,2,50451,50452,50454,1,3,0
14365,5,2,50456,50456,50458,0,2,2
14366,1,2,50457,50458,50460,1,3,0
14367,6,3,50463,50463,50466,0,3,3
14368,2,1,50465,50466,50467,1,2,0
14369,2,2,50467,50467,50469,0,2,0
14370,5,1,50472,50472,50473,0,1,3
14371,2,2,50474,50474,50476,0,2,1
14372,6,2,50480,50480,50482,0,2,4
14373,2,1,50482,50482,50483,0,1,0
14374,5,2,50487,50487,50489,0,2,4
14375,4,2,50491,50491,50493,0,2,2
14376,4,2,50495,50495,50497,0,2,2
14377,3,1,50498,50498,50499,0,1,1
14378,6,2,50504,50504,50506,0,2,5
14379,5,1,50509,50509,50510,0,1,3
14380,2,1,50511,50511,50512,0,1,1
14381,2,3,50513,50513,50516,0,3,1
14382,6,1,50519,50519,50520,0,1,3
14383,2,2,50521,50521,50523,0,2,1
14384,5,3,50526,50526,50529,0,3,3
14385,4,1,50530,50530,50531,0,1,1
14386,3,3,50533,50533,50536,0,3,2
14387,4,3,50537,50537,50540,0,3,1
14388,2,1,50539,50540,50541,1,2,0
14389,6,3,50545,50545,50548,0,3,4
14390,4,2,50549,50549,50551,0,2,1
14391,1,1,50550,50551,50552,1,2,0
14392,5,1,50555,50555,50556,0,1,3
14393,4,2,50559,50559,50561,0,2,3
14394,1,1,50560,50561,50562,1,2,0
14395,6,3,50566,50566,50569,0,3,4
14396,1,1,50567,50569,50570,2,3,0
14397,3,1,50570,50570,50571,0,1,0
14398,3,1,50573,50573,50574,0,1,2
14399,5,3,50578,50578,50581,0,3,4
14400,2,3,50580,50581,50584,1,4,0
14401,6,2,50586,50586,50588,0,2,2
14402,2,3,50588,50588,50591,0,3,0
14403,5,1,50593,50593,50594,0,1,2
14404,1,2,50594,50594,50596,0,2,0
14405,1,1,50595,50596,50597,1,2,0
14406,3,2,50598,50598,50600,0,2,1
14407,1,1,50599,50600,50601,1,2,0
14408,1,3,50600,50601,50604,1,4,0
14409,2,3,50602,50604,50607,2,5,0
14410,4,1,50606,50607,50608,1,2,0
14411,5,3,50611,50611,50614,0,3,3
14412,1,3,50612,50614,50617,2,5,0
14413,5,2,50617,50617,50619,0,2,0
14414,1,3,50618,50619,50622,1,4,0
14415,5,1,50623,50623,50624,0,1,1
14416,3,2,50626,50626,50628,0,2,2
14417,6,1,50632,50632,50633,0,1,4
14418,5,3,50637,50637,50640,0,3,4
14419,4,3,50641,50641,50644,0,3,1
14420,6,3,50647,50647,50650,0,3,3
14421,4,2,50651,50651,50653,0,2,1
14422,2,1,50653,50653,50654,0,1,0
14423,5,3,50658,50658,50661,0,3,4
14424,1,3,50659,50661,50664,2,5,0
14425,4,3,50663,50664,50667,1,4,0
14426,1,2,50664,50667,50669,3,5,0
14427,6,1,50670,50670,50671,0,1,1
14428,5,1,50675,50675,50676,0,1,4
14429,2,2,50677,50677,50679,0,2,1
14430,6,1,50683,50683,50684,0,1,4
14431,6,2,50689,50689,50691,0,2,5
14432,5,1,50694,50694,50695,0,1,3
14433,1,3,50695,50695,50698,0,3,0
14434,6,2,50701,50701,50703,0,2,3
14435,1,2,50702,50703,50705,1,3,0
14436,5,1,50707,50707,50708,0,1,2
14437,2,2,50709,50709,50711,0,2,1
14438,6,2,50715,50715,50717,0,2,4
14439,4,3,50719,50719,50722,0,3,2
14440,5,3,50724,50724,50727,0,3,2
14441,5,1,50729,50729,50730,0,1,2
14442,2,3,50731,50731,50734,0,3,1
14443,5,1,50736,50736,50737,0,1,2
14444,2,1,50738,50738,50739,0,1,1
14445,6,1,50744,50744,50745,0,1,5
14446,1,2,50745,50745,50747,0,2,0
14447,3,1,50748,50748,50749,0,1,1
14448,5,3,50753,50753,50756,0,3,4
14449,5,2,50758,50758,50760,0,2,2
14450,6,2,50764,50764,50766,0,2,4
14451,1,2,50765,50766,50768,1,3,0
14452,5,2,50770,50770,50772,0,2,2
14453,2,1,50772,50772,50773,0,1,0
14454,5,2,50777,50777,50779,0,2,4
14455,2,3,50779,50779,50782,0,3,0
14456,1,2,50780,50782,50784,2,4,0
14457,2,2,50782,50784,50786,2,4,0
14458,3,3,50785,50786,50789,1,4,0
14459,3,3,50788,50789,50792,1,4,0
14460,5,3,50793,50793,50796,0,3,1
14461,6,3,50799,50799,50802,0,3,3
14462,5,3,50804,50804,50807,0,3,2
14463,2,1,50806,50807,50808,1,2,0
14464,2,2,50808,50808,50810,0,2,0
14465,6,1,50814,50814,50815,0,1,4
14466,1,3,50815,50815,50818,0,3,0
14467,6,2,50821,50821,50823,0,2,3
14468,4,3,50825,50825,50828,0,3,2
14469,1,2,50826,50828,50830,2,4,0
14470,2,3,50828,50830,50833,2,5,0
14471,2,1,50830,50833,50834,3,4,0
14472,5,3,50835,50835,50838,0,3,1
14473,6,3,50841,50841,50844,0,3,3
14474,3,2,50844,50844,50846,0,2,0
14475,2,2,50846,50846,50848,0,2,0
14476,2,1,50848,50848,50849,0,1,0
14477,3,2,50851,50851,50853,0,2,2
14478,2,1,50853,50853,50854,0,1,0
14479,4,2,50857,50857,50859,0,2,3
14480,2,2,50859,50859,50861,0,2,0
14481,2,3,50861,50861,50864,0,3,0
14482,4,2,50865,50865,50867,0,2,1
14483,5,1,50870,50870,50871,0,1,3
14484,3,3,50873,50873,50876,0,3,2
14485,3,1,50876,50876,50877,0,1,0
14486,6,2,50882,50882,50884,0,2,5
14487,3,3,50885,50885,50888,0,3,1
14488,6,1,50891,50891,50892,0,1,3
14489,4,2,50895,50895,50897,0,2,3
14490,4,2,50899,50899,50901,0,2,2
14491,6,3,50905,50905,50908,0,3,4
14492,3,3,50908,50908,50911,0,3,0
14493,5,1,50913,50913,50914,0,1,2
14494,2,3,50915,50915,50918,0,3,1
14495,4,1,50919,50919,50920,0,1,1
14496,1,1,50920,50920,50921,0,1,0
14497,4,1,50924,50924,50925,0,1,3
14498,4,1,50928,50928,50929,0,1,3
14499,4,1,50932,50932,50933,0,1,3
14500,6,3,50938,50938,50941,0,3,5
14501,6,3,50944,50944,50947,0,3,3
14502,2,2,50946,50947,50949,1,3,0
14503,2,1,50948,50949,50950,1,2,0
14504,4,1,50952,50952,50953,0,1,2
14505,3,3,50955,50955,50958,0,3,2
14506,6,1,50961,50961,50962,0,1,3
14507,5,1,50966,50966,50967,0,1,4
14508,5,1,50971,50971,50972,0,1,4
14509,5,1,50976,50976,50977,0,1,4
14510,4,2,50980,50980,50982,0,2,3
14511,2,3,50982,50982,50985,0,3,0
14512,4,3,50986,50986,50989,0,3,1
14513,1,3,50987,50989,50992,2,5,0
14514,3,3,50990,50992,50995,2,5,0
14515,1,2,50991,50995,50997,4,6,0
14516,5,1,50996,50997,50998,1,2,0
14517,3,1,50999,50999,51000,0,1,1
14518,4,1,51003,51003,51004,0,1,3
14519,5,3,51008,51008,51011,0,3,4
14520,6,2,51014,51014,51016,0,2,3
14521,2,3,51016,51016,51019,0,3,0
14522,4,3,51020,51020,51023,0,3,1
14523,6,1,51026,51026,51027,0,1,3
14524,5,3,51031,51031,51034,0,3,4
14525,4,2,51035,51035,51037,0,2,1
14526,1,3,51036,51037,51040,1,4,0
14527,1,1,51037,51040,51041,3,4,0
14528,6,1,51043,51043,51044,0,1,2
14529,5,3,51048,51048,51051,0,3,4
14530,2,2,51050,51051,51053,1,3,0
14531,5,2,51055,51055,51057,0,2,2
14532,5,3,51060,51060,51063,0,3,3
14533,3,1,51063,51063,51064,0,1,0
14534,3,1,51066,51066,51067,0,1,2
14535,4,2,51070,51070,51072,0,2,3
14536,2,2,51072,51072,51074,0,2,0
14537,6,1,51078,51078,51079,0,1,4
14538,5,3,51083,51083,51086,0,3,4
14539,2,2,51085,51086,51088,1,3,0
14540,1,3,51086,51088,51091,2,5,0
14541,4,2,51090,51091,51093,1,3,0
14542,6,3,51096,51096,51099,0,3,3
14543,5,1,51101,51101,51102,0,1,2
14544,3,2,51104,51104,51106,0,2,2
14545,2,1,51106,51106,51107,0,1,0
14546,3,2,51109,51109,51111,0,2,2
14547,1,1,51110,51111,51112,1,2,0
14548,2,2,51112,51112,51114,0,2,0
14549,1,1,51113,51114,51115,1,2,0
14550,6,1,51119,51119,51120,0,1,4
14551,1,1,51120,51120,51121,0,1,0
14552,3,3,51123,51123,51126,0,3,2
14553,2,2,51125,51126,51128,1,3,0
14554,1,3,51126,51128,51131,2,5,0
14555,2,1,51128,51131,51132,3,4,0
14556,5,1,51133,51133,51134,0,1,1
14557,4,3,51137,51137,51140,0,3,3
14558,1,3,51138,51140,51143,2,5,0
14559,4,3,51142,51143,51146,1,4,0
14560,6,3,51148,51148,51151,0,3,2
14561,4,2,51152,51152,51154,0,2,1
14562,4,1,51156,51156,51157,0,1,2
14563,5,2,51161,51161,51163,0,2,4
14564,5,2,51166,51166,51168,0,2,3
14565,4,1,51170,51170,51171,0,1,2
14566,3,3,51173,51173,51176,0,3,2
14567,5,1,51178,51178,51179,0,1,2
14568,6,1,51184,51184,51185,0,1,5
14569,6,1,51190,51190,51191,0,1,5
14570,6,3,51196,51196,51199,0,3,5
14571,1,3,51197,51199,51202,2,5,0
14572,4,2,51201,51202,51204,1,3,0
14573,6,2,51207,51207,51209,0,2,3
14574,1,3,51208,51209,51212,1,4,0
14575,2,1,51210,51212,51213,2,3,0
14576,3,1,51213,51213,51214,0,1,0
14577,5,2,51218,51218,51220,0,2,4
14578,1,1,51219,51220,51221,1,2,0
14579,5,3,51224,51224,51227,0,3,3
14580,5,3,51229,51229,51232,0,3,2
14581,3,3,51232,51232,51235,0,3,0
14582,3,2,51235,51235,51237,0,2,0
14583,4,2,51239,51239,51241,0,2,2
14584,4,3,51243,51243,51246,0,3,2
14585,1,2,51244,51246,51248,2,4,0
14586,5,3,51249,51249,51252,0,3,1
14587,5,2,51254,51254,51256,0,2,2
14588,5,3,51259,51259,51262,0,3,3
14589,1,1,51260,51262,51263,2,3,0
14590,3,3,51263,51263,51266,0,3,0
14591,2,3,51265,51266,51269,1,4,0
14592,2,1,51267,51269,51270,2,3,0
14593,6,1,51273,51273,51274,0,1,3
14594,2,3,51275,51275,51278,0,3,1
14595,4,2,51279,51279,51281,0,2,1
14596,6,1,51285,51285,51286,0,1,4
14597,6,2,51291,51291,51293,0,2,5
14598,1,2,51292,51293,51295,1,3,0
14599,4,2,51296,51296,51298,0,2,1
14600,3,3,51299,51299,51302,0,3,1
14601,2,2,51301,51302,51304,1,3,0
14602,4,3,51305,51305,51308,0,3,1
14603,6,2,51311,51311,51313,0,2,3
14604,6,1,51317,51317,51318,0,1,4
14605,6,1,51323,51323,51324,0,1,5
14606,6,1,51329,51329,51330,0,1,5
14607,3,2,51332,51332,51334,0,2,2
14608,1,1,51333,51334,51335,1,2,0
14609,1,3,51334,51335,51338,1,4,0
14610,3,1,51337,51338,51339,1,2,0
14611,6,1,51343,51343,51344,0,1,4
14612,5,3,51348,51348,51351,0,3,4
14613,4,3,51352,51352,51355,0,3,1
14614,4,1,51356,51356,51357,0,1,1
14615,3,2,51359,51359,51361,0,2,2
14616,4,2,51363,51363,51365,0,2,2
14617,4,3,51367,51367,51370,0,3,2
14618,6,1,51373,51373,51374,0,1,3
14619,6,1,51379,51379,51380,0,1,5
14620,1,1,51380,51380,51381,0,1,0
14621,3,1,51383,51383,51384,0,1,2
14622,1,3,51384,51384,51387,0,3,0
14623,4,1,51388,51388,51389,0,1,1
14624,4,1,51392,51392,51393,0,1,3
14625,1,3,51393,51393,51396,0,3,0
14626,5,1,51398,51398,51399,0,1,2
14627,6,2,51404,51404,51406,0,2,5
14628,6,2,51410,51410,51412,0,2,4
14629,3,1,51413,51413,51414,0,1,1
14630,2,2,51415,51415,51417,0,2,1
14631,3,2,51418,51418,51420,0,2,1
14632,4,1,51422,51422,51423,0,1,2
14633,3,3,51425,51425,51428,0,3,2
14634,3,1,51428,51428,51429,0,1,0
14635,6,2,51434,51434,51436,0,2,5
14636,2,3,51436,51436,51439,0,3,0
14637,3,3,51439,51439,51442,0,3,0
14638,1,3,51440,51442,51445,2,5,0
14639,2,2,51442,51445,51447,3,5,0
14640,5,1,51447,51447,51448,0,1,0
14641,2,2,51449,51449,51451,0,2,1
14642,3,3,51452,51452,51455,0,3,1
14643,3,2,51455,51455,51457,0,2,0
14644,1,2,51456,51457,51459,1,3,0
14645,6,3,51462,51462,51465,0,3,3
14646,1,1,51463,51465,51466,2,3,0
14647,6,2,51469,51469,51471,0,2,3
14648,6,1,51475,51475,51476,0,1,4
14649,3,2,51478,51478,51480,0,2,2
14650,5,1,51483,51483,51484,0,1,3
14651,1,3,51484,51484,51487,0,3,0
14652,1,2,51485,51487,51489,2,4,0
14653,2,2,51487,51489,51491,2,4,0
14654,2,3,51489,51491,51494,2,5,0
14655,5,2,51494,51494,51496,0,2,0
14656,5,3,51499,51499,51502,0,3,3
14657,1,3,51500,51502,51505,2,5,0
14658,1,1,51501,51505,51506,4,5,0
14659,3,2,51504,51506,51508,2,4,0
14660,1,1,51505,51508,51509,3,4,0
14661,6,3,51511,51511,51514,0,3,2
14662,6,3,51517,51517,51520,0,3,3
14663,1,3,51518,51520,51523,2,5,0
14664,4,2,51522,51523,51525,1,3,0
14665,1,1,51523,51525,51526,2,3,0
14666,4,2,51527,51527,51529,0,2,1
14667,3,1,51530,51530,51531,0,1,1
14668,5,3,51535,51535,51538,0,3,4
14669,2,2,51537,51538,51540,1,3,0
14670,6,1,51543,51543,51544,0,1,3
14671,1,3,51544,51544,51547,0,3,0
14672,5,3,51549,51549,51552,0,3,2
14673,2,3,51551,51552,51555,1,4,0
14674,3,2,51554,51555,51557,1,3,0
14675,4,2,51558,51558,51560,0,2,1
14676,1,1,51559,51560,51561,1,2,0
14677,6,1,51565,51565,51566,0,1,4
14678,3,2,51568,51568,51570,0,2,2
14679,4,1,51572,51572,51573,0,1,2
14680,4,1,51576,51576,51577,0,1,3
14681,6,1,51582,51582,51583,0,1,5
14682,4,2,51586,51586,51588,0,2,3
14683,1,3,51587,51588,51591,1,4,0
14684,2,2,51589,51591,51593,2,4,0
14685,3,1,51592,51593,51594,1,2,0
14686,2,2,51594,51594,51596,0,2,0
14687,3,1,51597,51597,51598,0,1,1
14688,2,2,51599,51599,51601,0,2,1
14689,2,3,51601,51601,51604,0,3,0
14690,6,1,51607,51607,51608,0,1,3
14691,2,2,51609,51609,51611,0,2,1
14692,6,3,51615,51615,51618,0,3,4
14693,2,3,51617,51618,51621,1,4,0
14694,5,3,51622,51622,51625,0,3,1
14695,3,1,51625,51625,51626,0,1,0
14696,1,2,51626,51626,51628,0,2,0
14697,1,1,51627,51628,51629,1,2,0
14698,6,3,51633,51633,51636,0,3,4
14699,3,1,51636,51636,51637,0,1,0
14700,6,2,51642,51642,51644,0,2,5
14701,2,2,51644,51644,51646,0,2,0
14702,4,1,51648,51648,51649,0,1,2
14703,6,2,51654,51654,51656,0,2,5
14704,1,3,51655,51656,51659,1,4,0
14705,5,2,51660,51660,51662,0,2,1
14706,5,1,51665,51665,51666,0,1,3
14707,4,2,51669,51669,51671,0,2,3
14708,1,3,51670,51671,51674,1,4,0
14709,5,2,51675,51675,51677,0,2,1
14710,3,2,51678,51678,51680,0,2,1
14711,4,2,51682,51682,51684,0,2,2
14712,2,1,51684,51684,51685,0,1,0
14713,1,3,51685,51685,51688,0,3,0
14714,4,1,51689,51689,51690,0,1,1
14715,2,3,51691,51691,51694,0,3,1
14716,2,2,51693,51694,51696,1,3,0
14717,2,1,51695,51696,51697,1,2,0
14718,2,3,51697,51697,51700,0,3,0
14719,6,2,51703,51703,51705,0,2,3
14720,1,1,51704,51705,51706,1,2,0
14721,6,2,51710,51710,51712,0,2,4
14722,2,1,51712,51712,51713,0,1,0
14723,1,3,51713,51713,51716,0,3,0
14724,2,3,51715,51716,51719,1,4,0
14725,2,1,51717,51719,51720,2,3,0
14726,5,3,51722,51722,51725,0,3,2
14727,6,3,51728,51728,51731,0,3,3
14728,3,1,51731,51731,51732,0,1,0
14729,2,3,51733,51733,51736,0,3,1
14730,5,3,51738,51738,51741,0,3,2
14731,4,2,51742,51742,51744,0,2,1
14732,6,1,51748,51748,51749,0,1,4
14733,6,2,51754,51754,51756,0,2,5
14734,6,1,51760,51760,51761,0,1,4
14735,1,1,51761,51761,51762,0,1,0
14736,3,1,51764,51764,51765,0,1,2
14737,1,1,51765,51765,51766,0,1,0
14738,6,1,51771,51771,51772,0,1,5
14739,2,1,51773,51773,51774,0,1,1
14740,1,2,51774,51774,51776,0,2,0
14741,6,2,51780,51780,51782,0,2,4
14742,5,2,51785,51785,51787,0,2,3
14743,6,1,51791,51791,51792,0,1,4
14744,4,1,51795,51795,51796,0,1,3
14745,4,2,51799,51799,51801,0,2,3
14746,6,2,51805,51805,51807,0,2,4
14747,4,1,51809,51809,51810,0,1,2
14748,2,1,51811,51811,51812,0,1,1
14749,6,3,51817,51817,51820,0,3,5
14750,4,2,51821,51821,51823,0,2,1
14751,3,1,51824,51824,51825,0,1,1
14752,2,1,51826,51826,51827,0,1,1
14753,6,1,51832,51832,51833,0,1,5
14754,2,1,51834,51834,51835,0,1,1
14755,4,3,51838,51838,51841,0,3,3
14756,4,2,51842,51842,51844,0,2,1
14757,1,3,51843,51844,51847,1,4,0
14758,4,3,51847,51847,51850,0,3,0
14759,3,2,51850,51850,51852,0,2,0
14760,1,3,51851,51852,51855,1,4,0
14761,1,3,51852,51855,51858,3,6,0
14762,5,1,51857,51858,51859,1,2,0
14763,5,2,51862,51862,51864,0,2,3
14764,4,2,51866,51866,51868,0,2,2
14765,2,2,51868,51868,51870,0,2,0
14766,2,3,51870,51870,51873,0,3,0
14767,5,2,51875,51875,51877,0,2,2
14768,2,2,51877,51877,51879,0,2,0
14769,2,1,51879,51879,51880,0,1,0
14770,5,1,51884,51884,51885,0,1,4
14771,1,1,51885,51885,51886,0,1,0
14772,1,2,51886,51886,51888,0,2,0
14773,1,1,51887,51888,51889,1,2,0
14774,3,1,51890,51890,51891,0,1,1
14775,4,3,51894,51894,51897,0,3,3
14776,4,1,51898,51898,51899,0,1,1
14777,5,3,51903,51903,51906,0,3,4
14778,5,2,51908,51908,51910,0,2,2
14779,1,1,51909,51910,51911,1,2,0
14780,2,2,51911,51911,51913,0,2,0
14781,6,1,51917,51917,51918,0,1,4
14782,1,2,51918,51918,51920,0,2,0
14783,3,1,51921,51921,51922,0,1,1
14784,4,2,51925,51925,51927,0,2,3
14785,2,1,51927,51927,51928,0,1,0
14786,2,3,51929,51929,51932,0,3,1
14787,2,3,51931,51932,51935,1,4,0
14788,6,2,51937,51937,51939,0,2,2
14789,3,2,51940,51940,51942,0,2,1
14790,2,2,51942,51942,51944,0,2,0
14791,6,1,51948,51948,51949,0,1,4
14792,3,3,51951,51951,51954,0,3,2
14793,4,1,51955,51955,51956,0,1,1
14794,6,2,51961,51961,51963,0,2,5
14795,5,2,51966,51966,51968,0,2,3
14796,4,2,51970,51970,51972,0,2,2
14797,3,1,51973,51973,51974,0,1,1
14798,1,2,51974,51974,51976,0,2,0
14799,4,1,51978,51978,51979,0,1,2
14800,1,1,51979,51979,51980,0,1,0
14801,2,3,51981,51981,51984,0,3,1
14802,6,2,51987,51987,51989,0,2,3
14803,1,1,51988,51989,51990,1,2,0
14804,3,1,51991,51991,51992,0,1,1
14805,3,2,51994,51994,51996,0,2,2
14806,6,1,52000,52000,52001,0,1,4
14807,2,1,52002,52002,52003,0,1,1
14808,6,2,52008,52008,52010,0,2,5
14809,5,1,52013,52013,52014,0,1,3
14810,6,1,52019,52019,52020,0,1,5
14811,1,1,52020,52020,52021,0,1,0
14812,5,3,52025,52025,52028,0,3,4
14813,6,2,52031,52031,52033,0,2,3
14814,1,3,52032,52033,52036,1,4,0
14815,3,1,52035,52036,52037,1,2,0
14816,5,1,52040,52040,52041,0,1,3
14817,4,3,52044,52044,52047,0,3,3
14818,6,1,52050,52050,52051,0,1,3
14819,4,1,52054,52054,52055,0,1,3
14820,4,3,52058,52058,52061,0,3,3
14821,4,2,52062,52062,52064,0,2,1
14822,6,3,52068,52068,52071,0,3,4
14823,5,2,52073,52073,52075,0,2,2
14824,6,2,52079,52079,52081,0,2,4
14825,5,3,52084,52084,52087,0,3,3
14826,4,1,52088,52088,52089,0,1,1
14827,3,3,52091,52091,52094,0,3,2
14828,6,2,52097,52097,52099,0,2,3
14829,2,1,52099,52099,52100,0,1,0
14830,6,3,52105,52105,52108,0,3,5
14831,6,3,52111,52111,52114,0,3,3
14832,3,3,52114,52114,52117,0,3,0
14833,2,1,52116,52117,52118,1,2,0
14834,1,3,52117,52118,52121,1,4,0
14835,1,2,52118,52121,52123,3,5,0
14836,6,3,52124,52124,52127,0,3,1
14837,1,3,52125,52127,52130,2,5,0
14838,6,1,52131,52131,52132,0,1,1
14839,1,3,52132,52132,52135,0,3,0
14840,5,3,52137,52137,52140,0,3,2
14841,2,2,52139,52140,52142,1,3,0
14842,5,1,52144,52144,52145,0,1,2
14843,4,3,52148,52148,52151,0,3,3
14844,1,3,52149,52151,52154,2,5,0
14845,5,1,52154,52154,52155,0,1,0
14846,2,3,52156,52156,52159,0,3,1
14847,4,1,52160,52160,52161,0,1,1
14848,3,3,52163,52163,52166,0,3,2
14849,5,2,52168,52168,52170,0,2,2
14850,3,2,52171,52171,52173,0,2,1
14851,6,3,52177,52177,52180,0,3,4
14852,4,1,52181,52181,52182,0,1,1
14853,6,2,52187,52187,52189,0,2,5
14854,4,3,52191,52191,52194,0,3,2
14855,4,3,52195,52195,52198,0,3,1
14856,4,2,52199,52199,52201,0,2,1
14857,2,1,52201,52201,52202,0,1,0
14858,3,1,52204,52204,52205,0,1,2
14859,4,2,52208,52208,52210,0,2,3
14860,1,2,52209,52210,52212,1,3,0
14861,5,1,52214,52214,52215,0,1,2
14862,5,1,52219,52219,52220,0,1,4
14863,2,1,52221,52221,52222,0,1,1
14864,1,3,52222,52222,52225,0,3,0
14865,6,3,52228,52228,52231,0,3,3
14866,3,2,52231,52231,52233,0,2,0
14867,2,2,52233,52233,52235,0,2,0
14868,4,2,52237,52237,52239,0,2,2
14869,3,3,52240,52240,52243,0,3,1
14870,1,1,52241,52243,52244,2,3,0
14871,6,1,52247,52247,52248,0,1,3
14872,5,2,52252,52252,52254,0,2,4
14873,6,1,52258,52258,52259,0,1,4
14874,5,1,52263,52263,52264,0,1,4
14875,2,3,52265,52265,52268,0,3,1
14876,1,1,52266,52268,52269,2,3,0
14877,3,3,52269,52269,52272,0,3,0
14878,6,1,52275,52275,52276,0,1,3
14879,4,3,52279,52279,52282,0,3,3
14880,6,1,52285,52285,52286,0,1,3
14881,6,2,52291,52291,52293,0,2,5
14882,3,2,52294,52294,52296,0,2,1
14883,5,3,52299,52299,52302,0,3,3
14884,2,2,52301,52302,52304,1,3,0
14885,1,3,52302,52304,52307,2,5,0
14886,2,2,52304,52307,52309,3,5,0
14887,4,3,52308,52309,52312,1,4,0
14888,2,3,52310,52312,52315,2,5,0
14889,6,3,52316,52316,52319,0,3,1
14890,6,3,52322,52322,52325,0,3,3
14891,5,3,52327,52327,52330,0,3,2
14892,2,2,52329,52330,52332,1,3,0
14893,6,2,52335,52335,52337,0,2,3
14894,3,2,52338,52338,52340,0,2,1
14895,4,3,52342,52342,52345,0,3,2
14896,6,3,52348,52348,52351,0,3,3
14897,3,3,52351,52351,52354,0,3,0
14898,3,2,52354,52354,52356,0,2,0
14899,1,3,52355,52356,52359,1,4,0
14900,3,3,52358,52359,52362,1,4,0
14901,1,2,52359,52362,52364,3,5,0
14902,6,1,52365,52365,52366,0,1,1
14903,1,3,52366,52366,52369,0,3,0
14904,2,1,52368,52369,52370,1,2,0
14905,5,3,52373,52373,52376,0,3,3
14906,2,3,52375,52376,52379,1,4,0
14907,6,1,52381,52381,52382,0,1,2
14908,2,3,52383,52383,52386,0,3,1
14909,1,2,52384,52386,52388,2,4,0
14910,3,3,52387,52388,52391,1,4,0
14911,4,2,52391,52391,52393,0,2,0
14912,6,1,52397,52397,52398,0,1,4
14913,6,2,52403,52403,52405,0,2,5
14914,5,3,52408,52408,52411,0,3,3
14915,6,2,52414,52414,52416,0,2,3
14916,4,3,52418,52418,52421,0,3,2
14917,6,3,52424,52424,52427,0,3,3
14918,3,2,52427,52427,52429,0,2,0
14919,4,2,52431,52431,52433,0,2,2
14920,6,2,52437,52437,52439,0,2,4
14921,5,2,52442,52442,52444,0,2,3
14922,4,3,52446,52446,52449,0,3,2
14923,3,3,52449,52449,52452,0,3,0
14924,5,1,52454,52454,52455,0,1,2
14925,4,3,52458,52458,52461,0,3,3
14926,6,1,52464,52464,52465,0,1,3
14927,3,2,52467,52467,52469,0,2,2
14928,6,3,52473,52473,52476,0,3,4
14929,1,1,52474,52476,52477,2,3,0
14930,3,3,52477,52477,52480,0,3,0
14931,2,2,52479,52480,52482,1,3,0
14932,3,1,52482,52482,52483,0,1,0
14933,2,3,52484,52484,52487,0,3,1
14934,2,2,52486,52487,52489,1,3,0
14935,1,3,52487,52489,52492,2,5,0
14936,1,3,52488,52492,52495,4,7,0
14937,1,3,52489,52495,52498,6,9,0
14938,1,1,52490,52498,52499,8,9,0
14939,4,3,52494,52499,52502,5,8,0
14940,2,2,52496,52502,52504,6,8,0
14941,1,3,52497,52504,52507,7,10,0
14942,5,3,52502,52507,52510,5,8,0
14943,4,2,52506,52510,52512,4,6,0
14944,5,1,52511,52512,52513,1,2,0
14945,5,1,52516,52516,52517,0,1,3
14946,1,3,52517,52517,52520,0,3,0
14947,2,2,52519,52520,52522,1,3,0
14948,6,1,52525,52525,52526,0,1,3
14949,2,3,52527,52527,52530,0,3,1
14950,3,3,52530,52530,52533,0,3,0
14951,5,2,52535,52535,52537,0,2,2
14952,3,3,52538,52538,52541,0,3,1
14953,3,3,52541,52541,52544,0,3,0
14954,2,3,52543,52544,52547,1,4,0
14955,1,2,52544,52547,52549,3,5,0
14956,6,3,52550,52550,52553,0,3,1
14957,3,2,52553,52553,52555,0,2,0
14958,3,3,52556,52556,52559,0,3,1
14959,6,2,52562,52562,52564,0,2,3
14960,4,2,52566,52566,52568,0,2,2
14961,2,1,52568,52568,52569,0,1,0
14962,5,3,52573,52573,52576,0,3,4
14963,1,2,52574,52576,52578,2,4,0
14964,3,3,52577,52578,52581,1,4,0
14965,4,1,52581,52581,52582,0,1,0
14966,4,2,52585,52585,52587,0,2,3
14967,6,1,52591,52591,52592,0,1,4
14968,4,3,52595,52595,52598,0,3,3
14969,3,1,52598,52598,52599,0,1,0
14970,6,3,52604,52604,52607,0,3,5
14971,4,3,52608,52608,52611,0,3,1
14972,4,3,52612,52612,52615,0,3,1
14973,4,2,52616,52616,52618,0,2,1
14974,6,2,52622,52622,52624,0,2,4
14975,3,3,52625,52625,52628,0,3,1
14976,1,3,52626,52628,52631,2,5,0
14977,5,2,52631,52631,52633,0,2,0
14978,6,1,52637,52637,52638,0,1,4
14979,3,1,52640,52640,52641,0,1,2
14980,1,2,52641,52641,52643,0,2,0
14981,1,1,52642,52643,52644,1,2,0
14982,1,1,52643,52644,52645,1,2,0
14983,6,3,52649,52649,52652,0,3,4
14984,3,3,52652,52652,52655,0,3,0
14985,6,3,52658,52658,52661,0,3,3
14986,4,3,52662,52662,52665,0,3,1
14987,4,3,52666,52666,52669,0,3,1
14988,1,1,52667,52669,52670,2,3,0
14989,2,2,52669,52670,52672,1,3,0
14990,4,1,52673,52673,52674,0,1,1
14991,3,3,52676,52676,52679,0,3,2
14992,4,3,52680,52680,52683,0,3,1
14993,4,1,52684,52684,52685,0,1,1
14994,2,1,52686,52686,52687,0,1,1
14995,1,1,52687,52687,52688,0,1,0
14996,3,1,52690,52690,52691,0,1,2
14997,5,2,52695,52695,52697,0,2,4
14998,4,3,52699,52699,52702,0,3,2
14999,4,2,52703,52703,52705,0,2,1
15000,2,1,52705,52705,52706,0,1,0
15001,4,1,52709,52709,52710,0,1,3
15002,2,2,52711,52711,52713,0,2,1
15003,1,2,52712,52713,52715,1,3,0
15004,5,2,52717,52717,52719,0,2,2
15005,2,2,52719,52719,52721,0,2,0
15006,1,3,52720,52721,52724,1,4,0
15007,5,2,52725,52725,52727,0,2,1
15008,5,2,52730,52730,52732,0,2,3
15009,2,3,52732,52732,52735,0,3,0
15010,1,3,52733,52735,52738,2,5,0
15011,6,1,52739,52739,52740,0,1,1
15012,1,2,52740,52740,52742,0,2,0
15013,4,2,52744,52744,52746,0,2,2
15014,5,3,52749,52749,52752,0,3,3
15015,1,3,52750,52752,52755,2,5,0
15016,2,3,52752,52755,52758,3,6,0
15017,3,2,52755,52758,52760,3,5,0
15018,3,1,52758,52760,52761,2,3,0
15019,2,3,52760,52761,52764,1,4,0
15020,1,3,52761,52764,52767,3,6,0
15021,4,1,52765,52767,52768,2,3,0
15022,2,2,52767,52768,52770,1,3,0
15023,4,1,52771,52771,52772,0,1,1
15024,6,1,52777,52777,52778,0,1,5
15025,5,3,52782,52782,52785,0,3,4
15026,3,3,52785,52785,52788,0,3,0
15027,4,2,52789,52789,52791,0,2,1
15028,2,3,52791,52791,52794,0,3,0
15029,2,1,52793,52794,52795,1,2,0
15030,5,2,52798,52798,52800,0,2,3
15031,2,3,52800,52800,52803,0,3,0
15032,5,1,52805,52805,52806,0,1,2
15033,3,1,52808,52808,52809,0,1,2
15034,6,1,52814,52814,52815,0,1,5
15035,3,1,52817,52817,52818,0,1,2
15036,5,1,52822,52822,52823,0,1,4
15037,1,1,52823,52823,52824,0,1,0
15038,6,1,52829,52829,52830,0,1,5
15039,1,2,52830,52830,52832,0,2,0
15040,4,2,52834,52834,52836,0,2,2
15041,5,2,52839,52839,52841,0,2,3
15042,3,2,52842,52842,52844,0,2,1
15043,1,2,52843,52844,52846,1,3,0
15044,3,2,52846,52846,52848,0,2,0
15045,5,2,52851,52851,52853,0,2,3
15046,3,3,52854,52854,52857,0,3,1
15047,1,3,52855,52857,52860,2,5,0
15048,2,1,52857,52860,52861,3,4,0
15049,4,2,52861,52861,52863,0,2,0
15050,1,3,52862,52863,52866,1,4,0
15051,4,3,52866,52866,52869,0,3,0
15052,6,1,52872,52872,52873,0,1,3
15053,5,2,52877,52877,52879,0,2,4
15054,3,1,52880,52880,52881,0,1,1
15055,3,2,52883,52883,52885,0,2,2
15056,3,2,52886,52886,52888,0,2,1
15057,2,1,52888,52888,52889,0,1,0
15058,4,2,52892,52892,52894,0,2,3
15059,6,1,52898,52898,52899,0,1,4
15060,2,1,52900,52900,52901,0,1,1
15061,6,2,52906,52906,52908,0,2,5
15062,5,3,52911,52911,52914,0,3,3
15063,6,1,52917,52917,52918,0,1,3
15064,1,3,52918,52918,52921,0,3,0
15065,1,3,52919,52921,52924,2,5,0
15066,5,3,52924,52924,52927,0,3,0
15067,3,2,52927,52927,52929,0,2,0
15068,4,2,52931,52931,52933,0,2,2
15069,5,1,52936,52936,52937,0,1,3
15070,6,3,52942,52942,52945,0,3,5
15071,3,2,52945,52945,52947,0,2,0
15072,5,3,52950,52950,52953,0,3,3
15073,1,1,52951,52953,52954,2,3,0
15074,5,3,52956,52956,52959,0,3,2
15075,5,1,52961,52961,52962,0,1,2
15076,3,3,52964,52964,52967,0,3,2
15077,2,3,52966,52967,52970,1,4,0
15078,2,2,52968,52970,52972,2,4,0
15079,6,1,52974,52974,52975,0,1,2
15080,4,2,52978,52978,52980,0,2,3
15081,1,1,52979,52980,52981,1,2,0
15082,5,1,52984,52984,52985,0,1,3
15083,4,3,52988,52988,52991,0,3,3
15084,6,2,52994,52994,52996,0,2,3
15085,2,3,52996,52996,52999,0,3,0
15086,1,2,52997,52999,53001,2,4,0
15087,6,2,53003,53003,53005,0,2,2
15088,6,2,53009,53009,53011,0,2,4
15089,2,2,53011,53011,53013,0,2,0
15090,4,3,53015,53015,53018,0,3,2
15091,2,3,53017,53018,53021,1,4,0
15092,6,1,53023,53023,53024,0,1,2
15093,2,3,53025,53025,53028,0,3,1
15094,4,3,53029,53029,53032,0,3,1
15095,2,1,53031,53032,53033,1,2,0
15096,5,2,53036,53036,53038,0,2,3
15097,4,2,53040,53040,53042,0,2,2
15098,2,1,53042,53042,53043,0,1,0
15099,4,2,53046,53046,53048,0,2,3
15100,2,3,53048,53048,53051,0,3,0
15101,3,1,53051,53051,53052,0,1,0
15102,3,2,53054,53054,53056,0,2,2
15103,1,2,53055,53056,53058,1,3,0
15104,6,2,53061,53061,53063,0,2,3
15105,2,3,53063,53063,53066,0,3,0
15106,1,3,53064,53066,53069,2,5,0
15107,2,1,53066,53069,53070,3,4,0
15108,4,1,53070,53070,53071,0,1,0
15109,1,1,53071,53071,53072,0,1,0
15110,4,2,53075,53075,53077,0,2,3
15111,6,3,53081,53081,53084,0,3,4
15112,4,1,53085,53085,53086,0,1,1
15113,4,1,53089,53089,53090,0,1,3
15114,1,2,53090,53090,53092,0,2,0
15115,3,2,53093,53093,53095,0,2,1
15116,1,3,53094,53095,53098,1,4,0
15117,2,3,53096,53098,53101,2,5,0
15118,4,1,53100,53101,53102,1,2,0
15119,1,3,53101,53102,53105,1,4,0
15120,2,2,53103,53105,53107,2,4,0
15121,6,1,53109,53109,53110,0,1,2
15122,6,3,53115,53115,53118,0,3,5
15123,5,1,53120,53120,53121,0,1,2
15124,5,2,53125,53125,53127,0,2,4
15125,5,3,53130,53130,53133,0,3,3
15126,2,3,53132,53133,53136,1,4,0
15127,3,2,53135,53136,53138,1,3,0
15128,2,3,53137,53138,53141,1,4,0
15129,1,3,53138,53141,53144,3,6,0
15130,6,1,53144,53144,53145,0,1,0
15131,1,2,53145,53145,53147,0,2,0
15132,4,1,53149,53149,53150,0,1,2
15133,2,2,53151,53151,53153,0,2,1
15134,2,2,53153,53153,53155,0,2,0
15135,2,2,53155,53155,53157,0,2,0
15136,4,2,53159,53159,53161,0,2,2
15137,4,1,53163,53163,53164,0,1,2
15138,6,3,53169,53169,53172,0,3,5
15139,4,2,53173,53173,53175,0,2,1
15140,2,1,53175,53175,53176,0,1,0
15141,3,1,53178,53178,53179,0,1,2
15142,5,2,53183,53183,53185,0,2,4
15143,6,3,53189,53189,53192,0,3,4
15144,1,2,53190,53192,53194,2,4,0
15145,3,3,53193,53194,53197,1,4,0
15146,1,3,53194,53197,53200,3,6,0
15147,6,3,53200,53200,53203,0,3,0
15148,2,2,53202,53203,53205,1,3,0
15149,5,3,53207,53207,53210,0,3,2
15150,5,2,53212,53212,53214,0,2,2
15151,4,3,53216,53216,53219,0,3,2
15152,3,3,53219,53219,53222,0,3,0
15153,1,3,53220,53222,53225,2,5,0
15154,5,3,53225,53225,53228,0,3,0
15155,1,1,53226,53228,53229,2,3,0
15156,5,3,53231,53231,53234,0,3,2
15157,6,3,53237,53237,53240,0,3,3
15158,5,1,53242,53242,53243,0,1,2
15159,2,2,53244,53244,53246,0,2,1
15160,1,2,53245,53246,53248,1,3,0
15161,1,3,53246,53248,53251,2,5,0
15162,4,1,53250,53251,53252,1,2,0
15163,4,1,53254,53254,53255,0,1,2
15164,1,2,53255,53255,53257,0,2,0
15165,3,3,53258,53258,53261,0,3,1
15166,3,1,53261,53261,53262,0,1,0
15167,1,1,53262,53262,53263,0,1,0
15168,2,3,53264,53264,53267,0,3,1
15169,6,2,53270,53270,53272,0,2,3
15170,4,3,53274,53274,53277,0,3,2
15171,6,2,53280,53280,53282,0,2,3
15172,1,1,53281,53282,53283,1,2,0
15173,1,1,53282,53283,53284,1,2,0
15174,5,2,53287,53287,53289,0,2,3
15175,1,1,53288,53289,53290,1,2,0
15176,6,3,53294,53294,53297,0,3,4
15177,5,3,53299,53299,53302,0,3,2
15178,5,1,53304,53304,53305,0,1,2
15179,1,2,53305,53305,53307,0,2,0
15180,6,2,53311,53311,53313,0,2,4
15181,5,2,53316,53316,53318,0,2,3
15182,6,3,53322,53322,53325,0,3,4
15183,5,2,53327,53327,53329,0,2,2
15184,1,3,53328,53329,53332,1,4,0
15185,6,2,53334,53334,53336,0,2,2
15186,3,2,53337,53337,53339,0,2,1
15187,6,1,53343,53343,53344,0,1,4
15188,3,1,53346,53346,53347,0,1,2
15189,2,1,53348,53348,53349,0,1,1
15190,5,3,53353,53353,53356,0,3,4
15191,1,2,53354,53356,53358,2,4,0
15192,1,3,53355,53358,53361,3,6,0
15193,2,2,53357,53361,53363,4,6,0
15194,3,2,53360,53363,53365,3,5,0
15195,5,2,53365,53365,53367,0,2,0
15196,4,3,53369,53369,53372,0,3,2
15197,5,3,53374,53374,53377,0,3,2
15198,2,1,53376,53377,53378,1,2,0
15199,2,2,53378,53378,53380,0,2,0
15200,2,3,53380,53380,53383,0,3,0
15201,3,3,53383,53383,53386,0,3,0
15202,5,3,53388,53388,53391,0,3,2
15203,1,2,53389,53391,53393,2,4,0
15204,3,3,53392,53393,53396,1,4,0
15205,3,1,53395,53396,53397,1,2,0
15206,1,2,53396,53397,53399,1,3,0
15207,3,1,53399,53399,53400,0,1,0
15208,1,1,53400,53400,53401,0,1,0
15209,6,1,53406,53406,53407,0,1,5
15210,4,2,53410,53410,53412,0,2,3
15211,6,3,53416,53416,53419,0,3,4
15212,3,2,53419,53419,53421,0,2,0
15213,1,2,53420,53421,53423,1,3,0
15214,4,3,53424,53424,53427,0,3,1
15215,3,1,53427,53427,53428,0,1,0
15216,1,1,53428,53428,53429,0,1,0
15217,4,2,53432,53432,53434,0,2,3
15218,1,3,53433,53434,53437,1,4,0
15219,3,3,53436,53437,53440,1,4,0
15220,3,1,53439,53440,53441,1,2,0
15221,2,2,53441,53441,53443,0,2,0
15222,4,2,53445,53445,53447,0,2,2
15223,1,3,53446,53447,53450,1,4,0
15224,1,2,53447,53450,53452,3,5,0
15225,1,3,53448,53452,53455,4,7,0
15226,2,1,53450,53455,53456,5,6,0
15227,5,1,53455,53456,53457,1,2,0
15228,4,2,53459,53459,53461,0,2,2
15229,1,3,53460,53461,53464,1,4,0
15230,4,3,53464,53464,53467,0,3,0
15231,4,1,53468,53468,53469,0,1,1
15232,2,3,53470,53470,53473,0,3,1
15233,5,1,53475,53475,53476,0,1,2
15234,2,1,53477,53477,53478,0,1,1
15235,2,2,53479,53479,53481,0,2,1
15236,3,2,53482,53482,53484,0,2,1
15237,5,3,53487,53487,53490,0,3,3
15238,5,3,53492,53492,53495,0,3,2
15239,6,1,53498,53498,53499,0,1,3
15240,4,1,53502,53502,53503,0,1,3
15241,4,1,53506,53506,53507,0,1,3
15242,5,1,53511,53511,53512,0,1,4
15243,6,2,53517,53517,53519,0,2,5
15244,5,2,53522,53522,53524,0,2,3
15245,1,1,53523,53524,53525,1,2,0
15246,5,2,53528,53528,53530,0,2,3
15247,5,1,53533,53533,53534,0,1,3
15248,6,3,53539,53539,53542,0,3,5
15249,5,3,53544,53544,53547,0,3,2
15250,3,2,53547,53547,53549,0,2,0
15251,3,3,53550,53550,53553,0,3,1
15252,2,1,53552,53553,53554,1,2,0
15253,2,2,53554,53554,53556,0,2,0
15254,5,2,53559,53559,53561,0,2,3
15255,5,2,53564,53564,53566,0,2,3
15256,5,2,53569,53569,53571,0,2,3
15257,4,2,53573,53573,53575,0,2,2
15258,1,3,53574,53575,53578,1,4,0
15259,3,3,53577,53578,53581,1,4,0
15260,1,3,53578,53581,53584,3,6,0
15261,2,2,53580,53584,53586,4,6,0
15262,3,3,53583,53586,53589,3,6,0
15263,3,1,53586,53589,53590,3,4,0
15264,3,2,53589,53590,53592,1,3,0
15265,3,3,53592,53592,53595,0,3,0
15266,6,1,53598,53598,53599,0,1,3
15267,4,3,53602,53602,53605,0,3,3
15268,4,2,53606,53606,53608,0,2,1
15269,2,1,53608,53608,53609,0,1,0
15270,2,1,53610,53610,53611,0,1,1
15271,2,2,53612,53612,53614,0,2,1
15272,2,3,53614,53614,53617,0,3,0
15273,5,3,53619,53619,53622,0,3,2
15274,5,1,53624,53624,53625,0,1,2
15275,4,1,53628,53628,53629,0,1,3
15276,1,1,53629,53629,53630,0,1,0
15277,3,1,53632,53632,53633,0,1,2
15278,2,3,53634,53634,53637,0,3,1
15279,6,2,53640,53640,53642,0,2,3
15280,1,3,53641,53642,53645,1,4,0
15281,5,3,53646,53646,53649,0,3,1
15282,2,1,53648,53649,53650,1,2,0
15283,3,2,53651,53651,53653,0,2,1
15284,2,2,53653,53653,53655,0,2,0
15285,6,3,53659,53659,53662,0,3,4
15286,1,3,53660,53662,53665,2,5,0
15287,1,1,53661,53665,53666,4,5,0
15288,6,2,53667,53667,53669,0,2,1
15289,4,3,53671,53671,53674,0,3,2
15290,5,3,53676,53676,53679,0,3,2
15291,1,3,53677,53679,53682,2,5,0
15292,1,3,53678,53682,53685,4,7,0
15293,6,2,53684,53685,53687,1,3,0
15294,2,3,53686,53687,53690,1,4,0
15295,4,2,53690,53690,53692,0,2,0
15296,5,1,53695,53695,53696,0,1,3
15297,1,3,53696,53696,53699,0,3,0
15298,3,3,53699,53699,53702,0,3,0
15299,1,3,53700,53702,53705,2,5,0
15300,5,2,53705,53705,53707,0,2,0
15301,5,1,53710,53710,53711,0,1,3
15302,6,2,53716,53716,53718,0,2,5
15303,5,2,53721,53721,53723,0,2,3
15304,2,1,53723,53723,53724,0,1,0
15305,3,1,53726,53726,53727,0,1,2
15306,4,1,53730,53730,53731,0,1,3
15307,1,2,53731,53731,53733,0,2,0
15308,3,3,53734,53734,53737,0,3,1
15309,4,2,53738,53738,53740,0,2,1
15310,2,2,53740,53740,53742,0,2,0
15311,2,1,53742,53742,53743,0,1,0
15312,4,2,53746,53746,53748,0,2,3
15313,1,1,53747,53748,53749,1,2,0
15314,1,2,53748,53749,53751,1,3,0
15315,2,2,53750,53751,53753,1,3,0
15316,5,3,53755,53755,53758,0,3,2
15317,6,2,53761,53761,53763,0,2,3
15318,2,1,53763,53763,53764,0,1,0
15319,3,2,53766,53766,53768,0,2,2
15320,6,3,53772,53772,53775,0,3,4
15321,6,3,53778,53778,53781,0,3,3
15322,2,1,53780,53781,53782,1,2,0
15323,2,1,53782,53782,53783,0,1,0
15324,2,2,53784,53784,53786,0,2,1
15325,3,1,53787,53787,53788,0,1,1
15326,6,2,53793,53793,53795,0,2,5
15327,6,1,53799,53799,53800,0,1,4
15328,3,3,53802,53802,53805,0,3,2
15329,4,2,53806,53806,53808,0,2,1
15330,5,1,53811,53811,53812,0,1,3
15331,5,3,53816,53816,53819,0,3,4
15332,1,3,53817,53819,53822,2,5,0
15333,2,1,53819,53822,53823,3,4,0
15334,3,1,53822,53823,53824,1,2,0
15335,2,1,53824,53824,53825,0,1,0
15336,3,2,53827,53827,53829,0,2,2
15337,4,3,53831,53831,53834,0,3,2
15338,5,3,53836,53836,53839,0,3,2
15339,3,2,53839,53839,53841,0,2,0
15340,6,2,53845,53845,53847,0,2,4
15341,5,2,53850,53850,53852,0,2,3
15342,6,3,53856,53856,53859,0,3,4
15343,5,2,53861,53861,53863,0,2,2
15344,6,3,53867,53867,53870,0,3,4
15345,1,2,53868,53870,53872,2,4,0
15346,1,3,53869,53872,53875,3,6,0
15347,1,1,53870,53875,53876,5,6,0
15348,4,2,53874,53876,53878,2,4,0
15349,1,3,53875,53878,53881,3,6,0
15350,5,3,53880,53881,53884,1,4,0
15351,1,1,53881,53884,53885,3,4,0
15352,6,1,53887,53887,53888,0,1,2
15353,5,1,53892,53892,53893,0,1,4
15354,4,1,53896,53896,53897,0,1,3
15355,5,1,53901,53901,53902,0,1,4
15356,5,1,53906,53906,53907,0,1,4
15357,6,3,53912,53912,53915,0,3,5
15358,6,2,53918,53918,53920,0,2,3
15359,2,3,53920,53920,53923,0,3,0
15360,6,1,53926,53926,53927,0,1,3
15361,5,2,53931,53931,53933,0,2,4
15362,2,1,53933,53933,53934,0,1,0
15363,6,3,53939,53939,53942,0,3,5
15364,3,2,53942,53942,53944,0,2,0
15365,5,2,53947,53947,53949,0,2,3
15366,6,3,53953,53953,53956,0,3,4
15367,5,3,53958,53958,53961,0,3,2
15368,1,3,53959,53961,53964,2,5,0
15369,5,1,53964,53964,53965,0,1,0
15370,2,3,53966,53966,53969,0,3,1
15371,4,1,53970,53970,53971,0,1,1
15372,2,2,53972,53972,53974,0,2,1
15373,6,2,53978,53978,53980,0,2,4
15374,3,1,53981,53981,53982,0,1,1
15375,3,2,53984,53984,53986,0,2,2
15376,2,3,53986,53986,53989,0,3,0
15377,3,3,53989,53989,53992,0,3,0
15378,4,1,53993,53993,53994,0,1,1
15379,4,2,53997,53997,53999,0,2,3
15380,6,1,54003,54003,54004,0,1,4
15381,4,2,54007,54007,54009,0,2,3
15382,1,1,54008,54009,54010,1,2,0
15383,4,2,54012,54012,54014,0,2,2
15384,4,1,54016,54016,54017,0,1,2
15385,3,3,54019,54019,54022,0,3,2
15386,5,1,54024,54024,54025,0,1,2
15387,5,1,54029,54029,54030,0,1,4
15388,5,2,54034,54034,54036,0,2,4
15389,2,1,54036,54036,54037,0,1,0
15390,1,2,54037,54037,54039,0,2,0
15391,4,1,54041,54041,54042,0,1,2
15392,5,1,54046,54046,54047,0,1,4
15393,2,2,54048,54048,54050,0,2,1
15394,4,3,54052,54052,54055,0,3,2
15395,5,1,54057,54057,54058,0,1,2
15396,1,1,54058,54058,54059,0,1,0
15397,2,3,54060,54060,54063,0,3,1
15398,1,1,54061,54063,54064,2,3,0
15399,6,1,54067,54067,54068,0,1,3
15400,1,2,54068,54068,54070,0,2,0
15401,4,2,54072,54072,54074,0,2,2
15402,6,2,54078,54078,54080,0,2,4
15403,6,3,54084,54084,54087,0,3,4
15404,3,2,54087,54087,54089,0,2,0
15405,2,1,54089,54089,54090,0,1,0
15406,1,3,54090,54090,54093,0,3,0
15407,4,2,54094,54094,54096,0,2,1
15408,4,1,54098,54098,54099,0,1,2
15409,6,3,54104,54104,54107,0,3,5
15410,6,2,54110,54110,54112,0,2,3
15411,1,3,54111,54112,54115,1,4,0
15412,4,3,54115,54115,54118,0,3,0
15413,2,2,54117,54118,54120,1,3,0
15414,3,2,54120,54120,54122,0,2,0
15415,5,1,54125,54125,54126,0,1,3
15416,2,3,54127,54127,54130,0,3,1
15417,5,2,54132,54132,54134,0,2,2
15418,6,1,54138,54138,54139,0,1,4
15419,1,2,54139,54139,54141,0,2,0
15420,2,3,54141,54141,54144,0,3,0
15421,4,1,54145,54145,54146,0,1,1
15422,1,2,54146,54146,54148,0,2,0
15423,6,2,54152,54152,54154,0,2,4
15424,3,3,54155,54155,54158,0,3,1
15425,4,2,54159,54159,54161,0,2,1
15426,3,2,54162,54162,54164,0,2,1
15427,3,3,54165,54165,54168,0,3,1
15428,5,2,54170,54170,54172,0,2,2
15429,5,3,54175,54175,54178,0,3,3
15430,5,3,54180,54180,54183,0,3,2
15431,4,2,54184,54184,54186,0,2,1
15432,1,2,54185,54186,54188,1,3,0
15433,1,2,54186,54188,54190,2,4,0
15434,6,1,54192,54192,54193,0,1,2
15435,6,3,54198,54198,54201,0,3,5
15436,2,3,54200,54201,54204,1,4,0
15437,3,1,54203,54204,54205,1,2,0
15438,6,2,54209,54209,54211,0,2,4
15439,1,3,54210,54211,54214,1,4,0
15440,3,2,54213,54214,54216,1,3,0
15441,5,1,54218,54218,54219,0,1,2
15442,5,2,54223,54223,54225,0,2,4
15443,3,1,54226,54226,54227,0,1,1
15444,6,3,54232,54232,54235,0,3,5
15445,2,2,54234,54235,54237,1,3,0
15446,6,1,54240,54240,54241,0,1,3
15447,1,1,54241,54241,54242,0,1,0
15448,3,3,54244,54244,54247,0,3,2
15449,5,2,54249,54249,54251,0,2,2
15450,6,3,54255,54255,54258,0,3,4
15451,1,2,54256,54258,54260,2,4,0
15452,6,2,54262,54262,54264,0,2,2
15453,6,1,54268,54268,54269,0,1,4
15454,4,2,54272,54272,54274,0,2,3
15455,6,1,54278,54278,54279,0,1,4
15456,1,3,54279,54279,54282,0,3,0
15457,2,1,54281,54282,54283,1,2,0
15458,2,2,54283,54283,54285,0,2,0
15459,6,2,54289,54289,54291,0,2,4
15460,3,3,54292,54292,54295,0,3,1
15461,4,2,54296,54296,54298,0,2,1
15462,1,1,54297,54298,54299,1,2,0
15463,6,2,54303,54303,54305,0,2,4
15464,2,3,54305,54305,54308,0,3,0
15465,2,1,54307,54308,54309,1,2,0
15466,6,2,54313,54313,54315,0,2,4
15467,6,3,54319,54319,54322,0,3,4
15468,6,1,54325,54325,54326,0,1,3
15469,1,1,54326,54326,54327,0,1,0
15470,4,2,54330,54330,54332,0,2,3
15471,1,2,54331,54332,54334,1,3,0
15472,1,2,54332,54334,54336,2,4,0
15473,4,3,54336,54336,54339,0,3,0
15474,5,2,54341,54341,54343,0,2,2
15475,1,2,54342,54343,54345,1,3,0
15476,2,1,54344,54345,54346,1,2,0
15477,6,3,54350,54350,54353,0,3,4
15478,3,2,54353,54353,54355,0,2,0
15479,4,2,54357,54357,54359,0,2,2
15480,3,1,54360,54360,54361,0,1,1
15481,1,1,54361,54361,54362,0,1,0
15482,5,1,54366,54366,54367,0,1,4
15483,1,3,54367,54367,54370,0,3,0
15484,6,3,54373,54373,54376,0,3,3
15485,5,2,54378,54378,54380,0,2,2
15486,4,2,54382,54382,54384,0,2,2
15487,3,2,54385,54385,54387,0,2,1
15488,4,2,54389,54389,54391,0,2,2
15489,3,1,54392,54392,54393,0,1,1
15490,4,2,54396,54396,54398,0,2,3
15491,2,1,54398,54398,54399,0,1,0
15492,1,1,54399,54399,54400,0,1,0
15493,4,2,54403,54403,54405,0,2,3
15494,3,1,54406,54406,54407,0,1,1
15495,6,3,54412,54412,54415,0,3,5
15496,3,2,54415,54415,54417,0,2,0
15497,3,3,54418,54418,54421,0,3,1
15498,6,3,54424,54424,54427,0,3,3
15499,5,2,54429,54429,54431,0,2,2
15500,6,3,54435,54435,54438,0,3,4
15501,3,1,54438,54438,54439,0,1,0
15502,6,3,54444,54444,54447,0,3,5
15503,2,2,54446,54447,54449,1,3,0
15504,2,1,54448,54449,54450,1,2,0
15505,3,2,54451,54451,54453,0,2,1
15506,1,2,54452,54453,54455,1,3,0
15507,3,2,54455,54455,54457,0,2,0
15508,3,2,54458,54458,54460,0,2,1
15509,5,3,54463,54463,54466,0,3,3
15510,3,3,54466,54466,54469,0,3,0
15511,4,3,54470,54470,54473,0,3,1
15512,5,3,54475,54475,54478,0,3,2
15513,5,1,54480,54480,54481,0,1,2
15514,5,1,54485,54485,54486,0,1,4
15515,5,1,54490,54490,54491,0,1,4
15516,1,1,54491,54491,54492,0,1,0
15517,4,1,54495,54495,54496,0,1,3
15518,6,3,54501,54501,54504,0,3,5
15519,3,3,54504,54504,54507,0,3,0
15520,1,3,54505,54507,54510,2,5,0
15521,5,1,54510,54510,54511,0,1,0
15522,5,1,54515,54515,54516,0,1,4
15523,1,1,54516,54516,54517,0,1,0
15524,1,2,54517,54517,54519,0,2,0
15525,2,1,54519,54519,54520,0,1,0
15526,1,2,54520,54520,54522,0,2,0
15527,3,1,54523,54523,54524,0,1,1
15528,2,3,54525,54525,54528,0,3,1
15529,4,2,54529,54529,54531,0,2,1
15530,2,3,54531,54531,54534,0,3,0
15531,3,1,54534,54534,54535,0,1,0
15532,3,2,54537,54537,54539,0,2,2
15533,4,1,54541,54541,54542,0,1,2
15534,6,1,54547,54547,54548,0,1,5
15535,6,3,54553,54553,54556,0,3,5
15536,6,1,54559,54559,54560,0,1,3
15537,4,3,54563,54563,54566,0,3,3
15538,3,3,54566,54566,54569,0,3,0
15539,1,1,54567,54569,54570,2,3,0
15540,2,3,54569,54570,54573,1,4,0
15541,6,2,54575,54575,54577,0,2,2
15542,2,2,54577,54577,54579,0,2,0
15543,4,3,54581,54581,54584,0,3,2
15544,6,1,54587,54587,54588,0,1,3
15545,1,1,54588,54588,54589,0,1,0
15546,1,1,54589,54589,54590,0,1,0
15547,5,3,54594,54594,54597,0,3,4
15548,5,1,54599,54599,54600,0,1,2
15549,1,1,54600,54600,54601,0,1,0
15550,5,2,54605,54605,54607,0,2,4
15551,4,1,54609,54609,54610,0,1,2
15552,4,1,54613,54613,54614,0,1,3
15553,3,1,54616,54616,54617,0,1,2
15554,5,3,54621,54621,54624,0,3,4
15555,2,2,54623,54624,54626,1,3,0
15556,3,2,54626,54626,54628,0,2,0
15557,6,1,54632,54632,54633,0,1,4
15558,1,3,54633,54633,54636,0,3,0
15559,3,2,54636,54636,54638,0,2,0
15560,6,3,54642,54642,54645,0,3,4
15561,2,1,54644,54645,54646,1,2,0
15562,1,2,54645,54646,54648,1,3,0
15563,3,1,54648,54648,54649,0,1,0
15564,2,1,54650,54650,54651,0,1,1
15565,1,1,54651,54651,54652,0,1,0
15566,2,1,54653,54653,54654,0,1,1
15567,4,2,54657,54657,54659,0,2,3
15568,1,1,54658,54659,54660,1,2,0
15569,4,1,54662,54662,54663,0,1,2
15570,6,3,54668,54668,54671,0,3,5
15571,3,1,54671,54671,54672,0,1,0
15572,5,1,54676,54676,54677,0,1,4
15573,4,1,54680,54680,54681,0,1,3
15574,4,2,54684,54684,54686,0,2,3
15575,2,1,54686,54686,54687,0,1,0
15576,1,1,54687,54687,54688,0,1,0
15577,1,1,54688,54688,54689,0,1,0
15578,3,1,54691,54691,54692,0,1,2
15579,4,2,54695,54695,54697,0,2,3
15580,6,3,54701,54701,54704,0,3,4
15581,4,2,54705,54705,54707,0,2,1
15582,2,2,54707,54707,54709,0,2,0
15583,4,3,54711,54711,54714,0,3,2
15584,5,3,54716,54716,54719,0,3,2
15585,2,1,54718,54719,54720,1,2,0
15586,3,3,54721,54721,54724,0,3,1
15587,5,1,54726,54726,54727,0,1,2
15588,3,2,54729,54729,54731,0,2,2
15589,3,3,54732,54732,54735,0,3,1
15590,1,2,54733,54735,54737,2,4,0
15591,1,3,54734,54737,54740,3,6,0
15592,1,1,54735,54740,54741,5,6,0
15593,6,1,54741,54741,54742,0,1,0
15594,5,3,54746,54746,54749,0,3,4
15595,3,3,54749,54749,54752,0,3,0
15596,4,2,54753,54753,54755,0,2,1
15597,1,1,54754,54755,54756,1,2,0
15598,5,2,54759,54759,54761,0,2,3
15599,4,1,54763,54763,54764,0,1,2
15600,3,1,54766,54766,54767,0,1,2
15601,2,3,54768,54768,54771,0,3,1
15602,4,2,54772,54772,54774,0,2,1
15603,3,3,54775,54775,54778,0,3,1
15604,4,3,54779,54779,54782,0,3,1
15605,2,1,54781,54782,54783,1,2,0
15606,3,1,54784,54784,54785,0,1,1
15607,6,3,54790,54790,54793,0,3,5
15608,5,2,54795,54795,54797,0,2,2
15609,5,3,54800,54800,54803,0,3,3
15610,4,2,54804,54804,54806,0,2,1
15611,2,1,54806,54806,54807,0,1,0
15612,3,2,54809,54809,54811,0,2,2
15613,6,1,54815,54815,54816,0,1,4
15614,2,1,54817,54817,54818,0,1,1
15615,5,2,54822,54822,54824,0,2,4
15616,4,3,54826,54826,54829,0,3,2
15617,4,3,54830,54830,54833,0,3,1
15618,5,1,54835,54835,54836,0,1,2
15619,6,1,54841,54841,54842,0,1,5
15620,4,3,54845,54845,54848,0,3,3
15621,2,2,54847,54848,54850,1,3,0
15622,2,1,54849,54850,54851,1,2,0
15623,6,3,54855,54855,54858,0,3,4
15624,1,2,54856,54858,54860,2,4,0
15625,5,2,54861,54861,54863,0,2,1
15626,1,1,54862,54863,54864,1,2,0
15627,6,3,54868,54868,54871,0,3,4
15628,2,3,54870,54871,54874,1,4,0
15629,3,1,54873,54874,54875,1,2,0
15630,5,3,54878,54878,54881,0,3,3
15631,3,1,54881,54881,54882,0,1,0
15632,3,3,54884,54884,54887,0,3,2
15633,2,1,54886,54887,54888,1,2,0
15634,1,2,54887,54888,54890,1,3,0
15635,6,2,54893,54893,54895,0,2,3
15636,5,3,54898,54898,54901,0,3,3
15637,1,1,54899,54901,54902,2,3,0
15638,3,2,54902,54902,54904,0,2,0
15639,5,3,54907,54907,54910,0,3,3
15640,5,3,54912,54912,54915,0,3,2
15641,6,2,54918,54918,54920,0,2,3
15642,6,1,54924,54924,54925,0,1,4
15643,1,1,54925,54925,54926,0,1,0
15644,5,2,54930,54930,54932,0,2,4
15645,6,3,54936,54936,54939,0,3,4
15646,5,3,54941,54941,54944,0,3,2
15647,2,3,54943,54944,54947,1,4,0
15648,6,2,54949,54949,54951,0,2,2
15649,3,2,54952,54952,54954,0,2,1
15650,3,3,54955,54955,54958,0,3,1
15651,5,3,54960,54960,54963,0,3,2
15652,6,3,54966,54966,54969,0,3,3
15653,6,1,54972,54972,54973,0,1,3
15654,3,1,54975,54975,54976,0,1,2
15655,2,2,54977,54977,54979,0,2,1
15656,1,2,54978,54979,54981,1,3,0
15657,3,3,54981,54981,54984,0,3,0
15658,3,2,54984,54984,54986,0,2,0
15659,3,3,54987,54987,54990,0,3,1
15660,6,1,54993,54993,54994,0,1,3
15661,3,1,54996,54996,54997,0,1,2
15662,2,2,54998,54998,55000,0,2,1
15663,2,1,55000,55000,55001,0,1,0
15664,4,3,55004,55004,55007,0,3,3
15665,5,3,55009,55009,55012,0,3,2
15666,6,1,55015,55015,55016,0,1,3
15667,4,3,55019,55019,55022,0,3,3
15668,1,1,55020,55022,55023,2,3,0
15669,2,3,55022,55023,55026,1,4,0
15670,3,1,55025,55026,55027,1,2,0
15671,1,2,55026,55027,55029,1,3,0
15672,3,3,55029,55029,55032,0,3,0
15673,5,3,55034,55034,55037,0,3,2
15674,3,1,55037,55037,55038,0,1,0
15675,3,2,55040,55040,55042,0,2,2
15676,5,2,55045,55045,55047,0,2,3
15677,5,2,55050,55050,55052,0,2,3
15678,6,1,55056,55056,55057,0,1,4
15679,2,3,55058,55058,55061,0,3,1
15680,6,3,55064,55064,55067,0,3,3
15681,3,2,55067,55067,55069,0,2,0
15682,2,2,55069,55069,55071,0,2,0
15683,1,3,55070,55071,55074,1,4,0
15684,6,3,55076,55076,55079,0,3,2
15685,1,2,55077,55079,55081,2,4,0
15686,2,2,55079,55081,55083,2,4,0
15687,6,1,55085,55085,55086,0,1,2
15688,2,2,55087,55087,55089,0,2,1
15689,5,2,55092,55092,55094,0,2,3
15690,1,3,55093,55094,55097,1,4,0
15691,5,1,55098,55098,55099,0,1,1
15692,3,2,55101,55101,55103,0,2,2
15693,1,1,55102,55103,55104,1,2,0
15694,6,2,55108,55108,55110,0,2,4
15695,4,3,55112,55112,55115,0,3,2
15696,5,2,55117,55117,55119,0,2,2
15697,5,1,55122,55122,55123,0,1,3
15698,3,1,55125,55125,55126,0,1,2
15699,6,1,55131,55131,55132,0,1,5
15700,2,3,55133,55133,55136,0,3,1
15701,2,3,55135,55136,55139,1,4,0
15702,1,2,55136,55139,55141,3,5,0
15703,5,2,55141,55141,55143,0,2,0
15704,5,2,55146,55146,55148,0,2,3
15705,3,3,55149,55149,55152,0,3,1
15706,3,3,55152,55152,55155,0,3,0
15707,4,1,55156,55156,55157,0,1,1
15708,4,1,55160,55160,55161,0,1,3
15709,6,3,55166,55166,55169,0,3,5
15710,1,3,55167,55169,55172,2,5,0
15711,6,3,55173,55173,55176,0,3,1
15712,5,1,55178,55178,55179,0,1,2
15713,6,1,55184,55184,55185,0,1,5
15714,6,2,55190,55190,55192,0,2,5
15715,4,2,55194,55194,55196,0,2,2
15716,1,3,55195,55196,55199,1,4,0
15717,4,1,55199,55199,55200,0,1,0
15718,3,2,55202,55202,55204,0,2,2
15719,4,1,55206,55206,55207,0,1,2
15720,1,2,55207,55207,55209,0,2,0
15721,1,1,55208,55209,55210,1,2,0
15722,4,1,55212,55212,55213,0,1,2
15723,2,1,55214,55214,55215,0,1,1
15724,2,1,55216,55216,55217,0,1,1
15725,4,2,55220,55220,55222,0,2,3
15726,2,1,55222,55222,55223,0,1,0
15727,1,1,55223,55223,55224,0,1,0
15728,6,1,55229,55229,55230,0,1,5
15729,1,2,55230,55230,55232,0,2,0
15730,5,2,55235,55235,55237,0,2,3
15731,3,3,55238,55238,55241,0,3,1
15732,5,1,55243,55243,55244,0,1,2
15733,3,2,55246,55246,55248,0,2,2
15734,4,2,55250,55250,55252,0,2,2
15735,4,3,55254,55254,55257,0,3,2
15736,6,3,55260,55260,55263,0,3,3
15737,3,3,55263,55263,55266,0,3,0
15738,3,2,55266,55266,55268,0,2,0
15739,2,3,55268,55268,55271,0,3,0
15740,2,1,55270,55271,55272,1,2,0
15741,6,1,55276,55276,55277,0,1,4
15742,3,1,55279,55279,55280,0,1,2
15743,4,3,55283,55283,55286,0,3,3
15744,6,1,55289,55289,55290,0,1,3
15745,4,3,55293,55293,55296,0,3,3
15746,1,3,55294,55296,55299,2,5,0
15747,1,1,55295,55299,55300,4,5,0
15748,4,1,55299,55300,55301,1,2,0
15749,5,2,55304,55304,55306,0,2,3
15750,6,2,55310,55310,55312,0,2,4
15751,5,2,55315,55315,55317,0,2,3
15752,6,2,55321,55321,55323,0,2,4
15753,2,2,55323,55323,55325,0,2,0
15754,1,1,55324,55325,55326,1,2,0
15755,6,3,55330,55330,55333,0,3,4
15756,1,2,55331,55333,55335,2,4,0
15757,5,3,55336,55336,55339,0,3,1
15758,4,1,55340,55340,55341,0,1,1
15759,5,3,55345,55345,55348,0,3,4
15760,1,3,55346,55348,55351,2,5,0
15761,6,2,55352,55352,55354,0,2,1
15762,1,1,55353,55354,55355,1,2,0
15763,1,2,55354,55355,55357,1,3,0
15764,4,1,55358,55358,55359,0,1,1
15765,5,3,55363,55363,55366,0,3,4
15766,2,1,55365,55366,55367,1,2,0
15767,1,1,55366,55367,55368,1,2,0
15768,4,2,55370,55370,55372,0,2,2
15769,2,3,55372,55372,55375,0,3,0
15770,6,3,55378,55378,55381,0,3,3
15771,6,3,55384,55384,55387,0,3,3
15772,1,3,55385,55387,55390,2,5,0
15773,3,1,55388,55390,55391,2,3,0
15774,2,3,55390,55391,55394,1,4,0
15775,5,3,55395,55395,55398,0,3,1
15776,2,2,55397,55398,55400,1,3,0
15777,1,1,55398,55400,55401,2,3,0
15778,6,2,55404,55404,55406,0,2,3
15779,1,1,55405,55406,55407,1,2,0
15780,5,1,55410,55410,55411,0,1,3
15781,1,1,55411,55411,55412,0,1,0
15782,4,1,55415,55415,55416,0,1,3
15783,5,2,55420,55420,55422,0,2,4
15784,6,1,55426,55426,55427,0,1,4
15785,5,2,55431,55431,55433,0,2,4
15786,4,1,55435,55435,55436,0,1,2
15787,5,3,55440,55440,55443,0,3,4
15788,4,3,55444,55444,55447,0,3,1
15789,3,2,55447,55447,55449,0,2,0
15790,2,1,55449,55449,55450,0,1,0
15791,6,3,55455,55455,55458,0,3,5
15792,2,3,55457,55458,55461,1,4,0
15793,5,1,55462,55462,55463,0,1,1
15794,4,1,55466,55466,55467,0,1,3
15795,1,1,55467,55467,55468,0,1,0
15796,3,1,55470,55470,55471,0,1,2
15797,1,2,55471,55471,55473,0,2,0
15798,2,3,55473,55473,55476,0,3,0
15799,4,3,55477,55477,55480,0,3,1
15800,1,2,55478,55480,55482,2,4,0
15801,5,2,55483,55483,55485,0,2,1
15802,5,1,55488,55488,55489,0,1,3
15803,5,3,55493,55493,55496,0,3,4
15804,6,3,55499,55499,55502,0,3,3
15805,2,2,55501,55502,55504,1,3,0
15806,6,3,55507,55507,55510,0,3,3
15807,6,2,55513,55513,55515,0,2,3
15808,4,3,55517,55517,55520,0,3,2
15809,5,3,55522,55522,55525,0,3,2
15810,2,1,55524,55525,55526,1,2,0
15811,6,2,55530,55530,55532,0,2,4
15812,5,2,55535,55535,55537,0,2,3
15813,2,2,55537,55537,55539,0,2,0
15814,2,2,55539,55539,55541,0,2,0
15815,2,2,55541,55541,55543,0,2,0
15816,4,2,55545,55545,55547,0,2,2
15817,5,1,55550,55550,55551,0,1,3
15818,4,3,55554,55554,55557,0,3,3
15819,3,3,55557,55557,55560,0,3,0
15820,2,3,55559,55560,55563,1,4,0
15821,6,1,55565,55565,55566,0,1,2
15822,2,1,55567,55567,55568,0,1,1
15823,1,1,55568,55568,55569,0,1,0
15824,6,3,55574,55574,55577,0,3,5
15825,6,3,55580,55580,55583,0,3,3
15826,5,3,55585,55585,55588,0,3,2
15827,4,2,55589,55589,55591,0,2,1
15828,4,3,55593,55593,55596,0,3,2
15829,5,3,55598,55598,55601,0,3,2
15830,2,1,55600,55601,55602,1,2,0
15831,6,3,55606,55606,55609,0,3,4
15832,2,3,55608,55609,55612,1,4,0
15833,6,2,55614,55614,55616,0,2,2
15834,3,3,55617,55617,55620,0,3,1
15835,4,2,55621,55621,55623,0,2,1
15836,5,3,55626,55626,55629,0,3,3
15837,2,1,55628,55629,55630,1,2,0
15838,3,1,55631,55631,55632,0,1,1
15839,6,2,55637,55637,55639,0,2,5
15840,3,1,55640,55640,55641,0,1,1
15841,2,3,55642,55642,55645,0,3,1
15842,5,2,55647,55647,55649,0,2,2
15843,3,2,55650,55650,55652,0,2,1
15844,5,2,55655,55655,55657,0,2,3
15845,2,3,55657,55657,55660,0,3,0
15846,4,2,55661,55661,55663,0,2,1
15847,6,3,55667,55667,55670,0,3,4
15848,1,2,55668,55670,55672,2,4,0
15849,4,2,55672,55672,55674,0,2,0
15850,5,3,55677,55677,55680,0,3,3
15851,1,3,55678,55680,55683,2,5,0
15852,3,3,55681,55683,55686,2,5,0
15853,4,2,55685,55686,55688,1,3,0
15854,1,3,55686,55688,55691,2,5,0
15855,5,1,55691,55691,55692,0,1,0
15856,1,3,55692,55692,55695,0,3,0
15857,4,3,55696,55696,55699,0,3,1
15858,3,2,55699,55699,55701,0,2,0
15859,4,1,55703,55703,55704,0,1,2
15860,3,2,55706,55706,55708,0,2,2
15861,6,1,55712,55712,55713,0,1,4
15862,3,3,55715,55715,55718,0,3,2
15863,1,2,55716,55718,55720,2,4,0
15864,5,3,55721,55721,55724,0,3,1
15865,5,2,55726,55726,55728,0,2,2
15866,6,1,55732,55732,55733,0,1,4
15867,1,1,55733,55733,55734,0,1,0
15868,2,1,55735,55735,55736,0,1,1
15869,1,3,55736,55736,55739,0,3,0
15870,4,2,55740,55740,55742,0,2,1
15871,4,2,55744,55744,55746,0,2,2
15872,1,2,55745,55746,55748,1,3,0
15873,3,2,55748,55748,55750,0,2,0
15874,1,3,55749,55750,55753,1,4,0
15875,4,2,55753,55753,55755,0,2,0
15876,5,3,55758,55758,55761,0,3,3
15877,1,3,55759,55761,55764,2,5,0
15878,5,3,55764,55764,55767,0,3,0
15879,6,3,55770,55770,55773,0,3,3
15880,4,1,55774,55774,55775,0,1,1
15881,3,1,55777,55777,55778,0,1,2
15882,6,2,55783,55783,55785,0,2,5
15883,1,1,55784,55785,55786,1,2,0
15884,5,2,55789,55789,55791,0,2,3
15885,4,2,55793,55793,55795,0,2,2
15886,3,2,55796,55796,55798,0,2,1
15887,2,1,55798,55798,55799,0,1,0
15888,6,3,55804,55804,55807,0,3,5
15889,1,1,55805,55807,55808,2,3,0
15890,6,2,55811,55811,55813,0,2,3
15891,3,1,55814,55814,55815,0,1,1
15892,2,1,55816,55816,55817,0,1,1
15893,3,2,55819,55819,55821,0,2,2
15894,4,1,55823,55823,55824,0,1,2
15895,5,1,55828,55828,55829,0,1,4
15896,1,1,55829,55829,55830,0,1,0
15897,3,2,55832,55832,55834,0,2,2
15898,1,3,55833,55834,55837,1,4,0
15899,4,2,55837,55837,55839,0,2,0
15900,2,3,55839,55839,55842,0,3,0
15901,1,1,55840,55842,55843,2,3,0
15902,3,3,55843,55843,55846,0,3,0
15903,2,3,55845,55846,55849,1,4,0
15904,2,2,55847,55849,55851,2,4,0
15905,6,1,55853,55853,55854,0,1,2
15906,3,3,55856,55856,55859,0,3,2
15907,2,2,55858,55859,55861,1,3,0
15908,4,2,55862,55862,55864,0,2,1
15909,2,1,55864,55864,55865,0,1,0
15910,2,3,55866,55866,55869,0,3,1
15911,4,2,55870,55870,55872,0,2,1
15912,6,3,55876,55876,55879,0,3,4
15913,1,3,55877,55879,55882,2,5,0
15914,1,1,55878,55882,55883,4,5,0
15915,5,2,55883,55883,55885,0,2,0
15916,4,2,55887,55887,55889,0,2,2
15917,6,3,55893,55893,55896,0,3,4
15918,2,1,55895,55896,55897,1,2,0
15919,6,3,55901,55901,55904,0,3,4
15920,5,2,55906,55906,55908,0,2,2
15921,1,3,55907,55908,55911,1,4,0
15922,3,3,55910,55911,55914,1,4,0
15923,3,3,55913,55914,55917,1,4,0
15924,1,2,55914,55917,55919,3,5,0
15925,6,1,55920,55920,55921,0,1,1
15926,3,2,55923,55923,55925,0,2,2
15927,6,1,55929,55929,55930,0,1,4
15928,6,2,55935,55935,55937,0,2,5
15929,2,1,55937,55937,55938,0,1,0
15930,2,3,55939,55939,55942,0,3,1
15931,4,1,55943,55943,55944,0,1,1
15932,3,3,55946,55946,55949,0,3,2
15933,2,3,55948,55949,55952,1,4,0
15934,1,1,55949,55952,55953,3,4,0
15935,3,2,55952,55953,55955,1,3,0
15936,4,1,55956,55956,55957,0,1,1
15937,4,1,55960,55960,55961,0,1,3
15938,1,3,55961,55961,55964,0,3,0
15939,4,1,55965,55965,55966,0,1,1
15940,5,1,55970,55970,55971,0,1,4
15941,6,2,55976,55976,55978,0,2,5
15942,4,3,55980,55980,55983,0,3,2
15943,3,3,55983,55983,55986,0,3,0
15944,5,3,55988,55988,55991,0,3,2
15945,2,3,55990,55991,55994,1,4,0
15946,6,1,55996,55996,55997,0,1,2
15947,2,2,55998,55998,56000,0,2,1
15948,1,2,55999,56000,56002,1,3,0
15949,2,2,56001,56002,56004,1,3,0
15950,2,2,56003,56004,56006,1,3,0
15951,6,1,56009,56009,56010,0,1,3
15952,1,3,56010,56010,56013,0,3,0
15953,1,2,56011,56013,56015,2,4,0
15954,5,2,56016,56016,56018,0,2,1
15955,6,3,56022,56022,56025,0,3,4
15956,1,3,56023,56025,56028,2,5,0
15957,1,2,56024,56028,56030,4,6,0
15958,4,2,56028,56030,56032,2,4,0
15959,5,2,56033,56033,56035,0,2,1
15960,4,1,56037,56037,56038,0,1,2
15961,4,1,56041,56041,56042,0,1,3
15962,4,3,56045,56045,56048,0,3,3
15963,4,1,56049,56049,56050,0,1,1
15964,4,3,56053,56053,56056,0,3,3
15965,4,1,56057,56057,56058,0,1,1
15966,1,3,56058,56058,56061,0,3,0
15967,2,3,56060,56061,56064,1,4,0
15968,4,2,56064,56064,56066,0,2,0
15969,2,3,56066,56066,56069,0,3,0
15970,5,1,56071,56071,56072,0,1,2
15971,3,2,56074,56074,56076,0,2,2
15972,4,1,56078,56078,56079,0,1,2
15973,5,1,56083,56083,56084,0,1,4
15974,5,2,56088,56088,56090,0,2,4
15975,3,1,56091,56091,56092,0,1,1
15976,4,2,56095,56095,56097,0,2,3
15977,2,3,56097,56097,56100,0,3,0
15978,5,3,56102,56102,56105,0,3,2
15979,1,3,56103,56105,56108,2,5,0
15980,2,3,56105,56108,56111,3,6,0
15981,6,2,56111,56111,56113,0,2,0
15982,5,1,56116,56116,56117,0,1,3
15983,6,3,56122,56122,56125,0,3,5
15984,5,1,56127,56127,56128,0,1,2
15985,1,1,56128,56128,56129,0,1,0
15986,4,3,56132,56132,56135,0,3,3
15987,2,1,56134,56135,56136,1,2,0
15988,4,2,56138,56138,56140,0,2,2
15989,4,2,56142,56142,56144,0,2,2
15990,6,3,56148,56148,56151,0,3,4
15991,6,1,56154,56154,56155,0,1,3
15992,1,3,56155,56155,56158,0,3,0
15993,3,1,56158,56158,56159,0,1,0
15994,5,1,56163,56163,56164,0,1,4
15995,5,1,56168,56168,56169,0,1,4
15996,2,2,56170,56170,56172,0,2,1
15997,1,3,56171,56172,56175,1,4,0
15998,2,2,56173,56175,56177,2,4,0
15999,6,3,56179,56179,56182,0,3,2
16000,3,1,56182,56182,56183,0,1,0
16001,3,3,56185,56185,56188,0,3,2
16002,2,2,56187,56188,56190,1,3,0
16003,3,3,56190,56190,56193,0,3,0
16004,3,2,56193,56193,56195,0,2,0
16005,4,3,56197,56197,56200,0,3,2
16006,6,1,56203,56203,56204,0,1,3
16007,6,2,56209,56209,56211,0,2,5
16008,3,1,56212,56212,56213,0,1,1
16009,3,3,56215,56215,56218,0,3,2
16010,1,2,56216,56218,56220,2,4,0
16011,1,3,56217,56220,56223,3,6,0
16012,6,1,56223,56223,56224,0,1,0
16013,3,3,56226,56226,56229,0,3,2
16014,4,1,56230,56230,56231,0,1,1
16015,6,2,56236,56236,56238,0,2,5
16016,5,3,56241,56241,56244,0,3,3
16017,6,3,56247,56247,56250,0,3,3
16018,3,1,56250,56250,56251,0,1,0
16019,6,3,56256,56256,56259,0,3,5
16020,5,1,56261,56261,56262,0,1,2
16021,2,3,56263,56263,56266,0,3,1
16022,2,1,56265,56266,56267,1,2,0
16023,3,3,56268,56268,56271,0,3,1
16024,1,3,56269,56271,56274,2,5,0
16025,1,3,56270,56274,56277,4,7,0
16026,3,2,56273,56277,56279,4,6,0
16027,3,3,56276,56279,56282,3,6,0
16028,4,3,56280,56282,56285,2,5,0
16029,5,2,56285,56285,56287,0,2,0
16030,3,3,56288,56288,56291,0,3,1
16031,1,3,56289,56291,56294,2,5,0
16032,2,2,56291,56294,56296,3,5,0
16033,5,3,56296,56296,56299,0,3,0
16034,2,1,56298,56299,56300,1,2,0
16035,3,3,56301,56301,56304,0,3,1
16036,4,1,56305,56305,56306,0,1,1
16037,3,3,56308,56308,56311,0,3,2
16038,3,1,56311,56311,56312,0,1,0
16039,4,3,56315,56315,56318,0,3,3
16040,1,1,56316,56318,56319,2,3,0
16041,6,1,56322,56322,56323,0,1,3
16042,5,1,56327,56327,56328,0,1,4
16043,3,2,56330,56330,56332,0,2,2
16044,4,3,56334,56334,56337,0,3,2
16045,2,3,56336,56337,56340,1,4,0
16046,5,1,56341,56341,56342,0,1,1
16047,3,1,56344,56344,56345,0,1,2
16048,4,2,56348,56348,56350,0,2,3
16049,2,3,56350,56350,56353,0,3,0
16050,4,3,56354,56354,56357,0,3,1
16051,6,1,56360,56360,56361,0,1,3
16052,5,1,56365,56365,56366,0,1,4
16053,3,1,56368,56368,56369,0,1,2
16054,1,1,56369,56369,56370,0,1,0
16055,5,3,56374,56374,56377,0,3,4
16056,1,1,56375,56377,56378,2,3,0
16057,6,2,56381,56381,56383,0,2,3
16058,3,2,56384,56384,56386,0,2,1
16059,2,2,56386,56386,56388,0,2,0
16060,2,2,56388,56388,56390,0,2,0
16061,3,2,56391,56391,56393,0,2,1
16062,1,1,56392,56393,56394,1,2,0
16063,2,1,56394,56394,56395,0,1,0
16064,4,2,56398,56398,56400,0,2,3
16065,3,3,56401,56401,56404,0,3,1
16066,4,1,56405,56405,56406,0,1,1
16067,1,3,56406,56406,56409,0,3,0
16068,6,2,56412,56412,56414,0,2,3
16069,1,3,56413,56414,56417,1,4,0
16070,4,2,56417,56417,56419,0,2,0
16071,3,2,56420,56420,56422,0,2,1
16072,5,2,56425,56425,56427,0,2,3
16073,1,2,56426,56427,56429,1,3,0
16074,3,1,56429,56429,56430,0,1,0
16075,6,1,56435,56435,56436,0,1,5
16076,6,2,56441,56441,56443,0,2,5
16077,1,2,56442,56443,56445,1,3,0
16078,5,2,56447,56447,56449,0,2,2
16079,6,2,56453,56453,56455,0,2,4
16080,6,3,56459,56459,56462,0,3,4
16081,5,3,56464,56464,56467,0,3,2
16082,4,3,56468,56468,56471,0,3,1
16083,1,3,56469,56471,56474,2,5,0
16084,6,1,56475,56475,56476,0,1,1
16085,6,3,56481,56481,56484,0,3,5
16086,1,1,56482,56484,56485,2,3,0
16087,2,3,56484,56485,56488,1,4,0
16088,2,1,56486,56488,56489,2,3,0
16089,3,2,56489,56489,56491,0,2,0
16090,4,2,56493,56493,56495,0,2,2
16091,1,3,56494,56495,56498,1,4,0
16092,3,1,56497,56498,56499,1,2,0
16093,3,3,56500,56500,56503,0,3,1
16094,5,3,56505,56505,56508,0,3,2
16095,4,1,56509,56509,56510,0,1,1
16096,5,2,56514,56514,56516,0,2,4
16097,6,3,56520,56520,56523,0,3,4
16098,5,2,56525,56525,56527,0,2,2
16099,5,3,56530,56530,56533,0,3,3
16100,3,3,56533,56533,56536,0,3,0
16101,5,1,56538,56538,56539,0,1,2
16102,3,1,56541,56541,56542,0,1,2
16103,1,1,56542,56542,56543,0,1,0
16104,1,3,56543,56543,56546,0,3,0
16105,2,1,56545,56546,56547,1,2,0
16106,5,1,56550,56550,56551,0,1,3
16107,3,1,56553,56553,56554,0,1,2
16108,5,2,56558,56558,56560,0,2,4
16109,2,2,56560,56560,56562,0,2,0
16110,2,2,56562,56562,56564,0,2,0
16111,3,3,56565,56565,56568,0,3,1
16112,3,3,56568,56568,56571,0,3,0
16113,4,1,56572,56572,56573,0,1,1
16114,6,1,56578,56578,56579,0,1,5
16115,5,3,56583,56583,56586,0,3,4
16116,1,1,56584,56586,56587,2,3,0
16117,6,1,56590,56590,56591,0,1,3
16118,6,2,56596,56596,56598,0,2,5
16119,5,2,56601,56601,56603,0,2,3
16120,1,3,56602,56603,56606,1,4,0
16121,4,1,56606,56606,56607,0,1,0
16122,6,1,56612,56612,56613,0,1,5
16123,5,3,56617,56617,56620,0,3,4
16124,6,1,56623,56623,56624,0,1,3
16125,6,2,56629,56629,56631,0,2,5
16126,5,1,56634,56634,56635,0,1,3
16127,3,1,56637,56637,56638,0,1,2
16128,4,1,56641,56641,56642,0,1,3
16129,5,3,56646,56646,56649,0,3,4
16130,4,1,56650,56650,56651,0,1,1
16131,3,1,56653,56653,56654,0,1,2
16132,1,1,56654,56654,56655,0,1,0
16133,6,2,56660,56660,56662,0,2,5
16134,3,2,56663,56663,56665,0,2,1
16135,2,3,56665,56665,56668,0,3,0
16136,2,2,56667,56668,56670,1,3,0
16137,1,2,56668,56670,56672,2,4,0
16138,1,2,56669,56672,56674,3,5,0
16139,4,2,56673,56674,56676,1,3,0
16140,1,1,56674,56676,56677,2,3,0
16141,4,1,56678,56678,56679,0,1,1
16142,2,1,56680,56680,56681,0,1,1
16143,2,1,56682,56682,56683,0,1,1
16144,2,1,56684,56684,56685,0,1,1
16145,1,2,56685,56685,56687,0,2,0
16146,5,3,56690,56690,56693,0,3,3
16147,5,1,56695,56695,56696,0,1,2
16148,5,1,56700,56700,56701,0,1,4
16149,5,3,56705,56705,56708,0,3,4
16150,5,3,56710,56710,56713,0,3,2
16151,6,2,56716,56716,56718,0,2,3
16152,1,2,56717,56718,56720,1,3,0
16153,1,3,56718,56720,56723,2,5,0
16154,5,1,56723,56723,56724,0,1,0
16155,6,2,56729,56729,56731,0,2,5
16156,3,2,56732,56732,56734,0,2,1
16157,2,3,56734,56734,56737,0,3,0
16158,3,1,56737,56737,56738,0,1,0
16159,1,2,56738,56738,56740,0,2,0
16160,3,3,56741,56741,56744,0,3,1
16161,2,1,56743,56744,56745,1,2,0
16162,5,1,56748,56748,56749,0,1,3
16163,1,3,56749,56749,56752,0,3,0
16164,2,1,56751,56752,56753,1,2,0
16165,3,1,56754,56754,56755,0,1,1
16166,4,3,56758,56758,56761,0,3,3
16167,5,1,56763,56763,56764,0,1,2
16168,6,1,56769,56769,56770,0,1,5
16169,1,2,56770,56770,56772,0,2,0
16170,3,2,56773,56773,56775,0,2,1
16171,5,3,56778,56778,56781,0,3,3
16172,4,3,56782,56782,56785,0,3,1
16173,5,3,56787,56787,56790,0,3,2
16174,3,1,56790,56790,56791,0,1,0
16175,3,3,56793,56793,56796,0,3,2
16176,5,1,56798,56798,56799,0,1,2
16177,1,2,56799,56799,56801,0,2,0
16178,5,2,56804,56804,56806,0,2,3
16179,1,3,56805,56806,56809,1,4,0
16180,3,3,56808,56809,56812,1,4,0
16181,4,1,56812,56812,56813,0,1,0
16182,4,2,56816,56816,56818,0,2,3
16183,1,1,56817,56818,56819,1,2,0
16184,5,1,56822,56822,56823,0,1,3
16185,2,3,56824,56824,56827,0,3,1
16186,4,3,56828,56828,56831,0,3,1
16187,1,3,56829,56831,56834,2,5,0
16188,5,2,56834,56834,56836,0,2,0
16189,1,3,56835,56836,56839,1,4,0
16190,5,2,56840,56840,56842,0,2,1
16191,2,1,56842,56842,56843,0,1,0
16192,1,2,56843,56843,56845,0,2,0
16193,1,2,56844,56845,56847,1,3,0
16194,2,3,56846,56847,56850,1,4,0
16195,2,2,56848,56850,56852,2,4,0
16196,1,1,56849,56852,56853,3,4,0
16197,5,3,56854,56854,56857,0,3,1
16198,3,1,56857,56857,56858,0,1,0
16199,3,2,56860,56860,56862,0,2,2
16200,1,1,56861,56862,56863,1,2,0
16201,4,1,56865,56865,56866,0,1,2
16202,4,3,56869,56869,56872,0,3,3
16203,6,3,56875,56875,56878,0,3,3
16204,6,3,56881,56881,56884,0,3,3
16205,4,2,56885,56885,56887,0,2,1
16206,3,2,56888,56888,56890,0,2,1
16207,3,2,56891,56891,56893,0,2,1
16208,4,3,56895,56895,56898,0,3,2
16209,2,2,56897,56898,56900,1,3,0
16210,5,2,56902,56902,56904,0,2,2
16211,6,3,56908,56908,56911,0,3,4
16212,2,1,56910,56911,56912,1,2,0
16213,2,1,56912,56912,56913,0,1,0
16214,1,2,56913,56913,56915,0,2,0
16215,6,2,56919,56919,56921,0,2,4
16216,4,2,56923,56923,56925,0,2,2
16217,1,1,56924,56925,56926,1,2,0
16218,2,3,56926,56926,56929,0,3,0
16219,4,2,56930,56930,56932,0,2,1
16220,6,3,56936,56936,56939,0,3,4
16221,2,2,56938,56939,56941,1,3,0
16222,1,2,56939,56941,56943,2,4,0
16223,1,1,56940,56943,56944,3,4,0
16224,2,2,56942,56944,56946,2,4,0
16225,3,1,56945,56946,56947,1,2,0
16226,1,3,56946,56947,56950,1,4,0
16227,3,2,56949,56950,56952,1,3,0
16228,1,3,56950,56952,56955,2,5,0
16229,2,1,56952,56955,56956,3,4,0
16230,4,1,56956,56956,56957,0,1,0
16231,5,2,56961,56961,56963,0,2,4
16232,2,2,56963,56963,56965,0,2,0
16233,6,3,56969,56969,56972,0,3,4
16234,4,3,56973,56973,56976,0,3,1
16235,4,1,56977,56977,56978,0,1,1
16236,5,3,56982,56982,56985,0,3,4
16237,4,2,56986,56986,56988,0,2,1
16238,4,3,56990,56990,56993,0,3,2
16239,4,3,56994,56994,56997,0,3,1
16240,6,3,57000,57000,57003,0,3,3
16241,6,2,57006,57006,57008,0,2,3
16242,4,3,57010,57010,57013,0,3,2
16243,1,2,57011,57013,57015,2,4,0
16244,4,3,57015,57015,57018,0,3,0
16245,4,1,57019,57019,57020,0,1,1
16246,1,2,57020,57020,57022,0,2,0
16247,4,1,57024,57024,57025,0,1,2
16248,3,2,57027,57027,57029,0,2,2
16249,5,1,57032,57032,57033,0,1,3
16250,2,3,57034,57034,57037,0,3,1
16251,2,3,57036,57037,57040,1,4,0
16252,6,1,57042,57042,57043,0,1,2
16253,6,3,57048,57048,57051,0,3,5
16254,4,3,57052,57052,57055,0,3,1
16255,4,3,57056,57056,57059,0,3,1
16256,6,1,57062,57062,57063,0,1,3
16257,3,1,57065,57065,57066,0,1,2
16258,2,1,57067,57067,57068,0,1,1
16259,4,3,57071,57071,57074,0,3,3
16260,6,2,57077,57077,57079,0,2,3
16261,5,2,57082,57082,57084,0,2,3
16262,1,3,57083,57084,57087,1,4,0
16263,3,2,57086,57087,57089,1,3,0
16264,5,2,57091,57091,57093,0,2,2
16265,3,2,57094,57094,57096,0,2,1
16266,1,1,57095,57096,57097,1,2,0
16267,2,2,57097,57097,57099,0,2,0
16268,4,2,57101,57101,57103,0,2,2
16269,6,1,57107,57107,57108,0,1,4
16270,5,2,57112,57112,57114,0,2,4
16271,6,2,57118,57118,57120,0,2,4
16272,1,3,57119,57120,57123,1,4,0
16273,3,2,57122,57123,57125,1,3,0
16274,2,3,57124,57125,57128,1,4,0
16275,1,1,57125,57128,57129,3,4,0
16276,2,2,57127,57129,57131,2,4,0
16277,1,2,57128,57131,57133,3,5,0
16278,4,1,57132,57133,57134,1,2,0
16279,5,1,57137,57137,57138,0,1,3
16280,2,1,57139,57139,57140,0,1,1
16281,6,2,57145,57145,57147,0,2,5
16282,1,3,57146,57147,57150,1,4,0
16283,2,2,57148,57150,57152,2,4,0
16284,4,2,57152,57152,57154,0,2,0
16285,4,2,57156,57156,57158,0,2,2
16286,6,2,57162,57162,57164,0,2,4
16287,2,1,57164,57164,57165,0,1,0
16288,6,3,57170,57170,57173,0,3,5
16289,4,1,57174,57174,57175,0,1,1
16290,5,3,57179,57179,57182,0,3,4
16291,6,1,57185,57185,57186,0,1,3
16292,2,3,57187,57187,57190,0,3,1
16293,6,1,57193,57193,57194,0,1,3
16294,3,2,57196,57196,57198,0,2,2
16295,6,2,57202,57202,57204,0,2,4
16296,2,1,57204,57204,57205,0,1,0
16297,6,3,57210,57210,57213,0,3,5
16298,4,1,57214,57214,57215,0,1,1
16299,6,3,57220,57220,57223,0,3,5
16300,5,2,57225,57225,57227,0,2,2
16301,4,2,57229,57229,57231,0,2,2
16302,4,2,57233,57233,57235,0,2,2
16303,6,2,57239,57239,57241,0,2,4
16304,6,2,57245,57245,57247,0,2,4
16305,4,1,57249,57249,57250,0,1,2
16306,1,2,57250,57250,57252,0,2,0
16307,4,1,57254,57254,57255,0,1,2
16308,2,1,57256,57256,57257,0,1,1
16309,1,1,57257,57257,57258,0,1,0
16310,2,2,57259,57259,57261,0,2,1
16311,4,1,57263,57263,57264,0,1,2
16312,4,2,57267,57267,57269,0,2,3
16313,2,2,57269,57269,57271,0,2,0
16314,5,3,57274,57274,57277,0,3,3
16315,4,2,57278,57278,57280,0,2,1
16316,1,1,57279,57280,57281,1,2,0
16317,4,2,57283,57283,57285,0,2,2
16318,4,3,57287,57287,57290,0,3,2
16319,3,2,57290,57290,57292,0,2,0
16320,6,2,57296,57296,57298,0,2,4
16321,1,2,57297,57298,57300,1,3,0
16322,2,3,57299,57300,57303,1,4,0
16323,3,3,57302,57303,57306,1,4,0
16324,5,3,57307,57307,57310,0,3,1
16325,6,3,57313,57313,57316,0,3,3
16326,4,2,57317,57317,57319,0,2,1
16327,6,3,57323,57323,57326,0,3,4
16328,2,3,57325,57326,57329,1,4,0
16329,2,2,57327,57329,57331,2,4,0
16330,3,3,57330,57331,57334,1,4,0
16331,6,1,57336,57336,57337,0,1,2
16332,3,1,57339,57339,57340,0,1,2
16333,6,1,57345,57345,57346,0,1,5
16334,1,3,57346,57346,57349,0,3,0
16335,1,2,57347,57349,57351,2,4,0
16336,4,2,57351,57351,57353,0,2,0
16337,4,1,57355,57355,57356,0,1,2
16338,2,2,57357,57357,57359,0,2,1
16339,6,2,57363,57363,57365,0,2,4
16340,5,2,57368,57368,57370,0,2,3
16341,4,2,57372,57372,57374,0,2,2
16342,2,1,57374,57374,57375,0,1,0
16343,3,2,57377,57377,57379,0,2,2
16344,6,1,57383,57383,57384,0,1,4
16345,6,3,57389,57389,57392,0,3,5
16346,6,3,57395,57395,57398,0,3,3
16347,6,1,57401,57401,57402,0,1,3
16348,4,3,57405,57405,57408,0,3,3
16349,6,3,57411,57411,57414,0,3,3
16350,5,2,57416,57416,57418,0,2,2
16351,4,1,57420,57420,57421,0,1,2
16352,2,3,57422,57422,57425,0,3,1
16353,1,1,57423,57425,57426,2,3,0
16354,2,2,57425,57426,57428,1,3,0
16355,6,2,57431,57431,57433,0,2,3
16356,2,2,57433,57433,57435,0,2,0
16357,5,1,57438,57438,57439,0,1,3
16358,3,1,57441,57441,57442,0,1,2
16359,5,1,57446,57446,57447,0,1,4
16360,6,3,57452,57452,57455,0,3,5
16361,6,2,57458,57458,57460,0,2,3
16362,5,1,57463,57463,57464,0,1,3
16363,4,3,57467,57467,57470,0,3,3
16364,6,1,57473,57473,57474,0,1,3
16365,3,1,57476,57476,57477,0,1,2
16366,4,2,57480,57480,57482,0,2,3
16367,5,3,57485,57485,57488,0,3,3
16368,1,2,57486,57488,57490,2,4,0
16369,6,2,57492,57492,57494,0,2,2
16370,5,2,57497,57497,57499,0,2,3
16371,4,3,57501,57501,57504,0,3,2
16372,5,3,57506,57506,57509,0,3,2
16373,4,3,57510,57510,57513,0,3,1
16374,5,3,57515,57515,57518,0,3,2
16375,5,3,57520,57520,57523,0,3,2
16376,3,2,57523,57523,57525,0,2,0
16377,4,2,57527,57527,57529,0,2,2
16378,4,3,57531,57531,57534,0,3,2
16379,6,2,57537,57537,57539,0,2,3
16380,6,3,57543,57543,57546,0,3,4
16381,6,2,57549,57549,57551,0,2,3
16382,4,2,57553,57553,57555,0,2,2
16383,4,2,57557,57557,57559,0,2,2
16384,5,3,57562,57562,57565,0,3,3
16385,6,3,57568,57568,57571,0,3,3
16386,2,3,57570,57571,57574,1,4,0
16387,2,3,57572,57574,57577,2,5,0
16388,4,2,57576,57577,57579,1,3,0
16389,1,3,57577,57579,57582,2,5,0
16390,1,2,57578,57582,57584,4,6,0
16391,2,2,57580,57584,57586,4,6,0
16392,4,2,57584,57586,57588,2,4,0
16393,4,3,57588,57588,57591,0,3,0
16394,5,3,57593,57593,57596,0,3,2
16395,6,2,57599,57599,57601,0,2,3
16396,5,1,57604,57604,57605,0,1,3
16397,5,1,57609,57609,57610,0,1,4
16398,5,2,57614,57614,57616,0,2,4
16399,2,2,57616,57616,57618,0,2,0
16400,2,2,57618,57618,57620,0,2,0
16401,6,3,57624,57624,57627,0,3,4
16402,6,1,57630,57630,57631,0,1,3
16403,6,1,57636,57636,57637,0,1,5
16404,6,1,57642,57642,57643,0,1,5
16405,4,2,57646,57646,57648,0,2,3
16406,3,3,57649,57649,57652,0,3,1
16407,3,2,57652,57652,57654,0,2,0
16408,3,1,57655,57655,57656,0,1,1
16409,6,3,57661,57661,57664,0,3,5
16410,4,2,57665,57665,57667,0,2,1
16411,2,1,57667,57667,57668,0,1,0
16412,1,1,57668,57668,57669,0,1,0
16413,3,3,57671,57671,57674,0,3,2
16414,6,1,57677,57677,57678,0,1,3
16415,4,3,57681,57681,57684,0,3,3
16416,3,2,57684,57684,57686,0,2,0
16417,5,1,57689,57689,57690,0,1,3
16418,2,2,57691,57691,57693,0,2,1
16419,6,3,57697,57697,57700,0,3,4
16420,2,2,57699,57700,57702,1,3,0
16421,1,3,57700,57702,57705,2,5,0
16422,5,3,57705,57705,57708,0,3,0
16423,2,1,57707,57708,57709,1,2,0
16424,1,3,57708,57709,57712,1,4,0
16425,1,3,57709,57712,57715,3,6,0
16426,3,1,57712,57715,57716,3,4,0
16427,6,3,57718,57718,57721,0,3,2
16428,4,3,57722,57722,57725,0,3,1
16429,3,1,57725,57725,57726,0,1,0
16430,6,1,57731,57731,57732,0,1,5
16431,3,2,57734,57734,57736,0,2,2
16432,3,2,57737,57737,57739,0,2,1
16433,4,1,57741,57741,57742,0,1,2
16434,2,2,57743,57743,57745,0,2,1
16435,3,2,57746,57746,57748,0,2,1
16436,5,1,57751,57751,57752,0,1,3
16437,6,1,57757,57757,57758,0,1,5
16438,2,3,57759,57759,57762,0,3,1
16439,5,3,57764,57764,57767,0,3,2
16440,1,1,57765,57767,57768,2,3,0
16441,1,1,57766,57768,57769,2,3,0
16442,3,1,57769,57769,57770,0,1,0
16443,3,2,57772,57772,57774,0,2,2
16444,6,1,57778,57778,57779,0,1,4
16445,3,2,57781,57781,57783,0,2,2
16446,1,3,57782,57783,57786,1,4,0
16447,6,1,57788,57788,57789,0,1,2
16448,1,1,57789,57789,57790,0,1,0
16449,2,3,57791,57791,57794,0,3,1
16450,4,3,57795,57795,57798,0,3,1
16451,2,3,57797,57798,57801,1,4,0
16452,2,3,57799,57801,57804,2,5,0
16453,3,1,57802,57804,57805,2,3,0
16454,6,2,57808,57808,57810,0,2,3
16455,6,1,57814,57814,57815,0,1,4
16456,3,1,57817,57817,57818,0,1,2
16457,4,3,57821,57821,57824,0,3,3
16458,1,1,57822,57824,57825,2,3,0
16459,2,1,57824,57825,57826,1,2,0
16460,6,1,57830,57830,57831,0,1,4
16461,6,1,57836,57836,57837,0,1,5
16462,4,3,57840,57840,57843,0,3,3
16463,5,1,57845,57845,57846,0,1,2
16464,1,1,57846,57846,57847,0,1,0
16465,2,3,57848,57848,57851,0,3,1
16466,4,1,57852,57852,57853,0,1,1
16467,2,1,57854,57854,57855,0,1,1
16468,1,3,57855,57855,57858,0,3,0
16469,4,2,57859,57859,57861,0,2,1
16470,2,3,57861,57861,57864,0,3,0
16471,5,3,57866,57866,57869,0,3,2
16472,2,2,57868,57869,57871,1,3,0
16473,1,2,57869,57871,57873,2,4,0
16474,2,2,57871,57873,57875,2,4,0
16475,3,2,57874,57875,57877,1,3,0
16476,1,1,57875,57877,57878,2,3,0
16477,4,2,57879,57879,57881,0,2,1
16478,6,3,57885,57885,57888,0,3,4
16479,1,2,57886,57888,57890,2,4,0
16480,5,3,57891,57891,57894,0,3,1
16481,6,1,57897,57897,57898,0,1,3
16482,4,2,57901,57901,57903,0,2,3
16483,5,2,57906,57906,57908,0,2,3
16484,6,1,57912,57912,57913,0,1,4
16485,4,2,57916,57916,57918,0,2,3
16486,6,3,57922,57922,57925,0,3,4
16487,5,3,57927,57927,57930,0,3,2
16488,4,1,57931,57931,57932,0,1,1
16489,2,2,57933,57933,57935,0,2,1
16490,5,1,57938,57938,57939,0,1,3
16491,3,3,57941,57941,57944,0,3,2
16492,4,2,57945,57945,57947,0,2,1
16493,5,1,57950,57950,57951,0,1,3
16494,6,3,57956,57956,57959,0,3,5
16495,6,2,57962,57962,57964,0,2,3
16496,5,1,57967,57967,57968,0,1,3
16497,1,3,57968,57968,57971,0,3,0
16498,3,1,57971,57971,57972,0,1,0
16499,5,2,57976,57976,57978,0,2,4
16500,4,1,57980,57980,57981,0,1,2
16501,2,2,57982,57982,57984,0,2,1
16502,5,2,57987,57987,57989,0,2,3
16503,5,3,57992,57992,57995,0,3,3
16504,5,2,57997,57997,57999,0,2,2
16505,6,2,58003,58003,58005,0,2,4
16506,4,2,58007,58007,58009,0,2,2
16507,3,3,58010,58010,58013,0,3,1
16508,4,2,58014,58014,58016,0,2,1
16509,2,2,58016,58016,58018,0,2,0
16510,2,3,58018,58018,58021,0,3,0
16511,1,1,58019,58021,58022,2,3,0
16512,2,2,58021,58022,58024,1,3,0
16513,6,3,58027,58027,58030,0,3,3
16514,3,2,58030,58030,58032,0,2,0
16515,3,1,58033,58033,58034,0,1,1
16516,5,1,58038,58038,58039,0,1,4
16517,6,1,58044,58044,58045,0,1,5
16518,6,2,58050,58050,58052,0,2,5
16519,6,3,58056,58056,58059,0,3,4
16520,5,3,58061,58061,58064,0,3,2
16521,6,3,58067,58067,58070,0,3,3
16522,1,3,58068,58070,58073,2,5,0
16523,1,3,58069,58073,58076,4,7,0
16524,1,2,58070,58076,58078,6,8,0
16525,3,2,58073,58078,58080,5,7,0
16526,6,3,58079,58080,58083,1,4,0
16527,6,2,58085,58085,58087,0,2,2
16528,1,2,58086,58087,58089,1,3,0
16529,4,2,58090,58090,58092,0,2,1
16530,2,1,58092,58092,58093,0,1,0
16531,3,1,58095,58095,58096,0,1,2
16532,3,2,58098,58098,58100,0,2,2
16533,5,1,58103,58103,58104,0,1,3
16534,4,1,58107,58107,58108,0,1,3
16535,4,1,58111,58111,58112,0,1,3
16536,2,1,58113,58113,58114,0,1,1
16537,1,3,58114,58114,58117,0,3,0
16538,1,2,58115,58117,58119,2,4,0
16539,2,1,58117,58119,58120,2,3,0
16540,5,3,58122,58122,58125,0,3,2
16541,1,1,58123,58125,58126,2,3,0
16542,1,3,58124,58126,58129,2,5,0
16543,3,2,58127,58129,58131,2,4,0
16544,1,2,58128,58131,58133,3,5,0
16545,6,2,58134,58134,58136,0,2,1
16546,3,3,58137,58137,58140,0,3,1
16547,2,3,58139,58140,58143,1,4,0
16548,5,1,58144,58144,58145,0,1,1
16549,2,1,58146,58146,58147,0,1,1
16550,3,2,58149,58149,58151,0,2,2
16551,1,1,58150,58151,58152,1,2,0
16552,5,1,58155,58155,58156,0,1,3
16553,1,2,58156,58156,58158,0,2,0
16554,2,1,58158,58158,58159,0,1,0
16555,2,2,58160,58160,58162,0,2,1
16556,1,2,58161,58162,58164,1,3,0
16557,3,1,58164,58164,58165,0,1,0
16558,5,3,58169,58169,58172,0,3,4
16559,4,1,58173,58173,58174,0,1,1
16560,3,2,58176,58176,58178,0,2,2
16561,5,2,58181,58181,58183,0,2,3
16562,1,2,58182,58183,58185,1,3,0
16563,1,3,58183,58185,58188,2,5,0
16564,6,1,58189,58189,58190,0,1,1
16565,4,2,58193,58193,58195,0,2,3
16566,3,3,58196,58196,58199,0,3,1
16567,3,1,58199,58199,58200,0,1,0
16568,4,3,58203,58203,58206,0,3,3
16569,2,3,58205,58206,58209,1,4,0
16570,6,1,58211,58211,58212,0,1,2
16571,2,2,58213,58213,58215,0,2,1
16572,4,2,58217,58217,58219,0,2,2
16573,4,1,58221,58221,58222,0,1,2
16574,4,3,58225,58225,58228,0,3,3
16575,4,1,58229,58229,58230,0,1,1
16576,3,3,58232,58232,58235,0,3,2
16577,4,3,58236,58236,58239,0,3,1
16578,2,1,58238,58239,58240,1,2,0
16579,4,1,58242,58242,58243,0,1,2
16580,1,3,58243,58243,58246,0,3,0
16581,2,1,58245,58246,58247,1,2,0
16582,6,3,58251,58251,58254,0,3,4
16583,5,2,58256,58256,58258,0,2,2
16584,1,3,58257,58258,58261,1,4,0
16585,4,3,58261,58261,58264,0,3,0
16586,3,2,58264,58264,58266,0,2,0
16587,6,1,58270,58270,58271,0,1,4
16588,4,1,58274,58274,58275,0,1,3
16589,4,2,58278,58278,58280,0,2,3
16590,1,3,58279,58280,58283,1,4,0
16591,6,1,58285,58285,58286,0,1,2
16592,6,1,58291,58291,58292,0,1,5
16593,2,2,58293,58293,58295,0,2,1
16594,5,3,58298,58298,58301,0,3,3
16595,2,3,58300,58301,58304,1,4,0
16596,6,1,58306,58306,58307,0,1,2
16597,2,3,58308,58308,58311,0,3,1
16598,1,2,58309,58311,58313,2,4,0
16599,1,3,58310,58313,58316,3,6,0
16600,4,2,58314,58316,58318,2,4,0
16601,3,1,58317,58318,58319,1,2,0
16602,6,1,58323,58323,58324,0,1,4
16603,3,1,58326,58326,58327,0,1,2
16604,2,2,58328,58328,58330,0,2,1
16605,1,3,58329,58330,58333,1,4,0
16606,5,3,58334,58334,58337,0,3,1
16607,4,3,58338,58338,58341,0,3,1
16608,2,1,58340,58341,58342,1,2,0
16609,1,2,58341,58342,58344,1,3,0
16610,6,1,58347,58347,58348,0,1,3
16611,6,1,58353,58353,58354,0,1,5
16612,2,1,58355,58355,58356,0,1,1
16613,5,1,58360,58360,58361,0,1,4
16614,5,2,58365,58365,58367,0,2,4
16615,3,3,58368,58368,58371,0,3,1
16616,1,1,58369,58371,58372,2,3,0
16617,1,2,58370,58372,58374,2,4,0
16618,6,2,58376,58376,58378,0,2,2
16619,2,1,58378,58378,58379,0,1,0
16620,2,1,58380,58380,58381,0,1,1
16621,4,3,58384,58384,58387,0,3,3
16622,1,2,58385,58387,58389,2,4,0
16623,5,1,58390,58390,58391,0,1,1
16624,1,3,58391,58391,58394,0,3,0
16625,2,3,58393,58394,58397,1,4,0
16626,2,3,58395,58397,58400,2,5,0
16627,2,1,58397,58400,58401,3,4,0
16628,3,3,58400,58401,58404,1,4,0
16629,3,3,58403,58404,58407,1,4,0
16630,4,2,58407,58407,58409,0,2,0
16631,3,2,58410,58410,58412,0,2,1
16632,3,3,58413,58413,58416,0,3,1
16633,6,3,58419,58419,58422,0,3,3
16634,5,2,58424,58424,58426,0,2,2
16635,1,1,58425,58426,58427,1,2,0
16636,2,2,58427,58427,58429,0,2,0
16637,4,1,58431,58431,58432,0,1,2
16638,3,2,58434,58434,58436,0,2,2
16639,2,3,58436,58436,58439,0,3,0
16640,3,1,58439,58439,58440,0,1,0
16641,3,3,58442,58442,58445,0,3,2
16642,3,2,58445,58445,58447,0,2,0
16643,5,1,58450,58450,58451,0,1,3
16644,3,3,58453,58453,58456,0,3,2
16645,2,1,58455,58456,58457,1,2,0
16646,2,2,58457,58457,58459,0,2,0
16647,4,1,58461,58461,58462,0,1,2
16648,3,1,58464,58464,58465,0,1,2
16649,6,3,58470,58470,58473,0,3,5
16650,3,2,58473,58473,58475,0,2,0
16651,3,2,58476,58476,58478,0,2,1
16652,5,1,58481,58481,58482,0,1,3
16653,4,2,58485,58485,58487,0,2,3
16654,1,2,58486,58487,58489,1,3,0
16655,4,3,58490,58490,58493,0,3,1
16656,4,3,58494,58494,58497,0,3,1
16657,4,2,58498,58498,58500,0,2,1
16658,3,2,58501,58501,58503,0,2,1
16659,4,1,58505,58505,58506,0,1,2
16660,6,3,58511,58511,58514,0,3,5
16661,5,2,58516,58516,58518,0,2,2
16662,6,1,58522,58522,58523,0,1,4
16663,5,3,58527,58527,58530,0,3,4
16664,1,3,58528,58530,58533,2,5,0
16665,1,3,58529,58533,58536,4,7,0
16666,2,1,58531,58536,58537,5,6,0
16667,6,3,58537,58537,58540,0,3,0
16668,1,1,58538,58540,58541,2,3,0
16669,3,1,58541,58541,58542,0,1,0
16670,6,2,58547,58547,58549,0,2,5
16671,2,1,58549,58549,58550,0,1,0
16672,6,2,58555,58555,58557,0,2,5
16673,2,3,58557,58557,58560,0,3,0
16674,6,3,58563,58563,58566,0,3,3
16675,4,1,58567,58567,58568,0,1,1
16676,1,3,58568,58568,58571,0,3,0
16677,4,2,58572,58572,58574,0,2,1
16678,4,3,58576,58576,58579,0,3,2
16679,5,1,58581,58581,58582,0,1,2
16680,4,3,58585,58585,58588,0,3,3
16681,6,1,58591,58591,58592,0,1,3
16682,1,3,58592,58592,58595,0,3,0
16683,3,3,58595,58595,58598,0,3,0
16684,6,2,58601,58601,58603,0,2,3
16685,3,2,58604,58604,58606,0,2,1
16686,3,1,58607,58607,58608,0,1,1
16687,2,3,58609,58609,58612,0,3,1
16688,4,3,58613,58613,58616,0,3,1
16689,2,2,58615,58616,58618,1,3,0
16690,2,3,58617,58618,58621,1,4,0
16691,2,1,58619,58621,58622,2,3,0
16692,2,1,58621,58622,58623,1,2,0
16693,2,3,58623,58623,58626,0,3,0
16694,3,2,58626,58626,58628,0,2,0
16695,4,3,58630,58630,58633,0,3,2
16696,6,2,58636,58636,58638,0,2,3
16697,1,2,58637,58638,58640,1,3,0
16698,6,1,58643,58643,58644,0,1,3
16699,3,2,58646,58646,58648,0,2,2
16700,2,3,58648,58648,58651,0,3,0
16701,2,2,58650,58651,58653,1,3,0
16702,3,3,58653,58653,58656,0,3,0
16703,1,1,58654,58656,58657,2,3,0
16704,6,1,58660,58660,58661,0,1,3
16705,6,3,58666,58666,58669,0,3,5
16706,2,3,58668,58669,58672,1,4,0
16707,1,3,58669,58672,58675,3,6,0
16708,2,3,58671,58675,58678,4,7,0
16709,6,2,58677,58678,58680,1,3,0
16710,3,2,58680,58680,58682,0,2,0
16711,5,2,58685,58685,58687,0,2,3
16712,2,1,58687,58687,58688,0,1,0
16713,3,1,58690,58690,58691,0,1,2
16714,5,2,58695,58695,58697,0,2,4
16715,3,3,58698,58698,58701,0,3,1
16716,4,1,58702,58702,58703,0,1,1
16717,2,3,58704,58704,58707,0,3,1
16718,6,1,58710,58710,58711,0,1,3
16719,4,1,58714,58714,58715,0,1,3
16720,4,1,58718,58718,58719,0,1,3
16721,5,1,58723,58723,58724,0,1,4
16722,5,1,58728,58728,58729,0,1,4
16723,5,3,58733,58733,58736,0,3,4
16724,6,2,58739,58739,58741,0,2,3
16725,5,2,58744,58744,58746,0,2,3
16726,2,3,58746,58746,58749,0,3,0
16727,5,2,58751,58751,58753,0,2,2
16728,4,3,58755,58755,58758,0,3,2
16729,2,1,58757,58758,58759,1,2,0
16730,6,3,58763,58763,58766,0,3,4
16731,3,1,58766,58766,58767,0,1,0
16732,1,2,58767,58767,58769,0,2,0
16733,1,1,58768,58769,58770,1,2,0
16734,5,1,58773,58773,58774,0,1,3
16735,4,2,58777,58777,58779,0,2,3
16736,5,3,58782,58782,58785,0,3,3
16737,6,2,58788,58788,58790,0,2,3
16738,1,2,58789,58790,58792,1,3,0
16739,4,2,58793,58793,58795,0,2,1
16740,3,3,58796,58796,58799,0,3,1
16741,6,3,58802,58802,58805,0,3,3
16742,3,1,58805,58805,58806,0,1,0
16743,1,1,58806,58806,58807,0,1,0
16744,5,1,58811,58811,58812,0,1,4
16745,6,3,58817,58817,58820,0,3,5
16746,6,1,58823,58823,58824,0,1,3
16747,6,3,58829,58829,58832,0,3,5
16748,2,2,58831,58832,58834,1,3,0
16749,3,1,58834,58834,58835,0,1,0
16750,5,3,58839,58839,58842,0,3,4
16751,2,1,58841,58842,58843,1,2,0
16752,1,2,58842,58843,58845,1,3,0
16753,6,1,58848,58848,58849,0,1,3
16754,6,2,58854,58854,58856,0,2,5
16755,5,2,58859,58859,58861,0,2,3
16756,5,2,58864,58864,58866,0,2,3
16757,4,2,58868,58868,58870,0,2,2
16758,2,2,58870,58870,58872,0,2,0
16759,1,2,58871,58872,58874,1,3,0
16760,1,2,58872,58874,58876,2,4,0
16761,1,3,58873,58876,58879,3,6,0
16762,3,1,58876,58879,58880,3,4,0
16763,1,1,58877,58880,58881,3,4,0
16764,2,3,58879,58881,58884,2,5,0
16765,4,3,58883,58884,58887,1,4,0
16766,5,1,58888,58888,58889,0,1,1
16767,5,3,58893,58893,58896,0,3,4
16768,4,3,58897,58897,58900,0,3,1
16769,4,3,58901,58901,58904,0,3,1
16770,1,2,58902,58904,58906,2,4,0
16771,6,1,58908,58908,58909,0,1,2
16772,3,3,58911,58911,58914,0,3,2
16773,1,1,58912,58914,58915,2,3,0
16774,3,3,58915,58915,58918,0,3,0
16775,1,1,58916,58918,58919,2,3,0
16776,2,2,58918,58919,58921,1,3,0
16777,1,1,58919,58921,58922,2,3,0
16778,5,3,58924,58924,58927,0,3,2
16779,6,3,58930,58930,58933,0,3,3
16780,5,3,58935,58935,58938,0,3,2
16781,6,1,58941,58941,58942,0,1,3
16782,3,2,58944,58944,58946,0,2,2
16783,1,1,58945,58946,58947,1,2,0
16784,6,1,58951,58951,58952,0,1,4
16785,3,3,58954,58954,58957,0,3,2
16786,5,1,58959,58959,58960,0,1,2
16787,4,1,58963,58963,58964,0,1,3
16788,3,3,58966,58966,58969,0,3,2
16789,5,3,58971,58971,58974,0,3,2
16790,2,1,58973,58974,58975,1,2,0
16791,2,1,58975,58975,58976,0,1,0
16792,2,1,58977,58977,58978,0,1,1
16793,2,2,58979,58979,58981,0,2,1
16794,1,2,58980,58981,58983,1,3,0
16795,3,3,58983,58983,58986,0,3,0
16796,5,1,58988,58988,58989,0,1,2
16797,6,1,58994,58994,58995,0,1,5
16798,5,2,58999,58999,59001,0,2,4
16799,1,2,59000,59001,59003,1,3,0
16800,3,1,59003,59003,59004,0,1,0
16801,4,2,59007,59007,59009,0,2,3
16802,1,3,59008,59009,59012,1,4,0
16803,6,2,59014,59014,59016,0,2,2
16804,2,3,59016,59016,59019,0,3,0
16805,1,1,59017,59019,59020,2,3,0
16806,4,3,59021,59021,59024,0,3,1
16807,1,3,59022,59024,59027,2,5,0
16808,4,1,59026,59027,59028,1,2,0
16809,4,3,59030,59030,59033,0,3,2
16810,5,2,59035,59035,59037,0,2,2
16811,2,2,59037,59037,59039,0,2,0
16812,1,2,59038,59039,59041,1,3,0
16813,1,2,59039,59041,59043,2,4,0
16814,4,2,59043,59043,59045,0,2,0
16815,2,1,59045,59045,59046,0,1,0
16816,6,1,59051,59051,59052,0,1,5
16817,3,2,59054,59054,59056,0,2,2
16818,6,1,59060,59060,59061,0,1,4
16819,2,2,59062,59062,59064,0,2,1
16820,5,2,59067,59067,59069,0,2,3
16821,2,1,59069,59069,59070,0,1,0
16822,6,3,59075,59075,59078,0,3,5
16823,1,1,59076,59078,59079,2,3,0
16824,6,2,59082,59082,59084,0,2,3
16825,3,2,59085,59085,59087,0,2,1
16826,4,1,59089,59089,59090,0,1,2
16827,5,2,59094,59094,59096,0,2,4
16828,5,3,59099,59099,59102,0,3,3
16829,1,3,59100,59102,59105,2,5,0
16830,2,3,59102,59105,59108,3,6,0
16831,6,3,59108,59108,59111,0,3,0
16832,4,2,59112,59112,59114,0,2,1
16833,5,1,59117,59117,59118,0,1,3
16834,2,3,59119,59119,59122,0,3,1
16835,2,1,59121,59122,59123,1,2,0
16836,3,1,59124,59124,59125,0,1,1
16837,5,1,59129,59129,59130,0,1,4
16838,5,3,59134,59134,59137,0,3,4
16839,2,3,59136,59137,59140,1,4,0
16840,6,2,59142,59142,59144,0,2,2
16841,6,1,59148,59148,59149,0,1,4
16842,2,1,59150,59150,59151,0,1,1
16843,4,3,59154,59154,59157,0,3,3
16844,3,1,59157,59157,59158,0,1,0
16845,2,2,59159,59159,59161,0,2,1
16846,6,1,59165,59165,59166,0,1,4
16847,6,2,59171,59171,59173,0,2,5
16848,3,2,59174,59174,59176,0,2,1
16849,6,3,59180,59180,59183,0,3,4
16850,1,3,59181,59183,59186,2,5,0
16851,1,3,59182,59186,59189,4,7,0
16852,2,3,59184,59189,59192,5,8,0
16853,4,3,59188,59192,59195,4,7,0
16854,5,1,59193,59195,59196,2,3,0
16855,4,3,59197,59197,59200,0,3,1
16856,1,2,59198,59200,59202,2,4,0
16857,2,3,59200,59202,59205,2,5,0
16858,2,3,59202,59205,59208,3,6,0
16859,3,2,59205,59208,59210,3,5,0
16860,2,3,59207,59210,59213,3,6,0
16861,4,3,59211,59213,59216,2,5,0
16862,1,1,59212,59216,59217,4,5,0
16863,5,1,59217,59217,59218,0,1,0
16864,2,3,59219,59219,59222,0,3,1
16865,1,3,59220,59222,59225,2,5,0
16866,5,2,59225,59225,59227,0,2,0
16867,6,2,59231,59231,59233,0,2,4
16868,3,1,59234,59234,59235,0,1,1
16869,6,3,59240,59240,59243,0,3,5
16870,4,2,59244,59244,59246,0,2,1
16871,2,3,59246,59246,59249,0,3,0
16872,4,2,59250,59250,59252,0,2,1
16873,1,2,59251,59252,59254,1,3,0
16874,2,2,59253,59254,59256,1,3,0
16875,4,1,59257,59257,59258,0,1,1
16876,6,2,59263,59263,59265,0,2,5
16877,5,3,59268,59268,59271,0,3,3
16878,1,2,59269,59271,59273,2,4,0
16879,3,1,59272,59273,59274,1,2,0
16880,4,1,59276,59276,59277,0,1,2
16881,4,1,59280,59280,59281,0,1,3
16882,4,2,59284,59284,59286,0,2,3
16883,2,1,59286,59286,59287,0,1,0
16884,1,3,59287,59287,59290,0,3,0
16885,1,2,59288,59290,59292,2,4,0
16886,2,1,59290,59292,59293,2,3,0
16887,6,3,59296,59296,59299,0,3,3
16888,1,2,59297,59299,59301,2,4,0
16889,6,3,59303,59303,59306,0,3,2
16890,3,2,59306,59306,59308,0,2,0
16891,5,2,59311,59311,59313,0,2,3
16892,2,1,59313,59313,59314,0,1,0
16893,4,1,59317,59317,59318,0,1,3
16894,2,2,59319,59319,59321,0,2,1
16895,6,3,59325,59325,59328,0,3,4
16896,5,2,59330,59330,59332,0,2,2
16897,1,2,59331,59332,59334,1,3,0
16898,4,3,59335,59335,59338,0,3,1
16899,1,1,59336,59338,59339,2,3,0
16900,6,2,59342,59342,59344,0,2,3
16901,1,1,59343,59344,59345,1,2,0
16902,5,1,59348,59348,59349,0,1,3
16903,5,1,59353,59353,59354,0,1,4
16904,2,3,59355,59355,59358,0,3,1
16905,1,3,59356,59358,59361,2,5,0
16906,3,1,59359,59361,59362,2,3,0
16907,3,3,59362,59362,59365,0,3,0
16908,5,1,59367,59367,59368,0,1,2
16909,2,1,59369,59369,59370,0,1,1
16910,3,3,59372,59372,59375,0,3,2
16911,3,2,59375,59375,59377,0,2,0
16912,3,1,59378,59378,59379,0,1,1
16913,2,1,59380,59380,59381,0,1,1
16914,2,3,59382,59382,59385,0,3,1
16915,2,3,59384,59385,59388,1,4,0
16916,5,3,59389,59389,59392,0,3,1
16917,1,3,59390,59392,59395,2,5,0
16918,2,3,59392,59395,59398,3,6,0
16919,4,1,59396,59398,59399,2,3,0
16920,3,3,59399,59399,59402,0,3,0
16921,4,3,59403,59403,59406,0,3,1
16922,3,3,59406,59406,59409,0,3,0
16923,1,1,59407,59409,59410,2,3,0
16924,3,2,59410,59410,59412,0,2,0
16925,1,2,59411,59412,59414,1,3,0
16926,6,2,59417,59417,59419,0,2,3
16927,3,1,59420,59420,59421,0,1,1
16928,3,1,59423,59423,59424,0,1,2
16929,1,1,59424,59424,59425,0,1,0
16930,5,3,59429,59429,59432,0,3,4
16931,5,3,59434,59434,59437,0,3,2
16932,3,2,59437,59437,59439,0,2,0
16933,1,2,59438,59439,59441,1,3,0
16934,3,2,59441,59441,59443,0,2,0
16935,5,3,59446,59446,59449,0,3,3
16936,4,1,59450,59450,59451,0,1,1
16937,2,1,59452,59452,59453,0,1,1
16938,4,3,59456,59456,59459,0,3,3
16939,5,3,59461,59461,59464,0,3,2
16940,2,3,59463,59464,59467,1,4,0
16941,2,1,59465,59467,59468,2,3,0
16942,5,1,59470,59470,59471,0,1,2
16943,5,1,59475,59475,59476,0,1,4
16944,1,2,59476,59476,59478,0,2,0
16945,6,2,59482,59482,59484,0,2,4
16946,4,3,59486,59486,59489,0,3,2
16947,6,1,59492,59492,59493,0,1,3
16948,1,2,59493,59493,59495,0,2,0
16949,4,1,59497,59497,59498,0,1,2
16950,6,3,59503,59503,59506,0,3,5
16951,2,3,59505,59506,59509,1,4,0
16952,3,2,59508,59509,59511,1,3,0
16953,4,1,59512,59512,59513,0,1,1
16954,4,1,59516,59516,59517,0,1,3
16955,2,2,59518,59518,59520,0,2,1
16956,2,1,59520,59520,59521,0,1,0
16957,5,1,59525,59525,59526,0,1,4
16958,5,1,59530,59530,59531,0,1,4
16959,2,1,59532,59532,59533,0,1,1
16960,1,1,59533,59533,59534,0,1,0
16961,1,1,59534,59534,59535,0,1,0
16962,4,1,59538,59538,59539,0,1,3
16963,6,3,59544,59544,59547,0,3,5
16964,4,1,59548,59548,59549,0,1,1
16965,2,3,59550,59550,59553,0,3,1
16966,3,1,59553,59553,59554,0,1,0
16967,2,2,59555,59555,59557,0,2,1
16968,4,2,59559,59559,59561,0,2,2
16969,6,1,59565,59565,59566,0,1,4
16970,1,1,59566,59566,59567,0,1,0
16971,6,2,59572,59572,59574,0,2,5
16972,3,3,59575,59575,59578,0,3,1
16973,6,2,59581,59581,59583,0,2,3
16974,1,1,59582,59583,59584,1,2,0
16975,5,2,59587,59587,59589,0,2,3
16976,3,2,59590,59590,59592,0,2,1
16977,2,3,59592,59592,59595,0,3,0
16978,2,1,59594,59595,59596,1,2,0
16979,2,1,59596,59596,59597,0,1,0
16980,2,1,59598,59598,59599,0,1,1
16981,2,2,59600,59600,59602,0,2,1
16982,2,3,59602,59602,59605,0,3,0
16983,1,1,59603,59605,59606,2,3,0
16984,4,1,59607,59607,59608,0,1,1
16985,3,2,59610,59610,59612,0,2,2
16986,2,2,59612,59612,59614,0,2,0
16987,2,2,59614,59614,59616,0,2,0
16988,4,1,59618,59618,59619,0,1,2
16989,2,3,59620,59620,59623,0,3,1
16990,1,2,59621,59623,59625,2,4,0
16991,3,2,59624,59625,59627,1,3,0
16992,1,2,59625,59627,59629,2,4,0
16993,2,1,59627,59629,59630,2,3,0
16994,1,2,59628,59630,59632,2,4,0
16995,4,2,59632,59632,59634,0,2,0
16996,3,2,59635,59635,59637,0,2,1
16997,6,2,59641,59641,59643,0,2,4
16998,3,2,59644,59644,59646,0,2,1
16999,4,2,59648,59648,59650,0,2,2
17000,6,1,59654,59654,59655,0,1,4
17001,5,2,59659,59659,59661,0,2,4
17002,3,3,59662,59662,59665,0,3,1
17003,6,3,59668,59668,59671,0,3,3
17004,4,1,59672,59672,59673,0,1,1
17005,6,2,59678,59678,59680,0,2,5
17006,6,2,59684,59684,59686,0,2,4
17007,3,2,59687,59687,59689,0,2,1
17008,5,2,59692,59692,59694,0,2,3
17009,4,3,59696,59696,59699,0,3,2
17010,1,3,59697,59699,59702,2,5,0
17011,2,2,59699,59702,59704,3,5,0
17012,1,1,59700,59704,59705,4,5,0
17013,6,1,59706,59706,59707,0,1,1
17014,2,1,59708,59708,59709,0,1,1
17015,1,3,59709,59709,59712,0,3,0
17016,5,1,59714,59714,59715,0,1,2
17017,1,1,59715,59715,59716,0,1,0
17018,4,2,59719,59719,59721,0,2,3
17019,6,3,59725,59725,59728,0,3,4
17020,2,3,59727,59728,59731,1,4,0
17021,1,1,59728,59731,59732,3,4,0
17022,5,1,59733,59733,59734,0,1,1
17023,3,1,59736,59736,59737,0,1,2
17024,5,1,59741,59741,59742,0,1,4
17025,6,3,59747,59747,59750,0,3,5
17026,2,2,59749,59750,59752,1,3,0
17027,2,1,59751,59752,59753,1,2,0
17028,3,3,59754,59754,59757,0,3,1
17029,6,2,59760,59760,59762,0,2,3
17030,2,1,59762,59762,59763,0,1,0
17031,2,1,59764,59764,59765,0,1,1
17032,5,1,59769,59769,59770,0,1,4
17033,3,1,59772,59772,59773,0,1,2
17034,5,3,59777,59777,59780,0,3,4
17035,1,1,59778,59780,59781,2,3,0
17036,5,2,59783,59783,59785,0,2,2
17037,1,1,59784,59785,59786,1,2,0
17038,1,3,59785,59786,59789,1,4,0
17039,1,3,59786,59789,59792,3,6,0
17040,2,3,59788,59792,59795,4,7,0
17041,6,3,59794,59795,59798,1,4,0
17042,1,1,59795,59798,59799,3,4,0
17043,6,2,59801,59801,59803,0,2,2
17044,3,2,59804,59804,59806,0,2,1
17045,1,3,59805,59806,59809,1,4,0
17046,3,3,59808,59809,59812,1,4,0
17047,6,3,59814,59814,59817,0,3,2
17048,6,2,59820,59820,59822,0,2,3
17049,5,2,59825,59825,59827,0,2,3
17050,3,2,59828,59828,59830,0,2,1
17051,1,2,59829,59830,59832,1,3,0
17052,4,2,59833,59833,59835,0,2,1
17053,6,1,59839,59839,59840,0,1,4
17054,2,3,59841,59841,59844,0,3,1
17055,4,3,59845,59845,59848,0,3,1
17056,3,3,59848,59848,59851,0,3,0
17057,1,3,59849,59851,59854,2,5,0
17058,5,3,59854,59854,59857,0,3,0
17059,3,2,59857,59857,59859,0,2,0
17060,1,1,59858,59859,59860,1,2,0
17061,4,2,59862,59862,59864,0,2,2
17062,4,2,59866,59866,59868,0,2,2
17063,3,3,59869,59869,59872,0,3,1
17064,4,2,59873,59873,59875,0,2,1
17065,5,1,59878,59878,59879,0,1,3
17066,2,1,59880,59880,59881,0,1,1
17067,6,1,59886,59886,59887,0,1,5
17068,2,1,59888,59888,59889,0,1,1
17069,6,1,59894,59894,59895,0,1,5
17070,1,2,59895,59895,59897,0,2,0
17071,3,3,59898,59898,59901,0,3,1
17072,2,1,59900,59901,59902,1,2,0
17073,6,2,59906,59906,59908,0,2,4
17074,4,1,59910,59910,59911,0,1,2
17075,6,1,59916,59916,59917,0,1,5
17076,6,2,59922,59922,59924,0,2,5
17077,2,1,59924,59924,59925,0,1,0
17078,1,2,59925,59925,59927,0,2,0
17079,2,2,59927,59927,59929,0,2,0
17080,5,3,59932,59932,59935,0,3,3
17081,2,1,59934,59935,59936,1,2,0
17082,1,2,59935,59936,59938,1,3,0
17083,4,2,59939,59939,59941,0,2,1
17084,3,1,59942,59942,59943,0,1,1
17085,4,1,59946,59946,59947,0,1,3
17086,2,2,59948,59948,59950,0,2,1
17087,2,1,59950,59950,59951,0,1,0
17088,4,2,59954,59954,59956,0,2,3
17089,6,1,59960,59960,59961,0,1,4
17090,1,3,59961,59961,59964,0,3,0
17091,6,2,59967,59967,59969,0,2,3
17092,6,1,59973,59973,59974,0,1,4
17093,2,2,59975,59975,59977,0,2,1
17094,5,3,59980,59980,59983,0,3,3
17095,6,1,59986,59986,59987,0,1,3
17096,4,1,59990,59990,59991,0,1,3
17097,1,2,59991,59991,59993,0,2,0
17098,5,1,59996,59996,59997,0,1,3
17099,2,1,59998,59998,59999,0,1,1
17100,5,3,60003,60003,60006,0,3,4
17101,1,3,60004,60006,60009,2,5,0
17102,3,1,60007,60009,60010,2,3,0
17103,1,3,60008,60010,60013,2,5,0
17104,2,2,60010,60013,60015,3,5,0
17105,2,3,60012,60015,60018,3,6,0
17106,5,1,60017,60018,60019,1,2,0
17107,5,1,60022,60022,60023,0,1,3
17108,5,2,60027,60027,60029,0,2,4
17109,5,1,60032,60032,60033,0,1,3
17110,4,3,60036,60036,60039,0,3,3
17111,5,3,60041,60041,60044,0,3,2
17112,4,3,60045,60045,60048,0,3,1
17113,1,3,60046,60048,60051,2,5,0
17114,2,1,60048,60051,60052,3,4,0
17115,3,2,60051,60052,60054,1,3,0
17116,3,1,60054,60054,60055,0,1,0
17117,2,2,60056,60056,60058,0,2,1
17118,2,2,60058,60058,60060,0,2,0
17119,4,2,60062,60062,60064,0,2,2
17120,1,2,60063,60064,60066,1,3,0
17121,6,1,60069,60069,60070,0,1,3
17122,6,1,60075,60075,60076,0,1,5
17123,3,1,60078,60078,60079,0,1,2
17124,3,3,60081,60081,60084,0,3,2
17125,6,2,60087,60087,60089,0,2,3
17126,4,2,60091,60091,60093,0,2,2
17127,1,3,60092,60093,60096,1,4,0
17128,3,3,60095,60096,60099,1,4,0
17129,2,1,60097,60099,60100,2,3,0
17130,3,2,60100,60100,60102,0,2,0
17131,5,2,60105,60105,60107,0,2,3
17132,6,2,60111,60111,60113,0,2,4
17133,4,1,60115,60115,60116,0,1,2
17134,2,2,60117,60117,60119,0,2,1
17135,5,3,60122,60122,60125,0,3,3
17136,5,2,60127,60127,60129,0,2,2
17137,5,2,60132,60132,60134,0,2,3
17138,1,1,60133,60134,60135,1,2,0
17139,2,3,60135,60135,60138,0,3,0
17140,3,3,60138,60138,60141,0,3,0
17141,5,2,60143,60143,60145,0,2,2
17142,4,1,60147,60147,60148,0,1,2
17143,1,1,60148,60148,60149,0,1,0
17144,5,1,60153,60153,60154,0,1,4
17145,2,3,60155,60155,60158,0,3,1
17146,1,2,60156,60158,60160,2,4,0
17147,4,2,60160,60160,60162,0,2,0
17148,4,3,60164,60164,60167,0,3,2
17149,1,3,60165,60167,60170,2,5,0
17150,4,2,60169,60170,60172,1,3,0
17151,5,3,60174,60174,60177,0,3,2
17152,2,3,60176,60177,60180,1,4,0
17153,3,1,60179,60180,60181,1,2,0
17154,2,1,60181,60181,60182,0,1,0
17155,5,1,60186,60186,60187,0,1,4
17156,2,3,60188,60188,60191,0,3,1
17157,6,2,60194,60194,60196,0,2,3
17158,1,3,60195,60196,60199,1,4,0
17159,1,2,60196,60199,60201,3,5,0
17160,3,1,60199,60201,60202,2,3,0
17161,5,3,60204,60204,60207,0,3,2
17162,3,1,60207,60207,60208,0,1,0
17163,6,2,60213,60213,60215,0,2,5
17164,4,2,60217,60217,60219,0,2,2
17165,4,3,60221,60221,60224,0,3,2
17166,3,1,60224,60224,60225,0,1,0
17167,3,3,60227,60227,60230,0,3,2
17168,2,3,60229,60230,60233,1,4,0
17169,3,1,60232,60233,60234,1,2,0
17170,3,3,60235,60235,60238,0,3,1
17171,1,2,60236,60238,60240,2,4,0
17172,1,1,60237,60240,60241,3,4,0
17173,3,3,60240,60241,60244,1,4,0
17174,5,1,60245,60245,60246,0,1,1
17175,6,1,60251,60251,60252,0,1,5
17176,3,1,60254,60254,60255,0,1,2
17177,5,3,60259,60259,60262,0,3,4
17178,2,1,60261,60262,60263,1,2,0
17179,1,2,60262,60263,60265,1,3,0
17180,2,3,60264,60265,60268,1,4,0
17181,2,1,60266,60268,60269,2,3,0
17182,2,1,60268,60269,60270,1,2,0
17183,1,2,60269,60270,60272,1,3,0
17184,6,3,60275,60275,60278,0,3,3
17185,1,2,60276,60278,60280,2,4,0
17186,1,1,60277,60280,60281,3,4,0
17187,1,1,60278,60281,60282,3,4,0
17188,2,2,60280,60282,60284,2,4,0
17189,5,1,60285,60285,60286,0,1,1
17190,1,3,60286,60286,60289,0,3,0
17191,1,3,60287,60289,60292,2,5,0
17192,1,1,60288,60292,60293,4,5,0
17193,3,2,60291,60293,60295,2,4,0
17194,1,1,60292,60295,60296,3,4,0
17195,6,3,60298,60298,60301,0,3,2
17196,4,1,60302,60302,60303,0,1,1
17197,5,1,60307,60307,60308,0,1,4
17198,6,2,60313,60313,60315,0,2,5
17199,5,1,60318,60318,60319,0,1,3
17200,5,2,60323,60323,60325,0,2,4
17201,2,2,60325,60325,60327,0,2,0
17202,6,2,60331,60331,60333,0,2,4
17203,1,3,60332,60333,60336,1,4,0
17204,1,2,60333,60336,60338,3,5,0
17205,1,3,60334,60338,60341,4,7,0
17206,3,1,60337,60341,60342,4,5,0
17207,4,3,60341,60342,60345,1,4,0
17208,2,2,60343,60345,60347,2,4,0
17209,6,3,60349,60349,60352,0,3,2
17210,5,2,60354,60354,60356,0,2,2
17211,5,3,60359,60359,60362,0,3,3
17212,2,2,60361,60362,60364,1,3,0
17213,1,3,60362,60364,60367,2,5,0
17214,6,3,60368,60368,60371,0,3,1
17215,2,2,60370,60371,60373,1,3,0
17216,2,3,60372,60373,60376,1,4,0
17217,1,3,60373,60376,60379,3,6,0
17218,1,1,60374,60379,60380,5,6,0
17219,6,3,60380,60380,60383,0,3,0
17220,3,2,60383,60383,60385,0,2,0
17221,6,1,60389,60389,60390,0,1,4
17222,6,1,60395,60395,60396,0,1,5
17223,2,3,60397,60397,60400,0,3,1
17224,4,1,60401,60401,60402,0,1,1
17225,5,3,60406,60406,60409,0,3,4
17226,4,3,60410,60410,60413,0,3,1
17227,6,2,60416,60416,60418,0,2,3
17228,1,2,60417,60418,60420,1,3,0
17229,2,1,60419,60420,60421,1,2,0
17230,1,2,60420,60421,60423,1,3,0
17231,5,1,60425,60425,60426,0,1,2
17232,6,3,60431,60431,60434,0,3,5
17233,1,3,60432,60434,60437,2,5,0
17234,1,2,60433,60437,60439,4,6,0
17235,4,1,60437,60439,60440,2,3,0
17236,6,1,60443,60443,60444,0,1,3
17237,4,1,60447,60447,60448,0,1,3
17238,1,3,60448,60448,60451,0,3,0
17239,3,1,60451,60451,60452,0,1,0
17240,5,3,60456,60456,60459,0,3,4
17241,5,2,60461,60461,60463,0,2,2
17242,1,2,60462,60463,60465,1,3,0
17243,1,1,60463,60465,60466,2,3,0
17244,4,1,60467,60467,60468,0,1,1
17245,1,3,60468,60468,60471,0,3,0
17246,1,1,60469,60471,60472,2,3,0
17247,6,1,60475,60475,60476,0,1,3
17248,6,3,60481,60481,60484,0,3,5
17249,1,1,60482,60484,60485,2,3,0
17250,2,1,60484,60485,60486,1,2,0
17251,4,2,60488,60488,60490,0,2,2
17252,6,1,60494,60494,60495,0,1,4
17253,5,1,60499,60499,60500,0,1,4
17254,3,1,60502,60502,60503,0,1,2
17255,2,2,60504,60504,60506,0,2,1
17256,4,3,60508,60508,60511,0,3,2
17257,4,2,60512,60512,60514,0,2,1
17258,1,2,60513,60514,60516,1,3,0
17259,1,2,60514,60516,60518,2,4,0
17260,1,2,60515,60518,60520,3,5,0
17261,2,3,60517,60520,60523,3,6,0
17262,2,3,60519,60523,60526,4,7,0
17263,2,3,60521,60526,60529,5,8,0
17264,3,2,60524,60529,60531,5,7,0
17265,2,1,60526,60531,60532,5,6,0
17266,1,1,60527,60532,60533,5,6,0
17267,1,3,60528,60533,60536,5,8,0
17268,1,2,60529,60536,60538,7,9,0
17269,6,1,60535,60538,60539,3,4,0
17270,6,1,60541,60541,60542,0,1,2
17271,6,2,60547,60547,60549,0,2,5
17272,4,2,60551,60551,60553,0,2,2
17273,1,2,60552,60553,60555,1,3,0
17274,5,3,60557,60557,60560,0,3,2
17275,6,1,60563,60563,60564,0,1,3
17276,4,1,60567,60567,60568,0,1,3
17277,2,3,60569,60569,60572,0,3,1
17278,3,1,60572,60572,60573,0,1,0
17279,6,2,60578,60578,60580,0,2,5
17280,1,2,60579,60580,60582,1,3,0
17281,1,2,60580,60582,60584,2,4,0
17282,4,1,60584,60584,60585,0,1,0
17283,6,3,60590,60590,60593,0,3,5
17284,6,1,60596,60596,60597,0,1,3
17285,2,3,60598,60598,60601,0,3,1
17286,3,3,60601,60601,60604,0,3,0
17287,1,2,60602,60604,60606,2,4,0
17288,3,3,60605,60606,60609,1,4,0
17289,3,1,60608,60609,60610,1,2,0
17290,4,3,60612,60612,60615,0,3,2
17291,2,1,60614,60615,60616,1,2,0
17292,6,3,60620,60620,60623,0,3,4
17293,2,3,60622,60623,60626,1,4,0
17294,6,2,60628,60628,60630,0,2,2
17295,2,1,60630,60630,60631,0,1,0
17296,6,1,60636,60636,60637,0,1,5
17297,5,1,60641,60641,60642,0,1,4
17298,1,3,60642,60642,60645,0,3,0
17299,2,2,60644,60645,60647,1,3,0
17300,3,1,60647,60647,60648,0,1,0
17301,1,1,60648,60648,60649,0,1,0
17302,5,1,60653,60653,60654,0,1,4
17303,1,1,60654,60654,60655,0,1,0
17304,4,3,60658,60658,60661,0,3,3
17305,6,2,60664,60664,60666,0,2,3
17306,4,2,60668,60668,60670,0,2,2
17307,6,3,60674,60674,60677,0,3,4
17308,1,1,60675,60677,60678,2,3,0
17309,1,3,60676,60678,60681,2,5,0
17310,4,2,60680,60681,60683,1,3,0
17311,1,2,60681,60683,60685,2,4,0
17312,2,1,60683,60685,60686,2,3,0
17313,5,2,60688,60688,60690,0,2,2
17314,5,1,60693,60693,60694,0,1,3
17315,5,3,60698,60698,60701,0,3,4
17316,1,1,60699,60701,60702,2,3,0
17317,6,3,60705,60705,60708,0,3,3
17318,4,2,60709,60709,60711,0,2,1
17319,5,2,60714,60714,60716,0,2,3
17320,1,1,60715,60716,60717,1,2,0
17321,2,2,60717,60717,60719,0,2,0
17322,3,2,60720,60720,60722,0,2,1
17323,2,1,60722,60722,60723,0,1,0
17324,2,2,60724,60724,60726,0,2,1
17325,3,1,60727,60727,60728,0,1,1
17326,6,1,60733,60733,60734,0,1,5
17327,1,2,60734,60734,60736,0,2,0
17328,4,3,60738,60738,60741,0,3,2
17329,5,1,60743,60743,60744,0,1,2
17330,2,3,60745,60745,60748,0,3,1
17331,6,1,60751,60751,60752,0,1,3
17332,3,1,60754,60754,60755,0,1,2
17333,1,2,60755,60755,60757,0,2,0
17334,1,3,60756,60757,60760,1,4,0
17335,1,1,60757,60760,60761,3,4,0
17336,1,3,60758,60761,60764,3,6,0
17337,1,3,60759,60764,60767,5,8,0
17338,3,3,60762,60767,60770,5,8,0
17339,1,1,60763,60770,60771,7,8,0
17340,5,1,60768,60771,60772,3,4,0
17341,3,1,60771,60772,60773,1,2,0
17342,1,2,60772,60773,60775,1,3,0
17343,5,1,60777,60777,60778,0,1,2
17344,5,1,60782,60782,60783,0,1,4
17345,1,3,60783,60783,60786,0,3,0
17346,1,1,60784,60786,60787,2,3,0
17347,3,2,60787,60787,60789,0,2,0
17348,1,1,60788,60789,60790,1,2,0
17349,1,2,60789,60790,60792,1,3,0
17350,3,2,60792,60792,60794,0,2,0
17351,3,2,60795,60795,60797,0,2,1
17352,3,1,60798,60798,60799,0,1,1
17353,3,2,60801,60801,60803,0,2,2
17354,3,3,60804,60804,60807,0,3,1
17355,2,1,60806,60807,60808,1,2,0
17356,3,2,60809,60809,60811,0,2,1
17357,1,2,60810,60811,60813,1,3,0
17358,5,2,60815,60815,60817,0,2,2
17359,1,3,60816,60817,60820,1,4,0
17360,2,2,60818,60820,60822,2,4,0
17361,6,1,60824,60824,60825,0,1,2
17362,1,3,60825,60825,60828,0,3,0
17363,6,3,60831,60831,60834,0,3,3
17364,5,1,60836,60836,60837,0,1,2
17365,2,2,60838,60838,60840,0,2,1
17366,2,3,60840,60840,60843,0,3,0
17367,3,1,60843,60843,60844,0,1,0
17368,3,3,60846,60846,60849,0,3,2
17369,3,1,60849,60849,60850,0,1,0
17370,2,3,60851,60851,60854,0,3,1
17371,2,1,60853,60854,60855,1,2,0
17372,3,3,60856,60856,60859,0,3,1
17373,6,3,60862,60862,60865,0,3,3
17374,6,2,60868,60868,60870,0,2,3
17375,2,2,60870,60870,60872,0,2,0
17376,2,3,60872,60872,60875,0,3,0
17377,6,3,60878,60878,60881,0,3,3
17378,6,3,60884,60884,60887,0,3,3
17379,2,2,60886,60887,60889,1,3,0
17380,5,3,60891,60891,60894,0,3,2
17381,3,1,60894,60894,60895,0,1,0
17382,3,1,60897,60897,60898,0,1,2
17383,6,3,60903,60903,60906,0,3,5
17384,2,1,60905,60906,60907,1,2,0
17385,2,3,60907,60907,60910,0,3,0
17386,5,2,60912,60912,60914,0,2,2
17387,3,2,60915,60915,60917,0,2,1
17388,1,2,60916,60917,60919,1,3,0
17389,6,2,60922,60922,60924,0,2,3
17390,6,2,60928,60928,60930,0,2,4
17391,6,3,60934,60934,60937,0,3,4
17392,2,1,60936,60937,60938,1,2,0
17393,3,3,60939,60939,60942,0,3,1
17394,2,3,60941,60942,60945,1,4,0
17395,4,3,60945,60945,60948,0,3,0
17396,3,1,60948,60948,60949,0,1,0
17397,1,2,60949,60949,60951,0,2,0
17398,2,1,60951,60951,60952,0,1,0
17399,4,1,60955,60955,60956,0,1,3
17400,5,2,60960,60960,60962,0,2,4
17401,2,1,60962,60962,60963,0,1,0
17402,4,2,60966,60966,60968,0,2,3
17403,2,2,60968,60968,60970,0,2,0
17404,4,3,60972,60972,60975,0,3,2
17405,3,3,60975,60975,60978,0,3,0
17406,6,1,60981,60981,60982,0,1,3
17407,6,3,60987,60987,60990,0,3,5
17408,5,3,60992,60992,60995,0,3,2
17409,6,2,60998,60998,61000,0,2,3
17410,1,2,60999,61000,61002,1,3,0
17411,1,3,61000,61002,61005,2,5,0
17412,3,2,61003,61005,61007,2,4,0
17413,3,1,61006,61007,61008,1,2,0
17414,1,3,61007,61008,61011,1,4,0
17415,2,2,61009,61011,61013,2,4,0
17416,6,1,61015,61015,61016,0,1,2
17417,5,1,61020,61020,61021,0,1,4
17418,5,2,61025,61025,61027,0,2,4
17419,4,1,61029,61029,61030,0,1,2
17420,1,3,61030,61030,61033,0,3,0
17421,2,2,61032,61033,61035,1,3,0
17422,4,1,61036,61036,61037,0,1,1
17423,1,3,61037,61037,61040,0,3,0
17424,1,1,61038,61040,61041,2,3,0
17425,1,1,61039,61041,61042,2,3,0
17426,6,2,61045,61045,61047,0,2,3
17427,2,3,61047,61047,61050,0,3,0
17428,4,2,61051,61051,61053,0,2,1
17429,1,1,61052,61053,61054,1,2,0
17430,6,2,61058,61058,61060,0,2,4
17431,4,3,61062,61062,61065,0,3,2
17432,4,3,61066,61066,61069,0,3,1
17433,2,3,61068,61069,61072,1,4,0
17434,2,1,61070,61072,61073,2,3,0
17435,4,2,61074,61074,61076,0,2,1
17436,3,3,61077,61077,61080,0,3,1
17437,4,1,61081,61081,61082,0,1,1
17438,6,2,61087,61087,61089,0,2,5
17439,4,1,61091,61091,61092,0,1,2
17440,5,3,61096,61096,61099,0,3,4
17441,3,2,61099,61099,61101,0,2,0
17442,2,2,61101,61101,61103,0,2,0
17443,6,3,61107,61107,61110,0,3,4
17444,3,1,61110,61110,61111,0,1,0
17445,6,3,61116,61116,61119,0,3,5
17446,6,1,61122,61122,61123,0,1,3
17447,6,3,61128,61128,61131,0,3,5
17448,5,1,61133,61133,61134,0,1,2
17449,2,2,61135,61135,61137,0,2,1
17450,2,3,61137,61137,61140,0,3,0
17451,6,2,61143,61143,61145,0,2,3
17452,4,3,61147,61147,61150,0,3,2
17453,2,2,61149,61150,61152,1,3,0
17454,5,3,61154,61154,61157,0,3,2
17455,5,3,61159,61159,61162,0,3,2
17456,1,3,61160,61162,61165,2,5,0
17457,3,2,61163,61165,61167,2,4,0
17458,1,3,61164,61167,61170,3,6,0
17459,3,2,61167,61170,61172,3,5,0
17460,6,1,61173,61173,61174,0,1,1
17461,3,1,61176,61176,61177,0,1,2
17462,4,1,61180,61180,61181,0,1,3
17463,4,2,61184,61184,61186,0,2,3
17464,3,1,61187,61187,61188,0,1,1
17465,1,3,61188,61188,61191,0,3,0
17466,5,2,61193,61193,61195,0,2,2
17467,2,2,61195,61195,61197,0,2,0
17468,4,2,61199,61199,61201,0,2,2
17469,3,2,61202,61202,61204,0,2,1
17470,2,3,61204,61204,61207,0,3,0
17471,3,3,61207,61207,61210,0,3,0
17472,6,1,61213,61213,61214,0,1,3
17473,1,2,61214,61214,61216,0,2,0
17474,1,1,61215,61216,61217,1,2,0
17475,6,2,61221,61221,61223,0,2,4
17476,4,1,61225,61225,61226,0,1,2
17477,2,2,61227,61227,61229,0,2,1
17478,4,3,61231,61231,61234,0,3,2
17479,1,3,61232,61234,61237,2,5,0
17480,1,3,61233,61237,61240,4,7,0
17481,4,3,61237,61240,61243,3,6,0
17482,2,2,61239,61243,61245,4,6,0
17483,4,3,61243,61245,61248,2,5,0
17484,3,2,61246,61248,61250,2,4,0
17485,1,3,61247,61250,61253,3,6,0
17486,6,1,61253,61253,61254,0,1,0
17487,3,2,61256,61256,61258,0,2,2
17488,5,1,61261,61261,61262,0,1,3
17489,3,3,61264,61264,61267,0,3,2
17490,2,3,61266,61267,61270,1,4,0
17491,6,3,61272,61272,61275,0,3,2
17492,3,3,61275,61275,61278,0,3,0
17493,3,1,61278,61278,61279,0,1,0
17494,5,3,61283,61283,61286,0,3,4
17495,4,1,61287,61287,61288,0,1,1
17496,4,1,61291,61291,61292,0,1,3
17497,1,1,61292,61292,61293,0,1,0
17498,6,2,61298,61298,61300,0,2,5
17499,2,1,61300,61300,61301,0,1,0
17500,2,1,61302,61302,61303,0,1,1
17501,6,3,61308,61308,61311,0,3,5
17502,3,2,61311,61311,61313,0,2,0
17503,6,1,61317,61317,61318,0,1,4
17504,1,1,61318,61318,61319,0,1,0
17505,2,1,61320,61320,61321,0,1,1
17506,4,1,61324,61324,61325,0,1,3
17507,6,3,61330,61330,61333,0,3,5
17508,2,1,61332,61333,61334,1,2,0
17509,2,1,61334,61334,61335,0,1,0
17510,6,1,61340,61340,61341,0,1,5
17511,2,1,61342,61342,61343,0,1,1
17512,6,3,61348,61348,61351,0,3,5
17513,4,2,61352,61352,61354,0,2,1
17514,1,3,61353,61354,61357,1,4,0
17515,2,1,61355,61357,61358,2,3,0
17516,2,3,61357,61358,61361,1,4,0
17517,5,3,61362,61362,61365,0,3,1
17518,1,2,61363,61365,61367,2,4,0
17519,3,3,61366,61367,61370,1,4,0
17520,1,3,61367,61370,61373,3,6,0
17521,6,2,61373,61373,61375,0,2,0
17522,1,1,61374,61375,61376,1,2,0
17523,2,3,61376,61376,61379,0,3,0
17524,5,1,61381,61381,61382,0,1,2
17525,5,2,61386,61386,61388,0,2,4
17526,5,2,61391,61391,61393,0,2,3
17527,2,2,61393,61393,61395,0,2,0
17528,2,1,61395,61395,61396,0,1,0
17529,6,2,61401,61401,61403,0,2,5
17530,6,2,61407,61407,61409,0,2,4
17531,4,2,61411,61411,61413,0,2,2
17532,3,1,61414,61414,61415,0,1,1
17533,6,1,61420,61420,61421,0,1,5
17534,6,3,61426,61426,61429,0,3,5
17535,4,3,61430,61430,61433,0,3,1
17536,3,1,61433,61433,61434,0,1,0
17537,1,3,61434,61434,61437,0,3,0
17538,6,3,61440,61440,61443,0,3,3
17539,2,3,61442,61443,61446,1,4,0
17540,3,3,61445,61446,61449,1,4,0
17541,1,2,61446,61449,61451,3,5,0
17542,4,3,61450,61451,61454,1,4,0
17543,6,2,61456,61456,61458,0,2,2
17544,2,2,61458,61458,61460,0,2,0
17545,2,3,61460,61460,61463,0,3,0
17546,4,1,61464,61464,61465,0,1,1
17547,4,1,61468,61468,61469,0,1,3
17548,4,3,61472,61472,61475,0,3,3
17549,5,1,61477,61477,61478,0,1,2
17550,1,2,61478,61478,61480,0,2,0
17551,5,2,61483,61483,61485,0,2,3
17552,1,2,61484,61485,61487,1,3,0
17553,5,3,61489,61489,61492,0,3,2
17554,4,2,61493,61493,61495,0,2,1
17555,5,3,61498,61498,61501,0,3,3
17556,5,1,61503,61503,61504,0,1,2
17557,2,1,61505,61505,61506,0,1,1
17558,6,1,61511,61511,61512,0,1,5
17559,5,3,61516,61516,61519,0,3,4
17560,1,2,61517,61519,61521,2,4,0
17561,4,1,61521,61521,61522,0,1,0
17562,3,2,61524,61524,61526,0,2,2
17563,1,2,61525,61526,61528,1,3,0
17564,1,1,61526,61528,61529,2,3,0
17565,2,3,61528,61529,61532,1,4,0
17566,4,2,61532,61532,61534,0,2,0
17567,1,1,61533,61534,61535,1,2,0
17568,2,3,61535,61535,61538,0,3,0
17569,3,1,61538,61538,61539,0,1,0
17570,3,1,61541,61541,61542,0,1,2
17571,2,1,61543,61543,61544,0,1,1
17572,5,3,61548,61548,61551,0,3,4
17573,2,1,61550,61551,61552,1,2,0
17574,3,2,61553,61553,61555,0,2,1
17575,1,2,61554,61555,61557,1,3,0
17576,6,3,61560,61560,61563,0,3,3
17577,5,2,61565,61565,61567,0,2,2
17578,1,1,61566,61567,61568,1,2,0
17579,1,1,61567,61568,61569,1,2,0
17580,6,2,61573,61573,61575,0,2,4
17581,4,2,61577,61577,61579,0,2,2
17582,1,2,61578,61579,61581,1,3,0
17583,4,2,61582,61582,61584,0,2,1
17584,6,3,61588,61588,61591,0,3,4
17585,3,1,61591,61591,61592,0,1,0
17586,5,1,61596,61596,61597,0,1,4
17587,5,3,61601,61601,61604,0,3,4
17588,4,2,61605,61605,61607,0,2,1
17589,1,3,61606,61607,61610,1,4,0
17590,1,3,61607,61610,61613,3,6,0
17591,4,1,61611,61613,61614,2,3,0
17592,5,2,61616,61616,61618,0,2,2
17593,2,2,61618,61618,61620,0,2,0
17594,5,1,61623,61623,61624,0,1,3
17595,3,3,61626,61626,61629,0,3,2
17596,5,3,61631,61631,61634,0,3,2
17597,5,3,61636,61636,61639,0,3,2
17598,3,2,61639,61639,61641,0,2,0
17599,5,1,61644,61644,61645,0,1,3
17600,5,2,61649,61649,61651,0,2,4
17601,2,1,61651,61651,61652,0,1,0
17602,6,2,61657,61657,61659,0,2,5
17603,6,2,61663,61663,61665,0,2,4
17604,3,2,61666,61666,61668,0,2,1
17605,6,1,61672,61672,61673,0,1,4
17606,4,2,61676,61676,61678,0,2,3
17607,5,2,61681,61681,61683,0,2,3
17608,1,1,61682,61683,61684,1,2,0
17609,1,1,61683,61684,61685,1,2,0
17610,2,3,61685,61685,61688,0,3,0
17611,3,1,61688,61688,61689,0,1,0
17612,3,3,61691,61691,61694,0,3,2
17613,6,1,61697,61697,61698,0,1,3
17614,4,3,61701,61701,61704,0,3,3
17615,4,2,61705,61705,61707,0,2,1
17616,6,3,61711,61711,61714,0,3,4
17617,6,3,61717,61717,61720,0,3,3
17618,6,2,61723,61723,61725,0,2,3
17619,3,3,61726,61726,61729,0,3,1
17620,2,2,61728,61729,61731,1,3,0
17621,5,3,61733,61733,61736,0,3,2
17622,5,2,61738,61738,61740,0,2,2
17623,1,2,61739,61740,61742,1,3,0
17624,1,2,61740,61742,61744,2,4,0
17625,2,1,61742,61744,61745,2,3,0
17626,5,1,61747,61747,61748,0,1,2
17627,5,2,61752,61752,61754,0,2,4
17628,5,3,61757,61757,61760,0,3,3
17629,4,1,61761,61761,61762,0,1,1
17630,2,1,61763,61763,61764,0,1,1
17631,6,2,61769,61769,61771,0,2,5
17632,4,3,61773,61773,61776,0,3,2
17633,1,3,61774,61776,61779,2,5,0
17634,4,1,61778,61779,61780,1,2,0
17635,4,3,61782,61782,61785,0,3,2
17636,2,2,61784,61785,61787,1,3,0
17637,6,2,61790,61790,61792,0,2,3
17638,4,2,61794,61794,61796,0,2,2
17639,1,1,61795,61796,61797,1,2,0
17640,3,2,61798,61798,61800,0,2,1
17641,1,1,61799,61800,61801,1,2,0
17642,5,1,61804,61804,61805,0,1,3
17643,5,2,61809,61809,61811,0,2,4
17644,4,2,61813,61813,61815,0,2,2
17645,4,1,61817,61817,61818,0,1,2
17646,2,1,61819,61819,61820,0,1,1
17647,6,3,61825,61825,61828,0,3,5
17648,6,2,61831,61831,61833,0,2,3
17649,6,1,61837,61837,61838,0,1,4
17650,4,3,61841,61841,61844,0,3,3
17651,5,3,61846,61846,61849,0,3,2
17652,3,2,61849,61849,61851,0,2,0
17653,4,3,61853,61853,61856,0,3,2
17654,2,1,61855,61856,61857,1,2,0
17655,6,2,61861,61861,61863,0,2,4
17656,4,2,61865,61865,61867,0,2,2
17657,3,3,61868,61868,61871,0,3,1
17658,6,2,61874,61874,61876,0,2,3
17659,3,3,61877,61877,61880,0,3,1
17660,1,2,61878,61880,61882,2,4,0
17661,3,2,61881,61882,61884,1,3,0
17662,3,1,61884,61884,61885,0,1,0
17663,4,1,61888,61888,61889,0,1,3
17664,1,3,61889,61889,61892,0,3,0
17665,2,1,61891,61892,61893,1,2,0
17666,6,2,61897,61897,61899,0,2,4
17667,4,3,61901,61901,61904,0,3,2
17668,5,1,61906,61906,61907,0,1,2
17669,5,3,61911,61911,61914,0,3,4
17670,3,1,61914,61914,61915,0,1,0
17671,3,2,61917,61917,61919,0,2,2
17672,2,1,61919,61919,61920,0,1,0
17673,6,3,61925,61925,61928,0,3,5
17674,2,2,61927,61928,61930,1,3,0
17675,2,2,61929,61930,61932,1,3,0
17676,2,1,61931,61932,61933,1,2,0
17677,3,1,61934,61934,61935,0,1,1
17678,3,2,61937,61937,61939,0,2,2
17679,5,3,61942,61942,61945,0,3,3
17680,6,3,61948,61948,61951,0,3,3
17681,6,1,61954,61954,61955,0,1,3
17682,6,2,61960,61960,61962,0,2,5
17683,3,1,61963,61963,61964,0,1,1
17684,3,3,61966,61966,61969,0,3,2
17685,3,1,61969,61969,61970,0,1,0
17686,6,3,61975,61975,61978,0,3,5
17687,1,3,61976,61978,61981,2,5,0
17688,1,3,61977,61981,61984,4,7,0
17689,3,2,61980,61984,61986,4,6,0
17690,4,1,61984,61986,61987,2,3,0
17691,1,1,61985,61987,61988,2,3,0
17692,1,3,61986,61988,61991,2,5,0
17693,3,3,61989,61991,61994,2,5,0
17694,3,2,61992,61994,61996,2,4,0
17695,4,2,61996,61996,61998,0,2,0
17696,1,2,61997,61998,62000,1,3,0
17697,4,2,62001,62001,62003,0,2,1
17698,3,2,62004,62004,62006,0,2,1
17699,5,1,62009,62009,62010,0,1,3
17700,6,2,62015,62015,62017,0,2,5
17701,4,1,62019,62019,62020,0,1,2
17702,6,1,62025,62025,62026,0,1,5
17703,6,1,62031,62031,62032,0,1,5
17704,5,2,62036,62036,62038,0,2,4
17705,3,1,62039,62039,62040,0,1,1
17706,2,1,62041,62041,62042,0,1,1
17707,4,3,62045,62045,62048,0,3,3
17708,4,2,62049,62049,62051,0,2,1
17709,2,2,62051,62051,62053,0,2,0
17710,6,3,62057,62057,62060,0,3,4
17711,3,2,62060,62060,62062,0,2,0
17712,5,2,62065,62065,62067,0,2,3
17713,5,1,62070,62070,62071,0,1,3
17714,5,2,62075,62075,62077,0,2,4
17715,1,3,62076,62077,62080,1,4,0
17716,6,3,62082,62082,62085,0,3,2
17717,6,3,62088,62088,62091,0,3,3
17718,3,1,62091,62091,62092,0,1,0
17719,5,3,62096,62096,62099,0,3,4
17720,3,1,62099,62099,62100,0,1,0
17721,6,2,62105,62105,62107,0,2,5
17722,4,1,62109,62109,62110,0,1,2
17723,2,1,62111,62111,62112,0,1,1
17724,2,1,62113,62113,62114,0,1,1
17725,3,3,62116,62116,62119,0,3,2
17726,1,2,62117,62119,62121,2,4,0
17727,6,3,62123,62123,62126,0,3,2
17728,2,2,62125,62126,62128,1,3,0
17729,5,2,62130,62130,62132,0,2,2
17730,6,2,62136,62136,62138,0,2,4
17731,4,1,62140,62140,62141,0,1,2
17732,5,3,62145,62145,62148,0,3,4
17733,4,2,62149,62149,62151,0,2,1
17734,6,3,62155,62155,62158,0,3,4
17735,3,2,62158,62158,62160,0,2,0
17736,3,2,62161,62161,62163,0,2,1
17737,5,2,62166,62166,62168,0,2,3
17738,1,1,62167,62168,62169,1,2,0
17739,3,2,62170,62170,62172,0,2,1
17740,6,3,62176,62176,62179,0,3,4
17741,4,1,62180,62180,62181,0,1,1
17742,3,3,62183,62183,62186,0,3,2
17743,4,1,62187,62187,62188,0,1,1
17744,3,1,62190,62190,62191,0,1,2
17745,4,2,62194,62194,62196,0,2,3
17746,2,3,62196,62196,62199,0,3,0
17747,2,2,62198,62199,62201,1,3,0
17748,6,1,62204,62204,62205,0,1,3
17749,6,1,62210,62210,62211,0,1,5
17750,2,1,62212,62212,62213,0,1,1
17751,1,1,62213,62213,62214,0,1,0
17752,5,3,62218,62218,62221,0,3,4
17753,6,1,62224,62224,62225,0,1,3
17754,3,3,62227,62227,62230,0,3,2
17755,1,1,62228,62230,62231,2,3,0
17756,4,1,62232,62232,62233,0,1,1
17757,6,2,62238,62238,62240,0,2,5
17758,6,3,62244,62244,62247,0,3,4
17759,2,1,62246,62247,62248,1,2,0
17760,2,2,62248,62248,62250,0,2,0
17761,3,1,62251,62251,62252,0,1,1
17762,6,3,62257,62257,62260,0,3,5
17763,2,2,62259,62260,62262,1,3,0
17764,3,1,62262,62262,62263,0,1,0
17765,6,3,62268,62268,62271,0,3,5
17766,2,2,62270,62271,62273,1,3,0
17767,3,3,62273,62273,62276,0,3,0
17768,6,2,62279,62279,62281,0,2,3
17769,6,1,62285,62285,62286,0,1,4
17770,2,2,62287,62287,62289,0,2,1
17771,1,2,62288,62289,62291,1,3,0
17772,6,2,62294,62294,62296,0,2,3
17773,5,2,62299,62299,62301,0,2,3
17774,6,1,62305,62305,62306,0,1,4
17775,5,1,62310,62310,62311,0,1,4
17776,4,2,62314,62314,62316,0,2,3
17777,3,1,62317,62317,62318,0,1,1
17778,6,2,62323,62323,62325,0,2,5
17779,2,3,62325,62325,62328,0,3,0
17780,5,2,62330,62330,62332,0,2,2
17781,3,1,62333,62333,62334,0,1,1
17782,6,1,62339,62339,62340,0,1,5
17783,5,3,62344,62344,62347,0,3,4
17784,3,3,62347,62347,62350,0,3,0
17785,5,2,62352,62352,62354,0,2,2
17786,4,2,62356,62356,62358,0,2,2
17787,4,1,62360,62360,62361,0,1,2
17788,5,2,62365,62365,62367,0,2,4
17789,1,2,62366,62367,62369,1,3,0
17790,3,1,62369,62369,62370,0,1,0
17791,5,2,62374,62374,62376,0,2,4
17792,1,1,62375,62376,62377,1,2,0
17793,5,1,62380,62380,62381,0,1,3
17794,2,3,62382,62382,62385,0,3,1
17795,4,2,62386,62386,62388,0,2,1
17796,3,2,62389,62389,62391,0,2,1
17797,5,3,62394,62394,62397,0,3,3
17798,3,3,62397,62397,62400,0,3,0
17799,1,2,62398,62400,62402,2,4,0
17800,6,2,62404,62404,62406,0,2,2
17801,6,1,62410,62410,62411,0,1,4
17802,3,1,62413,62413,62414,0,1,2
17803,1,2,62414,62414,62416,0,2,0
17804,3,2,62417,62417,62419,0,2,1
17805,3,2,62420,62420,62422,0,2,1
17806,6,3,62426,62426,62429,0,3,4
17807,3,3,62429,62429,62432,0,3,0
17808,1,2,62430,62432,62434,2,4,0
17809,4,1,62434,62434,62435,0,1,0
17810,5,3,62439,62439,62442,0,3,4
17811,1,1,62440,62442,62443,2,3,0
17812,1,2,62441,62443,62445,2,4,0
17813,5,3,62446,62446,62449,0,3,1
17814,1,1,62447,62449,62450,2,3,0
17815,3,3,62450,62450,62453,0,3,0
17816,2,3,62452,62453,62456,1,4,0
17817,5,2,62457,62457,62459,0,2,1
17818,1,3,62458,62459,62462,1,4,0
17819,4,3,62462,62462,62465,0,3,0
17820,3,3,62465,62465,62468,0,3,0
17821,1,3,62466,62468,62471,2,5,0
17822,1,3,62467,62471,62474,4,7,0
17823,3,2,62470,62474,62476,4,6,0
17824,1,1,62471,62476,62477,5,6,0
17825,1,2,62472,62477,62479,5,7,0
17826,3,2,62475,62479,62481,4,6,0
17827,6,2,62481,62481,62483,0,2,0
17828,5,1,62486,62486,62487,0,1,3
17829,5,1,62491,62491,62492,0,1,4
17830,1,1,62492,62492,62493,0,1,0
17831,5,3,62497,62497,62500,0,3,4
17832,1,3,62498,62500,62503,2,5,0
17833,6,2,62504,62504,62506,0,2,1
17834,2,1,62506,62506,62507,0,1,0
17835,1,2,62507,62507,62509,0,2,0
17836,4,2,62511,62511,62513,0,2,2
17837,1,3,62512,62513,62516,1,4,0
17838,6,1,62518,62518,62519,0,1,2
17839,4,1,62522,62522,62523,0,1,3
17840,1,2,62523,62523,62525,0,2,0
17841,4,3,62527,62527,62530,0,3,2
17842,3,2,62530,62530,62532,0,2,0
17843,2,3,62532,62532,62535,0,3,0
17844,4,2,62536,62536,62538,0,2,1
17845,4,2,62540,62540,62542,0,2,2
17846,6,1,62546,62546,62547,0,1,4
17847,5,3,62551,62551,62554,0,3,4
17848,3,1,62554,62554,62555,0,1,0
17849,6,1,62560,62560,62561,0,1,5
17850,5,3,62565,62565,62568,0,3,4
17851,1,1,62566,62568,62569,2,3,0
17852,1,3,62567,62569,62572,2,5,0
17853,2,2,62569,62572,62574,3,5,0
17854,1,2,62570,62574,62576,4,6,0
17855,6,3,62576,62576,62579,0,3,0
17856,1,3,62577,62579,62582,2,5,0
17857,6,3,62583,62583,62586,0,3,1
17858,2,3,62585,62586,62589,1,4,0
17859,5,1,62590,62590,62591,0,1,1
17860,2,3,62592,62592,62595,0,3,1
17861,1,1,62593,62595,62596,2,3,0
17862,2,2,62595,62596,62598,1,3,0
17863,1,2,62596,62598,62600,2,4,0
17864,5,3,62601,62601,62604,0,3,1
17865,3,1,62604,62604,62605,0,1,0
17866,1,1,62605,62605,62606,0,1,0
17867,3,3,62608,62608,62611,0,3,2
17868,4,2,62612,62612,62614,0,2,1
17869,6,3,62618,62618,62621,0,3,4
17870,4,2,62622,62622,62624,0,2,1
17871,1,3,62623,62624,62627,1,4,0
17872,3,3,62626,62627,62630,1,4,0
17873,1,3,62627,62630,62633,3,6,0
17874,5,2,62632,62633,62635,1,3,0
17875,6,3,62638,62638,62641,0,3,3
17876,5,1,62643,62643,62644,0,1,2
17877,1,2,62644,62644,62646,0,2,0
17878,6,2,62650,62650,62652,0,2,4
17879,6,2,62656,62656,62658,0,2,4
17880,4,1,62660,62660,62661,0,1,2
17881,4,2,62664,62664,62666,0,2,3
17882,1,1,62665,62666,62667,1,2,0
17883,1,3,62666,62667,62670,1,4,0
17884,2,1,62668,62670,62671,2,3,0
17885,1,3,62669,62671,62674,2,5,0
17886,1,2,62670,62674,62676,4,6,0
17887,1,1,62671,62676,62677,5,6,0
17888,3,3,62674,62677,62680,3,6,0
17889,5,3,62679,62680,62683,1,4,0
17890,5,2,62684,62684,62686,0,2,1
17891,6,1,62690,62690,62691,0,1,4
17892,3,2,62693,62693,62695,0,2,2
17893,6,2,62699,62699,62701,0,2,4
17894,1,2,62700,62701,62703,1,3,0
17895,2,2,62702,62703,62705,1,3,0
17896,3,1,62705,62705,62706,0,1,0
17897,2,2,62707,62707,62709,0,2,1
17898,6,2,62713,62713,62715,0,2,4
17899,4,3,62717,62717,62720,0,3,2
17900,6,2,62723,62723,62725,0,2,3
17901,4,1,62727,62727,62728,0,1,2
17902,4,2,62731,62731,62733,0,2,3
17903,6,3,62737,62737,62740,0,3,4
17904,6,3,62743,62743,62746,0,3,3
17905,6,1,62749,62749,62750,0,1,3
17906,2,3,62751,62751,62754,0,3,1
17907,2,3,62753,62754,62757,1,4,0
17908,3,3,62756,62757,62760,1,4,0
17909,4,1,62760,62760,62761,0,1,0
17910,1,2,62761,62761,62763,0,2,0
17911,4,3,62765,62765,62768,0,3,2
17912,1,2,62766,62768,62770,2,4,0
17913,1,2,62767,62770,62772,3,5,0
17914,5,1,62772,62772,62773,0,1,0
17915,4,2,62776,62776,62778,0,2,3
17916,3,3,62779,62779,62782,0,3,1
17917,3,3,62782,62782,62785,0,3,0
17918,6,2,62788,62788,62790,0,2,3
17919,4,1,62792,62792,62793,0,1,2
17920,6,3,62798,62798,62801,0,3,5
17921,2,3,62800,62801,62804,1,4,0
17922,1,1,62801,62804,62805,3,4,0
17923,1,3,62802,62805,62808,3,6,0
17924,2,2,62804,62808,62810,4,6,0
17925,1,1,62805,62810,62811,5,6,0
17926,6,3,62811,62811,62814,0,3,0
17927,2,3,62813,62814,62817,1,4,0
17928,3,3,62816,62817,62820,1,4,0
17929,5,2,62821,62821,62823,0,2,1
17930,4,3,62825,62825,62828,0,3,2
17931,4,3,62829,62829,62832,0,3,1
17932,2,1,62831,62832,62833,1,2,0
17933,6,3,62837,62837,62840,0,3,4
17934,1,2,62838,62840,62842,2,4,0
17935,3,1,62841,62842,62843,1,2,0
17936,5,2,62846,62846,62848,0,2,3
17937,4,2,62850,62850,62852,0,2,2
17938,1,1,62851,62852,62853,1,2,0
17939,6,2,62857,62857,62859,0,2,4
17940,2,2,62859,62859,62861,0,2,0
17941,5,2,62864,62864,62866,0,2,3
17942,5,1,62869,62869,62870,0,1,3
17943,2,1,62871,62871,62872,0,1,1
17944,3,2,62874,62874,62876,0,2,2
17945,2,2,62876,62876,62878,0,2,0
17946,1,2,62877,62878,62880,1,3,0
17947,3,1,62880,62880,62881,0,1,0
17948,1,2,62881,62881,62883,0,2,0
17949,4,3,62885,62885,62888,0,3,2
17950,3,3,62888,62888,62891,0,3,0
17951,5,3,62893,62893,62896,0,3,2
17952,2,1,62895,62896,62897,1,2,0
17953,6,1,62901,62901,62902,0,1,4
17954,3,3,62904,62904,62907,0,3,2
17955,4,2,62908,62908,62910,0,2,1
17956,4,3,62912,62912,62915,0,3,2
17957,1,3,62913,62915,62918,2,5,0
17958,2,3,62915,62918,62921,3,6,0
17959,2,3,62917,62921,62924,4,7,0
17960,4,3,62921,62924,62927,3,6,0
17961,6,3,62927,62927,62930,0,3,0
17962,3,2,62930,62930,62932,0,2,0
17963,4,1,62934,62934,62935,0,1,2
17964,1,1,62935,62935,62936,0,1,0
17965,5,3,62940,62940,62943,0,3,4
17966,4,3,62944,62944,62947,0,3,1
17967,1,1,62945,62947,62948,2,3,0
17968,2,1,62947,62948,62949,1,2,0
17969,4,3,62951,62951,62954,0,3,2
17970,3,2,62954,62954,62956,0,2,0
17971,1,3,62955,62956,62959,1,4,0
17972,5,1,62960,62960,62961,0,1,1
17973,3,1,62963,62963,62964,0,1,2
17974,4,2,62967,62967,62969,0,2,3
17975,5,2,62972,62972,62974,0,2,3
17976,5,3,62977,62977,62980,0,3,3
17977,4,2,62981,62981,62983,0,2,1
17978,3,2,62984,62984,62986,0,2,1
17979,5,3,62989,62989,62992,0,3,3
17980,2,3,62991,62992,62995,1,4,0
17981,2,2,62993,62995,62997,2,4,0
17982,6,1,62999,62999,63000,0,1,2
17983,3,3,63002,63002,63005,0,3,2
17984,6,1,63008,63008,63009,0,1,3
17985,5,3,63013,63013,63016,0,3,4
17986,3,2,63016,63016,63018,0,2,0
17987,4,1,63020,63020,63021,0,1,2
17988,6,1,63026,63026,63027,0,1,5
17989,6,2,63032,63032,63034,0,2,5
17990,1,1,63033,63034,63035,1,2,0
17991,5,3,63038,63038,63041,0,3,3
17992,5,1,63043,63043,63044,0,1,2
17993,5,3,63048,63048,63051,0,3,4
17994,4,1,63052,63052,63053,0,1,1
17995,5,3,63057,63057,63060,0,3,4
17996,4,3,63061,63061,63064,0,3,1
17997,4,2,63065,63065,63067,0,2,1
17998,6,3,63071,63071,63074,0,3,4
17999,1,1,63072,63074,63075,2,3,0
18000,4,3,63076,63076,63079,0,3,1
18001,3,2,63079,63079,63081,0,2,0
18002,4,2,63083,63083,63085,0,2,2
18003,1,1,63084,63085,63086,1,2,0
18004,5,3,63089,63089,63092,0,3,3
18005,4,1,63093,63093,63094,0,1,1
18006,3,2,63096,63096,63098,0,2,2
18007,2,2,63098,63098,63100,0,2,0
18008,5,3,63103,63103,63106,0,3,3
18009,4,3,63107,63107,63110,0,3,1
18010,3,3,63110,63110,63113,0,3,0
18011,1,3,63111,63113,63116,2,5,0
18012,5,2,63116,63116,63118,0,2,0
18013,2,3,63118,63118,63121,0,3,0
18014,6,3,63124,63124,63127,0,3,3
18015,3,2,63127,63127,63129,0,2,0
18016,4,1,63131,63131,63132,0,1,2
18017,1,2,63132,63132,63134,0,2,0
18018,2,3,63134,63134,63137,0,3,0
18019,6,3,63140,63140,63143,0,3,3
18020,2,3,63142,63143,63146,1,4,0
18021,4,3,63146,63146,63149,0,3,0
18022,2,1,63148,63149,63150,1,2,0
18023,4,2,63152,63152,63154,0,2,2
18024,3,2,63155,63155,63157,0,2,1
18025,1,2,63156,63157,63159,1,3,0
18026,1,1,63157,63159,63160,2,3,0
18027,5,3,63162,63162,63165,0,3,2
18028,5,2,63167,63167,63169,0,2,2
18029,6,2,63173,63173,63175,0,2,4
18030,4,3,63177,63177,63180,0,3,2
18031,1,1,63178,63180,63181,2,3,0
18032,1,3,63179,63181,63184,2,5,0
18033,3,1,63182,63184,63185,2,3,0
18034,3,2,63185,63185,63187,0,2,0
18035,2,2,63187,63187,63189,0,2,0
18036,5,3,63192,63192,63195,0,3,3
18037,4,1,63196,63196,63197,0,1,1
18038,1,1,63197,63197,63198,0,1,0
18039,3,2,63200,63200,63202,0,2,2
18040,6,1,63206,63206,63207,0,1,4
18041,6,2,63212,63212,63214,0,2,5
18042,5,3,63217,63217,63220,0,3,3
18043,6,3,63223,63223,63226,0,3,3
18044,1,1,63224,63226,63227,2,3,0
18045,5,1,63229,63229,63230,0,1,2
18046,2,1,63231,63231,63232,0,1,1
18047,6,2,63237,63237,63239,0,2,5
18048,2,3,63239,63239,63242,0,3,0
18049,6,1,63245,63245,63246,0,1,3
18050,6,3,63251,63251,63254,0,3,5
18051,4,3,63255,63255,63258,0,3,1
18052,5,1,63260,63260,63261,0,1,2
18053,4,1,63264,63264,63265,0,1,3
18054,3,2,63267,63267,63269,0,2,2
18055,4,3,63271,63271,63274,0,3,2
18056,2,2,63273,63274,63276,1,3,0
18057,6,2,63279,63279,63281,0,2,3
18058,5,3,63284,63284,63287,0,3,3
18059,5,1,63289,63289,63290,0,1,2
18060,3,1,63292,63292,63293,0,1,2
18061,1,2,63293,63293,63295,0,2,0
18062,6,1,63299,63299,63300,0,1,4
18063,1,3,63300,63300,63303,0,3,0
18064,2,3,63302,63303,63306,1,4,0
18065,5,1,63307,63307,63308,0,1,1
18066,4,1,63311,63311,63312,0,1,3
18067,4,1,63315,63315,63316,0,1,3
18068,1,1,63316,63316,63317,0,1,0
18069,6,2,63322,63322,63324,0,2,5
18070,5,1,63327,63327,63328,0,1,3
18071,3,3,63330,63330,63333,0,3,2
18072,2,2,63332,63333,63335,1,3,0
18073,4,1,63336,63336,63337,0,1,1
18074,5,2,63341,63341,63343,0,2,4
18075,6,3,63347,63347,63350,0,3,4
18076,1,3,63348,63350,63353,2,5,0
18077,5,2,63353,63353,63355,0,2,0
18078,5,3,63358,63358,63361,0,3,3
18079,6,2,63364,63364,63366,0,2,3
18080,6,2,63370,63370,63372,0,2,4
18081,2,3,63372,63372,63375,0,3,0
18082,5,1,63377,63377,63378,0,1,2
18083,2,3,63379,63379,63382,0,3,1
18084,4,2,63383,63383,63385,0,2,1
18085,6,2,63389,63389,63391,0,2,4
18086,4,2,63393,63393,63395,0,2,2
18087,4,3,63397,63397,63400,0,3,2
18088,1,1,63398,63400,63401,2,3,0
18089,1,1,63399,63401,63402,2,3,0
18090,1,3,63400,63402,63405,2,5,0
18091,5,3,63405,63405,63408,0,3,0
18092,6,1,63411,63411,63412,0,1,3
18093,4,3,63415,63415,63418,0,3,3
18094,5,1,63420,63420,63421,0,1,2
18095,4,1,63424,63424,63425,0,1,3
18096,3,3,63427,63427,63430,0,3,2
18097,1,1,63428,63430,63431,2,3,0
18098,3,2,63431,63431,63433,0,2,0
18099,4,1,63435,63435,63436,0,1,2
18100,6,1,63441,63441,63442,0,1,5
18101,4,1,63445,63445,63446,0,1,3
18102,5,2,63450,63450,63452,0,2,4
18103,2,3,63452,63452,63455,0,3,0
18104,4,2,63456,63456,63458,0,2,1
18105,6,3,63462,63462,63465,0,3,4
18106,6,2,63468,63468,63470,0,2,3
18107,4,3,63472,63472,63475,0,3,2
18108,3,3,63475,63475,63478,0,3,0
18109,6,3,63481,63481,63484,0,3,3
18110,3,2,63484,63484,63486,0,2,0
18111,2,3,63486,63486,63489,0,3,0
18112,5,1,63491,63491,63492,0,1,2
18113,1,3,63492,63492,63495,0,3,0
18114,2,1,63494,63495,63496,1,2,0
18115,6,2,63500,63500,63502,0,2,4
18116,3,1,63503,63503,63504,0,1,1
18117,1,1,63504,63504,63505,0,1,0
18118,1,1,63505,63505,63506,0,1,0
18119,3,3,63508,63508,63511,0,3,2
18120,3,3,63511,63511,63514,0,3,0
18121,1,2,63512,63514,63516,2,4,0
18122,4,2,63516,63516,63518,0,2,0
18123,4,2,63520,63520,63522,0,2,2
18124,3,3,63523,63523,63526,0,3,1
18125,1,2,63524,63526,63528,2,4,0
18126,3,1,63527,63528,63529,1,2,0
18127,5,2,63532,63532,63534,0,2,3
18128,5,2,63537,63537,63539,0,2,3
18129,3,2,63540,63540,63542,0,2,1
18130,2,3,63542,63542,63545,0,3,0
18131,3,3,63545,63545,63548,0,3,0
18132,6,2,63551,63551,63553,0,2,3
18133,5,3,63556,63556,63559,0,3,3
18134,1,2,63557,63559,63561,2,4,0
18135,2,3,63559,63561,63564,2,5,0
18136,4,1,63563,63564,63565,1,2,0
18137,6,1,63569,63569,63570,0,1,4
18138,4,2,63573,63573,63575,0,2,3
18139,1,1,63574,63575,63576,1,2,0
18140,2,1,63576,63576,63577,0,1,0
18141,6,1,63582,63582,63583,0,1,5
18142,6,2,63588,63588,63590,0,2,5
18143,1,1,63589,63590,63591,1,2,0
18144,1,3,63590,63591,63594,1,4,0
18145,4,2,63594,63594,63596,0,2,0
18146,1,1,63595,63596,63597,1,2,0
18147,2,2,63597,63597,63599,0,2,0
18148,3,1,63600,63600,63601,0,1,1
18149,1,1,63601,63601,63602,0,1,0
18150,2,3,63603,63603,63606,0,3,1
18151,3,2,63606,63606,63608,0,2,0
18152,1,2,63607,63608,63610,1,3,0
18153,2,3,63609,63610,63613,1,4,0
18154,6,3,63615,63615,63618,0,3,2
18155,3,3,63618,63618,63621,0,3,0
18156,6,3,63624,63624,63627,0,3,3
18157,6,1,63630,63630,63631,0,1,3
18158,1,1,63631,63631,63632,0,1,0
18159,5,3,63636,63636,63639,0,3,4
18160,6,3,63642,63642,63645,0,3,3
18161,6,3,63648,63648,63651,0,3,3
18162,1,2,63649,63651,63653,2,4,0
18163,3,3,63652,63653,63656,1,4,0
18164,3,1,63655,63656,63657,1,2,0
18165,4,3,63659,63659,63662,0,3,2
18166,6,3,63665,63665,63668,0,3,3
18167,6,1,63671,63671,63672,0,1,3
18168,5,3,63676,63676,63679,0,3,4
18169,5,3,63681,63681,63684,0,3,2
18170,6,3,63687,63687,63690,0,3,3
18171,1,2,63688,63690,63692,2,4,0
18172,5,3,63693,63693,63696,0,3,1
18173,3,2,63696,63696,63698,0,2,0
18174,1,3,63697,63698,63701,1,4,0
18175,6,1,63703,63703,63704,0,1,2
18176,6,2,63709,63709,63711,0,2,5
18177,4,2,63713,63713,63715,0,2,2
18178,5,2,63718,63718,63720,0,2,3
18179,6,1,63724,63724,63725,0,1,4
18180,5,3,63729,63729,63732,0,3,4
18181,3,1,63732,63732,63733,0,1,0
18182,1,1,63733,63733,63734,0,1,0
18183,5,1,63738,63738,63739,0,1,4
18184,1,3,63739,63739,63742,0,3,0
18185,2,1,63741,63742,63743,1,2,0
18186,2,3,63743,63743,63746,0,3,0
18187,6,1,63749,63749,63750,0,1,3
18188,1,2,63750,63750,63752,0,2,0
18189,1,2,63751,63752,63754,1,3,0
18190,6,3,63757,63757,63760,0,3,3
18191,6,1,63763,63763,63764,0,1,3
18192,4,1,63767,63767,63768,0,1,3
18193,6,1,63773,63773,63774,0,1,5
18194,6,1,63779,63779,63780,0,1,5
18195,6,3,63785,63785,63788,0,3,5
18196,1,2,63786,63788,63790,2,4,0
18197,5,3,63791,63791,63794,0,3,1
18198,5,2,63796,63796,63798,0,2,2
18199,2,3,63798,63798,63801,0,3,0
18200,1,2,63799,63801,63803,2,4,0
18201,1,2,63800,63803,63805,3,5,0
18202,4,1,63804,63805,63806,1,2,0
18203,6,3,63810,63810,63813,0,3,4
18204,6,1,63816,63816,63817,0,1,3
18205,3,3,63819,63819,63822,0,3,2
18206,2,2,63821,63822,63824,1,3,0
18207,5,3,63826,63826,63829,0,3,2
18208,2,2,63828,63829,63831,1,3,0
18209,6,2,63834,63834,63836,0,2,3
18210,3,2,63837,63837,63839,0,2,1
18211,3,3,63840,63840,63843,0,3,1
18212,6,2,63846,63846,63848,0,2,3
18213,6,3,63852,63852,63855,0,3,4
18214,6,2,63858,63858,63860,0,2,3
18215,6,2,63864,63864,63866,0,2,4
18216,5,2,63869,63869,63871,0,2,3
18217,1,2,63870,63871,63873,1,3,0
18218,3,1,63873,63873,63874,0,1,0
18219,2,1,63875,63875,63876,0,1,1
18220,6,3,63881,63881,63884,0,3,5
18221,4,1,63885,63885,63886,0,1,1
18222,1,2,63886,63886,63888,0,2,0
18223,2,3,63888,63888,63891,0,3,0
18224,6,3,63894,63894,63897,0,3,3
18225,4,1,63898,63898,63899,0,1,1
18226,4,2,63902,63902,63904,0,2,3
18227,4,2,63906,63906,63908,0,2,2
18228,3,2,63909,63909,63911,0,2,1
18229,2,1,63911,63911,63912,0,1,0
18230,1,3,63912,63912,63915,0,3,0
18231,4,2,63916,63916,63918,0,2,1
18232,2,1,63918,63918,63919,0,1,0
18233,4,1,63922,63922,63923,0,1,3
18234,4,3,63926,63926,63929,0,3,3
18235,2,3,63928,63929,63932,1,4,0
18236,3,3,63931,63932,63935,1,4,0
18237,5,2,63936,63936,63938,0,2,1
18238,2,1,63938,63938,63939,0,1,0
18239,4,2,63942,63942,63944,0,2,3
18240,5,2,63947,63947,63949,0,2,3
18241,5,3,63952,63952,63955,0,3,3
18242,3,2,63955,63955,63957,0,2,0
18243,5,3,63960,63960,63963,0,3,3
18244,3,2,63963,63963,63965,0,2,0
18245,5,2,63968,63968,63970,0,2,3
18246,5,2,63973,63973,63975,0,2,3
18247,2,3,63975,63975,63978,0,3,0
18248,2,3,63977,63978,63981,1,4,0
18249,4,2,63981,63981,63983,0,2,0
18250,1,3,63982,63983,63986,1,4,0
18251,1,1,63983,63986,63987,3,4,0
18252,6,3,63989,63989,63992,0,3,2
18253,5,1,63994,63994,63995,0,1,2
18254,1,2,63995,63995,63997,0,2,0
18255,5,3,64000,64000,64003,0,3,3
18256,4,1,64004,64004,64005,0,1,1
18257,1,3,64005,64005,64008,0,3,0
18258,2,3,64007,64008,64011,1,4,0
18259,3,1,64010,64011,64012,1,2,0
18260,6,2,64016,64016,64018,0,2,4
18261,2,2,64018,64018,64020,0,2,0
18262,5,3,64023,64023,64026,0,3,3
18263,4,2,64027,64027,64029,0,2,1
18264,5,1,64032,64032,64033,0,1,3
18265,4,1,64036,64036,64037,0,1,3
18266,3,3,64039,64039,64042,0,3,2
18267,6,3,64045,64045,64048,0,3,3
18268,5,1,64050,64050,64051,0,1,2
18269,6,1,64056,64056,64057,0,1,5
18270,3,2,64059,64059,64061,0,2,2
18271,2,2,64061,64061,64063,0,2,0
18272,6,2,64067,64067,64069,0,2,4
18273,3,2,64070,64070,64072,0,2,1
18274,2,2,64072,64072,64074,0,2,0
18275,5,2,64077,64077,64079,0,2,3
18276,1,1,64078,64079,64080,1,2,0
18277,6,1,64084,64084,64085,0,1,4
18278,3,2,64087,64087,64089,0,2,2
18279,4,1,64091,64091,64092,0,1,2
18280,5,3,64096,64096,64099,0,3,4
18281,1,1,64097,64099,64100,2,3,0
18282,4,1,64101,64101,64102,0,1,1
18283,2,2,64103,64103,64105,0,2,1
18284,3,1,64106,64106,64107,0,1,1
18285,1,2,64107,64107,64109,0,2,0
18286,6,1,64113,64113,64114,0,1,4
18287,4,2,64117,64117,64119,0,2,3
18288,5,2,64122,64122,64124,0,2,3
18289,1,2,64123,64124,64126,1,3,0
18290,4,2,64127,64127,64129,0,2,1
18291,6,1,64133,64133,64134,0,1,4
18292,2,1,64135,64135,64136,0,1,1
18293,4,1,64139,64139,64140,0,1,3
18294,3,2,64142,64142,64144,0,2,2
18295,2,1,64144,64144,64145,0,1,0
18296,5,2,64149,64149,64151,0,2,4
18297,6,2,64155,64155,64157,0,2,4
18298,6,1,64161,64161,64162,0,1,4
18299,4,1,64165,64165,64166,0,1,3
18300,2,1,64167,64167,64168,0,1,1
18301,1,2,64168,64168,64170,0,2,0
18302,6,2,64174,64174,64176,0,2,4
18303,6,2,64180,64180,64182,0,2,4
18304,1,1,64181,64182,64183,1,2,0
18305,1,2,64182,64183,64185,1,3,0
18306,6,2,64188,64188,64190,0,2,3
18307,2,1,64190,64190,64191,0,1,0
18308,6,3,64196,64196,64199,0,3,5
18309,5,3,64201,64201,64204,0,3,2
18310,6,2,64207,64207,64209,0,2,3
18311,3,2,64210,64210,64212,0,2,1
18312,6,1,64216,64216,64217,0,1,4
18313,5,2,64221,64221,64223,0,2,4
18314,6,1,64227,64227,64228,0,1,4
18315,2,3,64229,64229,64232,0,3,1
18316,1,1,64230,64232,64233,2,3,0
18317,6,2,64236,64236,64238,0,2,3
18318,4,3,64240,64240,64243,0,3,2
18319,6,2,64246,64246,64248,0,2,3
18320,4,3,64250,64250,64253,0,3,2
18321,5,1,64255,64255,64256,0,1,2
18322,1,2,64256,64256,64258,0,2,0
18323,5,3,64261,64261,64264,0,3,3
18324,1,2,64262,64264,64266,2,4,0
18325,2,3,64264,64266,64269,2,5,0
18326,3,3,64267,64269,64272,2,5,0
18327,6,3,64273,64273,64276,0,3,1
18328,2,2,64275,64276,64278,1,3,0
18329,3,3,64278,64278,64281,0,3,0
18330,5,2,64283,64283,64285,0,2,2
18331,1,3,64284,64285,64288,1,4,0
18332,4,3,64288,64288,64291,0,3,0
18333,1,1,64289,64291,64292,2,3,0
18334,2,2,64291,64292,64294,1,3,0
18335,2,2,64293,64294,64296,1,3,0
18336,4,1,64297,64297,64298,0,1,1
18337,1,1,64298,64298,64299,0,1,0
18338,2,2,64300,64300,64302,0,2,1
18339,4,1,64304,64304,64305,0,1,2
18340,1,2,64305,64305,64307,0,2,0
18341,2,3,64307,64307,64310,0,3,0
18342,4,1,64311,64311,64312,0,1,1
18343,4,3,64315,64315,64318,0,3,3
18344,5,1,64320,64320,64321,0,1,2
18345,6,2,64326,64326,64328,0,2,5
18346,4,1,64330,64330,64331,0,1,2
18347,1,3,64331,64331,64334,0,3,0
18348,4,1,64335,64335,64336,0,1,1
18349,6,3,64341,64341,64344,0,3,5
18350,6,2,64347,64347,64349,0,2,3
18351,6,3,64353,64353,64356,0,3,4
18352,3,3,64356,64356,64359,0,3,0
18353,1,3,64357,64359,64362,2,5,0
18354,6,1,64363,64363,64364,0,1,1
18355,6,1,64369,64369,64370,0,1,5
18356,2,3,64371,64371,64374,0,3,1
18357,5,1,64376,64376,64377,0,1,2
18358,5,2,64381,64381,64383,0,2,4
18359,1,3,64382,64383,64386,1,4,0
18360,2,2,64384,64386,64388,2,4,0
18361,3,2,64387,64388,64390,1,3,0
18362,6,1,64393,64393,64394,0,1,3
18363,1,2,64394,64394,64396,0,2,0
18364,2,2,64396,64396,64398,0,2,0
18365,4,3,64400,64400,64403,0,3,2
18366,6,2,64406,64406,64408,0,2,3
18367,3,2,64409,64409,64411,0,2,1
18368,3,3,64412,64412,64415,0,3,1
18369,3,1,64415,64415,64416,0,1,0
18370,3,3,64418,64418,64421,0,3,2
18371,6,1,64424,64424,64425,0,1,3
18372,4,3,64428,64428,64431,0,3,3
18373,2,1,64430,64431,64432,1,2,0
18374,3,1,64433,64433,64434,0,1,1
18375,3,1,64436,64436,64437,0,1,2
18376,4,3,64440,64440,64443,0,3,3
18377,1,3,64441,64443,64446,2,5,0
18378,2,2,64443,64446,64448,3,5,0
18379,2,1,64445,64448,64449,3,4,0
18380,4,2,64449,64449,64451,0,2,0
18381,4,3,64453,64453,64456,0,3,2
18382,5,3,64458,64458,64461,0,3,2
18383,4,2,64462,64462,64464,0,2,1
18384,2,3,64464,64464,64467,0,3,0
18385,3,1,64467,64467,64468,0,1,0
18386,1,2,64468,64468,64470,0,2,0
18387,1,2,64469,64470,64472,1,3,0
18388,3,1,64472,64472,64473,0,1,0
18389,3,2,64475,64475,64477,0,2,2
18390,2,2,64477,64477,64479,0,2,0
18391,5,2,64482,64482,64484,0,2,3
18392,1,2,64483,64484,64486,1,3,0
18393,5,1,64488,64488,64489,0,1,2
18394,4,2,64492,64492,64494,0,2,3
18395,4,3,64496,64496,64499,0,3,2
18396,5,1,64501,64501,64502,0,1,2
18397,6,1,64507,64507,64508,0,1,5
18398,6,3,64513,64513,64516,0,3,5
18399,6,1,64519,64519,64520,0,1,3
18400,4,1,64523,64523,64524,0,1,3
18401,4,3,64527,64527,64530,0,3,3
18402,1,3,64528,64530,64533,2,5,0
18403,5,1,64533,64533,64534,0,1,0
18404,2,2,64535,64535,64537,0,2,1
18405,1,3,64536,64537,64540,1,4,0
18406,3,3,64539,64540,64543,1,4,0
18407,2,1,64541,64543,64544,2,3,0
18408,3,2,64544,64544,64546,0,2,0
18409,6,2,64550,64550,64552,0,2,4
18410,5,3,64555,64555,64558,0,3,3
18411,4,3,64559,64559,64562,0,3,1
18412,3,2,64562,64562,64564,0,2,0
18413,2,3,64564,64564,64567,0,3,0
18414,1,2,64565,64567,64569,2,4,0
18415,2,3,64567,64569,64572,2,5,0
18416,3,2,64570,64572,64574,2,4,0
18417,6,1,64576,64576,64577,0,1,2
18418,2,1,64578,64578,64579,0,1,1
18419,6,2,64584,64584,64586,0,2,5
18420,1,1,64585,64586,64587,1,2,0
18421,5,2,64590,64590,64592,0,2,3
18422,4,1,64594,64594,64595,0,1,2
18423,3,3,64597,64597,64600,0,3,2
18424,4,1,64601,64601,64602,0,1,1
18425,5,2,64606,64606,64608,0,2,4
18426,5,2,64611,64611,64613,0,2,3
18427,1,1,64612,64613,64614,1,2,0
18428,6,3,64618,64618,64621,0,3,4
18429,3,2,64621,64621,64623,0,2,0
18430,4,2,64625,64625,64627,0,2,2
18431,4,1,64629,64629,64630,0,1,2
18432,6,2,64635,64635,64637,0,2,5
18433,2,2,64637,64637,64639,0,2,0
18434,4,1,64641,64641,64642,0,1,2
18435,3,2,64644,64644,64646,0,2,2
18436,5,2,64649,64649,64651,0,2,3
18437,3,1,64652,64652,64653,0,1,1
18438,2,1,64654,64654,64655,0,1,1
18439,4,3,64658,64658,64661,0,3,3
18440,4,1,64662,64662,64663,0,1,1
18441,6,2,64668,64668,64670,0,2,5
18442,4,1,64672,64672,64673,0,1,2
18443,6,1,64678,64678,64679,0,1,5
18444,3,1,64681,64681,64682,0,1,2
18445,3,3,64684,64684,64687,0,3,2
18446,3,3,64687,64687,64690,0,3,0
18447,3,2,64690,64690,64692,0,2,0
18448,5,2,64695,64695,64697,0,2,3
18449,3,3,64698,64698,64701,0,3,1
18450,4,3,64702,64702,64705,0,3,1
18451,3,1,64705,64705,64706,0,1,0
18452,1,2,64706,64706,64708,0,2,0
18453,5,3,64711,64711,64714,0,3,3
18454,1,3,64712,64714,64717,2,5,0
18455,6,3,64718,64718,64721,0,3,1
18456,4,1,64722,64722,64723,0,1,1
18457,5,1,64727,64727,64728,0,1,4
18458,2,1,64729,64729,64730,0,1,1
18459,3,2,64732,64732,64734,0,2,2
18460,6,3,64738,64738,64741,0,3,4
18461,3,1,64741,64741,64742,0,1,0
18462,4,1,64745,64745,64746,0,1,3
18463,2,2,64747,64747,64749,0,2,1
18464,2,3,64749,64749,64752,0,3,0
18465,4,2,64753,64753,64755,0,2,1
18466,2,2,64755,64755,64757,0,2,0
18467,5,2,64760,64760,64762,0,2,3
18468,1,2,64761,64762,64764,1,3,0
18469,6,1,64767,64767,64768,0,1,3
18470,2,1,64769,64769,64770,0,1,1
18471,2,2,64771,64771,64773,0,2,1
18472,3,2,64774,64774,64776,0,2,1
18473,2,2,64776,64776,64778,0,2,0
18474,5,2,64781,64781,64783,0,2,3
18475,5,3,64786,64786,64789,0,3,3
18476,6,2,64792,64792,64794,0,2,3
18477,2,1,64794,64794,64795,0,1,0
18478,5,2,64799,64799,64801,0,2,4
18479,1,3,64800,64801,64804,1,4,0
18480,4,1,64804,64804,64805,0,1,0
18481,2,2,64806,64806,64808,0,2,1
18482,4,1,64810,64810,64811,0,1,2
18483,5,1,64815,64815,64816,0,1,4
18484,5,3,64820,64820,64823,0,3,4
18485,6,1,64826,64826,64827,0,1,3
18486,5,2,64831,64831,64833,0,2,4
18487,1,1,64832,64833,64834,1,2,0
18488,5,3,64837,64837,64840,0,3,3
18489,6,1,64843,64843,64844,0,1,3
18490,6,3,64849,64849,64852,0,3,5
18491,1,2,64850,64852,64854,2,4,0
18492,6,2,64856,64856,64858,0,2,2
18493,3,1,64859,64859,64860,0,1,1
18494,5,3,64864,64864,64867,0,3,4
18495,6,2,64870,64870,64872,0,2,3
18496,3,3,64873,64873,64876,0,3,1
18497,4,2,64877,64877,64879,0,2,1
18498,1,1,64878,64879,64880,1,2,0
18499,1,2,64879,64880,64882,1,3,0
18500,2,1,64881,64882,64883,1,2,0
18501,5,2,64886,64886,64888,0,2,3
18502,3,3,64889,64889,64892,0,3,1
18503,2,3,64891,64892,64895,1,4,0
18504,5,1,64896,64896,64897,0,1,1
18505,6,1,64902,64902,64903,0,1,5
18506,1,3,64903,64903,64906,0,3,0
18507,4,3,64907,64907,64910,0,3,1
18508,1,2,64908,64910,64912,2,4,0
18509,5,3,64913,64913,64916,0,3,1
18510,2,1,64915,64916,64917,1,2,0
18511,4,2,64919,64919,64921,0,2,2
18512,3,1,64922,64922,64923,0,1,1
18513,2,3,64924,64924,64927,0,3,1
18514,6,3,64930,64930,64933,0,3,3
18515,4,1,64934,64934,64935,0,1,1
18516,5,3,64939,64939,64942,0,3,4
18517,5,2,64944,64944,64946,0,2,2
18518,3,1,64947,64947,64948,0,1,1
18519,1,3,64948,64948,64951,0,3,0
18520,2,2,64950,64951,64953,1,3,0
18521,6,3,64956,64956,64959,0,3,3
18522,5,1,64961,64961,64962,0,1,2
18523,2,3,64963,64963,64966,0,3,1
18524,4,3,64967,64967,64970,0,3,1
18525,6,2,64973,64973,64975,0,2,3
18526,1,2,64974,64975,64977,1,3,0
18527,2,1,64976,64977,64978,1,2,0
18528,5,3,64981,64981,64984,0,3,3
18529,2,3,64983,64984,64987,1,4,0
18530,6,3,64989,64989,64992,0,3,2
18531,5,2,64994,64994,64996,0,2,2
18532,3,3,64997,64997,65000,0,3,1
18533,3,1,65000,65000,65001,0,1,0
18534,3,2,65003,65003,65005,0,2,2
18535,4,1,65007,65007,65008,0,1,2
18536,3,3,65010,65010,65013,0,3,2
18537,2,2,65012,65013,65015,1,3,0
18538,1,1,65013,65015,65016,2,3,0
18539,1,2,65014,65016,65018,2,4,0
18540,3,3,65017,65018,65021,1,4,0
18541,5,3,65022,65022,65025,0,3,1
18542,6,3,65028,65028,65031,0,3,3
18543,2,2,65030,65031,65033,1,3,0
18544,5,2,65035,65035,65037,0,2,2
18545,5,2,65040,65040,65042,0,2,3
18546,2,1,65042,65042,65043,0,1,0
18547,1,2,65043,65043,65045,0,2,0
18548,3,1,65046,65046,65047,0,1,1
18549,5,3,65051,65051,65054,0,3,4
18550,2,2,65053,65054,65056,1,3,0
18551,4,1,65057,65057,65058,0,1,1
18552,5,1,65062,65062,65063,0,1,4
18553,3,1,65065,65065,65066,0,1,2
18554,1,1,65066,65066,65067,0,1,0
18555,3,2,65069,65069,65071,0,2,2
18556,4,2,65073,65073,65075,0,2,2
18557,4,1,65077,65077,65078,0,1,2
18558,6,1,65083,65083,65084,0,1,5
18559,6,1,65089,65089,65090,0,1,5
18560,2,2,65091,65091,65093,0,2,1
18561,2,1,65093,65093,65094,0,1,0
18562,4,2,65097,65097,65099,0,2,3
18563,2,1,65099,65099,65100,0,1,0
18564,5,1,65104,65104,65105,0,1,4
18565,1,1,65105,65105,65106,0,1,0
18566,2,1,65107,65107,65108,0,1,1
18567,5,1,65112,65112,65113,0,1,4
18568,6,3,65118,65118,65121,0,3,5
18569,1,2,65119,65121,65123,2,4,0
18570,4,1,65123,65123,65124,0,1,0
18571,3,2,65126,65126,65128,0,2,2
18572,6,3,65132,65132,65135,0,3,4
18573,5,2,65137,65137,65139,0,2,2
18574,4,3,65141,65141,65144,0,3,2
18575,2,2,65143,65144,65146,1,3,0
18576,1,2,65144,65146,65148,2,4,0
18577,2,2,65146,65148,65150,2,4,0
18578,4,2,65150,65150,65152,0,2,0
18579,4,2,65154,65154,65156,0,2,2
18580,5,3,65159,65159,65162,0,3,3
18581,5,3,65164,65164,65167,0,3,2
18582,6,3,65170,65170,65173,0,3,3
18583,6,2,65176,65176,65178,0,2,3
18584,4,2,65180,65180,65182,0,2,2
18585,2,1,65182,65182,65183,0,1,0
18586,4,2,65186,65186,65188,0,2,3
18587,1,1,65187,65188,65189,1,2,0
18588,5,1,65192,65192,65193,0,1,3
18589,2,2,65194,65194,65196,0,2,1
18590,5,2,65199,65199,65201,0,2,3
18591,6,2,65205,65205,65207,0,2,4
18592,4,1,65209,65209,65210,0,1,2
18593,1,3,65210,65210,65213,0,3,0
18594,4,3,65214,65214,65217,0,3,1
18595,4,2,65218,65218,65220,0,2,1
18596,3,2,65221,65221,65223,0,2,1
18597,2,3,65223,65223,65226,0,3,0
18598,5,3,65228,65228,65231,0,3,2
18599,3,3,65231,65231,65234,0,3,0
18600,4,3,65235,65235,65238,0,3,1
18601,4,2,65239,65239,65241,0,2,1
18602,4,3,65243,65243,65246,0,3,2
18603,3,2,65246,65246,65248,0,2,0
18604,1,3,65247,65248,65251,1,4,0
18605,4,3,65251,65251,65254,0,3,0
18606,6,3,65257,65257,65260,0,3,3
18607,6,3,65263,65263,65266,0,3,3
18608,1,2,65264,65266,65268,2,4,0
18609,4,2,65268,65268,65270,0,2,0
18610,1,2,65269,65270,65272,1,3,0
18611,3,3,65272,65272,65275,0,3,0
18612,5,3,65277,65277,65280,0,3,2
18613,5,1,65282,65282,65283,0,1,2
18614,4,1,65286,65286,65287,0,1,3
18615,3,1,65289,65289,65290,0,1,2
18616,2,1,65291,65291,65292,0,1,1
18617,5,2,65296,65296,65298,0,2,4
18618,3,2,65299,65299,65301,0,2,1
18619,4,3,65303,65303,65306,0,3,2
18620,3,1,65306,65306,65307,0,1,0
18621,3,1,65309,65309,65310,0,1,2
18622,3,2,65312,65312,65314,0,2,2
18623,6,2,65318,65318,65320,0,2,4
18624,4,1,65322,65322,65323,0,1,2
18625,3,3,65325,65325,65328,0,3,2
18626,2,3,65327,65328,65331,1,4,0
18627,2,3,65329,65331,65334,2,5,0
18628,5,1,65334,65334,65335,0,1,0
18629,3,2,65337,65337,65339,0,2,2
18630,1,2,65338,65339,65341,1,3,0
18631,1,2,65339,65341,65343,2,4,0
18632,3,1,65342,65343,65344,1,2,0
18633,4,1,65346,65346,65347,0,1,2
18634,4,1,65350,65350,65351,0,1,3
18635,3,1,65353,65353,65354,0,1,2
18636,5,3,65358,65358,65361,0,3,4
18637,6,2,65364,65364,65366,0,2,3
18638,4,3,65368,65368,65371,0,3,2
18639,6,1,65374,65374,65375,0,1,3
18640,1,3,65375,65375,65378,0,3,0
18641,4,1,65379,65379,65380,0,1,1
18642,3,3,65382,65382,65385,0,3,2
18643,1,1,65383,65385,65386,2,3,0
18644,6,3,65389,65389,65392,0,3,3
18645,4,3,65393,65393,65396,0,3,1
18646,5,3,65398,65398,65401,0,3,2
18647,2,3,65400,65401,65404,1,4,0
18648,2,2,65402,65404,65406,2,4,0
18649,4,2,65406,65406,65408,0,2,0
18650,1,2,65407,65408,65410,1,3,0
18651,4,1,65411,65411,65412,0,1,1
18652,2,1,65413,65413,65414,0,1,1
18653,4,3,65417,65417,65420,0,3,3
18654,5,1,65422,65422,65423,0,1,2
18655,2,2,65424,65424,65426,0,2,1
18656,2,1,65426,65426,65427,0,1,0
18657,4,2,65430,65430,65432,0,2,3
18658,1,3,65431,65432,65435,1,4,0
18659,1,3,65432,65435,65438,3,6,0
18660,4,2,65436,65438,65440,2,4,0
18661,4,1,65440,65440,65441,0,1,0
18662,4,1,65444,65444,65445,0,1,3
18663,2,1,65446,65446,65447,0,1,1
18664,6,2,65452,65452,65454,0,2,5
18665,4,1,65456,65456,65457,0,1,2
18666,4,2,65460,65460,65462,0,2,3
18667,6,2,65466,65466,65468,0,2,4
18668,2,2,65468,65468,65470,0,2,0
18669,6,3,65474,65474,65477,0,3,4
18670,1,3,65475,65477,65480,2,5,0
18671,5,2,65480,65480,65482,0,2,0
18672,6,2,65486,65486,65488,0,2,4
18673,2,1,65488,65488,65489,0,1,0
18674,5,2,65493,65493,65495,0,2,4
18675,5,1,65498,65498,65499,0,1,3
18676,3,2,65501,65501,65503,0,2,2
18677,5,3,65506,65506,65509,0,3,3
18678,1,3,65507,65509,65512,2,5,0
18679,6,1,65513,65513,65514,0,1,1
18680,4,2,65517,65517,65519,0,2,3
18681,3,1,65520,65520,65521,0,1,1
18682,3,3,65523,65523,65526,0,3,2
18683,3,2,65526,65526,65528,0,2,0
18684,2,2,65528,65528,65530,0,2,0
18685,5,2,65533,65533,65535,0,2,3
18686,4,3,65537,65537,65540,0,3,2
18687,3,2,65540,65540,65542,0,2,0
18688,4,3,65544,65544,65547,0,3,2
18689,4,3,65548,65548,65551,0,3,1
18690,2,3,65550,65551,65554,1,4,0
18691,6,3,65556,65556,65559,0,3,2
18692,6,2,65562,65562,65564,0,2,3
18693,5,2,65567,65567,65569,0,2,3
18694,6,1,65573,65573,65574,0,1,4
18695,5,2,65578,65578,65580,0,2,4
18696,3,3,65581,65581,65584,0,3,1
18697,1,2,65582,65584,65586,2,4,0
18698,4,3,65586,65586,65589,0,3,0
18699,5,1,65591,65591,65592,0,1,2
18700,5,3,65596,65596,65599,0,3,4
18701,1,1,65597,65599,65600,2,3,0
18702,3,3,65600,65600,65603,0,3,0
18703,2,1,65602,65603,65604,1,2,0
18704,4,2,65606,65606,65608,0,2,2
18705,3,2,65609,65609,65611,0,2,1
18706,6,1,65615,65615,65616,0,1,4
18707,1,3,65616,65616,65619,0,3,0
18708,3,2,65619,65619,65621,0,2,0
18709,4,3,65623,65623,65626,0,3,2
18710,6,1,65629,65629,65630,0,1,3
18711,4,2,65633,65633,65635,0,2,3
18712,4,3,65637,65637,65640,0,3,2
18713,1,1,65638,65640,65641,2,3,0
18714,3,3,65641,65641,65644,0,3,0
18715,3,3,65644,65644,65647,0,3,0
18716,4,1,65648,65648,65649,0,1,1
18717,1,3,65649,65649,65652,0,3,0
18718,2,3,65651,65652,65655,1,4,0
18719,2,2,65653,65655,65657,2,4,0
18720,4,2,65657,65657,65659,0,2,0
18721,6,2,65663,65663,65665,0,2,4
18722,1,3,65664,65665,65668,1,4,0
18723,3,3,65667,65668,65671,1,4,0
18724,2,1,65669,65671,65672,2,3,0
18725,3,1,65672,65672,65673,0,1,0
18726,5,3,65677,65677,65680,0,3,4
18727,5,1,65682,65682,65683,0,1,2
18728,2,1,65684,65684,65685,0,1,1
18729,5,2,65689,65689,65691,0,2,4
18730,6,1,65695,65695,65696,0,1,4
18731,5,1,65700,65700,65701,0,1,4
18732,1,1,65701,65701,65702,0,1,0
18733,6,3,65707,65707,65710,0,3,5
18734,1,1,65708,65710,65711,2,3,0
18735,3,1,65711,65711,65712,0,1,0
18736,4,3,65715,65715,65718,0,3,3
18737,1,2,65716,65718,65720,2,4,0
18738,1,1,65717,65720,65721,3,4,0
18739,3,3,65720,65721,65724,1,4,0
18740,4,2,65724,65724,65726,0,2,0
18741,6,1,65730,65730,65731,0,1,4
18742,1,3,65731,65731,65734,0,3,0
18743,1,3,65732,65734,65737,2,5,0
18744,6,1,65738,65738,65739,0,1,1
18745,6,2,65744,65744,65746,0,2,5
18746,6,2,65750,65750,65752,0,2,4
18747,6,2,65756,65756,65758,0,2,4
18748,2,1,65758,65758,65759,0,1,0
18749,2,2,65760,65760,65762,0,2,1
18750,4,1,65764,65764,65765,0,1,2
18751,4,1,65768,65768,65769,0,1,3
18752,5,2,65773,65773,65775,0,2,4
18753,3,2,65776,65776,65778,0,2,1
18754,5,3,65781,65781,65784,0,3,3
18755,6,2,65787,65787,65789,0,2,3
18756,5,3,65792,65792,65795,0,3,3
18757,3,2,65795,65795,65797,0,2,0
18758,4,2,65799,65799,65801,0,2,2
18759,5,1,65804,65804,65805,0,1,3
18760,1,3,65805,65805,65808,0,3,0
18761,3,2,65808,65808,65810,0,2,0
18762,1,3,65809,65810,65813,1,4,0
18763,2,3,65811,65813,65816,2,5,0
18764,4,2,65815,65816,65818,1,3,0
18765,3,2,65818,65818,65820,0,2,0
18766,4,2,65822,65822,65824,0,2,2
18767,6,2,65828,65828,65830,0,2,4
18768,4,3,65832,65832,65835,0,3,2
18769,1,3,65833,65835,65838,2,5,0
18770,2,2,65835,65838,65840,3,5,0
18771,3,1,65838,65840,65841,2,3,0
18772,5,2,65843,65843,65845,0,2,2
18773,3,3,65846,65846,65849,0,3,1
18774,2,1,65848,65849,65850,1,2,0
18775,3,1,65851,65851,65852,0,1,1
18776,1,3,65852,65852,65855,0,3,0
18777,2,2,65854,65855,65857,1,3,0
18778,4,1,65858,65858,65859,0,1,1
18779,5,3,65863,65863,65866,0,3,4
18780,4,3,65867,65867,65870,0,3,1
18781,1,3,65868,65870,65873,2,5,0
18782,1,3,65869,65873,65876,4,7,0
18783,4,2,65873,65876,65878,3,5,0
18784,6,3,65879,65879,65882,0,3,1
18785,2,2,65881,65882,65884,1,3,0
18786,6,3,65887,65887,65890,0,3,3
18787,2,1,65889,65890,65891,1,2,0
18788,4,1,65893,65893,65894,0,1,2
18789,3,2,65896,65896,65898,0,2,2
18790,3,1,65899,65899,65900,0,1,1
18791,2,3,65901,65901,65904,0,3,1
18792,5,1,65906,65906,65907,0,1,2
18793,6,1,65912,65912,65913,0,1,5
18794,2,3,65914,65914,65917,0,3,1
18795,4,1,65918,65918,65919,0,1,1
18796,3,3,65921,65921,65924,0,3,2
18797,5,3,65926,65926,65929,0,3,2
18798,2,2,65928,65929,65931,1,3,0
18799,1,1,65929,65931,65932,2,3,0
18800,6,2,65935,65935,65937,0,2,3
18801,3,3,65938,65938,65941,0,3,1
18802,5,3,65943,65943,65946,0,3,2
18803,4,3,65947,65947,65950,0,3,1
18804,5,1,65952,65952,65953,0,1,2
18805,2,3,65954,65954,65957,0,3,1
18806,1,2,65955,65957,65959,2,4,0
18807,3,2,65958,65959,65961,1,3,0
18808,1,1,65959,65961,65962,2,3,0
18809,4,1,65963,65963,65964,0,1,1
18810,3,2,65966,65966,65968,0,2,2
18811,3,2,65969,65969,65971,0,2,1
18812,1,1,65970,65971,65972,1,2,0
18813,4,2,65974,65974,65976,0,2,2
18814,6,1,65980,65980,65981,0,1,4
18815,4,1,65984,65984,65985,0,1,3
18816,3,1,65987,65987,65988,0,1,2
18817,3,1,65990,65990,65991,0,1,2
18818,5,1,65995,65995,65996,0,1,4
18819,2,3,65997,65997,66000,0,3,1
18820,2,3,65999,66000,66003,1,4,0
18821,1,1,66000,66003,66004,3,4,0
18822,6,1,66006,66006,66007,0,1,2
18823,6,2,66012,66012,66014,0,2,5
18824,2,3,66014,66014,66017,0,3,0
18825,2,1,66016,66017,66018,1,2,0
18826,3,2,66019,66019,66021,0,2,1
18827,3,2,66022,66022,66024,0,2,1
18828,5,3,66027,66027,66030,0,3,3
18829,3,2,66030,66030,66032,0,2,0
18830,6,3,66036,66036,66039,0,3,4
18831,5,1,66041,66041,66042,0,1,2
18832,1,1,66042,66042,66043,0,1,0
18833,6,1,66048,66048,66049,0,1,5
18834,5,3,66053,66053,66056,0,3,4
18835,3,1,66056,66056,66057,0,1,0
18836,2,3,66058,66058,66061,0,3,1
18837,2,2,66060,66061,66063,1,3,0
18838,1,3,66061,66063,66066,2,5,0
18839,3,1,66064,66066,66067,2,3,0
18840,3,1,66067,66067,66068,0,1,0
18841,6,1,66073,66073,66074,0,1,5
18842,4,1,66077,66077,66078,0,1,3
18843,1,2,66078,66078,66080,0,2,0
18844,3,3,66081,66081,66084,0,3,1
18845,3,1,66084,66084,66085,0,1,0
18846,4,1,66088,66088,66089,0,1,3
18847,2,1,66090,66090,66091,0,1,1
18848,2,1,66092,66092,66093,0,1,1
18849,6,1,66098,66098,66099,0,1,5
18850,3,2,66101,66101,66103,0,2,2
18851,3,2,66104,66104,66106,0,2,1
18852,3,2,66107,66107,66109,0,2,1
18853,2,3,66109,66109,66112,0,3,0
18854,6,3,66115,66115,66118,0,3,3
18855,3,3,66118,66118,66121,0,3,0
18856,3,2,66121,66121,66123,0,2,0
18857,3,1,66124,66124,66125,0,1,1
18858,3,1,66127,66127,66128,0,1,2
18859,4,2,66131,66131,66133,0,2,3
18860,4,1,66135,66135,66136,0,1,2
18861,4,2,66139,66139,66141,0,2,3
18862,5,3,66144,66144,66147,0,3,3
18863,2,1,66146,66147,66148,1,2,0
18864,1,1,66147,66148,66149,1,2,0
18865,2,1,66149,66149,66150,0,1,0
18866,6,2,66155,66155,66157,0,2,5
18867,4,1,66159,66159,66160,0,1,2
18868,1,2,66160,66160,66162,0,2,0
18869,4,1,66164,66164,66165,0,1,2
18870,6,1,66170,66170,66171,0,1,5
18871,5,1,66175,66175,66176,0,1,4
18872,2,2,66177,66177,66179,0,2,1
18873,2,1,66179,66179,66180,0,1,0
18874,4,2,66183,66183,66185,0,2,3
18875,4,3,66187,66187,66190,0,3,2
18876,3,2,66190,66190,66192,0,2,0
18877,3,3,66193,66193,66196,0,3,1
18878,4,3,66197,66197,66200,0,3,1
18879,2,3,66199,66200,66203,1,4,0
18880,4,1,66203,66203,66204,0,1,0
18881,4,1,66207,66207,66208,0,1,3
18882,2,3,66209,66209,66212,0,3,1
18883,5,3,66214,66214,66217,0,3,2
18884,1,2,66215,66217,66219,2,4,0
18885,5,1,66220,66220,66221,0,1,1
18886,6,2,66226,66226,66228,0,2,5
18887,4,3,66230,66230,66233,0,3,2
18888,4,1,66234,66234,66235,0,1,1
18889,3,1,66237,66237,66238,0,1,2
18890,2,3,66239,66239,66242,0,3,1
18891,6,1,66245,66245,66246,0,1,3
18892,2,1,66247,66247,66248,0,1,1
18893,2,1,66249,66249,66250,0,1,1
18894,4,3,66253,66253,66256,0,3,3
18895,2,2,66255,66256,66258,1,3,0
18896,1,1,66256,66258,66259,2,3,0
18897,1,3,66257,66259,66262,2,5,0
18898,2,1,66259,66262,66263,3,4,0
18899,5,3,66264,66264,66267,0,3,1
18900,2,3,66266,66267,66270,1,4,0
18901,3,2,66269,66270,66272,1,3,0
18902,4,2,66273,66273,66275,0,2,1
18903,2,1,66275,66275,66276,0,1,0
18904,1,1,66276,66276,66277,0,1,0
18905,5,2,66281,66281,66283,0,2,4
18906,5,2,66286,66286,66288,0,2,3
18907,1,1,66287,66288,66289,1,2,0
18908,6,2,66293,66293,66295,0,2,4
18909,3,3,66296,66296,66299,0,3,1
18910,2,3,66298,66299,66302,1,4,0
18911,4,2,66302,66302,66304,0,2,0
18912,6,2,66308,66308,66310,0,2,4
18913,4,2,66312,66312,66314,0,2,2
18914,3,2,66315,66315,66317,0,2,1
18915,4,3,66319,66319,66322,0,3,2
18916,2,1,66321,66322,66323,1,2,0
18917,1,3,66322,66323,66326,1,4,0
18918,6,1,66328,66328,66329,0,1,2
18919,2,2,66330,66330,66332,0,2,1
18920,4,1,66334,66334,66335,0,1,2
18921,5,1,66339,66339,66340,0,1,4
18922,2,2,66341,66341,66343,0,2,1
18923,3,1,66344,66344,66345,0,1,1
18924,5,1,66349,66349,66350,0,1,4
18925,6,2,66355,66355,66357,0,2,5
18926,5,2,66360,66360,66362,0,2,3
18927,4,3,66364,66364,66367,0,3,2
18928,3,3,66367,66367,66370,0,3,0
18929,1,1,66368,66370,66371,2,3,0
18930,1,3,66369,66371,66374,2,5,0
18931,1,1,66370,66374,66375,4,5,0
18932,4,2,66374,66375,66377,1,3,0
18933,6,2,66380,66380,66382,0,2,3
18934,1,3,66381,66382,66385,1,4,0
18935,5,3,66386,66386,66389,0,3,1
18936,6,1,66392,66392,66393,0,1,3
18937,2,2,66394,66394,66396,0,2,1
18938,1,3,66395,66396,66399,1,4,0
18939,1,1,66396,66399,66400,3,4,0
18940,5,2,66401,66401,66403,0,2,1
18941,1,3,66402,66403,66406,1,4,0
18942,3,2,66405,66406,66408,1,3,0
18943,5,1,66410,66410,66411,0,1,2
18944,1,2,66411,66411,66413,0,2,0
18945,4,3,66415,66415,66418,0,3,2
18946,5,2,66420,66420,66422,0,2,2
18947,1,2,66421,66422,66424,1,3,0
18948,4,1,66425,66425,66426,0,1,1
18949,6,1,66431,66431,66432,0,1,5
18950,5,2,66436,66436,66438,0,2,4
18951,2,3,66438,66438,66441,0,3,0
18952,3,3,66441,66441,66444,0,3,0
18953,3,1,66444,66444,66445,0,1,0
18954,3,1,66447,66447,66448,0,1,2
18955,6,1,66453,66453,66454,0,1,5
18956,1,1,66454,66454,66455,0,1,0
18957,4,1,66458,66458,66459,0,1,3
18958,4,3,66462,66462,66465,0,3,3
18959,2,3,66464,66465,66468,1,4,0
18960,3,2,66467,66468,66470,1,3,0
18961,3,3,66470,66470,66473,0,3,0
18962,4,1,66474,66474,66475,0,1,1
18963,2,1,66476,66476,66477,0,1,1
18964,3,1,66479,66479,66480,0,1,2
18965,3,3,66482,66482,66485,0,3,2
18966,6,2,66488,66488,66490,0,2,3
18967,3,1,66491,66491,66492,0,1,1
18968,1,3,66492,66492,66495,0,3,0
18969,3,3,66495,66495,66498,0,3,0
18970,5,1,66500,66500,66501,0,1,2
18971,4,2,66504,66504,66506,0,2,3
18972,2,2,66506,66506,66508,0,2,0
18973,3,1,66509,66509,66510,0,1,1
18974,3,1,66512,66512,66513,0,1,2
18975,5,3,66517,66517,66520,0,3,4
18976,1,3,66518,66520,66523,2,5,0
18977,3,3,66521,66523,66526,2,5,0
18978,1,1,66522,66526,66527,4,5,0
18979,5,2,66527,66527,66529,0,2,0
18980,2,1,66529,66529,66530,0,1,0
18981,5,3,66534,66534,66537,0,3,4
18982,3,1,66537,66537,66538,0,1,0
18983,6,2,66543,66543,66545,0,2,5
18984,1,2,66544,66545,66547,1,3,0
18985,1,3,66545,66547,66550,2,5,0
18986,5,1,66550,66550,66551,0,1,0
18987,4,3,66554,66554,66557,0,3,3
18988,3,2,66557,66557,66559,0,2,0
18989,3,2,66560,66560,66562,0,2,1
18990,6,3,66566,66566,66569,0,3,4
18991,2,1,66568,66569,66570,1,2,0
18992,1,3,66569,66570,66573,1,4,0
18993,4,3,66573,66573,66576,0,3,0
18994,5,2,66578,66578,66580,0,2,2
18995,3,2,66581,66581,66583,0,2,1
18996,1,3,66582,66583,66586,1,4,0
18997,3,1,66585,66586,66587,1,2,0
18998,5,1,66590,66590,66591,0,1,3
18999,1,3,66591,66591,66594,0,3,0
19000,1,2,66592,66594,66596,2,4,0
19001,6,1,66598,66598,66599,0,1,2
19002,2,2,66600,66600,66602,0,2,1
19003,2,1,66602,66602,66603,0,1,0
19004,3,2,66605,66605,66607,0,2,2
19005,6,2,66611,66611,66613,0,2,4
19006,6,1,66617,66617,66618,0,1,4
19007,1,1,66618,66618,66619,0,1,0
19008,5,1,66623,66623,66624,0,1,4
19009,4,2,66627,66627,66629,0,2,3
19010,6,2,66633,66633,66635,0,2,4
19011,3,2,66636,66636,66638,0,2,1
19012,2,3,66638,66638,66641,0,3,0
19013,4,1,66642,66642,66643,0,1,1
19014,3,1,66645,66645,66646,0,1,2
19015,4,3,66649,66649,66652,0,3,3
19016,6,2,66655,66655,66657,0,2,3
19017,4,3,66659,66659,66662,0,3,2
19018,5,3,66664,66664,66667,0,3,2
19019,4,3,66668,66668,66671,0,3,1
19020,6,3,66674,66674,66677,0,3,3
19021,5,1,66679,66679,66680,0,1,2
19022,5,3,66684,66684,66687,0,3,4
19023,3,3,66687,66687,66690,0,3,0
19024,3,1,66690,66690,66691,0,1,0
19025,4,3,66694,66694,66697,0,3,3
19026,1,2,66695,66697,66699,2,4,0
19027,2,1,66697,66699,66700,2,3,0
19028,6,2,66703,66703,66705,0,2,3
19029,6,1,66709,66709,66710,0,1,4
19030,6,2,66715,66715,66717,0,2,5
19031,2,1,66717,66717,66718,0,1,0
19032,1,3,66718,66718,66721,0,3,0
19033,6,3,66724,66724,66727,0,3,3
19034,5,3,66729,66729,66732,0,3,2
19035,6,3,66735,66735,66738,0,3,3
19036,1,1,66736,66738,66739,2,3,0
19037,3,3,66739,66739,66742,0,3,0
19038,6,3,66745,66745,66748,0,3,3
19039,2,2,66747,66748,66750,1,3,0
19040,4,3,66751,66751,66754,0,3,1
19041,4,2,66755,66755,66757,0,2,1
19042,4,3,66759,66759,66762,0,3,2
19043,5,3,66764,66764,66767,0,3,2
19044,6,2,66770,66770,66772,0,2,3
19045,3,3,66773,66773,66776,0,3,1
19046,3,2,66776,66776,66778,0,2,0
19047,2,1,66778,66778,66779,0,1,0
19048,2,1,66780,66780,66781,0,1,1
19049,2,1,66782,66782,66783,0,1,1
19050,2,1,66784,66784,66785,0,1,1
19051,5,1,66789,66789,66790,0,1,4
19052,4,3,66793,66793,66796,0,3,3
19053,4,1,66797,66797,66798,0,1,1
19054,4,1,66801,66801,66802,0,1,3
19055,4,1,66805,66805,66806,0,1,3
19056,5,1,66810,66810,66811,0,1,4
19057,6,1,66816,66816,66817,0,1,5
19058,3,1,66819,66819,66820,0,1,2
19059,6,1,66825,66825,66826,0,1,5
19060,5,1,66830,66830,66831,0,1,4
19061,1,1,66831,66831,66832,0,1,0
19062,2,3,66833,66833,66836,0,3,1
19063,4,1,66837,66837,66838,0,1,1
19064,5,3,66842,66842,66845,0,3,4
19065,2,1,66844,66845,66846,1,2,0
19066,3,2,66847,66847,66849,0,2,1
19067,2,2,66849,66849,66851,0,2,0
19068,1,2,66850,66851,66853,1,3,0
19069,1,2,66851,66853,66855,2,4,0
19070,6,1,66857,66857,66858,0,1,2
19071,5,3,66862,66862,66865,0,3,4
19072,3,2,66865,66865,66867,0,2,0
19073,3,2,66868,66868,66870,0,2,1
19074,3,1,66871,66871,66872,0,1,1
19075,6,2,66877,66877,66879,0,2,5
19076,1,3,66878,66879,66882,1,4,0
19077,5,3,66883,66883,66886,0,3,1
19078,5,1,66888,66888,66889,0,1,2
19079,5,3,66893,66893,66896,0,3,4
19080,5,2,66898,66898,66900,0,2,2
19081,2,3,66900,66900,66903,0,3,0
19082,2,1,66902,66903,66904,1,2,0
19083,4,3,66906,66906,66909,0,3,2
19084,3,3,66909,66909,66912,0,3,0
19085,6,1,66915,66915,66916,0,1,3
19086,3,1,66918,66918,66919,0,1,2
19087,5,3,66923,66923,66926,0,3,4
19088,3,2,66926,66926,66928,0,2,0
19089,6,1,66932,66932,66933,0,1,4
19090,1,2,66933,66933,66935,0,2,0
19091,5,3,66938,66938,66941,0,3,3
19092,1,1,66939,66941,66942,2,3,0
19093,4,1,66943,66943,66944,0,1,1
19094,6,1,66949,66949,66950,0,1,5
19095,1,1,66950,66950,66951,0,1,0
19096,6,3,66956,66956,66959,0,3,5
19097,1,2,66957,66959,66961,2,4,0
19098,1,2,66958,66961,66963,3,5,0
19099,3,2,66961,66963,66965,2,4,0
19100,2,2,66963,66965,66967,2,4,0
19101,1,3,66964,66967,66970,3,6,0
19102,5,1,66969,66970,66971,1,2,0
19103,5,1,66974,66974,66975,0,1,3
19104,5,1,66979,66979,66980,0,1,4
19105,1,2,66980,66980,66982,0,2,0
19106,6,3,66986,66986,66989,0,3,4
19107,5,2,66991,66991,66993,0,2,2
19108,2,3,66993,66993,66996,0,3,0
19109,6,1,66999,66999,67000,0,1,3
19110,3,2,67002,67002,67004,0,2,2
19111,6,3,67008,67008,67011,0,3,4
19112,5,2,67013,67013,67015,0,2,2
19113,2,2,67015,67015,67017,0,2,0
19114,2,2,67017,67017,67019,0,2,0
19115,3,2,67020,67020,67022,0,2,1
19116,1,1,67021,67022,67023,1,2,0
19117,1,1,67022,67023,67024,1,2,0
19118,3,3,67025,67025,67028,0,3,1
19119,6,1,67031,67031,67032,0,1,3
19120,2,1,67033,67033,67034,0,1,1
19121,6,1,67039,67039,67040,0,1,5
19122,1,3,67040,67040,67043,0,3,0
19123,3,2,67043,67043,67045,0,2,0
19124,5,3,67048,67048,67051,0,3,3
19125,6,2,67054,67054,67056,0,2,3
19126,5,2,67059,67059,67061,0,2,3
19127,4,3,67063,67063,67066,0,3,2
19128,2,1,67065,67066,67067,1,2,0
19129,3,1,67068,67068,67069,0,1,1
19130,6,1,67074,67074,67075,0,1,5
19131,1,3,67075,67075,67078,0,3,0
19132,4,3,67079,67079,67082,0,3,1
19133,3,3,67082,67082,67085,0,3,0
19134,6,1,67088,67088,67089,0,1,3
19135,6,1,67094,67094,67095,0,1,5
19136,3,1,67097,67097,67098,0,1,2
19137,5,1,67102,67102,67103,0,1,4
19138,3,2,67105,67105,67107,0,2,2
19139,6,3,67111,67111,67114,0,3,4
19140,4,3,67115,67115,67118,0,3,1
19141,3,1,67118,67118,67119,0,1,0
19142,4,2,67122,67122,67124,0,2,3
19143,4,2,67126,67126,67128,0,2,2
19144,6,3,67132,67132,67135,0,3,4
19145,4,1,67136,67136,67137,0,1,1
19146,4,3,67140,67140,67143,0,3,3
19147,1,3,67141,67143,67146,2,5,0
19148,4,3,67145,67146,67149,1,4,0
19149,1,3,67146,67149,67152,3,6,0
19150,3,2,67149,67152,67154,3,5,0
19151,2,1,67151,67154,67155,3,4,0
19152,3,3,67154,67155,67158,1,4,0
19153,4,2,67158,67158,67160,0,2,0
19154,1,3,67159,67160,67163,1,4,0
19155,2,3,67161,67163,67166,2,5,0
19156,3,1,67164,67166,67167,2,3,0
19157,3,2,67167,67167,67169,0,2,0
19158,6,1,67173,67173,67174,0,1,4
19159,1,1,67174,67174,67175,0,1,0
19160,6,2,67180,67180,67182,0,2,5
19161,5,1,67185,67185,67186,0,1,3
19162,4,3,67189,67189,67192,0,3,3
19163,1,1,67190,67192,67193,2,3,0
19164,3,3,67193,67193,67196,0,3,0
19165,5,3,67198,67198,67201,0,3,2
19166,2,2,67200,67201,67203,1,3,0
19167,1,3,67201,67203,67206,2,5,0
19168,3,3,67204,67206,67209,2,5,0
19169,1,1,67205,67209,67210,4,5,0
19170,6,3,67211,67211,67214,0,3,1
19171,1,3,67212,67214,67217,2,5,0
19172,2,2,67214,67217,67219,3,5,0
19173,6,3,67220,67220,67223,0,3,1
19174,1,2,67221,67223,67225,2,4,0
19175,5,3,67226,67226,67229,0,3,1
19176,1,2,67227,67229,67231,2,4,0
19177,4,3,67231,67231,67234,0,3,0
19178,2,2,67233,67234,67236,1,3,0
19179,6,1,67239,67239,67240,0,1,3
19180,5,1,67244,67244,67245,0,1,4
19181,5,1,67249,67249,67250,0,1,4
19182,2,2,67251,67251,67253,0,2,1
19183,3,1,67254,67254,67255,0,1,1
19184,2,3,67256,67256,67259,0,3,1
19185,3,2,67259,67259,67261,0,2,0
19186,1,1,67260,67261,67262,1,2,0
19187,1,3,67261,67262,67265,1,4,0
19188,3,2,67264,67265,67267,1,3,0
19189,4,3,67268,67268,67271,0,3,1
19190,6,1,67274,67274,67275,0,1,3
19191,3,3,67277,67277,67280,0,3,2
19192,6,3,67283,67283,67286,0,3,3
19193,6,2,67289,67289,67291,0,2,3
19194,3,3,67292,67292,67295,0,3,1
19195,2,2,67294,67295,67297,1,3,0
19196,1,3,67295,67297,67300,2,5,0
19197,4,2,67299,67300,67302,1,3,0
19198,3,2,67302,67302,67304,0,2,0
19199,6,2,67308,67308,67310,0,2,4
19200,6,3,67314,67314,67317,0,3,4
19201,6,2,67320,67320,67322,0,2,3
19202,1,2,67321,67322,67324,1,3,0
19203,6,3,67327,67327,67330,0,3,3
19204,2,1,67329,67330,67331,1,2,0
19205,1,2,67330,67331,67333,1,3,0
19206,6,1,67336,67336,67337,0,1,3
19207,6,1,67342,67342,67343,0,1,5
19208,3,3,67345,67345,67348,0,3,2
19209,4,1,67349,67349,67350,0,1,1
19210,4,2,67353,67353,67355,0,2,3
19211,4,3,67357,67357,67360,0,3,2
19212,1,3,67358,67360,67363,2,5,0
19213,5,2,67363,67363,67365,0,2,0
19214,1,3,67364,67365,67368,1,4,0
19215,1,1,67365,67368,67369,3,4,0
19216,2,3,67367,67369,67372,2,5,0
19217,4,2,67371,67372,67374,1,3,0
19218,5,3,67376,67376,67379,0,3,2
19219,4,1,67380,67380,67381,0,1,1
19220,1,3,67381,67381,67384,0,3,0
19221,6,2,67387,67387,67389,0,2,3
19222,3,1,67390,67390,67391,0,1,1
19223,6,2,67396,67396,67398,0,2,5
19224,5,1,67401,67401,67402,0,1,3
19225,2,3,67403,67403,67406,0,3,1
19226,1,3,67404,67406,67409,2,5,0
19227,2,2,67406,67409,67411,3,5,0
19228,6,3,67412,67412,67415,0,3,1
19229,5,1,67417,67417,67418,0,1,2
19230,3,1,67420,67420,67421,0,1,2
19231,1,3,67421,67421,67424,0,3,0
19232,1,1,67422,67424,67425,2,3,0
19233,3,1,67425,67425,67426,0,1,0
19234,5,3,67430,67430,67433,0,3,4
19235,6,2,67436,67436,67438,0,2,3
19236,6,2,67442,67442,67444,0,2,4
19237,2,3,67444,67444,67447,0,3,0
19238,5,3,67449,67449,67452,0,3,2
19239,4,1,67453,67453,67454,0,1,1
19240,6,3,67459,67459,67462,0,3,5
19241,1,1,67460,67462,67463,2,3,0
19242,3,2,67463,67463,67465,0,2,0
19243,3,3,67466,67466,67469,0,3,1
19244,3,1,67469,67469,67470,0,1,0
19245,4,2,67473,67473,67475,0,2,3
19246,2,2,67475,67475,67477,0,2,0
19247,4,2,67479,67479,67481,0,2,2
19248,6,2,67485,67485,67487,0,2,4
19249,4,3,67489,67489,67492,0,3,2
19250,6,1,67495,67495,67496,0,1,3
19251,1,2,67496,67496,67498,0,2,0
19252,3,1,67499,67499,67500,0,1,1
19253,2,3,67501,67501,67504,0,3,1
19254,2,1,67503,67504,67505,1,2,0
19255,2,1,67505,67505,67506,0,1,0
19256,6,2,67511,67511,67513,0,2,5
19257,2,2,67513,67513,67515,0,2,0
19258,1,1,67514,67515,67516,1,2,0
19259,2,2,67516,67516,67518,0,2,0
19260,5,3,67521,67521,67524,0,3,3
19261,6,3,67527,67527,67530,0,3,3
19262,5,2,67532,67532,67534,0,2,2
19263,1,3,67533,67534,67537,1,4,0
19264,1,2,67534,67537,67539,3,5,0
19265,6,2,67540,67540,67542,0,2,1
19266,3,3,67543,67543,67546,0,3,1
19267,1,2,67544,67546,67548,2,4,0
19268,4,1,67548,67548,67549,0,1,0
19269,1,2,67549,67549,67551,0,2,0
19270,2,2,67551,67551,67553,0,2,0
19271,3,1,67554,67554,67555,0,1,1
19272,1,3,67555,67555,67558,0,3,0
19273,1,2,67556,67558,67560,2,4,0
19274,5,2,67561,67561,67563,0,2,1
19275,2,1,67563,67563,67564,0,1,0
19276,4,3,67567,67567,67570,0,3,3
19277,1,1,67568,67570,67571,2,3,0
19278,4,1,67572,67572,67573,0,1,1
19279,1,1,67573,67573,67574,0,1,0
19280,6,1,67579,67579,67580,0,1,5
19281,5,2,67584,67584,67586,0,2,4
19282,2,1,67586,67586,67587,0,1,0
19283,6,3,67592,67592,67595,0,3,5
19284,2,2,67594,67595,67597,1,3,0
19285,1,2,67595,67597,67599,2,4,0
19286,2,1,67597,67599,67600,2,3,0
19287,2,1,67599,67600,67601,1,2,0
19288,6,2,67605,67605,67607,0,2,4
19289,2,2,67607,67607,67609,0,2,0
19290,5,3,67612,67612,67615,0,3,3
19291,4,3,67616,67616,67619,0,3,1
19292,3,1,67619,67619,67620,0,1,0
19293,4,2,67623,67623,67625,0,2,3
19294,2,1,67625,67625,67626,0,1,0
19295,6,2,67631,67631,67633,0,2,5
19296,1,2,67632,67633,67635,1,3,0
19297,6,1,67638,67638,67639,0,1,3
19298,6,2,67644,67644,67646,0,2,5
19299,5,1,67649,67649,67650,0,1,3
19300,1,3,67650,67650,67653,0,3,0
19301,1,2,67651,67653,67655,2,4,0
19302,1,3,67652,67655,67658,3,6,0
19303,3,2,67655,67658,67660,3,5,0
19304,5,1,67660,67660,67661,0,1,0
19305,4,2,67664,67664,67666,0,2,3
19306,1,1,67665,67666,67667,1,2,0
19307,2,3,67667,67667,67670,0,3,0
19308,2,2,67669,67670,67672,1,3,0
19309,6,1,67675,67675,67676,0,1,3
19310,3,1,67678,67678,67679,0,1,2
19311,1,1,67679,67679,67680,0,1,0
19312,5,2,67684,67684,67686,0,2,4
19313,1,2,67685,67686,67688,1,3,0
19314,1,2,67686,67688,67690,2,4,0
19315,1,2,67687,67690,67692,3,5,0
19316,5,2,67692,67692,67694,0,2,0
19317,5,2,67697,67697,67699,0,2,3
19318,3,2,67700,67700,67702,0,2,1
19319,5,1,67705,67705,67706,0,1,3
19320,4,2,67709,67709,67711,0,2,3
19321,6,2,67715,67715,67717,0,2,4
19322,5,3,67720,67720,67723,0,3,3
19323,5,2,67725,67725,67727,0,2,2
19324,6,2,67731,67731,67733,0,2,4
19325,5,2,67736,67736,67738,0,2,3
19326,4,1,67740,67740,67741,0,1,2
19327,2,2,67742,67742,67744,0,2,1
19328,6,2,67748,67748,67750,0,2,4
19329,1,3,67749,67750,67753,1,4,0
19330,6,1,67755,67755,67756,0,1,2
19331,5,1,67760,67760,67761,0,1,4
19332,2,1,67762,67762,67763,0,1,1
19333,6,3,67768,67768,67771,0,3,5
19334,3,1,67771,67771,67772,0,1,0
19335,1,1,67772,67772,67773,0,1,0
19336,5,3,67777,67777,67780,0,3,4
19337,5,1,67782,67782,67783,0,1,2
19338,3,2,67785,67785,67787,0,2,2
19339,3,2,67788,67788,67790,0,2,1
19340,5,2,67793,67793,67795,0,2,3
19341,4,2,67797,67797,67799,0,2,2
19342,2,3,67799,67799,67802,0,3,0
19343,1,3,67800,67802,67805,2,5,0
19344,3,1,67803,67805,67806,2,3,0
19345,1,1,67804,67806,67807,2,3,0
19346,4,3,67808,67808,67811,0,3,1
19347,4,2,67812,67812,67814,0,2,1
19348,6,3,67818,67818,67821,0,3,4
19349,5,2,67823,67823,67825,0,2,2
19350,3,1,67826,67826,67827,0,1,1
19351,2,1,67828,67828,67829,0,1,1
19352,1,3,67829,67829,67832,0,3,0
19353,1,2,67830,67832,67834,2,4,0
19354,6,1,67836,67836,67837,0,1,2
19355,5,3,67841,67841,67844,0,3,4
19356,2,2,67843,67844,67846,1,3,0
19357,2,3,67845,67846,67849,1,4,0
19358,4,1,67849,67849,67850,0,1,0
19359,4,3,67853,67853,67856,0,3,3
19360,2,1,67855,67856,67857,1,2,0
19361,1,1,67856,67857,67858,1,2,0
19362,3,2,67859,67859,67861,0,2,1
19363,1,3,67860,67861,67864,1,4,0
19364,3,3,67863,67864,67867,1,4,0
19365,4,2,67867,67867,67869,0,2,0
19366,6,3,67873,67873,67876,0,3,4
19367,2,1,67875,67876,67877,1,2,0
19368,3,3,67878,67878,67881,0,3,1
19369,5,1,67883,67883,67884,0,1,2
19370,6,1,67889,67889,67890,0,1,5
19371,2,2,67891,67891,67893,0,2,1
19372,1,2,67892,67893,67895,1,3,0
19373,1,2,67893,67895,67897,2,4,0
19374,1,2,67894,67897,67899,3,5,0
19375,6,2,67900,67900,67902,0,2,1
19376,2,2,67902,67902,67904,0,2,0
19377,5,1,67907,67907,67908,0,1,3
19378,3,2,67910,67910,67912,0,2,2
19379,3,1,67913,67913,67914,0,1,1
19380,4,1,67917,67917,67918,0,1,3
19381,3,3,67920,67920,67923,0,3,2
19382,2,1,67922,67923,67924,1,2,0
19383,1,1,67923,67924,67925,1,2,0
19384,3,2,67926,67926,67928,0,2,1
19385,5,3,67931,67931,67934,0,3,3
19386,2,1,67933,67934,67935,1,2,0
19387,3,1,67936,67936,67937,0,1,1
19388,3,1,67939,67939,67940,0,1,2
19389,4,3,67943,67943,67946,0,3,3
19390,3,3,67946,67946,67949,0,3,0
19391,5,2,67951,67951,67953,0,2,2
19392,5,2,67956,67956,67958,0,2,3
19393,1,1,67957,67958,67959,1,2,0
19394,2,3,67959,67959,67962,0,3,0
19395,1,2,67960,67962,67964,2,4,0
19396,1,2,67961,67964,67966,3,5,0
19397,4,2,67965,67966,67968,1,3,0
19398,4,2,67969,67969,67971,0,2,1
19399,6,1,67975,67975,67976,0,1,4
19400,2,1,67977,67977,67978,0,1,1
19401,6,2,67983,67983,67985,0,2,5
19402,4,3,67987,67987,67990,0,3,2
19403,2,2,67989,67990,67992,1,3,0
19404,1,3,67990,67992,67995,2,5,0
19405,2,2,67992,67995,67997,3,5,0
19406,6,2,67998,67998,68000,0,2,1
19407,6,3,68004,68004,68007,0,3,4
19408,5,3,68009,68009,68012,0,3,2
19409,2,3,68011,68012,68015,1,4,0
19410,3,1,68014,68015,68016,1,2,0
19411,3,1,68017,68017,68018,0,1,1
19412,2,2,68019,68019,68021,0,2,1
19413,6,2,68025,68025,68027,0,2,4
19414,4,2,68029,68029,68031,0,2,2
19415,1,1,68030,68031,68032,1,2,0
19416,4,2,68034,68034,68036,0,2,2
19417,3,1,68037,68037,68038,0,1,1
19418,6,1,68043,68043,68044,0,1,5
19419,2,1,68045,68045,68046,0,1,1
19420,2,2,68047,68047,68049,0,2,1
19421,4,1,68051,68051,68052,0,1,2
19422,3,1,68054,68054,68055,0,1,2
19423,5,2,68059,68059,68061,0,2,4
19424,3,1,68062,68062,68063,0,1,1
19425,6,2,68068,68068,68070,0,2,5
19426,3,1,68071,68071,68072,0,1,1
19427,5,1,68076,68076,68077,0,1,4
19428,3,3,68079,68079,68082,0,3,2
19429,5,3,68084,68084,68087,0,3,2
19430,3,3,68087,68087,68090,0,3,0
19431,5,2,68092,68092,68094,0,2,2
19432,4,2,68096,68096,68098,0,2,2
19433,2,3,68098,68098,68101,0,3,0
19434,1,1,68099,68101,68102,2,3,0
19435,3,2,68102,68102,68104,0,2,0
19436,2,2,68104,68104,68106,0,2,0
19437,2,2,68106,68106,68108,0,2,0
19438,3,3,68109,68109,68112,0,3,1
19439,6,1,68115,68115,68116,0,1,3
19440,1,1,68116,68116,68117,0,1,0
19441,5,2,68121,68121,68123,0,2,4
19442,6,2,68127,68127,68129,0,2,4
19443,5,3,68132,68132,68135,0,3,3
19444,6,1,68138,68138,68139,0,1,3
19445,4,1,68142,68142,68143,0,1,3
19446,5,3,68147,68147,68150,0,3,4
19447,1,1,68148,68150,68151,2,3,0
19448,1,2,68149,68151,68153,2,4,0
19449,3,1,68152,68153,68154,1,2,0
19450,3,1,68155,68155,68156,0,1,1
19451,3,3,68158,68158,68161,0,3,2
19452,2,3,68160,68161,68164,1,4,0
19453,4,1,68164,68164,68165,0,1,0
19454,4,1,68168,68168,68169,0,1,3
19455,4,1,68172,68172,68173,0,1,3
19456,2,1,68174,68174,68175,0,1,1
19457,1,2,68175,68175,68177,0,2,0
19458,2,1,68177,68177,68178,0,1,0
19459,1,3,68178,68178,68181,0,3,0
19460,6,3,68184,68184,68187,0,3,3
19461,5,3,68189,68189,68192,0,3,2
19462,3,1,68192,68192,68193,0,1,0
19463,3,2,68195,68195,68197,0,2,2
19464,4,2,68199,68199,68201,0,2,2
19465,3,1,68202,68202,68203,0,1,1
19466,6,2,68208,68208,68210,0,2,5
19467,6,3,68214,68214,68217,0,3,4
19468,5,2,68219,68219,68221,0,2,2
19469,4,2,68223,68223,68225,0,2,2
19470,6,3,68229,68229,68232,0,3,4
19471,1,1,68230,68232,68233,2,3,0
19472,3,2,68233,68233,68235,0,2,0
19473,4,1,68237,68237,68238,0,1,2
19474,6,1,68243,68243,68244,0,1,5
19475,4,2,68247,68247,68249,0,2,3
19476,4,1,68251,68251,68252,0,1,2
19477,6,3,68257,68257,68260,0,3,5
19478,6,2,68263,68263,68265,0,2,3
19479,4,3,68267,68267,68270,0,3,2
19480,6,1,68273,68273,68274,0,1,3
19481,3,1,68276,68276,68277,0,1,2
19482,3,1,68279,68279,68280,0,1,2
19483,2,2,68281,68281,68283,0,2,1
19484,4,3,68285,68285,68288,0,3,2
19485,3,3,68288,68288,68291,0,3,0
19486,3,1,68291,68291,68292,0,1,0
19487,5,1,68296,68296,68297,0,1,4
19488,6,3,68302,68302,68305,0,3,5
19489,2,1,68304,68305,68306,1,2,0
19490,1,1,68305,68306,68307,1,2,0
19491,5,1,68310,68310,68311,0,1,3
19492,5,1,68315,68315,68316,0,1,4
19493,5,2,68320,68320,68322,0,2,4
19494,3,1,68323,68323,68324,0,1,1
19495,1,1,68324,68324,68325,0,1,0
19496,2,1,68326,68326,68327,0,1,1
19497,4,3,68330,68330,68333,0,3,3
19498,1,3,68331,68333,68336,2,5,0
19499,1,2,68332,68336,68338,4,6,0
19500,1,3,68333,68338,68341,5,8,0
19501,3,3,68336,68341,68344,5,8,0
19502,5,1,68341,68344,68345,3,4,0
19503,4,3,68345,68345,68348,0,3,0
19504,3,3,68348,68348,68351,0,3,0
19505,1,1,68349,68351,68352,2,3,0
19506,4,2,68353,68353,68355,0,2,1
19507,3,3,68356,68356,68359,0,3,1
19508,2,3,68358,68359,68362,1,4,0
19509,3,1,68361,68362,68363,1,2,0
19510,1,1,68362,68363,68364,1,2,0
19511,2,3,68364,68364,68367,0,3,0
19512,3,3,68367,68367,68370,0,3,0
19513,6,1,68373,68373,68374,0,1,3
19514,6,1,68379,68379,68380,0,1,5
19515,2,1,68381,68381,68382,0,1,1
19516,1,2,68382,68382,68384,0,2,0
19517,2,1,68384,68384,68385,0,1,0
19518,5,3,68389,68389,68392,0,3,4
19519,1,2,68390,68392,68394,2,4,0
19520,4,2,68394,68394,68396,0,2,0
19521,5,2,68399,68399,68401,0,2,3
19522,1,3,68400,68401,68404,1,4,0
19523,3,2,68403,68404,68406,1,3,0
19524,5,1,68408,68408,68409,0,1,2
19525,5,2,68413,68413,68415,0,2,4
19526,3,2,68416,68416,68418,0,2,1
19527,6,2,68422,68422,68424,0,2,4
19528,5,3,68427,68427,68430,0,3,3
19529,6,3,68433,68433,68436,0,3,3
19530,6,3,68439,68439,68442,0,3,3
19531,5,2,68444,68444,68446,0,2,2
19532,1,3,68445,68446,68449,1,4,0
19533,4,2,68449,68449,68451,0,2,0
19534,2,2,68451,68451,68453,0,2,0
19535,4,3,68455,68455,68458,0,3,2
19536,6,3,68461,68461,68464,0,3,3
19537,1,2,68462,68464,68466,2,4,0
19538,4,2,68466,68466,68468,0,2,0
19539,2,1,68468,68468,68469,0,1,0
19540,3,3,68471,68471,68474,0,3,2
19541,4,3,68475,68475,68478,0,3,1
19542,1,2,68476,68478,68480,2,4,0
19543,3,1,68479,68480,68481,1,2,0
19544,4,3,68483,68483,68486,0,3,2
19545,2,3,68485,68486,68489,1,4,0
19546,5,3,68490,68490,68493,0,3,1
19547,1,3,68491,68493,68496,2,5,0
19548,3,2,68494,68496,68498,2,4,0
19549,1,1,68495,68498,68499,3,4,0
19550,2,1,68497,68499,68500,2,3,0
19551,3,2,68500,68500,68502,0,2,0
19552,2,3,68502,68502,68505,0,3,0
19553,5,2,68507,68507,68509,0,2,2
19554,6,1,68513,68513,68514,0,1,4
19555,6,2,68519,68519,68521,0,2,5
19556,4,2,68523,68523,68525,0,2,2
19557,1,2,68524,68525,68527,1,3,0
19558,3,3,68527,68527,68530,0,3,0
19559,4,3,68531,68531,68534,0,3,1
19560,2,1,68533,68534,68535,1,2,0
19561,5,1,68538,68538,68539,0,1,3
19562,5,3,68543,68543,68546,0,3,4
19563,6,1,68549,68549,68550,0,1,3
19564,2,1,68551,68551,68552,0,1,1
19565,4,1,68555,68555,68556,0,1,3
19566,4,2,68559,68559,68561,0,2,3
19567,5,2,68564,68564,68566,0,2,3
19568,2,3,68566,68566,68569,0,3,0
19569,6,1,68572,68572,68573,0,1,3
19570,3,2,68575,68575,68577,0,2,2
19571,5,2,68580,68580,68582,0,2,3
19572,4,1,68584,68584,68585,0,1,2
19573,4,1,68588,68588,68589,0,1,3
19574,5,2,68593,68593,68595,0,2,4
19575,3,3,68596,68596,68599,0,3,1
19576,2,3,68598,68599,68602,1,4,0
19577,4,3,68602,68602,68605,0,3,0
19578,1,2,68603,68605,68607,2,4,0
19579,3,3,68606,68607,68610,1,4,0
19580,5,1,68611,68611,68612,0,1,1
19581,4,2,68615,68615,68617,0,2,3
19582,4,3,68619,68619,68622,0,3,2
19583,4,1,68623,68623,68624,0,1,1
19584,5,3,68628,68628,68631,0,3,4
19585,4,2,68632,68632,68634,0,2,1
19586,5,1,68637,68637,68638,0,1,3
19587,3,2,68640,68640,68642,0,2,2
19588,1,2,68641,68642,68644,1,3,0
19589,1,1,68642,68644,68645,2,3,0
19590,5,2,68647,68647,68649,0,2,2
19591,4,3,68651,68651,68654,0,3,2
19592,5,3,68656,68656,68659,0,3,2
19593,6,3,68662,68662,68665,0,3,3
19594,6,2,68668,68668,68670,0,2,3
19595,3,3,68671,68671,68674,0,3,1
19596,5,2,68676,68676,68678,0,2,2
19597,1,1,68677,68678,68679,1,2,0
19598,5,3,68682,68682,68685,0,3,3
19599,2,3,68684,68685,68688,1,4,0
19600,6,1,68690,68690,68691,0,1,2
19601,3,1,68693,68693,68694,0,1,2
19602,4,2,68697,68697,68699,0,2,3
19603,3,3,68700,68700,68703,0,3,1
19604,3,1,68703,68703,68704,0,1,0
19605,5,1,68708,68708,68709,0,1,4
19606,2,3,68710,68710,68713,0,3,1
19607,2,3,68712,68713,68716,1,4,0
19608,3,2,68715,68716,68718,1,3,0
19609,5,3,68720,68720,68723,0,3,2
19610,4,2,68724,68724,68726,0,2,1
19611,2,3,68726,68726,68729,0,3,0
19612,4,2,68730,68730,68732,0,2,1
19613,1,2,68731,68732,68734,1,3,0
19614,5,1,68736,68736,68737,0,1,2
19615,2,3,68738,68738,68741,0,3,1
19616,4,3,68742,68742,68745,0,3,1
19617,5,2,68747,68747,68749,0,2,2
19618,5,3,68752,68752,68755,0,3,3
19619,6,2,68758,68758,68760,0,2,3
19620,4,1,68762,68762,68763,0,1,2
19621,6,3,68768,68768,68771,0,3,5
19622,3,2,68771,68771,68773,0,2,0
19623,2,3,68773,68773,68776,0,3,0
19624,1,2,68774,68776,68778,2,4,0
19625,5,2,68779,68779,68781,0,2,1
19626,3,1,68782,68782,68783,0,1,1
19627,1,1,68783,68783,68784,0,1,0
19628,3,2,68786,68786,68788,0,2,2
19629,4,2,68790,68790,68792,0,2,2
19630,5,3,68795,68795,68798,0,3,3
19631,4,2,68799,68799,68801,0,2,1
19632,3,1,68802,68802,68803,0,1,1
19633,2,3,68804,68804,68807,0,3,1
19634,5,3,68809,68809,68812,0,3,2
19635,6,3,68815,68815,68818,0,3,3
19636,3,1,68818,68818,68819,0,1,0
19637,6,2,68824,68824,68826,0,2,5
19638,2,2,68826,68826,68828,0,2,0
19639,3,2,68829,68829,68831,0,2,1
19640,2,1,68831,68831,68832,0,1,0
19641,1,2,68832,68832,68834,0,2,0
19642,6,2,68838,68838,68840,0,2,4
19643,6,3,68844,68844,68847,0,3,4
19644,5,2,68849,68849,68851,0,2,2
19645,4,1,68853,68853,68854,0,1,2
19646,6,3,68859,68859,68862,0,3,5
19647,4,1,68863,68863,68864,0,1,1
19648,3,2,68866,68866,68868,0,2,2
19649,6,2,68872,68872,68874,0,2,4
19650,5,1,68877,68877,68878,0,1,3
19651,5,2,68882,68882,68884,0,2,4
19652,4,3,68886,68886,68889,0,3,2
19653,5,1,68891,68891,68892,0,1,2
19654,6,1,68897,68897,68898,0,1,5
19655,1,3,68898,68898,68901,0,3,0
19656,6,3,68904,68904,68907,0,3,3
19657,6,1,68910,68910,68911,0,1,3
19658,6,2,68916,68916,68918,0,2,5
19659,2,2,68918,68918,68920,0,2,0
19660,2,3,68920,68920,68923,0,3,0
19661,3,2,68923,68923,68925,0,2,0
19662,3,2,68926,68926,68928,0,2,1
19663,6,3,68932,68932,68935,0,3,4
19664,4,3,68936,68936,68939,0,3,1
19665,3,3,68939,68939,68942,0,3,0
19666,5,2,68944,68944,68946,0,2,2
19667,3,1,68947,68947,68948,0,1,1
19668,1,1,68948,68948,68949,0,1,0
19669,2,1,68950,68950,68951,0,1,1
19670,3,1,68953,68953,68954,0,1,2
19671,1,3,68954,68954,68957,0,3,0
19672,6,3,68960,68960,68963,0,3,3
19673,4,2,68964,68964,68966,0,2,1
19674,6,3,68970,68970,68973,0,3,4
19675,1,3,68971,68973,68976,2,5,0
19676,4,3,68975,68976,68979,1,4,0
19677,5,2,68980,68980,68982,0,2,1
19678,6,3,68986,68986,68989,0,3,4
19679,2,1,68988,68989,68990,1,2,0
19680,2,2,68990,68990,68992,0,2,0
19681,2,2,68992,68992,68994,0,2,0
19682,6,3,68998,68998,69001,0,3,4
19683,6,3,69004,69004,69007,0,3,3
19684,5,2,69009,69009,69011,0,2,2
19685,5,1,69014,69014,69015,0,1,3
19686,4,1,69018,69018,69019,0,1,3
19687,5,2,69023,69023,69025,0,2,4
19688,6,3,69029,69029,69032,0,3,4
19689,5,3,69034,69034,69037,0,3,2
19690,5,3,69039,69039,69042,0,3,2
19691,5,3,69044,69044,69047,0,3,2
19692,3,3,69047,69047,69050,0,3,0
19693,6,1,69053,69053,69054,0,1,3
19694,5,2,69058,69058,69060,0,2,4
19695,6,1,69064,69064,69065,0,1,4
19696,3,3,69067,69067,69070,0,3,2
19697,5,3,69072,69072,69075,0,3,2
19698,2,2,69074,69075,69077,1,3,0
19699,5,1,69079,69079,69080,0,1,2
19700,3,3,69082,69082,69085,0,3,2
19701,5,3,69087,69087,69090,0,3,2
19702,1,1,69088,69090,69091,2,3,0
19703,6,2,69094,69094,69096,0,2,3
19704,5,1,69099,69099,69100,0,1,3
19705,1,2,69100,69100,69102,0,2,0
19706,4,2,69104,69104,69106,0,2,2
19707,2,3,69106,69106,69109,0,3,0
19708,2,3,69108,69109,69112,1,4,0
19709,1,3,69109,69112,69115,3,6,0
19710,5,2,69114,69115,69117,1,3,0
19711,1,3,69115,69117,69120,2,5,0
19712,1,1,69116,69120,69121,4,5,0
19713,4,2,69120,69121,69123,1,3,0
19714,6,2,69126,69126,69128,0,2,3
19715,6,2,69132,69132,69134,0,2,4
19716,3,3,69135,69135,69138,0,3,1
19717,6,2,69141,69141,69143,0,2,3
19718,2,3,69143,69143,69146,0,3,0
19719,6,1,69149,69149,69150,0,1,3
19720,4,1,69153,69153,69154,0,1,3
19721,6,2,69159,69159,69161,0,2,5
19722,6,1,69165,69165,69166,0,1,4
19723,6,2,69171,69171,69173,0,2,5
19724,6,2,69177,69177,69179,0,2,4
19725,3,3,69180,69180,69183,0,3,1
19726,5,3,69185,69185,69188,0,3,2
19727,5,3,69190,69190,69193,0,3,2
19728,3,1,69193,69193,69194,0,1,0
19729,1,2,69194,69194,69196,0,2,0
19730,1,3,69195,69196,69199,1,4,0
19731,4,1,69199,69199,69200,0,1,0
19732,2,2,69201,69201,69203,0,2,1
19733,5,1,69206,69206,69207,0,1,3
19734,1,3,69207,69207,69210,0,3,0
19735,3,3,69210,69210,69213,0,3,0
19736,5,3,69215,69215,69218,0,3,2
19737,5,3,69220,69220,69223,0,3,2
19738,4,3,69224,69224,69227,0,3,1
19739,3,1,69227,69227,69228,0,1,0
19740,1,1,69228,69228,69229,0,1,0
19741,4,2,69232,69232,69234,0,2,3
19742,4,1,69236,69236,69237,0,1,2
19743,1,1,69237,69237,69238,0,1,0
19744,1,1,69238,69238,69239,0,1,0
19745,4,2,69242,69242,69244,0,2,3
19746,4,1,69246,69246,69247,0,1,2
19747,6,1,69252,69252,69253,0,1,5
19748,6,2,69258,69258,69260,0,2,5
19749,5,1,69263,69263,69264,0,1,3
19750,4,1,69267,69267,69268,0,1,3
19751,4,2,69271,69271,69273,0,2,3
19752,4,1,69275,69275,69276,0,1,2
19753,4,2,69279,69279,69281,0,2,3
19754,1,2,69280,69281,69283,1,3,0
19755,2,1,69282,69283,69284,1,2,0
19756,1,2,69283,69284,69286,1,3,0
19757,6,2,69289,69289,69291,0,2,3
19758,3,3,69292,69292,69295,0,3,1
19759,5,2,69297,69297,69299,0,2,2
19760,1,1,69298,69299,69300,1,2,0
19761,4,1,69302,69302,69303,0,1,2
19762,4,1,69306,69306,69307,0,1,3
19763,6,2,69312,69312,69314,0,2,5
19764,2,3,69314,69314,69317,0,3,0
19765,4,2,69318,69318,69320,0,2,1
19766,5,3,69323,69323,69326,0,3,3
19767,1,1,69324,69326,69327,2,3,0
19768,1,2,69325,69327,69329,2,4,0
19769,6,3,69331,69331,69334,0,3,2
19770,1,3,69332,69334,69337,2,5,0
19771,5,1,69337,69337,69338,0,1,0
19772,1,3,69338,69338,69341,0,3,0
19773,1,2,69339,69341,69343,2,4,0
19774,2,1,69341,69343,69344,2,3,0
19775,2,2,69343,69344,69346,1,3,0
19776,6,2,69349,69349,69351,0,2,3
19777,5,2,69354,69354,69356,0,2,3
19778,3,3,69357,69357,69360,0,3,1
19779,4,1,69361,69361,69362,0,1,1
19780,1,3,69362,69362,69365,0,3,0
19781,3,1,69365,69365,69366,0,1,0
19782,1,3,69366,69366,69369,0,3,0
19783,2,3,69368,69369,69372,1,4,0
19784,6,2,69374,69374,69376,0,2,2
19785,1,2,69375,69376,69378,1,3,0
19786,5,1,69380,69380,69381,0,1,2
19787,6,1,69386,69386,69387,0,1,5
19788,1,3,69387,69387,69390,0,3,0
19789,3,1,69390,69390,69391,0,1,0
19790,4,2,69394,69394,69396,0,2,3
19791,4,2,69398,69398,69400,0,2,2
19792,6,2,69404,69404,69406,0,2,4
19793,4,1,69408,69408,69409,0,1,2
19794,2,2,69410,69410,69412,0,2,1
19795,5,1,69415,69415,69416,0,1,3
19796,1,1,69416,69416,69417,0,1,0
19797,4,3,69420,69420,69423,0,3,3
19798,5,3,69425,69425,69428,0,3,2
19799,6,1,69431,69431,69432,0,1,3
19800,1,3,69432,69432,69435,0,3,0
19801,5,2,69437,69437,69439,0,2,2
19802,3,2,69440,69440,69442,0,2,1
19803,2,2,69442,69442,69444,0,2,0
19804,4,1,69446,69446,69447,0,1,2
19805,2,2,69448,69448,69450,0,2,1
19806,1,3,69449,69450,69453,1,4,0
19807,2,2,69451,69453,69455,2,4,0
19808,2,2,69453,69455,69457,2,4,0
19809,1,2,69454,69457,69459,3,5,0
19810,6,3,69460,69460,69463,0,3,1
19811,4,2,69464,69464,69466,0,2,1
19812,3,3,69467,69467,69470,0,3,1
19813,2,1,69469,69470,69471,1,2,0
19814,5,2,69474,69474,69476,0,2,3
19815,5,2,69479,69479,69481,0,2,3
19816,1,3,69480,69481,69484,1,4,0
19817,3,1,69483,69484,69485,1,2,0
19818,6,2,69489,69489,69491,0,2,4
19819,2,2,69491,69491,69493,0,2,0
19820,1,2,69492,69493,69495,1,3,0
19821,4,2,69496,69496,69498,0,2,1
19822,6,3,69502,69502,69505,0,3,4
19823,3,3,69505,69505,69508,0,3,0
19824,1,3,69506,69508,69511,2,5,0
19825,6,1,69512,69512,69513,0,1,1
19826,2,2,69514,69514,69516,0,2,1
19827,5,2,69519,69519,69521,0,2,3
19828,6,1,69525,69525,69526,0,1,4
19829,1,1,69526,69526,69527,0,1,0
19830,5,2,69531,69531,69533,0,2,4
19831,4,2,69535,69535,69537,0,2,2
19832,3,3,69538,69538,69541,0,3,1
19833,1,2,69539,69541,69543,2,4,0
19834,4,2,69543,69543,69545,0,2,0
19835,6,2,69549,69549,69551,0,2,4
19836,5,2,69554,69554,69556,0,2,3
19837,4,3,69558,69558,69561,0,3,2
19838,3,1,69561,69561,69562,0,1,0
19839,2,1,69563,69563,69564,0,1,1
19840,4,3,69567,69567,69570,0,3,3
19841,4,2,69571,69571,69573,0,2,1
19842,2,2,69573,69573,69575,0,2,0
19843,4,2,69577,69577,69579,0,2,2
19844,1,1,69578,69579,69580,1,2,0
19845,2,3,69580,69580,69583,0,3,0
19846,3,3,69583,69583,69586,0,3,0
19847,1,1,69584,69586,69587,2,3,0
19848,3,3,69587,69587,69590,0,3,0
19849,2,1,69589,69590,69591,1,2,0
19850,1,1,69590,69591,69592,1,2,0
19851,3,2,69593,69593,69595,0,2,1
19852,3,2,69596,69596,69598,0,2,1
19853,6,3,69602,69602,69605,0,3,4
19854,6,2,69608,69608,69610,0,2,3
19855,4,2,69612,69612,69614,0,2,2
19856,4,3,69616,69616,69619,0,3,2
19857,6,2,69622,69622,69624,0,2,3
19858,2,1,69624,69624,69625,0,1,0
19859,4,3,69628,69628,69631,0,3,3
19860,5,1,69633,69633,69634,0,1,2
19861,5,1,69638,69638,69639,0,1,4
19862,3,3,69641,69641,69644,0,3,2
19863,6,2,69647,69647,69649,0,2,3
19864,1,2,69648,69649,69651,1,3,0
19865,4,2,69652,69652,69654,0,2,1
19866,3,3,69655,69655,69658,0,3,1
19867,6,1,69661,69661,69662,0,1,3
19868,3,1,69664,69664,69665,0,1,2
19869,4,1,69668,69668,69669,0,1,3
19870,2,3,69670,69670,69673,0,3,1
19871,4,3,69674,69674,69677,0,3,1
19872,1,1,69675,69677,69678,2,3,0
19873,3,3,69678,69678,69681,0,3,0
19874,6,1,69684,69684,69685,0,1,3
19875,6,2,69690,69690,69692,0,2,5
19876,3,1,69693,69693,69694,0,1,1
19877,1,3,69694,69694,69697,0,3,0
19878,1,1,69695,69697,69698,2,3,0
19879,3,2,69698,69698,69700,0,2,0
19880,4,1,69702,69702,69703,0,1,2
19881,6,3,69708,69708,69711,0,3,5
19882,5,1,69713,69713,69714,0,1,2
19883,6,2,69719,69719,69721,0,2,5
19884,6,2,69725,69725,69727,0,2,4
19885,4,2,69729,69729,69731,0,2,2
19886,4,2,69733,69733,69735,0,2,2
19887,3,1,69736,69736,69737,0,1,1
19888,5,2,69741,69741,69743,0,2,4
19889,3,3,69744,69744,69747,0,3,1
19890,6,1,69750,69750,69751,0,1,3
19891,4,2,69754,69754,69756,0,2,3
19892,5,3,69759,69759,69762,0,3,3
19893,4,1,69763,69763,69764,0,1,1
19894,5,3,69768,69768,69771,0,3,4
19895,6,3,69774,69774,69777,0,3,3
19896,6,1,69780,69780,69781,0,1,3
19897,4,1,69784,69784,69785,0,1,3
19898,1,3,69785,69785,69788,0,3,0
19899,5,2,69790,69790,69792,0,2,2
19900,3,3,69793,69793,69796,0,3,1
19901,1,3,69794,69796,69799,2,5,0
19902,6,2,69800,69800,69802,0,2,1
19903,4,3,69804,69804,69807,0,3,2
19904,4,2,69808,69808,69810,0,2,1
19905,1,1,69809,69810,69811,1,2,0
19906,2,3,69811,69811,69814,0,3,0
19907,1,2,69812,69814,69816,2,4,0
19908,2,2,69814,69816,69818,2,4,0
19909,1,2,69815,69818,69820,3,5,0
19910,1,3,69816,69820,69823,4,7,0
19911,5,2,69821,69823,69825,2,4,0
19912,3,3,69824,69825,69828,1,4,0
19913,6,1,69830,69830,69831,0,1,2
19914,2,2,69832,69832,69834,0,2,1
19915,2,2,69834,69834,69836,0,2,0
19916,6,2,69840,69840,69842,0,2,4
19917,2,1,69842,69842,69843,0,1,0
19918,4,2,69846,69846,69848,0,2,3
19919,1,1,69847,69848,69849,1,2,0
19920,6,1,69853,69853,69854,0,1,4
19921,6,1,69859,69859,69860,0,1,5
19922,5,1,69864,69864,69865,0,1,4
19923,6,2,69870,69870,69872,0,2,5
19924,6,2,69876,69876,69878,0,2,4
19925,3,2,69879,69879,69881,0,2,1
19926,5,3,69884,69884,69887,0,3,3
19927,2,3,69886,69887,69890,1,4,0
19928,4,3,69890,69890,69893,0,3,0
19929,2,1,69892,69893,69894,1,2,0
19930,5,2,69897,69897,69899,0,2,3
19931,2,1,69899,69899,69900,0,1,0
19932,4,1,69903,69903,69904,0,1,3
19933,6,1,69909,69909,69910,0,1,5
19934,1,3,69910,69910,69913,0,3,0
19935,1,3,69911,69913,69916,2,5,0
19936,4,2,69915,69916,69918,1,3,0
19937,5,1,69920,69920,69921,0,1,2
19938,2,3,69922,69922,69925,0,3,1
19939,3,2,69925,69925,69927,0,2,0
19940,6,2,69931,69931,69933,0,2,4
19941,3,1,69934,69934,69935,0,1,1
19942,4,3,69938,69938,69941,0,3,3
19943,3,1,69941,69941,69942,0,1,0
19944,1,3,69942,69942,69945,0,3,0
19945,1,2,69943,69945,69947,2,4,0
19946,6,1,69949,69949,69950,0,1,2
19947,3,3,69952,69952,69955,0,3,2
19948,6,1,69958,69958,69959,0,1,3
19949,3,2,69961,69961,69963,0,2,2
19950,3,1,69964,69964,69965,0,1,1
19951,4,1,69968,69968,69969,0,1,3
19952,4,1,69972,69972,69973,0,1,3
19953,6,1,69978,69978,69979,0,1,5
19954,6,1,69984,69984,69985,0,1,5
19955,5,2,69989,69989,69991,0,2,4
19956,5,2,69994,69994,69996,0,2,3
19957,5,2,69999,69999,70001,0,2,3
19958,2,1,70001,70001,70002,0,1,0
19959,3,3,70004,70004,70007,0,3,2
19960,6,2,70010,70010,70012,0,2,3
19961,3,2,70013,70013,70015,0,2,1
19962,4,2,70017,70017,70019,0,2,2
19963,6,1,70023,70023,70024,0,1,4
19964,3,2,70026,70026,70028,0,2,2
19965,6,1,70032,70032,70033,0,1,4
19966,3,2,70035,70035,70037,0,2,2
19967,3,1,70038,70038,70039,0,1,1
19968,6,1,70044,70044,70045,0,1,5
19969,6,3,70050,70050,70053,0,3,5
19970,4,2,70054,70054,70056,0,2,1
19971,4,2,70058,70058,70060,0,2,2
19972,3,2,70061,70061,70063,0,2,1
19973,2,1,70063,70063,70064,0,1,0
19974,5,3,70068,70068,70071,0,3,4
19975,1,2,70069,70071,70073,2,4,0
19976,5,3,70074,70074,70077,0,3,1
19977,6,2,70080,70080,70082,0,2,3
19978,1,1,70081,70082,70083,1,2,0
19979,5,3,70086,70086,70089,0,3,3
19980,4,3,70090,70090,70093,0,3,1
19981,3,2,70093,70093,70095,0,2,0
19982,3,1,70096,70096,70097,0,1,1
19983,5,1,70101,70101,70102,0,1,4
19984,4,3,70105,70105,70108,0,3,3
19985,3,1,70108,70108,70109,0,1,0
19986,6,3,70114,70114,70117,0,3,5
19987,1,1,70115,70117,70118,2,3,0
19988,5,2,70120,70120,70122,0,2,2
19989,6,2,70126,70126,70128,0,2,4
19990,3,1,70129,70129,70130,0,1,1
19991,3,3,70132,70132,70135,0,3,2
19992,6,3,70138,70138,70141,0,3,3
19993,5,3,70143,70143,70146,0,3,2
19994,5,2,70148,70148,70150,0,2,2
19995,2,2,70150,70150,70152,0,2,0
19996,3,3,70153,70153,70156,0,3,1
19997,2,1,70155,70156,70157,1,2,0
19998,6,1,70161,70161,70162,0,1,4
19999,2,3,70163,70163,70166,0,3,1
20000,6,2,70169,70169,70171,0,2,3
20001,3,3,70172,70172,70175,0,3,1
20002,5,3,70177,70177,70180,0,3,2
20003,3,2,70180,70180,70182,0,2,0
20004,1,1,70181,70182,70183,1,2,0
20005,5,1,70186,70186,70187,0,1,3
20006,4,3,70190,70190,70193,0,3,3
20007,4,2,70194,70194,70196,0,2,1
20008,4,1,70198,70198,70199,0,1,2
20009,2,2,70200,70200,70202,0,2,1
20010,4,2,70204,70204,70206,0,2,2
20011,1,2,70205,70206,70208,1,3,0
20012,2,1,70207,70208,70209,1,2,0
20013,2,1,70209,70209,70210,0,1,0
20014,4,3,70213,70213,70216,0,3,3
20015,6,3,70219,70219,70222,0,3,3
20016,1,2,70220,70222,70224,2,4,0
20017,6,3,70226,70226,70229,0,3,2
20018,6,1,70232,70232,70233,0,1,3
20019,6,2,70238,70238,70240,0,2,5
20020,4,2,70242,70242,70244,0,2,2
20021,5,2,70247,70247,70249,0,2,3
20022,1,1,70248,70249,70250,1,2,0
20023,3,1,70251,70251,70252,0,1,1
20024,6,1,70257,70257,70258,0,1,5
20025,5,3,70262,70262,70265,0,3,4
20026,6,2,70268,70268,70270,0,2,3
20027,2,3,70270,70270,70273,0,3,0
20028,3,2,70273,70273,70275,0,2,0
20029,4,3,70277,70277,70280,0,3,2
20030,1,1,70278,70280,70281,2,3,0
20031,1,1,70279,70281,70282,2,3,0
20032,3,1,70282,70282,70283,0,1,0
20033,2,2,70284,70284,70286,0,2,1
20034,4,2,70288,70288,70290,0,2,2
20035,4,1,70292,70292,70293,0,1,2
20036,4,1,70296,70296,70297,0,1,3
20037,3,3,70299,70299,70302,0,3,2
20038,4,3,70303,70303,70306,0,3,1
20039,4,2,70307,70307,70309,0,2,1
20040,5,2,70312,70312,70314,0,2,3
20041,5,1,70317,70317,70318,0,1,3
20042,1,3,70318,70318,70321,0,3,0
20043,3,1,70321,70321,70322,0,1,0
20044,1,3,70322,70322,70325,0,3,0
20045,3,1,70325,70325,70326,0,1,0
20046,1,1,70326,70326,70327,0,1,0
20047,1,3,70327,70327,70330,0,3,0
20048,6,3,70333,70333,70336,0,3,3
20049,4,3,70337,70337,70340,0,3,1
20050,4,3,70341,70341,70344,0,3,1
20051,2,2,70343,70344,70346,1,3,0
20052,4,1,70347,70347,70348,0,1,1
20053,1,1,70348,70348,70349,0,1,0
20054,1,1,70349,70349,70350,0,1,0
20055,5,3,70354,70354,70357,0,3,4
20056,3,3,70357,70357,70360,0,3,0
20057,5,3,70362,70362,70365,0,3,2
20058,3,3,70365,70365,70368,0,3,0
20059,5,2,70370,70370,70372,0,2,2
20060,3,2,70373,70373,70375,0,2,1
20061,4,2,70377,70377,70379,0,2,2
20062,5,1,70382,70382,70383,0,1,3
20063,6,3,70388,70388,70391,0,3,5
20064,5,1,70393,70393,70394,0,1,2
20065,3,1,70396,70396,70397,0,1,2
20066,1,1,70397,70397,70398,0,1,0
20067,1,1,70398,70398,70399,0,1,0
20068,3,1,70401,70401,70402,0,1,2
20069,2,2,70403,70403,70405,0,2,1
20070,1,2,70404,70405,70407,1,3,0
20071,3,1,70407,70407,70408,0,1,0
20072,4,3,70411,70411,70414,0,3,3
20073,1,3,70412,70414,70417,2,5,0
20074,3,2,70415,70417,70419,2,4,0
20075,6,3,70421,70421,70424,0,3,2
20076,1,1,70422,70424,70425,2,3,0
20077,5,1,70427,70427,70428,0,1,2
20078,5,2,70432,70432,70434,0,2,4
20079,6,2,70438,70438,70440,0,2,4
20080,3,1,70441,70441,70442,0,1,1
20081,6,2,70447,70447,70449,0,2,5
20082,3,2,70450,70450,70452,0,2,1
20083,6,3,70456,70456,70459,0,3,4
20084,2,1,70458,70459,70460,1,2,0
20085,4,2,70462,70462,70464,0,2,2
20086,5,2,70467,70467,70469,0,2,3
20087,3,3,70470,70470,70473,0,3,1
20088,3,2,70473,70473,70475,0,2,0
20089,1,1,70474,70475,70476,1,2,0
20090,3,3,70477,70477,70480,0,3,1
20091,3,2,70480,70480,70482,0,2,0
20092,2,1,70482,70482,70483,0,1,0
20093,1,3,70483,70483,70486,0,3,0
20094,6,2,70489,70489,70491,0,2,3
20095,1,3,70490,70491,70494,1,4,0
20096,5,1,70495,70495,70496,0,1,1
20097,1,3,70496,70496,70499,0,3,0
20098,3,2,70499,70499,70501,0,2,0
20099,3,1,70502,70502,70503,0,1,1
20100,4,1,70506,70506,70507,0,1,3
20101,2,3,70508,70508,70511,0,3,1
20102,4,3,70512,70512,70515,0,3,1
20103,4,1,70516,70516,70517,0,1,1
20104,2,1,70518,70518,70519,0,1,1
20105,5,2,70523,70523,70525,0,2,4
20106,5,2,70528,70528,70530,0,2,3
20107,4,1,70532,70532,70533,0,1,2
20108,6,3,70538,70538,70541,0,3,5
20109,2,3,70540,70541,70544,1,4,0
20110,1,1,70541,70544,70545,3,4,0
20111,4,2,70545,70545,70547,0,2,0
20112,6,3,70551,70551,70554,0,3,4
20113,4,2,70555,70555,70557,0,2,1
20114,4,2,70559,70559,70561,0,2,2
20115,4,1,70563,70563,70564,0,1,2
20116,4,2,70567,70567,70569,0,2,3
20117,4,3,70571,70571,70574,0,3,2
20118,1,1,70572,70574,70575,2,3,0
20119,4,3,70576,70576,70579,0,3,1
20120,2,2,70578,70579,70581,1,3,0
20121,6,2,70584,70584,70586,0,2,3
20122,5,1,70589,70589,70590,0,1,3
20123,4,3,70593,70593,70596,0,3,3
20124,5,2,70598,70598,70600,0,2,2
20125,5,2,70603,70603,70605,0,2,3
20126,4,1,70607,70607,70608,0,1,2
20127,5,1,70612,70612,70613,0,1,4
20128,1,3,70613,70613,70616,0,3,0
20129,1,2,70614,70616,70618,2,4,0
20130,5,3,70619,70619,70622,0,3,1
20131,1,2,70620,70622,70624,2,4,0
20132,5,2,70625,70625,70627,0,2,1
20133,3,2,70628,70628,70630,0,2,1
20134,5,2,70633,70633,70635,0,2,3
20135,3,3,70636,70636,70639,0,3,1
20136,3,2,70639,70639,70641,0,2,0
20137,1,2,70640,70641,70643,1,3,0
20138,2,1,70642,70643,70644,1,2,0
20139,5,2,70647,70647,70649,0,2,3
20140,6,2,70653,70653,70655,0,2,4
20141,2,3,70655,70655,70658,0,3,0
20142,6,3,70661,70661,70664,0,3,3
20143,3,1,70664,70664,70665,0,1,0
20144,5,1,70669,70669,70670,0,1,4
20145,1,3,70670,70670,70673,0,3,0
20146,6,1,70676,70676,70677,0,1,3
20147,3,2,70679,70679,70681,0,2,2
20148,6,1,70685,70685,70686,0,1,4
20149,5,2,70690,70690,70692,0,2,4
20150,2,1,70692,70692,70693,0,1,0
20151,2,1,70694,70694,70695,0,1,1
20152,5,2,70699,70699,70701,0,2,4
20153,4,1,70703,70703,70704,0,1,2
20154,6,2,70709,70709,70711,0,2,5
20155,4,2,70713,70713,70715,0,2,2
20156,2,1,70715,70715,70716,0,1,0
20157,6,1,70721,70721,70722,0,1,5
20158,3,2,70724,70724,70726,0,2,2
20159,2,1,70726,70726,70727,0,1,0
20160,5,2,70731,70731,70733,0,2,4
20161,5,3,70736,70736,70739,0,3,3
20162,5,2,70741,70741,70743,0,2,2
20163,1,3,70742,70743,70746,1,4,0
20164,6,2,70748,70748,70750,0,2,2
20165,3,1,70751,70751,70752,0,1,1
20166,5,2,70756,70756,70758,0,2,4
20167,2,3,70758,70758,70761,0,3,0
20168,5,1,70763,70763,70764,0,1,2
20169,4,2,70767,70767,70769,0,2,3
20170,2,2,70769,70769,70771,0,2,0
20171,2,1,70771,70771,70772,0,1,0
20172,2,3,70773,70773,70776,0,3,1
20173,1,1,70774,70776,70777,2,3,0
20174,5,1,70779,70779,70780,0,1,2
20175,2,1,70781,70781,70782,0,1,1
20176,2,1,70783,70783,70784,0,1,1
20177,6,2,70789,70789,70791,0,2,5
20178,3,3,70792,70792,70795,0,3,1
20179,2,2,70794,70795,70797,1,3,0
20180,2,1,70796,70797,70798,1,2,0
20181,4,1,70800,70800,70801,0,1,2
20182,1,3,70801,70801,70804,0,3,0
20183,4,1,70805,70805,70806,0,1,1
20184,1,3,70806,70806,70809,0,3,0
20185,2,1,70808,70809,70810,1,2,0
20186,3,1,70811,70811,70812,0,1,1
20187,6,2,70817,70817,70819,0,2,5
20188,4,1,70821,70821,70822,0,1,2
20189,6,1,70827,70827,70828,0,1,5
20190,4,1,70831,70831,70832,0,1,3
20191,6,2,70837,70837,70839,0,2,5
20192,3,2,70840,70840,70842,0,2,1
20193,4,2,70844,70844,70846,0,2,2
20194,6,2,70850,70850,70852,0,2,4
20195,5,2,70855,70855,70857,0,2,3
20196,4,2,70859,70859,70861,0,2,2
20197,1,2,70860,70861,70863,1,3,0
20198,6,1,70866,70866,70867,0,1,3
20199,2,1,70868,70868,70869,0,1,1
20200,6,3,70874,70874,70877,0,3,5
20201,2,3,70876,70877,70880,1,4,0
20202,4,2,70880,70880,70882,0,2,0
20203,3,2,70883,70883,70885,0,2,1
20204,1,2,70884,70885,70887,1,3,0
20205,6,2,70890,70890,70892,0,2,3
20206,2,1,70892,70892,70893,0,1,0
20207,3,1,70895,70895,70896,0,1,2
20208,4,3,70899,70899,70902,0,3,3
20209,1,2,70900,70902,70904,2,4,0
20210,5,3,70905,70905,70908,0,3,1
20211,4,3,70909,70909,70912,0,3,1
20212,1,2,70910,70912,70914,2,4,0
20213,4,2,70914,70914,70916,0,2,0
20214,2,1,70916,70916,70917,0,1,0
20215,1,3,70917,70917,70920,0,3,0
20216,3,2,70920,70920,70922,0,2,0
20217,1,1,70921,70922,70923,1,2,0
20218,4,2,70925,70925,70927,0,2,2
20219,4,3,70929,70929,70932,0,3,2
20220,2,1,70931,70932,70933,1,2,0
20221,5,1,70936,70936,70937,0,1,3
20222,1,2,70937,70937,70939,0,2,0
20223,6,1,70943,70943,70944,0,1,4
20224,6,2,70949,70949,70951,0,2,5
20225,6,3,70955,70955,70958,0,3,4
20226,4,1,70959,70959,70960,0,1,1
20227,5,3,70964,70964,70967,0,3,4
20228,3,3,70967,70967,70970,0,3,0
20229,4,2,70971,70971,70973,0,2,1
20230,1,3,70972,70973,70976,1,4,0
20231,3,2,70975,70976,70978,1,3,0
20232,5,3,70980,70980,70983,0,3,2
20233,5,2,70985,70985,70987,0,2,2
20234,1,2,70986,70987,70989,1,3,0
20235,1,2,70987,70989,70991,2,4,0
20236,1,3,70988,70991,70994,3,6,0
20237,5,2,70993,70994,70996,1,3,0
20238,5,3,70998,70998,71001,0,3,2
20239,5,3,71003,71003,71006,0,3,2
20240,4,3,71007,71007,71010,0,3,1
20241,1,2,71008,71010,71012,2,4,0
20242,2,1,71010,71012,71013,2,3,0
20243,6,3,71016,71016,71019,0,3,3
20244,4,3,71020,71020,71023,0,3,1
20245,4,3,71024,71024,71027,0,3,1
20246,1,1,71025,71027,71028,2,3,0
20247,4,3,71029,71029,71032,0,3,1
20248,2,2,71031,71032,71034,1,3,0
20249,4,3,71035,71035,71038,0,3,1
20250,1,1,71036,71038,71039,2,3,0
20251,6,3,71042,71042,71045,0,3,3
20252,2,3,71044,71045,71048,1,4,0
20253,5,3,71049,71049,71052,0,3,1
20254,6,1,71055,71055,71056,0,1,3
20255,6,2,71061,71061,71063,0,2,5
20256,1,2,71062,71063,71065,1,3,0
20257,6,1,71068,71068,71069,0,1,3
20258,1,3,71069,71069,71072,0,3,0
20259,1,2,71070,71072,71074,2,4,0
20260,4,2,71074,71074,71076,0,2,0
20261,6,3,71080,71080,71083,0,3,4
20262,4,2,71084,71084,71086,0,2,1
20263,6,3,71090,71090,71093,0,3,4
20264,2,2,71092,71093,71095,1,3,0
20265,6,2,71098,71098,71100,0,2,3
20266,5,2,71103,71103,71105,0,2,3
20267,3,2,71106,71106,71108,0,2,1
20268,6,3,71112,71112,71115,0,3,4
20269,6,2,71118,71118,71120,0,2,3
20270,2,2,71120,71120,71122,0,2,0
20271,6,3,71126,71126,71129,0,3,4
20272,4,3,71130,71130,71133,0,3,1
20273,2,1,71132,71133,71134,1,2,0
20274,3,1,71135,71135,71136,0,1,1
20275,2,2,71137,71137,71139,0,2,1
20276,2,1,71139,71139,71140,0,1,0
20277,2,1,71141,71141,71142,0,1,1
20278,4,2,71145,71145,71147,0,2,3
20279,5,1,71150,71150,71151,0,1,3
20280,2,3,71152,71152,71155,0,3,1
20281,1,2,71153,71155,71157,2,4,0
20282,5,1,71158,71158,71159,0,1,1
20283,6,1,71164,71164,71165,0,1,5
20284,4,1,71168,71168,71169,0,1,3
20285,2,1,71170,71170,71171,0,1,1
20286,3,1,71173,71173,71174,0,1,2
20287,4,2,71177,71177,71179,0,2,3
20288,2,1,71179,71179,71180,0,1,0
20289,4,3,71183,71183,71186,0,3,3
20290,3,2,71186,71186,71188,0,2,0
20291,2,2,71188,71188,71190,0,2,0
20292,1,3,71189,71190,71193,1,4,0
20293,2,3,71191,71193,71196,2,5,0
20294,3,1,71194,71196,71197,2,3,0
20295,5,3,71199,71199,71202,0,3,2
20296,5,1,71204,71204,71205,0,1,2
20297,6,2,71210,71210,71212,0,2,5
20298,1,2,71211,71212,71214,1,3,0
20299,1,3,71212,71214,71217,2,5,0
20300,3,1,71215,71217,71218,2,3,0
20301,3,2,71218,71218,71220,0,2,0
20302,1,3,71219,71220,71223,1,4,0
20303,4,1,71223,71223,71224,0,1,0
20304,3,3,71226,71226,71229,0,3,2
20305,6,3,71232,71232,71235,0,3,3
20306,2,3,71234,71235,71238,1,4,0
20307,2,1,71236,71238,71239,2,3,0
20308,5,3,71241,71241,71244,0,3,2
20309,5,2,71246,71246,71248,0,2,2
20310,3,3,71249,71249,71252,0,3,1
20311,4,2,71253,71253,71255,0,2,1
20312,1,3,71254,71255,71258,1,4,0
20313,4,2,71258,71258,71260,0,2,0
20314,6,3,71264,71264,71267,0,3,4
20315,3,1,71267,71267,71268,0,1,0
20316,1,2,71268,71268,71270,0,2,0
20317,1,2,71269,71270,71272,1,3,0
20318,5,2,71274,71274,71276,0,2,2
20319,5,1,71279,71279,71280,0,1,3
20320,4,2,71283,71283,71285,0,2,3
20321,1,1,71284,71285,71286,1,2,0
20322,6,2,71290,71290,71292,0,2,4
20323,5,3,71295,71295,71298,0,3,3
20324,4,2,71299,71299,71301,0,2,1
20325,3,3,71302,71302,71305,0,3,1
20326,5,1,71307,71307,71308,0,1,2
20327,3,2,71310,71310,71312,0,2,2
20328,4,2,71314,71314,71316,0,2,2
20329,3,2,71317,71317,71319,0,2,1
20330,6,1,71323,71323,71324,0,1,4
20331,2,2,71325,71325,71327,0,2,1
20332,6,1,71331,71331,71332,0,1,4
20333,4,3,71335,71335,71338,0,3,3
20334,5,3,71340,71340,71343,0,3,2
20335,4,3,71344,71344,71347,0,3,1
20336,1,1,71345,71347,71348,2,3,0
20337,5,3,71350,71350,71353,0,3,2
20338,1,3,71351,71353,71356,2,5,0
20339,1,2,71352,71356,71358,4,6,0
20340,2,1,71354,71358,71359,4,5,0
20341,5,2,71359,71359,71361,0,2,0
20342,2,1,71361,71361,71362,0,1,0
20343,2,2,71363,71363,71365,0,2,1
20344,4,2,71367,71367,71369,0,2,2
20345,6,2,71373,71373,71375,0,2,4
20346,6,1,71379,71379,71380,0,1,4
20347,4,2,71383,71383,71385,0,2,3
20348,6,3,71389,71389,71392,0,3,4
20349,6,2,71395,71395,71397,0,2,3
20350,5,1,71400,71400,71401,0,1,3
20351,1,3,71401,71401,71404,0,3,0
20352,2,3,71403,71404,71407,1,4,0
20353,5,3,71408,71408,71411,0,3,1
20354,6,1,71414,71414,71415,0,1,3
20355,4,2,71418,71418,71420,0,2,3
20356,2,3,71420,71420,71423,0,3,0
20357,6,3,71426,71426,71429,0,3,3
20358,5,1,71431,71431,71432,0,1,2
20359,6,2,71437,71437,71439,0,2,5
20360,2,2,71439,71439,71441,0,2,0
20361,5,2,71444,71444,71446,0,2,3
20362,5,2,71449,71449,71451,0,2,3
20363,2,1,71451,71451,71452,0,1,0
20364,1,1,71452,71452,71453,0,1,0
20365,3,2,71455,71455,71457,0,2,2
20366,5,1,71460,71460,71461,0,1,3
20367,5,1,71465,71465,71466,0,1,4
20368,3,1,71468,71468,71469,0,1,2
20369,1,3,71469,71469,71472,0,3,0
20370,5,2,71474,71474,71476,0,2,2
20371,2,3,71476,71476,71479,0,3,0
20372,1,1,71477,71479,71480,2,3,0
20373,4,1,71481,71481,71482,0,1,1
20374,2,1,71483,71483,71484,0,1,1
20375,3,3,71486,71486,71489,0,3,2
20376,1,2,71487,71489,71491,2,4,0
20377,6,2,71493,71493,71495,0,2,2
20378,5,1,71498,71498,71499,0,1,3
20379,4,3,71502,71502,71505,0,3,3
20380,1,1,71503,71505,71506,2,3,0
20381,5,3,71508,71508,71511,0,3,2
20382,4,3,71512,71512,71515,0,3,1
20383,4,1,71516,71516,71517,0,1,1
20384,1,2,71517,71517,71519,0,2,0
20385,3,3,71520,71520,71523,0,3,1
20386,2,1,71522,71523,71524,1,2,0
20387,6,3,71528,71528,71531,0,3,4
20388,4,3,71532,71532,71535,0,3,1
20389,2,1,71534,71535,71536,1,2,0
20390,3,2,71537,71537,71539,0,2,1
20391,1,3,71538,71539,71542,1,4,0
20392,2,3,71540,71542,71545,2,5,0
20393,6,2,71546,71546,71548,0,2,1
20394,1,1,71547,71548,71549,1,2,0
20395,4,1,71551,71551,71552,0,1,2
20396,3,2,71554,71554,71556,0,2,2
20397,6,3,71560,71560,71563,0,3,4
20398,2,2,71562,71563,71565,1,3,0
20399,2,3,71564,71565,71568,1,4,0
20400,6,1,71570,71570,71571,0,1,2
20401,6,1,71576,71576,71577,0,1,5
20402,6,3,71582,71582,71585,0,3,5
20403,6,1,71588,71588,71589,0,1,3
20404,4,3,71592,71592,71595,0,3,3
20405,2,1,71594,71595,71596,1,2,0
20406,1,1,71595,71596,71597,1,2,0
20407,2,1,71597,71597,71598,0,1,0
20408,4,2,71601,71601,71603,0,2,3
20409,1,1,71602,71603,71604,1,2,0
20410,6,1,71608,71608,71609,0,1,4
20411,6,3,71614,71614,71617,0,3,5
20412,3,3,71617,71617,71620,0,3,0
20413,4,1,71621,71621,71622,0,1,1
20414,2,2,71623,71623,71625,0,2,1
20415,5,1,71628,71628,71629,0,1,3
20416,2,3,71630,71630,71633,0,3,1
20417,4,3,71634,71634,71637,0,3,1
20418,1,2,71635,71637,71639,2,4,0
20419,3,3,71638,71639,71642,1,4,0
20420,4,3,71642,71642,71645,0,3,0
20421,5,1,71647,71647,71648,0,1,2
20422,2,3,71649,71649,71652,0,3,1
20423,2,2,71651,71652,71654,1,3,0
20424,5,2,71656,71656,71658,0,2,2
20425,3,1,71659,71659,71660,0,1,1
20426,1,2,71660,71660,71662,0,2,0
20427,6,3,71666,71666,71669,0,3,4
20428,5,1,71671,71671,71672,0,1,2
20429,6,3,71677,71677,71680,0,3,5
20430,6,3,71683,71683,71686,0,3,3
20431,6,2,71689,71689,71691,0,2,3
20432,5,2,71694,71694,71696,0,2,3
20433,1,3,71695,71696,71699,1,4,0
20434,6,1,71701,71701,71702,0,1,2
20435,4,2,71705,71705,71707,0,2,3
20436,2,3,71707,71707,71710,0,3,0
20437,2,1,71709,71710,71711,1,2,0
20438,2,1,71711,71711,71712,0,1,0
20439,5,2,71716,71716,71718,0,2,4
20440,5,1,71721,71721,71722,0,1,3
20441,1,3,71722,71722,71725,0,3,0
20442,2,2,71724,71725,71727,1,3,0
20443,2,2,71726,71727,71729,1,3,0
20444,4,2,71730,71730,71732,0,2,1
20445,1,2,71731,71732,71734,1,3,0
20446,1,3,71732,71734,71737,2,5,0
20447,4,1,71736,71737,71738,1,2,0
20448,3,1,71739,71739,71740,0,1,1
20449,3,1,71742,71742,71743,0,1,2
20450,6,1,71748,71748,71749,0,1,5
20451,3,3,71751,71751,71754,0,3,2
20452,2,3,71753,71754,71757,1,4,0
20453,5,2,71758,71758,71760,0,2,1
20454,2,1,71760,71760,71761,0,1,0
20455,5,1,71765,71765,71766,0,1,4
20456,3,2,71768,71768,71770,0,2,2
20457,2,1,71770,71770,71771,0,1,0
20458,1,2,71771,71771,71773,0,2,0
20459,1,3,71772,71773,71776,1,4,0
20460,3,1,71775,71776,71777,1,2,0
20461,5,3,71780,71780,71783,0,3,3
20462,5,2,71785,71785,71787,0,2,2
20463,4,1,71789,71789,71790,0,1,2
20464,3,3,71792,71792,71795,0,3,2
20465,3,2,71795,71795,71797,0,2,0
20466,6,3,71801,71801,71804,0,3,4
20467,4,3,71805,71805,71808,0,3,1
20468,2,3,71807,71808,71811,1,4,0
20469,3,3,71810,71811,71814,1,4,0
20470,5,2,71815,71815,71817,0,2,1
20471,2,1,71817,71817,71818,0,1,0
20472,1,3,71818,71818,71821,0,3,0
20473,3,3,71821,71821,71824,0,3,0
20474,2,3,71823,71824,71827,1,4,0
20475,1,1,71824,71827,71828,3,4,0
20476,2,3,71826,71828,71831,2,5,0
20477,5,1,71831,71831,71832,0,1,0
20478,1,2,71832,71832,71834,0,2,0
20479,6,1,71838,71838,71839,0,1,4
20480,5,1,71843,71843,71844,0,1,4
20481,4,1,71847,71847,71848,0,1,3
20482,4,2,71851,71851,71853,0,2,3
20483,5,2,71856,71856,71858,0,2,3
20484,1,2,71857,71858,71860,1,3,0
20485,1,3,71858,71860,71863,2,5,0
20486,2,3,71860,71863,71866,3,6,0
20487,2,1,71862,71866,71867,4,5,0
20488,3,2,71865,71867,71869,2,4,0
20489,1,2,71866,71869,71871,3,5,0
20490,1,2,71867,71871,71873,4,6,0
20491,2,3,71869,71873,71876,4,7,0
20492,2,3,71871,71876,71879,5,8,0
20493,5,1,71876,71879,71880,3,4,0
20494,2,2,71878,71880,71882,2,4,0
20495,2,2,71880,71882,71884,2,4,0
20496,2,1,71882,71884,71885,2,3,0
20497,6,2,71888,71888,71890,0,2,3
20498,3,3,71891,71891,71894,0,3,1
20499,1,1,71892,71894,71895,2,3,0
20500,2,1,71894,71895,71896,1,2,0
20501,3,1,71897,71897,71898,0,1,1
20502,2,3,71899,71899,71902,0,3,1
20503,1,1,71900,71902,71903,2,3,0
20504,5,3,71905,71905,71908,0,3,2
20505,1,1,71906,71908,71909,2,3,0
20506,5,3,71911,71911,71914,0,3,2
20507,4,2,71915,71915,71917,0,2,1
20508,1,3,71916,71917,71920,1,4,0
20509,4,1,71920,71920,71921,0,1,0
20510,6,1,71926,71926,71927,0,1,5
20511,6,2,71932,71932,71934,0,2,5
20512,3,2,71935,71935,71937,0,2,1
20513,4,1,71939,71939,71940,0,1,2
20514,5,2,71944,71944,71946,0,2,4
20515,2,3,71946,71946,71949,0,3,0
20516,2,1,71948,71949,71950,1,2,0
20517,2,3,71950,71950,71953,0,3,0
20518,2,2,71952,71953,71955,1,3,0
20519,6,2,71958,71958,71960,0,2,3
20520,4,3,71962,71962,71965,0,3,2
20521,2,2,71964,71965,71967,1,3,0
20522,5,3,71969,71969,71972,0,3,2
20523,5,1,71974,71974,71975,0,1,2
20524,2,3,71976,71976,71979,0,3,1
20525,1,3,71977,71979,71982,2,5,0
20526,3,3,71980,71982,71985,2,5,0
20527,5,3,71985,71985,71988,0,3,0
20528,4,2,71989,71989,71991,0,2,1
20529,2,2,71991,71991,71993,0,2,0
20530,4,2,71995,71995,71997,0,2,2
20531,3,2,71998,71998,72000,0,2,1
20532,5,3,72003,72003,72006,0,3,3
20533,6,1,72009,72009,72010,0,1,3
20534,1,1,72010,72010,72011,0,1,0
20535,2,2,72012,72012,72014,0,2,1
20536,1,3,72013,72014,72017,1,4,0
20537,1,3,72014,72017,72020,3,6,0
20538,6,1,72020,72020,72021,0,1,0
20539,6,3,72026,72026,72029,0,3,5
20540,6,3,72032,72032,72035,0,3,3
20541,3,1,72035,72035,72036,0,1,0
20542,6,2,72041,72041,72043,0,2,5
20543,6,2,72047,72047,72049,0,2,4
20544,6,3,72053,72053,72056,0,3,4
20545,1,3,72054,72056,72059,2,5,0
20546,4,1,72058,72059,72060,1,2,0
20547,6,2,72064,72064,72066,0,2,4
20548,4,3,72068,72068,72071,0,3,2
20549,1,1,72069,72071,72072,2,3,0
20550,4,3,72073,72073,72076,0,3,1
20551,6,3,72079,72079,72082,0,3,3
20552,3,2,72082,72082,72084,0,2,0
20553,4,3,72086,72086,72089,0,3,2
20554,3,3,72089,72089,72092,0,3,0
20555,5,1,72094,72094,72095,0,1,2
20556,1,1,72095,72095,72096,0,1,0
20557,1,3,72096,72096,72099,0,3,0
20558,3,3,72099,72099,72102,0,3,0
20559,4,3,72103,72103,72106,0,3,1
20560,4,3,72107,72107,72110,0,3,1
20561,3,3,72110,72110,72113,0,3,0
20562,2,1,72112,72113,72114,1,2,0
20563,5,3,72117,72117,72120,0,3,3
20564,4,3,72121,72121,72124,0,3,1
20565,6,2,72127,72127,72129,0,2,3
20566,4,1,72131,72131,72132,0,1,2
20567,5,3,72136,72136,72139,0,3,4
20568,4,2,72140,72140,72142,0,2,1
20569,2,3,72142,72142,72145,0,3,0
20570,3,1,72145,72145,72146,0,1,0
20571,6,2,72151,72151,72153,0,2,5
20572,2,1,72153,72153,72154,0,1,0
20573,1,3,72154,72154,72157,0,3,0
20574,5,1,72159,72159,72160,0,1,2
20575,4,1,72163,72163,72164,0,1,3
20576,1,3,72164,72164,72167,0,3,0
20577,1,1,72165,72167,72168,2,3,0
20578,6,2,72171,72171,72173,0,2,3
20579,1,1,72172,72173,72174,1,2,0
20580,3,2,72175,72175,72177,0,2,1
20581,5,1,72180,72180,72181,0,1,3
20582,5,2,72185,72185,72187,0,2,4
20583,2,1,72187,72187,72188,0,1,0
20584,6,1,72193,72193,72194,0,1,5
20585,3,1,72196,72196,72197,0,1,2
20586,1,3,72197,72197,72200,0,3,0
20587,1,3,72198,72200,72203,2,5,0
20588,5,1,72203,72203,72204,0,1,0
20589,4,3,72207,72207,72210,0,3,3
20590,3,1,72210,72210,72211,0,1,0
20591,2,1,72212,72212,72213,0,1,1
20592,5,2,72217,72217,72219,0,2,4
20593,1,3,72218,72219,72222,1,4,0
20594,2,1,72220,72222,72223,2,3,0
20595,1,3,72221,72223,72226,2,5,0
20596,5,2,72226,72226,72228,0,2,0
20597,6,1,72232,72232,72233,0,1,4
20598,2,3,72234,72234,72237,0,3,1
20599,1,1,72235,72237,72238,2,3,0
20600,3,1,72238,72238,72239,0,1,0
20601,1,1,72239,72239,72240,0,1,0
20602,3,1,72242,72242,72243,0,1,2
20603,3,1,72245,72245,72246,0,1,2
20604,1,2,72246,72246,72248,0,2,0
20605,1,3,72247,72248,72251,1,4,0
20606,5,1,72252,72252,72253,0,1,1
20607,5,3,72257,72257,72260,0,3,4
20608,5,3,72262,72262,72265,0,3,2
20609,2,3,72264,72265,72268,1,4,0
20610,4,1,72268,72268,72269,0,1,0
20611,3,3,72271,72271,72274,0,3,2
20612,2,2,72273,72274,72276,1,3,0
20613,6,2,72279,72279,72281,0,2,3
20614,6,2,72285,72285,72287,0,2,4
20615,5,3,72290,72290,72293,0,3,3
20616,1,3,72291,72293,72296,2,5,0
20617,5,1,72296,72296,72297,0,1,0
20618,4,1,72300,72300,72301,0,1,3
20619,5,1,72305,72305,72306,0,1,4
20620,2,2,72307,72307,72309,0,2,1
20621,2,2,72309,72309,72311,0,2,0
20622,5,3,72314,72314,72317,0,3,3
20623,5,2,72319,72319,72321,0,2,2
20624,1,1,72320,72321,72322,1,2,0
20625,2,2,72322,72322,72324,0,2,0
20626,5,1,72327,72327,72328,0,1,3
20627,4,2,72331,72331,72333,0,2,3
20628,1,3,72332,72333,72336,1,4,0
20629,4,1,72336,72336,72337,0,1,0
20630,4,2,72340,72340,72342,0,2,3
20631,1,3,72341,72342,72345,1,4,0
20632,6,3,72347,72347,72350,0,3,2
20633,4,2,72351,72351,72353,0,2,1
20634,5,2,72356,72356,72358,0,2,3
20635,1,2,72357,72358,72360,1,3,0
20636,1,3,72358,72360,72363,2,5,0
20637,6,1,72364,72364,72365,0,1,1
20638,1,1,72365,72365,72366,0,1,0
20639,6,1,72371,72371,72372,0,1,5
20640,1,1,72372,72372,72373,0,1,0
20641,4,2,72376,72376,72378,0,2,3
20642,4,2,72380,72380,72382,0,2,2
20643,5,3,72385,72385,72388,0,3,3
20644,4,3,72389,72389,72392,0,3,1
20645,1,1,72390,72392,72393,2,3,0
20646,1,3,72391,72393,72396,2,5,0
20647,6,3,72397,72397,72400,0,3,1
20648,2,3,72399,72400,72403,1,4,0
20649,3,1,72402,72403,72404,1,2,0
20650,4,1,72406,72406,72407,0,1,2
20651,5,3,72411,72411,72414,0,3,4
20652,2,1,72413,72414,72415,1,2,0
20653,6,3,72419,72419,72422,0,3,4
20654,6,3,72425,72425,72428,0,3,3
20655,3,1,72428,72428,72429,0,1,0
20656,1,3,72429,72429,72432,0,3,0
20657,3,3,72432,72432,72435,0,3,0
20658,2,1,72434,72435,72436,1,2,0
20659,3,3,72437,72437,72440,0,3,1
20660,5,2,72442,72442,72444,0,2,2
20661,4,1,72446,72446,72447,0,1,2
20662,6,3,72452,72452,72455,0,3,5
20663,6,1,72458,72458,72459,0,1,3
20664,5,3,72463,72463,72466,0,3,4
20665,4,1,72467,72467,72468,0,1,1
20666,6,2,72473,72473,72475,0,2,5
20667,2,2,72475,72475,72477,0,2,0
20668,4,1,72479,72479,72480,0,1,2
20669,2,1,72481,72481,72482,0,1,1
20670,3,2,72484,72484,72486,0,2,2
20671,4,3,72488,72488,72491,0,3,2
20672,6,1,72494,72494,72495,0,1,3
20673,2,2,72496,72496,72498,0,2,1
20674,5,1,72501,72501,72502,0,1,3
20675,6,3,72507,72507,72510,0,3,5
20676,5,3,72512,72512,72515,0,3,2
20677,6,1,72518,72518,72519,0,1,3
20678,5,2,72523,72523,72525,0,2,4
20679,1,2,72524,72525,72527,1,3,0
20680,1,2,72525,72527,72529,2,4,0
20681,5,1,72530,72530,72531,0,1,1
20682,5,1,72535,72535,72536,0,1,4
20683,6,3,72541,72541,72544,0,3,5
20684,1,1,72542,72544,72545,2,3,0
20685,6,1,72548,72548,72549,0,1,3
20686,5,1,72553,72553,72554,0,1,4
20687,4,2,72557,72557,72559,0,2,3
20688,1,1,72558,72559,72560,1,2,0
20689,6,1,72564,72564,72565,0,1,4
20690,2,3,72566,72566,72569,0,3,1
20691,3,2,72569,72569,72571,0,2,0
20692,6,2,72575,72575,72577,0,2,4
20693,6,3,72581,72581,72584,0,3,4
20694,5,3,72586,72586,72589,0,3,2
20695,5,2,72591,72591,72593,0,2,2
20696,4,3,72595,72595,72598,0,3,2
20697,5,3,72600,72600,72603,0,3,2
20698,3,1,72603,72603,72604,0,1,0
20699,2,1,72605,72605,72606,0,1,1
20700,1,2,72606,72606,72608,0,2,0
20701,6,2,72612,72612,72614,0,2,4
20702,5,2,72617,72617,72619,0,2,3
20703,4,1,72621,72621,72622,0,1,2
20704,2,3,72623,72623,72626,0,3,1
20705,6,3,72629,72629,72632,0,3,3
20706,5,2,72634,72634,72636,0,2,2
20707,2,2,72636,72636,72638,0,2,0
20708,1,3,72637,72638,72641,1,4,0
20709,5,3,72642,72642,72645,0,3,1
20710,5,2,72647,72647,72649,0,2,2
20711,3,3,72650,72650,72653,0,3,1
20712,5,1,72655,72655,72656,0,1,2
20713,6,1,72661,72661,72662,0,1,5
20714,4,2,72665,72665,72667,0,2,3
20715,2,3,72667,72667,72670,0,3,0
20716,4,3,72671,72671,72674,0,3,1
20717,3,3,72674,72674,72677,0,3,0
20718,5,3,72679,72679,72682,0,3,2
20719,1,1,72680,72682,72683,2,3,0
20720,2,3,72682,72683,72686,1,4,0
20721,5,1,72687,72687,72688,0,1,1
20722,3,3,72690,72690,72693,0,3,2
20723,1,3,72691,72693,72696,2,5,0
20724,4,2,72695,72696,72698,1,3,0
20725,4,1,72699,72699,72700,0,1,1
20726,5,2,72704,72704,72706,0,2,4
20727,6,1,72710,72710,72711,0,1,4
20728,2,3,72712,72712,72715,0,3,1
20729,1,2,72713,72715,72717,2,4,0
20730,6,1,72719,72719,72720,0,1,2
20731,3,1,72722,72722,72723,0,1,2
20732,1,2,72723,72723,72725,0,2,0
20733,5,3,72728,72728,72731,0,3,3
20734,2,1,72730,72731,72732,1,2,0
20735,5,1,72735,72735,72736,0,1,3
20736,6,2,72741,72741,72743,0,2,5
20737,4,2,72745,72745,72747,0,2,2
20738,2,1,72747,72747,72748,0,1,0
20739,3,3,72750,72750,72753,0,3,2
20740,5,2,72755,72755,72757,0,2,2
20741,4,3,72759,72759,72762,0,3,2
20742,2,1,72761,72762,72763,1,2,0
20743,3,1,72764,72764,72765,0,1,1
20744,6,2,72770,72770,72772,0,2,5
20745,1,3,72771,72772,72775,1,4,0
20746,6,3,72777,72777,72780,0,3,2
20747,1,2,72778,72780,72782,2,4,0
20748,6,3,72784,72784,72787,0,3,2
20749,3,3,72787,72787,72790,0,3,0
20750,5,2,72792,72792,72794,0,2,2
20751,1,3,72793,72794,72797,1,4,0
20752,4,1,72797,72797,72798,0,1,0
20753,4,3,72801,72801,72804,0,3,3
20754,2,1,72803,72804,72805,1,2,0
20755,2,1,72805,72805,72806,0,1,0
20756,3,1,72808,72808,72809,0,1,2
20757,5,1,72813,72813,72814,0,1,4
20758,1,1,72814,72814,72815,0,1,0
20759,4,2,72818,72818,72820,0,2,3
20760,1,2,72819,72820,72822,1,3,0
20761,4,1,72823,72823,72824,0,1,1
20762,3,1,72826,72826,72827,0,1,2
20763,2,3,72828,72828,72831,0,3,1
20764,2,2,72830,72831,72833,1,3,0
20765,3,1,72833,72833,72834,0,1,0
20766,4,1,72837,72837,72838,0,1,3
20767,1,1,72838,72838,72839,0,1,0
20768,3,1,72841,72841,72842,0,1,2
20769,6,1,72847,72847,72848,0,1,5
20770,4,2,72851,72851,72853,0,2,3
20771,2,1,72853,72853,72854,0,1,0
20772,3,3,72856,72856,72859,0,3,2
20773,5,2,72861,72861,72863,0,2,2
20774,4,2,72865,72865,72867,0,2,2
20775,2,2,72867,72867,72869,0,2,0
20776,3,2,72870,72870,72872,0,2,1
20777,3,3,72873,72873,72876,0,3,1
20778,5,2,72878,72878,72880,0,2,2
20779,1,3,72879,72880,72883,1,4,0
20780,2,1,72881,72883,72884,2,3,0
20781,2,2,72883,72884,72886,1,3,0
20782,2,3,72885,72886,72889,1,4,0
20783,5,3,72890,72890,72893,0,3,1
20784,1,1,72891,72893,72894,2,3,0
20785,2,2,72893,72894,72896,1,3,0
20786,5,3,72898,72898,72901,0,3,2
20787,6,2,72904,72904,72906,0,2,3
20788,1,3,72905,72906,72909,1,4,0
20789,3,2,72908,72909,72911,1,3,0
20790,6,3,72914,72914,72917,0,3,3
20791,6,1,72920,72920,72921,0,1,3
20792,4,3,72924,72924,72927,0,3,3
20793,5,3,72929,72929,72932,0,3,2
20794,5,1,72934,72934,72935,0,1,2
20795,2,1,72936,72936,72937,0,1,1
20796,6,1,72942,72942,72943,0,1,5
20797,2,3,72944,72944,72947,0,3,1
20798,1,2,72945,72947,72949,2,4,0
20799,5,3,72950,72950,72953,0,3,1
20800,6,2,72956,72956,72958,0,2,3
20801,4,1,72960,72960,72961,0,1,2
20802,1,2,72961,72961,72963,0,2,0
20803,2,1,72963,72963,72964,0,1,0
20804,2,3,72965,72965,72968,0,3,1
20805,3,3,72968,72968,72971,0,3,0
20806,1,1,72969,72971,72972,2,3,0
20807,1,1,72970,72972,72973,2,3,0
20808,3,2,72973,72973,72975,0,2,0
20809,6,2,72979,72979,72981,0,2,4
20810,4,3,72983,72983,72986,0,3,2
20811,2,3,72985,72986,72989,1,4,0
20812,2,2,72987,72989,72991,2,4,0
20813,1,3,72988,72991,72994,3,6,0
20814,2,2,72990,72994,72996,4,6,0
20815,2,1,72992,72996,72997,4,5,0
20816,5,3,72997,72997,73000,0,3,0
20817,6,3,73003,73003,73006,0,3,3
20818,1,1,73004,73006,73007,2,3,0
20819,1,1,73005,73007,73008,2,3,0
20820,2,2,73007,73008,73010,1,3,0
20821,2,2,73009,73010,73012,1,3,0
20822,3,3,73012,73012,73015,0,3,0
20823,3,1,73015,73015,73016,0,1,0
20824,2,2,73017,73017,73019,0,2,1
20825,5,1,73022,73022,73023,0,1,3
20826,4,3,73026,73026,73029,0,3,3
20827,2,1,73028,73029,73030,1,2,0
20828,5,2,73033,73033,73035,0,2,3
20829,3,3,73036,73036,73039,0,3,1
20830,5,2,73041,73041,73043,0,2,2
20831,5,3,73046,73046,73049,0,3,3
20832,5,1,73051,73051,73052,0,1,2
20833,4,3,73055,73055,73058,0,3,3
20834,6,1,73061,73061,73062,0,1,3
20835,6,2,73067,73067,73069,0,2,5
20836,2,3,73069,73069,73072,0,3,0
20837,5,3,73074,73074,73077,0,3,2
20838,3,3,73077,73077,73080,0,3,0
20839,3,1,73080,73080,73081,0,1,0
20840,5,3,73085,73085,73088,0,3,4
20841,1,3,73086,73088,73091,2,5,0
20842,2,2,73088,73091,73093,3,5,0
20843,6,2,73094,73094,73096,0,2,1
20844,4,1,73098,73098,73099,0,1,2
20845,4,1,73102,73102,73103,0,1,3
20846,3,2,73105,73105,73107,0,2,2
20847,6,3,73111,73111,73114,0,3,4
20848,6,2,73117,73117,73119,0,2,3
20849,6,2,73123,73123,73125,0,2,4
20850,4,3,73127,73127,73130,0,3,2
20851,5,1,73132,73132,73133,0,1,2
20852,2,2,73134,73134,73136,0,2,1
20853,2,2,73136,73136,73138,0,2,0
20854,6,3,73142,73142,73145,0,3,4
20855,1,2,73143,73145,73147,2,4,0
20856,1,1,73144,73147,73148,3,4,0
20857,4,2,73148,73148,73150,0,2,0
20858,4,2,73152,73152,73154,0,2,2
20859,2,1,73154,73154,73155,0,1,0
20860,6,2,73160,73160,73162,0,2,5
20861,4,1,73164,73164,73165,0,1,2
20862,3,2,73167,73167,73169,0,2,2
20863,4,3,73171,73171,73174,0,3,2
20864,3,1,73174,73174,73175,0,1,0
20865,6,2,73180,73180,73182,0,2,5
20866,6,3,73186,73186,73189,0,3,4
20867,2,1,73188,73189,73190,1,2,0
20868,1,1,73189,73190,73191,1,2,0
20869,2,1,73191,73191,73192,0,1,0
20870,3,1,73194,73194,73195,0,1,2
20871,2,1,73196,73196,73197,0,1,1
20872,4,2,73200,73200,73202,0,2,3
20873,2,2,73202,73202,73204,0,2,0
20874,1,1,73203,73204,73205,1,2,0
20875,6,3,73209,73209,73212,0,3,4
20876,1,1,73210,73212,73213,2,3,0
20877,2,2,73212,73213,73215,1,3,0
20878,4,3,73216,73216,73219,0,3,1
20879,4,2,73220,73220,73222,0,2,1
20880,5,2,73225,73225,73227,0,2,3
20881,3,2,73228,73228,73230,0,2,1
20882,5,3,73233,73233,73236,0,3,3
20883,3,3,73236,73236,73239,0,3,0
20884,2,1,73238,73239,73240,1,2,0
20885,6,1,73244,73244,73245,0,1,4
20886,2,3,73246,73246,73249,0,3,1
20887,6,3,73252,73252,73255,0,3,3
20888,4,2,73256,73256,73258,0,2,1
20889,1,2,73257,73258,73260,1,3,0
20890,3,2,73260,73260,73262,0,2,0
20891,3,3,73263,73263,73266,0,3,1
20892,1,3,73264,73266,73269,2,5,0
20893,2,3,73266,73269,73272,3,6,0
20894,4,2,73270,73272,73274,2,4,0
20895,1,1,73271,73274,73275,3,4,0
20896,5,3,73276,73276,73279,0,3,1
20897,3,2,73279,73279,73281,0,2,0
20898,5,1,73284,73284,73285,0,1,3
20899,1,1,73285,73285,73286,0,1,0
20900,2,2,73287,73287,73289,0,2,1
20901,1,3,73288,73289,73292,1,4,0
20902,2,2,73290,73292,73294,2,4,0
20903,3,2,73293,73294,73296,1,3,0
20904,5,3,73298,73298,73301,0,3,2
20905,2,3,73300,73301,73304,1,4,0
20906,4,2,73304,73304,73306,0,2,0
20907,5,3,73309,73309,73312,0,3,3
20908,2,1,73311,73312,73313,1,2,0
20909,3,3,73314,73314,73317,0,3,1
20910,4,2,73318,73318,73320,0,2,1
20911,4,3,73322,73322,73325,0,3,2
20912,4,3,73326,73326,73329,0,3,1
20913,2,1,73328,73329,73330,1,2,0
20914,6,2,73334,73334,73336,0,2,4
20915,6,3,73340,73340,73343,0,3,4
20916,4,3,73344,73344,73347,0,3,1
20917,3,3,73347,73347,73350,0,3,0
20918,6,3,73353,73353,73356,0,3,3
20919,4,3,73357,73357,73360,0,3,1
20920,5,3,73362,73362,73365,0,3,2
20921,6,3,73368,73368,73371,0,3,3
20922,2,2,73370,73371,73373,1,3,0
20923,3,2,73373,73373,73375,0,2,0
20924,1,2,73374,73375,73377,1,3,0
20925,1,1,73375,73377,73378,2,3,0
20926,6,2,73381,73381,73383,0,2,3
20927,6,2,73387,73387,73389,0,2,4
20928,4,1,73391,73391,73392,0,1,2
20929,1,2,73392,73392,73394,0,2,0
20930,1,2,73393,73394,73396,1,3,0
20931,3,1,73396,73396,73397,0,1,0
20932,5,1,73401,73401,73402,0,1,4
20933,4,1,73405,73405,73406,0,1,3
20934,4,3,73409,73409,73412,0,3,3
20935,5,3,73414,73414,73417,0,3,2
20936,6,2,73420,73420,73422,0,2,3
20937,6,3,73426,73426,73429,0,3,4
20938,5,3,73431,73431,73434,0,3,2
20939,2,1,73433,73434,73435,1,2,0
20940,2,1,73435,73435,73436,0,1,0
20941,6,2,73441,73441,73443,0,2,5
20942,1,2,73442,73443,73445,1,3,0
20943,5,2,73447,73447,73449,0,2,2
20944,1,1,73448,73449,73450,1,2,0
20945,3,1,73451,73451,73452,0,1,1
20946,3,3,73454,73454,73457,0,3,2
20947,5,2,73459,73459,73461,0,2,2
20948,6,1,73465,73465,73466,0,1,4
20949,1,2,73466,73466,73468,0,2,0
20950,3,3,73469,73469,73472,0,3,1
20951,1,3,73470,73472,73475,2,5,0
20952,5,2,73475,73475,73477,0,2,0
20953,4,3,73479,73479,73482,0,3,2
20954,1,3,73480,73482,73485,2,5,0
20955,1,1,73481,73485,73486,4,5,0
20956,4,1,73485,73486,73487,1,2,0
20957,6,3,73491,73491,73494,0,3,4
20958,2,2,73493,73494,73496,1,3,0
20959,3,3,73496,73496,73499,0,3,0
20960,4,3,73500,73500,73503,0,3,1
20961,5,1,73505,73505,73506,0,1,2
20962,3,3,73508,73508,73511,0,3,2
20963,5,1,73513,73513,73514,0,1,2
20964,6,1,73519,73519,73520,0,1,5
20965,5,2,73524,73524,73526,0,2,4
20966,2,2,73526,73526,73528,0,2,0
20967,4,3,73530,73530,73533,0,3,2
20968,2,3,73532,73533,73536,1,4,0
20969,4,1,73536,73536,73537,0,1,0
20970,3,3,73539,73539,73542,0,3,2
20971,5,2,73544,73544,73546,0,2,2
20972,1,1,73545,73546,73547,1,2,0
20973,3,3,73548,73548,73551,0,3,1
20974,2,1,73550,73551,73552,1,2,0
20975,6,3,73556,73556,73559,0,3,4
20976,4,1,73560,73560,73561,0,1,1
20977,5,2,73565,73565,73567,0,2,4
20978,4,3,73569,73569,73572,0,3,2
20979,5,1,73574,73574,73575,0,1,2
20980,4,1,73578,73578,73579,0,1,3
20981,3,1,73581,73581,73582,0,1,2
20982,4,2,73585,73585,73587,0,2,3
20983,2,2,73587,73587,73589,0,2,0
20984,4,3,73591,73591,73594,0,3,2
20985,6,3,73597,73597,73600,0,3,3
20986,6,2,73603,73603,73605,0,2,3
20987,6,3,73609,73609,73612,0,3,4
20988,3,1,73612,73612,73613,0,1,0
20989,3,1,73615,73615,73616,0,1,2
20990,6,1,73621,73621,73622,0,1,5
20991,3,1,73624,73624,73625,0,1,2
20992,5,3,73629,73629,73632,0,3,4
20993,1,2,73630,73632,73634,2,4,0
20994,1,1,73631,73634,73635,3,4,0
20995,5,3,73636,73636,73639,0,3,1
20996,6,3,73642,73642,73645,0,3,3
20997,5,2,73647,73647,73649,0,2,2
20998,1,1,73648,73649,73650,1,2,0
20999,6,2,73654,73654,73656,0,2,4
21000,2,3,73656,73656,73659,0,3,0
21001,3,1,73659,73659,73660,0,1,0
21002,3,3,73662,73662,73665,0,3,2
21003,4,1,73666,73666,73667,0,1,1
21004,3,3,73669,73669,73672,0,3,2
21005,3,1,73672,73672,73673,0,1,0
21006,6,3,73678,73678,73681,0,3,5
21007,2,3,73680,73681,73684,1,4,0
21008,4,3,73684,73684,73687,0,3,0
21009,2,3,73686,73687,73690,1,4,0
21010,2,2,73688,73690,73692,2,4,0
21011,6,2,73694,73694,73696,0,2,2
21012,1,3,73695,73696,73699,1,4,0
21013,3,1,73698,73699,73700,1,2,0
21014,6,1,73704,73704,73705,0,1,4
21015,3,1,73707,73707,73708,0,1,2
21016,4,2,73711,73711,73713,0,2,3
21017,6,2,73717,73717,73719,0,2,4
21018,2,2,73719,73719,73721,0,2,0
21019,1,3,73720,73721,73724,1,4,0
21020,3,1,73723,73724,73725,1,2,0
21021,6,3,73729,73729,73732,0,3,4
21022,6,1,73735,73735,73736,0,1,3
21023,2,2,73737,73737,73739,0,2,1
21024,3,1,73740,73740,73741,0,1,1
21025,5,3,73745,73745,73748,0,3,4
21026,1,3,73746,73748,73751,2,5,0
21027,6,2,73752,73752,73754,0,2,1
21028,5,3,73757,73757,73760,0,3,3
21029,4,2,73761,73761,73763,0,2,1
21030,5,2,73766,73766,73768,0,2,3
21031,4,2,73770,73770,73772,0,2,2
21032,1,2,73771,73772,73774,1,3,0
21033,5,2,73776,73776,73778,0,2,2
21034,3,3,73779,73779,73782,0,3,1
21035,5,1,73784,73784,73785,0,1,2
21036,1,2,73785,73785,73787,0,2,0
21037,4,1,73789,73789,73790,0,1,2
21038,5,2,73794,73794,73796,0,2,4
21039,5,2,73799,73799,73801,0,2,3
21040,5,3,73804,73804,73807,0,3,3
21041,5,1,73809,73809,73810,0,1,2
21042,6,3,73815,73815,73818,0,3,5
21043,5,3,73820,73820,73823,0,3,2
21044,2,3,73822,73823,73826,1,4,0
21045,2,2,73824,73826,73828,2,4,0
21046,3,3,73827,73828,73831,1,4,0
21047,5,3,73832,73832,73835,0,3,1
21048,6,3,73838,73838,73841,0,3,3
21049,5,1,73843,73843,73844,0,1,2
21050,3,3,73846,73846,73849,0,3,2
21051,5,2,73851,73851,73853,0,2,2
21052,3,3,73854,73854,73857,0,3,1
21053,5,3,73859,73859,73862,0,3,2
21054,3,1,73862,73862,73863,0,1,0
21055,6,3,73868,73868,73871,0,3,5
21056,6,1,73874,73874,73875,0,1,3
21057,1,2,73875,73875,73877,0,2,0
21058,1,2,73876,73877,73879,1,3,0
21059,5,1,73881,73881,73882,0,1,2
21060,2,1,73883,73883,73884,0,1,1
21061,6,3,73889,73889,73892,0,3,5
21062,5,2,73894,73894,73896,0,2,2
21063,5,1,73899,73899,73900,0,1,3
21064,5,1,73904,73904,73905,0,1,4
21065,1,1,73905,73905,73906,0,1,0
21066,2,1,73907,73907,73908,0,1,1
21067,6,3,73913,73913,73916,0,3,5
21068,6,2,73919,73919,73921,0,2,3
21069,4,2,73923,73923,73925,0,2,2
21070,3,3,73926,73926,73929,0,3,1
21071,3,2,73929,73929,73931,0,2,0
21072,3,2,73932,73932,73934,0,2,1
21073,6,3,73938,73938,73941,0,3,4
21074,2,1,73940,73941,73942,1,2,0
21075,1,2,73941,73942,73944,1,3,0
21076,2,1,73943,73944,73945,1,2,0
21077,4,2,73947,73947,73949,0,2,2
21078,4,2,73951,73951,73953,0,2,2
21079,6,1,73957,73957,73958,0,1,4
21080,6,3,73963,73963,73966,0,3,5
21081,2,2,73965,73966,73968,1,3,0
21082,6,3,73971,73971,73974,0,3,3
21083,4,2,73975,73975,73977,0,2,1
21084,4,3,73979,73979,73982,0,3,2
21085,2,1,73981,73982,73983,1,2,0
21086,3,2,73984,73984,73986,0,2,1
21087,6,3,73990,73990,73993,0,3,4
21088,4,2,73994,73994,73996,0,2,1
21089,2,2,73996,73996,73998,0,2,0
21090,1,2,73997,73998,74000,1,3,0
21091,4,3,74001,74001,74004,0,3,1
21092,4,3,74005,74005,74008,0,3,1
21093,4,3,74009,74009,74012,0,3,1
21094,6,1,74015,74015,74016,0,1,3
21095,1,3,74016,74016,74019,0,3,0
21096,4,2,74020,74020,74022,0,2,1
21097,6,1,74026,74026,74027,0,1,4
21098,3,3,74029,74029,74032,0,3,2
21099,4,2,74033,74033,74035,0,2,1
21100,6,1,74039,74039,74040,0,1,4
21101,3,3,74042,74042,74045,0,3,2
21102,1,3,74043,74045,74048,2,5,0
21103,6,3,74049,74049,74052,0,3,1
21104,5,2,74054,74054,74056,0,2,2
21105,1,2,74055,74056,74058,1,3,0
21106,4,1,74059,74059,74060,0,1,1
21107,5,3,74064,74064,74067,0,3,4
21108,3,1,74067,74067,74068,0,1,0
21109,4,2,74071,74071,74073,0,2,3
21110,6,3,74077,74077,74080,0,3,4
21111,1,2,74078,74080,74082,2,4,0
21112,6,1,74084,74084,74085,0,1,2
21113,5,2,74089,74089,74091,0,2,4
21114,6,3,74095,74095,74098,0,3,4
21115,5,1,74100,74100,74101,0,1,2
21116,3,2,74103,74103,74105,0,2,2
21117,5,1,74108,74108,74109,0,1,3
21118,2,3,74110,74110,74113,0,3,1
21119,5,3,74115,74115,74118,0,3,2
21120,6,3,74121,74121,74124,0,3,3
21121,2,2,74123,74124,74126,1,3,0
21122,5,1,74128,74128,74129,0,1,2
21123,3,2,74131,74131,74133,0,2,2
21124,6,1,74137,74137,74138,0,1,4
21125,2,1,74139,74139,74140,0,1,1
21126,2,2,74141,74141,74143,0,2,1
21127,6,1,74147,74147,74148,0,1,4
21128,4,3,74151,74151,74154,0,3,3
21129,6,2,74157,74157,74159,0,2,3
21130,2,3,74159,74159,74162,0,3,0
21131,6,1,74165,74165,74166,0,1,3
21132,6,1,74171,74171,74172,0,1,5
21133,5,3,74176,74176,74179,0,3,4
21134,1,2,74177,74179,74181,2,4,0
21135,6,2,74183,74183,74185,0,2,2
21136,3,2,74186,74186,74188,0,2,1
21137,2,1,74188,74188,74189,0,1,0
21138,4,3,74192,74192,74195,0,3,3
21139,2,2,74194,74195,74197,1,3,0
21140,2,1,74196,74197,74198,1,2,0
21141,4,3,74200,74200,74203,0,3,2
21142,6,1,74206,74206,74207,0,1,3
21143,6,3,74212,74212,74215,0,3,5
21144,4,3,74216,74216,74219,0,3,1
21145,5,2,74221,74221,74223,0,2,2
21146,1,1,74222,74223,74224,1,2,0
21147,3,1,74225,74225,74226,0,1,1
21148,6,1,74231,74231,74232,0,1,5
21149,4,3,74235,74235,74238,0,3,3
21150,2,2,74237,74238,74240,1,3,0
21151,5,2,74242,74242,74244,0,2,2
21152,3,1,74245,74245,74246,0,1,1
21153,3,2,74248,74248,74250,0,2,2
21154,1,1,74249,74250,74251,1,2,0
21155,4,1,74253,74253,74254,0,1,2
21156,1,2,74254,74254,74256,0,2,0
21157,5,2,74259,74259,74261,0,2,3
21158,4,3,74263,74263,74266,0,3,2
21159,4,1,74267,74267,74268,0,1,1
21160,4,2,74271,74271,74273,0,2,3
21161,5,1,74276,74276,74277,0,1,3
21162,4,2,74280,74280,74282,0,2,3
21163,4,1,74284,74284,74285,0,1,2
21164,5,2,74289,74289,74291,0,2,4
21165,4,1,74293,74293,74294,0,1,2
21166,2,2,74295,74295,74297,0,2,1
21167,4,3,74299,74299,74302,0,3,2
21168,1,2,74300,74302,74304,2,4,0
21169,6,2,74306,74306,74308,0,2,2
21170,6,1,74312,74312,74313,0,1,4
21171,6,3,74318,74318,74321,0,3,5
21172,2,1,74320,74321,74322,1,2,0
21173,2,1,74322,74322,74323,0,1,0
21174,5,2,74327,74327,74329,0,2,4
21175,6,1,74333,74333,74334,0,1,4
21176,3,2,74336,74336,74338,0,2,2
21177,4,3,74340,74340,74343,0,3,2
21178,1,1,74341,74343,74344,2,3,0
21179,2,1,74343,74344,74345,1,2,0
21180,4,1,74347,74347,74348,0,1,2
21181,1,1,74348,74348,74349,0,1,0
21182,4,1,74352,74352,74353,0,1,3
21183,4,3,74356,74356,74359,0,3,3
21184,5,2,74361,74361,74363,0,2,2
21185,4,2,74365,74365,74367,0,2,2
21186,3,3,74368,74368,74371,0,3,1
21187,3,1,74371,74371,74372,0,1,0
21188,6,1,74377,74377,74378,0,1,5
21189,5,1,74382,74382,74383,0,1,4
21190,6,1,74388,74388,74389,0,1,5
21191,1,1,74389,74389,74390,0,1,0
21192,2,1,74391,74391,74392,0,1,1
21193,4,2,74395,74395,74397,0,2,3
21194,3,1,74398,74398,74399,0,1,1
21195,2,3,74400,74400,74403,0,3,1
21196,1,2,74401,74403,74405,2,4,0
21197,5,2,74406,74406,74408,0,2,1
21198,1,3,74407,74408,74411,1,4,0
21199,6,1,74413,74413,74414,0,1,2
21200,3,3,74416,74416,74419,0,3,2
21201,3,3,74419,74419,74422,0,3,0
21202,2,2,74421,74422,74424,1,3,0
21203,3,3,74424,74424,74427,0,3,0
21204,5,3,74429,74429,74432,0,3,2
21205,4,2,74433,74433,74435,0,2,1
21206,3,1,74436,74436,74437,0,1,1
21207,3,1,74439,74439,74440,0,1,2
21208,2,1,74441,74441,74442,0,1,1
21209,1,1,74442,74442,74443,0,1,0
21210,5,3,74447,74447,74450,0,3,4
21211,4,2,74451,74451,74453,0,2,1
21212,4,3,74455,74455,74458,0,3,2
21213,1,1,74456,74458,74459,2,3,0
21214,6,2,74462,74462,74464,0,2,3
21215,4,3,74466,74466,74469,0,3,2
21216,2,2,74468,74469,74471,1,3,0
21217,1,1,74469,74471,74472,2,3,0
21218,4,3,74473,74473,74476,0,3,1
21219,5,3,74478,74478,74481,0,3,2
21220,3,1,74481,74481,74482,0,1,0
21221,5,3,74486,74486,74489,0,3,4
21222,6,1,74492,74492,74493,0,1,3
21223,3,1,74495,74495,74496,0,1,2
21224,5,1,74500,74500,74501,0,1,4
21225,2,3,74502,74502,74505,0,3,1
21226,5,2,74507,74507,74509,0,2,2
21227,3,2,74510,74510,74512,0,2,1
21228,2,1,74512,74512,74513,0,1,0
21229,2,1,74514,74514,74515,0,1,1
21230,3,3,74517,74517,74520,0,3,2
21231,3,3,74520,74520,74523,0,3,0
21232,2,3,74522,74523,74526,1,4,0
21233,4,3,74526,74526,74529,0,3,0
21234,6,1,74532,74532,74533,0,1,3
21235,3,3,74535,74535,74538,0,3,2
21236,5,2,74540,74540,74542,0,2,2
21237,2,1,74542,74542,74543,0,1,0
21238,3,2,74545,74545,74547,0,2,2
21239,3,2,74548,74548,74550,0,2,1
21240,3,3,74551,74551,74554,0,3,1
21241,1,3,74552,74554,74557,2,5,0
21242,5,3,74557,74557,74560,0,3,0
21243,5,1,74562,74562,74563,0,1,2
21244,1,3,74563,74563,74566,0,3,0
21245,4,1,74567,74567,74568,0,1,1
21246,6,2,74573,74573,74575,0,2,5
21247,4,2,74577,74577,74579,0,2,2
21248,2,2,74579,74579,74581,0,2,0
21249,6,1,74585,74585,74586,0,1,4
21250,3,3,74588,74588,74591,0,3,2
21251,6,2,74594,74594,74596,0,2,3
21252,4,1,74598,74598,74599,0,1,2
21253,6,3,74604,74604,74607,0,3,5
21254,2,3,74606,74607,74610,1,4,0
21255,2,2,74608,74610,74612,2,4,0
21256,3,2,74611,74612,74614,1,3,0
21257,3,2,74614,74614,74616,0,2,0
21258,6,3,74620,74620,74623,0,3,4
21259,4,1,74624,74624,74625,0,1,1
21260,4,2,74628,74628,74630,0,2,3
21261,5,2,74633,74633,74635,0,2,3
21262,5,2,74638,74638,74640,0,2,3
21263,3,3,74641,74641,74644,0,3,1
21264,3,1,74644,74644,74645,0,1,0
21265,5,1,74649,74649,74650,0,1,4
21266,5,2,74654,74654,74656,0,2,4
21267,5,2,74659,74659,74661,0,2,3
21268,2,2,74661,74661,74663,0,2,0
21269,4,2,74665,74665,74667,0,2,2
21270,3,3,74668,74668,74671,0,3,1
21271,2,2,74670,74671,74673,1,3,0
21272,4,2,74674,74674,74676,0,2,1
21273,2,2,74676,74676,74678,0,2,0
21274,4,1,74680,74680,74681,0,1,2
21275,1,2,74681,74681,74683,0,2,0
21276,3,3,74684,74684,74687,0,3,1
21277,5,3,74689,74689,74692,0,3,2
21278,6,1,74695,74695,74696,0,1,3
21279,5,3,74700,74700,74703,0,3,4
21280,1,1,74701,74703,74704,2,3,0
21281,2,1,74703,74704,74705,1,2,0
21282,5,3,74708,74708,74711,0,3,3
21283,3,3,74711,74711,74714,0,3,0
21284,5,1,74716,74716,74717,0,1,2
21285,6,3,74722,74722,74725,0,3,5
21286,6,2,74728,74728,74730,0,2,3
21287,1,2,74729,74730,74732,1,3,0
21288,2,3,74731,74732,74735,1,4,0
21289,2,3,74733,74735,74738,2,5,0
21290,2,1,74735,74738,74739,3,4,0
21291,6,3,74741,74741,74744,0,3,2
21292,6,1,74747,74747,74748,0,1,3
21293,6,3,74753,74753,74756,0,3,5
21294,6,1,74759,74759,74760,0,1,3
21295,1,2,74760,74760,74762,0,2,0
21296,2,3,74762,74762,74765,0,3,0
21297,2,1,74764,74765,74766,1,2,0
21298,1,3,74765,74766,74769,1,4,0
21299,5,2,74770,74770,74772,0,2,1
21300,1,3,74771,74772,74775,1,4,0
21301,1,3,74772,74775,74778,3,6,0
21302,1,2,74773,74778,74780,5,7,0
21303,5,3,74778,74780,74783,2,5,0
21304,6,2,74784,74784,74786,0,2,1
21305,1,2,74785,74786,74788,1,3,0
21306,5,2,74790,74790,74792,0,2,2
21307,3,1,74793,74793,74794,0,1,1
21308,4,1,74797,74797,74798,0,1,3
21309,6,2,74803,74803,74805,0,2,5
21310,5,3,74808,74808,74811,0,3,3
21311,5,1,74813,74813,74814,0,1,2
21312,4,3,74817,74817,74820,0,3,3
21313,4,2,74821,74821,74823,0,2,1
21314,2,3,74823,74823,74826,0,3,0
21315,6,2,74829,74829,74831,0,2,3
21316,1,2,74830,74831,74833,1,3,0
21317,4,2,74834,74834,74836,0,2,1
21318,3,3,74837,74837,74840,0,3,1
21319,4,3,74841,74841,74844,0,3,1
21320,2,3,74843,74844,74847,1,4,0
21321,1,1,74844,74847,74848,3,4,0
21322,5,3,74849,74849,74852,0,3,1
21323,5,3,74854,74854,74857,0,3,2
21324,6,1,74860,74860,74861,0,1,3
21325,6,2,74866,74866,74868,0,2,5
21326,4,2,74870,74870,74872,0,2,2
21327,2,1,74872,74872,74873,0,1,0
21328,4,3,74876,74876,74879,0,3,3
21329,4,1,74880,74880,74881,0,1,1
21330,5,1,74885,74885,74886,0,1,4
21331,6,2,74891,74891,74893,0,2,5
21332,6,1,74897,74897,74898,0,1,4
21333,6,3,74903,74903,74906,0,3,5
21334,6,3,74909,74909,74912,0,3,3
21335,4,1,74913,74913,74914,0,1,1
21336,1,2,74914,74914,74916,0,2,0
21337,4,2,74918,74918,74920,0,2,2
21338,4,2,74922,74922,74924,0,2,2
21339,3,1,74925,74925,74926,0,1,1
21340,1,1,74926,74926,74927,0,1,0
21341,1,3,74927,74927,74930,0,3,0
21342,3,3,74930,74930,74933,0,3,0
21343,5,1,74935,74935,74936,0,1,2
21344,1,3,74936,74936,74939,0,3,0
21345,6,1,74942,74942,74943,0,1,3
21346,2,1,74944,74944,74945,0,1,1
21347,6,3,74950,74950,74953,0,3,5
21348,1,2,74951,74953,74955,2,4,0
21349,3,1,74954,74955,74956,1,2,0
21350,5,3,74959,74959,74962,0,3,3
21351,2,3,74961,74962,74965,1,4,0
21352,6,2,74967,74967,74969,0,2,2
21353,2,3,74969,74969,74972,0,3,0
21354,4,2,74973,74973,74975,0,2,1
21355,4,3,74977,74977,74980,0,3,2
21356,4,2,74981,74981,74983,0,2,1
21357,6,1,74987,74987,74988,0,1,4
21358,1,2,74988,74988,74990,0,2,0
21359,6,3,74994,74994,74997,0,3,4
21360,1,1,74995,74997,74998,2,3,0
21361,6,1,75001,75001,75002,0,1,3
21362,3,1,75004,75004,75005,0,1,2
21363,3,1,75007,75007,75008,0,1,2
21364,6,3,75013,75013,75016,0,3,5
21365,2,2,75015,75016,75018,1,3,0
21366,1,2,75016,75018,75020,2,4,0
21367,4,1,75020,75020,75021,0,1,0
21368,2,2,75022,75022,75024,0,2,1
21369,3,2,75025,75025,75027,0,2,1
21370,5,1,75030,75030,75031,0,1,3
21371,6,2,75036,75036,75038,0,2,5
21372,5,2,75041,75041,75043,0,2,3
21373,4,3,75045,75045,75048,0,3,2
21374,2,2,75047,75048,75050,1,3,0
21375,1,1,75048,75050,75051,2,3,0
21376,6,3,75054,75054,75057,0,3,3
21377,3,1,75057,75057,75058,0,1,0
21378,1,2,75058,75058,75060,0,2,0
21379,2,2,75060,75060,75062,0,2,0
21380,4,2,75064,75064,75066,0,2,2
21381,3,2,75067,75067,75069,0,2,1
21382,1,1,75068,75069,75070,1,2,0
21383,4,1,75072,75072,75073,0,1,2
21384,2,2,75074,75074,75076,0,2,1
21385,6,1,75080,75080,75081,0,1,4
21386,3,2,75083,75083,75085,0,2,2
21387,2,1,75085,75085,75086,0,1,0
21388,4,3,75089,75089,75092,0,3,3
21389,6,3,75095,75095,75098,0,3,3
21390,4,1,75099,75099,75100,0,1,1
21391,3,2,75102,75102,75104,0,2,2
21392,3,1,75105,75105,75106,0,1,1
21393,4,1,75109,75109,75110,0,1,3
21394,4,1,75113,75113,75114,0,1,3
21395,3,1,75116,75116,75117,0,1,2
21396,2,2,75118,75118,75120,0,2,1
21397,6,3,75124,75124,75127,0,3,4
21398,1,3,75125,75127,75130,2,5,0
21399,3,2,75128,75130,75132,2,4,0
21400,5,1,75133,75133,75134,0,1,1
21401,4,3,75137,75137,75140,0,3,3
21402,6,1,75143,75143,75144,0,1,3
21403,1,1,75144,75144,75145,0,1,0
21404,5,2,75149,75149,75151,0,2,4
21405,2,2,75151,75151,75153,0,2,0
21406,6,3,75157,75157,75160,0,3,4
21407,1,2,75158,75160,75162,2,4,0
21408,5,1,75163,75163,75164,0,1,1
21409,5,3,75168,75168,75171,0,3,4
21410,2,3,75170,75171,75174,1,4,0
21411,3,3,75173,75174,75177,1,4,0
21412,5,1,75178,75178,75179,0,1,1
21413,4,3,75182,75182,75185,0,3,3
21414,2,3,75184,75185,75188,1,4,0
21415,2,1,75186,75188,75189,2,3,0
21416,5,2,75191,75191,75193,0,2,2
21417,1,3,75192,75193,75196,1,4,0
21418,1,2,75193,75196,75198,3,5,0
21419,5,1,75198,75198,75199,0,1,0
21420,1,2,75199,75199,75201,0,2,0
21421,2,3,75201,75201,75204,0,3,0
21422,6,2,75207,75207,75209,0,2,3
21423,2,1,75209,75209,75210,0,1,0
21424,5,1,75214,75214,75215,0,1,4
21425,4,2,75218,75218,75220,0,2,3
21426,5,1,75223,75223,75224,0,1,3
21427,6,1,75229,75229,75230,0,1,5
21428,3,2,75232,75232,75234,0,2,2
21429,3,2,75235,75235,75237,0,2,1
21430,3,3,75238,75238,75241,0,3,1
21431,2,2,75240,75241,75243,1,3,0
21432,6,1,75246,75246,75247,0,1,3
21433,3,1,75249,75249,75250,0,1,2
21434,1,3,75250,75250,75253,0,3,0
21435,2,3,75252,75253,75256,1,4,0
21436,1,2,75253,75256,75258,3,5,0
21437,1,1,75254,75258,75259,4,5,0
21438,4,3,75258,75259,75262,1,4,0
21439,2,3,75260,75262,75265,2,5,0
21440,2,3,75262,75265,75268,3,6,0
21441,6,3,75268,75268,75271,0,3,0
21442,2,2,75270,75271,75273,1,3,0
21443,6,3,75276,75276,75279,0,3,3
21444,5,3,75281,75281,75284,0,3,2
21445,4,1,75285,75285,75286,0,1,1
21446,2,1,75287,75287,75288,0,1,1
21447,3,1,75290,75290,75291,0,1,2
21448,2,1,75292,75292,75293,0,1,1
21449,5,1,75297,75297,75298,0,1,4
21450,3,2,75300,75300,75302,0,2,2
21451,2,2,75302,75302,75304,0,2,0
21452,4,1,75306,75306,75307,0,1,2
21453,1,1,75307,75307,75308,0,1,0
21454,5,1,75312,75312,75313,0,1,4
21455,5,3,75317,75317,75320,0,3,4
21456,3,1,75320,75320,75321,0,1,0
21457,2,1,75322,75322,75323,0,1,1
21458,4,1,75326,75326,75327,0,1,3
21459,6,3,75332,75332,75335,0,3,5
21460,5,1,75337,75337,75338,0,1,2
21461,3,3,75340,75340,75343,0,3,2
21462,3,3,75343,75343,75346,0,3,0
21463,5,2,75348,75348,75350,0,2,2
21464,5,2,75353,75353,75355,0,2,3
21465,5,2,75358,75358,75360,0,2,3
21466,3,3,75361,75361,75364,0,3,1
21467,1,1,75362,75364,75365,2,3,0
21468,4,1,75366,75366,75367,0,1,1
21469,1,2,75367,75367,75369,0,2,0
21470,4,2,75371,75371,75373,0,2,2
21471,5,3,75376,75376,75379,0,3,3
21472,4,3,75380,75380,75383,0,3,1
21473,3,2,75383,75383,75385,0,2,0
21474,6,3,75389,75389,75392,0,3,4
21475,2,1,75391,75392,75393,1,2,0
21476,5,1,75396,75396,75397,0,1,3
21477,2,2,75398,75398,75400,0,2,1
21478,3,3,75401,75401,75404,0,3,1
21479,3,2,75404,75404,75406,0,2,0
21480,4,2,75408,75408,75410,0,2,2
21481,4,1,75412,75412,75413,0,1,2
21482,2,2,75414,75414,75416,0,2,1
21483,3,2,75417,75417,75419,0,2,1
21484,2,1,75419,75419,75420,0,1,0
21485,4,3,75423,75423,75426,0,3,3
21486,4,2,75427,75427,75429,0,2,1
21487,6,2,75433,75433,75435,0,2,4
21488,2,2,75435,75435,75437,0,2,0
21489,1,1,75436,75437,75438,1,2,0
21490,3,2,75439,75439,75441,0,2,1
21491,5,2,75444,75444,75446,0,2,3
21492,3,1,75447,75447,75448,0,1,1
21493,2,1,75449,75449,75450,0,1,1
21494,5,2,75454,75454,75456,0,2,4
21495,1,2,75455,75456,75458,1,3,0
21496,2,2,75457,75458,75460,1,3,0
21497,2,2,75459,75460,75462,1,3,0
21498,2,1,75461,75462,75463,1,2,0
21499,3,2,75464,75464,75466,0,2,1
21500,3,1,75467,75467,75468,0,1,1
21501,2,2,75469,75469,75471,0,2,1
21502,4,3,75473,75473,75476,0,3,2
21503,5,1,75478,75478,75479,0,1,2
21504,3,3,75481,75481,75484,0,3,2
21505,3,1,75484,75484,75485,0,1,0
21506,2,2,75486,75486,75488,0,2,1
21507,4,1,75490,75490,75491,0,1,2
21508,3,3,75493,75493,75496,0,3,2
21509,1,2,75494,75496,75498,2,4,0
21510,1,2,75495,75498,75500,3,5,0
21511,1,1,75496,75500,75501,4,5,0
21512,2,3,75498,75501,75504,3,6,0
21513,2,1,75500,75504,75505,4,5,0
21514,4,2,75504,75505,75507,1,3,0
21515,4,3,75508,75508,75511,0,3,1
21516,2,1,75510,75511,75512,1,2,0
21517,4,3,75514,75514,75517,0,3,2
21518,1,3,75515,75517,75520,2,5,0
21519,4,1,75519,75520,75521,1,2,0
21520,1,2,75520,75521,75523,1,3,0
21521,3,2,75523,75523,75525,0,2,0
21522,6,3,75529,75529,75532,0,3,4
21523,3,1,75532,75532,75533,0,1,0
21524,6,1,75538,75538,75539,0,1,5
21525,4,2,75542,75542,75544,0,2,3
21526,6,3,75548,75548,75551,0,3,4
21527,4,1,75552,75552,75553,0,1,1
21528,5,2,75557,75557,75559,0,2,4
21529,4,2,75561,75561,75563,0,2,2
21530,6,3,75567,75567,75570,0,3,4
21531,2,1,75569,75570,75571,1,2,0
21532,2,1,75571,75571,75572,0,1,0
21533,6,1,75577,75577,75578,0,1,5
21534,3,3,75580,75580,75583,0,3,2
21535,3,2,75583,75583,75585,0,2,0
21536,2,1,75585,75585,75586,0,1,0
21537,3,2,75588,75588,75590,0,2,2
21538,5,3,75593,75593,75596,0,3,3
21539,6,1,75599,75599,75600,0,1,3
21540,4,1,75603,75603,75604,0,1,3
21541,2,1,75605,75605,75606,0,1,1
21542,3,3,75608,75608,75611,0,3,2
21543,1,3,75609,75611,75614,2,5,0
21544,5,1,75614,75614,75615,0,1,0
21545,2,2,75616,75616,75618,0,2,1
21546,1,3,75617,75618,75621,1,4,0
21547,4,2,75621,75621,75623,0,2,0
21548,1,2,75622,75623,75625,1,3,0
21549,5,1,75627,75627,75628,0,1,2
21550,4,1,75631,75631,75632,0,1,3
21551,5,1,75636,75636,75637,0,1,4
21552,4,3,75640,75640,75643,0,3,3
21553,4,2,75644,75644,75646,0,2,1
21554,1,1,75645,75646,75647,1,2,0
21555,5,1,75650,75650,75651,0,1,3
21556,3,2,75653,75653,75655,0,2,2
21557,4,3,75657,75657,75660,0,3,2
21558,4,2,75661,75661,75663,0,2,1
21559,6,1,75667,75667,75668,0,1,4
21560,1,1,75668,75668,75669,0,1,0
21561,4,2,75672,75672,75674,0,2,3
21562,4,2,75676,75676,75678,0,2,2
21563,2,2,75678,75678,75680,0,2,0
21564,3,2,75681,75681,75683,0,2,1
21565,2,2,75683,75683,75685,0,2,0
21566,3,2,75686,75686,75688,0,2,1
21567,2,2,75688,75688,75690,0,2,0
21568,3,2,75691,75691,75693,0,2,1
21569,6,3,75697,75697,75700,0,3,4
21570,3,3,75700,75700,75703,0,3,0
21571,1,2,75701,75703,75705,2,4,0
21572,2,3,75703,75705,75708,2,5,0
21573,4,2,75707,75708,75710,1,3,0
21574,6,3,75713,75713,75716,0,3,3
21575,6,1,75719,75719,75720,0,1,3
21576,4,3,75723,75723,75726,0,3,3
21577,3,1,75726,75726,75727,0,1,0
21578,4,2,75730,75730,75732,0,2,3
21579,2,1,75732,75732,75733,0,1,0
21580,3,2,75735,75735,75737,0,2,2
21581,2,2,75737,75737,75739,0,2,0
21582,5,2,75742,75742,75744,0,2,3
21583,6,1,75748,75748,75749,0,1,4
21584,6,2,75754,75754,75756,0,2,5
21585,4,1,75758,75758,75759,0,1,2
21586,5,2,75763,75763,75765,0,2,4
21587,4,1,75767,75767,75768,0,1,2
21588,5,1,75772,75772,75773,0,1,4
21589,3,1,75775,75775,75776,0,1,2
21590,4,1,75779,75779,75780,0,1,3
21591,3,1,75782,75782,75783,0,1,2
21592,3,2,75785,75785,75787,0,2,2
21593,6,3,75791,75791,75794,0,3,4
21594,5,2,75796,75796,75798,0,2,2
21595,3,2,75799,75799,75801,0,2,1
21596,1,3,75800,75801,75804,1,4,0
21597,5,2,75805,75805,75807,0,2,1
21598,3,1,75808,75808,75809,0,1,1
21599,6,2,75814,75814,75816,0,2,5
21600,4,3,75818,75818,75821,0,3,2
21601,3,1,75821,75821,75822,0,1,0
21602,4,1,75825,75825,75826,0,1,3
21603,2,2,75827,75827,75829,0,2,1
21604,1,2,75828,75829,75831,1,3,0
21605,5,1,75833,75833,75834,0,1,2
21606,6,1,75839,75839,75840,0,1,5
21607,1,3,75840,75840,75843,0,3,0
21608,5,1,75845,75845,75846,0,1,2
21609,4,2,75849,75849,75851,0,2,3
21610,4,1,75853,75853,75854,0,1,2
21611,3,1,75856,75856,75857,0,1,2
21612,3,1,75859,75859,75860,0,1,2
21613,6,1,75865,75865,75866,0,1,5
21614,6,3,75871,75871,75874,0,3,5
21615,6,2,75877,75877,75879,0,2,3
21616,4,1,75881,75881,75882,0,1,2
21617,1,3,75882,75882,75885,0,3,0
21618,5,1,75887,75887,75888,0,1,2
21619,5,3,75892,75892,75895,0,3,4
21620,6,1,75898,75898,75899,0,1,3
21621,5,1,75903,75903,75904,0,1,4
21622,1,1,75904,75904,75905,0,1,0
21623,5,1,75909,75909,75910,0,1,4
21624,1,3,75910,75910,75913,0,3,0
21625,5,2,75915,75915,75917,0,2,2
21626,3,1,75918,75918,75919,0,1,1
21627,6,3,75924,75924,75927,0,3,5
21628,3,1,75927,75927,75928,0,1,0
21629,4,2,75931,75931,75933,0,2,3
21630,6,2,75937,75937,75939,0,2,4
21631,6,2,75943,75943,75945,0,2,4
21632,4,1,75947,75947,75948,0,1,2
21633,6,1,75953,75953,75954,0,1,5
21634,4,2,75957,75957,75959,0,2,3
21635,6,2,75963,75963,75965,0,2,4
21636,2,1,75965,75965,75966,0,1,0
21637,5,2,75970,75970,75972,0,2,4
21638,3,2,75973,75973,75975,0,2,1
21639,2,1,75975,75975,75976,0,1,0
21640,5,1,75980,75980,75981,0,1,4
21641,2,3,75982,75982,75985,0,3,1
21642,2,1,75984,75985,75986,1,2,0
21643,4,3,75988,75988,75991,0,3,2
21644,6,3,75994,75994,75997,0,3,3
21645,4,3,75998,75998,76001,0,3,1
21646,3,1,76001,76001,76002,0,1,0
21647,4,2,76005,76005,76007,0,2,3
21648,5,3,76010,76010,76013,0,3,3
21649,3,2,76013,76013,76015,0,2,0
21650,5,3,76018,76018,76021,0,3,3
21651,3,2,76021,76021,76023,0,2,0
21652,6,3,76027,76027,76030,0,3,4
21653,5,1,76032,76032,76033,0,1,2
21654,4,3,76036,76036,76039,0,3,3
21655,1,1,76037,76039,76040,2,3,0
21656,4,2,76041,76041,76043,0,2,1
21657,1,1,76042,76043,76044,1,2,0
21658,1,3,76043,76044,76047,1,4,0
21659,4,1,76047,76047,76048,0,1,0
21660,4,3,76051,76051,76054,0,3,3
21661,6,1,76057,76057,76058,0,1,3
21662,1,2,76058,76058,76060,0,2,0
21663,2,3,76060,76060,76063,0,3,0
21664,4,2,76064,76064,76066,0,2,1
21665,4,1,76068,76068,76069,0,1,2
21666,5,3,76073,76073,76076,0,3,4
21667,6,1,76079,76079,76080,0,1,3
21668,3,2,76082,76082,76084,0,2,2
21669,3,3,76085,76085,76088,0,3,1
21670,1,2,76086,76088,76090,2,4,0
21671,1,1,76087,76090,76091,3,4,0
21672,5,1,76092,76092,76093,0,1,1
21673,4,1,76096,76096,76097,0,1,3
21674,2,1,76098,76098,76099,0,1,1
21675,2,3,76100,76100,76103,0,3,1
21676,3,2,76103,76103,76105,0,2,0
21677,3,2,76106,76106,76108,0,2,1
21678,4,2,76110,76110,76112,0,2,2
21679,6,3,76116,76116,76119,0,3,4
21680,1,2,76117,76119,76121,2,4,0
21681,4,2,76121,76121,76123,0,2,0
21682,1,1,76122,76123,76124,1,2,0
21683,5,1,76127,76127,76128,0,1,3
21684,4,3,76131,76131,76134,0,3,3
21685,2,3,76133,76134,76137,1,4,0
21686,1,2,76134,76137,76139,3,5,0
21687,5,3,76139,76139,76142,0,3,0
21688,2,1,76141,76142,76143,1,2,0
21689,2,1,76143,76143,76144,0,1,0
21690,2,1,76145,76145,76146,0,1,1
21691,4,1,76149,76149,76150,0,1,3
21692,3,1,76152,76152,76153,0,1,2
21693,6,1,76158,76158,76159,0,1,5
21694,3,1,76161,76161,76162,0,1,2
21695,3,3,76164,76164,76167,0,3,2
21696,1,1,76165,76167,76168,2,3,0
21697,5,3,76170,76170,76173,0,3,2
21698,5,3,76175,76175,76178,0,3,2
21699,5,1,76180,76180,76181,0,1,2
21700,3,1,76183,76183,76184,0,1,2
21701,4,2,76187,76187,76189,0,2,3
21702,2,2,76189,76189,76191,0,2,0
21703,5,1,76194,76194,76195,0,1,3
21704,3,3,76197,76197,76200,0,3,2
21705,1,2,76198,76200,76202,2,4,0
21706,2,3,76200,76202,76205,2,5,0
21707,5,3,76205,76205,76208,0,3,0
21708,2,1,76207,76208,76209,1,2,0
21709,5,2,76212,76212,76214,0,2,3
21710,2,3,76214,76214,76217,0,3,0
21711,5,2,76219,76219,76221,0,2,2
21712,3,3,76222,76222,76225,0,3,1
21713,3,3,76225,76225,76228,0,3,0
21714,5,3,76230,76230,76233,0,3,2
21715,2,3,76232,76233,76236,1,4,0
21716,3,1,76235,76236,76237,1,2,0
21717,3,3,76238,76238,76241,0,3,1
21718,4,2,76242,76242,76244,0,2,1
21719,2,1,76244,76244,76245,0,1,0
21720,6,1,76250,76250,76251,0,1,5
21721,1,2,76251,76251,76253,0,2,0
21722,5,3,76256,76256,76259,0,3,3
21723,3,2,76259,76259,76261,0,2,0
21724,2,3,76261,76261,76264,0,3,0
21725,6,1,76267,76267,76268,0,1,3
21726,6,1,76273,76273,76274,0,1,5
21727,1,2,76274,76274,76276,0,2,0
21728,4,2,76278,76278,76280,0,2,2
21729,2,1,76280,76280,76281,0,1,0
21730,5,2,76285,76285,76287,0,2,4
21731,6,2,76291,76291,76293,0,2,4
21732,4,2,76295,76295,76297,0,2,2
21733,3,2,76298,76298,76300,0,2,1
21734,6,2,76304,76304,76306,0,2,4
21735,5,3,76309,76309,76312,0,3,3
21736,2,3,76311,76312,76315,1,4,0
21737,1,1,76312,76315,76316,3,4,0
21738,3,2,76315,76316,76318,1,3,0
21739,2,1,76317,76318,76319,1,2,0
21740,1,3,76318,76319,76322,1,4,0
21741,3,2,76321,76322,76324,1,3,0
21742,3,2,76324,76324,76326,0,2,0
21743,3,3,76327,76327,76330,0,3,1
21744,1,3,76328,76330,76333,2,5,0
21745,3,1,76331,76333,76334,2,3,0
21746,5,3,76336,76336,76339,0,3,2
21747,5,1,76341,76341,76342,0,1,2
21748,6,2,76347,76347,76349,0,2,5
21749,4,1,76351,76351,76352,0,1,2
21750,1,1,76352,76352,76353,0,1,0
21751,5,2,76357,76357,76359,0,2,4
21752,5,3,76362,76362,76365,0,3,3
21753,4,3,76366,76366,76369,0,3,1
21754,4,1,76370,76370,76371,0,1,1
21755,2,1,76372,76372,76373,0,1,1
21756,1,2,76373,76373,76375,0,2,0
21757,5,2,76378,76378,76380,0,2,3
21758,5,2,76383,76383,76385,0,2,3
21759,5,1,76388,76388,76389,0,1,3
21760,3,2,76391,76391,76393,0,2,2
21761,1,2,76392,76393,76395,1,3,0
21762,2,1,76394,76395,76396,1,2,0
21763,5,2,76399,76399,76401,0,2,3
21764,5,2,76404,76404,76406,0,2,3
21765,6,1,76410,76410,76411,0,1,4
21766,5,3,76415,76415,76418,0,3,4
21767,2,2,76417,76418,76420,1,3,0
21768,5,1,76422,76422,76423,0,1,2
21769,3,2,76425,76425,76427,0,2,2
21770,4,2,76429,76429,76431,0,2,2
21771,2,1,76431,76431,76432,0,1,0
21772,5,1,76436,76436,76437,0,1,4
21773,2,1,76438,76438,76439,0,1,1
21774,5,2,76443,76443,76445,0,2,4
21775,2,2,76445,76445,76447,0,2,0
21776,3,1,76448,76448,76449,0,1,1
21777,1,3,76449,76449,76452,0,3,0
21778,1,2,76450,76452,76454,2,4,0
21779,5,1,76455,76455,76456,0,1,1
21780,6,3,76461,76461,76464,0,3,5
21781,1,1,76462,76464,76465,2,3,0
21782,6,1,76468,76468,76469,0,1,3
21783,2,3,76470,76470,76473,0,3,1
21784,4,3,76474,76474,76477,0,3,1
21785,1,3,76475,76477,76480,2,5,0
21786,4,3,76479,76480,76483,1,4,0
21787,3,3,76482,76483,76486,1,4,0
21788,3,1,76485,76486,76487,1,2,0
21789,1,1,76486,76487,76488,1,2,0
21790,1,1,76487,76488,76489,1,2,0
21791,5,1,76492,76492,76493,0,1,3
21792,3,3,76495,76495,76498,0,3,2
21793,3,3,76498,76498,76501,0,3,0
21794,6,2,76504,76504,76506,0,2,3
21795,1,2,76505,76506,76508,1,3,0
21796,3,3,76508,76508,76511,0,3,0
21797,3,1,76511,76511,76512,0,1,0
21798,5,3,76516,76516,76519,0,3,4
21799,6,3,76522,76522,76525,0,3,3
21800,6,1,76528,76528,76529,0,1,3
21801,1,2,76529,76529,76531,0,2,0
21802,3,1,76532,76532,76533,0,1,1
21803,3,3,76535,76535,76538,0,3,2
21804,1,3,76536,76538,76541,2,5,0
21805,4,1,76540,76541,76542,1,2,0
21806,4,3,76544,76544,76547,0,3,2
21807,5,3,76549,76549,76552,0,3,2
21808,5,1,76554,76554,76555,0,1,2
21809,3,2,76557,76557,76559,0,2,2
21810,6,2,76563,76563,76565,0,2,4
21811,5,1,76568,76568,76569,0,1,3
21812,5,2,76573,76573,76575,0,2,4
21813,4,3,76577,76577,76580,0,3,2
21814,2,3,76579,76580,76583,1,4,0
21815,2,3,76581,76583,76586,2,5,0
21816,2,3,76583,76586,76589,3,6,0
21817,5,3,76588,76589,76592,1,4,0
21818,1,2,76589,76592,76594,3,5,0
21819,3,3,76592,76594,76597,2,5,0
21820,3,1,76595,76597,76598,2,3,0
21821,3,2,76598,76598,76600,0,2,0
21822,1,3,76599,76600,76603,1,4,0
21823,5,3,76604,76604,76607,0,3,1
21824,3,3,76607,76607,76610,0,3,0
21825,4,2,76611,76611,76613,0,2,1
21826,3,1,76614,76614,76615,0,1,1
21827,1,3,76615,76615,76618,0,3,0
21828,1,1,76616,76618,76619,2,3,0
21829,6,1,76622,76622,76623,0,1,3
21830,5,3,76627,76627,76630,0,3,4
21831,6,1,76633,76633,76634,0,1,3
21832,5,1,76638,76638,76639,0,1,4
21833,1,2,76639,76639,76641,0,2,0
21834,2,2,76641,76641,76643,0,2,0
21835,5,2,76646,76646,76648,0,2,3
21836,2,1,76648,76648,76649,0,1,0
21837,4,3,76652,76652,76655,0,3,3
21838,4,1,76656,76656,76657,0,1,1
21839,2,2,76658,76658,76660,0,2,1
21840,2,1,76660,76660,76661,0,1,0
21841,6,1,76666,76666,76667,0,1,5
21842,4,2,76670,76670,76672,0,2,3
21843,3,1,76673,76673,76674,0,1,1
21844,2,2,76675,76675,76677,0,2,1
21845,4,1,76679,76679,76680,0,1,2
21846,5,1,76684,76684,76685,0,1,4
21847,3,3,76687,76687,76690,0,3,2
21848,1,2,76688,76690,76692,2,4,0
21849,3,1,76691,76692,76693,1,2,0
21850,5,1,76696,76696,76697,0,1,3
21851,2,3,76698,76698,76701,0,3,1
21852,4,3,76702,76702,76705,0,3,1
21853,4,2,76706,76706,76708,0,2,1
21854,3,3,76709,76709,76712,0,3,1
21855,5,2,76714,76714,76716,0,2,2
21856,5,1,76719,76719,76720,0,1,3
21857,1,3,76720,76720,76723,0,3,0
21858,2,1,76722,76723,76724,1,2,0
21859,1,2,76723,76724,76726,1,3,0
21860,6,1,76729,76729,76730,0,1,3
21861,3,1,76732,76732,76733,0,1,2
21862,6,1,76738,76738,76739,0,1,5
21863,1,2,76739,76739,76741,0,2,0
21864,5,2,76744,76744,76746,0,2,3
21865,5,1,76749,76749,76750,0,1,3
21866,3,1,76752,76752,76753,0,1,2
21867,3,2,76755,76755,76757,0,2,2
21868,1,3,76756,76757,76760,1,4,0
21869,1,2,76757,76760,76762,3,5,0
21870,3,1,76760,76762,76763,2,3,0
21871,5,2,76765,76765,76767,0,2,2
21872,6,2,76771,76771,76773,0,2,4
21873,4,2,76775,76775,76777,0,2,2
21874,6,3,76781,76781,76784,0,3,4
21875,6,2,76787,76787,76789,0,2,3
21876,2,2,76789,76789,76791,0,2,0
21877,4,3,76793,76793,76796,0,3,2
21878,6,1,76799,76799,76800,0,1,3
21879,2,1,76801,76801,76802,0,1,1
21880,4,3,76805,76805,76808,0,3,3
21881,3,3,76808,76808,76811,0,3,0
21882,6,3,76814,76814,76817,0,3,3
21883,6,3,76820,76820,76823,0,3,3
21884,1,1,76821,76823,76824,2,3,0
21885,2,3,76823,76824,76827,1,4,0
21886,5,1,76828,76828,76829,0,1,1
21887,4,2,76832,76832,76834,0,2,3
21888,5,1,76837,76837,76838,0,1,3
21889,4,1,76841,76841,76842,0,1,3
21890,3,3,76844,76844,76847,0,3,2
21891,4,3,76848,76848,76851,0,3,1
21892,5,2,76853,76853,76855,0,2,2
21893,3,1,76856,76856,76857,0,1,1
21894,5,3,76861,76861,76864,0,3,4
21895,1,3,76862,76864,76867,2,5,0
21896,3,3,76865,76867,76870,2,5,0
21897,4,3,76869,76870,76873,1,4,0
21898,6,1,76875,76875,76876,0,1,2
21899,6,1,76881,76881,76882,0,1,5
21900,3,3,76884,76884,76887,0,3,2
21901,3,3,76887,76887,76890,0,3,0
21902,6,2,76893,76893,76895,0,2,3
21903,4,3,76897,76897,76900,0,3,2
21904,2,1,76899,76900,76901,1,2,0
21905,5,1,76904,76904,76905,0,1,3
21906,3,2,76907,76907,76909,0,2,2
21907,2,2,76909,76909,76911,0,2,0
21908,6,3,76915,76915,76918,0,3,4
21909,4,1,76919,76919,76920,0,1,1
21910,1,3,76920,76920,76923,0,3,0
21911,6,2,76926,76926,76928,0,2,3
21912,2,1,76928,76928,76929,0,1,0
21913,5,2,76933,76933,76935,0,2,4
21914,2,2,76935,76935,76937,0,2,0
21915,4,1,76939,76939,76940,0,1,2
21916,5,2,76944,76944,76946,0,2,4
21917,1,1,76945,76946,76947,1,2,0
21918,6,1,76951,76951,76952,0,1,4
21919,4,1,76955,76955,76956,0,1,3
21920,6,1,76961,76961,76962,0,1,5
21921,2,1,76963,76963,76964,0,1,1
21922,2,2,76965,76965,76967,0,2,1
21923,4,3,76969,76969,76972,0,3,2
21924,4,1,76973,76973,76974,0,1,1
21925,6,2,76979,76979,76981,0,2,5
21926,4,1,76983,76983,76984,0,1,2
21927,3,2,76986,76986,76988,0,2,2
21928,6,1,76992,76992,76993,0,1,4
21929,3,2,76995,76995,76997,0,2,2
21930,2,2,76997,76997,76999,0,2,0
21931,3,1,77000,77000,77001,0,1,1
21932,3,2,77003,77003,77005,0,2,2
21933,6,3,77009,77009,77012,0,3,4
21934,2,3,77011,77012,77015,1,4,0
21935,2,3,77013,77015,77018,2,5,0
21936,4,2,77017,77018,77020,1,3,0
21937,4,3,77021,77021,77024,0,3,1
21938,4,2,77025,77025,77027,0,2,1
21939,2,1,77027,77027,77028,0,1,0
21940,1,3,77028,77028,77031,0,3,0
21941,4,1,77032,77032,77033,0,1,1
21942,6,3,77038,77038,77041,0,3,5
21943,5,1,77043,77043,77044,0,1,2
21944,2,2,77045,77045,77047,0,2,1
21945,2,1,77047,77047,77048,0,1,0
21946,2,1,77049,77049,77050,0,1,1
21947,3,2,77052,77052,77054,0,2,2
21948,3,3,77055,77055,77058,0,3,1
21949,3,2,77058,77058,77060,0,2,0
21950,3,1,77061,77061,77062,0,1,1
21951,3,2,77064,77064,77066,0,2,2
21952,2,2,77066,77066,77068,0,2,0
21953,4,3,77070,77070,77073,0,3,2
21954,4,3,77074,77074,77077,0,3,1
21955,6,3,77080,77080,77083,0,3,3
21956,1,2,77081,77083,77085,2,4,0
21957,4,3,77085,77085,77088,0,3,0
21958,6,1,77091,77091,77092,0,1,3
21959,1,3,77092,77092,77095,0,3,0
21960,2,2,77094,77095,77097,1,3,0
21961,4,1,77098,77098,77099,0,1,1
21962,4,3,77102,77102,77105,0,3,3
21963,3,2,77105,77105,77107,0,2,0
21964,6,2,77111,77111,77113,0,2,4
21965,4,1,77115,77115,77116,0,1,2
21966,3,3,77118,77118,77121,0,3,2
21967,6,2,77124,77124,77126,0,2,3
21968,2,3,77126,77126,77129,0,3,0
21969,4,1,77130,77130,77131,0,1,1
21970,4,2,77134,77134,77136,0,2,3
21971,1,1,77135,77136,77137,1,2,0
21972,6,3,77141,77141,77144,0,3,4
21973,2,2,77143,77144,77146,1,3,0
21974,4,3,77147,77147,77150,0,3,1
21975,1,1,77148,77150,77151,2,3,0
21976,6,1,77154,77154,77155,0,1,3
21977,3,2,77157,77157,77159,0,2,2
21978,2,1,77159,77159,77160,0,1,0
21979,4,1,77163,77163,77164,0,1,3
21980,6,2,77169,77169,77171,0,2,5
21981,6,2,77175,77175,77177,0,2,4
21982,6,1,77181,77181,77182,0,1,4
21983,1,1,77182,77182,77183,0,1,0
21984,3,2,77185,77185,77187,0,2,2
21985,2,2,77187,77187,77189,0,2,0
21986,5,1,77192,77192,77193,0,1,3
21987,3,2,77195,77195,77197,0,2,2
21988,6,1,77201,77201,77202,0,1,4
21989,5,2,77206,77206,77208,0,2,4
21990,2,1,77208,77208,77209,0,1,0
21991,3,1,77211,77211,77212,0,1,2
21992,5,1,77216,77216,77217,0,1,4
21993,2,3,77218,77218,77221,0,3,1
21994,3,1,77221,77221,77222,0,1,0
21995,1,3,77222,77222,77225,0,3,0
21996,1,3,77223,77225,77228,2,5,0
21997,1,2,77224,77228,77230,4,6,0
21998,2,2,77226,77230,77232,4,6,0
21999,1,1,77227,77232,77233,5,6,0
22000,3,3,77230,77233,77236,3,6,0
22001,6,1,77236,77236,77237,0,1,0
22002,3,1,77239,77239,77240,0,1,2
22003,6,2,77245,77245,77247,0,2,5
22004,5,1,77250,77250,77251,0,1,3
22005,5,2,77255,77255,77257,0,2,4
22006,4,1,77259,77259,77260,0,1,2
22007,2,1,77261,77261,77262,0,1,1
22008,1,3,77262,77262,77265,0,3,0
22009,5,3,77267,77267,77270,0,3,2
22010,2,2,77269,77270,77272,1,3,0
22011,3,1,77272,77272,77273,0,1,0
22012,3,2,77275,77275,77277,0,2,2
22013,1,2,77276,77277,77279,1,3,0
22014,6,2,77282,77282,77284,0,2,3
22015,3,2,77285,77285,77287,0,2,1
22016,3,2,77288,77288,77290,0,2,1
22017,6,3,77294,77294,77297,0,3,4
22018,2,1,77296,77297,77298,1,2,0
22019,6,3,77302,77302,77305,0,3,4
22020,5,1,77307,77307,77308,0,1,2
22021,3,3,77310,77310,77313,0,3,2
22022,1,1,77311,77313,77314,2,3,0
22023,1,2,77312,77314,77316,2,4,0
22024,3,1,77315,77316,77317,1,2,0
22025,5,2,77320,77320,77322,0,2,3
22026,3,3,77323,77323,77326,0,3,1
22027,3,3,77326,77326,77329,0,3,0
22028,3,2,77329,77329,77331,0,2,0
22029,6,3,77335,77335,77338,0,3,4
22030,6,2,77341,77341,77343,0,2,3
22031,1,1,77342,77343,77344,1,2,0
22032,4,1,77346,77346,77347,0,1,2
22033,2,1,77348,77348,77349,0,1,1
22034,5,2,77353,77353,77355,0,2,4
22035,5,2,77358,77358,77360,0,2,3
22036,5,1,77363,77363,77364,0,1,3
22037,4,2,77367,77367,77369,0,2,3
22038,3,3,77370,77370,77373,0,3,1
22039,5,1,77375,77375,77376,0,1,2
22040,6,1,77381,77381,77382,0,1,5
22041,4,1,77385,77385,77386,0,1,3
22042,2,1,77387,77387,77388,0,1,1
22043,2,3,77389,77389,77392,0,3,1
22044,6,1,77395,77395,77396,0,1,3
22045,4,2,77399,77399,77401,0,2,3
22046,1,3,77400,77401,77404,1,4,0
22047,2,2,77402,77404,77406,2,4,0
22048,3,3,77405,77406,77409,1,4,0
22049,2,2,77407,77409,77411,2,4,0
22050,2,3,77409,77411,77414,2,5,0
22051,3,3,77412,77414,77417,2,5,0
22052,1,2,77413,77417,77419,4,6,0
22053,5,3,77418,77419,77422,1,4,0
22054,3,1,77421,77422,77423,1,2,0
22055,6,1,77427,77427,77428,0,1,4
22056,2,3,77429,77429,77432,0,3,1
22057,6,2,77435,77435,77437,0,2,3
22058,2,1,77437,77437,77438,0,1,0
22059,6,1,77443,77443,77444,0,1,5
22060,1,3,77444,77444,77447,0,3,0
22061,2,3,77446,77447,77450,1,4,0
22062,6,3,77452,77452,77455,0,3,2
22063,1,3,77453,77455,77458,2,5,0
22064,6,2,77459,77459,77461,0,2,1
22065,3,1,77462,77462,77463,0,1,1
22066,1,1,77463,77463,77464,0,1,0
22067,2,3,77465,77465,77468,0,3,1
22068,3,2,77468,77468,77470,0,2,0
22069,3,2,77471,77471,77473,0,2,1
22070,1,1,77472,77473,77474,1,2,0
22071,2,2,77474,77474,77476,0,2,0
22072,3,3,77477,77477,77480,0,3,1
22073,2,3,77479,77480,77483,1,4,0
22074,5,3,77484,77484,77487,0,3,1
22075,2,1,77486,77487,77488,1,2,0
22076,1,3,77487,77488,77491,1,4,0
22077,2,2,77489,77491,77493,2,4,0
22078,4,1,77493,77493,77494,0,1,0
22079,4,3,77497,77497,77500,0,3,3
22080,1,3,77498,77500,77503,2,5,0
22081,4,1,77502,77503,77504,1,2,0
22082,5,3,77507,77507,77510,0,3,3
22083,3,3,77510,77510,77513,0,3,0
22084,3,2,77513,77513,77515,0,2,0
22085,6,2,77519,77519,77521,0,2,4
22086,6,2,77525,77525,77527,0,2,4
22087,1,2,77526,77527,77529,1,3,0
22088,4,1,77530,77530,77531,0,1,1
22089,5,2,77535,77535,77537,0,2,4
22090,6,3,77541,77541,77544,0,3,4
22091,2,3,77543,77544,77547,1,4,0
22092,2,1,77545,77547,77548,2,3,0
22093,2,1,77547,77548,77549,1,2,0
22094,5,3,77552,77552,77555,0,3,3
22095,2,2,77554,77555,77557,1,3,0
22096,5,1,77559,77559,77560,0,1,2
22097,6,1,77565,77565,77566,0,1,5
22098,1,1,77566,77566,77567,0,1,0
22099,2,3,77568,77568,77571,0,3,1
22100,1,2,77569,77571,77573,2,4,0
22101,5,1,77574,77574,77575,0,1,1
22102,6,2,77580,77580,77582,0,2,5
22103,4,1,77584,77584,77585,0,1,2
22104,4,2,77588,77588,77590,0,2,3
22105,1,1,77589,77590,77591,1,2,0
22106,3,1,77592,77592,77593,0,1,1
22107,6,2,77598,77598,77600,0,2,5
22108,4,1,77602,77602,77603,0,1,2
22109,4,2,77606,77606,77608,0,2,3
22110,4,1,77610,77610,77611,0,1,2
22111,3,1,77613,77613,77614,0,1,2
22112,4,2,77617,77617,77619,0,2,3
22113,4,3,77621,77621,77624,0,3,2
22114,3,1,77624,77624,77625,0,1,0
22115,5,2,77629,77629,77631,0,2,4
22116,4,2,77633,77633,77635,0,2,2
22117,4,2,77637,77637,77639,0,2,2
22118,4,1,77641,77641,77642,0,1,2
22119,2,1,77643,77643,77644,0,1,1
22120,5,2,77648,77648,77650,0,2,4
22121,3,2,77651,77651,77653,0,2,1
22122,3,3,77654,77654,77657,0,3,1
22123,3,1,77657,77657,77658,0,1,0
22124,4,2,77661,77661,77663,0,2,3
22125,4,3,77665,77665,77668,0,3,2
22126,2,2,77667,77668,77670,1,3,0
22127,6,3,77673,77673,77676,0,3,3
22128,5,3,77678,77678,77681,0,3,2
22129,1,1,77679,77681,77682,2,3,0
22130,2,3,77681,77682,77685,1,4,0
22131,1,2,77682,77685,77687,3,5,0
22132,1,3,77683,77687,77690,4,7,0
22133,5,2,77688,77690,77692,2,4,0
22134,1,2,77689,77692,77694,3,5,0
22135,2,2,77691,77694,77696,3,5,0
22136,5,1,77696,77696,77697,0,1,0
22137,6,3,77702,77702,77705,0,3,5
22138,4,2,77706,77706,77708,0,2,1
22139,1,3,77707,77708,77711,1,4,0
22140,1,2,77708,77711,77713,3,5,0
22141,3,3,77711,77713,77716,2,5,0
22142,5,1,77716,77716,77717,0,1,0
22143,3,3,77719,77719,77722,0,3,2
22144,4,2,77723,77723,77725,0,2,1
22145,4,2,77727,77727,77729,0,2,2
22146,5,2,77732,77732,77734,0,2,3
22147,5,1,77737,77737,77738,0,1,3
22148,3,1,77740,77740,77741,0,1,2
22149,2,3,77742,77742,77745,0,3,1
22150,6,1,77748,77748,77749,0,1,3
22151,6,3,77754,77754,77757,0,3,5
22152,4,3,77758,77758,77761,0,3,1
22153,3,1,77761,77761,77762,0,1,0
22154,1,1,77762,77762,77763,0,1,0
22155,5,2,77767,77767,77769,0,2,4
22156,6,2,77773,77773,77775,0,2,4
22157,6,3,77779,77779,77782,0,3,4
22158,2,2,77781,77782,77784,1,3,0
22159,3,2,77784,77784,77786,0,2,0
22160,5,2,77789,77789,77791,0,2,3
22161,4,2,77793,77793,77795,0,2,2
22162,1,1,77794,77795,77796,1,2,0
22163,2,1,77796,77796,77797,0,1,0
22164,6,2,77802,77802,77804,0,2,5
22165,5,1,77807,77807,77808,0,1,3
22166,6,1,77813,77813,77814,0,1,5
22167,4,2,77817,77817,77819,0,2,3
22168,6,3,77823,77823,77826,0,3,4
22169,3,1,77826,77826,77827,0,1,0
22170,5,3,77831,77831,77834,0,3,4
22171,3,1,77834,77834,77835,0,1,0
22172,2,1,77836,77836,77837,0,1,1
22173,2,2,77838,77838,77840,0,2,1
22174,5,1,77843,77843,77844,0,1,3
22175,4,2,77847,77847,77849,0,2,3
22176,2,3,77849,77849,77852,0,3,0
22177,1,2,77850,77852,77854,2,4,0
22178,5,2,77855,77855,77857,0,2,1
22179,1,3,77856,77857,77860,1,4,0
22180,3,3,77859,77860,77863,1,4,0
22181,1,1,77860,77863,77864,3,4,0
22182,3,1,77863,77864,77865,1,2,0
22183,1,2,77864,77865,77867,1,3,0
22184,2,3,77866,77867,77870,1,4,0
22185,4,1,77870,77870,77871,0,1,0
22186,4,1,77874,77874,77875,0,1,3
22187,1,1,77875,77875,77876,0,1,0
22188,1,3,77876,77876,77879,0,3,0
22189,5,1,77881,77881,77882,0,1,2
22190,2,1,77883,77883,77884,0,1,1
22191,4,2,77887,77887,77889,0,2,3
22192,6,3,77893,77893,77896,0,3,4
22193,1,2,77894,77896,77898,2,4,0
22194,3,2,77897,77898,77900,1,3,0
22195,1,2,77898,77900,77902,2,4,0
22196,6,1,77904,77904,77905,0,1,2
22197,5,1,77909,77909,77910,0,1,4
22198,1,3,77910,77910,77913,0,3,0
22199,5,3,77915,77915,77918,0,3,2
22200,2,2,77917,77918,77920,1,3,0
22201,3,3,77920,77920,77923,0,3,0
22202,6,3,77926,77926,77929,0,3,3
22203,2,2,77928,77929,77931,1,3,0
22204,4,1,77932,77932,77933,0,1,1
22205,2,1,77934,77934,77935,0,1,1
22206,1,3,77935,77935,77938,0,3,0
22207,1,2,77936,77938,77940,2,4,0
22208,1,3,77937,77940,77943,3,6,0
22209,1,3,77938,77943,77946,5,8,0
22210,2,1,77940,77946,77947,6,7,0
22211,2,1,77942,77947,77948,5,6,0
22212,2,2,77944,77948,77950,4,6,0
22213,6,1,77950,77950,77951,0,1,0
22214,6,2,77956,77956,77958,0,2,5
22215,2,3,77958,77958,77961,0,3,0
22216,5,1,77963,77963,77964,0,1,2
22217,6,2,77969,77969,77971,0,2,5
22218,4,3,77973,77973,77976,0,3,2
22219,3,1,77976,77976,77977,0,1,0
22220,1,3,77977,77977,77980,0,3,0
22221,4,3,77981,77981,77984,0,3,1
22222,5,1,77986,77986,77987,0,1,2
22223,3,3,77989,77989,77992,0,3,2
22224,3,1,77992,77992,77993,0,1,0
22225,3,1,77995,77995,77996,0,1,2
22226,6,3,78001,78001,78004,0,3,5
22227,6,1,78007,78007,78008,0,1,3
22228,3,2,78010,78010,78012,0,2,2
22229,1,3,78011,78012,78015,1,4,0
22230,3,2,78014,78015,78017,1,3,0
22231,3,1,78017,78017,78018,0,1,0
22232,6,2,78023,78023,78025,0,2,5
22233,3,3,78026,78026,78029,0,3,1
22234,6,3,78032,78032,78035,0,3,3
22235,3,1,78035,78035,78036,0,1,0
22236,6,3,78041,78041,78044,0,3,5
22237,2,2,78043,78044,78046,1,3,0
22238,1,3,78044,78046,78049,2,5,0
22239,4,1,78048,78049,78050,1,2,0
22240,2,1,78050,78050,78051,0,1,0
22241,6,1,78056,78056,78057,0,1,5
22242,4,1,78060,78060,78061,0,1,3
22243,5,3,78065,78065,78068,0,3,4
22244,5,1,78070,78070,78071,0,1,2
22245,1,2,78071,78071,78073,0,2,0
22246,2,2,78073,78073,78075,0,2,0
22247,2,1,78075,78075,78076,0,1,0
22248,4,1,78079,78079,78080,0,1,3
22249,4,1,78083,78083,78084,0,1,3
22250,5,1,78088,78088,78089,0,1,4
22251,1,1,78089,78089,78090,0,1,0
22252,5,2,78094,78094,78096,0,2,4
22253,5,3,78099,78099,78102,0,3,3
22254,2,2,78101,78102,78104,1,3,0
22255,6,1,78107,78107,78108,0,1,3
22256,6,3,78113,78113,78116,0,3,5
22257,5,1,78118,78118,78119,0,1,2
22258,2,1,78120,78120,78121,0,1,1
22259,4,3,78124,78124,78127,0,3,3
22260,4,1,78128,78128,78129,0,1,1
22261,6,2,78134,78134,78136,0,2,5
22262,4,2,78138,78138,78140,0,2,2
22263,6,3,78144,78144,78147,0,3,4
22264,5,2,78149,78149,78151,0,2,2
22265,2,3,78151,78151,78154,0,3,0
22266,5,2,78156,78156,78158,0,2,2
22267,4,1,78160,78160,78161,0,1,2
22268,6,3,78166,78166,78169,0,3,5
22269,1,3,78167,78169,78172,2,5,0
22270,2,1,78169,78172,78173,3,4,0
22271,4,1,78173,78173,78174,0,1,0
22272,1,2,78174,78174,78176,0,2,0
22273,5,2,78179,78179,78181,0,2,3
22274,1,2,78180,78181,78183,1,3,0
22275,1,1,78181,78183,78184,2,3,0
22276,2,1,78183,78184,78185,1,2,0
22277,4,2,78187,78187,78189,0,2,2
22278,6,2,78193,78193,78195,0,2,4
22279,2,1,78195,78195,78196,0,1,0
22280,1,2,78196,78196,78198,0,2,0
22281,3,1,78199,78199,78200,0,1,1
22282,5,2,78204,78204,78206,0,2,4
22283,3,1,78207,78207,78208,0,1,1
22284,3,2,78210,78210,78212,0,2,2
22285,2,3,78212,78212,78215,0,3,0
22286,6,1,78218,78218,78219,0,1,3
22287,4,2,78222,78222,78224,0,2,3
22288,5,3,78227,78227,78230,0,3,3
22289,5,1,78232,78232,78233,0,1,2
22290,5,3,78237,78237,78240,0,3,4
22291,1,3,78238,78240,78243,2,5,0
22292,6,2,78244,78244,78246,0,2,1
22293,6,3,78250,78250,78253,0,3,4
22294,3,1,78253,78253,78254,0,1,0
22295,3,3,78256,78256,78259,0,3,2
22296,5,2,78261,78261,78263,0,2,2
22297,1,3,78262,78263,78266,1,4,0
22298,4,3,78266,78266,78269,0,3,0
22299,2,3,78268,78269,78272,1,4,0
22300,1,2,78269,78272,78274,3,5,0
22301,2,3,78271,78274,78277,3,6,0
22302,3,1,78274,78277,78278,3,4,0
22303,5,3,78279,78279,78282,0,3,1
22304,5,3,78284,78284,78287,0,3,2
22305,2,3,78286,78287,78290,1,4,0
22306,1,3,78287,78290,78293,3,6,0
22307,5,2,78292,78293,78295,1,3,0
22308,3,1,78295,78295,78296,0,1,0
22309,5,2,78300,78300,78302,0,2,4
22310,6,2,78306,78306,78308,0,2,4
22311,6,3,78312,78312,78315,0,3,4
22312,2,2,78314,78315,78317,1,3,0
22313,2,2,78316,78317,78319,1,3,0
22314,2,1,78318,78319,78320,1,2,0
22315,1,1,78319,78320,78321,1,2,0
22316,1,3,78320,78321,78324,1,4,0
22317,1,3,78321,78324,78327,3,6,0
22318,2,1,78323,78327,78328,4,5,0
22319,6,1,78329,78329,78330,0,1,1
22320,6,1,78335,78335,78336,0,1,5
22321,1,2,78336,78336,78338,0,2,0
22322,2,1,78338,78338,78339,0,1,0
22323,5,2,78343,78343,78345,0,2,4
22324,2,3,78345,78345,78348,0,3,0
22325,1,2,78346,78348,78350,2,4,0
22326,6,3,78352,78352,78355,0,3,2
22327,2,2,78354,78355,78357,1,3,0
22328,1,1,78355,78357,78358,2,3,0
22329,3,2,78358,78358,78360,0,2,0
22330,5,2,78363,78363,78365,0,2,3
22331,2,3,78365,78365,78368,0,3,0
22332,4,3,78369,78369,78372,0,3,1
22333,2,1,78371,78372,78373,1,2,0
22334,6,3,78377,78377,78380,0,3,4
22335,1,3,78378,78380,78383,2,5,0
22336,6,3,78384,78384,78387,0,3,1
22337,3,3,78387,78387,78390,0,3,0
22338,6,2,78393,78393,78395,0,2,3
22339,2,3,78395,78395,78398,0,3,0
22340,2,3,78397,78398,78401,1,4,0
22341,1,1,78398,78401,78402,3,4,0
22342,3,1,78401,78402,78403,1,2,0
22343,3,1,78404,78404,78405,0,1,1
22344,6,2,78410,78410,78412,0,2,5
22345,6,3,78416,78416,78419,0,3,4
22346,4,2,78420,78420,78422,0,2,1
22347,4,3,78424,78424,78427,0,3,2
22348,4,3,78428,78428,78431,0,3,1
22349,5,2,78433,78433,78435,0,2,2
22350,4,1,78437,78437,78438,0,1,2
22351,4,2,78441,78441,78443,0,2,3
22352,5,1,78446,78446,78447,0,1,3
22353,4,3,78450,78450,78453,0,3,3
22354,1,1,78451,78453,78454,2,3,0
22355,1,2,78452,78454,78456,2,4,0
22356,2,3,78454,78456,78459,2,5,0
22357,1,3,78455,78459,78462,4,7,0
22358,1,1,78456,78462,78463,6,7,0
22359,1,2,78457,78463,78465,6,8,0
22360,1,1,78458,78465,78466,7,8,0
22361,3,1,78461,78466,78467,5,6,0
22362,2,1,78463,78467,78468,4,5,0
22363,3,3,78466,78468,78471,2,5,0
22364,4,2,78470,78471,78473,1,3,0
22365,3,3,78473,78473,78476,0,3,0
22366,3,2,78476,78476,78478,0,2,0
22367,4,3,78480,78480,78483,0,3,2
22368,3,2,78483,78483,78485,0,2,0
22369,2,3,78485,78485,78488,0,3,0
22370,4,2,78489,78489,78491,0,2,1
22371,6,1,78495,78495,78496,0,1,4
22372,1,3,78496,78496,78499,0,3,0
22373,3,1,78499,78499,78500,0,1,0
22374,6,1,78505,78505,78506,0,1,5
22375,5,1,78510,78510,78511,0,1,4
22376,3,3,78513,78513,78516,0,3,2
22377,2,1,78515,78516,78517,1,2,0
22378,5,2,78520,78520,78522,0,2,3
22379,4,3,78524,78524,78527,0,3,2
22380,6,1,78530,78530,78531,0,1,3
22381,2,3,78532,78532,78535,0,3,1
22382,1,3,78533,78535,78538,2,5,0
22383,2,3,78535,78538,78541,3,6,0
22384,5,3,78540,78541,78544,1,4,0
22385,4,3,78544,78544,78547,0,3,0
22386,6,3,78550,78550,78553,0,3,3
22387,1,2,78551,78553,78555,2,4,0
22388,4,3,78555,78555,78558,0,3,0
22389,4,1,78559,78559,78560,0,1,1
22390,1,2,78560,78560,78562,0,2,0
22391,5,1,78565,78565,78566,0,1,3
22392,5,2,78570,78570,78572,0,2,4
22393,3,3,78573,78573,78576,0,3,1
22394,5,2,78578,78578,78580,0,2,2
22395,6,3,78584,78584,78587,0,3,4
22396,5,1,78589,78589,78590,0,1,2
22397,5,1,78594,78594,78595,0,1,4
22398,5,2,78599,78599,78601,0,2,4
22399,1,3,78600,78601,78604,1,4,0
22400,2,3,78602,78604,78607,2,5,0
22401,2,3,78604,78607,78610,3,6,0
22402,4,1,78608,78610,78611,2,3,0
22403,2,2,78610,78611,78613,1,3,0
22404,5,1,78615,78615,78616,0,1,2
22405,2,3,78617,78617,78620,0,3,1
22406,3,2,78620,78620,78622,0,2,0
22407,3,1,78623,78623,78624,0,1,1
22408,4,3,78627,78627,78630,0,3,3
22409,3,1,78630,78630,78631,0,1,0
22410,4,1,78634,78634,78635,0,1,3
22411,5,1,78639,78639,78640,0,1,4
22412,1,3,78640,78640,78643,0,3,0
22413,1,3,78641,78643,78646,2,5,0
22414,1,2,78642,78646,78648,4,6,0
22415,6,3,78648,78648,78651,0,3,0
22416,6,2,78654,78654,78656,0,2,3
22417,3,3,78657,78657,78660,0,3,1
22418,2,2,78659,78660,78662,1,3,0
22419,6,1,78665,78665,78666,0,1,3
22420,3,3,78668,78668,78671,0,3,2
22421,6,3,78674,78674,78677,0,3,3
22422,4,3,78678,78678,78681,0,3,1
22423,5,1,78683,78683,78684,0,1,2
22424,4,2,78687,78687,78689,0,2,3
22425,1,1,78688,78689,78690,1,2,0
22426,4,3,78692,78692,78695,0,3,2
22427,2,3,78694,78695,78698,1,4,0
22428,5,3,78699,78699,78702,0,3,1
22429,3,2,78702,78702,78704,0,2,0
22430,5,1,78707,78707,78708,0,1,3
22431,2,1,78709,78709,78710,0,1,1
22432,4,3,78713,78713,78716,0,3,3
22433,6,1,78719,78719,78720,0,1,3
22434,4,3,78723,78723,78726,0,3,3
22435,4,3,78727,78727,78730,0,3,1
22436,3,2,78730,78730,78732,0,2,0
22437,2,1,78732,78732,78733,0,1,0
22438,6,2,78738,78738,78740,0,2,5
22439,5,2,78743,78743,78745,0,2,3
22440,3,3,78746,78746,78749,0,3,1
22441,6,1,78752,78752,78753,0,1,3
22442,3,2,78755,78755,78757,0,2,2
22443,5,1,78760,78760,78761,0,1,3
22444,2,3,78762,78762,78765,0,3,1
22445,2,1,78764,78765,78766,1,2,0
22446,6,3,78770,78770,78773,0,3,4
22447,3,1,78773,78773,78774,0,1,0
22448,2,3,78775,78775,78778,0,3,1
22449,5,3,78780,78780,78783,0,3,2
22450,1,1,78781,78783,78784,2,3,0
22451,5,3,78786,78786,78789,0,3,2
22452,1,3,78787,78789,78792,2,5,0
22453,5,1,78792,78792,78793,0,1,0
22454,1,1,78793,78793,78794,0,1,0
22455,3,2,78796,78796,78798,0,2,2
22456,2,2,78798,78798,78800,0,2,0
22457,2,3,78800,78800,78803,0,3,0
22458,1,2,78801,78803,78805,2,4,0
22459,4,1,78805,78805,78806,0,1,0
22460,2,2,78807,78807,78809,0,2,1
22461,1,1,78808,78809,78810,1,2,0
22462,1,3,78809,78810,78813,1,4,0
22463,1,2,78810,78813,78815,3,5,0
22464,3,3,78813,78815,78818,2,5,0
22465,5,2,78818,78818,78820,0,2,0
22466,6,1,78824,78824,78825,0,1,4
22467,5,1,78829,78829,78830,0,1,4
22468,1,2,78830,78830,78832,0,2,0
22469,4,1,78834,78834,78835,0,1,2
22470,4,1,78838,78838,78839,0,1,3
22471,4,1,78842,78842,78843,0,1,3
22472,1,1,78843,78843,78844,0,1,0
22473,6,3,78849,78849,78852,0,3,5
22474,6,2,78855,78855,78857,0,2,3
22475,4,3,78859,78859,78862,0,3,2
22476,1,2,78860,78862,78864,2,4,0
22477,3,1,78863,78864,78865,1,2,0
22478,3,2,78866,78866,78868,0,2,1
22479,3,3,78869,78869,78872,0,3,1
22480,3,1,78872,78872,78873,0,1,0
22481,6,3,78878,78878,78881,0,3,5
22482,5,1,78883,78883,78884,0,1,2
22483,5,3,78888,78888,78891,0,3,4
22484,5,1,78893,78893,78894,0,1,2
22485,4,2,78897,78897,78899,0,2,3
22486,6,3,78903,78903,78906,0,3,4
22487,5,1,78908,78908,78909,0,1,2
22488,3,1,78911,78911,78912,0,1,2
22489,6,3,78917,78917,78920,0,3,5
22490,1,2,78918,78920,78922,2,4,0
22491,5,3,78923,78923,78926,0,3,1
22492,1,2,78924,78926,78928,2,4,0
22493,5,3,78929,78929,78932,0,3,1
22494,1,3,78930,78932,78935,2,5,0
22495,6,2,78936,78936,78938,0,2,1
22496,6,1,78942,78942,78943,0,1,4
22497,1,2,78943,78943,78945,0,2,0
22498,3,1,78946,78946,78947,0,1,1
22499,5,1,78951,78951,78952,0,1,4
22500,4,2,78955,78955,78957,0,2,3
22501,2,2,78957,78957,78959,0,2,0
22502,1,3,78958,78959,78962,1,4,0
22503,1,2,78959,78962,78964,3,5,0
22504,1,2,78960,78964,78966,4,6,0
22505,3,3,78963,78966,78969,3,6,0
22506,6,3,78969,78969,78972,0,3,0
22507,5,2,78974,78974,78976,0,2,2
22508,5,3,78979,78979,78982,0,3,3
22509,3,3,78982,78982,78985,0,3,0
22510,6,3,78988,78988,78991,0,3,3
22511,1,3,78989,78991,78994,2,5,0
22512,1,1,78990,78994,78995,4,5,0
22513,2,3,78992,78995,78998,3,6,0
22514,4,1,78996,78998,78999,2,3,0
22515,6,1,79002,79002,79003,0,1,3
22516,3,3,79005,79005,79008,0,3,2
22517,2,3,79007,79008,79011,1,4,0
22518,1,1,79008,79011,79012,3,4,0
22519,1,3,79009,79012,79015,3,6,0
22520,5,1,79014,79015,79016,1,2,0
22521,6,1,79020,79020,79021,0,1,4
22522,4,1,79024,79024,79025,0,1,3
22523,2,2,79026,79026,79028,0,2,1
22524,4,3,79030,79030,79033,0,3,2
22525,3,2,79033,79033,79035,0,2,0
22526,1,2,79034,79035,79037,1,3,0
22527,1,3,79035,79037,79040,2,5,0
22528,5,3,79040,79040,79043,0,3,0
22529,5,1,79045,79045,79046,0,1,2
22530,4,1,79049,79049,79050,0,1,3
22531,2,3,79051,79051,79054,0,3,1
22532,4,1,79055,79055,79056,0,1,1
22533,2,3,79057,79057,79060,0,3,1
22534,2,1,79059,79060,79061,1,2,0
22535,5,2,79064,79064,79066,0,2,3
22536,4,3,79068,79068,79071,0,3,2
22537,3,1,79071,79071,79072,0,1,0
22538,5,3,79076,79076,79079,0,3,4
22539,3,2,79079,79079,79081,0,2,0
22540,1,3,79080,79081,79084,1,4,0
22541,2,1,79082,79084,79085,2,3,0
22542,5,1,79087,79087,79088,0,1,2
22543,2,3,79089,79089,79092,0,3,1
22544,1,3,79090,79092,79095,2,5,0
22545,4,1,79094,79095,79096,1,2,0
22546,5,1,79099,79099,79100,0,1,3
22547,3,2,79102,79102,79104,0,2,2
22548,1,2,79103,79104,79106,1,3,0
22549,1,2,79104,79106,79108,2,4,0
22550,4,1,79108,79108,79109,0,1,0
22551,6,3,79114,79114,79117,0,3,5
22552,6,3,79120,79120,79123,0,3,3
22553,3,1,79123,79123,79124,0,1,0
22554,4,1,79127,79127,79128,0,1,3
22555,3,3,79130,79130,79133,0,3,2
22556,6,1,79136,79136,79137,0,1,3
22557,5,2,79141,79141,79143,0,2,4
22558,2,1,79143,79143,79144,0,1,0
22559,1,2,79144,79144,79146,0,2,0
22560,3,2,79147,79147,79149,0,2,1
22561,4,3,79151,79151,79154,0,3,2
22562,3,2,79154,79154,79156,0,2,0
22563,2,1,79156,79156,79157,0,1,0
22564,3,2,79159,79159,79161,0,2,2
22565,5,2,79164,79164,79166,0,2,3
22566,6,2,79170,79170,79172,0,2,4
22567,4,1,79174,79174,79175,0,1,2
22568,4,1,79178,79178,79179,0,1,3
22569,1,3,79179,79179,79182,0,3,0
22570,3,2,79182,79182,79184,0,2,0
22571,3,3,79185,79185,79188,0,3,1
22572,5,1,79190,79190,79191,0,1,2
22573,4,3,79194,79194,79197,0,3,3
22574,6,1,79200,79200,79201,0,1,3
22575,3,2,79203,79203,79205,0,2,2
22576,6,1,79209,79209,79210,0,1,4
22577,4,3,79213,79213,79216,0,3,3
22578,6,2,79219,79219,79221,0,2,3
22579,6,2,79225,79225,79227,0,2,4
22580,2,1,79227,79227,79228,0,1,0
22581,1,1,79228,79228,79229,0,1,0
22582,4,1,79232,79232,79233,0,1,3
22583,2,3,79234,79234,79237,0,3,1
22584,4,3,79238,79238,79241,0,3,1
22585,5,3,79243,79243,79246,0,3,2
22586,1,1,79244,79246,79247,2,3,0
22587,1,2,79245,79247,79249,2,4,0
22588,1,3,79246,79249,79252,3,6,0
22589,1,2,79247,79252,79254,5,7,0
22590,4,1,79251,79254,79255,3,4,0
22591,6,1,79257,79257,79258,0,1,2
22592,2,2,79259,79259,79261,0,2,1
22593,4,3,79263,79263,79266,0,3,2
22594,4,1,79267,79267,79268,0,1,1
22595,1,3,79268,79268,79271,0,3,0
22596,6,3,79274,79274,79277,0,3,3
22597,5,2,79279,79279,79281,0,2,2
22598,3,2,79282,79282,79284,0,2,1
22599,3,1,79285,79285,79286,0,1,1
22600,6,3,79291,79291,79294,0,3,5
22601,6,1,79297,79297,79298,0,1,3
22602,4,3,79301,79301,79304,0,3,3
22603,3,3,79304,79304,79307,0,3,0
22604,4,3,79308,79308,79311,0,3,1
22605,3,2,79311,79311,79313,0,2,0
22606,1,2,79312,79313,79315,1,3,0
22607,2,1,79314,79315,79316,1,2,0
22608,6,2,79320,79320,79322,0,2,4
22609,2,2,79322,79322,79324,0,2,0
22610,2,2,79324,79324,79326,0,2,0
22611,4,3,79328,79328,79331,0,3,2
22612,5,3,79333,79333,79336,0,3,2
22613,5,1,79338,79338,79339,0,1,2
22614,4,1,79342,79342,79343,0,1,3
22615,2,2,79344,79344,79346,0,2,1
22616,5,2,79349,79349,79351,0,2,3
22617,6,2,79355,79355,79357,0,2,4
22618,1,1,79356,79357,79358,1,2,0
22619,3,2,79359,79359,79361,0,2,1
22620,1,1,79360,79361,79362,1,2,0
22621,5,2,79365,79365,79367,0,2,3
22622,6,2,79371,79371,79373,0,2,4
22623,4,3,79375,79375,79378,0,3,2
22624,5,1,79380,79380,79381,0,1,2
22625,4,3,79384,79384,79387,0,3,3
22626,4,2,79388,79388,79390,0,2,1
22627,6,1,79394,79394,79395,0,1,4
22628,5,2,79399,79399,79401,0,2,4
22629,4,2,79403,79403,79405,0,2,2
22630,6,2,79409,79409,79411,0,2,4
22631,6,1,79415,79415,79416,0,1,4
22632,2,3,79417,79417,79420,0,3,1
22633,2,2,79419,79420,79422,1,3,0
22634,5,1,79424,79424,79425,0,1,2
22635,5,3,79429,79429,79432,0,3,4
22636,1,3,79430,79432,79435,2,5,0
22637,2,1,79432,79435,79436,3,4,0
22638,1,1,79433,79436,79437,3,4,0
22639,3,2,79436,79437,79439,1,3,0
22640,3,2,79439,79439,79441,0,2,0
22641,1,1,79440,79441,79442,1,2,0
22642,2,2,79442,79442,79444,0,2,0
22643,4,1,79446,79446,79447,0,1,2
22644,3,1,79449,79449,79450,0,1,2
22645,6,3,79455,79455,79458,0,3,5
22646,1,2,79456,79458,79460,2,4,0
22647,4,1,79460,79460,79461,0,1,0
22648,6,2,79466,79466,79468,0,2,5
22649,2,3,79468,79468,79471,0,3,0
22650,1,2,79469,79471,79473,2,4,0
22651,5,2,79474,79474,79476,0,2,1
22652,2,3,79476,79476,79479,0,3,0
22653,1,2,79477,79479,79481,2,4,0
22654,1,2,79478,79481,79483,3,5,0
22655,2,2,79480,79483,79485,3,5,0
22656,5,1,79485,79485,79486,0,1,0
22657,2,2,79487,79487,79489,0,2,1
22658,2,3,79489,79489,79492,0,3,0
22659,1,3,79490,79492,79495,2,5,0
22660,5,2,79495,79495,79497,0,2,0
22661,5,3,79500,79500,79503,0,3,3
22662,4,2,79504,79504,79506,0,2,1
22663,6,2,79510,79510,79512,0,2,4
22664,2,1,79512,79512,79513,0,1,0
22665,3,3,79515,79515,79518,0,3,2
22666,3,1,79518,79518,79519,0,1,0
22667,6,1,79524,79524,79525,0,1,5
22668,1,2,79525,79525,79527,0,2,0
22669,2,3,79527,79527,79530,0,3,0
22670,2,2,79529,79530,79532,1,3,0
22671,4,3,79533,79533,79536,0,3,1
22672,2,3,79535,79536,79539,1,4,0
22673,4,1,79539,79539,79540,0,1,0
22674,5,3,79544,79544,79547,0,3,4
22675,3,3,79547,79547,79550,0,3,0
22676,5,1,79552,79552,79553,0,1,2
22677,4,1,79556,79556,79557,0,1,3
22678,4,3,79560,79560,79563,0,3,3
22679,5,3,79565,79565,79568,0,3,2
22680,1,1,79566,79568,79569,2,3,0
22681,4,3,79570,79570,79573,0,3,1
22682,6,1,79576,79576,79577,0,1,3
22683,6,1,79582,79582,79583,0,1,5
22684,4,2,79586,79586,79588,0,2,3
22685,6,2,79592,79592,79594,0,2,4
22686,1,1,79593,79594,79595,1,2,0
22687,3,3,79596,79596,79599,0,3,1
22688,6,1,79602,79602,79603,0,1,3
22689,2,2,79604,79604,79606,0,2,1
22690,1,2,79605,79606,79608,1,3,0
22691,6,2,79611,79611,79613,0,2,3
22692,3,1,79614,79614,79615,0,1,1
22693,4,1,79618,79618,79619,0,1,3
22694,4,3,79622,79622,79625,0,3,3
22695,6,1,79628,79628,79629,0,1,3
22696,3,3,79631,79631,79634,0,3,2
22697,4,1,79635,79635,79636,0,1,1
22698,6,1,79641,79641,79642,0,1,5
22699,6,3,79647,79647,79650,0,3,5
22700,6,3,79653,79653,79656,0,3,3
22701,2,1,79655,79656,79657,1,2,0
22702,4,3,79659,79659,79662,0,3,2
22703,5,1,79664,79664,79665,0,1,2
22704,3,3,79667,79667,79670,0,3,2
22705,6,3,79673,79673,79676,0,3,3
22706,3,1,79676,79676,79677,0,1,0
22707,5,2,79681,79681,79683,0,2,4
22708,1,3,79682,79683,79686,1,4,0
22709,5,2,79687,79687,79689,0,2,1
22710,6,2,79693,79693,79695,0,2,4
22711,2,1,79695,79695,79696,0,1,0
22712,6,2,79701,79701,79703,0,2,5
22713,1,2,79702,79703,79705,1,3,0
22714,6,2,79708,79708,79710,0,2,3
22715,4,2,79712,79712,79714,0,2,2
22716,3,2,79715,79715,79717,0,2,1
22717,4,1,79719,79719,79720,0,1,2
22718,3,2,79722,79722,79724,0,2,2
22719,6,2,79728,79728,79730,0,2,4
22720,1,2,79729,79730,79732,1,3,0
22721,2,2,79731,79732,79734,1,3,0
22722,4,2,79735,79735,79737,0,2,1
22723,4,2,79739,79739,79741,0,2,2
22724,1,1,79740,79741,79742,1,2,0
22725,1,2,79741,79742,79744,1,3,0
22726,6,3,79747,79747,79750,0,3,3
22727,4,1,79751,79751,79752,0,1,1
22728,5,3,79756,79756,79759,0,3,4
22729,3,1,79759,79759,79760,0,1,0
22730,3,1,79762,79762,79763,0,1,2
22731,1,1,79763,79763,79764,0,1,0
22732,4,2,79767,79767,79769,0,2,3
22733,4,3,79771,79771,79774,0,3,2
22734,2,1,79773,79774,79775,1,2,0
22735,2,3,79775,79775,79778,0,3,0
22736,3,2,79778,79778,79780,0,2,0
22737,4,2,79782,79782,79784,0,2,2
22738,4,3,79786,79786,79789,0,3,2
22739,1,2,79787,79789,79791,2,4,0
22740,5,3,79792,79792,79795,0,3,1
22741,2,1,79794,79795,79796,1,2,0
22742,6,2,79800,79800,79802,0,2,4
22743,2,3,79802,79802,79805,0,3,0
22744,2,1,79804,79805,79806,1,2,0
22745,3,1,79807,79807,79808,0,1,1
22746,6,1,79813,79813,79814,0,1,5
22747,1,1,79814,79814,79815,0,1,0
22748,5,3,79819,79819,79822,0,3,4
22749,2,1,79821,79822,79823,1,2,0
22750,2,1,79823,79823,79824,0,1,0
22751,5,3,79828,79828,79831,0,3,4
22752,4,1,79832,79832,79833,0,1,1
22753,2,1,79834,79834,79835,0,1,1
22754,5,3,79839,79839,79842,0,3,4
22755,5,2,79844,79844,79846,0,2,2
22756,1,1,79845,79846,79847,1,2,0
22757,5,2,79850,79850,79852,0,2,3
22758,2,1,79852,79852,79853,0,1,0
22759,2,1,79854,79854,79855,0,1,1
22760,2,2,79856,79856,79858,0,2,1
22761,5,2,79861,79861,79863,0,2,3
22762,1,3,79862,79863,79866,1,4,0
22763,6,1,79868,79868,79869,0,1,2
22764,5,1,79873,79873,79874,0,1,4
22765,5,3,79878,79878,79881,0,3,4
22766,3,3,79881,79881,79884,0,3,0
22767,4,2,79885,79885,79887,0,2,1
22768,2,1,79887,79887,79888,0,1,0
22769,6,2,79893,79893,79895,0,2,5
22770,4,3,79897,79897,79900,0,3,2
22771,5,1,79902,79902,79903,0,1,2
22772,6,3,79908,79908,79911,0,3,5
22773,3,3,79911,79911,79914,0,3,0
22774,2,3,79913,79914,79917,1,4,0
22775,5,2,79918,79918,79920,0,2,1
22776,4,1,79922,79922,79923,0,1,2
22777,3,2,79925,79925,79927,0,2,2
22778,3,1,79928,79928,79929,0,1,1
22779,4,3,79932,79932,79935,0,3,3
22780,3,2,79935,79935,79937,0,2,0
22781,6,2,79941,79941,79943,0,2,4
22782,6,3,79947,79947,79950,0,3,4
22783,5,1,79952,79952,79953,0,1,2
22784,5,3,79957,79957,79960,0,3,4
22785,3,2,79960,79960,79962,0,2,0
22786,2,1,79962,79962,79963,0,1,0
22787,4,2,79966,79966,79968,0,2,3
22788,5,3,79971,79971,79974,0,3,3
22789,5,2,79976,79976,79978,0,2,2
22790,6,3,79982,79982,79985,0,3,4
22791,4,2,79986,79986,79988,0,2,1
22792,1,2,79987,79988,79990,1,3,0
22793,1,3,79988,79990,79993,2,5,0
22794,3,1,79991,79993,79994,2,3,0
22795,4,1,79995,79995,79996,0,1,1
22796,5,2,80000,80000,80002,0,2,4
22797,5,3,80005,80005,80008,0,3,3
22798,2,2,80007,80008,80010,1,3,0
22799,6,1,80013,80013,80014,0,1,3
22800,4,1,80017,80017,80018,0,1,3
22801,4,2,80021,80021,80023,0,2,3
22802,5,2,80026,80026,80028,0,2,3
22803,2,1,80028,80028,80029,0,1,0
22804,3,1,80031,80031,80032,0,1,2
22805,4,1,80035,80035,80036,0,1,3
22806,4,2,80039,80039,80041,0,2,3
22807,6,2,80045,80045,80047,0,2,4
22808,3,1,80048,80048,80049,0,1,1
22809,5,3,80053,80053,80056,0,3,4
22810,1,2,80054,80056,80058,2,4,0
22811,5,3,80059,80059,80062,0,3,1
22812,3,2,80062,80062,80064,0,2,0
22813,1,1,80063,80064,80065,1,2,0
22814,2,1,80065,80065,80066,0,1,0
22815,1,2,80066,80066,80068,0,2,0
22816,1,1,80067,80068,80069,1,2,0
22817,3,2,80070,80070,80072,0,2,1
22818,2,2,80072,80072,80074,0,2,0
22819,1,1,80073,80074,80075,1,2,0
22820,2,3,80075,80075,80078,0,3,0
22821,1,2,80076,80078,80080,2,4,0
22822,1,3,80077,80080,80083,3,6,0
22823,1,2,80078,80083,80085,5,7,0
22824,6,2,80084,80085,80087,1,3,0
22825,6,2,80090,80090,80092,0,2,3
22826,6,1,80096,80096,80097,0,1,4
22827,6,3,80102,80102,80105,0,3,5
22828,1,2,80103,80105,80107,2,4,0
22829,6,2,80109,80109,80111,0,2,2
22830,4,2,80113,80113,80115,0,2,2
22831,3,3,80116,80116,80119,0,3,1
22832,4,2,80120,80120,80122,0,2,1
22833,2,3,80122,80122,80125,0,3,0
22834,5,1,80127,80127,80128,0,1,2
22835,3,1,80130,80130,80131,0,1,2
22836,4,3,80134,80134,80137,0,3,3
22837,5,1,80139,80139,80140,0,1,2
22838,4,3,80143,80143,80146,0,3,3
22839,2,2,80145,80146,80148,1,3,0
22840,6,3,80151,80151,80154,0,3,3
22841,3,1,80154,80154,80155,0,1,0
22842,4,1,80158,80158,80159,0,1,3
22843,2,2,80160,80160,80162,0,2,1
22844,2,1,80162,80162,80163,0,1,0
22845,6,1,80168,80168,80169,0,1,5
22846,1,2,80169,80169,80171,0,2,0
22847,5,1,80174,80174,80175,0,1,3
22848,4,2,80178,80178,80180,0,2,3
22849,3,3,80181,80181,80184,0,3,1
22850,6,1,80187,80187,80188,0,1,3
22851,2,3,80189,80189,80192,0,3,1
22852,2,3,80191,80192,80195,1,4,0
22853,6,1,80197,80197,80198,0,1,2
22854,3,2,80200,80200,80202,0,2,2
22855,5,1,80205,80205,80206,0,1,3
22856,4,3,80209,80209,80212,0,3,3
22857,4,1,80213,80213,80214,0,1,1
22858,6,1,80219,80219,80220,0,1,5
22859,3,2,80222,80222,80224,0,2,2
22860,5,2,80227,80227,80229,0,2,3
22861,5,1,80232,80232,80233,0,1,3
22862,2,3,80234,80234,80237,0,3,1
22863,4,1,80238,80238,80239,0,1,1
22864,3,2,80241,80241,80243,0,2,2
22865,6,2,80247,80247,80249,0,2,4
22866,2,3,80249,80249,80252,0,3,0
22867,2,2,80251,80252,80254,1,3,0
22868,1,3,80252,80254,80257,2,5,0
22869,1,2,80253,80257,80259,4,6,0
22870,3,3,80256,80259,80262,3,6,0
22871,1,2,80257,80262,80264,5,7,0
22872,3,3,80260,80264,80267,4,7,0
22873,6,2,80266,80267,80269,1,3,0
22874,6,2,80272,80272,80274,0,2,3
22875,1,3,80273,80274,80277,1,4,0
22876,1,1,80274,80277,80278,3,4,0
22877,2,1,80276,80278,80279,2,3,0
22878,5,1,80281,80281,80282,0,1,2
22879,2,2,80283,80283,80285,0,2,1
22880,1,1,80284,80285,80286,1,2,0
22881,3,3,80287,80287,80290,0,3,1
22882,6,3,80293,80293,80296,0,3,3
22883,5,2,80298,80298,80300,0,2,2
22884,1,1,80299,80300,80301,1,2,0
22885,1,2,80300,80301,80303,1,3,0
22886,3,2,80303,80303,80305,0,2,0
22887,6,2,80309,80309,80311,0,2,4
22888,1,3,80310,80311,80314,1,4,0
22889,1,2,80311,80314,80316,3,5,0
22890,3,3,80314,80316,80319,2,5,0
22891,1,3,80315,80319,80322,4,7,0
22892,4,3,80319,80322,80325,3,6,0
22893,4,3,80323,80325,80328,2,5,0
22894,3,3,80326,80328,80331,2,5,0
22895,5,3,80331,80331,80334,0,3,0
22896,6,1,80337,80337,80338,0,1,3
22897,3,2,80340,80340,80342,0,2,2
22898,5,3,80345,80345,80348,0,3,3
22899,2,1,80347,80348,80349,1,2,0
22900,5,1,80352,80352,80353,0,1,3
22901,4,3,80356,80356,80359,0,3,3
22902,5,3,80361,80361,80364,0,3,2
22903,3,1,80364,80364,80365,0,1,0
22904,6,3,80370,80370,80373,0,3,5
22905,2,2,80372,80373,80375,1,3,0
22906,4,3,80376,80376,80379,0,3,1
22907,6,1,80382,80382,80383,0,1,3
22908,6,2,80388,80388,80390,0,2,5
22909,6,3,80394,80394,80397,0,3,4
22910,2,2,80396,80397,80399,1,3,0
22911,5,2,80401,80401,80403,0,2,2
22912,3,1,80404,80404,80405,0,1,1
22913,3,2,80407,80407,80409,0,2,2
22914,3,3,80410,80410,80413,0,3,1
22915,6,2,80416,80416,80418,0,2,3
22916,6,1,80422,80422,80423,0,1,4
22917,5,2,80427,80427,80429,0,2,4
22918,4,2,80431,80431,80433,0,2,2
22919,3,2,80434,80434,80436,0,2,1
22920,4,3,80438,80438,80441,0,3,2
22921,4,1,80442,80442,80443,0,1,1
22922,1,2,80443,80443,80445,0,2,0
22923,3,2,80446,80446,80448,0,2,1
22924,3,3,80449,80449,80452,0,3,1
22925,5,3,80454,80454,80457,0,3,2
22926,2,2,80456,80457,80459,1,3,0
22927,1,3,80457,80459,80462,2,5,0
22928,3,3,80460,80462,80465,2,5,0
22929,3,1,80463,80465,80466,2,3,0
22930,6,3,80469,80469,80472,0,3,3
22931,2,3,80471,80472,80475,1,4,0
22932,3,3,80474,80475,80478,1,4,0
22933,1,2,80475,80478,80480,3,5,0
22934,5,2,80480,80480,80482,0,2,0
22935,6,3,80486,80486,80489,0,3,4
22936,6,2,80492,80492,80494,0,2,3
22937,2,2,80494,80494,80496,0,2,0
22938,5,1,80499,80499,80500,0,1,3
22939,5,1,80504,80504,80505,0,1,4
22940,5,1,80509,80509,80510,0,1,4
22941,6,3,80515,80515,80518,0,3,5
22942,4,2,80519,80519,80521,0,2,1
22943,4,1,80523,80523,80524,0,1,2
22944,1,3,80524,80524,80527,0,3,0
22945,1,1,80525,80527,80528,2,3,0
22946,1,1,80526,80528,80529,2,3,0
22947,1,2,80527,80529,80531,2,4,0
22948,4,2,80531,80531,80533,0,2,0
22949,1,2,80532,80533,80535,1,3,0
22950,4,3,80536,80536,80539,0,3,1
22951,5,1,80541,80541,80542,0,1,2
22952,3,2,80544,80544,80546,0,2,2
22953,1,2,80545,80546,80548,1,3,0
22954,2,1,80547,80548,80549,1,2,0
22955,1,1,80548,80549,80550,1,2,0
22956,5,2,80553,80553,80555,0,2,3
22957,3,2,80556,80556,80558,0,2,1
22958,5,1,80561,80561,80562,0,1,3
22959,5,1,80566,80566,80567,0,1,4
22960,5,3,80571,80571,80574,0,3,4
22961,4,3,80575,80575,80578,0,3,1
22962,3,2,80578,80578,80580,0,2,0
22963,5,1,80583,80583,80584,0,1,3
22964,3,1,80586,80586,80587,0,1,2
22965,6,2,80592,80592,80594,0,2,5
22966,5,2,80597,80597,80599,0,2,3
22967,3,1,80600,80600,80601,0,1,1
22968,5,3,80605,80605,80608,0,3,4
22969,3,2,80608,80608,80610,0,2,0
22970,6,2,80614,80614,80616,0,2,4
22971,5,3,80619,80619,80622,0,3,3
22972,5,2,80624,80624,80626,0,2,2
22973,4,3,80628,80628,80631,0,3,2
22974,4,2,80632,80632,80634,0,2,1
22975,5,3,80637,80637,80640,0,3,3
22976,5,2,80642,80642,80644,0,2,2
22977,3,1,80645,80645,80646,0,1,1
22978,5,1,80650,80650,80651,0,1,4
22979,3,2,80653,80653,80655,0,2,2
22980,1,1,80654,80655,80656,1,2,0
22981,2,1,80656,80656,80657,0,1,0
22982,1,1,80657,80657,80658,0,1,0
22983,1,1,80658,80658,80659,0,1,0
22984,6,1,80664,80664,80665,0,1,5
22985,3,3,80667,80667,80670,0,3,2
22986,6,2,80673,80673,80675,0,2,3
22987,4,3,80677,80677,80680,0,3,2
22988,2,3,80679,80680,80683,1,4,0
22989,4,1,80683,80683,80684,0,1,0
22990,5,3,80688,80688,80691,0,3,4
22991,5,1,80693,80693,80694,0,1,2
22992,3,1,80696,80696,80697,0,1,2
22993,6,2,80702,80702,80704,0,2,5
22994,6,3,80708,80708,80711,0,3,4
22995,6,1,80714,80714,80715,0,1,3
22996,1,1,80715,80715,80716,0,1,0
22997,1,2,80716,80716,80718,0,2,0
22998,1,3,80717,80718,80721,1,4,0
22999,2,2,80719,80721,80723,2,4,0
23000,4,1,80723,80723,80724,0,1,0
23001,2,2,80725,80725,80727,0,2,1
23002,4,1,80729,80729,80730,0,1,2
23003,2,3,80731,80731,80734,0,3,1
23004,4,1,80735,80735,80736,0,1,1
23005,4,2,80739,80739,80741,0,2,3
23006,3,2,80742,80742,80744,0,2,1
23007,6,3,80748,80748,80751,0,3,4
23008,3,1,80751,80751,80752,0,1,0
23009,6,1,80757,80757,80758,0,1,5
23010,1,2,80758,80758,80760,0,2,0
23011,2,1,80760,80760,80761,0,1,0
23012,4,3,80764,80764,80767,0,3,3
23013,4,1,80768,80768,80769,0,1,1
23014,4,2,80772,80772,80774,0,2,3
23015,6,3,80778,80778,80781,0,3,4
23016,4,2,80782,80782,80784,0,2,1
23017,4,3,80786,80786,80789,0,3,2
23018,1,3,80787,80789,80792,2,5,0
23019,6,3,80793,80793,80796,0,3,1
23020,1,2,80794,80796,80798,2,4,0
23021,5,3,80799,80799,80802,0,3,1
23022,4,3,80803,80803,80806,0,3,1
23023,2,2,80805,80806,80808,1,3,0
23024,5,3,80810,80810,80813,0,3,2
23025,6,1,80816,80816,80817,0,1,3
23026,4,2,80820,80820,80822,0,2,3
23027,2,2,80822,80822,80824,0,2,0
23028,6,1,80828,80828,80829,0,1,4
23029,5,1,80833,80833,80834,0,1,4
23030,3,2,80836,80836,80838,0,2,2
23031,5,3,80841,80841,80844,0,3,3
23032,5,2,80846,80846,80848,0,2,2
23033,4,2,80850,80850,80852,0,2,2
23034,5,3,80855,80855,80858,0,3,3
23035,5,3,80860,80860,80863,0,3,2
23036,6,3,80866,80866,80869,0,3,3
23037,4,2,80870,80870,80872,0,2,1
23038,1,3,80871,80872,80875,1,4,0
23039,3,3,80874,80875,80878,1,4,0
23040,1,3,80875,80878,80881,3,6,0
23041,5,2,80880,80881,80883,1,3,0
23042,5,2,80885,80885,80887,0,2,2
23043,3,3,80888,80888,80891,0,3,1
23044,3,3,80891,80891,80894,0,3,0
23045,3,2,80894,80894,80896,0,2,0
23046,1,3,80895,80896,80899,1,4,0
23047,1,3,80896,80899,80902,3,6,0
23048,4,2,80900,80902,80904,2,4,0
23049,4,1,80904,80904,80905,0,1,0
23050,4,2,80908,80908,80910,0,2,3
23051,3,3,80911,80911,80914,0,3,1
23052,6,3,80917,80917,80920,0,3,3
23053,2,3,80919,80920,80923,1,4,0
23054,4,2,80923,80923,80925,0,2,0
23055,6,3,80929,80929,80932,0,3,4
23056,6,2,80935,80935,80937,0,2,3
23057,5,3,80940,80940,80943,0,3,3
23058,6,1,80946,80946,80947,0,1,3
23059,6,1,80952,80952,80953,0,1,5
23060,3,1,80955,80955,80956,0,1,2
23061,5,2,80960,80960,80962,0,2,4
23062,2,1,80962,80962,80963,0,1,0
23063,4,3,80966,80966,80969,0,3,3
23064,1,1,80967,80969,80970,2,3,0
23065,3,2,80970,80970,80972,0,2,0
23066,4,2,80974,80974,80976,0,2,2
23067,4,1,80978,80978,80979,0,1,2
23068,4,2,80982,80982,80984,0,2,3
23069,5,3,80987,80987,80990,0,3,3
23070,4,1,80991,80991,80992,0,1,1
23071,2,1,80993,80993,80994,0,1,1
23072,5,1,80998,80998,80999,0,1,4
23073,1,1,80999,80999,81000,0,1,0
23074,3,1,81002,81002,81003,0,1,2
23075,5,3,81007,81007,81010,0,3,4
23076,1,3,81008,81010,81013,2,5,0
23077,2,1,81010,81013,81014,3,4,0
23078,1,2,81011,81014,81016,3,5,0
23079,5,3,81016,81016,81019,0,3,0
23080,1,3,81017,81019,81022,2,5,0
23081,6,3,81023,81023,81026,0,3,1
23082,4,1,81027,81027,81028,0,1,1
23083,2,2,81029,81029,81031,0,2,1
23084,6,3,81035,81035,81038,0,3,4
23085,1,2,81036,81038,81040,2,4,0
23086,2,2,81038,81040,81042,2,4,0
23087,6,2,81044,81044,81046,0,2,2
23088,3,2,81047,81047,81049,0,2,1
23089,3,1,81050,81050,81051,0,1,1
23090,6,3,81056,81056,81059,0,3,5
23091,1,1,81057,81059,81060,2,3,0
23092,3,2,81060,81060,81062,0,2,0
23093,2,3,81062,81062,81065,0,3,0
23094,5,3,81067,81067,81070,0,3,2
23095,4,3,81071,81071,81074,0,3,1
23096,1,1,81072,81074,81075,2,3,0
23097,2,2,81074,81075,81077,1,3,0
23098,5,3,81079,81079,81082,0,3,2
23099,6,1,81085,81085,81086,0,1,3
23100,3,3,81088,81088,81091,0,3,2
23101,4,2,81092,81092,81094,0,2,1
23102,1,3,81093,81094,81097,1,4,0
23103,6,3,81099,81099,81102,0,3,2
23104,6,2,81105,81105,81107,0,2,3
23105,1,3,81106,81107,81110,1,4,0
23106,1,3,81107,81110,81113,3,6,0
23107,3,1,81110,81113,81114,3,4,0
23108,4,3,81114,81114,81117,0,3,0
23109,2,1,81116,81117,81118,1,2,0
23110,3,3,81119,81119,81122,0,3,1
23111,3,2,81122,81122,81124,0,2,0
23112,6,1,81128,81128,81129,0,1,4
23113,6,2,81134,81134,81136,0,2,5
23114,4,2,81138,81138,81140,0,2,2
23115,5,3,81143,81143,81146,0,3,3
23116,2,2,81145,81146,81148,1,3,0
23117,6,1,81151,81151,81152,0,1,3
23118,1,2,81152,81152,81154,0,2,0
23119,4,1,81156,81156,81157,0,1,2
23120,5,3,81161,81161,81164,0,3,4
23121,4,2,81165,81165,81167,0,2,1
23122,2,1,81167,81167,81168,0,1,0
23123,5,2,81172,81172,81174,0,2,4
23124,1,1,81173,81174,81175,1,2,0
23125,3,2,81176,81176,81178,0,2,1
23126,1,3,81177,81178,81181,1,4,0
23127,2,2,81179,81181,81183,2,4,0
23128,4,1,81183,81183,81184,0,1,0
23129,2,1,81185,81185,81186,0,1,1
23130,5,2,81190,81190,81192,0,2,4
23131,1,3,81191,81192,81195,1,4,0
23132,3,1,81194,81195,81196,1,2,0
23133,6,3,81200,81200,81203,0,3,4
23134,5,1,81205,81205,81206,0,1,2
23135,4,2,81209,81209,81211,0,2,3
23136,5,3,81214,81214,81217,0,3,3
23137,4,2,81218,81218,81220,0,2,1
23138,3,2,81221,81221,81223,0,2,1
23139,6,1,81227,81227,81228,0,1,4
23140,2,3,81229,81229,81232,0,3,1
23141,1,1,81230,81232,81233,2,3,0
23142,6,3,81236,81236,81239,0,3,3
23143,4,3,81240,81240,81243,0,3,1
23144,5,1,81245,81245,81246,0,1,2
23145,3,1,81248,81248,81249,0,1,2
23146,4,3,81252,81252,81255,0,3,3
23147,6,2,81258,81258,81260,0,2,3
23148,3,1,81261,81261,81262,0,1,1
23149,5,2,81266,81266,81268,0,2,4
23150,3,3,81269,81269,81272,0,3,1
23151,4,1,81273,81273,81274,0,1,1
23152,3,2,81276,81276,81278,0,2,2
23153,4,2,81280,81280,81282,0,2,2
23154,4,2,81284,81284,81286,0,2,2
23155,3,1,81287,81287,81288,0,1,1
23156,5,2,81292,81292,81294,0,2,4
23157,6,2,81298,81298,81300,0,2,4
23158,6,3,81304,81304,81307,0,3,4
23159,4,3,81308,81308,81311,0,3,1
23160,2,2,81310,81311,81313,1,3,0
23161,4,1,81314,81314,81315,0,1,1
23162,4,1,81318,81318,81319,0,1,3
23163,3,3,81321,81321,81324,0,3,2
23164,2,3,81323,81324,81327,1,4,0
23165,3,2,81326,81327,81329,1,3,0
23166,4,3,81330,81330,81333,0,3,1
23167,4,3,81334,81334,81337,0,3,1
23168,5,3,81339,81339,81342,0,3,2
23169,5,2,81344,81344,81346,0,2,2
23170,5,3,81349,81349,81352,0,3,3
23171,4,1,81353,81353,81354,0,1,1
23172,5,3,81358,81358,81361,0,3,4
23173,4,3,81362,81362,81365,0,3,1
23174,6,1,81368,81368,81369,0,1,3
23175,6,2,81374,81374,81376,0,2,5
23176,4,3,81378,81378,81381,0,3,2
23177,1,2,81379,81381,81383,2,4,0
23178,2,2,81381,81383,81385,2,4,0
23179,4,1,81385,81385,81386,0,1,0
23180,5,3,81390,81390,81393,0,3,4
23181,5,2,81395,81395,81397,0,2,2
23182,5,3,81400,81400,81403,0,3,3
23183,2,1,81402,81403,81404,1,2,0
23184,4,2,81406,81406,81408,0,2,2
23185,5,2,81411,81411,81413,0,2,3
23186,4,1,81415,81415,81416,0,1,2
23187,6,3,81421,81421,81424,0,3,5
23188,2,3,81423,81424,81427,1,4,0
23189,2,3,81425,81427,81430,2,5,0
23190,3,2,81428,81430,81432,2,4,0
23191,5,1,81433,81433,81434,0,1,1
23192,2,2,81435,81435,81437,0,2,1
23193,5,2,81440,81440,81442,0,2,3
23194,3,3,81443,81443,81446,0,3,1
23195,3,1,81446,81446,81447,0,1,0
23196,6,3,81452,81452,81455,0,3,5
23197,3,2,81455,81455,81457,0,2,0
23198,6,2,81461,81461,81463,0,2,4
23199,4,2,81465,81465,81467,0,2,2
23200,4,2,81469,81469,81471,0,2,2
23201,5,2,81474,81474,81476,0,2,3
23202,3,1,81477,81477,81478,0,1,1
23203,6,1,81483,81483,81484,0,1,5
23204,2,1,81485,81485,81486,0,1,1
23205,1,2,81486,81486,81488,0,2,0
23206,2,1,81488,81488,81489,0,1,0
23207,3,1,81491,81491,81492,0,1,2
23208,3,3,81494,81494,81497,0,3,2
23209,3,1,81497,81497,81498,0,1,0
23210,3,2,81500,81500,81502,0,2,2
23211,5,1,81505,81505,81506,0,1,3
23212,4,2,81509,81509,81511,0,2,3
23213,2,3,81511,81511,81514,0,3,0
23214,4,2,81515,81515,81517,0,2,1
23215,4,2,81519,81519,81521,0,2,2
23216,5,3,81524,81524,81527,0,3,3
23217,2,1,81526,81527,81528,1,2,0
23218,4,3,81530,81530,81533,0,3,2
23219,2,3,81532,81533,81536,1,4,0
23220,1,1,81533,81536,81537,3,4,0
23221,4,3,81537,81537,81540,0,3,0
23222,5,2,81542,81542,81544,0,2,2
23223,2,1,81544,81544,81545,0,1,0
23224,6,2,81550,81550,81552,0,2,5
23225,2,2,81552,81552,81554,0,2,0
23226,6,1,81558,81558,81559,0,1,4
23227,6,1,81564,81564,81565,0,1,5
23228,2,3,81566,81566,81569,0,3,1
23229,2,3,81568,81569,81572,1,4,0
23230,2,2,81570,81572,81574,2,4,0
23231,5,3,81575,81575,81578,0,3,1
23232,4,3,81579,81579,81582,0,3,1
23233,6,3,81585,81585,81588,0,3,3
23234,1,3,81586,81588,81591,2,5,0
23235,2,1,81588,81591,81592,3,4,0
23236,6,3,81594,81594,81597,0,3,2
23237,2,1,81596,81597,81598,1,2,0
23238,2,1,81598,81598,81599,0,1,0
23239,4,1,81602,81602,81603,0,1,3
23240,1,2,81603,81603,81605,0,2,0
23241,2,2,81605,81605,81607,0,2,0
23242,4,3,81609,81609,81612,0,3,2
23243,1,3,81610,81612,81615,2,5,0
23244,5,1,81615,81615,81616,0,1,0
23245,4,1,81619,81619,81620,0,1,3
23246,1,1,81620,81620,81621,0,1,0
23247,6,1,81626,81626,81627,0,1,5
23248,1,1,81627,81627,81628,0,1,0
23249,2,2,81629,81629,81631,0,2,1
23250,3,2,81632,81632,81634,0,2,1
23251,2,3,81634,81634,81637,0,3,0
23252,3,1,81637,81637,81638,0,1,0
23253,1,3,81638,81638,81641,0,3,0
23254,4,1,81642,81642,81643,0,1,1
23255,4,1,81646,81646,81647,0,1,3
23256,6,3,81652,81652,81655,0,3,5
23257,1,1,81653,81655,81656,2,3,0
23258,3,3,81656,81656,81659,0,3,0
23259,3,1,81659,81659,81660,0,1,0
23260,6,2,81665,81665,81667,0,2,5
23261,2,3,81667,81667,81670,0,3,0
23262,3,1,81670,81670,81671,0,1,0
23263,6,1,81676,81676,81677,0,1,5
23264,6,1,81682,81682,81683,0,1,5
23265,4,3,81686,81686,81689,0,3,3
23266,1,2,81687,81689,81691,2,4,0
23267,4,3,81691,81691,81694,0,3,0
23268,3,1,81694,81694,81695,0,1,0
23269,6,1,81700,81700,81701,0,1,5
23270,4,2,81704,81704,81706,0,2,3
23271,6,2,81710,81710,81712,0,2,4
23272,4,3,81714,81714,81717,0,3,2
23273,2,3,81716,81717,81720,1,4,0
23274,6,2,81722,81722,81724,0,2,2
23275,1,2,81723,81724,81726,1,3,0
23276,5,1,81728,81728,81729,0,1,2
23277,4,1,81732,81732,81733,0,1,3
23278,3,2,81735,81735,81737,0,2,2
23279,4,1,81739,81739,81740,0,1,2
23280,6,2,81745,81745,81747,0,2,5
23281,2,2,81747,81747,81749,0,2,0
23282,5,1,81752,81752,81753,0,1,3
23283,5,3,81757,81757,81760,0,3,4
23284,5,2,81762,81762,81764,0,2,2
23285,5,3,81767,81767,81770,0,3,3
23286,1,2,81768,81770,81772,2,4,0
23287,1,2,81769,81772,81774,3,5,0
23288,3,2,81772,81774,81776,2,4,0
23289,5,1,81777,81777,81778,0,1,1
23290,6,1,81783,81783,81784,0,1,5
23291,1,1,81784,81784,81785,0,1,0
23292,6,1,81790,81790,81791,0,1,5
23293,5,2,81795,81795,81797,0,2,4
23294,5,3,81800,81800,81803,0,3,3
23295,3,2,81803,81803,81805,0,2,0
23296,4,2,81807,81807,81809,0,2,2
23297,4,2,81811,81811,81813,0,2,2
23298,4,2,81815,81815,81817,0,2,2
23299,1,2,81816,81817,81819,1,3,0
23300,3,1,81819,81819,81820,0,1,0
23301,1,2,81820,81820,81822,0,2,0
23302,1,1,81821,81822,81823,1,2,0
23303,6,1,81827,81827,81828,0,1,4
23304,2,2,81829,81829,81831,0,2,1
23305,4,2,81833,81833,81835,0,2,2
23306,6,3,81839,81839,81842,0,3,4
23307,2,2,81841,81842,81844,1,3,0
23308,1,1,81842,81844,81845,2,3,0
23309,2,2,81844,81845,81847,1,3,0
23310,6,3,81850,81850,81853,0,3,3
23311,1,2,81851,81853,81855,2,4,0
23312,4,3,81855,81855,81858,0,3,0
23313,1,2,81856,81858,81860,2,4,0
23314,3,3,81859,81860,81863,1,4,0
23315,2,1,81861,81863,81864,2,3,0
23316,6,3,81867,81867,81870,0,3,3
23317,3,3,81870,81870,81873,0,3,0
23318,1,3,81871,81873,81876,2,5,0
23319,4,3,81875,81876,81879,1,4,0
23320,5,1,81880,81880,81881,0,1,1
23321,6,1,81886,81886,81887,0,1,5
23322,1,3,81887,81887,81890,0,3,0
23323,3,3,81890,81890,81893,0,3,0
23324,4,1,81894,81894,81895,0,1,1
23325,6,3,81900,81900,81903,0,3,5
23326,1,1,81901,81903,81904,2,3,0
23327,4,3,81905,81905,81908,0,3,1
23328,6,3,81911,81911,81914,0,3,3
23329,4,1,81915,81915,81916,0,1,1
23330,2,2,81917,81917,81919,0,2,1
23331,1,1,81918,81919,81920,1,2,0
23332,6,3,81924,81924,81927,0,3,4
23333,6,3,81930,81930,81933,0,3,3
23334,3,1,81933,81933,81934,0,1,0
23335,5,1,81938,81938,81939,0,1,4
23336,5,1,81943,81943,81944,0,1,4
23337,5,3,81948,81948,81951,0,3,4
23338,4,3,81952,81952,81955,0,3,1
23339,6,2,81958,81958,81960,0,2,3
23340,3,3,81961,81961,81964,0,3,1
23341,2,1,81963,81964,81965,1,2,0
23342,3,1,81966,81966,81967,0,1,1
23343,4,3,81970,81970,81973,0,3,3
23344,5,2,81975,81975,81977,0,2,2
23345,1,1,81976,81977,81978,1,2,0
23346,1,1,81977,81978,81979,1,2,0
23347,3,3,81980,81980,81983,0,3,1
23348,1,1,81981,81983,81984,2,3,0
23349,4,1,81985,81985,81986,0,1,1
23350,2,2,81987,81987,81989,0,2,1
23351,5,3,81992,81992,81995,0,3,3
23352,5,1,81997,81997,81998,0,1,2
23353,2,3,81999,81999,82002,0,3,1
23354,3,2,82002,82002,82004,0,2,0
23355,6,2,82008,82008,82010,0,2,4
23356,3,3,82011,82011,82014,0,3,1
23357,1,1,82012,82014,82015,2,3,0
23358,3,2,82015,82015,82017,0,2,0
23359,6,2,82021,82021,82023,0,2,4
23360,2,2,82023,82023,82025,0,2,0
23361,5,3,82028,82028,82031,0,3,3
23362,6,1,82034,82034,82035,0,1,3
23363,6,1,82040,82040,82041,0,1,5
23364,1,1,82041,82041,82042,0,1,0
23365,6,2,82047,82047,82049,0,2,5
23366,4,1,82051,82051,82052,0,1,2
23367,1,2,82052,82052,82054,0,2,0
23368,2,3,82054,82054,82057,0,3,0
23369,4,2,82058,82058,82060,0,2,1
23370,6,3,82064,82064,82067,0,3,4
23371,1,3,82065,82067,82070,2,5,0
23372,3,3,82068,82070,82073,2,5,0
23373,2,2,82070,82073,82075,3,5,0
23374,1,3,82071,82075,82078,4,7,0
23375,3,3,82074,82078,82081,4,7,0
23376,6,2,82080,82081,82083,1,3,0
23377,4,1,82084,82084,82085,0,1,1
23378,3,1,82087,82087,82088,0,1,2
23379,4,2,82091,82091,82093,0,2,3
23380,3,3,82094,82094,82097,0,3,1
23381,5,3,82099,82099,82102,0,3,2
23382,4,3,82103,82103,82106,0,3,1
23383,3,1,82106,82106,82107,0,1,0
23384,4,1,82110,82110,82111,0,1,3
23385,5,1,82115,82115,82116,0,1,4
23386,4,2,82119,82119,82121,0,2,3
23387,3,3,82122,82122,82125,0,3,1
23388,6,2,82128,82128,82130,0,2,3
23389,4,2,82132,82132,82134,0,2,2
23390,3,2,82135,82135,82137,0,2,1
23391,6,1,82141,82141,82142,0,1,4
23392,4,1,82145,82145,82146,0,1,3
23393,1,2,82146,82146,82148,0,2,0
23394,5,3,82151,82151,82154,0,3,3
23395,4,1,82155,82155,82156,0,1,1
23396,6,2,82161,82161,82163,0,2,5
23397,3,1,82164,82164,82165,0,1,1
23398,6,3,82170,82170,82173,0,3,5
23399,3,3,82173,82173,82176,0,3,0
23400,2,2,82175,82176,82178,1,3,0
23401,1,1,82176,82178,82179,2,3,0
23402,4,1,82180,82180,82181,0,1,1
23403,3,3,82183,82183,82186,0,3,2
23404,1,1,82184,82186,82187,2,3,0
23405,1,1,82185,82187,82188,2,3,0
23406,2,2,82187,82188,82190,1,3,0
23407,2,3,82189,82190,82193,1,4,0
23408,6,3,82195,82195,82198,0,3,2
23409,3,2,82198,82198,82200,0,2,0
23410,5,2,82203,82203,82205,0,2,3
23411,6,3,82209,82209,82212,0,3,4
23412,3,1,82212,82212,82213,0,1,0
23413,3,2,82215,82215,82217,0,2,2
23414,3,2,82218,82218,82220,0,2,1
23415,3,2,82221,82221,82223,0,2,1
23416,6,1,82227,82227,82228,0,1,4
23417,2,2,82229,82229,82231,0,2,1
23418,4,1,82233,82233,82234,0,1,2
23419,6,2,82239,82239,82241,0,2,5
23420,2,3,82241,82241,82244,0,3,0
23421,4,3,82245,82245,82248,0,3,1
23422,2,1,82247,82248,82249,1,2,0
23423,2,3,82249,82249,82252,0,3,0
23424,6,2,82255,82255,82257,0,2,3
23425,2,2,82257,82257,82259,0,2,0
23426,6,3,82263,82263,82266,0,3,4
23427,4,1,82267,82267,82268,0,1,1
23428,4,1,82271,82271,82272,0,1,3
23429,4,1,82275,82275,82276,0,1,3
23430,3,3,82278,82278,82281,0,3,2
23431,3,3,82281,82281,82284,0,3,0
23432,6,2,82287,82287,82289,0,2,3
23433,6,2,82293,82293,82295,0,2,4
23434,2,2,82295,82295,82297,0,2,0
23435,2,2,82297,82297,82299,0,2,0
23436,6,3,82303,82303,82306,0,3,4
23437,2,2,82305,82306,82308,1,3,0
23438,3,3,82308,82308,82311,0,3,0
23439,3,3,82311,82311,82314,0,3,0
23440,2,1,82313,82314,82315,1,2,0
23441,5,1,82318,82318,82319,0,1,3
23442,5,3,82323,82323,82326,0,3,4
23443,4,1,82327,82327,82328,0,1,1
23444,1,2,82328,82328,82330,0,2,0
23445,2,3,82330,82330,82333,0,3,0
23446,1,2,82331,82333,82335,2,4,0
23447,2,2,82333,82335,82337,2,4,0
23448,1,2,82334,82337,82339,3,5,0
23449,3,1,82337,82339,82340,2,3,0
23450,4,2,82341,82341,82343,0,2,1
23451,2,2,82343,82343,82345,0,2,0
23452,6,3,82349,82349,82352,0,3,4
23453,3,1,82352,82352,82353,0,1,0
23454,1,1,82353,82353,82354,0,1,0
23455,3,3,82356,82356,82359,0,3,2
23456,3,2,82359,82359,82361,0,2,0
23457,1,3,82360,82361,82364,1,4,0
23458,4,2,82364,82364,82366,0,2,0
23459,5,2,82369,82369,82371,0,2,3
23460,3,3,82372,82372,82375,0,3,1
23461,1,1,82373,82375,82376,2,3,0
23462,5,3,82378,82378,82381,0,3,2
23463,3,2,82381,82381,82383,0,2,0
23464,1,2,82382,82383,82385,1,3,0
23465,3,3,82385,82385,82388,0,3,0
23466,2,1,82387,82388,82389,1,2,0
23467,2,1,82389,82389,82390,0,1,0
23468,6,3,82395,82395,82398,0,3,5
23469,1,2,82396,82398,82400,2,4,0
23470,1,1,82397,82400,82401,3,4,0
23471,2,2,82399,82401,82403,2,4,0
23472,5,2,82404,82404,82406,0,2,1
23473,3,3,82407,82407,82410,0,3,1
23474,3,2,82410,82410,82412,0,2,0
23475,6,1,82416,82416,82417,0,1,4
23476,5,3,82421,82421,82424,0,3,4
23477,1,1,82422,82424,82425,2,3,0
23478,3,2,82425,82425,82427,0,2,0
23479,6,2,82431,82431,82433,0,2,4
23480,3,3,82434,82434,82437,0,3,1
23481,5,1,82439,82439,82440,0,1,2
23482,2,1,82441,82441,82442,0,1,1
23483,4,3,82445,82445,82448,0,3,3
23484,1,3,82446,82448,82451,2,5,0
23485,5,3,82451,82451,82454,0,3,0
23486,6,2,82457,82457,82459,0,2,3
23487,6,2,82463,82463,82465,0,2,4
23488,1,3,82464,82465,82468,1,4,0
23489,3,3,82467,82468,82471,1,4,0
23490,3,3,82470,82471,82474,1,4,0
23491,4,3,82474,82474,82477,0,3,0
23492,3,1,82477,82477,82478,0,1,0
23493,5,3,82482,82482,82485,0,3,4
23494,3,2,82485,82485,82487,0,2,0
23495,2,1,82487,82487,82488,0,1,0
23496,4,3,82491,82491,82494,0,3,3
23497,2,2,82493,82494,82496,1,3,0
23498,2,2,82495,82496,82498,1,3,0
23499,3,1,82498,82498,82499,0,1,0
23500,4,2,82502,82502,82504,0,2,3
23501,1,2,82503,82504,82506,1,3,0
23502,1,3,82504,82506,82509,2,5,0
23503,2,3,82506,82509,82512,3,6,0
23504,5,2,82511,82512,82514,1,3,0
23505,2,3,82513,82514,82517,1,4,0
23506,2,1,82515,82517,82518,2,3,0
23507,5,3,82520,82520,82523,0,3,2
23508,6,2,82526,82526,82528,0,2,3
23509,1,3,82527,82528,82531,1,4,0
23510,2,3,82529,82531,82534,2,5,0
23511,4,1,82533,82534,82535,1,2,0
23512,4,3,82537,82537,82540,0,3,2
23513,6,2,82543,82543,82545,0,2,3
23514,2,2,82545,82545,82547,0,2,0
23515,4,1,82549,82549,82550,0,1,2
23516,4,2,82553,82553,82555,0,2,3
23517,3,2,82556,82556,82558,0,2,1
23518,3,3,82559,82559,82562,0,3,1
23519,3,1,82562,82562,82563,0,1,0
23520,2,1,82564,82564,82565,0,1,1
23521,2,3,82566,82566,82569,0,3,1
23522,1,2,82567,82569,82571,2,4,0
23523,5,2,82572,82572,82574,0,2,1
23524,6,2,82578,82578,82580,0,2,4
23525,5,3,82583,82583,82586,0,3,3
23526,2,1,82585,82586,82587,1,2,0
23527,3,2,82588,82588,82590,0,2,1
23528,4,1,82592,82592,82593,0,1,2
23529,5,3,82597,82597,82600,0,3,4
23530,3,3,82600,82600,82603,0,3,0
23531,5,2,82605,82605,82607,0,2,2
23532,5,2,82610,82610,82612,0,2,3
23533,6,2,82616,82616,82618,0,2,4
23534,6,3,82622,82622,82625,0,3,4
23535,1,2,82623,82625,82627,2,4,0
23536,1,2,82624,82627,82629,3,5,0
23537,6,1,82630,82630,82631,0,1,1
23538,1,1,82631,82631,82632,0,1,0
23539,5,1,82636,82636,82637,0,1,4
23540,2,2,82638,82638,82640,0,2,1
23541,5,3,82643,82643,82646,0,3,3
23542,6,3,82649,82649,82652,0,3,3
23543,1,1,82650,82652,82653,2,3,0
23544,2,3,82652,82653,82656,1,4,0
23545,4,2,82656,82656,82658,0,2,0
23546,3,1,82659,82659,82660,0,1,1
23547,3,3,82662,82662,82665,0,3,2
23548,4,1,82666,82666,82667,0,1,1
23549,2,2,82668,82668,82670,0,2,1
23550,4,2,82672,82672,82674,0,2,2
23551,3,3,82675,82675,82678,0,3,1
23552,2,3,82677,82678,82681,1,4,0
23553,5,1,82682,82682,82683,0,1,1
23554,6,3,82688,82688,82691,0,3,5
23555,4,1,82692,82692,82693,0,1,1
23556,5,3,82697,82697,82700,0,3,4
23557,6,1,82703,82703,82704,0,1,3
23558,3,2,82706,82706,82708,0,2,2
23559,3,1,82709,82709,82710,0,1,1
23560,2,1,82711,82711,82712,0,1,1
23561,1,1,82712,82712,82713,0,1,0
23562,6,1,82718,82718,82719,0,1,5
23563,2,2,82720,82720,82722,0,2,1
23564,2,2,82722,82722,82724,0,2,0
23565,2,3,82724,82724,82727,0,3,0
23566,6,2,82730,82730,82732,0,2,3
23567,1,2,82731,82732,82734,1,3,0
23568,2,3,82733,82734,82737,1,4,0
23569,3,1,82736,82737,82738,1,2,0
23570,3,3,82739,82739,82742,0,3,1
23571,2,3,82741,82742,82745,1,4,0
23572,6,3,82747,82747,82750,0,3,2
23573,2,2,82749,82750,82752,1,3,0
23574,1,2,82750,82752,82754,2,4,0
23575,1,1,82751,82754,82755,3,4,0
23576,3,2,82754,82755,82757,1,3,0
23577,4,3,82758,82758,82761,0,3,1
23578,2,3,82760,82761,82764,1,4,0
23579,6,3,82766,82766,82769,0,3,2
23580,3,2,82769,82769,82771,0,2,0
23581,2,1,82771,82771,82772,0,1,0
23582,3,3,82774,82774,82777,0,3,2
23583,2,3,82776,82777,82780,1,4,0
23584,1,2,82777,82780,82782,3,5,0
23585,1,2,82778,82782,82784,4,6,0
23586,3,2,82781,82784,82786,3,5,0
23587,6,1,82787,82787,82788,0,1,1
23588,2,2,82789,82789,82791,0,2,1
23589,2,2,82791,82791,82793,0,2,0
23590,6,1,82797,82797,82798,0,1,4
23591,1,2,82798,82798,82800,0,2,0
23592,4,3,82802,82802,82805,0,3,2
23593,3,1,82805,82805,82806,0,1,0
23594,2,2,82807,82807,82809,0,2,1
23595,6,3,82813,82813,82816,0,3,4
23596,3,2,82816,82816,82818,0,2,0
23597,2,1,82818,82818,82819,0,1,0
23598,4,2,82822,82822,82824,0,2,3
23599,6,3,82828,82828,82831,0,3,4
23600,1,2,82829,82831,82833,2,4,0
23601,4,3,82833,82833,82836,0,3,0
23602,3,2,82836,82836,82838,0,2,0
23603,5,3,82841,82841,82844,0,3,3
23604,2,2,82843,82844,82846,1,3,0
23605,5,2,82848,82848,82850,0,2,2
23606,4,3,82852,82852,82855,0,3,2
23607,5,2,82857,82857,82859,0,2,2
23608,6,2,82863,82863,82865,0,2,4
23609,6,1,82869,82869,82870,0,1,4
23610,2,3,82871,82871,82874,0,3,1
23611,3,1,82874,82874,82875,0,1,0
23612,1,2,82875,82875,82877,0,2,0
23613,5,3,82880,82880,82883,0,3,3
23614,3,1,82883,82883,82884,0,1,0
23615,5,1,82888,82888,82889,0,1,4
23616,3,1,82891,82891,82892,0,1,2
23617,3,3,82894,82894,82897,0,3,2
23618,3,3,82897,82897,82900,0,3,0
23619,6,1,82903,82903,82904,0,1,3
23620,6,1,82909,82909,82910,0,1,5
23621,4,2,82913,82913,82915,0,2,3
23622,1,2,82914,82915,82917,1,3,0
23623,5,1,82919,82919,82920,0,1,2
23624,4,3,82923,82923,82926,0,3,3
23625,1,3,82924,82926,82929,2,5,0
23626,1,2,82925,82929,82931,4,6,0
23627,6,1,82931,82931,82932,0,1,0
23628,6,3,82937,82937,82940,0,3,5
23629,5,1,82942,82942,82943,0,1,2
23630,4,3,82946,82946,82949,0,3,3
23631,5,3,82951,82951,82954,0,3,2
23632,4,3,82955,82955,82958,0,3,1
23633,1,3,82956,82958,82961,2,5,0
23634,6,3,82962,82962,82965,0,3,1
23635,1,3,82963,82965,82968,2,5,0
23636,5,3,82968,82968,82971,0,3,0
23637,3,2,82971,82971,82973,0,2,0
23638,4,2,82975,82975,82977,0,2,2
23639,2,1,82977,82977,82978,0,1,0
23640,4,3,82981,82981,82984,0,3,3
23641,2,3,82983,82984,82987,1,4,0
23642,5,3,82988,82988,82991,0,3,1
23643,3,1,82991,82991,82992,0,1,0
23644,2,3,82993,82993,82996,0,3,1
23645,2,1,82995,82996,82997,1,2,0
23646,1,1,82996,82997,82998,1,2,0
23647,5,1,83001,83001,83002,0,1,3
23648,1,1,83002,83002,83003,0,1,0
23649,4,2,83006,83006,83008,0,2,3
23650,2,2,83008,83008,83010,0,2,0
23651,2,1,83010,83010,83011,0,1,0
23652,1,2,83011,83011,83013,0,2,0
23653,1,1,83012,83013,83014,1,2,0
23654,2,2,83014,83014,83016,0,2,0
23655,3,2,83017,83017,83019,0,2,1
23656,2,1,83019,83019,83020,0,1,0
23657,5,1,83024,83024,83025,0,1,4
23658,6,2,83030,83030,83032,0,2,5
23659,6,1,83036,83036,83037,0,1,4
23660,2,1,83038,83038,83039,0,1,1
23661,6,1,83044,83044,83045,0,1,5
23662,1,3,83045,83045,83048,0,3,0
23663,4,3,83049,83049,83052,0,3,1
23664,3,2,83052,83052,83054,0,2,0
23665,3,2,83055,83055,83057,0,2,1
23666,6,1,83061,83061,83062,0,1,4
23667,5,2,83066,83066,83068,0,2,4
23668,5,1,83071,83071,83072,0,1,3
23669,6,3,83077,83077,83080,0,3,5
23670,5,3,83082,83082,83085,0,3,2
23671,4,3,83086,83086,83089,0,3,1
23672,6,3,83092,83092,83095,0,3,3
23673,1,3,83093,83095,83098,2,5,0
23674,3,1,83096,83098,83099,2,3,0
23675,4,1,83100,83100,83101,0,1,1
23676,2,2,83102,83102,83104,0,2,1
23677,5,3,83107,83107,83110,0,3,3
23678,1,3,83108,83110,83113,2,5,0
23679,6,1,83114,83114,83115,0,1,1
23680,2,1,83116,83116,83117,0,1,1
23681,6,2,83122,83122,83124,0,2,5
23682,1,1,83123,83124,83125,1,2,0
23683,2,1,83125,83125,83126,0,1,0
23684,3,3,83128,83128,83131,0,3,2
23685,5,3,83133,83133,83136,0,3,2
23686,1,3,83134,83136,83139,2,5,0
23687,4,3,83138,83139,83142,1,4,0
23688,6,1,83144,83144,83145,0,1,2
23689,2,1,83146,83146,83147,0,1,1
23690,5,1,83151,83151,83152,0,1,4
23691,5,1,83156,83156,83157,0,1,4
23692,6,1,83162,83162,83163,0,1,5
23693,2,1,83164,83164,83165,0,1,1
23694,4,1,83168,83168,83169,0,1,3
23695,5,2,83173,83173,83175,0,2,4
23696,3,2,83176,83176,83178,0,2,1
23697,2,1,83178,83178,83179,0,1,0
23698,4,2,83182,83182,83184,0,2,3
23699,4,3,83186,83186,83189,0,3,2
23700,5,2,83191,83191,83193,0,2,2
23701,2,1,83193,83193,83194,0,1,0
23702,4,1,83197,83197,83198,0,1,3
23703,4,3,83201,83201,83204,0,3,3
23704,1,3,83202,83204,83207,2,5,0
23705,6,2,83208,83208,83210,0,2,1
23706,5,1,83213,83213,83214,0,1,3
23707,3,2,83216,83216,83218,0,2,2
23708,1,2,83217,83218,83220,1,3,0
23709,6,1,83223,83223,83224,0,1,3
23710,2,2,83225,83225,83227,0,2,1
23711,3,1,83228,83228,83229,0,1,1
23712,3,2,83231,83231,83233,0,2,2
23713,2,2,83233,83233,83235,0,2,0
23714,6,2,83239,83239,83241,0,2,4
23715,1,2,83240,83241,83243,1,3,0
23716,4,2,83244,83244,83246,0,2,1
23717,3,3,83247,83247,83250,0,3,1
23718,6,2,83253,83253,83255,0,2,3
23719,6,2,83259,83259,83261,0,2,4
23720,4,2,83263,83263,83265,0,2,2
23721,5,1,83268,83268,83269,0,1,3
23722,4,2,83272,83272,83274,0,2,3
23723,1,1,83273,83274,83275,1,2,0
23724,4,1,83277,83277,83278,0,1,2
23725,2,3,83279,83279,83282,0,3,1
23726,5,1,83284,83284,83285,0,1,2
23727,4,3,83288,83288,83291,0,3,3
23728,3,3,83291,83291,83294,0,3,0
23729,4,3,83295,83295,83298,0,3,1
23730,5,1,83300,83300,83301,0,1,2
23731,1,3,83301,83301,83304,0,3,0
23732,1,3,83302,83304,83307,2,5,0
23733,5,3,83307,83307,83310,0,3,0
23734,5,3,83312,83312,83315,0,3,2
23735,6,1,83318,83318,83319,0,1,3
23736,3,3,83321,83321,83324,0,3,2
23737,1,3,83322,83324,83327,2,5,0
23738,6,3,83328,83328,83331,0,3,1
23739,2,1,83330,83331,83332,1,2,0
23740,2,2,83332,83332,83334,0,2,0
23741,6,2,83338,83338,83340,0,2,4
23742,1,2,83339,83340,83342,1,3,0
23743,1,2,83340,83342,83344,2,4,0
23744,6,3,83346,83346,83349,0,3,2
23745,4,1,83350,83350,83351,0,1,1
23746,1,3,83351,83351,83354,0,3,0
23747,1,3,83352,83354,83357,2,5,0
23748,6,3,83358,83358,83361,0,3,1
23749,1,2,83359,83361,83363,2,4,0
23750,3,3,83362,83363,83366,1,4,0
23751,3,3,83365,83366,83369,1,4,0
23752,3,3,83368,83369,83372,1,4,0
23753,6,1,83374,83374,83375,0,1,2
23754,3,3,83377,83377,83380,0,3,2
23755,4,2,83381,83381,83383,0,2,1
23756,4,2,83385,83385,83387,0,2,2
23757,1,2,83386,83387,83389,1,3,0
23758,5,1,83391,83391,83392,0,1,2
23759,4,1,83395,83395,83396,0,1,3
23760,6,1,83401,83401,83402,0,1,5
23761,3,3,83404,83404,83407,0,3,2
23762,6,3,83410,83410,83413,0,3,3
23763,2,1,83412,83413,83414,1,2,0
23764,5,1,83417,83417,83418,0,1,3
23765,1,3,83418,83418,83421,0,3,0
23766,3,3,83421,83421,83424,0,3,0
23767,3,1,83424,83424,83425,0,1,0
23768,3,1,83427,83427,83428,0,1,2
23769,6,3,83433,83433,83436,0,3,5
23770,5,3,83438,83438,83441,0,3,2
23771,3,3,83441,83441,83444,0,3,0
23772,4,3,83445,83445,83448,0,3,1
23773,5,3,83450,83450,83453,0,3,2
23774,2,3,83452,83453,83456,1,4,0
23775,6,2,83458,83458,83460,0,2,2
23776,3,1,83461,83461,83462,0,1,1
23777,3,1,83464,83464,83465,0,1,2
23778,5,2,83469,83469,83471,0,2,4
23779,6,1,83475,83475,83476,0,1,4
23780,3,2,83478,83478,83480,0,2,2
23781,3,2,83481,83481,83483,0,2,1
23782,1,2,83482,83483,83485,1,3,0
23783,2,2,83484,83485,83487,1,3,0
23784,4,1,83488,83488,83489,0,1,1
23785,4,1,83492,83492,83493,0,1,3
23786,4,3,83496,83496,83499,0,3,3
23787,2,1,83498,83499,83500,1,2,0
23788,6,3,83504,83504,83507,0,3,4
23789,1,3,83505,83507,83510,2,5,0
23790,2,2,83507,83510,83512,3,5,0
23791,1,2,83508,83512,83514,4,6,0
23792,2,3,83510,83514,83517,4,7,0
23793,6,1,83516,83517,83518,1,2,0
23794,6,2,83522,83522,83524,0,2,4
23795,3,1,83525,83525,83526,0,1,1
23796,5,1,83530,83530,83531,0,1,4
23797,3,2,83533,83533,83535,0,2,2
23798,2,3,83535,83535,83538,0,3,0
23799,1,3,83536,83538,83541,2,5,0
23800,2,3,83538,83541,83544,3,6,0
23801,1,2,83539,83544,83546,5,7,0
23802,6,2,83545,83546,83548,1,3,0
23803,4,2,83549,83549,83551,0,2,1
23804,4,2,83553,83553,83555,0,2,2
23805,3,1,83556,83556,83557,0,1,1
23806,5,2,83561,83561,83563,0,2,4
23807,6,1,83567,83567,83568,0,1,4
23808,3,3,83570,83570,83573,0,3,2
23809,3,3,83573,83573,83576,0,3,0
23810,6,2,83579,83579,83581,0,2,3
23811,6,3,83585,83585,83588,0,3,4
23812,1,1,83586,83588,83589,2,3,0
23813,2,3,83588,83589,83592,1,4,0
23814,3,3,83591,83592,83595,1,4,0
23815,5,1,83596,83596,83597,0,1,1
23816,1,1,83597,83597,83598,0,1,0
23817,4,1,83601,83601,83602,0,1,3
23818,6,1,83607,83607,83608,0,1,5
23819,1,2,83608,83608,83610,0,2,0
23820,4,1,83612,83612,83613,0,1,2
23821,5,1,83617,83617,83618,0,1,4
23822,4,2,83621,83621,83623,0,2,3
23823,5,2,83626,83626,83628,0,2,3
23824,5,3,83631,83631,83634,0,3,3
23825,3,2,83634,83634,83636,0,2,0
23826,6,1,83640,83640,83641,0,1,4
23827,6,3,83646,83646,83649,0,3,5
23828,6,1,83652,83652,83653,0,1,3
23829,6,2,83658,83658,83660,0,2,5
23830,4,2,83662,83662,83664,0,2,2
23831,3,3,83665,83665,83668,0,3,1
23832,1,3,83666,83668,83671,2,5,0
23833,4,2,83670,83671,83673,1,3,0
23834,1,1,83671,83673,83674,2,3,0
23835,5,3,83676,83676,83679,0,3,2
23836,3,2,83679,83679,83681,0,2,0
23837,1,2,83680,83681,83683,1,3,0
23838,5,1,83685,83685,83686,0,1,2
23839,2,3,83687,83687,83690,0,3,1
23840,5,2,83692,83692,83694,0,2,2
23841,6,3,83698,83698,83701,0,3,4
23842,6,2,83704,83704,83706,0,2,3
23843,5,3,83709,83709,83712,0,3,3
23844,3,1,83712,83712,83713,0,1,0
23845,2,1,83714,83714,83715,0,1,1
23846,2,2,83716,83716,83718,0,2,1
23847,6,1,83722,83722,83723,0,1,4
23848,5,2,83727,83727,83729,0,2,4
23849,6,2,83733,83733,83735,0,2,4
23850,4,1,83737,83737,83738,0,1,2
23851,1,2,83738,83738,83740,0,2,0
23852,3,1,83741,83741,83742,0,1,1
23853,6,3,83747,83747,83750,0,3,5
23854,2,3,83749,83750,83753,1,4,0
23855,2,2,83751,83753,83755,2,4,0
23856,4,3,83755,83755,83758,0,3,0
23857,5,1,83760,83760,83761,0,1,2
23858,2,2,83762,83762,83764,0,2,1
23859,4,1,83766,83766,83767,0,1,2
23860,4,2,83770,83770,83772,0,2,3
23861,2,3,83772,83772,83775,0,3,0
23862,2,2,83774,83775,83777,1,3,0
23863,4,3,83778,83778,83781,0,3,1
23864,6,2,83784,83784,83786,0,2,3
23865,1,1,83785,83786,83787,1,2,0
23866,4,2,83789,83789,83791,0,2,2
23867,3,1,83792,83792,83793,0,1,1
23868,6,2,83798,83798,83800,0,2,5
23869,6,3,83804,83804,83807,0,3,4
23870,4,3,83808,83808,83811,0,3,1
23871,1,3,83809,83811,83814,2,5,0
23872,5,1,83814,83814,83815,0,1,0
23873,1,1,83815,83815,83816,0,1,0
23874,2,3,83817,83817,83820,0,3,1
23875,1,1,83818,83820,83821,2,3,0
23876,3,2,83821,83821,83823,0,2,0
23877,3,1,83824,83824,83825,0,1,1
23878,2,3,83826,83826,83829,0,3,1
23879,2,1,83828,83829,83830,1,2,0
23880,5,3,83833,83833,83836,0,3,3
23881,4,2,83837,83837,83839,0,2,1
23882,6,1,83843,83843,83844,0,1,4
23883,2,2,83845,83845,83847,0,2,1
23884,1,3,83846,83847,83850,1,4,0
23885,1,2,83847,83850,83852,3,5,0
23886,1,3,83848,83852,83855,4,7,0
23887,5,1,83853,83855,83856,2,3,0
23888,6,3,83859,83859,83862,0,3,3
23889,3,3,83862,83862,83865,0,3,0
23890,4,3,83866,83866,83869,0,3,1
23891,6,2,83872,83872,83874,0,2,3
23892,4,1,83876,83876,83877,0,1,2
23893,4,2,83880,83880,83882,0,2,3
23894,4,1,83884,83884,83885,0,1,2
23895,6,2,83890,83890,83892,0,2,5
23896,2,2,83892,83892,83894,0,2,0
23897,2,1,83894,83894,83895,0,1,0
23898,4,2,83898,83898,83900,0,2,3
23899,2,1,83900,83900,83901,0,1,0
23900,5,3,83905,83905,83908,0,3,4
23901,2,1,83907,83908,83909,1,2,0
23902,5,1,83912,83912,83913,0,1,3
23903,5,2,83917,83917,83919,0,2,4
23904,1,2,83918,83919,83921,1,3,0
23905,2,3,83920,83921,83924,1,4,0
23906,1,2,83921,83924,83926,3,5,0
23907,6,1,83927,83927,83928,0,1,1
23908,2,1,83929,83929,83930,0,1,1
23909,2,1,83931,83931,83932,0,1,1
23910,1,3,83932,83932,83935,0,3,0
23911,5,3,83937,83937,83940,0,3,2
23912,5,1,83942,83942,83943,0,1,2
23913,6,2,83948,83948,83950,0,2,5
23914,2,2,83950,83950,83952,0,2,0
23915,1,1,83951,83952,83953,1,2,0
23916,1,3,83952,83953,83956,1,4,0
23917,3,2,83955,83956,83958,1,3,0
23918,3,3,83958,83958,83961,0,3,0
23919,5,1,83963,83963,83964,0,1,2
23920,3,1,83966,83966,83967,0,1,2
23921,1,1,83967,83967,83968,0,1,0
23922,3,1,83970,83970,83971,0,1,2
23923,6,3,83976,83976,83979,0,3,5
23924,1,3,83977,83979,83982,2,5,0
23925,2,3,83979,83982,83985,3,6,0
23926,6,1,83985,83985,83986,0,1,0
23927,5,2,83990,83990,83992,0,2,4
23928,4,1,83994,83994,83995,0,1,2
23929,5,3,83999,83999,84002,0,3,4
23930,2,3,84001,84002,84005,1,4,0
23931,5,2,84006,84006,84008,0,2,1
23932,2,3,84008,84008,84011,0,3,0
23933,6,1,84014,84014,84015,0,1,3
23934,2,3,84016,84016,84019,0,3,1
23935,4,2,84020,84020,84022,0,2,1
23936,2,1,84022,84022,84023,0,1,0
23937,1,3,84023,84023,84026,0,3,0
23938,6,2,84029,84029,84031,0,2,3
23939,4,1,84033,84033,84034,0,1,2
23940,4,2,84037,84037,84039,0,2,3
23941,2,1,84039,84039,84040,0,1,0
23942,2,1,84041,84041,84042,0,1,1
23943,5,2,84046,84046,84048,0,2,4
23944,4,3,84050,84050,84053,0,3,2
23945,1,2,84051,84053,84055,2,4,0
23946,1,3,84052,84055,84058,3,6,0
23947,3,1,84055,84058,84059,3,4,0
23948,4,2,84059,84059,84061,0,2,0
23949,2,3,84061,84061,84064,0,3,0
23950,6,2,84067,84067,84069,0,2,3
23951,5,2,84072,84072,84074,0,2,3
23952,6,3,84078,84078,84081,0,3,4
23953,2,1,84080,84081,84082,1,2,0
23954,1,3,84081,84082,84085,1,4,0
23955,5,2,84086,84086,84088,0,2,1
23956,2,1,84088,84088,84089,0,1,0
23957,4,2,84092,84092,84094,0,2,3
23958,6,3,84098,84098,84101,0,3,4
23959,6,2,84104,84104,84106,0,2,3
23960,5,3,84109,84109,84112,0,3,3
23961,2,3,84111,84112,84115,1,4,0
23962,1,1,84112,84115,84116,3,4,0
23963,3,1,84115,84116,84117,1,2,0
23964,2,2,84117,84117,84119,0,2,0
23965,4,2,84121,84121,84123,0,2,2
23966,1,1,84122,84123,84124,1,2,0
23967,6,2,84128,84128,84130,0,2,4
23968,3,1,84131,84131,84132,0,1,1
23969,6,2,84137,84137,84139,0,2,5
23970,5,3,84142,84142,84145,0,3,3
23971,4,2,84146,84146,84148,0,2,1
23972,4,1,84150,84150,84151,0,1,2
23973,4,1,84154,84154,84155,0,1,3
23974,3,2,84157,84157,84159,0,2,2
23975,2,3,84159,84159,84162,0,3,0
23976,6,3,84165,84165,84168,0,3,3
23977,3,3,84168,84168,84171,0,3,0
23978,2,3,84170,84171,84174,1,4,0
23979,4,3,84174,84174,84177,0,3,0
23980,6,1,84180,84180,84181,0,1,3
23981,3,3,84183,84183,84186,0,3,2
23982,6,1,84189,84189,84190,0,1,3
23983,1,2,84190,84190,84192,0,2,0
23984,5,1,84195,84195,84196,0,1,3
23985,6,3,84201,84201,84204,0,3,5
23986,3,3,84204,84204,84207,0,3,0
23987,1,3,84205,84207,84210,2,5,0
23988,4,1,84209,84210,84211,1,2,0
23989,4,1,84213,84213,84214,0,1,2
23990,2,3,84215,84215,84218,0,3,1
23991,5,1,84220,84220,84221,0,1,2
23992,2,3,84222,84222,84225,0,3,1
23993,3,1,84225,84225,84226,0,1,0
23994,3,1,84228,84228,84229,0,1,2
23995,5,1,84233,84233,84234,0,1,4
23996,1,3,84234,84234,84237,0,3,0
23997,5,1,84239,84239,84240,0,1,2
23998,2,2,84241,84241,84243,0,2,1
23999,6,2,84247,84247,84249,0,2,4
24000,1,3,84248,84249,84252,1,4,0
24001,3,2,84251,84252,84254,1,3,0
24002,5,3,84256,84256,84259,0,3,2
24003,3,1,84259,84259,84260,0,1,0
24004,1,3,84260,84260,84263,0,3,0
24005,6,3,84266,84266,84269,0,3,3
24006,2,1,84268,84269,84270,1,2,0
24007,5,2,84273,84273,84275,0,2,3
24008,2,3,84275,84275,84278,0,3,0
24009,2,2,84277,84278,84280,1,3,0
24010,3,1,84280,84280,84281,0,1,0
24011,4,3,84284,84284,84287,0,3,3
24012,6,1,84290,84290,84291,0,1,3
24013,5,2,84295,84295,84297,0,2,4
24014,6,1,84301,84301,84302,0,1,4
24015,6,2,84307,84307,84309,0,2,5
24016,4,3,84311,84311,84314,0,3,2
24017,4,2,84315,84315,84317,0,2,1
24018,3,2,84318,84318,84320,0,2,1
24019,3,1,84321,84321,84322,0,1,1
24020,5,2,84326,84326,84328,0,2,4
24021,2,2,84328,84328,84330,0,2,0
24022,6,1,84334,84334,84335,0,1,4
24023,1,1,84335,84335,84336,0,1,0
24024,3,1,84338,84338,84339,0,1,2
24025,4,2,84342,84342,84344,0,2,3
24026,3,3,84345,84345,84348,0,3,1
24027,5,2,84350,84350,84352,0,2,2
24028,6,3,84356,84356,84359,0,3,4
24029,4,1,84360,84360,84361,0,1,1
24030,1,2,84361,84361,84363,0,2,0
24031,4,2,84365,84365,84367,0,2,2
24032,2,3,84367,84367,84370,0,3,0
24033,1,1,84368,84370,84371,2,3,0
24034,4,2,84372,84372,84374,0,2,1
24035,2,3,84374,84374,84377,0,3,0
24036,5,2,84379,84379,84381,0,2,2
24037,5,3,84384,84384,84387,0,3,3
24038,1,1,84385,84387,84388,2,3,0
24039,2,2,84387,84388,84390,1,3,0
24040,5,1,84392,84392,84393,0,1,2
24041,3,3,84395,84395,84398,0,3,2
24042,6,2,84401,84401,84403,0,2,3
24043,2,1,84403,84403,84404,0,1,0
24044,5,2,84408,84408,84410,0,2,4
24045,6,2,84414,84414,84416,0,2,4
24046,5,3,84419,84419,84422,0,3,3
24047,5,3,84424,84424,84427,0,3,2
24048,2,1,84426,84427,84428,1,2,0
24049,5,1,84431,84431,84432,0,1,3
24050,2,1,84433,84433,84434,0,1,1
24051,1,2,84434,84434,84436,0,2,0
24052,2,3,84436,84436,84439,0,3,0
24053,3,2,84439,84439,84441,0,2,0
24054,2,3,84441,84441,84444,0,3,0
24055,4,1,84445,84445,84446,0,1,1
24056,4,3,84449,84449,84452,0,3,3
24057,2,2,84451,84452,84454,1,3,0
24058,4,1,84455,84455,84456,0,1,1
24059,2,2,84457,84457,84459,0,2,1
24060,1,3,84458,84459,84462,1,4,0
24061,6,1,84464,84464,84465,0,1,2
24062,6,1,84470,84470,84471,0,1,5
24063,1,1,84471,84471,84472,0,1,0
24064,2,2,84473,84473,84475,0,2,1
24065,5,3,84478,84478,84481,0,3,3
24066,5,1,84483,84483,84484,0,1,2
24067,1,3,84484,84484,84487,0,3,0
24068,5,3,84489,84489,84492,0,3,2
24069,5,2,84494,84494,84496,0,2,2
24070,5,2,84499,84499,84501,0,2,3
24071,5,1,84504,84504,84505,0,1,3
24072,2,3,84506,84506,84509,0,3,1
24073,6,2,84512,84512,84514,0,2,3
24074,2,1,84514,84514,84515,0,1,0
24075,3,1,84517,84517,84518,0,1,2
24076,2,1,84519,84519,84520,0,1,1
24077,2,1,84521,84521,84522,0,1,1
24078,5,3,84526,84526,84529,0,3,4
24079,4,2,84530,84530,84532,0,2,1
24080,6,1,84536,84536,84537,0,1,4
24081,6,2,84542,84542,84544,0,2,5
24082,4,3,84546,84546,84549,0,3,2
24083,3,2,84549,84549,84551,0,2,0
24084,4,3,84553,84553,84556,0,3,2
24085,2,2,84555,84556,84558,1,3,0
24086,4,1,84559,84559,84560,0,1,1
24087,1,1,84560,84560,84561,0,1,0
24088,3,3,84563,84563,84566,0,3,2
24089,6,3,84569,84569,84572,0,3,3
24090,4,1,84573,84573,84574,0,1,1
24091,1,3,84574,84574,84577,0,3,0
24092,5,2,84579,84579,84581,0,2,2
24093,2,2,84581,84581,84583,0,2,0
24094,3,1,84584,84584,84585,0,1,1
24095,4,1,84588,84588,84589,0,1,3
24096,5,2,84593,84593,84595,0,2,4
24097,1,1,84594,84595,84596,1,2,0
24098,1,2,84595,84596,84598,1,3,0
24099,6,3,84601,84601,84604,0,3,3
24100,3,3,84604,84604,84607,0,3,0
24101,4,3,84608,84608,84611,0,3,1
24102,6,2,84614,84614,84616,0,2,3
24103,3,1,84617,84617,84618,0,1,1
24104,4,3,84621,84621,84624,0,3,3
24105,4,1,84625,84625,84626,0,1,1
24106,2,3,84627,84627,84630,0,3,1
24107,3,2,84630,84630,84632,0,2,0
24108,4,2,84634,84634,84636,0,2,2
24109,4,1,84638,84638,84639,0,1,2
24110,5,2,84643,84643,84645,0,2,4
24111,1,3,84644,84645,84648,1,4,0
24112,6,2,84650,84650,84652,0,2,2
24113,6,3,84656,84656,84659,0,3,4
24114,3,1,84659,84659,84660,0,1,0
24115,3,3,84662,84662,84665,0,3,2
24116,6,3,84668,84668,84671,0,3,3
24117,5,2,84673,84673,84675,0,2,2
24118,5,3,84678,84678,84681,0,3,3
24119,6,1,84684,84684,84685,0,1,3
24120,1,2,84685,84685,84687,0,2,0
24121,5,2,84690,84690,84692,0,2,3
24122,6,2,84696,84696,84698,0,2,4
24123,6,2,84702,84702,84704,0,2,4
24124,3,3,84705,84705,84708,0,3,1
24125,6,3,84711,84711,84714,0,3,3
24126,2,3,84713,84714,84717,1,4,0
24127,3,1,84716,84717,84718,1,2,0
24128,5,1,84721,84721,84722,0,1,3
24129,6,2,84727,84727,84729,0,2,5
24130,4,3,84731,84731,84734,0,3,2
24131,6,3,84737,84737,84740,0,3,3
24132,5,1,84742,84742,84743,0,1,2
24133,5,2,84747,84747,84749,0,2,4
24134,3,3,84750,84750,84753,0,3,1
24135,6,3,84756,84756,84759,0,3,3
24136,5,1,84761,84761,84762,0,1,2
24137,3,1,84764,84764,84765,0,1,2
24138,5,2,84769,84769,84771,0,2,4
24139,5,3,84774,84774,84777,0,3,3
24140,4,2,84778,84778,84780,0,2,1
24141,2,1,84780,84780,84781,0,1,0
24142,2,1,84782,84782,84783,0,1,1
24143,5,3,84787,84787,84790,0,3,4
24144,5,2,84792,84792,84794,0,2,2
24145,5,2,84797,84797,84799,0,2,3
24146,1,1,84798,84799,84800,1,2,0
24147,5,3,84803,84803,84806,0,3,3
24148,4,1,84807,84807,84808,0,1,1
24149,3,3,84810,84810,84813,0,3,2
24150,1,2,84811,84813,84815,2,4,0
24151,6,2,84817,84817,84819,0,2,2
24152,6,2,84823,84823,84825,0,2,4
24153,3,2,84826,84826,84828,0,2,1
24154,1,3,84827,84828,84831,1,4,0
24155,3,2,84830,84831,84833,1,3,0
24156,4,1,84834,84834,84835,0,1,1
24157,6,3,84840,84840,84843,0,3,5
24158,4,2,84844,84844,84846,0,2,1
24159,2,2,84846,84846,84848,0,2,0
24160,5,3,84851,84851,84854,0,3,3
24161,3,3,84854,84854,84857,0,3,0
24162,2,3,84856,84857,84860,1,4,0
24163,4,2,84860,84860,84862,0,2,0
24164,3,3,84863,84863,84866,0,3,1
24165,5,3,84868,84868,84871,0,3,2
24166,6,2,84874,84874,84876,0,2,3
24167,5,1,84879,84879,84880,0,1,3
24168,1,3,84880,84880,84883,0,3,0
24169,5,3,84885,84885,84888,0,3,2
24170,4,3,84889,84889,84892,0,3,1
24171,1,1,84890,84892,84893,2,3,0
24172,2,1,84892,84893,84894,1,2,0
24173,2,1,84894,84894,84895,0,1,0
24174,2,1,84896,84896,84897,0,1,1
24175,3,1,84899,84899,84900,0,1,2
24176,2,3,84901,84901,84904,0,3,1
24177,2,1,84903,84904,84905,1,2,0
24178,2,1,84905,84905,84906,0,1,0
24179,1,1,84906,84906,84907,0,1,0
24180,1,2,84907,84907,84909,0,2,0
24181,6,1,84913,84913,84914,0,1,4
24182,4,2,84917,84917,84919,0,2,3
24183,4,3,84921,84921,84924,0,3,2
24184,1,3,84922,84924,84927,2,5,0
24185,2,2,84924,84927,84929,3,5,0
24186,5,1,84929,84929,84930,0,1,0
24187,6,3,84935,84935,84938,0,3,5
24188,1,1,84936,84938,84939,2,3,0
24189,5,1,84941,84941,84942,0,1,2
24190,3,1,84944,84944,84945,0,1,2
24191,4,1,84948,84948,84949,0,1,3
24192,1,2,84949,84949,84951,0,2,0
24193,2,1,84951,84951,84952,0,1,0
24194,1,1,84952,84952,84953,0,1,0
24195,6,3,84958,84958,84961,0,3,5
24196,1,3,84959,84961,84964,2,5,0
24197,6,3,84965,84965,84968,0,3,1
24198,5,3,84970,84970,84973,0,3,2
24199,1,3,84971,84973,84976,2,5,0
24200,5,3,84976,84976,84979,0,3,0
24201,5,1,84981,84981,84982,0,1,2
24202,2,3,84983,84983,84986,0,3,1
24203,2,2,84985,84986,84988,1,3,0
24204,5,2,84990,84990,84992,0,2,2
24205,3,3,84993,84993,84996,0,3,1
24206,2,1,84995,84996,84997,1,2,0
24207,4,3,84999,84999,85002,0,3,2
24208,5,2,85004,85004,85006,0,2,2
24209,3,1,85007,85007,85008,0,1,1
24210,3,3,85010,85010,85013,0,3,2
24211,5,1,85015,85015,85016,0,1,2
24212,1,2,85016,85016,85018,0,2,0
24213,4,3,85020,85020,85023,0,3,2
24214,1,3,85021,85023,85026,2,5,0
24215,5,3,85026,85026,85029,0,3,0
24216,1,1,85027,85029,85030,2,3,0
24217,2,2,85029,85030,85032,1,3,0
24218,2,1,85031,85032,85033,1,2,0
24219,6,3,85037,85037,85040,0,3,4
24220,6,2,85043,85043,85045,0,2,3
24221,1,1,85044,85045,85046,1,2,0
24222,3,2,85047,85047,85049,0,2,1
24223,4,2,85051,85051,85053,0,2,2
24224,6,1,85057,85057,85058,0,1,4
24225,2,2,85059,85059,85061,0,2,1
24226,3,3,85062,85062,85065,0,3,1
24227,1,3,85063,85065,85068,2,5,0
24228,2,3,85065,85068,85071,3,6,0
24229,4,3,85069,85071,85074,2,5,0
24230,1,2,85070,85074,85076,4,6,0
24231,3,1,85073,85076,85077,3,4,0
24232,2,3,85075,85077,85080,2,5,0
24233,3,3,85078,85080,85083,2,5,0
24234,1,1,85079,85083,85084,4,5,0
24235,3,2,85082,85084,85086,2,4,0
24236,3,3,85085,85086,85089,1,4,0
24237,3,2,85088,85089,85091,1,3,0
24238,4,2,85092,85092,85094,0,2,1
24239,3,1,85095,85095,85096,0,1,1
24240,5,2,85100,85100,85102,0,2,4
24241,2,3,85102,85102,85105,0,3,0
24242,4,1,85106,85106,85107,0,1,1
24243,5,1,85111,85111,85112,0,1,4
24244,6,1,85117,85117,85118,0,1,5
24245,6,1,85123,85123,85124,0,1,5
24246,5,3,85128,85128,85131,0,3,4
24247,1,3,85129,85131,85134,2,5,0
24248,4,1,85133,85134,85135,1,2,0
24249,1,2,85134,85135,85137,1,3,0
24250,1,2,85135,85137,85139,2,4,0
24251,4,2,85139,85139,85141,0,2,0
24252,1,2,85140,85141,85143,1,3,0
24253,5,1,85145,85145,85146,0,1,2
24254,1,1,85146,85146,85147,0,1,0
24255,5,1,85151,85151,85152,0,1,4
24256,5,1,85156,85156,85157,0,1,4
24257,6,1,85162,85162,85163,0,1,5
24258,3,3,85165,85165,85168,0,3,2
24259,4,2,85169,85169,85171,0,2,1
24260,6,3,85175,85175,85178,0,3,4
24261,3,3,85178,85178,85181,0,3,0
24262,1,3,85179,85181,85184,2,5,0
24263,3,1,85182,85184,85185,2,3,0
24264,4,2,85186,85186,85188,0,2,1
24265,4,3,85190,85190,85193,0,3,2
24266,6,2,85196,85196,85198,0,2,3
24267,6,3,85202,85202,85205,0,3,4
24268,4,2,85206,85206,85208,0,2,1
24269,2,1,85208,85208,85209,0,1,0
24270,6,1,85214,85214,85215,0,1,5
24271,6,3,85220,85220,85223,0,3,5
24272,1,2,85221,85223,85225,2,4,0
24273,5,2,85226,85226,85228,0,2,1
24274,2,1,85228,85228,85229,0,1,0
24275,4,1,85232,85232,85233,0,1,3
24276,2,2,85234,85234,85236,0,2,1
24277,5,1,85239,85239,85240,0,1,3
24278,5,1,85244,85244,85245,0,1,4
24279,4,2,85248,85248,85250,0,2,3
24280,2,3,85250,85250,85253,0,3,0
24281,3,1,85253,85253,85254,0,1,0
24282,2,3,85255,85255,85258,0,3,1
24283,4,3,85259,85259,85262,0,3,1
24284,6,1,85265,85265,85266,0,1,3
24285,2,1,85267,85267,85268,0,1,1
24286,3,1,85270,85270,85271,0,1,2
24287,5,1,85275,85275,85276,0,1,4
24288,1,3,85276,85276,85279,0,3,0
24289,4,3,85280,85280,85283,0,3,1
24290,5,2,85285,85285,85287,0,2,2
24291,5,1,85290,85290,85291,0,1,3
24292,2,3,85292,85292,85295,0,3,1
24293,6,1,85298,85298,85299,0,1,3
24294,4,1,85302,85302,85303,0,1,3
24295,2,2,85304,85304,85306,0,2,1
24296,3,3,85307,85307,85310,0,3,1
24297,3,2,85310,85310,85312,0,2,0
24298,4,1,85314,85314,85315,0,1,2
24299,6,3,85320,85320,85323,0,3,5
24300,2,1,85322,85323,85324,1,2,0
24301,6,1,85328,85328,85329,0,1,4
24302,1,1,85329,85329,85330,0,1,0
24303,2,1,85331,85331,85332,0,1,1
24304,4,2,85335,85335,85337,0,2,3
24305,2,3,85337,85337,85340,0,3,0
24306,6,2,85343,85343,85345,0,2,3
24307,4,1,85347,85347,85348,0,1,2
24308,3,2,85350,85350,85352,0,2,2
24309,5,3,85355,85355,85358,0,3,3
24310,2,2,85357,85358,85360,1,3,0
24311,5,2,85362,85362,85364,0,2,2
24312,2,3,85364,85364,85367,0,3,0
24313,4,3,85368,85368,85371,0,3,1
24314,3,2,85371,85371,85373,0,2,0
24315,2,2,85373,85373,85375,0,2,0
24316,5,1,85378,85378,85379,0,1,3
24317,2,2,85380,85380,85382,0,2,1
24318,4,3,85384,85384,85387,0,3,2
24319,2,3,85386,85387,85390,1,4,0
24320,5,3,85391,85391,85394,0,3,1
24321,1,3,85392,85394,85397,2,5,0
24322,3,3,85395,85397,85400,2,5,0
24323,3,1,85398,85400,85401,2,3,0
24324,5,2,85403,85403,85405,0,2,2
24325,3,2,85406,85406,85408,0,2,1
24326,4,2,85410,85410,85412,0,2,2
24327,6,1,85416,85416,85417,0,1,4
24328,6,2,85422,85422,85424,0,2,5
24329,6,3,85428,85428,85431,0,3,4
24330,2,3,85430,85431,85434,1,4,0
24331,5,1,85435,85435,85436,0,1,1
24332,4,2,85439,85439,85441,0,2,3
24333,5,2,85444,85444,85446,0,2,3
24334,4,2,85448,85448,85450,0,2,2
24335,2,3,85450,85450,85453,0,3,0
24336,6,1,85456,85456,85457,0,1,3
24337,2,3,85458,85458,85461,0,3,1
24338,5,1,85463,85463,85464,0,1,2
24339,3,1,85466,85466,85467,0,1,2
24340,3,3,85469,85469,85472,0,3,2
24341,3,3,85472,85472,85475,0,3,0
24342,5,1,85477,85477,85478,0,1,2
24343,3,1,85480,85480,85481,0,1,2
24344,2,3,85482,85482,85485,0,3,1
24345,2,1,85484,85485,85486,1,2,0
24346,5,2,85489,85489,85491,0,2,3
24347,5,2,85494,85494,85496,0,2,3
24348,3,3,85497,85497,85500,0,3,1
24349,6,2,85503,85503,85505,0,2,3
24350,5,2,85508,85508,85510,0,2,3
24351,3,1,85511,85511,85512,0,1,1
24352,5,3,85516,85516,85519,0,3,4
24353,3,3,85519,85519,85522,0,3,0
24354,6,3,85525,85525,85528,0,3,3
24355,4,2,85529,85529,85531,0,2,1
24356,1,3,85530,85531,85534,1,4,0
24357,3,1,85533,85534,85535,1,2,0
24358,4,3,85537,85537,85540,0,3,2
24359,5,2,85542,85542,85544,0,2,2
24360,4,1,85546,85546,85547,0,1,2
24361,3,1,85549,85549,85550,0,1,2
24362,2,1,85551,85551,85552,0,1,1
24363,3,3,85554,85554,85557,0,3,2
24364,2,3,85556,85557,85560,1,4,0
24365,2,3,85558,85560,85563,2,5,0
24366,4,2,85562,85563,85565,1,3,0
24367,6,3,85568,85568,85571,0,3,3
24368,4,1,85572,85572,85573,0,1,1
24369,1,2,85573,85573,85575,0,2,0
24370,4,1,85577,85577,85578,0,1,2
24371,2,3,85579,85579,85582,0,3,1
24372,2,3,85581,85582,85585,1,4,0
24373,2,2,85583,85585,85587,2,4,0
24374,6,1,85589,85589,85590,0,1,2
24375,4,1,85593,85593,85594,0,1,3
24376,1,1,85594,85594,85595,0,1,0
24377,5,3,85599,85599,85602,0,3,4
24378,1,3,85600,85602,85605,2,5,0
24379,1,1,85601,85605,85606,4,5,0
24380,6,2,85607,85607,85609,0,2,1
24381,2,1,85609,85609,85610,0,1,0
24382,6,2,85615,85615,85617,0,2,5
24383,4,3,85619,85619,85622,0,3,2
24384,3,2,85622,85622,85624,0,2,0
24385,3,2,85625,85625,85627,0,2,1
24386,6,1,85631,85631,85632,0,1,4
24387,4,1,85635,85635,85636,0,1,3
24388,4,1,85639,85639,85640,0,1,3
24389,1,1,85640,85640,85641,0,1,0
24390,4,1,85644,85644,85645,0,1,3
24391,3,2,85647,85647,85649,0,2,2
24392,6,2,85653,85653,85655,0,2,4
24393,4,3,85657,85657,85660,0,3,2
24394,3,2,85660,85660,85662,0,2,0
24395,3,2,85663,85663,85665,0,2,1
24396,1,1,85664,85665,85666,1,2,0
24397,5,1,85669,85669,85670,0,1,3
24398,2,3,85671,85671,85674,0,3,1
24399,6,1,85677,85677,85678,0,1,3
24400,5,3,85682,85682,85685,0,3,4
24401,2,2,85684,85685,85687,1,3,0
24402,5,3,85689,85689,85692,0,3,2
24403,6,1,85695,85695,85696,0,1,3
24404,6,1,85701,85701,85702,0,1,5
24405,2,2,85703,85703,85705,0,2,1
24406,2,1,85705,85705,85706,0,1,0
24407,2,1,85707,85707,85708,0,1,1
24408,3,1,85710,85710,85711,0,1,2
24409,4,1,85714,85714,85715,0,1,3
24410,1,1,85715,85715,85716,0,1,0
24411,3,3,85718,85718,85721,0,3,2
24412,3,1,85721,85721,85722,0,1,0
24413,5,3,85726,85726,85729,0,3,4
24414,6,1,85732,85732,85733,0,1,3
24415,5,2,85737,85737,85739,0,2,4
24416,3,1,85740,85740,85741,0,1,1
24417,4,1,85744,85744,85745,0,1,3
24418,2,3,85746,85746,85749,0,3,1
24419,3,2,85749,85749,85751,0,2,0
24420,2,2,85751,85751,85753,0,2,0
24421,5,2,85756,85756,85758,0,2,3
24422,2,1,85758,85758,85759,0,1,0
24423,2,3,85760,85760,85763,0,3,1
24424,5,2,85765,85765,85767,0,2,2
24425,4,2,85769,85769,85771,0,2,2
24426,1,2,85770,85771,85773,1,3,0
24427,1,2,85771,85773,85775,2,4,0
24428,6,1,85777,85777,85778,0,1,2
24429,6,2,85783,85783,85785,0,2,5
24430,2,3,85785,85785,85788,0,3,0
24431,3,1,85788,85788,85789,0,1,0
24432,1,3,85789,85789,85792,0,3,0
24433,2,3,85791,85792,85795,1,4,0
24434,2,3,85793,85795,85798,2,5,0
24435,2,3,85795,85798,85801,3,6,0
24436,1,2,85796,85801,85803,5,7,0
24437,2,3,85798,85803,85806,5,8,0
24438,2,2,85800,85806,85808,6,8,0
24439,3,3,85803,85808,85811,5,8,0
24440,1,2,85804,85811,85813,7,9,0
24441,1,1,85805,85813,85814,8,9,0
24442,3,3,85808,85814,85817,6,9,0
24443,1,3,85809,85817,85820,8,11,0
24444,5,2,85814,85820,85822,6,8,0
24445,2,3,85816,85822,85825,6,9,0
24446,1,1,85817,85825,85826,8,9,0
24447,5,2,85822,85826,85828,4,6,0
24448,3,2,85825,85828,85830,3,5,0
24449,2,2,85827,85830,85832,3,5,0
24450,3,3,85830,85832,85835,2,5,0
24451,4,3,85834,85835,85838,1,4,0
24452,6,2,85840,85840,85842,0,2,2
24453,2,2,85842,85842,85844,0,2,0
24454,2,3,85844,85844,85847,0,3,0
24455,1,3,85845,85847,85850,2,5,0
24456,2,3,85847,85850,85853,3,6,0
24457,6,1,85853,85853,85854,0,1,0
24458,2,1,85855,85855,85856,0,1,1
24459,3,2,85858,85858,85860,0,2,2
24460,2,3,85860,85860,85863,0,3,0
24461,3,3,85863,85863,85866,0,3,0
24462,4,1,85867,85867,85868,0,1,1
24463,2,2,85869,85869,85871,0,2,1
24464,4,2,85873,85873,85875,0,2,2
24465,4,3,85877,85877,85880,0,3,2
24466,3,3,85880,85880,85883,0,3,0
24467,6,3,85886,85886,85889,0,3,3
24468,1,3,85887,85889,85892,2,5,0
24469,3,1,85890,85892,85893,2,3,0
24470,3,3,85893,85893,85896,0,3,0
24471,5,2,85898,85898,85900,0,2,2
24472,6,3,85904,85904,85907,0,3,4
24473,2,3,85906,85907,85910,1,4,0
24474,5,2,85911,85911,85913,0,2,1
24475,6,2,85917,85917,85919,0,2,4
24476,2,1,85919,85919,85920,0,1,0
24477,1,2,85920,85920,85922,0,2,0
24478,4,3,85924,85924,85927,0,3,2
24479,5,2,85929,85929,85931,0,2,2
24480,2,3,85931,85931,85934,0,3,0
24481,4,1,85935,85935,85936,0,1,1
24482,3,2,85938,85938,85940,0,2,2
24483,4,1,85942,85942,85943,0,1,2
24484,3,2,85945,85945,85947,0,2,2
24485,4,2,85949,85949,85951,0,2,2
24486,3,1,85952,85952,85953,0,1,1
24487,2,3,85954,85954,85957,0,3,1
24488,3,2,85957,85957,85959,0,2,0
24489,6,1,85963,85963,85964,0,1,4
24490,3,1,85966,85966,85967,0,1,2
24491,4,2,85970,85970,85972,0,2,3
24492,4,1,85974,85974,85975,0,1,2
24493,2,2,85976,85976,85978,0,2,1
24494,2,2,85978,85978,85980,0,2,0
24495,4,1,85982,85982,85983,0,1,2
24496,2,3,85984,85984,85987,0,3,1
24497,3,1,85987,85987,85988,0,1,0
24498,5,3,85992,85992,85995,0,3,4
24499,4,2,85996,85996,85998,0,2,1
24500,6,2,86002,86002,86004,0,2,4
24501,1,2,86003,86004,86006,1,3,0
24502,3,1,86006,86006,86007,0,1,0
24503,1,2,86007,86007,86009,0,2,0
24504,1,2,86008,86009,86011,1,3,0
24505,4,1,86012,86012,86013,0,1,1
24506,2,1,86014,86014,86015,0,1,1
24507,3,1,86017,86017,86018,0,1,2
24508,3,3,86020,86020,86023,0,3,2
24509,6,2,86026,86026,86028,0,2,3
24510,2,1,86028,86028,86029,0,1,0
24511,6,1,86034,86034,86035,0,1,5
24512,6,3,86040,86040,86043,0,3,5
24513,2,2,86042,86043,86045,1,3,0
24514,4,2,86046,86046,86048,0,2,1
24515,2,1,86048,86048,86049,0,1,0
24516,3,2,86051,86051,86053,0,2,2
24517,6,3,86057,86057,86060,0,3,4
24518,4,2,86061,86061,86063,0,2,1
24519,5,1,86066,86066,86067,0,1,3
24520,4,3,86070,86070,86073,0,3,3
24521,6,3,86076,86076,86079,0,3,3
24522,2,3,86078,86079,86082,1,4,0
24523,3,2,86081,86082,86084,1,3,0
24524,5,2,86086,86086,86088,0,2,2
24525,5,1,86091,86091,86092,0,1,3
24526,3,3,86094,86094,86097,0,3,2
24527,3,1,86097,86097,86098,0,1,0
24528,4,2,86101,86101,86103,0,2,3
24529,5,3,86106,86106,86109,0,3,3
24530,2,1,86108,86109,86110,1,2,0
24531,1,3,86109,86110,86113,1,4,0
24532,1,3,86110,86113,86116,3,6,0
24533,4,3,86114,86116,86119,2,5,0
24534,5,2,86119,86119,86121,0,2,0
24535,1,2,86120,86121,86123,1,3,0
24536,3,2,86123,86123,86125,0,2,0
24537,4,3,86127,86127,86130,0,3,2
24538,2,3,86129,86130,86133,1,4,0
24539,6,1,86135,86135,86136,0,1,2
24540,2,1,86137,86137,86138,0,1,1
24541,6,1,86143,86143,86144,0,1,5
24542,2,1,86145,86145,86146,0,1,1
24543,5,2,86150,86150,86152,0,2,4
24544,5,1,86155,86155,86156,0,1,3
24545,5,3,86160,86160,86163,0,3,4
24546,3,1,86163,86163,86164,0,1,0
24547,5,1,86168,86168,86169,0,1,4
24548,5,3,86173,86173,86176,0,3,4
24549,1,1,86174,86176,86177,2,3,0
24550,2,1,86176,86177,86178,1,2,0
24551,4,3,86180,86180,86183,0,3,2
24552,6,2,86186,86186,86188,0,2,3
24553,6,1,86192,86192,86193,0,1,4
24554,3,1,86195,86195,86196,0,1,2
24555,6,1,86201,86201,86202,0,1,5
24556,2,1,86203,86203,86204,0,1,1
24557,4,1,86207,86207,86208,0,1,3
24558,3,2,86210,86210,86212,0,2,2
24559,4,2,86214,86214,86216,0,2,2
24560,4,2,86218,86218,86220,0,2,2
24561,1,3,86219,86220,86223,1,4,0
24562,3,2,86222,86223,86225,1,3,0
24563,6,3,86228,86228,86231,0,3,3
24564,1,2,86229,86231,86233,2,4,0
24565,6,3,86235,86235,86238,0,3,2
24566,5,3,86240,86240,86243,0,3,2
24567,1,3,86241,86243,86246,2,5,0
24568,3,3,86244,86246,86249,2,5,0
24569,3,1,86247,86249,86250,2,3,0
24570,2,2,86249,86250,86252,1,3,0
24571,2,1,86251,86252,86253,1,2,0
24572,5,1,86256,86256,86257,0,1,3
24573,3,2,86259,86259,86261,0,2,2
24574,4,3,86263,86263,86266,0,3,2
24575,1,3,86264,86266,86269,2,5,0
24576,2,1,86266,86269,86270,3,4,0
24577,2,3,86268,86270,86273,2,5,0
24578,2,2,86270,86273,86275,3,5,0
24579,5,2,86275,86275,86277,0,2,0
24580,3,3,86278,86278,86281,0,3,1
24581,5,2,86283,86283,86285,0,2,2
24582,2,3,86285,86285,86288,0,3,0
24583,3,1,86288,86288,86289,0,1,0
24584,1,3,86289,86289,86292,0,3,0
24585,5,3,86294,86294,86297,0,3,2
24586,3,2,86297,86297,86299,0,2,0
24587,3,2,86300,86300,86302,0,2,1
24588,3,3,86303,86303,86306,0,3,1
24589,3,3,86306,86306,86309,0,3,0
24590,1,3,86307,86309,86312,2,5,0
24591,5,1,86312,86312,86313,0,1,0
24592,1,3,86313,86313,86316,0,3,0
24593,2,2,86315,86316,86318,1,3,0
24594,4,1,86319,86319,86320,0,1,1
24595,5,3,86324,86324,86327,0,3,4
24596,6,3,86330,86330,86333,0,3,3
24597,4,2,86334,86334,86336,0,2,1
24598,4,1,86338,86338,86339,0,1,2
24599,6,1,86344,86344,86345,0,1,5
24600,1,3,86345,86345,86348,0,3,0
24601,3,2,86348,86348,86350,0,2,0
24602,5,1,86353,86353,86354,0,1,3
24603,3,3,86356,86356,86359,0,3,2
24604,2,2,86358,86359,86361,1,3,0
24605,1,1,86359,86361,86362,2,3,0
24606,6,1,86365,86365,86366,0,1,3
24607,1,3,86366,86366,86369,0,3,0
24608,3,2,86369,86369,86371,0,2,0
24609,1,2,86370,86371,86373,1,3,0
24610,6,2,86376,86376,86378,0,2,3
24611,2,1,86378,86378,86379,0,1,0
24612,6,3,86384,86384,86387,0,3,5
24613,6,3,86390,86390,86393,0,3,3
24614,5,2,86395,86395,86397,0,2,2
24615,4,1,86399,86399,86400,0,1,2
24616,2,1,86401,86401,86402,0,1,1
24617,2,2,86403,86403,86405,0,2,1
24618,3,1,86406,86406,86407,0,1,1
24619,1,1,86407,86407,86408,0,1,0
24620,4,1,86411,86411,86412,0,1,3
24621,5,2,86416,86416,86418,0,2,4
24622,2,3,86418,86418,86421,0,3,0
24623,6,2,86424,86424,86426,0,2,3
24624,5,2,86429,86429,86431,0,2,3
24625,1,2,86430,86431,86433,1,3,0
24626,3,2,86433,86433,86435,0,2,0
24627,5,3,86438,86438,86441,0,3,3
24628,6,2,86444,86444,86446,0,2,3
24629,5,2,86449,86449,86451,0,2,3
24630,6,2,86455,86455,86457,0,2,4
24631,6,3,86461,86461,86464,0,3,4
24632,3,1,86464,86464,86465,0,1,0
24633,1,1,86465,86465,86466,0,1,0
24634,3,1,86468,86468,86469,0,1,2
24635,3,3,86471,86471,86474,0,3,2
24636,1,1,86472,86474,86475,2,3,0
24637,3,3,86475,86475,86478,0,3,0
24638,6,2,86481,86481,86483,0,2,3
24639,3,2,86484,86484,86486,0,2,1
24640,4,1,86488,86488,86489,0,1,2
24641,4,1,86492,86492,86493,0,1,3
24642,1,2,86493,86493,86495,0,2,0
24643,2,1,86495,86495,86496,0,1,0
24644,6,1,86501,86501,86502,0,1,5
24645,6,1,86507,86507,86508,0,1,5
24646,1,2,86508,86508,86510,0,2,0
24647,5,1,86513,86513,86514,0,1,3
24648,4,1,86517,86517,86518,0,1,3
24649,2,2,86519,86519,86521,0,2,1
24650,6,2,86525,86525,86527,0,2,4
24651,4,2,86529,86529,86531,0,2,2
24652,4,3,86533,86533,86536,0,3,2
24653,1,2,86534,86536,86538,2,4,0
24654,4,1,86538,86538,86539,0,1,0
24655,5,2,86543,86543,86545,0,2,4
24656,4,1,86547,86547,86548,0,1,2
24657,1,1,86548,86548,86549,0,1,0
24658,6,1,86554,86554,86555,0,1,5
24659,6,2,86560,86560,86562,0,2,5
24660,4,1,86564,86564,86565,0,1,2
24661,2,1,86566,86566,86567,0,1,1
24662,5,2,86571,86571,86573,0,2,4
24663,5,2,86576,86576,86578,0,2,3
24664,4,3,86580,86580,86583,0,3,2
24665,4,2,86584,86584,86586,0,2,1
24666,4,2,86588,86588,86590,0,2,2
24667,5,2,86593,86593,86595,0,2,3
24668,3,2,86596,86596,86598,0,2,1
24669,1,3,86597,86598,86601,1,4,0
24670,1,3,86598,86601,86604,3,6,0
24671,1,2,86599,86604,86606,5,7,0
24672,3,1,86602,86606,86607,4,5,0
24673,1,2,86603,86607,86609,4,6,0
24674,2,1,86605,86609,86610,4,5,0
24675,4,3,86609,86610,86613,1,4,0
24676,1,1,86610,86613,86614,3,4,0
24677,2,2,86612,86614,86616,2,4,0
24678,4,2,86616,86616,86618,0,2,0
24679,6,2,86622,86622,86624,0,2,4
24680,1,1,86623,86624,86625,1,2,0
24681,3,1,86626,86626,86627,0,1,1
24682,5,3,86631,86631,86634,0,3,4
24683,4,3,86635,86635,86638,0,3,1
24684,3,3,86638,86638,86641,0,3,0
24685,3,3,86641,86641,86644,0,3,0
24686,2,2,86643,86644,86646,1,3,0
24687,2,3,86645,86646,86649,1,4,0
24688,2,3,86647,86649,86652,2,5,0
24689,4,3,86651,86652,86655,1,4,0
24690,6,2,86657,86657,86659,0,2,2
24691,4,2,86661,86661,86663,0,2,2
24692,5,2,86666,86666,86668,0,2,3
24693,4,1,86670,86670,86671,0,1,2
24694,2,3,86672,86672,86675,0,3,1
24695,4,2,86676,86676,86678,0,2,1
24696,4,2,86680,86680,86682,0,2,2
24697,4,2,86684,86684,86686,0,2,2
24698,6,2,86690,86690,86692,0,2,4
24699,5,3,86695,86695,86698,0,3,3
24700,1,1,86696,86698,86699,2,3,0
24701,3,2,86699,86699,86701,0,2,0
24702,3,2,86702,86702,86704,0,2,1
24703,6,2,86708,86708,86710,0,2,4
24704,1,2,86709,86710,86712,1,3,0
24705,2,2,86711,86712,86714,1,3,0
24706,3,2,86714,86714,86716,0,2,0
24707,6,3,86720,86720,86723,0,3,4
24708,2,1,86722,86723,86724,1,2,0
24709,4,2,86726,86726,86728,0,2,2
24710,2,1,86728,86728,86729,0,1,0
24711,4,3,86732,86732,86735,0,3,3
24712,2,2,86734,86735,86737,1,3,0
24713,6,1,86740,86740,86741,0,1,3
24714,6,1,86746,86746,86747,0,1,5
24715,1,2,86747,86747,86749,0,2,0
24716,1,3,86748,86749,86752,1,4,0
24717,6,3,86754,86754,86757,0,3,2
24718,5,2,86759,86759,86761,0,2,2
24719,1,3,86760,86761,86764,1,4,0
24720,2,2,86762,86764,86766,2,4,0
24721,4,2,86766,86766,86768,0,2,0
24722,2,1,86768,86768,86769,0,1,0
24723,6,3,86774,86774,86777,0,3,5
24724,4,3,86778,86778,86781,0,3,1
24725,2,2,86780,86781,86783,1,3,0
24726,2,1,86782,86783,86784,1,2,0
24727,5,2,86787,86787,86789,0,2,3
24728,5,2,86792,86792,86794,0,2,3
24729,2,3,86794,86794,86797,0,3,0
24730,1,2,86795,86797,86799,2,4,0
24731,4,2,86799,86799,86801,0,2,0
24732,1,2,86800,86801,86803,1,3,0
24733,6,3,86806,86806,86809,0,3,3
24734,3,3,86809,86809,86812,0,3,0
24735,1,2,86810,86812,86814,2,4,0
24736,4,2,86814,86814,86816,0,2,0
24737,3,2,86817,86817,86819,0,2,1
24738,4,3,86821,86821,86824,0,3,2
24739,3,1,86824,86824,86825,0,1,0
24740,6,1,86830,86830,86831,0,1,5
24741,1,2,86831,86831,86833,0,2,0
24742,3,3,86834,86834,86837,0,3,1
24743,5,3,86839,86839,86842,0,3,2
24744,5,1,86844,86844,86845,0,1,2
24745,4,2,86848,86848,86850,0,2,3
24746,1,3,86849,86850,86853,1,4,0
24747,4,3,86853,86853,86856,0,3,0
24748,2,2,86855,86856,86858,1,3,0
24749,2,2,86857,86858,86860,1,3,0
24750,4,3,86861,86861,86864,0,3,1
24751,4,1,86865,86865,86866,0,1,1
24752,1,3,86866,86866,86869,0,3,0
24753,2,2,86868,86869,86871,1,3,0
24754,5,2,86873,86873,86875,0,2,2
24755,1,1,86874,86875,86876,1,2,0
24756,4,1,86878,86878,86879,0,1,2
24757,5,3,86883,86883,86886,0,3,4
24758,6,2,86889,86889,86891,0,2,3
24759,4,3,86893,86893,86896,0,3,2
24760,4,3,86897,86897,86900,0,3,1
24761,1,3,86898,86900,86903,2,5,0
24762,4,3,86902,86903,86906,1,4,0
24763,3,3,86905,86906,86909,1,4,0
24764,3,1,86908,86909,86910,1,2,0
24765,1,1,86909,86910,86911,1,2,0
24766,5,2,86914,86914,86916,0,2,3
24767,4,1,86918,86918,86919,0,1,2
24768,5,1,86923,86923,86924,0,1,4
24769,6,3,86929,86929,86932,0,3,5
24770,4,3,86933,86933,86936,0,3,1
24771,1,3,86934,86936,86939,2,5,0
24772,4,3,86938,86939,86942,1,4,0
24773,1,3,86939,86942,86945,3,6,0
24774,2,3,86941,86945,86948,4,7,0
24775,5,1,86946,86948,86949,2,3,0
24776,5,2,86951,86951,86953,0,2,2
24777,1,2,86952,86953,86955,1,3,0
24778,1,3,86953,86955,86958,2,5,0
24779,2,3,86955,86958,86961,3,6,0
24780,6,1,86961,86961,86962,0,1,0
24781,5,2,86966,86966,86968,0,2,4
24782,1,2,86967,86968,86970,1,3,0
24783,5,2,86972,86972,86974,0,2,2
24784,4,2,86976,86976,86978,0,2,2
24785,2,3,86978,86978,86981,0,3,0
24786,4,3,86982,86982,86985,0,3,1
24787,1,2,86983,86985,86987,2,4,0
24788,2,1,86985,86987,86988,2,3,0
24789,5,3,86990,86990,86993,0,3,2
24790,5,2,86995,86995,86997,0,2,2
24791,2,1,86997,86997,86998,0,1,0
24792,2,1,86999,86999,87000,0,1,1
24793,6,3,87005,87005,87008,0,3,5
24794,3,3,87008,87008,87011,0,3,0
24795,4,2,87012,87012,87014,0,2,1
24796,5,3,87017,87017,87020,0,3,3
24797,6,1,87023,87023,87024,0,1,3
24798,6,2,87029,87029,87031,0,2,5
24799,2,2,87031,87031,87033,0,2,0
24800,3,3,87034,87034,87037,0,3,1
24801,2,1,87036,87037,87038,1,2,0
24802,4,2,87040,87040,87042,0,2,2
24803,3,1,87043,87043,87044,0,1,1
24804,2,1,87045,87045,87046,0,1,1
24805,3,2,87048,87048,87050,0,2,2
24806,2,2,87050,87050,87052,0,2,0
24807,6,3,87056,87056,87059,0,3,4
24808,2,3,87058,87059,87062,1,4,0
24809,1,3,87059,87062,87065,3,6,0
24810,5,3,87064,87065,87068,1,4,0
24811,3,2,87067,87068,87070,1,3,0
24812,4,3,87071,87071,87074,0,3,1
24813,5,2,87076,87076,87078,0,2,2
24814,4,2,87080,87080,87082,0,2,2
24815,6,3,87086,87086,87089,0,3,4
24816,5,2,87091,87091,87093,0,2,2
24817,2,2,87093,87093,87095,0,2,0
24818,2,3,87095,87095,87098,0,3,0
24819,3,3,87098,87098,87101,0,3,0
24820,4,2,87102,87102,87104,0,2,1
24821,3,3,87105,87105,87108,0,3,1
24822,3,3,87108,87108,87111,0,3,0
24823,6,2,87114,87114,87116,0,2,3
24824,2,2,87116,87116,87118,0,2,0
24825,2,3,87118,87118,87121,0,3,0
24826,3,1,87121,87121,87122,0,1,0
24827,3,3,87124,87124,87127,0,3,2
24828,3,2,87127,87127,87129,0,2,0
24829,6,2,87133,87133,87135,0,2,4
24830,6,1,87139,87139,87140,0,1,4
24831,2,3,87141,87141,87144,0,3,1
24832,6,2,87147,87147,87149,0,2,3
24833,1,3,87148,87149,87152,1,4,0
24834,1,1,87149,87152,87153,3,4,0
24835,5,2,87154,87154,87156,0,2,1
24836,4,2,87158,87158,87160,0,2,2
24837,4,2,87162,87162,87164,0,2,2
24838,1,1,87163,87164,87165,1,2,0
24839,3,2,87166,87166,87168,0,2,1
24840,2,2,87168,87168,87170,0,2,0
24841,5,2,87173,87173,87175,0,2,3
24842,6,1,87179,87179,87180,0,1,4
24843,3,2,87182,87182,87184,0,2,2
24844,3,3,87185,87185,87188,0,3,1
24845,2,1,87187,87188,87189,1,2,0
24846,6,3,87193,87193,87196,0,3,4
24847,1,3,87194,87196,87199,2,5,0
24848,1,3,87195,87199,87202,4,7,0
24849,2,3,87197,87202,87205,5,8,0
24850,2,1,87199,87205,87206,6,7,0
24851,2,1,87201,87206,87207,5,6,0
24852,5,1,87206,87207,87208,1,2,0
24853,1,3,87207,87208,87211,1,4,0
24854,5,2,87212,87212,87214,0,2,1
24855,2,3,87214,87214,87217,0,3,0
24856,2,1,87216,87217,87218,1,2,0
24857,6,1,87222,87222,87223,0,1,4
24858,5,3,87227,87227,87230,0,3,4
24859,1,1,87228,87230,87231,2,3,0
24860,6,1,87234,87234,87235,0,1,3
24861,4,3,87238,87238,87241,0,3,3
24862,1,3,87239,87241,87244,2,5,0
24863,6,1,87245,87245,87246,0,1,1
24864,4,1,87249,87249,87250,0,1,3
24865,1,3,87250,87250,87253,0,3,0
24866,3,1,87253,87253,87254,0,1,0
24867,1,3,87254,87254,87257,0,3,0
24868,4,3,87258,87258,87261,0,3,1
24869,4,1,87262,87262,87263,0,1,1
24870,4,3,87266,87266,87269,0,3,3
24871,2,3,87268,87269,87272,1,4,0
24872,1,1,87269,87272,87273,3,4,0
24873,6,1,87275,87275,87276,0,1,2
24874,5,2,87280,87280,87282,0,2,4
24875,4,1,87284,87284,87285,0,1,2
24876,1,3,87285,87285,87288,0,3,0
24877,4,3,87289,87289,87292,0,3,1
24878,4,2,87293,87293,87295,0,2,1
24879,2,2,87295,87295,87297,0,2,0
24880,3,3,87298,87298,87301,0,3,1
24881,1,3,87299,87301,87304,2,5,0
24882,4,1,87303,87304,87305,1,2,0
24883,6,3,87309,87309,87312,0,3,4
24884,2,2,87311,87312,87314,1,3,0
24885,2,1,87313,87314,87315,1,2,0
24886,5,2,87318,87318,87320,0,2,3
24887,4,2,87322,87322,87324,0,2,2
24888,3,3,87325,87325,87328,0,3,1
24889,2,1,87327,87328,87329,1,2,0
24890,4,1,87331,87331,87332,0,1,2
24891,2,2,87333,87333,87335,0,2,1
24892,4,2,87337,87337,87339,0,2,2
24893,5,3,87342,87342,87345,0,3,3
24894,1,3,87343,87345,87348,2,5,0
24895,3,3,87346,87348,87351,2,5,0
24896,6,1,87352,87352,87353,0,1,1
24897,5,3,87357,87357,87360,0,3,4
24898,3,1,87360,87360,87361,0,1,0
24899,2,1,87362,87362,87363,0,1,1
24900,3,1,87365,87365,87366,0,1,2
24901,5,1,87370,87370,87371,0,1,4
24902,3,2,87373,87373,87375,0,2,2
24903,6,3,87379,87379,87382,0,3,4
24904,1,2,87380,87382,87384,2,4,0
24905,5,2,87385,87385,87387,0,2,1
24906,6,1,87391,87391,87392,0,1,4
24907,1,2,87392,87392,87394,0,2,0
24908,6,1,87398,87398,87399,0,1,4
24909,2,3,87400,87400,87403,0,3,1
24910,4,2,87404,87404,87406,0,2,1
24911,4,2,87408,87408,87410,0,2,2
24912,3,2,87411,87411,87413,0,2,1
24913,2,1,87413,87413,87414,0,1,0
24914,4,3,87417,87417,87420,0,3,3
24915,5,2,87422,87422,87424,0,2,2
24916,6,3,87428,87428,87431,0,3,4
24917,5,1,87433,87433,87434,0,1,2
24918,2,1,87435,87435,87436,0,1,1
24919,6,3,87441,87441,87444,0,3,5
24920,3,2,87444,87444,87446,0,2,0
24921,2,2,87446,87446,87448,0,2,0
24922,5,1,87451,87451,87452,0,1,3
24923,2,3,87453,87453,87456,0,3,1
24924,1,2,87454,87456,87458,2,4,0
24925,3,1,87457,87458,87459,1,2,0
24926,4,3,87461,87461,87464,0,3,2
24927,5,1,87466,87466,87467,0,1,2
24928,5,2,87471,87471,87473,0,2,4
24929,4,3,87475,87475,87478,0,3,2
24930,1,2,87476,87478,87480,2,4,0
24931,3,3,87479,87480,87483,1,4,0
24932,4,3,87483,87483,87486,0,3,0
24933,1,1,87484,87486,87487,2,3,0
24934,6,1,87490,87490,87491,0,1,3
24935,1,1,87491,87491,87492,0,1,0
24936,4,1,87495,87495,87496,0,1,3
24937,1,2,87496,87496,87498,0,2,0
24938,4,3,87500,87500,87503,0,3,2
24939,2,3,87502,87503,87506,1,4,0
24940,4,2,87506,87506,87508,0,2,0
24941,3,3,87509,87509,87512,0,3,1
24942,3,1,87512,87512,87513,0,1,0
24943,4,2,87516,87516,87518,0,2,3
24944,6,3,87522,87522,87525,0,3,4
24945,5,1,87527,87527,87528,0,1,2
24946,5,2,87532,87532,87534,0,2,4
24947,1,2,87533,87534,87536,1,3,0
24948,6,3,87539,87539,87542,0,3,3
24949,1,3,87540,87542,87545,2,5,0
24950,4,2,87544,87545,87547,1,3,0
24951,5,3,87549,87549,87552,0,3,2
24952,3,3,87552,87552,87555,0,3,0
24953,5,1,87557,87557,87558,0,1,2
24954,2,1,87559,87559,87560,0,1,1
24955,6,3,87565,87565,87568,0,3,5
24956,4,1,87569,87569,87570,0,1,1
24957,4,1,87573,87573,87574,0,1,3
24958,2,3,87575,87575,87578,0,3,1
24959,3,2,87578,87578,87580,0,2,0
24960,1,1,87579,87580,87581,1,2,0
24961,3,3,87582,87582,87585,0,3,1
24962,4,2,87586,87586,87588,0,2,1
24963,6,1,87592,87592,87593,0,1,4
24964,5,2,87597,87597,87599,0,2,4
24965,1,2,87598,87599,87601,1,3,0
24966,5,1,87603,87603,87604,0,1,2
24967,3,3,87606,87606,87609,0,3,2
24968,6,1,87612,87612,87613,0,1,3
24969,3,3,87615,87615,87618,0,3,2
24970,5,2,87620,87620,87622,0,2,2
24971,5,1,87625,87625,87626,0,1,3
24972,3,3,87628,87628,87631,0,3,2
24973,3,2,87631,87631,87633,0,2,0
24974,6,2,87637,87637,87639,0,2,4
24975,1,3,87638,87639,87642,1,4,0
24976,3,2,87641,87642,87644,1,3,0
24977,3,3,87644,87644,87647,0,3,0
24978,6,3,87650,87650,87653,0,3,3
24979,3,1,87653,87653,87654,0,1,0
24980,1,1,87654,87654,87655,0,1,0
24981,2,3,87656,87656,87659,0,3,1
24982,5,2,87661,87661,87663,0,2,2
24983,5,2,87666,87666,87668,0,2,3
24984,1,1,87667,87668,87669,1,2,0
24985,6,2,87673,87673,87675,0,2,4
24986,4,2,87677,87677,87679,0,2,2
24987,3,1,87680,87680,87681,0,1,1
24988,6,3,87686,87686,87689,0,3,5
24989,2,1,87688,87689,87690,1,2,0
24990,5,3,87693,87693,87696,0,3,3
24991,3,1,87696,87696,87697,0,1,0
24992,2,3,87698,87698,87701,0,3,1
24993,4,3,87702,87702,87705,0,3,1
24994,4,3,87706,87706,87709,0,3,1
24995,1,2,87707,87709,87711,2,4,0
24996,3,2,87710,87711,87713,1,3,0
24997,5,2,87715,87715,87717,0,2,2
24998,4,1,87719,87719,87720,0,1,2
24999,6,2,87725,87725,87727,0,2,5
25000,6,3,87731,87731,87734,0,3,4
25001,4,3,87735,87735,87738,0,3,1
25002,6,2,87741,87741,87743,0,2,3
25003,5,2,87746,87746,87748,0,2,3
25004,4,1,87750,87750,87751,0,1,2
25005,5,2,87755,87755,87757,0,2,4
25006,4,1,87759,87759,87760,0,1,2
25007,1,2,87760,87760,87762,0,2,0
25008,6,3,87766,87766,87769,0,3,4
25009,4,1,87770,87770,87771,0,1,1
25010,4,3,87774,87774,87777,0,3,3
25011,1,3,87775,87777,87780,2,5,0
25012,3,1,87778,87780,87781,2,3,0
25013,6,1,87784,87784,87785,0,1,3
25014,3,3,87787,87787,87790,0,3,2
25015,1,3,87788,87790,87793,2,5,0
25016,2,2,87790,87793,87795,3,5,0
25017,1,2,87791,87795,87797,4,6,0
25018,1,1,87792,87797,87798,5,6,0
25019,6,2,87798,87798,87800,0,2,0
25020,6,1,87804,87804,87805,0,1,4
25021,3,3,87807,87807,87810,0,3,2
25022,2,3,87809,87810,87813,1,4,0
25023,6,1,87815,87815,87816,0,1,2
25024,1,3,87816,87816,87819,0,3,0
25025,2,2,87818,87819,87821,1,3,0
25026,6,3,87824,87824,87827,0,3,3
25027,4,2,87828,87828,87830,0,2,1
25028,2,2,87830,87830,87832,0,2,0
25029,1,1,87831,87832,87833,1,2,0
25030,5,1,87836,87836,87837,0,1,3
25031,1,1,87837,87837,87838,0,1,0
25032,4,2,87841,87841,87843,0,2,3
25033,3,1,87844,87844,87845,0,1,1
25034,6,3,87850,87850,87853,0,3,5
25035,2,1,87852,87853,87854,1,2,0
25036,4,2,87856,87856,87858,0,2,2
25037,3,3,87859,87859,87862,0,3,1
25038,6,3,87865,87865,87868,0,3,3
25039,3,3,87868,87868,87871,0,3,0
25040,3,3,87871,87871,87874,0,3,0
25041,2,1,87873,87874,87875,1,2,0
25042,4,3,87877,87877,87880,0,3,2
25043,3,1,87880,87880,87881,0,1,0
25044,2,1,87882,87882,87883,0,1,1
25045,4,3,87886,87886,87889,0,3,3
25046,6,3,87892,87892,87895,0,3,3
25047,3,2,87895,87895,87897,0,2,0
25048,3,1,87898,87898,87899,0,1,1
25049,6,1,87904,87904,87905,0,1,5
25050,6,3,87910,87910,87913,0,3,5
25051,3,1,87913,87913,87914,0,1,0
25052,1,3,87914,87914,87917,0,3,0
25053,3,2,87917,87917,87919,0,2,0
25054,5,2,87922,87922,87924,0,2,3
25055,6,2,87928,87928,87930,0,2,4
25056,6,2,87934,87934,87936,0,2,4
25057,6,3,87940,87940,87943,0,3,4
25058,1,1,87941,87943,87944,2,3,0
25059,1,1,87942,87944,87945,2,3,0
25060,5,1,87947,87947,87948,0,1,2
25061,5,3,87952,87952,87955,0,3,4
25062,2,3,87954,87955,87958,1,4,0
25063,3,1,87957,87958,87959,1,2,0
25064,4,2,87961,87961,87963,0,2,2
25065,5,3,87966,87966,87969,0,3,3
25066,3,2,87969,87969,87971,0,2,0
25067,3,3,87972,87972,87975,0,3,1
25068,4,1,87976,87976,87977,0,1,1
25069,2,2,87978,87978,87980,0,2,1
25070,1,3,87979,87980,87983,1,4,0
25071,2,2,87981,87983,87985,2,4,0
25072,4,3,87985,87985,87988,0,3,0
25073,3,1,87988,87988,87989,0,1,0
25074,4,2,87992,87992,87994,0,2,3
25075,6,3,87998,87998,88001,0,3,4
25076,6,1,88004,88004,88005,0,1,3
25077,2,1,88006,88006,88007,0,1,1
25078,2,3,88008,88008,88011,0,3,1
25079,5,2,88013,88013,88015,0,2,2
25080,2,2,88015,88015,88017,0,2,0
25081,6,2,88021,88021,88023,0,2,4
25082,6,1,88027,88027,88028,0,1,4
25083,4,2,88031,88031,88033,0,2,3
25084,2,2,88033,88033,88035,0,2,0
25085,5,1,88038,88038,88039,0,1,3
25086,2,1,88040,88040,88041,0,1,1
25087,4,3,88044,88044,88047,0,3,3
25088,5,1,88049,88049,88050,0,1,2
25089,6,1,88055,88055,88056,0,1,5
25090,3,3,88058,88058,88061,0,3,2
25091,5,2,88063,88063,88065,0,2,2
25092,4,2,88067,88067,88069,0,2,2
25093,5,1,88072,88072,88073,0,1,3
25094,3,3,88075,88075,88078,0,3,2
25095,1,1,88076,88078,88079,2,3,0
25096,5,2,88081,88081,88083,0,2,2
25097,5,1,88086,88086,88087,0,1,3
25098,5,3,88091,88091,88094,0,3,4
25099,1,3,88092,88094,88097,2,5,0
25100,4,3,88096,88097,88100,1,4,0
25101,2,1,88098,88100,88101,2,3,0
25102,3,2,88101,88101,88103,0,2,0
25103,2,2,88103,88103,88105,0,2,0
25104,5,2,88108,88108,88110,0,2,3
25105,5,2,88113,88113,88115,0,2,3
25106,3,2,88116,88116,88118,0,2,1
25107,5,1,88121,88121,88122,0,1,3
25108,6,3,88127,88127,88130,0,3,5
25109,5,2,88132,88132,88134,0,2,2
25110,5,2,88137,88137,88139,0,2,3
25111,3,2,88140,88140,88142,0,2,1
25112,1,1,88141,88142,88143,1,2,0
25113,6,1,88147,88147,88148,0,1,4
25114,1,1,88148,88148,88149,0,1,0
25115,6,3,88154,88154,88157,0,3,5
25116,5,2,88159,88159,88161,0,2,2
25117,6,3,88165,88165,88168,0,3,4
25118,3,3,88168,88168,88171,0,3,0
25119,2,2,88170,88171,88173,1,3,0
25120,5,3,88175,88175,88178,0,3,2
25121,5,1,88180,88180,88181,0,1,2
25122,5,1,88185,88185,88186,0,1,4
25123,6,3,88191,88191,88194,0,3,5
25124,3,1,88194,88194,88195,0,1,0
25125,6,3,88200,88200,88203,0,3,5
25126,4,3,88204,88204,88207,0,3,1
25127,5,3,88209,88209,88212,0,3,2
25128,1,3,88210,88212,88215,2,5,0
25129,2,2,88212,88215,88217,3,5,0
25130,4,1,88216,88217,88218,1,2,0
25131,4,1,88220,88220,88221,0,1,2
25132,4,1,88224,88224,88225,0,1,3
25133,1,3,88225,88225,88228,0,3,0
25134,3,3,88228,88228,88231,0,3,0
25135,1,2,88229,88231,88233,2,4,0
25136,4,1,88233,88233,88234,0,1,0
25137,5,3,88238,88238,88241,0,3,4
25138,4,2,88242,88242,88244,0,2,1
25139,2,2,88244,88244,88246,0,2,0
25140,5,1,88249,88249,88250,0,1,3
25141,6,2,88255,88255,88257,0,2,5
25142,3,2,88258,88258,88260,0,2,1
25143,2,1,88260,88260,88261,0,1,0
25144,2,3,88262,88262,88265,0,3,1
25145,5,1,88267,88267,88268,0,1,2
25146,2,3,88269,88269,88272,0,3,1
25147,2,1,88271,88272,88273,1,2,0
25148,3,1,88274,88274,88275,0,1,1
25149,1,2,88275,88275,88277,0,2,0
25150,4,2,88279,88279,88281,0,2,2
25151,5,3,88284,88284,88287,0,3,3
25152,3,2,88287,88287,88289,0,2,0
25153,6,1,88293,88293,88294,0,1,4
25154,6,2,88299,88299,88301,0,2,5
25155,3,2,88302,88302,88304,0,2,1
25156,2,3,88304,88304,88307,0,3,0
25157,6,3,88310,88310,88313,0,3,3
25158,4,2,88314,88314,88316,0,2,1
25159,1,2,88315,88316,88318,1,3,0
25160,5,1,88320,88320,88321,0,1,2
25161,1,3,88321,88321,88324,0,3,0
25162,1,2,88322,88324,88326,2,4,0
25163,3,1,88325,88326,88327,1,2,0
25164,3,3,88328,88328,88331,0,3,1
25165,6,1,88334,88334,88335,0,1,3
25166,2,2,88336,88336,88338,0,2,1
25167,2,1,88338,88338,88339,0,1,0
25168,4,1,88342,88342,88343,0,1,3
25169,6,1,88348,88348,88349,0,1,5
25170,5,2,88353,88353,88355,0,2,4
25171,1,3,88354,88355,88358,1,4,0
25172,3,2,88357,88358,88360,1,3,0
25173,1,3,88358,88360,88363,2,5,0
25174,3,3,88361,88363,88366,2,5,0
25175,6,2,88367,88367,88369,0,2,1
25176,3,1,88370,88370,88371,0,1,1
25177,2,3,88372,88372,88375,0,3,1
25178,4,2,88376,88376,88378,0,2,1
25179,3,2,88379,88379,88381,0,2,1
25180,1,3,88380,88381,88384,1,4,0
25181,1,3,88381,88384,88387,3,6,0
25182,2,2,88383,88387,88389,4,6,0
25183,1,1,88384,88389,88390,5,6,0
25184,2,1,88386,88390,88391,4,5,0
25185,4,1,88390,88391,88392,1,2,0
25186,6,2,88396,88396,88398,0,2,4
25187,2,2,88398,88398,88400,0,2,0
25188,5,1,88403,88403,88404,0,1,3
25189,6,2,88409,88409,88411,0,2,5
25190,4,3,88413,88413,88416,0,3,2
25191,3,3,88416,88416,88419,0,3,0
25192,2,2,88418,88419,88421,1,3,0
25193,4,1,88422,88422,88423,0,1,1
25194,4,3,88426,88426,88429,0,3,3
25195,3,1,88429,88429,88430,0,1,0
25196,4,3,88433,88433,88436,0,3,3
25197,5,3,88438,88438,88441,0,3,2
25198,6,3,88444,88444,88447,0,3,3
25199,1,1,88445,88447,88448,2,3,0
25200,5,3,88450,88450,88453,0,3,2
25201,5,2,88455,88455,88457,0,2,2
25202,6,3,88461,88461,88464,0,3,4
25203,2,3,88463,88464,88467,1,4,0
25204,3,2,88466,88467,88469,1,3,0
25205,6,1,88472,88472,88473,0,1,3
25206,1,3,88473,88473,88476,0,3,0
25207,1,2,88474,88476,88478,2,4,0
25208,1,1,88475,88478,88479,3,4,0
25209,6,1,88481,88481,88482,0,1,2
25210,1,3,88482,88482,88485,0,3,0
25211,3,2,88485,88485,88487,0,2,0
25212,4,2,88489,88489,88491,0,2,2
25213,1,3,88490,88491,88494,1,4,0
25214,6,1,88496,88496,88497,0,1,2
25215,1,1,88497,88497,88498,0,1,0
25216,3,2,88500,88500,88502,0,2,2
25217,6,2,88506,88506,88508,0,2,4
25218,3,1,88509,88509,88510,0,1,1
25219,1,3,88510,88510,88513,0,3,0
25220,4,2,88514,88514,88516,0,2,1
25221,6,3,88520,88520,88523,0,3,4
25222,3,3,88523,88523,88526,0,3,0
25223,4,1,88527,88527,88528,0,1,1
25224,5,3,88532,88532,88535,0,3,4
25225,4,3,88536,88536,88539,0,3,1
25226,5,2,88541,88541,88543,0,2,2
25227,4,1,88545,88545,88546,0,1,2
25228,2,2,88547,88547,88549,0,2,1
25229,2,1,88549,88549,88550,0,1,0
25230,6,2,88555,88555,88557,0,2,5
25231,5,1,88560,88560,88561,0,1,3
25232,3,2,88563,88563,88565,0,2,2
25233,5,3,88568,88568,88571,0,3,3
25234,3,2,88571,88571,88573,0,2,0
25235,2,1,88573,88573,88574,0,1,0
25236,6,1,88579,88579,88580,0,1,5
25237,6,2,88585,88585,88587,0,2,5
25238,3,3,88588,88588,88591,0,3,1
25239,5,3,88593,88593,88596,0,3,2
25240,5,3,88598,88598,88601,0,3,2
25241,2,3,88600,88601,88604,1,4,0
25242,1,3,88601,88604,88607,3,6,0
25243,1,1,88602,88607,88608,5,6,0
25244,2,3,88604,88608,88611,4,7,0
25245,2,2,88606,88611,88613,5,7,0
25246,6,3,88612,88613,88616,1,4,0
25247,2,1,88614,88616,88617,2,3,0
25248,3,1,88617,88617,88618,0,1,0
25249,3,1,88620,88620,88621,0,1,2
25250,3,2,88623,88623,88625,0,2,2
25251,4,1,88627,88627,88628,0,1,2
25252,1,3,88628,88628,88631,0,3,0
25253,2,1,88630,88631,88632,1,2,0
25254,4,1,88634,88634,88635,0,1,2
25255,1,1,88635,88635,88636,0,1,0
25256,6,3,88641,88641,88644,0,3,5
25257,2,1,88643,88644,88645,1,2,0
25258,2,1,88645,88645,88646,0,1,0
25259,2,1,88647,88647,88648,0,1,1
25260,4,1,88651,88651,88652,0,1,3
25261,2,2,88653,88653,88655,0,2,1
25262,6,3,88659,88659,88662,0,3,4
25263,3,3,88662,88662,88665,0,3,0
25264,6,2,88668,88668,88670,0,2,3
25265,1,2,88669,88670,88672,1,3,0
25266,3,1,88672,88672,88673,0,1,0
25267,5,2,88677,88677,88679,0,2,4
25268,4,1,88681,88681,88682,0,1,2
25269,3,3,88684,88684,88687,0,3,2
25270,2,3,88686,88687,88690,1,4,0
25271,2,3,88688,88690,88693,2,5,0
25272,5,1,88693,88693,88694,0,1,0
25273,1,1,88694,88694,88695,0,1,0
25274,2,3,88696,88696,88699,0,3,1
25275,3,2,88699,88699,88701,0,2,0
25276,3,3,88702,88702,88705,0,3,1
25277,4,2,88706,88706,88708,0,2,1
25278,5,2,88711,88711,88713,0,2,3
25279,5,3,88716,88716,88719,0,3,3
25280,4,1,88720,88720,88721,0,1,1
25281,1,2,88721,88721,88723,0,2,0
25282,1,2,88722,88723,88725,1,3,0
25283,3,2,88725,88725,88727,0,2,0
25284,4,1,88729,88729,88730,0,1,2
25285,3,2,88732,88732,88734,0,2,2
25286,3,3,88735,88735,88738,0,3,1
25287,3,1,88738,88738,88739,0,1,0
25288,3,2,88741,88741,88743,0,2,2
25289,4,1,88745,88745,88746,0,1,2
25290,4,2,88749,88749,88751,0,2,3
25291,3,3,88752,88752,88755,0,3,1
25292,4,1,88756,88756,88757,0,1,1
25293,2,3,88758,88758,88761,0,3,1
25294,2,3,88760,88761,88764,1,4,0
25295,3,3,88763,88764,88767,1,4,0
25296,1,3,88764,88767,88770,3,6,0
25297,4,3,88768,88770,88773,2,5,0
25298,5,3,88773,88773,88776,0,3,0
25299,5,2,88778,88778,88780,0,2,2
25300,5,1,88783,88783,88784,0,1,3
25301,4,1,88787,88787,88788,0,1,3
25302,1,3,88788,88788,88791,0,3,0
25303,2,3,88790,88791,88794,1,4,0
25304,6,3,88796,88796,88799,0,3,2
25305,6,3,88802,88802,88805,0,3,3
25306,1,3,88803,88805,88808,2,5,0
25307,1,1,88804,88808,88809,4,5,0
25308,3,1,88807,88809,88810,2,3,0
25309,5,2,88812,88812,88814,0,2,2
25310,5,1,88817,88817,88818,0,1,3
25311,5,2,88822,88822,88824,0,2,4
25312,6,1,88828,88828,88829,0,1,4
25313,3,3,88831,88831,88834,0,3,2
25314,4,1,88835,88835,88836,0,1,1
25315,1,1,88836,88836,88837,0,1,0
25316,5,1,88841,88841,88842,0,1,4
25317,5,1,88846,88846,88847,0,1,4
25318,6,3,88852,88852,88855,0,3,5
25319,6,1,88858,88858,88859,0,1,3
25320,6,3,88864,88864,88867,0,3,5
25321,3,1,88867,88867,88868,0,1,0
25322,3,3,88870,88870,88873,0,3,2
25323,6,3,88876,88876,88879,0,3,3
25324,4,1,88880,88880,88881,0,1,1
25325,3,3,88883,88883,88886,0,3,2
25326,5,2,88888,88888,88890,0,2,2
25327,2,1,88890,88890,88891,0,1,0
25328,3,3,88893,88893,88896,0,3,2
25329,6,2,88899,88899,88901,0,2,3
25330,6,3,88905,88905,88908,0,3,4
25331,4,2,88909,88909,88911,0,2,1
25332,6,3,88915,88915,88918,0,3,4
25333,4,1,88919,88919,88920,0,1,1
25334,1,3,88920,88920,88923,0,3,0
25335,5,2,88925,88925,88927,0,2,2
25336,1,3,88926,88927,88930,1,4,0
25337,1,2,88927,88930,88932,3,5,0
25338,2,2,88929,88932,88934,3,5,0
25339,6,2,88935,88935,88937,0,2,1
25340,3,2,88938,88938,88940,0,2,1
25341,4,1,88942,88942,88943,0,1,2
25342,3,2,88945,88945,88947,0,2,2
25343,1,2,88946,88947,88949,1,3,0
25344,3,2,88949,88949,88951,0,2,0
25345,4,1,88953,88953,88954,0,1,2
25346,3,3,88956,88956,88959,0,3,2
25347,4,1,88960,88960,88961,0,1,1
25348,4,3,88964,88964,88967,0,3,3
25349,5,1,88969,88969,88970,0,1,2
25350,5,1,88974,88974,88975,0,1,4
25351,3,2,88977,88977,88979,0,2,2
25352,5,2,88982,88982,88984,0,2,3
25353,2,2,88984,88984,88986,0,2,0
25354,4,2,88988,88988,88990,0,2,2
25355,4,1,88992,88992,88993,0,1,2
25356,2,3,88994,88994,88997,0,3,1
25357,1,2,88995,88997,88999,2,4,0
25358,1,3,88996,88999,89002,3,6,0
25359,5,2,89001,89002,89004,1,3,0
25360,5,3,89006,89006,89009,0,3,2
25361,5,3,89011,89011,89014,0,3,2
25362,2,3,89013,89014,89017,1,4,0
25363,1,2,89014,89017,89019,3,5,0
25364,4,2,89018,89019,89021,1,3,0
25365,4,3,89022,89022,89025,0,3,1
25366,1,1,89023,89025,89026,2,3,0
25367,2,3,89025,89026,89029,1,4,0
25368,6,2,89031,89031,89033,0,2,2
25369,3,2,89034,89034,89036,0,2,1
25370,6,1,89040,89040,89041,0,1,4
25371,3,3,89043,89043,89046,0,3,2
25372,5,3,89048,89048,89051,0,3,2
25373,6,3,89054,89054,89057,0,3,3
25374,6,1,89060,89060,89061,0,1,3
25375,4,1,89064,89064,89065,0,1,3
25376,5,3,89069,89069,89072,0,3,4
25377,5,1,89074,89074,89075,0,1,2
25378,5,1,89079,89079,89080,0,1,4
25379,6,1,89085,89085,89086,0,1,5
25380,5,3,89090,89090,89093,0,3,4
25381,3,2,89093,89093,89095,0,2,0
25382,2,2,89095,89095,89097,0,2,0
25383,3,3,89098,89098,89101,0,3,1
25384,1,3,89099,89101,89104,2,5,0
25385,1,2,89100,89104,89106,4,6,0
25386,6,3,89106,89106,89109,0,3,0
25387,3,1,89109,89109,89110,0,1,0
25388,2,1,89111,89111,89112,0,1,1
25389,1,2,89112,89112,89114,0,2,0
25390,2,1,89114,89114,89115,0,1,0
25391,6,2,89120,89120,89122,0,2,5
25392,4,1,89124,89124,89125,0,1,2
25393,2,1,89126,89126,89127,0,1,1
25394,2,2,89128,89128,89130,0,2,1
25395,5,1,89133,89133,89134,0,1,3
25396,2,3,89135,89135,89138,0,3,1
25397,6,3,89141,89141,89144,0,3,3
25398,5,1,89146,89146,89147,0,1,2
25399,5,3,89151,89151,89154,0,3,4
25400,5,2,89156,89156,89158,0,2,2
25401,6,1,89162,89162,89163,0,1,4
25402,4,2,89166,89166,89168,0,2,3
25403,1,3,89167,89168,89171,1,4,0
25404,4,1,89171,89171,89172,0,1,0
25405,6,1,89177,89177,89178,0,1,5
25406,2,2,89179,89179,89181,0,2,1
25407,6,2,89185,89185,89187,0,2,4
25408,1,1,89186,89187,89188,1,2,0
25409,1,3,89187,89188,89191,1,4,0
25410,4,2,89191,89191,89193,0,2,0
25411,5,1,89196,89196,89197,0,1,3
25412,4,3,89200,89200,89203,0,3,3
25413,6,1,89206,89206,89207,0,1,3
25414,1,2,89207,89207,89209,0,2,0
25415,6,2,89213,89213,89215,0,2,4
25416,4,1,89217,89217,89218,0,1,2
25417,2,2,89219,89219,89221,0,2,1
25418,3,2,89222,89222,89224,0,2,1
25419,4,2,89226,89226,89228,0,2,2
25420,3,2,89229,89229,89231,0,2,1
25421,1,1,89230,89231,89232,1,2,0
25422,4,1,89234,89234,89235,0,1,2
25423,4,1,89238,89238,89239,0,1,3
25424,4,1,89242,89242,89243,0,1,3
25425,1,1,89243,89243,89244,0,1,0
25426,1,1,89244,89244,89245,0,1,0
25427,2,2,89246,89246,89248,0,2,1
25428,2,2,89248,89248,89250,0,2,0
25429,2,3,89250,89250,89253,0,3,0
25430,5,3,89255,89255,89258,0,3,2
25431,2,3,89257,89258,89261,1,4,0
25432,1,1,89258,89261,89262,3,4,0
25433,5,2,89263,89263,89265,0,2,1
25434,4,3,89267,89267,89270,0,3,2
25435,3,1,89270,89270,89271,0,1,0
25436,1,2,89271,89271,89273,0,2,0
25437,4,3,89275,89275,89278,0,3,2
25438,6,2,89281,89281,89283,0,2,3
25439,2,2,89283,89283,89285,0,2,0
25440,1,1,89284,89285,89286,1,2,0
25441,2,3,89286,89286,89289,0,3,0
25442,3,3,89289,89289,89292,0,3,0
25443,2,2,89291,89292,89294,1,3,0
25444,6,1,89297,89297,89298,0,1,3
25445,2,1,89299,89299,89300,0,1,1
25446,5,2,89304,89304,89306,0,2,4
25447,6,1,89310,89310,89311,0,1,4
25448,6,1,89316,89316,89317,0,1,5
25449,6,2,89322,89322,89324,0,2,5
25450,5,1,89327,89327,89328,0,1,3
25451,1,2,89328,89328,89330,0,2,0
25452,5,3,89333,89333,89336,0,3,3
25453,1,3,89334,89336,89339,2,5,0
25454,4,3,89338,89339,89342,1,4,0
25455,4,1,89342,89342,89343,0,1,0
25456,2,3,89344,89344,89347,0,3,1
25457,2,3,89346,89347,89350,1,4,0
25458,5,1,89351,89351,89352,0,1,1
25459,1,3,89352,89352,89355,0,3,0
25460,5,2,89357,89357,89359,0,2,2
25461,1,2,89358,89359,89361,1,3,0
25462,5,3,89363,89363,89366,0,3,2
25463,5,2,89368,89368,89370,0,2,2
25464,3,2,89371,89371,89373,0,2,1
25465,4,1,89375,89375,89376,0,1,2
25466,2,2,89377,89377,89379,0,2,1
25467,2,2,89379,89379,89381,0,2,0
25468,1,1,89380,89381,89382,1,2,0
25469,6,2,89386,89386,89388,0,2,4
25470,3,1,89389,89389,89390,0,1,1
25471,5,3,89394,89394,89397,0,3,4
25472,5,2,89399,89399,89401,0,2,2
25473,5,2,89404,89404,89406,0,2,3
25474,2,1,89406,89406,89407,0,1,0
25475,6,1,89412,89412,89413,0,1,5
25476,4,3,89416,89416,89419,0,3,3
25477,1,1,89417,89419,89420,2,3,0
25478,5,1,89422,89422,89423,0,1,2
25479,1,1,89423,89423,89424,0,1,0
25480,2,2,89425,89425,89427,0,2,1
25481,3,2,89428,89428,89430,0,2,1
25482,2,3,89430,89430,89433,0,3,0
25483,4,1,89434,89434,89435,0,1,1
25484,3,2,89437,89437,89439,0,2,2
25485,3,1,89440,89440,89441,0,1,1
25486,2,1,89442,89442,89443,0,1,1
25487,4,2,89446,89446,89448,0,2,3
25488,6,2,89452,89452,89454,0,2,4
25489,6,3,89458,89458,89461,0,3,4
25490,4,3,89462,89462,89465,0,3,1
25491,3,2,89465,89465,89467,0,2,0
25492,3,3,89468,89468,89471,0,3,1
25493,1,1,89469,89471,89472,2,3,0
25494,2,1,89471,89472,89473,1,2,0
25495,6,1,89477,89477,89478,0,1,4
25496,3,2,89480,89480,89482,0,2,2
25497,5,3,89485,89485,89488,0,3,3
25498,6,2,89491,89491,89493,0,2,3
25499,5,2,89496,89496,89498,0,2,3
25500,5,3,89501,89501,89504,0,3,3
25501,1,2,89502,89504,89506,2,4,0
25502,1,1,89503,89506,89507,3,4,0
25503,5,2,89508,89508,89510,0,2,1
25504,2,3,89510,89510,89513,0,3,0
25505,1,2,89511,89513,89515,2,4,0
25506,1,2,89512,89515,89517,3,5,0
25507,2,1,89514,89517,89518,3,4,0
25508,1,2,89515,89518,89520,3,5,0
25509,3,1,89518,89520,89521,2,3,0
25510,3,3,89521,89521,89524,0,3,0
25511,3,3,89524,89524,89527,0,3,0
25512,6,1,89530,89530,89531,0,1,3
25513,1,2,89531,89531,89533,0,2,0
25514,3,3,89534,89534,89537,0,3,1
25515,5,1,89539,89539,89540,0,1,2
25516,1,2,89540,89540,89542,0,2,0
25517,3,1,89543,89543,89544,0,1,1
25518,1,3,89544,89544,89547,0,3,0
25519,3,3,89547,89547,89550,0,3,0
25520,3,3,89550,89550,89553,0,3,0
25521,1,2,89551,89553,89555,2,4,0
25522,2,3,89553,89555,89558,2,5,0
25523,4,3,89557,89558,89561,1,4,0
25524,6,3,89563,89563,89566,0,3,2
25525,1,3,89564,89566,89569,2,5,0
25526,6,2,89570,89570,89572,0,2,1
25527,5,2,89575,89575,89577,0,2,3
25528,4,3,89579,89579,89582,0,3,2
25529,3,2,89582,89582,89584,0,2,0
25530,6,1,89588,89588,89589,0,1,4
25531,5,2,89593,89593,89595,0,2,4
25532,1,3,89594,89595,89598,1,4,0
25533,4,2,89598,89598,89600,0,2,0
25534,1,2,89599,89600,89602,1,3,0
25535,5,1,89604,89604,89605,0,1,2
25536,3,3,89607,89607,89610,0,3,2
25537,2,2,89609,89610,89612,1,3,0
25538,2,1,89611,89612,89613,1,2,0
25539,3,3,89614,89614,89617,0,3,1
25540,1,3,89615,89617,89620,2,5,0
25541,6,3,89621,89621,89624,0,3,1
25542,2,1,89623,89624,89625,1,2,0
25543,2,2,89625,89625,89627,0,2,0
25544,4,3,89629,89629,89632,0,3,2
25545,6,3,89635,89635,89638,0,3,3
25546,6,2,89641,89641,89643,0,2,3
25547,1,1,89642,89643,89644,1,2,0
25548,5,2,89647,89647,89649,0,2,3
25549,3,3,89650,89650,89653,0,3,1
25550,1,2,89651,89653,89655,2,4,0
25551,4,3,89655,89655,89658,0,3,0
25552,2,2,89657,89658,89660,1,3,0
25553,1,3,89658,89660,89663,2,5,0
25554,4,2,89662,89663,89665,1,3,0
25555,2,1,89664,89665,89666,1,2,0
25556,2,3,89666,89666,89669,0,3,0
25557,1,2,89667,89669,89671,2,4,0
25558,5,1,89672,89672,89673,0,1,1
25559,3,1,89675,89675,89676,0,1,2
25560,5,1,89680,89680,89681,0,1,4
25561,4,1,89684,89684,89685,0,1,3
25562,2,3,89686,89686,89689,0,3,1
25563,1,3,89687,89689,89692,2,5,0
25564,6,2,89693,89693,89695,0,2,1
25565,2,3,89695,89695,89698,0,3,0
25566,1,3,89696,89698,89701,2,5,0
25567,1,1,89697,89701,89702,4,5,0
25568,6,2,89703,89703,89705,0,2,1
25569,3,2,89706,89706,89708,0,2,1
25570,5,2,89711,89711,89713,0,2,3
25571,1,2,89712,89713,89715,1,3,0
25572,4,3,89716,89716,89719,0,3,1
25573,4,3,89720,89720,89723,0,3,1
25574,4,2,89724,89724,89726,0,2,1
25575,6,2,89730,89730,89732,0,2,4
25576,2,2,89732,89732,89734,0,2,0
25577,3,3,89735,89735,89738,0,3,1
25578,2,3,89737,89738,89741,1,4,0
25579,5,1,89742,89742,89743,0,1,1
25580,3,3,89745,89745,89748,0,3,2
25581,3,3,89748,89748,89751,0,3,0
25582,3,2,89751,89751,89753,0,2,0
25583,5,3,89756,89756,89759,0,3,3
25584,1,2,89757,89759,89761,2,4,0
25585,6,3,89763,89763,89766,0,3,2
25586,5,1,89768,89768,89769,0,1,2
25587,1,2,89769,89769,89771,0,2,0
25588,6,2,89775,89775,89777,0,2,4
25589,3,3,89778,89778,89781,0,3,1
25590,4,2,89782,89782,89784,0,2,1
25591,2,2,89784,89784,89786,0,2,0
25592,2,1,89786,89786,89787,0,1,0
25593,3,3,89789,89789,89792,0,3,2
25594,1,3,89790,89792,89795,2,5,0
25595,4,1,89794,89795,89796,1,2,0
25596,6,1,89800,89800,89801,0,1,4
25597,4,2,89804,89804,89806,0,2,3
25598,6,1,89810,89810,89811,0,1,4
25599,4,2,89814,89814,89816,0,2,3
25600,3,2,89817,89817,89819,0,2,1
25601,5,2,89822,89822,89824,0,2,3
25602,2,2,89824,89824,89826,0,2,0
25603,6,3,89830,89830,89833,0,3,4
25604,6,1,89836,89836,89837,0,1,3
25605,2,3,89838,89838,89841,0,3,1
25606,4,1,89842,89842,89843,0,1,1
25607,6,2,89848,89848,89850,0,2,5
25608,2,1,89850,89850,89851,0,1,0
25609,5,2,89855,89855,89857,0,2,4
25610,3,3,89858,89858,89861,0,3,1
25611,5,2,89863,89863,89865,0,2,2
25612,3,3,89866,89866,89869,0,3,1
25613,2,2,89868,89869,89871,1,3,0
25614,6,2,89874,89874,89876,0,2,3
25615,4,3,89878,89878,89881,0,3,2
25616,5,2,89883,89883,89885,0,2,2
25617,2,3,89885,89885,89888,0,3,0
25618,3,2,89888,89888,89890,0,2,0
25619,3,3,89891,89891,89894,0,3,1
25620,4,3,89895,89895,89898,0,3,1
25621,4,2,89899,89899,89901,0,2,1
25622,5,3,89904,89904,89907,0,3,3
25623,4,1,89908,89908,89909,0,1,1
25624,2,1,89910,89910,89911,0,1,1
25625,6,1,89916,89916,89917,0,1,5
25626,6,3,89922,89922,89925,0,3,5
25627,3,2,89925,89925,89927,0,2,0
25628,6,1,89931,89931,89932,0,1,4
25629,4,3,89935,89935,89938,0,3,3
25630,1,3,89936,89938,89941,2,5,0
25631,5,2,89941,89941,89943,0,2,0
25632,2,2,89943,89943,89945,0,2,0
25633,4,1,89947,89947,89948,0,1,2
25634,6,2,89953,89953,89955,0,2,5
25635,6,2,89959,89959,89961,0,2,4
25636,6,1,89965,89965,89966,0,1,4
25637,1,3,89966,89966,89969,0,3,0
25638,4,2,89970,89970,89972,0,2,1
25639,6,1,89976,89976,89977,0,1,4
25640,6,2,89982,89982,89984,0,2,5
25641,1,1,89983,89984,89985,1,2,0
25642,5,3,89988,89988,89991,0,3,3
25643,5,2,89993,89993,89995,0,2,2
25644,5,2,89998,89998,90000,0,2,3
25645,2,3,90000,90000,90003,0,3,0
25646,3,2,90003,90003,90005,0,2,0
25647,2,2,90005,90005,90007,0,2,0
25648,5,1,90010,90010,90011,0,1,3
25649,2,1,90012,90012,90013,0,1,1
25650,6,1,90018,90018,90019,0,1,5
25651,1,2,90019,90019,90021,0,2,0
25652,4,3,90023,90023,90026,0,3,2
25653,5,3,90028,90028,90031,0,3,2
25654,6,1,90034,90034,90035,0,1,3
25655,3,3,90037,90037,90040,0,3,2
25656,6,2,90043,90043,90045,0,2,3
25657,3,1,90046,90046,90047,0,1,1
25658,6,1,90052,90052,90053,0,1,5
25659,3,1,90055,90055,90056,0,1,2
25660,2,1,90057,90057,90058,0,1,1
25661,5,1,90062,90062,90063,0,1,4
25662,1,1,90063,90063,90064,0,1,0
25663,2,3,90065,90065,90068,0,3,1
25664,6,1,90071,90071,90072,0,1,3
25665,6,3,90077,90077,90080,0,3,5
25666,2,2,90079,90080,90082,1,3,0
25667,2,1,90081,90082,90083,1,2,0
25668,6,2,90087,90087,90089,0,2,4
25669,1,1,90088,90089,90090,1,2,0
25670,3,1,90091,90091,90092,0,1,1
25671,4,1,90095,90095,90096,0,1,3
25672,4,1,90099,90099,90100,0,1,3
25673,3,1,90102,90102,90103,0,1,2
25674,1,1,90103,90103,90104,0,1,0
25675,6,2,90109,90109,90111,0,2,5
25676,6,2,90115,90115,90117,0,2,4
25677,5,3,90120,90120,90123,0,3,3
25678,3,1,90123,90123,90124,0,1,0
25679,6,1,90129,90129,90130,0,1,5
25680,1,3,90130,90130,90133,0,3,0
25681,3,2,90133,90133,90135,0,2,0
25682,3,2,90136,90136,90138,0,2,1
25683,6,3,90142,90142,90145,0,3,4
25684,5,1,90147,90147,90148,0,1,2
25685,2,1,90149,90149,90150,0,1,1
25686,5,1,90154,90154,90155,0,1,4
25687,5,1,90159,90159,90160,0,1,4
25688,3,3,90162,90162,90165,0,3,2
25689,4,2,90166,90166,90168,0,2,1
25690,3,1,90169,90169,90170,0,1,1
25691,6,2,90175,90175,90177,0,2,5
25692,3,1,90178,90178,90179,0,1,1
25693,6,3,90184,90184,90187,0,3,5
25694,2,3,90186,90187,90190,1,4,0
25695,3,1,90189,90190,90191,1,2,0
25696,5,2,90194,90194,90196,0,2,3
25697,5,3,90199,90199,90202,0,3,3
25698,4,1,90203,90203,90204,0,1,1
25699,4,2,90207,90207,90209,0,2,3
25700,3,2,90210,90210,90212,0,2,1
25701,5,2,90215,90215,90217,0,2,3
25702,3,2,90218,90218,90220,0,2,1
25703,2,3,90220,90220,90223,0,3,0
25704,3,1,90223,90223,90224,0,1,0
25705,5,2,90228,90228,90230,0,2,4
25706,1,2,90229,90230,90232,1,3,0
25707,4,2,90233,90233,90235,0,2,1
25708,1,2,90234,90235,90237,1,3,0
25709,4,3,90238,90238,90241,0,3,1
25710,1,1,90239,90241,90242,2,3,0
25711,2,1,90241,90242,90243,1,2,0
25712,5,3,90246,90246,90249,0,3,3
25713,5,2,90251,90251,90253,0,2,2
25714,3,2,90254,90254,90256,0,2,1
25715,4,1,90258,90258,90259,0,1,2
25716,1,1,90259,90259,90260,0,1,0
25717,6,1,90265,90265,90266,0,1,5
25718,5,2,90270,90270,90272,0,2,4
25719,1,3,90271,90272,90275,1,4,0
25720,4,2,90275,90275,90277,0,2,0
25721,2,3,90277,90277,90280,0,3,0
25722,1,2,90278,90280,90282,2,4,0
25723,2,3,90280,90282,90285,2,5,0
25724,3,1,90283,90285,90286,2,3,0
25725,4,2,90287,90287,90289,0,2,1
25726,2,1,90289,90289,90290,0,1,0
25727,6,2,90295,90295,90297,0,2,5
25728,4,2,90299,90299,90301,0,2,2
25729,2,2,90301,90301,90303,0,2,0
25730,1,2,90302,90303,90305,1,3,0
25731,1,3,90303,90305,90308,2,5,0
25732,6,1,90309,90309,90310,0,1,1
25733,4,1,90313,90313,90314,0,1,3
25734,1,1,90314,90314,90315,0,1,0
25735,1,1,90315,90315,90316,0,1,0
25736,3,2,90318,90318,90320,0,2,2
25737,1,3,90319,90320,90323,1,4,0
25738,3,1,90322,90323,90324,1,2,0
25739,1,1,90323,90324,90325,1,2,0
25740,4,3,90327,90327,90330,0,3,2
25741,6,1,90333,90333,90334,0,1,3
25742,5,1,90338,90338,90339,0,1,4
25743,4,2,90342,90342,90344,0,2,3
25744,4,1,90346,90346,90347,0,1,2
25745,4,3,90350,90350,90353,0,3,3
25746,6,3,90356,90356,90359,0,3,3
25747,4,3,90360,90360,90363,0,3,1
25748,5,2,90365,90365,90367,0,2,2
25749,5,2,90370,90370,90372,0,2,3
25750,6,3,90376,90376,90379,0,3,4
25751,4,2,90380,90380,90382,0,2,1
25752,3,3,90383,90383,90386,0,3,1
25753,2,1,90385,90386,90387,1,2,0
25754,2,3,90387,90387,90390,0,3,0
25755,4,2,90391,90391,90393,0,2,1
25756,4,1,90395,90395,90396,0,1,2
25757,3,2,90398,90398,90400,0,2,2
25758,5,3,90403,90403,90406,0,3,3
25759,3,3,90406,90406,90409,0,3,0
25760,3,2,90409,90409,90411,0,2,0
25761,5,3,90414,90414,90417,0,3,3
25762,6,3,90420,90420,90423,0,3,3
25763,2,2,90422,90423,90425,1,3,0
25764,3,1,90425,90425,90426,0,1,0
25765,5,3,90430,90430,90433,0,3,4
25766,5,2,90435,90435,90437,0,2,2
25767,1,3,90436,90437,90440,1,4,0
25768,1,1,90437,90440,90441,3,4,0
25769,5,2,90442,90442,90444,0,2,1
25770,4,3,90446,90446,90449,0,3,2
25771,4,3,90450,90450,90453,0,3,1
25772,1,1,90451,90453,90454,2,3,0
25773,3,1,90454,90454,90455,0,1,0
25774,4,2,90458,90458,90460,0,2,3
25775,1,3,90459,90460,90463,1,4,0
25776,1,2,90460,90463,90465,3,5,0
25777,6,2,90466,90466,90468,0,2,1
25778,3,1,90469,90469,90470,0,1,1
25779,6,3,90475,90475,90478,0,3,5
25780,4,3,90479,90479,90482,0,3,1
25781,3,2,90482,90482,90484,0,2,0
25782,3,3,90485,90485,90488,0,3,1
25783,6,3,90491,90491,90494,0,3,3
25784,6,3,90497,90497,90500,0,3,3
25785,3,1,90500,90500,90501,0,1,0
25786,1,3,90501,90501,90504,0,3,0
25787,6,1,90507,90507,90508,0,1,3
25788,2,3,90509,90509,90512,0,3,1
25789,3,1,90512,90512,90513,0,1,0
25790,5,2,90517,90517,90519,0,2,4
25791,3,1,90520,90520,90521,0,1,1
25792,5,1,90525,90525,90526,0,1,4
25793,5,3,90530,90530,90533,0,3,4
25794,6,1,90536,90536,90537,0,1,3
25795,5,1,90541,90541,90542,0,1,4
25796,3,3,90544,90544,90547,0,3,2
25797,4,2,90548,90548,90550,0,2,1
25798,1,1,90549,90550,90551,1,2,0
25799,4,1,90553,90553,90554,0,1,2
25800,5,1,90558,90558,90559,0,1,4
25801,2,3,90560,90560,90563,0,3,1
25802,5,3,90565,90565,90568,0,3,2
25803,3,3,90568,90568,90571,0,3,0
25804,6,2,90574,90574,90576,0,2,3
25805,4,1,90578,90578,90579,0,1,2
25806,6,2,90584,90584,90586,0,2,5
25807,2,2,90586,90586,90588,0,2,0
25808,1,2,90587,90588,90590,1,3,0
25809,3,1,90590,90590,90591,0,1,0
25810,5,3,90595,90595,90598,0,3,4
25811,5,3,90600,90600,90603,0,3,2
25812,3,2,90603,90603,90605,0,2,0
25813,4,1,90607,90607,90608,0,1,2
25814,5,1,90612,90612,90613,0,1,4
25815,5,3,90617,90617,90620,0,3,4
25816,5,2,90622,90622,90624,0,2,2
25817,3,3,90625,90625,90628,0,3,1
25818,5,3,90630,90630,90633,0,3,2
25819,2,1,90632,90633,90634,1,2,0
25820,2,2,90634,90634,90636,0,2,0
25821,5,3,90639,90639,90642,0,3,3
25822,3,2,90642,90642,90644,0,2,0
25823,4,2,90646,90646,90648,0,2,2
25824,6,3,90652,90652,90655,0,3,4
25825,3,3,90655,90655,90658,0,3,0
25826,2,1,90657,90658,90659,1,2,0
25827,4,1,90661,90661,90662,0,1,2
25828,6,1,90667,90667,90668,0,1,5
25829,3,3,90670,90670,90673,0,3,2
25830,2,3,90672,90673,90676,1,4,0
25831,4,1,90676,90676,90677,0,1,0
25832,5,3,90681,90681,90684,0,3,4
25833,5,1,90686,90686,90687,0,1,2
25834,3,2,90689,90689,90691,0,2,2
25835,2,2,90691,90691,90693,0,2,0
25836,1,2,90692,90693,90695,1,3,0
25837,5,1,90697,90697,90698,0,1,2
25838,6,2,90703,90703,90705,0,2,5
25839,5,2,90708,90708,90710,0,2,3
25840,5,2,90713,90713,90715,0,2,3
25841,3,3,90716,90716,90719,0,3,1
25842,2,3,90718,90719,90722,1,4,0
25843,2,2,90720,90722,90724,2,4,0
25844,1,1,90721,90724,90725,3,4,0
25845,5,2,90726,90726,90728,0,2,1
25846,3,1,90729,90729,90730,0,1,1
25847,1,2,90730,90730,90732,0,2,0
25848,5,1,90735,90735,90736,0,1,3
25849,6,3,90741,90741,90744,0,3,5
25850,3,3,90744,90744,90747,0,3,0
25851,3,1,90747,90747,90748,0,1,0
25852,4,1,90751,90751,90752,0,1,3
25853,3,2,90754,90754,90756,0,2,2
25854,6,3,90760,90760,90763,0,3,4
25855,2,1,90762,90763,90764,1,2,0
25856,6,1,90768,90768,90769,0,1,4
25857,5,1,90773,90773,90774,0,1,4
25858,6,2,90779,90779,90781,0,2,5
25859,2,1,90781,90781,90782,0,1,0
25860,6,1,90787,90787,90788,0,1,5
25861,4,2,90791,90791,90793,0,2,3
25862,1,1,90792,90793,90794,1,2,0
25863,5,2,90797,90797,90799,0,2,3
25864,2,1,90799,90799,90800,0,1,0
25865,3,2,90802,90802,90804,0,2,2
25866,3,1,90805,90805,90806,0,1,1
25867,5,1,90810,90810,90811,0,1,4
25868,5,3,90815,90815,90818,0,3,4
25869,3,2,90818,90818,90820,0,2,0
25870,1,3,90819,90820,90823,1,4,0
25871,4,2,90823,90823,90825,0,2,0
25872,1,2,90824,90825,90827,1,3,0
25873,2,1,90826,90827,90828,1,2,0
25874,5,2,90831,90831,90833,0,2,3
25875,1,2,90832,90833,90835,1,3,0
25876,1,1,90833,90835,90836,2,3,0
25877,6,3,90839,90839,90842,0,3,3
25878,4,1,90843,90843,90844,0,1,1
25879,2,1,90845,90845,90846,0,1,1
25880,6,2,90851,90851,90853,0,2,5
25881,4,3,90855,90855,90858,0,3,2
25882,6,1,90861,90861,90862,0,1,3
25883,2,1,90863,90863,90864,0,1,1
25884,6,2,90869,90869,90871,0,2,5
25885,6,2,90875,90875,90877,0,2,4
25886,5,2,90880,90880,90882,0,2,3
25887,2,2,90882,90882,90884,0,2,0
25888,6,1,90888,90888,90889,0,1,4
25889,3,1,90891,90891,90892,0,1,2
25890,4,1,90895,90895,90896,0,1,3
25891,6,3,90901,90901,90904,0,3,5
25892,3,1,90904,90904,90905,0,1,0
25893,4,2,90908,90908,90910,0,2,3
25894,6,1,90914,90914,90915,0,1,4
25895,1,3,90915,90915,90918,0,3,0
25896,5,2,90920,90920,90922,0,2,2
25897,3,3,90923,90923,90926,0,3,1
25898,2,1,90925,90926,90927,1,2,0
25899,3,2,90928,90928,90930,0,2,1
25900,4,2,90932,90932,90934,0,2,2
25901,3,1,90935,90935,90936,0,1,1
25902,4,1,90939,90939,90940,0,1,3
25903,5,2,90944,90944,90946,0,2,4
25904,5,1,90949,90949,90950,0,1,3
25905,6,2,90955,90955,90957,0,2,5
25906,3,1,90958,90958,90959,0,1,1
25907,5,2,90963,90963,90965,0,2,4
25908,4,1,90967,90967,90968,0,1,2
25909,3,3,90970,90970,90973,0,3,2
25910,4,2,90974,90974,90976,0,2,1
25911,3,2,90977,90977,90979,0,2,1
25912,1,3,90978,90979,90982,1,4,0
25913,4,2,90982,90982,90984,0,2,0
25914,1,3,90983,90984,90987,1,4,0
25915,3,2,90986,90987,90989,1,3,0
25916,6,1,90992,90992,90993,0,1,3
25917,3,3,90995,90995,90998,0,3,2
25918,2,1,90997,90998,90999,1,2,0
25919,2,3,90999,90999,91002,0,3,0
25920,3,1,91002,91002,91003,0,1,0
25921,3,3,91005,91005,91008,0,3,2
25922,5,1,91010,91010,91011,0,1,2
25923,5,2,91015,91015,91017,0,2,4
25924,2,3,91017,91017,91020,0,3,0
25925,6,2,91023,91023,91025,0,2,3
25926,3,2,91026,91026,91028,0,2,1
25927,2,1,91028,91028,91029,0,1,0
25928,1,1,91029,91029,91030,0,1,0
25929,1,3,91030,91030,91033,0,3,0
25930,3,3,91033,91033,91036,0,3,0
25931,2,3,91035,91036,91039,1,4,0
25932,4,3,91039,91039,91042,0,3,0
25933,1,2,91040,91042,91044,2,4,0
25934,3,1,91043,91044,91045,1,2,0
25935,3,3,91046,91046,91049,0,3,1
25936,2,1,91048,91049,91050,1,2,0
25937,6,3,91054,91054,91057,0,3,4
25938,1,3,91055,91057,91060,2,5,0
25939,6,3,91061,91061,91064,0,3,1
25940,3,2,91064,91064,91066,0,2,0
25941,3,1,91067,91067,91068,0,1,1
25942,5,3,91072,91072,91075,0,3,4
25943,4,3,91076,91076,91079,0,3,1
25944,1,1,91077,91079,91080,2,3,0
25945,3,3,91080,91080,91083,0,3,0
25946,1,3,91081,91083,91086,2,5,0
25947,3,3,91084,91086,91089,2,5,0
25948,6,1,91090,91090,91091,0,1,1
25949,1,1,91091,91091,91092,0,1,0
25950,6,2,91097,91097,91099,0,2,5
25951,3,3,91100,91100,91103,0,3,1
25952,6,3,91106,91106,91109,0,3,3
25953,2,2,91108,91109,91111,1,3,0
25954,5,1,91113,91113,91114,0,1,2
25955,2,1,91115,91115,91116,0,1,1
25956,2,1,91117,91117,91118,0,1,1
25957,6,2,91123,91123,91125,0,2,5
25958,6,3,91129,91129,91132,0,3,4
25959,2,1,91131,91132,91133,1,2,0
25960,2,3,91133,91133,91136,0,3,0
25961,6,3,91139,91139,91142,0,3,3
25962,4,3,91143,91143,91146,0,3,1
25963,1,2,91144,91146,91148,2,4,0
25964,3,2,91147,91148,91150,1,3,0
25965,1,2,91148,91150,91152,2,4,0
25966,5,3,91153,91153,91156,0,3,1
25967,2,1,91155,91156,91157,1,2,0
25968,6,3,91161,91161,91164,0,3,4
25969,5,3,91166,91166,91169,0,3,2
25970,1,2,91167,91169,91171,2,4,0
25971,6,1,91173,91173,91174,0,1,2
25972,2,1,91175,91175,91176,0,1,1
25973,2,2,91177,91177,91179,0,2,1
25974,1,2,91178,91179,91181,1,3,0
25975,5,1,91183,91183,91184,0,1,2
25976,2,1,91185,91185,91186,0,1,1
25977,1,1,91186,91186,91187,0,1,0
25978,2,1,91188,91188,91189,0,1,1
25979,6,2,91194,91194,91196,0,2,5
25980,2,2,91196,91196,91198,0,2,0
25981,6,2,91202,91202,91204,0,2,4
25982,1,1,91203,91204,91205,1,2,0
25983,3,2,91206,91206,91208,0,2,1
25984,4,2,91210,91210,91212,0,2,2
25985,4,2,91214,91214,91216,0,2,2
25986,1,2,91215,91216,91218,1,3,0
25987,6,1,91221,91221,91222,0,1,3
25988,3,1,91224,91224,91225,0,1,2
25989,6,2,91230,91230,91232,0,2,5
25990,1,3,91231,91232,91235,1,4,0
25991,1,3,91232,91235,91238,3,6,0
25992,6,2,91238,91238,91240,0,2,0
25993,6,1,91244,91244,91245,0,1,4
25994,2,1,91246,91246,91247,0,1,1
25995,1,1,91247,91247,91248,0,1,0
25996,2,2,91249,91249,91251,0,2,1
25997,2,2,91251,91251,91253,0,2,0
25998,4,1,91255,91255,91256,0,1,2
25999,5,2,91260,91260,91262,0,2,4
26000,3,3,91263,91263,91266,0,3,1
26001,3,2,91266,91266,91268,0,2,0
26002,3,1,91269,91269,91270,0,1,1
26003,1,3,91270,91270,91273,0,3,0
26004,5,3,91275,91275,91278,0,3,2
26005,5,3,91280,91280,91283,0,3,2
26006,2,2,91282,91283,91285,1,3,0
26007,4,2,91286,91286,91288,0,2,1
26008,5,3,91291,91291,91294,0,3,3
26009,2,1,91293,91294,91295,1,2,0
26010,5,1,91298,91298,91299,0,1,3
26011,2,2,91300,91300,91302,0,2,1
26012,3,1,91303,91303,91304,0,1,1
26013,5,2,91308,91308,91310,0,2,4
26014,1,2,91309,91310,91312,1,3,0
26015,1,3,91310,91312,91315,2,5,0
26016,6,1,91316,91316,91317,0,1,1
26017,4,2,91320,91320,91322,0,2,3
26018,2,3,91322,91322,91325,0,3,0
26019,6,1,91328,91328,91329,0,1,3
26020,2,2,91330,91330,91332,0,2,1
26021,5,3,91335,91335,91338,0,3,3
26022,2,3,91337,91338,91341,1,4,0
26023,6,1,91343,91343,91344,0,1,2
26024,5,1,91348,91348,91349,0,1,4
26025,1,1,91349,91349,91350,0,1,0
26026,5,2,91354,91354,91356,0,2,4
26027,6,3,91360,91360,91363,0,3,4
26028,1,2,91361,91363,91365,2,4,0
26029,3,3,91364,91365,91368,1,4,0
26030,6,1,91370,91370,91371,0,1,2
26031,1,2,91371,91371,91373,0,2,0
26032,3,2,91374,91374,91376,0,2,1
26033,5,1,91379,91379,91380,0,1,3
26034,2,3,91381,91381,91384,0,3,1
26035,6,2,91387,91387,91389,0,2,3
26036,2,2,91389,91389,91391,0,2,0
26037,2,3,91391,91391,91394,0,3,0
26038,4,2,91395,91395,91397,0,2,1
26039,2,1,91397,91397,91398,0,1,0
26040,3,2,91400,91400,91402,0,2,2
26041,3,3,91403,91403,91406,0,3,1
26042,6,2,91409,91409,91411,0,2,3
26043,5,1,91414,91414,91415,0,1,3
26044,6,1,91420,91420,91421,0,1,5
26045,3,1,91423,91423,91424,0,1,2
26046,5,1,91428,91428,91429,0,1,4
26047,3,3,91431,91431,91434,0,3,2
26048,6,3,91437,91437,91440,0,3,3
26049,2,1,91439,91440,91441,1,2,0
26050,4,2,91443,91443,91445,0,2,2
26051,5,3,91448,91448,91451,0,3,3
26052,1,3,91449,91451,91454,2,5,0
26053,4,1,91453,91454,91455,1,2,0
26054,5,3,91458,91458,91461,0,3,3
26055,5,2,91463,91463,91465,0,2,2
26056,3,1,91466,91466,91467,0,1,1
26057,5,1,91471,91471,91472,0,1,4
26058,4,1,91475,91475,91476,0,1,3
26059,6,2,91481,91481,91483,0,2,5
26060,3,1,91484,91484,91485,0,1,1
26061,2,1,91486,91486,91487,0,1,1
26062,5,1,91491,91491,91492,0,1,4
26063,1,2,91492,91492,91494,0,2,0
26064,3,2,91495,91495,91497,0,2,1
26065,5,1,91500,91500,91501,0,1,3
26066,4,2,91504,91504,91506,0,2,3
26067,3,2,91507,91507,91509,0,2,1
26068,3,3,91510,91510,91513,0,3,1
26069,1,2,91511,91513,91515,2,4,0
26070,4,3,91515,91515,91518,0,3,0
26071,4,1,91519,91519,91520,0,1,1
26072,2,2,91521,91521,91523,0,2,1
26073,5,2,91526,91526,91528,0,2,3
26074,6,3,91532,91532,91535,0,3,4
26075,2,3,91534,91535,91538,1,4,0
26076,6,2,91540,91540,91542,0,2,2
26077,3,1,91543,91543,91544,0,1,1
26078,6,3,91549,91549,91552,0,3,5
26079,4,2,91553,91553,91555,0,2,1
26080,3,1,91556,91556,91557,0,1,1
26081,3,1,91559,91559,91560,0,1,2
26082,3,3,91562,91562,91565,0,3,2
26083,5,2,91567,91567,91569,0,2,2
26084,6,1,91573,91573,91574,0,1,4
26085,2,1,91575,91575,91576,0,1,1
26086,2,3,91577,91577,91580,0,3,1
26087,1,2,91578,91580,91582,2,4,0
26088,3,1,91581,91582,91583,1,2,0
26089,6,1,91587,91587,91588,0,1,4
26090,3,2,91590,91590,91592,0,2,2
26091,4,1,91594,91594,91595,0,1,2
26092,4,3,91598,91598,91601,0,3,3
26093,4,2,91602,91602,91604,0,2,1
26094,3,2,91605,91605,91607,0,2,1
26095,3,1,91608,91608,91609,0,1,1
26096,1,3,91609,91609,91612,0,3,0
26097,5,2,91614,91614,91616,0,2,2
26098,6,3,91620,91620,91623,0,3,4
26099,1,3,91621,91623,91626,2,5,0
26100,3,3,91624,91626,91629,2,5,0
26101,3,2,91627,91629,91631,2,4,0
26102,2,3,91629,91631,91634,2,5,0
26103,5,2,91634,91634,91636,0,2,0
26104,3,1,91637,91637,91638,0,1,1
26105,5,1,91642,91642,91643,0,1,4
26106,3,1,91645,91645,91646,0,1,2
26107,6,2,91651,91651,91653,0,2,5
26108,6,2,91657,91657,91659,0,2,4
26109,1,3,91658,91659,91662,1,4,0
26110,6,3,91664,91664,91667,0,3,2
26111,1,2,91665,91667,91669,2,4,0
26112,2,2,91667,91669,91671,2,4,0
26113,4,2,91671,91671,91673,0,2,0
26114,2,1,91673,91673,91674,0,1,0
26115,1,1,91674,91674,91675,0,1,0
26116,3,1,91677,91677,91678,0,1,2
26117,5,1,91682,91682,91683,0,1,4
26118,6,2,91688,91688,91690,0,2,5
26119,2,2,91690,91690,91692,0,2,0
26120,5,3,91695,91695,91698,0,3,3
26121,6,2,91701,91701,91703,0,2,3
26122,3,1,91704,91704,91705,0,1,1
26123,1,2,91705,91705,91707,0,2,0
26124,6,1,91711,91711,91712,0,1,4
26125,5,3,91716,91716,91719,0,3,4
26126,3,3,91719,91719,91722,0,3,0
26127,4,2,91723,91723,91725,0,2,1
26128,4,2,91727,91727,91729,0,2,2
26129,3,3,91730,91730,91733,0,3,1
26130,6,2,91736,91736,91738,0,2,3
26131,1,2,91737,91738,91740,1,3,0
26132,4,1,91741,91741,91742,0,1,1
26133,3,2,91744,91744,91746,0,2,2
26134,4,1,91748,91748,91749,0,1,2
26135,2,2,91750,91750,91752,0,2,1
26136,4,3,91754,91754,91757,0,3,2
26137,3,2,91757,91757,91759,0,2,0
26138,4,1,91761,91761,91762,0,1,2
26139,5,1,91766,91766,91767,0,1,4
26140,1,1,91767,91767,91768,0,1,0
26141,4,3,91771,91771,91774,0,3,3
26142,4,1,91775,91775,91776,0,1,1
26143,2,1,91777,91777,91778,0,1,1
26144,5,2,91782,91782,91784,0,2,4
26145,2,3,91784,91784,91787,0,3,0
26146,6,3,91790,91790,91793,0,3,3
26147,6,2,91796,91796,91798,0,2,3
26148,6,1,91802,91802,91803,0,1,4
26149,6,1,91808,91808,91809,0,1,5
26150,3,1,91811,91811,91812,0,1,2
26151,3,1,91814,91814,91815,0,1,2
26152,1,1,91815,91815,91816,0,1,0
26153,4,2,91819,91819,91821,0,2,3
26154,3,1,91822,91822,91823,0,1,1
26155,2,2,91824,91824,91826,0,2,1
26156,1,2,91825,91826,91828,1,3,0
26157,4,2,91829,91829,91831,0,2,1
26158,4,2,91833,91833,91835,0,2,2
26159,2,2,91835,91835,91837,0,2,0
26160,1,2,91836,91837,91839,1,3,0
26161,5,1,91841,91841,91842,0,1,2
26162,3,2,91844,91844,91846,0,2,2
26163,1,1,91845,91846,91847,1,2,0
26164,3,1,91848,91848,91849,0,1,1
26165,6,1,91854,91854,91855,0,1,5
26166,3,2,91857,91857,91859,0,2,2
26167,5,1,91862,91862,91863,0,1,3
26168,2,1,91864,91864,91865,0,1,1
26169,3,1,91867,91867,91868,0,1,2
26170,4,1,91871,91871,91872,0,1,3
26171,5,2,91876,91876,91878,0,2,4
26172,3,1,91879,91879,91880,0,1,1
26173,3,1,91882,91882,91883,0,1,2
26174,1,3,91883,91883,91886,0,3,0
26175,6,3,91889,91889,91892,0,3,3
26176,5,1,91894,91894,91895,0,1,2
26177,1,1,91895,91895,91896,0,1,0
26178,2,2,91897,91897,91899,0,2,1
26179,1,2,91898,91899,91901,1,3,0
26180,2,1,91900,91901,91902,1,2,0
26181,4,3,91904,91904,91907,0,3,2
26182,4,1,91908,91908,91909,0,1,1
26183,2,1,91910,91910,91911,0,1,1
26184,3,1,91913,91913,91914,0,1,2
26185,4,2,91917,91917,91919,0,2,3
26186,1,1,91918,91919,91920,1,2,0
26187,2,1,91920,91920,91921,0,1,0
26188,3,3,91923,91923,91926,0,3,2
26189,3,1,91926,91926,91927,0,1,0
26190,6,1,91932,91932,91933,0,1,5
26191,4,1,91936,91936,91937,0,1,3
26192,6,3,91942,91942,91945,0,3,5
26193,5,3,91947,91947,91950,0,3,2
26194,5,3,91952,91952,91955,0,3,2
26195,3,2,91955,91955,91957,0,2,0
26196,1,3,91956,91957,91960,1,4,0
26197,5,1,91961,91961,91962,0,1,1
26198,6,2,91967,91967,91969,0,2,5
26199,6,2,91973,91973,91975,0,2,4
26200,1,2,91974,91975,91977,1,3,0
26201,2,1,91976,91977,91978,1,2,0
26202,6,2,91982,91982,91984,0,2,4
26203,1,2,91983,91984,91986,1,3,0
26204,4,1,91987,91987,91988,0,1,1
26205,6,3,91993,91993,91996,0,3,5
26206,4,2,91997,91997,91999,0,2,1
26207,3,3,92000,92000,92003,0,3,1
26208,3,3,92003,92003,92006,0,3,0
26209,6,2,92009,92009,92011,0,2,3
26210,2,1,92011,92011,92012,0,1,0
26211,5,3,92016,92016,92019,0,3,4
26212,6,2,92022,92022,92024,0,2,3
26213,4,3,92026,92026,92029,0,3,2
26214,2,1,92028,92029,92030,1,2,0
26215,6,3,92034,92034,92037,0,3,4
26216,5,2,92039,92039,92041,0,2,2
26217,2,2,92041,92041,92043,0,2,0
26218,4,3,92045,92045,92048,0,3,2
26219,2,3,92047,92048,92051,1,4,0
26220,3,2,92050,92051,92053,1,3,0
26221,5,2,92055,92055,92057,0,2,2
26222,6,1,92061,92061,92062,0,1,4
26223,1,1,92062,92062,92063,0,1,0
26224,2,3,92064,92064,92067,0,3,1
26225,2,1,92066,92067,92068,1,2,0
26226,1,1,92067,92068,92069,1,2,0
26227,4,3,92071,92071,92074,0,3,2
26228,5,2,92076,92076,92078,0,2,2
26229,6,2,92082,92082,92084,0,2,4
26230,6,2,92088,92088,92090,0,2,4
26231,3,2,92091,92091,92093,0,2,1
26232,6,1,92097,92097,92098,0,1,4
26233,6,1,92103,92103,92104,0,1,5
26234,4,2,92107,92107,92109,0,2,3
26235,6,1,92113,92113,92114,0,1,4
26236,2,3,92115,92115,92118,0,3,1
26237,2,2,92117,92118,92120,1,3,0
26238,6,1,92123,92123,92124,0,1,3
26239,6,1,92129,92129,92130,0,1,5
26240,4,2,92133,92133,92135,0,2,3
26241,4,1,92137,92137,92138,0,1,2
26242,4,2,92141,92141,92143,0,2,3
26243,3,1,92144,92144,92145,0,1,1
26244,1,1,92145,92145,92146,0,1,0
26245,1,2,92146,92146,92148,0,2,0
26246,5,2,92151,92151,92153,0,2,3
26247,5,2,92156,92156,92158,0,2,3
26248,2,1,92158,92158,92159,0,1,0
26249,3,1,92161,92161,92162,0,1,2
26250,2,1,92163,92163,92164,0,1,1
26251,2,2,92165,92165,92167,0,2,1
26252,3,2,92168,92168,92170,0,2,1
26253,2,3,92170,92170,92173,0,3,0
26254,2,2,92172,92173,92175,1,3,0
26255,4,3,92176,92176,92179,0,3,1
26256,4,2,92180,92180,92182,0,2,1
26257,1,3,92181,92182,92185,1,4,0
26258,3,3,92184,92185,92188,1,4,0
26259,6,3,92190,92190,92193,0,3,2
26260,2,1,92192,92193,92194,1,2,0
26261,1,2,92193,92194,92196,1,3,0
26262,5,2,92198,92198,92200,0,2,2
26263,4,2,92202,92202,92204,0,2,2
26264,2,3,92204,92204,92207,0,3,0
26265,1,2,92205,92207,92209,2,4,0
26266,1,2,92206,92209,92211,3,5,0
26267,6,2,92212,92212,92214,0,2,1
26268,1,1,92213,92214,92215,1,2,0
26269,2,1,92215,92215,92216,0,1,0
26270,2,1,92217,92217,92218,0,1,1
26271,1,3,92218,92218,92221,0,3,0
26272,2,1,92220,92221,92222,1,2,0
26273,6,2,92226,92226,92228,0,2,4
26274,4,3,92230,92230,92233,0,3,2
26275,3,2,92233,92233,92235,0,2,0
26276,5,3,92238,92238,92241,0,3,3
26277,4,3,92242,92242,92245,0,3,1
26278,3,1,92245,92245,92246,0,1,0
26279,1,1,92246,92246,92247,0,1,0
26280,3,3,92249,92249,92252,0,3,2
26281,6,1,92255,92255,92256,0,1,3
26282,5,1,92260,92260,92261,0,1,4
26283,5,3,92265,92265,92268,0,3,4
26284,5,3,92270,92270,92273,0,3,2
26285,3,3,92273,92273,92276,0,3,0
26286,3,3,92276,92276,92279,0,3,0
26287,4,2,92280,92280,92282,0,2,1
26288,3,1,92283,92283,92284,0,1,1
26289,5,2,92288,92288,92290,0,2,4
26290,2,1,92290,92290,92291,0,1,0
26291,2,2,92292,92292,92294,0,2,1
26292,6,2,92298,92298,92300,0,2,4
26293,2,1,92300,92300,92301,0,1,0
26294,3,2,92303,92303,92305,0,2,2
26295,3,3,92306,92306,92309,0,3,1
26296,6,1,92312,92312,92313,0,1,3
26297,1,3,92313,92313,92316,0,3,0
26298,1,3,92314,92316,92319,2,5,0
26299,6,2,92320,92320,92322,0,2,1
26300,6,1,92326,92326,92327,0,1,4
26301,3,3,92329,92329,92332,0,3,2
26302,2,3,92331,92332,92335,1,4,0
26303,4,1,92335,92335,92336,0,1,0
26304,3,1,92338,92338,92339,0,1,2
26305,4,3,92342,92342,92345,0,3,3
26306,6,2,92348,92348,92350,0,2,3
26307,5,1,92353,92353,92354,0,1,3
26308,6,3,92359,92359,92362,0,3,5
26309,6,2,92365,92365,92367,0,2,3
26310,5,2,92370,92370,92372,0,2,3
26311,5,2,92375,92375,92377,0,2,3
26312,1,1,92376,92377,92378,1,2,0
26313,1,2,92377,92378,92380,1,3,0
26314,4,1,92381,92381,92382,0,1,1
26315,2,2,92383,92383,92385,0,2,1
26316,5,3,92388,92388,92391,0,3,3
26317,2,3,92390,92391,92394,1,4,0
26318,4,3,92394,92394,92397,0,3,0
26319,6,3,92400,92400,92403,0,3,3
26320,4,1,92404,92404,92405,0,1,1
26321,6,2,92410,92410,92412,0,2,5
26322,4,3,92414,92414,92417,0,3,2
26323,6,3,92420,92420,92423,0,3,3
26324,2,3,92422,92423,92426,1,4,0
26325,4,2,92426,92426,92428,0,2,0
26326,4,3,92430,92430,92433,0,3,2
26327,2,2,92432,92433,92435,1,3,0
26328,4,2,92436,92436,92438,0,2,1
26329,3,2,92439,92439,92441,0,2,1
26330,1,3,92440,92441,92444,1,4,0
26331,5,2,92445,92445,92447,0,2,1
26332,4,3,92449,92449,92452,0,3,2
26333,4,3,92453,92453,92456,0,3,1
26334,1,2,92454,92456,92458,2,4,0
26335,6,2,92460,92460,92462,0,2,2
26336,1,1,92461,92462,92463,1,2,0
26337,6,1,92467,92467,92468,0,1,4
26338,6,3,92473,92473,92476,0,3,5
26339,3,2,92476,92476,92478,0,2,0
26340,6,2,92482,92482,92484,0,2,4
26341,4,2,92486,92486,92488,0,2,2
26342,4,3,92490,92490,92493,0,3,2
26343,1,1,92491,92493,92494,2,3,0
26344,1,2,92492,92494,92496,2,4,0
26345,1,1,92493,92496,92497,3,4,0
26346,2,2,92495,92497,92499,2,4,0
26347,5,3,92500,92500,92503,0,3,1
26348,3,3,92503,92503,92506,0,3,0
26349,2,3,92505,92506,92509,1,4,0
26350,1,1,92506,92509,92510,3,4,0
26351,4,3,92510,92510,92513,0,3,0
26352,4,1,92514,92514,92515,0,1,1
26353,3,2,92517,92517,92519,0,2,2
26354,2,2,92519,92519,92521,0,2,0
26355,2,2,92521,92521,92523,0,2,0
26356,3,2,92524,92524,92526,0,2,1
26357,4,2,92528,92528,92530,0,2,2
26358,5,2,92533,92533,92535,0,2,3
26359,6,1,92539,92539,92540,0,1,4
26360,5,1,92544,92544,92545,0,1,4
26361,2,2,92546,92546,92548,0,2,1
26362,1,1,92547,92548,92549,1,2,0
26363,1,1,92548,92549,92550,1,2,0
26364,6,1,92554,92554,92555,0,1,4
26365,4,1,92558,92558,92559,0,1,3
26366,5,3,92563,92563,92566,0,3,4
26367,3,2,92566,92566,92568,0,2,0
26368,5,2,92571,92571,92573,0,2,3
26369,5,1,92576,92576,92577,0,1,3
26370,6,1,92582,92582,92583,0,1,5
26371,6,3,92588,92588,92591,0,3,5
26372,6,1,92594,92594,92595,0,1,3
26373,1,3,92595,92595,92598,0,3,0
26374,2,1,92597,92598,92599,1,2,0
26375,4,3,92601,92601,92604,0,3,2
26376,2,2,92603,92604,92606,1,3,0
26377,2,1,92605,92606,92607,1,2,0
26378,2,1,92607,92607,92608,0,1,0
26379,3,3,92610,92610,92613,0,3,2
26380,3,3,92613,92613,92616,0,3,0
26381,2,1,92615,92616,92617,1,2,0
26382,6,3,92621,92621,92624,0,3,4
26383,6,3,92627,92627,92630,0,3,3
26384,6,2,92633,92633,92635,0,2,3
26385,4,1,92637,92637,92638,0,1,2
26386,1,2,92638,92638,92640,0,2,0
26387,4,1,92642,92642,92643,0,1,2
26388,1,2,92643,92643,92645,0,2,0
26389,3,3,92646,92646,92649,0,3,1
26390,2,3,92648,92649,92652,1,4,0
26391,5,2,92653,92653,92655,0,2,1
26392,3,1,92656,92656,92657,0,1,1
26393,6,3,92662,92662,92665,0,3,5
26394,1,2,92663,92665,92667,2,4,0
26395,5,2,92668,92668,92670,0,2,1
26396,6,2,92674,92674,92676,0,2,4
26397,5,3,92679,92679,92682,0,3,3
26398,6,3,92685,92685,92688,0,3,3
26399,6,2,92691,92691,92693,0,2,3
26400,5,1,92696,92696,92697,0,1,3
26401,4,2,92700,92700,92702,0,2,3
26402,3,2,92703,92703,92705,0,2,1
26403,5,2,92708,92708,92710,0,2,3
26404,3,1,92711,92711,92712,0,1,1
26405,3,1,92714,92714,92715,0,1,2
26406,6,3,92720,92720,92723,0,3,5
26407,3,2,92723,92723,92725,0,2,0
26408,3,1,92726,92726,92727,0,1,1
26409,2,1,92728,92728,92729,0,1,1
26410,5,2,92733,92733,92735,0,2,4
26411,1,2,92734,92735,92737,1,3,0
26412,4,1,92738,92738,92739,0,1,1
26413,5,2,92743,92743,92745,0,2,4
26414,2,2,92745,92745,92747,0,2,0
26415,6,3,92751,92751,92754,0,3,4
26416,2,2,92753,92754,92756,1,3,0
26417,2,1,92755,92756,92757,1,2,0
26418,5,3,92760,92760,92763,0,3,3
26419,3,1,92763,92763,92764,0,1,0
26420,4,3,92767,92767,92770,0,3,3
26421,5,2,92772,92772,92774,0,2,2
26422,2,2,92774,92774,92776,0,2,0
26423,2,3,92776,92776,92779,0,3,0
26424,1,3,92777,92779,92782,2,5,0
26425,6,1,92783,92783,92784,0,1,1
26426,6,3,92789,92789,92792,0,3,5
26427,3,1,92792,92792,92793,0,1,0
26428,1,2,92793,92793,92795,0,2,0
26429,5,2,92798,92798,92800,0,2,3
26430,6,1,92804,92804,92805,0,1,4
26431,4,3,92808,92808,92811,0,3,3
26432,1,3,92809,92811,92814,2,5,0
26433,6,3,92815,92815,92818,0,3,1
26434,1,1,92816,92818,92819,2,3,0
26435,1,2,92817,92819,92821,2,4,0
26436,1,2,92818,92821,92823,3,5,0
26437,1,1,92819,92823,92824,4,5,0
26438,6,2,92825,92825,92827,0,2,1
26439,2,3,92827,92827,92830,0,3,0
26440,4,3,92831,92831,92834,0,3,1
26441,5,3,92836,92836,92839,0,3,2
26442,1,1,92837,92839,92840,2,3,0
26443,4,3,92841,92841,92844,0,3,1
26444,5,3,92846,92846,92849,0,3,2
26445,5,2,92851,92851,92853,0,2,2
26446,2,3,92853,92853,92856,0,3,0
26447,5,3,92858,92858,92861,0,3,2
26448,6,3,92864,92864,92867,0,3,3
26449,1,1,92865,92867,92868,2,3,0
26450,2,3,92867,92868,92871,1,4,0
26451,4,3,92871,92871,92874,0,3,0
26452,1,3,92872,92874,92877,2,5,0
26453,2,2,92874,92877,92879,3,5,0
26454,4,3,92878,92879,92882,1,4,0
26455,5,2,92883,92883,92885,0,2,1
26456,4,2,92887,92887,92889,0,2,2
26457,5,3,92892,92892,92895,0,3,3
26458,1,3,92893,92895,92898,2,5,0
26459,1,2,92894,92898,92900,4,6,0
26460,6,3,92900,92900,92903,0,3,0
26461,6,2,92906,92906,92908,0,2,3
26462,5,1,92911,92911,92912,0,1,3
26463,1,3,92912,92912,92915,0,3,0
26464,1,2,92913,92915,92917,2,4,0
26465,1,1,92914,92917,92918,3,4,0
26466,4,2,92918,92918,92920,0,2,0
26467,5,2,92923,92923,92925,0,2,3
26468,3,2,92926,92926,92928,0,2,1
26469,4,1,92930,92930,92931,0,1,2
26470,5,2,92935,92935,92937,0,2,4
26471,1,2,92936,92937,92939,1,3,0
26472,2,3,92938,92939,92942,1,4,0
26473,2,2,92940,92942,92944,2,4,0
26474,4,1,92944,92944,92945,0,1,0
26475,4,3,92948,92948,92951,0,3,3
26476,1,2,92949,92951,92953,2,4,0
26477,1,3,92950,92953,92956,3,6,0
26478,2,3,92952,92956,92959,4,7,0
26479,5,1,92957,92959,92960,2,3,0
26480,1,1,92958,92960,92961,2,3,0
26481,1,3,92959,92961,92964,2,5,0
26482,6,3,92965,92965,92968,0,3,1
26483,1,2,92966,92968,92970,2,4,0
26484,2,2,92968,92970,92972,2,4,0
26485,1,3,92969,92972,92975,3,6,0
26486,4,2,92973,92975,92977,2,4,0
26487,4,2,92977,92977,92979,0,2,0
26488,1,3,92978,92979,92982,1,4,0
26489,2,3,92980,92982,92985,2,5,0
26490,1,3,92981,92985,92988,4,7,0
26491,4,1,92985,92988,92989,3,4,0
26492,4,1,92989,92989,92990,0,1,0
26493,6,3,92995,92995,92998,0,3,5
26494,4,2,92999,92999,93001,0,2,1
26495,6,1,93005,93005,93006,0,1,4
26496,2,1,93007,93007,93008,0,1,1
26497,4,3,93011,93011,93014,0,3,3
26498,1,3,93012,93014,93017,2,5,0
26499,4,1,93016,93017,93018,1,2,0
26500,5,2,93021,93021,93023,0,2,3
26501,5,1,93026,93026,93027,0,1,3
26502,3,2,93029,93029,93031,0,2,2
26503,6,3,93035,93035,93038,0,3,4
26504,6,3,93041,93041,93044,0,3,3
26505,1,1,93042,93044,93045,2,3,0
26506,5,3,93047,93047,93050,0,3,2
26507,5,3,93052,93052,93055,0,3,2
26508,2,1,93054,93055,93056,1,2,0
26509,3,2,93057,93057,93059,0,2,1
26510,1,1,93058,93059,93060,1,2,0
26511,5,1,93063,93063,93064,0,1,3
26512,5,3,93068,93068,93071,0,3,4
26513,3,3,93071,93071,93074,0,3,0
26514,4,2,93075,93075,93077,0,2,1
26515,3,3,93078,93078,93081,0,3,1
26516,2,1,93080,93081,93082,1,2,0
26517,6,1,93086,93086,93087,0,1,4
26518,2,3,93088,93088,93091,0,3,1
26519,5,1,93093,93093,93094,0,1,2
26520,2,3,93095,93095,93098,0,3,1
26521,1,2,93096,93098,93100,2,4,0
26522,6,3,93102,93102,93105,0,3,2
26523,1,1,93103,93105,93106,2,3,0
26524,6,2,93109,93109,93111,0,2,3
26525,2,3,93111,93111,93114,0,3,0
26526,1,3,93112,93114,93117,2,5,0
26527,1,2,93113,93117,93119,4,6,0
26528,3,1,93116,93119,93120,3,4,0
26529,3,1,93119,93120,93121,1,2,0
26530,6,3,93125,93125,93128,0,3,4
26531,6,2,93131,93131,93133,0,2,3
26532,1,1,93132,93133,93134,1,2,0
26533,1,1,93133,93134,93135,1,2,0
26534,3,3,93136,93136,93139,0,3,1
26535,6,3,93142,93142,93145,0,3,3
26536,1,3,93143,93145,93148,2,5,0
26537,6,2,93149,93149,93151,0,2,1
26538,3,2,93152,93152,93154,0,2,1
26539,5,3,93157,93157,93160,0,3,3
26540,3,3,93160,93160,93163,0,3,0
26541,2,2,93162,93163,93165,1,3,0
26542,1,2,93163,93165,93167,2,4,0
26543,6,2,93169,93169,93171,0,2,2
26544,1,3,93170,93171,93174,1,4,0
26545,1,1,93171,93174,93175,3,4,0
26546,3,2,93174,93175,93177,1,3,0
26547,6,2,93180,93180,93182,0,2,3
26548,4,3,93184,93184,93187,0,3,2
26549,3,1,93187,93187,93188,0,1,0
26550,4,2,93191,93191,93193,0,2,3
26551,2,2,93193,93193,93195,0,2,0
26552,4,3,93197,93197,93200,0,3,2
26553,2,2,93199,93200,93202,1,3,0
26554,4,1,93203,93203,93204,0,1,1
26555,1,2,93204,93204,93206,0,2,0
26556,6,2,93210,93210,93212,0,2,4
26557,4,2,93214,93214,93216,0,2,2
26558,4,1,93218,93218,93219,0,1,2
26559,4,3,93222,93222,93225,0,3,3
26560,2,2,93224,93225,93227,1,3,0
26561,2,1,93226,93227,93228,1,2,0
26562,6,3,93232,93232,93235,0,3,4
26563,3,1,93235,93235,93236,0,1,0
26564,4,2,93239,93239,93241,0,2,3
26565,5,2,93244,93244,93246,0,2,3
26566,4,1,93248,93248,93249,0,1,2
26567,3,3,93251,93251,93254,0,3,2
26568,4,1,93255,93255,93256,0,1,1
26569,5,3,93260,93260,93263,0,3,4
26570,4,2,93264,93264,93266,0,2,1
26571,6,2,93270,93270,93272,0,2,4
26572,3,3,93273,93273,93276,0,3,1
26573,6,2,93279,93279,93281,0,2,3
26574,2,1,93281,93281,93282,0,1,0
26575,5,3,93286,93286,93289,0,3,4
26576,6,1,93292,93292,93293,0,1,3
26577,1,1,93293,93293,93294,0,1,0
26578,5,2,93298,93298,93300,0,2,4
26579,1,3,93299,93300,93303,1,4,0
26580,1,2,93300,93303,93305,3,5,0
26581,5,1,93305,93305,93306,0,1,0
26582,5,2,93310,93310,93312,0,2,4
26583,1,1,93311,93312,93313,1,2,0
26584,3,3,93314,93314,93317,0,3,1
26585,3,2,93317,93317,93319,0,2,0
26586,4,2,93321,93321,93323,0,2,2
26587,6,1,93327,93327,93328,0,1,4
26588,2,2,93329,93329,93331,0,2,1
26589,2,2,93331,93331,93333,0,2,0
26590,1,1,93332,93333,93334,1,2,0
26591,2,2,93334,93334,93336,0,2,0
26592,1,3,93335,93336,93339,1,4,0
26593,6,2,93341,93341,93343,0,2,2
26594,1,1,93342,93343,93344,1,2,0
26595,6,2,93348,93348,93350,0,2,4
26596,1,1,93349,93350,93351,1,2,0
26597,6,2,93355,93355,93357,0,2,4
26598,3,1,93358,93358,93359,0,1,1
26599,4,2,93362,93362,93364,0,2,3
26600,5,3,93367,93367,93370,0,3,3
26601,5,2,93372,93372,93374,0,2,2
26602,1,3,93373,93374,93377,1,4,0
26603,1,2,93374,93377,93379,3,5,0
26604,6,2,93380,93380,93382,0,2,1
26605,3,1,93383,93383,93384,0,1,1
26606,2,2,93385,93385,93387,0,2,1
26607,5,1,93390,93390,93391,0,1,3
26608,2,2,93392,93392,93394,0,2,1
26609,6,2,93398,93398,93400,0,2,4
26610,1,1,93399,93400,93401,1,2,0
26611,4,1,93403,93403,93404,0,1,2
26612,5,1,93408,93408,93409,0,1,4
26613,5,3,93413,93413,93416,0,3,4
26614,5,2,93418,93418,93420,0,2,2
26615,1,1,93419,93420,93421,1,2,0
26616,5,1,93424,93424,93425,0,1,3
26617,6,3,93430,93430,93433,0,3,5
26618,3,2,93433,93433,93435,0,2,0
26619,5,3,93438,93438,93441,0,3,3
26620,1,3,93439,93441,93444,2,5,0
26621,3,3,93442,93444,93447,2,5,0
26622,4,2,93446,93447,93449,1,3,0
26623,5,1,93451,93451,93452,0,1,2
26624,3,3,93454,93454,93457,0,3,2
26625,2,2,93456,93457,93459,1,3,0
26626,6,3,93462,93462,93465,0,3,3
26627,3,3,93465,93465,93468,0,3,0
26628,3,2,93468,93468,93470,0,2,0
26629,5,2,93473,93473,93475,0,2,3
26630,6,1,93479,93479,93480,0,1,4
26631,3,1,93482,93482,93483,0,1,2
26632,4,1,93486,93486,93487,0,1,3
26633,1,2,93487,93487,93489,0,2,0
26634,1,3,93488,93489,93492,1,4,0
26635,2,3,93490,93492,93495,2,5,0
26636,6,1,93496,93496,93497,0,1,1
26637,4,1,93500,93500,93501,0,1,3
26638,2,2,93502,93502,93504,0,2,1
26639,1,2,93503,93504,93506,1,3,0
26640,5,2,93508,93508,93510,0,2,2
26641,2,2,93510,93510,93512,0,2,0
26642,1,1,93511,93512,93513,1,2,0
26643,4,2,93515,93515,93517,0,2,2
26644,3,2,93518,93518,93520,0,2,1
26645,2,3,93520,93520,93523,0,3,0
26646,4,1,93524,93524,93525,0,1,1
26647,6,1,93530,93530,93531,0,1,5
26648,3,2,93533,93533,93535,0,2,2
26649,1,2,93534,93535,93537,1,3,0
26650,5,2,93539,93539,93541,0,2,2
26651,3,2,93542,93542,93544,0,2,1
26652,3,3,93545,93545,93548,0,3,1
26653,4,1,93549,93549,93550,0,1,1
26654,1,3,93550,93550,93553,0,3,0
26655,5,2,93555,93555,93557,0,2,2
26656,3,2,93558,93558,93560,0,2,1
26657,2,3,93560,93560,93563,0,3,0
26658,6,1,93566,93566,93567,0,1,3
26659,5,1,93571,93571,93572,0,1,4
26660,6,2,93577,93577,93579,0,2,5
26661,3,2,93580,93580,93582,0,2,1
26662,2,3,93582,93582,93585,0,3,0
26663,5,3,93587,93587,93590,0,3,2
26664,1,1,93588,93590,93591,2,3,0
26665,3,1,93591,93591,93592,0,1,0
26666,5,3,93596,93596,93599,0,3,4
26667,5,2,93601,93601,93603,0,2,2
26668,2,2,93603,93603,93605,0,2,0
26669,5,1,93608,93608,93609,0,1,3
26670,4,2,93612,93612,93614,0,2,3
26671,4,1,93616,93616,93617,0,1,2
26672,5,3,93621,93621,93624,0,3,4
26673,3,1,93624,93624,93625,0,1,0
26674,1,3,93625,93625,93628,0,3,0
26675,5,2,93630,93630,93632,0,2,2
26676,4,1,93634,93634,93635,0,1,2
26677,4,3,93638,93638,93641,0,3,3
26678,6,1,93644,93644,93645,0,1,3
26679,2,1,93646,93646,93647,0,1,1
26680,1,3,93647,93647,93650,0,3,0
26681,4,1,93651,93651,93652,0,1,1
26682,3,2,93654,93654,93656,0,2,2
26683,6,2,93660,93660,93662,0,2,4
26684,1,2,93661,93662,93664,1,3,0
26685,1,2,93662,93664,93666,2,4,0
26686,3,2,93665,93666,93668,1,3,0
26687,3,2,93668,93668,93670,0,2,0
26688,2,3,93670,93670,93673,0,3,0
26689,3,3,93673,93673,93676,0,3,0
26690,3,1,93676,93676,93677,0,1,0
26691,1,1,93677,93677,93678,0,1,0
26692,5,3,93682,93682,93685,0,3,4
26693,5,1,93687,93687,93688,0,1,2
26694,3,2,93690,93690,93692,0,2,2
26695,3,3,93693,93693,93696,0,3,1
26696,3,2,93696,93696,93698,0,2,0
26697,2,1,93698,93698,93699,0,1,0
26698,2,2,93700,93700,93702,0,2,1
26699,2,1,93702,93702,93703,0,1,0
26700,6,1,93708,93708,93709,0,1,5
26701,2,3,93710,93710,93713,0,3,1
26702,5,2,93715,93715,93717,0,2,2
26703,3,3,93718,93718,93721,0,3,1
26704,1,1,93719,93721,93722,2,3,0
26705,2,3,93721,93722,93725,1,4,0
26706,4,3,93725,93725,93728,0,3,0
26707,1,2,93726,93728,93730,2,4,0
26708,5,1,93731,93731,93732,0,1,1
26709,3,1,93734,93734,93735,0,1,2
26710,4,3,93738,93738,93741,0,3,3
26711,3,2,93741,93741,93743,0,2,0
26712,3,2,93744,93744,93746,0,2,1
26713,4,3,93748,93748,93751,0,3,2
26714,3,2,93751,93751,93753,0,2,0
26715,4,2,93755,93755,93757,0,2,2
26716,1,1,93756,93757,93758,1,2,0
26717,5,1,93761,93761,93762,0,1,3
26718,1,3,93762,93762,93765,0,3,0
26719,1,1,93763,93765,93766,2,3,0
26720,5,2,93768,93768,93770,0,2,2
26721,3,1,93771,93771,93772,0,1,1
26722,4,1,93775,93775,93776,0,1,3
26723,4,1,93779,93779,93780,0,1,3
26724,5,3,93784,93784,93787,0,3,4
26725,3,2,93787,93787,93789,0,2,0
26726,6,2,93793,93793,93795,0,2,4
26727,1,3,93794,93795,93798,1,4,0
26728,6,3,93800,93800,93803,0,3,2
26729,5,2,93805,93805,93807,0,2,2
26730,6,2,93811,93811,93813,0,2,4
26731,6,2,93817,93817,93819,0,2,4
26732,1,1,93818,93819,93820,1,2,0
26733,6,3,93824,93824,93827,0,3,4
26734,1,3,93825,93827,93830,2,5,0
26735,1,2,93826,93830,93832,4,6,0
26736,4,3,93830,93832,93835,2,5,0
26737,4,1,93834,93835,93836,1,2,0
26738,3,3,93837,93837,93840,0,3,1
26739,5,3,93842,93842,93845,0,3,2
26740,6,2,93848,93848,93850,0,2,3
26741,6,2,93854,93854,93856,0,2,4
26742,6,2,93860,93860,93862,0,2,4
26743,4,1,93864,93864,93865,0,1,2
26744,6,2,93870,93870,93872,0,2,5
26745,6,2,93876,93876,93878,0,2,4
26746,2,2,93878,93878,93880,0,2,0
26747,1,2,93879,93880,93882,1,3,0
26748,3,3,93882,93882,93885,0,3,0
26749,1,3,93883,93885,93888,2,5,0
26750,3,1,93886,93888,93889,2,3,0
26751,4,3,93890,93890,93893,0,3,1
26752,1,1,93891,93893,93894,2,3,0
26753,4,3,93895,93895,93898,0,3,1
26754,6,3,93901,93901,93904,0,3,3
26755,6,3,93907,93907,93910,0,3,3
26756,5,2,93912,93912,93914,0,2,2
26757,4,3,93916,93916,93919,0,3,2
26758,6,1,93922,93922,93923,0,1,3
26759,3,1,93925,93925,93926,0,1,2
26760,3,2,93928,93928,93930,0,2,2
26761,1,1,93929,93930,93931,1,2,0
26762,3,2,93932,93932,93934,0,2,1
26763,2,2,93934,93934,93936,0,2,0
26764,6,2,93940,93940,93942,0,2,4
26765,1,1,93941,93942,93943,1,2,0
26766,1,1,93942,93943,93944,1,2,0
26767,5,1,93947,93947,93948,0,1,3
26768,2,3,93949,93949,93952,0,3,1
26769,6,2,93955,93955,93957,0,2,3
26770,3,2,93958,93958,93960,0,2,1
26771,2,2,93960,93960,93962,0,2,0
26772,6,3,93966,93966,93969,0,3,4
26773,4,2,93970,93970,93972,0,2,1
26774,5,3,93975,93975,93978,0,3,3
26775,5,3,93980,93980,93983,0,3,2
26776,4,3,93984,93984,93987,0,3,1
26777,3,1,93987,93987,93988,0,1,0
26778,1,3,93988,93988,93991,0,3,0
26779,5,1,93993,93993,93994,0,1,2
26780,5,3,93998,93998,94001,0,3,4
26781,3,3,94001,94001,94004,0,3,0
26782,5,2,94006,94006,94008,0,2,2
26783,6,2,94012,94012,94014,0,2,4
26784,6,2,94018,94018,94020,0,2,4
26785,3,2,94021,94021,94023,0,2,1
26786,3,1,94024,94024,94025,0,1,1
26787,3,3,94027,94027,94030,0,3,2
26788,5,3,94032,94032,94035,0,3,2
26789,3,3,94035,94035,94038,0,3,0
26790,5,1,94040,94040,94041,0,1,2
26791,5,3,94045,94045,94048,0,3,4
26792,4,3,94049,94049,94052,0,3,1
26793,5,3,94054,94054,94057,0,3,2
26794,2,2,94056,94057,94059,1,3,0
26795,6,1,94062,94062,94063,0,1,3
26796,5,1,94067,94067,94068,0,1,4
26797,1,2,94068,94068,94070,0,2,0
26798,6,1,94074,94074,94075,0,1,4
26799,1,1,94075,94075,94076,0,1,0
26800,6,2,94081,94081,94083,0,2,5
26801,2,1,94083,94083,94084,0,1,0
26802,6,3,94089,94089,94092,0,3,5
26803,6,2,94095,94095,94097,0,2,3
26804,4,3,94099,94099,94102,0,3,2
26805,1,3,94100,94102,94105,2,5,0
26806,5,1,94105,94105,94106,0,1,0
26807,4,1,94109,94109,94110,0,1,3
26808,5,3,94114,94114,94117,0,3,4
26809,2,3,94116,94117,94120,1,4,0
26810,1,3,94117,94120,94123,3,6,0
26811,1,1,94118,94123,94124,5,6,0
26812,3,2,94121,94124,94126,3,5,0
26813,2,3,94123,94126,94129,3,6,0
26814,4,1,94127,94129,94130,2,3,0
26815,5,3,94132,94132,94135,0,3,2
26816,3,2,94135,94135,94137,0,2,0
26817,5,3,94140,94140,94143,0,3,3
26818,2,3,94142,94143,94146,1,4,0
26819,1,2,94143,94146,94148,3,5,0
26820,6,2,94149,94149,94151,0,2,1
26821,3,3,94152,94152,94155,0,3,1
26822,6,3,94158,94158,94161,0,3,3
26823,3,1,94161,94161,94162,0,1,0
26824,6,3,94167,94167,94170,0,3,5
26825,1,1,94168,94170,94171,2,3,0
26826,6,1,94174,94174,94175,0,1,3
26827,3,1,94177,94177,94178,0,1,2
26828,3,3,94180,94180,94183,0,3,2
26829,4,1,94184,94184,94185,0,1,1
26830,3,2,94187,94187,94189,0,2,2
26831,2,2,94189,94189,94191,0,2,0
26832,3,2,94192,94192,94194,0,2,1
26833,6,1,94198,94198,94199,0,1,4
26834,6,1,94204,94204,94205,0,1,5
26835,3,1,94207,94207,94208,0,1,2
26836,5,2,94212,94212,94214,0,2,4
26837,2,2,94214,94214,94216,0,2,0
26838,5,1,94219,94219,94220,0,1,3
26839,3,3,94222,94222,94225,0,3,2
26840,5,3,94227,94227,94230,0,3,2
26841,1,3,94228,94230,94233,2,5,0
26842,1,3,94229,94233,94236,4,7,0
26843,2,1,94231,94236,94237,5,6,0
26844,6,3,94237,94237,94240,0,3,0
26845,3,3,94240,94240,94243,0,3,0
26846,5,2,94245,94245,94247,0,2,2
26847,1,3,94246,94247,94250,1,4,0
26848,3,1,94249,94250,94251,1,2,0
26849,6,1,94255,94255,94256,0,1,4
26850,6,2,94261,94261,94263,0,2,5
26851,6,1,94267,94267,94268,0,1,4
26852,3,2,94270,94270,94272,0,2,2
26853,1,3,94271,94272,94275,1,4,0
26854,3,1,94274,94275,94276,1,2,0
26855,2,3,94276,94276,94279,0,3,0
26856,5,2,94281,94281,94283,0,2,2
26857,2,2,94283,94283,94285,0,2,0
26858,3,3,94286,94286,94289,0,3,1
26859,5,2,94291,94291,94293,0,2,2
26860,6,2,94297,94297,94299,0,2,4
26861,5,3,94302,94302,94305,0,3,3
26862,5,2,94307,94307,94309,0,2,2
26863,6,3,94313,94313,94316,0,3,4
26864,4,3,94317,94317,94320,0,3,1
26865,3,1,94320,94320,94321,0,1,0
26866,4,3,94324,94324,94327,0,3,3
26867,5,2,94329,94329,94331,0,2,2
26868,1,1,94330,94331,94332,1,2,0
26869,6,1,94336,94336,94337,0,1,4
26870,6,1,94342,94342,94343,0,1,5
26871,5,2,94347,94347,94349,0,2,4
26872,6,1,94353,94353,94354,0,1,4
26873,1,2,94354,94354,94356,0,2,0
26874,6,1,94360,94360,94361,0,1,4
26875,3,1,94363,94363,94364,0,1,2
26876,2,2,94365,94365,94367,0,2,1
26877,6,2,94371,94371,94373,0,2,4
26878,1,3,94372,94373,94376,1,4,0
26879,5,1,94377,94377,94378,0,1,1
26880,3,2,94380,94380,94382,0,2,2
26881,4,1,94384,94384,94385,0,1,2
26882,3,3,94387,94387,94390,0,3,2
26883,2,3,94389,94390,94393,1,4,0
26884,3,3,94392,94393,94396,1,4,0
26885,6,1,94398,94398,94399,0,1,2
26886,3,1,94401,94401,94402,0,1,2
26887,4,2,94405,94405,94407,0,2,3
26888,6,1,94411,94411,94412,0,1,4
26889,5,2,94416,94416,94418,0,2,4
26890,2,1,94418,94418,94419,0,1,0
26891,3,3,94421,94421,94424,0,3,2
26892,4,2,94425,94425,94427,0,2,1
26893,6,2,94431,94431,94433,0,2,4
26894,1,3,94432,94433,94436,1,4,0
26895,6,1,94438,94438,94439,0,1,2
26896,1,1,94439,94439,94440,0,1,0
26897,4,3,94443,94443,94446,0,3,3
26898,3,1,94446,94446,94447,0,1,0
26899,1,1,94447,94447,94448,0,1,0
26900,6,2,94453,94453,94455,0,2,5
26901,1,2,94454,94455,94457,1,3,0
26902,1,1,94455,94457,94458,2,3,0
26903,5,3,94460,94460,94463,0,3,2
26904,4,2,94464,94464,94466,0,2,1
26905,2,2,94466,94466,94468,0,2,0
26906,2,3,94468,94468,94471,0,3,0
26907,6,1,94474,94474,94475,0,1,3
26908,1,2,94475,94475,94477,0,2,0
26909,3,3,94478,94478,94481,0,3,1
26910,4,1,94482,94482,94483,0,1,1
26911,4,3,94486,94486,94489,0,3,3
26912,3,3,94489,94489,94492,0,3,0
26913,4,1,94493,94493,94494,0,1,1
26914,3,1,94496,94496,94497,0,1,2
26915,3,3,94499,94499,94502,0,3,2
26916,2,2,94501,94502,94504,1,3,0
26917,5,1,94506,94506,94507,0,1,2
26918,3,2,94509,94509,94511,0,2,2
26919,5,3,94514,94514,94517,0,3,3
26920,6,3,94520,94520,94523,0,3,3
26921,4,2,94524,94524,94526,0,2,1
26922,3,3,94527,94527,94530,0,3,1
26923,6,2,94533,94533,94535,0,2,3
26924,5,2,94538,94538,94540,0,2,3
26925,2,1,94540,94540,94541,0,1,0
26926,1,2,94541,94541,94543,0,2,0
26927,6,3,94547,94547,94550,0,3,4
26928,3,3,94550,94550,94553,0,3,0
26929,1,3,94551,94553,94556,2,5,0
26930,5,3,94556,94556,94559,0,3,0
26931,1,2,94557,94559,94561,2,4,0
26932,3,1,94560,94561,94562,1,2,0
26933,1,2,94561,94562,94564,1,3,0
26934,4,2,94565,94565,94567,0,2,1
26935,1,1,94566,94567,94568,1,2,0
26936,3,3,94569,94569,94572,0,3,1
26937,2,2,94571,94572,94574,1,3,0
26938,1,2,94572,94574,94576,2,4,0
26939,4,3,94576,94576,94579,0,3,0
26940,6,3,94582,94582,94585,0,3,3
26941,3,2,94585,94585,94587,0,2,0
26942,3,2,94588,94588,94590,0,2,1
26943,3,1,94591,94591,94592,0,1,1
26944,5,1,94596,94596,94597,0,1,4
26945,1,1,94597,94597,94598,0,1,0
26946,6,2,94603,94603,94605,0,2,5
26947,2,2,94605,94605,94607,0,2,0
26948,4,2,94609,94609,94611,0,2,2
26949,1,3,94610,94611,94614,1,4,0
26950,1,2,94611,94614,94616,3,5,0
26951,4,3,94615,94616,94619,1,4,0
26952,1,2,94616,94619,94621,3,5,0
26953,4,1,94620,94621,94622,1,2,0
26954,6,3,94626,94626,94629,0,3,4
26955,2,2,94628,94629,94631,1,3,0
26956,5,1,94633,94633,94634,0,1,2
26957,3,3,94636,94636,94639,0,3,2
26958,3,1,94639,94639,94640,0,1,0
26959,4,3,94643,94643,94646,0,3,3
26960,3,2,94646,94646,94648,0,2,0
26961,2,3,94648,94648,94651,0,3,0
26962,3,1,94651,94651,94652,0,1,0
26963,1,3,94652,94652,94655,0,3,0
26964,4,1,94656,94656,94657,0,1,1
26965,5,2,94661,94661,94663,0,2,4
26966,5,1,94666,94666,94667,0,1,3
26967,5,3,94671,94671,94674,0,3,4
26968,6,1,94677,94677,94678,0,1,3
26969,3,2,94680,94680,94682,0,2,2
26970,6,1,94686,94686,94687,0,1,4
26971,1,2,94687,94687,94689,0,2,0
26972,2,3,94689,94689,94692,0,3,0
26973,6,3,94695,94695,94698,0,3,3
26974,4,1,94699,94699,94700,0,1,1
26975,5,2,94704,94704,94706,0,2,4
26976,3,2,94707,94707,94709,0,2,1
26977,3,1,94710,94710,94711,0,1,1
26978,2,2,94712,94712,94714,0,2,1
26979,4,1,94716,94716,94717,0,1,2
26980,1,3,94717,94717,94720,0,3,0
26981,6,2,94723,94723,94725,0,2,3
26982,5,2,94728,94728,94730,0,2,3
26983,3,1,94731,94731,94732,0,1,1
26984,5,1,94736,94736,94737,0,1,4
26985,1,1,94737,94737,94738,0,1,0
26986,3,1,94740,94740,94741,0,1,2
26987,5,2,94745,94745,94747,0,2,4
26988,2,2,94747,94747,94749,0,2,0
26989,2,2,94749,94749,94751,0,2,0
26990,2,2,94751,94751,94753,0,2,0
26991,3,1,94754,94754,94755,0,1,1
26992,3,1,94757,94757,94758,0,1,2
26993,4,3,94761,94761,94764,0,3,3
26994,5,3,94766,94766,94769,0,3,2
26995,5,2,94771,94771,94773,0,2,2
26996,6,1,94777,94777,94778,0,1,4
26997,1,1,94778,94778,94779,0,1,0
26998,2,2,94780,94780,94782,0,2,1
26999,6,1,94786,94786,94787,0,1,4
27000,3,2,94789,94789,94791,0,2,2
27001,2,2,94791,94791,94793,0,2,0
27002,2,2,94793,94793,94795,0,2,0
27003,1,2,94794,94795,94797,1,3,0
27004,6,2,94800,94800,94802,0,2,3
27005,2,2,94802,94802,94804,0,2,0
27006,5,2,94807,94807,94809,0,2,3
27007,2,3,94809,94809,94812,0,3,0
27008,1,3,94810,94812,94815,2,5,0
27009,1,2,94811,94815,94817,4,6,0
27010,1,1,94812,94817,94818,5,6,0
27011,5,1,94817,94818,94819,1,2,0
27012,6,3,94823,94823,94826,0,3,4
27013,1,2,94824,94826,94828,2,4,0
27014,5,1,94829,94829,94830,0,1,1
27015,4,1,94833,94833,94834,0,1,3
27016,6,1,94839,94839,94840,0,1,5
27017,4,3,94843,94843,94846,0,3,3
27018,5,3,94848,94848,94851,0,3,2
27019,4,3,94852,94852,94855,0,3,1
27020,2,3,94854,94855,94858,1,4,0
27021,1,3,94855,94858,94861,3,6,0
27022,2,2,94857,94861,94863,4,6,0
27023,4,1,94861,94863,94864,2,3,0
27024,1,1,94862,94864,94865,2,3,0
27025,5,2,94867,94867,94869,0,2,2
27026,6,3,94873,94873,94876,0,3,4
27027,4,2,94877,94877,94879,0,2,1
27028,4,1,94881,94881,94882,0,1,2
27029,3,1,94884,94884,94885,0,1,2
27030,2,2,94886,94886,94888,0,2,1
27031,1,3,94887,94888,94891,1,4,0
27032,5,2,94892,94892,94894,0,2,1
27033,2,3,94894,94894,94897,0,3,0
27034,1,1,94895,94897,94898,2,3,0
27035,4,2,94899,94899,94901,0,2,1
27036,1,1,94900,94901,94902,1,2,0
27037,6,1,94906,94906,94907,0,1,4
27038,4,3,94910,94910,94913,0,3,3
27039,6,2,94916,94916,94918,0,2,3
27040,1,3,94917,94918,94921,1,4,0
27041,4,1,94921,94921,94922,0,1,0
27042,6,3,94927,94927,94930,0,3,5
27043,4,3,94931,94931,94934,0,3,1
27044,1,2,94932,94934,94936,2,4,0
27045,4,3,94936,94936,94939,0,3,0
27046,3,2,94939,94939,94941,0,2,0
27047,4,3,94943,94943,94946,0,3,2
27048,3,2,94946,94946,94948,0,2,0
27049,4,1,94950,94950,94951,0,1,2
27050,6,3,94956,94956,94959,0,3,5
27051,6,2,94962,94962,94964,0,2,3
27052,2,1,94964,94964,94965,0,1,0
27053,5,3,94969,94969,94972,0,3,4
27054,5,2,94974,94974,94976,0,2,2
27055,4,3,94978,94978,94981,0,3,2
27056,4,1,94982,94982,94983,0,1,1
27057,4,2,94986,94986,94988,0,2,3
27058,6,3,94992,94992,94995,0,3,4
27059,1,1,94993,94995,94996,2,3,0
27060,6,3,94999,94999,95002,0,3,3
27061,5,2,95004,95004,95006,0,2,2
27062,6,1,95010,95010,95011,0,1,4
27063,2,2,95012,95012,95014,0,2,1
27064,5,3,95017,95017,95020,0,3,3
27065,5,1,95022,95022,95023,0,1,2
27066,1,3,95023,95023,95026,0,3,0
27067,6,2,95029,95029,95031,0,2,3
27068,5,3,95034,95034,95037,0,3,3
27069,3,2,95037,95037,95039,0,2,0
27070,5,1,95042,95042,95043,0,1,3
27071,6,2,95048,95048,95050,0,2,5
27072,2,3,95050,95050,95053,0,3,0
27073,2,3,95052,95053,95056,1,4,0
27074,4,2,95056,95056,95058,0,2,0
27075,3,3,95059,95059,95062,0,3,1
27076,3,3,95062,95062,95065,0,3,0
27077,1,3,95063,95065,95068,2,5,0
27078,6,2,95069,95069,95071,0,2,1
27079,3,1,95072,95072,95073,0,1,1
27080,2,1,95074,95074,95075,0,1,1
27081,2,3,95076,95076,95079,0,3,1
27082,4,2,95080,95080,95082,0,2,1
27083,1,3,95081,95082,95085,1,4,0
27084,5,2,95086,95086,95088,0,2,1
27085,2,2,95088,95088,95090,0,2,0
27086,6,2,95094,95094,95096,0,2,4
27087,6,3,95100,95100,95103,0,3,4
27088,1,1,95101,95103,95104,2,3,0
27089,6,1,95107,95107,95108,0,1,3
27090,5,1,95112,95112,95113,0,1,4
27091,5,2,95117,95117,95119,0,2,4
27092,6,1,95123,95123,95124,0,1,4
27093,1,2,95124,95124,95126,0,2,0
27094,2,1,95126,95126,95127,0,1,0
27095,4,2,95130,95130,95132,0,2,3
27096,2,3,95132,95132,95135,0,3,0
27097,4,1,95136,95136,95137,0,1,1
27098,4,3,95140,95140,95143,0,3,3
27099,5,2,95145,95145,95147,0,2,2
27100,4,2,95149,95149,95151,0,2,2
27101,4,2,95153,95153,95155,0,2,2
27102,4,1,95157,95157,95158,0,1,2
27103,1,2,95158,95158,95160,0,2,0
27104,1,2,95159,95160,95162,1,3,0
27105,3,3,95162,95162,95165,0,3,0
27106,4,1,95166,95166,95167,0,1,1
27107,2,1,95168,95168,95169,0,1,1
27108,5,1,95173,95173,95174,0,1,4
27109,6,3,95179,95179,95182,0,3,5
27110,3,1,95182,95182,95183,0,1,0
27111,2,3,95184,95184,95187,0,3,1
27112,6,2,95190,95190,95192,0,2,3
27113,5,2,95195,95195,95197,0,2,3
27114,4,2,95199,95199,95201,0,2,2
27115,1,3,95200,95201,95204,1,4,0
27116,4,2,95204,95204,95206,0,2,0
27117,3,3,95207,95207,95210,0,3,1
27118,4,1,95211,95211,95212,0,1,1
27119,1,2,95212,95212,95214,0,2,0
27120,1,1,95213,95214,95215,1,2,0
27121,4,1,95217,95217,95218,0,1,2
27122,1,1,95218,95218,95219,0,1,0
27123,1,2,95219,95219,95221,0,2,0
27124,2,1,95221,95221,95222,0,1,0
27125,2,1,95223,95223,95224,0,1,1
27126,2,1,95225,95225,95226,0,1,1
27127,4,3,95229,95229,95232,0,3,3
27128,2,1,95231,95232,95233,1,2,0
27129,1,1,95232,95233,95234,1,2,0
27130,6,3,95238,95238,95241,0,3,4
27131,2,3,95240,95241,95244,1,4,0
27132,2,1,95242,95244,95245,2,3,0
27133,2,1,95244,95245,95246,1,2,0
27134,4,1,95248,95248,95249,0,1,2
27135,5,2,95253,95253,95255,0,2,4
27136,5,1,95258,95258,95259,0,1,3
27137,2,1,95260,95260,95261,0,1,1
27138,5,3,95265,95265,95268,0,3,4
27139,1,2,95266,95268,95270,2,4,0
27140,6,2,95272,95272,95274,0,2,2
27141,2,1,95274,95274,95275,0,1,0
27142,5,3,95279,95279,95282,0,3,4
27143,4,2,95283,95283,95285,0,2,1
27144,2,2,95285,95285,95287,0,2,0
27145,1,2,95286,95287,95289,1,3,0
27146,1,1,95287,95289,95290,2,3,0
27147,3,2,95290,95290,95292,0,2,0
27148,6,3,95296,95296,95299,0,3,4
27149,3,3,95299,95299,95302,0,3,0
27150,6,3,95305,95305,95308,0,3,3
27151,4,2,95309,95309,95311,0,2,1
27152,3,3,95312,95312,95315,0,3,1
27153,5,3,95317,95317,95320,0,3,2
27154,2,1,95319,95320,95321,1,2,0
27155,1,3,95320,95321,95324,1,4,0
27156,5,1,95325,95325,95326,0,1,1
27157,6,2,95331,95331,95333,0,2,5
27158,5,1,95336,95336,95337,0,1,3
27159,1,1,95337,95337,95338,0,1,0
27160,2,2,95339,95339,95341,0,2,1
27161,4,3,95343,95343,95346,0,3,2
27162,1,1,95344,95346,95347,2,3,0
27163,2,1,95346,95347,95348,1,2,0
27164,3,1,95349,95349,95350,0,1,1
27165,3,3,95352,95352,95355,0,3,2
27166,3,1,95355,95355,95356,0,1,0
27167,3,3,95358,95358,95361,0,3,2
27168,5,1,95363,95363,95364,0,1,2
27169,2,3,95365,95365,95368,0,3,1
27170,4,2,95369,95369,95371,0,2,1
27171,6,2,95375,95375,95377,0,2,4
27172,4,2,95379,95379,95381,0,2,2
27173,3,3,95382,95382,95385,0,3,1
27174,1,1,95383,95385,95386,2,3,0
27175,1,1,95384,95386,95387,2,3,0
27176,2,3,95386,95387,95390,1,4,0
27177,3,2,95389,95390,95392,1,3,0
27178,1,3,95390,95392,95395,2,5,0
27179,2,3,95392,95395,95398,3,6,0
27180,2,2,95394,95398,95400,4,6,0
27181,4,2,95398,95400,95402,2,4,0
27182,1,2,95399,95402,95404,3,5,0
27183,4,2,95403,95404,95406,1,3,0
27184,5,1,95408,95408,95409,0,1,2
27185,2,2,95410,95410,95412,0,2,1
27186,5,3,95415,95415,95418,0,3,3
27187,5,1,95420,95420,95421,0,1,2
27188,1,1,95421,95421,95422,0,1,0
27189,1,1,95422,95422,95423,0,1,0
27190,1,1,95423,95423,95424,0,1,0
27191,5,1,95428,95428,95429,0,1,4
27192,4,1,95432,95432,95433,0,1,3
27193,3,1,95435,95435,95436,0,1,2
27194,1,3,95436,95436,95439,0,3,0
27195,3,1,95439,95439,95440,0,1,0
27196,1,2,95440,95440,95442,0,2,0
27197,2,2,95442,95442,95444,0,2,0
27198,6,2,95448,95448,95450,0,2,4
27199,4,2,95452,95452,95454,0,2,2
27200,1,2,95453,95454,95456,1,3,0
27201,6,3,95459,95459,95462,0,3,3
27202,2,2,95461,95462,95464,1,3,0
27203,5,1,95466,95466,95467,0,1,2
27204,3,1,95469,95469,95470,0,1,2
27205,1,3,95470,95470,95473,0,3,0
27206,3,3,95473,95473,95476,0,3,0
27207,1,3,95474,95476,95479,2,5,0
27208,2,2,95476,95479,95481,3,5,0
27209,4,2,95480,95481,95483,1,3,0
27210,6,1,95486,95486,95487,0,1,3
27211,2,3,95488,95488,95491,0,3,1
27212,6,2,95494,95494,95496,0,2,3
27213,3,2,95497,95497,95499,0,2,1
27214,1,2,95498,95499,95501,1,3,0
27215,1,2,95499,95501,95503,2,4,0
27216,5,3,95504,95504,95507,0,3,1
27217,5,1,95509,95509,95510,0,1,2
27218,2,3,95511,95511,95514,0,3,1
27219,2,2,95513,95514,95516,1,3,0
27220,2,1,95515,95516,95517,1,2,0
27221,3,3,95518,95518,95521,0,3,1
27222,4,1,95522,95522,95523,0,1,1
27223,3,2,95525,95525,95527,0,2,2
27224,6,1,95531,95531,95532,0,1,4
27225,4,3,95535,95535,95538,0,3,3
27226,2,1,95537,95538,95539,1,2,0
27227,2,1,95539,95539,95540,0,1,0
27228,4,3,95543,95543,95546,0,3,3
27229,1,1,95544,95546,95547,2,3,0
27230,5,1,95549,95549,95550,0,1,2
27231,4,2,95553,95553,95555,0,2,3
27232,1,1,95554,95555,95556,1,2,0
27233,6,1,95560,95560,95561,0,1,4
27234,2,3,95562,95562,95565,0,3,1
27235,2,2,95564,95565,95567,1,3,0
27236,4,3,95568,95568,95571,0,3,1
27237,1,1,95569,95571,95572,2,3,0
27238,2,2,95571,95572,95574,1,3,0
27239,4,2,95575,95575,95577,0,2,1
27240,2,2,95577,95577,95579,0,2,0
27241,1,1,95578,95579,95580,1,2,0
27242,3,3,95581,95581,95584,0,3,1
27243,5,1,95586,95586,95587,0,1,2
27244,4,3,95590,95590,95593,0,3,3
27245,3,2,95593,95593,95595,0,2,0
27246,4,1,95597,95597,95598,0,1,2
27247,4,2,95601,95601,95603,0,2,3
27248,2,2,95603,95603,95605,0,2,0
27249,6,1,95609,95609,95610,0,1,4
27250,3,2,95612,95612,95614,0,2,2
27251,4,1,95616,95616,95617,0,1,2
27252,5,3,95621,95621,95624,0,3,4
27253,1,2,95622,95624,95626,2,4,0
27254,6,2,95628,95628,95630,0,2,2
27255,2,2,95630,95630,95632,0,2,0
27256,6,1,95636,95636,95637,0,1,4
27257,5,3,95641,95641,95644,0,3,4
27258,3,2,95644,95644,95646,0,2,0
27259,4,3,95648,95648,95651,0,3,2
27260,2,3,95650,95651,95654,1,4,0
27261,4,1,95654,95654,95655,0,1,0
27262,1,2,95655,95655,95657,0,2,0
27263,4,3,95659,95659,95662,0,3,2
27264,6,1,95665,95665,95666,0,1,3
27265,4,2,95669,95669,95671,0,2,3
27266,2,2,95671,95671,95673,0,2,0
27267,3,1,95674,95674,95675,0,1,1
27268,4,1,95678,95678,95679,0,1,3
27269,2,1,95680,95680,95681,0,1,1
27270,2,3,95682,95682,95685,0,3,1
27271,5,3,95687,95687,95690,0,3,2
27272,1,3,95688,95690,95693,2,5,0
27273,1,2,95689,95693,95695,4,6,0
27274,6,1,95695,95695,95696,0,1,0
27275,3,3,95698,95698,95701,0,3,2
27276,3,2,95701,95701,95703,0,2,0
27277,6,1,95707,95707,95708,0,1,4
27278,2,1,95709,95709,95710,0,1,1
27279,6,1,95715,95715,95716,0,1,5
27280,1,2,95716,95716,95718,0,2,0
27281,3,2,95719,95719,95721,0,2,1
27282,5,2,95724,95724,95726,0,2,3
27283,5,1,95729,95729,95730,0,1,3
27284,4,3,95733,95733,95736,0,3,3
27285,5,3,95738,95738,95741,0,3,2
27286,6,2,95744,95744,95746,0,2,3
27287,3,1,95747,95747,95748,0,1,1
27288,4,3,95751,95751,95754,0,3,3
27289,3,1,95754,95754,95755,0,1,0
27290,6,1,95760,95760,95761,0,1,5
27291,5,2,95765,95765,95767,0,2,4
27292,3,2,95768,95768,95770,0,2,1
27293,5,3,95773,95773,95776,0,3,3
27294,1,3,95774,95776,95779,2,5,0
27295,1,2,95775,95779,95781,4,6,0
27296,5,1,95780,95781,95782,1,2,0
27297,3,2,95783,95783,95785,0,2,1
27298,3,2,95786,95786,95788,0,2,1
27299,1,1,95787,95788,95789,1,2,0
27300,6,1,95793,95793,95794,0,1,4
27301,4,2,95797,95797,95799,0,2,3
27302,2,2,95799,95799,95801,0,2,0
27303,1,3,95800,95801,95804,1,4,0
27304,5,2,95805,95805,95807,0,2,1
27305,2,3,95807,95807,95810,0,3,0
27306,1,3,95808,95810,95813,2,5,0
27307,5,3,95813,95813,95816,0,3,0
27308,4,3,95817,95817,95820,0,3,1
27309,5,1,95822,95822,95823,0,1,2
27310,1,2,95823,95823,95825,0,2,0
27311,3,3,95826,95826,95829,0,3,1
27312,5,3,95831,95831,95834,0,3,2
27313,2,2,95833,95834,95836,1,3,0
27314,3,3,95836,95836,95839,0,3,0
27315,4,1,95840,95840,95841,0,1,1
27316,5,3,95845,95845,95848,0,3,4
27317,5,2,95850,95850,95852,0,2,2
27318,5,3,95855,95855,95858,0,3,3
27319,5,1,95860,95860,95861,0,1,2
27320,2,1,95862,95862,95863,0,1,1
27321,4,2,95866,95866,95868,0,2,3
27322,4,2,95870,95870,95872,0,2,2
27323,5,2,95875,95875,95877,0,2,3
27324,2,2,95877,95877,95879,0,2,0
27325,4,3,95881,95881,95884,0,3,2
27326,1,1,95882,95884,95885,2,3,0
27327,4,2,95886,95886,95888,0,2,1
27328,4,3,95890,95890,95893,0,3,2
27329,3,3,95893,95893,95896,0,3,0
27330,2,2,95895,95896,95898,1,3,0
27331,1,3,95896,95898,95901,2,5,0
27332,3,2,95899,95901,95903,2,4,0
27333,3,2,95902,95903,95905,1,3,0
27334,1,2,95903,95905,95907,2,4,0
27335,1,2,95904,95907,95909,3,5,0
27336,6,2,95910,95910,95912,0,2,1
27337,5,1,95915,95915,95916,0,1,3
27338,6,3,95921,95921,95924,0,3,5
27339,5,3,95926,95926,95929,0,3,2
27340,6,1,95932,95932,95933,0,1,3
27341,1,3,95933,95933,95936,0,3,0
27342,4,1,95937,95937,95938,0,1,1
27343,4,2,95941,95941,95943,0,2,3
27344,5,1,95946,95946,95947,0,1,3
27345,2,3,95948,95948,95951,0,3,1
27346,2,2,95950,95951,95953,1,3,0
27347,6,3,95956,95956,95959,0,3,3
27348,6,1,95962,95962,95963,0,1,3
27349,6,3,95968,95968,95971,0,3,5
27350,5,3,95973,95973,95976,0,3,2
27351,6,2,95979,95979,95981,0,2,3
27352,1,2,95980,95981,95983,1,3,0
27353,4,2,95984,95984,95986,0,2,1
27354,5,2,95989,95989,95991,0,2,3
27355,6,1,95995,95995,95996,0,1,4
27356,2,1,95997,95997,95998,0,1,1
27357,4,1,96001,96001,96002,0,1,3
27358,3,2,96004,96004,96006,0,2,2
27359,1,1,96005,96006,96007,1,2,0
27360,3,3,96008,96008,96011,0,3,1
27361,1,2,96009,96011,96013,2,4,0
27362,1,1,96010,96013,96014,3,4,0
27363,5,1,96015,96015,96016,0,1,1
27364,5,2,96020,96020,96022,0,2,4
27365,1,2,96021,96022,96024,1,3,0
27366,1,3,96022,96024,96027,2,5,0
27367,4,1,96026,96027,96028,1,2,0
27368,1,3,96027,96028,96031,1,4,0
27369,5,2,96032,96032,96034,0,2,1
27370,4,2,96036,96036,96038,0,2,2
27371,1,2,96037,96038,96040,1,3,0
27372,1,1,96038,96040,96041,2,3,0
27373,2,1,96040,96041,96042,1,2,0
27374,4,1,96044,96044,96045,0,1,2
27375,4,2,96048,96048,96050,0,2,3
27376,6,1,96054,96054,96055,0,1,4
27377,1,1,96055,96055,96056,0,1,0
27378,4,1,96059,96059,96060,0,1,3
27379,2,1,96061,96061,96062,0,1,1
27380,3,1,96064,96064,96065,0,1,2
27381,5,1,96069,96069,96070,0,1,4
27382,6,2,96075,96075,96077,0,2,5
27383,5,1,96080,96080,96081,0,1,3
27384,1,1,96081,96081,96082,0,1,0
27385,1,2,96082,96082,96084,0,2,0
27386,6,1,96088,96088,96089,0,1,4
27387,2,3,96090,96090,96093,0,3,1
27388,2,2,96092,96093,96095,1,3,0
27389,2,1,96094,96095,96096,1,2,0
27390,6,3,96100,96100,96103,0,3,4
27391,1,2,96101,96103,96105,2,4,0
27392,4,1,96105,96105,96106,0,1,0
27393,6,2,96111,96111,96113,0,2,5
27394,4,1,96115,96115,96116,0,1,2
27395,4,2,96119,96119,96121,0,2,3
27396,2,2,96121,96121,96123,0,2,0
27397,4,3,96125,96125,96128,0,3,2
27398,6,3,96131,96131,96134,0,3,3
27399,4,3,96135,96135,96138,0,3,1
27400,3,2,96138,96138,96140,0,2,0
27401,5,1,96143,96143,96144,0,1,3
27402,2,3,96145,96145,96148,0,3,1
27403,4,3,96149,96149,96152,0,3,1
27404,6,3,96155,96155,96158,0,3,3
27405,6,1,96161,96161,96162,0,1,3
27406,2,2,96163,96163,96165,0,2,1
27407,6,3,96169,96169,96172,0,3,4
27408,5,2,96174,96174,96176,0,2,2
27409,1,3,96175,96176,96179,1,4,0
27410,6,1,96181,96181,96182,0,1,2
27411,3,3,96184,96184,96187,0,3,2
27412,3,3,96187,96187,96190,0,3,0
27413,5,2,96192,96192,96194,0,2,2
27414,3,2,96195,96195,96197,0,2,1
27415,5,2,96200,96200,96202,0,2,3
27416,2,3,96202,96202,96205,0,3,0
27417,5,2,96207,96207,96209,0,2,2
27418,5,1,96212,96212,96213,0,1,3
27419,1,3,96213,96213,96216,0,3,0
27420,1,3,96214,96216,96219,2,5,0
27421,6,1,96220,96220,96221,0,1,1
27422,5,1,96225,96225,96226,0,1,4
27423,2,2,96227,96227,96229,0,2,1
27424,2,1,96229,96229,96230,0,1,0
27425,5,1,96234,96234,96235,0,1,4
27426,2,3,96236,96236,96239,0,3,1
27427,3,3,96239,96239,96242,0,3,0
27428,5,2,96244,96244,96246,0,2,2
27429,3,1,96247,96247,96248,0,1,1
27430,6,3,96253,96253,96256,0,3,5
27431,4,3,96257,96257,96260,0,3,1
27432,5,3,96262,96262,96265,0,3,2
27433,6,3,96268,96268,96271,0,3,3
27434,6,3,96274,96274,96277,0,3,3
27435,5,2,96279,96279,96281,0,2,2
27436,2,2,96281,96281,96283,0,2,0
27437,4,1,96285,96285,96286,0,1,2
27438,1,2,96286,96286,96288,0,2,0
27439,4,3,96290,96290,96293,0,3,2
27440,3,1,96293,96293,96294,0,1,0
27441,4,1,96297,96297,96298,0,1,3
27442,1,2,96298,96298,96300,0,2,0
27443,1,2,96299,96300,96302,1,3,0
27444,5,3,96304,96304,96307,0,3,2
27445,3,1,96307,96307,96308,0,1,0
27446,6,2,96313,96313,96315,0,2,5
27447,1,1,96314,96315,96316,1,2,0
27448,1,1,96315,96316,96317,1,2,0
27449,5,3,96320,96320,96323,0,3,3
27450,1,2,96321,96323,96325,2,4,0
27451,4,3,96325,96325,96328,0,3,0
27452,4,3,96329,96329,96332,0,3,1
27453,4,2,96333,96333,96335,0,2,1
27454,2,2,96335,96335,96337,0,2,0
27455,3,2,96338,96338,96340,0,2,1
27456,6,1,96344,96344,96345,0,1,4
27457,4,2,96348,96348,96350,0,2,3
27458,4,3,96352,96352,96355,0,3,2
27459,3,1,96355,96355,96356,0,1,0
27460,2,1,96357,96357,96358,0,1,1
27461,5,3,96362,96362,96365,0,3,4
27462,6,3,96368,96368,96371,0,3,3
27463,2,2,96370,96371,96373,1,3,0
27464,3,2,96373,96373,96375,0,2,0
27465,5,2,96378,96378,96380,0,2,3
27466,4,1,96382,96382,96383,0,1,2
27467,5,2,96387,96387,96389,0,2,4
27468,6,2,96393,96393,96395,0,2,4
27469,4,1,96397,96397,96398,0,1,2
27470,6,3,96403,96403,96406,0,3,5
27471,1,3,96404,96406,96409,2,5,0
27472,2,2,96406,96409,96411,3,5,0
27473,1,3,96407,96411,96414,4,7,0
27474,2,2,96409,96414,96416,5,7,0
27475,3,3,96412,96416,96419,4,7,0
27476,6,3,96418,96419,96422,1,4,0
27477,4,1,96422,96422,96423,0,1,0
27478,2,2,96424,96424,96426,0,2,1
27479,3,2,96427,96427,96429,0,2,1
27480,6,2,96433,96433,96435,0,2,4
27481,1,3,96434,96435,96438,1,4,0
27482,6,1,96440,96440,96441,0,1,2
27483,5,1,96445,96445,96446,0,1,4
27484,5,1,96450,96450,96451,0,1,4
27485,2,3,96452,96452,96455,0,3,1
27486,5,3,96457,96457,96460,0,3,2
27487,3,3,96460,96460,96463,0,3,0
27488,5,3,96465,96465,96468,0,3,2
27489,2,3,96467,96468,96471,1,4,0
27490,2,1,96469,96471,96472,2,3,0
27491,6,2,96475,96475,96477,0,2,3
27492,1,2,96476,96477,96479,1,3,0
27493,6,1,96482,96482,96483,0,1,3
27494,6,1,96488,96488,96489,0,1,5
27495,2,2,96490,96490,96492,0,2,1
27496,5,3,96495,96495,96498,0,3,3
27497,3,1,96498,96498,96499,0,1,0
27498,2,2,96500,96500,96502,0,2,1
27499,1,3,96501,96502,96505,1,4,0
27500,3,3,96504,96505,96508,1,4,0
27501,4,1,96508,96508,96509,0,1,0
27502,6,2,96514,96514,96516,0,2,5
27503,1,1,96515,96516,96517,1,2,0
27504,5,2,96520,96520,96522,0,2,3
27505,2,1,96522,96522,96523,0,1,0
27506,4,2,96526,96526,96528,0,2,3
27507,2,1,96528,96528,96529,0,1,0
27508,4,2,96532,96532,96534,0,2,3
27509,2,3,96534,96534,96537,0,3,0
27510,3,2,96537,96537,96539,0,2,0
27511,1,2,96538,96539,96541,1,3,0
27512,5,3,96543,96543,96546,0,3,2
27513,2,3,96545,96546,96549,1,4,0
27514,2,3,96547,96549,96552,2,5,0
27515,3,2,96550,96552,96554,2,4,0
27516,1,2,96551,96554,96556,3,5,0
27517,6,2,96557,96557,96559,0,2,1
27518,4,2,96561,96561,96563,0,2,2
27519,6,2,96567,96567,96569,0,2,4
27520,1,1,96568,96569,96570,1,2,0
27521,1,3,96569,96570,96573,1,4,0
27522,3,3,96572,96573,96576,1,4,0
27523,6,3,96578,96578,96581,0,3,2
27524,4,1,96582,96582,96583,0,1,1
27525,5,1,96587,96587,96588,0,1,4
27526,6,2,96593,96593,96595,0,2,5
27527,6,3,96599,96599,96602,0,3,4
27528,2,3,96601,96602,96605,1,4,0
27529,4,2,96605,96605,96607,0,2,0
27530,3,3,96608,96608,96611,0,3,1
27531,1,3,96609,96611,96614,2,5,0
27532,2,1,96611,96614,96615,3,4,0
27533,6,2,96617,96617,96619,0,2,2
27534,2,1,96619,96619,96620,0,1,0
27535,3,2,96622,96622,96624,0,2,2
27536,5,1,96627,96627,96628,0,1,3
27537,4,1,96631,96631,96632,0,1,3
27538,1,2,96632,96632,96634,0,2,0
27539,4,3,96636,96636,96639,0,3,2
27540,4,2,96640,96640,96642,0,2,1
27541,3,3,96643,96643,96646,0,3,1
27542,6,3,96649,96649,96652,0,3,3
27543,4,2,96653,96653,96655,0,2,1
27544,6,2,96659,96659,96661,0,2,4
27545,2,2,96661,96661,96663,0,2,0
27546,6,2,96667,96667,96669,0,2,4
27547,3,3,96670,96670,96673,0,3,1
27548,5,3,96675,96675,96678,0,3,2
27549,6,1,96681,96681,96682,0,1,3
27550,1,3,96682,96682,96685,0,3,0
27551,3,2,96685,96685,96687,0,2,0
27552,3,1,96688,96688,96689,0,1,1
27553,5,3,96693,96693,96696,0,3,4
27554,4,1,96697,96697,96698,0,1,1
27555,5,3,96702,96702,96705,0,3,4
27556,1,2,96703,96705,96707,2,4,0
27557,6,1,96709,96709,96710,0,1,2
27558,6,3,96715,96715,96718,0,3,5
27559,1,1,96716,96718,96719,2,3,0
27560,4,2,96720,96720,96722,0,2,1
27561,4,2,96724,96724,96726,0,2,2
27562,6,2,96730,96730,96732,0,2,4
27563,4,2,96734,96734,96736,0,2,2
27564,6,3,96740,96740,96743,0,3,4
27565,2,1,96742,96743,96744,1,2,0
27566,6,2,96748,96748,96750,0,2,4
27567,1,1,96749,96750,96751,1,2,0
27568,2,3,96751,96751,96754,0,3,0
27569,1,1,96752,96754,96755,2,3,0
27570,3,2,96755,96755,96757,0,2,0
27571,4,2,96759,96759,96761,0,2,2
27572,6,3,96765,96765,96768,0,3,4
27573,1,1,96766,96768,96769,2,3,0
27574,6,1,96772,96772,96773,0,1,3
27575,1,2,96773,96773,96775,0,2,0
27576,5,3,96778,96778,96781,0,3,3
27577,2,3,96780,96781,96784,1,4,0
27578,4,1,96784,96784,96785,0,1,0
27579,1,3,96785,96785,96788,0,3,0
27580,5,3,96790,96790,96793,0,3,2
27581,4,3,96794,96794,96797,0,3,1
27582,6,2,96800,96800,96802,0,2,3
27583,4,3,96804,96804,96807,0,3,2
27584,5,1,96809,96809,96810,0,1,2
27585,4,1,96813,96813,96814,0,1,3
27586,3,2,96816,96816,96818,0,2,2
27587,5,1,96821,96821,96822,0,1,3
27588,3,1,96824,96824,96825,0,1,2
27589,3,3,96827,96827,96830,0,3,2
27590,6,3,96833,96833,96836,0,3,3
27591,1,3,96834,96836,96839,2,5,0
27592,6,2,96840,96840,96842,0,2,1
27593,1,1,96841,96842,96843,1,2,0
27594,6,3,96847,96847,96850,0,3,4
27595,6,3,96853,96853,96856,0,3,3
27596,4,1,96857,96857,96858,0,1,1
27597,3,1,96860,96860,96861,0,1,2
27598,1,1,96861,96861,96862,0,1,0
27599,5,3,96866,96866,96869,0,3,4
27600,3,3,96869,96869,96872,0,3,0
27601,4,2,96873,96873,96875,0,2,1
27602,6,1,96879,96879,96880,0,1,4
27603,3,2,96882,96882,96884,0,2,2
27604,4,3,96886,96886,96889,0,3,2
27605,3,1,96889,96889,96890,0,1,0
27606,5,2,96894,96894,96896,0,2,4
27607,6,1,96900,96900,96901,0,1,4
27608,3,2,96903,96903,96905,0,2,2
27609,4,1,96907,96907,96908,0,1,2
27610,4,1,96911,96911,96912,0,1,3
27611,3,3,96914,96914,96917,0,3,2
27612,1,3,96915,96917,96920,2,5,0
27613,2,2,96917,96920,96922,3,5,0
27614,2,3,96919,96922,96925,3,6,0
27615,5,2,96924,96925,96927,1,3,0
27616,1,1,96925,96927,96928,2,3,0
27617,2,1,96927,96928,96929,1,2,0
27618,3,3,96930,96930,96933,0,3,1
27619,3,3,96933,96933,96936,0,3,0
27620,1,1,96934,96936,96937,2,3,0
27621,1,1,96935,96937,96938,2,3,0
27622,1,1,96936,96938,96939,2,3,0
27623,3,2,96939,96939,96941,0,2,0
27624,2,3,96941,96941,96944,0,3,0
27625,4,2,96945,96945,96947,0,2,1
27626,5,1,96950,96950,96951,0,1,3
27627,2,3,96952,96952,96955,0,3,1
27628,6,3,96958,96958,96961,0,3,3
27629,1,1,96959,96961,96962,2,3,0
27630,1,3,96960,96962,96965,2,5,0
27631,3,3,96963,96965,96968,2,5,0
27632,1,3,96964,96968,96971,4,7,0
27633,4,2,96968,96971,96973,3,5,0
27634,2,2,96970,96973,96975,3,5,0
27635,6,3,96976,96976,96979,0,3,1
27636,4,2,96980,96980,96982,0,2,1
27637,1,3,96981,96982,96985,1,4,0
27638,5,2,96986,96986,96988,0,2,1
27639,3,3,96989,96989,96992,0,3,1
27640,6,2,96995,96995,96997,0,2,3
27641,3,3,96998,96998,97001,0,3,1
27642,2,2,97000,97001,97003,1,3,0
27643,5,1,97005,97005,97006,0,1,2
27644,4,3,97009,97009,97012,0,3,3
27645,2,1,97011,97012,97013,1,2,0
27646,2,3,97013,97013,97016,0,3,0
27647,4,2,97017,97017,97019,0,2,1
27648,2,2,97019,97019,97021,0,2,0
27649,1,1,97020,97021,97022,1,2,0
27650,6,2,97026,97026,97028,0,2,4
27651,3,1,97029,97029,97030,0,1,1
27652,2,1,97031,97031,97032,0,1,1
27653,1,1,97032,97032,97033,0,1,0
27654,1,2,97033,97033,97035,0,2,0
27655,2,2,97035,97035,97037,0,2,0
27656,6,1,97041,97041,97042,0,1,4
27657,1,3,97042,97042,97045,0,3,0
27658,2,2,97044,97045,97047,1,3,0
27659,3,1,97047,97047,97048,0,1,0
27660,4,2,97051,97051,97053,0,2,3
27661,4,1,97055,97055,97056,0,1,2
27662,4,1,97059,97059,97060,0,1,3
27663,3,2,97062,97062,97064,0,2,2
27664,4,3,97066,97066,97069,0,3,2
27665,3,1,97069,97069,97070,0,1,0
27666,3,3,97072,97072,97075,0,3,2
27667,5,2,97077,97077,97079,0,2,2
27668,5,2,97082,97082,97084,0,2,3
27669,4,2,97086,97086,97088,0,2,2
27670,4,3,97090,97090,97093,0,3,2
27671,1,1,97091,97093,97094,2,3,0
27672,6,1,97097,97097,97098,0,1,3
27673,1,3,97098,97098,97101,0,3,0
27674,2,1,97100,97101,97102,1,2,0
27675,5,2,97105,97105,97107,0,2,3
27676,4,3,97109,97109,97112,0,3,2
27677,3,2,97112,97112,97114,0,2,0
27678,5,3,97117,97117,97120,0,3,3
27679,6,3,97123,97123,97126,0,3,3
27680,1,3,97124,97126,97129,2,5,0
27681,6,2,97130,97130,97132,0,2,1
27682,3,1,97133,97133,97134,0,1,1
27683,3,2,97136,97136,97138,0,2,2
27684,6,3,97142,97142,97145,0,3,4
27685,2,2,97144,97145,97147,1,3,0
27686,3,2,97147,97147,97149,0,2,0
27687,4,1,97151,97151,97152,0,1,2
27688,4,2,97155,97155,97157,0,2,3
27689,3,3,97158,97158,97161,0,3,1
27690,2,1,97160,97161,97162,1,2,0
27691,2,2,97162,97162,97164,0,2,0
27692,5,1,97167,97167,97168,0,1,3
27693,6,2,97173,97173,97175,0,2,5
27694,6,1,97179,97179,97180,0,1,4
27695,6,1,97185,97185,97186,0,1,5
27696,3,2,97188,97188,97190,0,2,2
27697,1,1,97189,97190,97191,1,2,0
27698,2,2,97191,97191,97193,0,2,0
27699,2,1,97193,97193,97194,0,1,0
27700,4,3,97197,97197,97200,0,3,3
27701,4,2,97201,97201,97203,0,2,1
27702,3,2,97204,97204,97206,0,2,1
27703,3,2,97207,97207,97209,0,2,1
27704,1,1,97208,97209,97210,1,2,0
27705,1,1,97209,97210,97211,1,2,0
27706,3,3,97212,97212,97215,0,3,1
27707,1,1,97213,97215,97216,2,3,0
27708,5,3,97218,97218,97221,0,3,2
27709,6,2,97224,97224,97226,0,2,3
27710,5,3,97229,97229,97232,0,3,3
27711,2,2,97231,97232,97234,1,3,0
27712,6,3,97237,97237,97240,0,3,3
27713,4,3,97241,97241,97244,0,3,1
27714,2,1,97243,97244,97245,1,2,0
27715,3,1,97246,97246,97247,0,1,1
27716,3,2,97249,97249,97251,0,2,2
27717,1,2,97250,97251,97253,1,3,0
27718,5,3,97255,97255,97258,0,3,2
27719,3,3,97258,97258,97261,0,3,0
27720,3,2,97261,97261,97263,0,2,0
27721,2,2,97263,97263,97265,0,2,0
27722,5,1,97268,97268,97269,0,1,3
27723,4,3,97272,97272,97275,0,3,3
27724,1,3,97273,97275,97278,2,5,0
27725,4,1,97277,97278,97279,1,2,0
27726,5,1,97282,97282,97283,0,1,3
27727,3,3,97285,97285,97288,0,3,2
27728,5,3,97290,97290,97293,0,3,2
27729,4,1,97294,97294,97295,0,1,1
27730,4,2,97298,97298,97300,0,2,3
27731,2,1,97300,97300,97301,0,1,0
27732,1,1,97301,97301,97302,0,1,0
27733,4,1,97305,97305,97306,0,1,3
27734,5,2,97310,97310,97312,0,2,4
27735,5,2,97315,97315,97317,0,2,3
27736,6,2,97321,97321,97323,0,2,4
27737,5,1,97326,97326,97327,0,1,3
27738,2,3,97328,97328,97331,0,3,1
27739,4,2,97332,97332,97334,0,2,1
27740,1,1,97333,97334,97335,1,2,0
27741,4,2,97337,97337,97339,0,2,2
27742,5,1,97342,97342,97343,0,1,3
27743,2,3,97344,97344,97347,0,3,1
27744,3,1,97347,97347,97348,0,1,0
27745,1,1,97348,97348,97349,0,1,0
27746,5,3,97353,97353,97356,0,3,4
27747,1,3,97354,97356,97359,2,5,0
27748,2,2,97356,97359,97361,3,5,0
27749,5,3,97361,97361,97364,0,3,0
27750,5,2,97366,97366,97368,0,2,2
27751,2,3,97368,97368,97371,0,3,0
27752,4,2,97372,97372,97374,0,2,1
27753,6,2,97378,97378,97380,0,2,4
27754,3,3,97381,97381,97384,0,3,1
27755,1,1,97382,97384,97385,2,3,0
27756,3,2,97385,97385,97387,0,2,0
27757,6,2,97391,97391,97393,0,2,4
27758,5,3,97396,97396,97399,0,3,3
27759,5,1,97401,97401,97402,0,1,2
27760,6,3,97407,97407,97410,0,3,5
27761,1,3,97408,97410,97413,2,5,0
27762,6,2,97414,97414,97416,0,2,1
27763,6,1,97420,97420,97421,0,1,4
27764,5,3,97425,97425,97428,0,3,4
27765,4,2,97429,97429,97431,0,2,1
27766,2,3,97431,97431,97434,0,3,0
27767,3,1,97434,97434,97435,0,1,0
27768,6,2,97440,97440,97442,0,2,5
27769,4,1,97444,97444,97445,0,1,2
27770,2,1,97446,97446,97447,0,1,1
27771,1,1,97447,97447,97448,0,1,0
27772,2,1,97449,97449,97450,0,1,1
27773,2,2,97451,97451,97453,0,2,1
27774,5,2,97456,97456,97458,0,2,3
27775,2,2,97458,97458,97460,0,2,0
27776,3,1,97461,97461,97462,0,1,1
27777,5,1,97466,97466,97467,0,1,4
27778,2,2,97468,97468,97470,0,2,1
27779,4,2,97472,97472,97474,0,2,2
27780,5,3,97477,97477,97480,0,3,3
27781,1,2,97478,97480,97482,2,4,0
27782,2,1,97480,97482,97483,2,3,0
27783,4,2,97484,97484,97486,0,2,1
27784,2,2,97486,97486,97488,0,2,0
27785,5,2,97491,97491,97493,0,2,3
27786,3,1,97494,97494,97495,0,1,1
27787,5,3,97499,97499,97502,0,3,4
27788,3,2,97502,97502,97504,0,2,0
27789,3,2,97505,97505,97507,0,2,1
27790,3,3,97508,97508,97511,0,3,1
27791,3,3,97511,97511,97514,0,3,0
27792,2,3,97513,97514,97517,1,4,0
27793,1,2,97514,97517,97519,3,5,0
27794,2,1,97516,97519,97520,3,4,0
27795,2,1,97518,97520,97521,2,3,0
27796,5,1,97523,97523,97524,0,1,2
27797,4,1,97527,97527,97528,0,1,3
27798,5,3,97532,97532,97535,0,3,4
27799,2,1,97534,97535,97536,1,2,0
27800,1,3,97535,97536,97539,1,4,0
27801,5,1,97540,97540,97541,0,1,1
27802,3,3,97543,97543,97546,0,3,2
27803,4,1,97547,97547,97548,0,1,1
27804,2,1,97549,97549,97550,0,1,1
27805,2,3,97551,97551,97554,0,3,1
27806,3,1,97554,97554,97555,0,1,0
27807,2,1,97556,97556,97557,0,1,1
27808,4,3,97560,97560,97563,0,3,3
27809,1,1,97561,97563,97564,2,3,0
27810,5,3,97566,97566,97569,0,3,2
27811,5,3,97571,97571,97574,0,3,2
27812,4,1,97575,97575,97576,0,1,1
27813,1,1,97576,97576,97577,0,1,0
27814,4,3,97580,97580,97583,0,3,3
27815,2,1,97582,97583,97584,1,2,0
27816,2,1,97584,97584,97585,0,1,0
27817,4,3,97588,97588,97591,0,3,3
27818,2,1,97590,97591,97592,1,2,0
27819,6,3,97596,97596,97599,0,3,4
27820,4,2,97600,97600,97602,0,2,1
27821,4,2,97604,97604,97606,0,2,2
27822,6,2,97610,97610,97612,0,2,4
27823,1,2,97611,97612,97614,1,3,0
27824,5,3,97616,97616,97619,0,3,2
27825,3,3,97619,97619,97622,0,3,0
27826,4,3,97623,97623,97626,0,3,1
27827,5,2,97628,97628,97630,0,2,2
27828,1,3,97629,97630,97633,1,4,0
27829,2,2,97631,97633,97635,2,4,0
27830,3,3,97634,97635,97638,1,4,0
27831,5,1,97639,97639,97640,0,1,1
27832,2,3,97641,97641,97644,0,3,1
27833,1,2,97642,97644,97646,2,4,0
27834,3,1,97645,97646,97647,1,2,0
27835,4,2,97649,97649,97651,0,2,2
27836,6,3,97655,97655,97658,0,3,4
27837,2,2,97657,97658,97660,1,3,0
27838,1,2,97658,97660,97662,2,4,0
27839,1,2,97659,97662,97664,3,5,0
27840,1,3,97660,97664,97667,4,7,0
27841,1,1,97661,97667,97668,6,7,0
27842,3,2,97664,97668,97670,4,6,0
27843,1,1,97665,97670,97671,5,6,0
27844,2,2,97667,97671,97673,4,6,0
27845,5,1,97672,97673,97674,1,2,0
27846,6,2,97678,97678,97680,0,2,4
27847,5,3,97683,97683,97686,0,3,3
27848,4,3,97687,97687,97690,0,3,1
27849,2,1,97689,97690,97691,1,2,0
27850,3,3,97692,97692,97695,0,3,1
27851,6,3,97698,97698,97701,0,3,3
27852,3,3,97701,97701,97704,0,3,0
27853,3,3,97704,97704,97707,0,3,0
27854,2,1,97706,97707,97708,1,2,0
27855,3,2,97709,97709,97711,0,2,1
27856,3,3,97712,97712,97715,0,3,1
27857,4,2,97716,97716,97718,0,2,1
27858,1,2,97717,97718,97720,1,3,0
27859,5,3,97722,97722,97725,0,3,2
27860,6,1,97728,97728,97729,0,1,3
27861,6,2,97734,97734,97736,0,2,5
27862,4,2,97738,97738,97740,0,2,2
27863,2,2,97740,97740,97742,0,2,0
27864,1,3,97741,97742,97745,1,4,0
27865,4,1,97745,97745,97746,0,1,0
27866,4,3,97749,97749,97752,0,3,3
27867,1,1,97750,97752,97753,2,3,0
27868,2,2,97752,97753,97755,1,3,0
27869,6,2,97758,97758,97760,0,2,3
27870,5,3,97763,97763,97766,0,3,3
27871,2,1,97765,97766,97767,1,2,0
27872,4,1,97769,97769,97770,0,1,2
27873,1,2,97770,97770,97772,0,2,0
27874,2,3,97772,97772,97775,0,3,0
27875,1,3,97773,97775,97778,2,5,0
27876,1,3,97774,97778,97781,4,7,0
27877,4,1,97778,97781,97782,3,4,0
27878,1,2,97779,97782,97784,3,5,0
27879,1,2,97780,97784,97786,4,6,0
27880,1,2,97781,97786,97788,5,7,0
27881,2,1,97783,97788,97789,5,6,0
27882,6,1,97789,97789,97790,0,1,0
27883,6,2,97795,97795,97797,0,2,5
27884,5,1,97800,97800,97801,0,1,3
27885,5,1,97805,97805,97806,0,1,4
27886,2,1,97807,97807,97808,0,1,1
27887,6,1,97813,97813,97814,0,1,5
27888,1,2,97814,97814,97816,0,2,0
27889,4,3,97818,97818,97821,0,3,2
27890,2,3,97820,97821,97824,1,4,0
27891,5,2,97825,97825,97827,0,2,1
27892,3,1,97828,97828,97829,0,1,1
27893,4,3,97832,97832,97835,0,3,3
27894,1,2,97833,97835,97837,2,4,0
27895,6,2,97839,97839,97841,0,2,2
27896,2,3,97841,97841,97844,0,3,0
27897,4,2,97845,97845,97847,0,2,1
27898,3,2,97848,97848,97850,0,2,1
27899,5,3,97853,97853,97856,0,3,3
27900,2,3,97855,97856,97859,1,4,0
27901,6,1,97861,97861,97862,0,1,2
27902,6,1,97867,97867,97868,0,1,5
27903,6,3,97873,97873,97876,0,3,5
27904,4,2,97877,97877,97879,0,2,1
27905,3,1,97880,97880,97881,0,1,1
27906,1,1,97881,97881,97882,0,1,0
27907,6,2,97887,97887,97889,0,2,5
27908,3,3,97890,97890,97893,0,3,1
27909,1,3,97891,97893,97896,2,5,0
27910,2,1,97893,97896,97897,3,4,0
27911,1,1,97894,97897,97898,3,4,0
27912,4,2,97898,97898,97900,0,2,0
27913,6,3,97904,97904,97907,0,3,4
27914,6,3,97910,97910,97913,0,3,3
27915,1,2,97911,97913,97915,2,4,0
27916,4,3,97915,97915,97918,0,3,0
27917,3,1,97918,97918,97919,0,1,0
27918,1,3,97919,97919,97922,0,3,0
27919,4,3,97923,97923,97926,0,3,1
27920,1,1,97924,97926,97927,2,3,0
27921,3,2,97927,97927,97929,0,2,0
27922,3,1,97930,97930,97931,0,1,1
27923,4,1,97934,97934,97935,0,1,3
27924,4,2,97938,97938,97940,0,2,3
27925,1,2,97939,97940,97942,1,3,0
27926,6,3,97945,97945,97948,0,3,3
27927,2,1,97947,97948,97949,1,2,0
27928,4,2,97951,97951,97953,0,2,2
27929,3,3,97954,97954,97957,0,3,1
27930,4,3,97958,97958,97961,0,3,1
27931,3,2,97961,97961,97963,0,2,0
27932,5,2,97966,97966,97968,0,2,3
27933,3,3,97969,97969,97972,0,3,1
27934,6,2,97975,97975,97977,0,2,3
27935,6,1,97981,97981,97982,0,1,4
27936,1,1,97982,97982,97983,0,1,0
27937,5,2,97987,97987,97989,0,2,4
27938,1,3,97988,97989,97992,1,4,0
27939,6,1,97994,97994,97995,0,1,2
27940,5,3,97999,97999,98002,0,3,4
27941,1,1,98000,98002,98003,2,3,0
27942,4,1,98004,98004,98005,0,1,1
27943,4,3,98008,98008,98011,0,3,3
27944,1,3,98009,98011,98014,2,5,0
27945,5,1,98014,98014,98015,0,1,0
27946,4,2,98018,98018,98020,0,2,3
27947,4,3,98022,98022,98025,0,3,2
27948,6,1,98028,98028,98029,0,1,3
27949,2,1,98030,98030,98031,0,1,1
27950,5,1,98035,98035,98036,0,1,4
27951,4,1,98039,98039,98040,0,1,3
27952,1,2,98040,98040,98042,0,2,0
27953,2,3,98042,98042,98045,0,3,0
27954,1,3,98043,98045,98048,2,5,0
27955,1,2,98044,98048,98050,4,6,0
27956,2,1,98046,98050,98051,4,5,0
27957,1,3,98047,98051,98054,4,7,0
27958,2,1,98049,98054,98055,5,6,0
27959,1,1,98050,98055,98056,5,6,0
27960,4,2,98054,98056,98058,2,4,0
27961,4,3,98058,98058,98061,0,3,0
27962,1,2,98059,98061,98063,2,4,0
27963,1,3,98060,98063,98066,3,6,0
27964,2,1,98062,98066,98067,4,5,0
27965,6,2,98068,98068,98070,0,2,1
27966,2,1,98070,98070,98071,0,1,0
27967,3,1,98073,98073,98074,0,1,2
27968,2,3,98075,98075,98078,0,3,1
27969,6,3,98081,98081,98084,0,3,3
27970,3,1,98084,98084,98085,0,1,0
27971,1,2,98085,98085,98087,0,2,0
27972,2,3,98087,98087,98090,0,3,0
27973,2,3,98089,98090,98093,1,4,0
27974,4,3,98093,98093,98096,0,3,0
27975,2,2,98095,98096,98098,1,3,0
27976,4,2,98099,98099,98101,0,2,1
27977,2,2,98101,98101,98103,0,2,0
27978,6,1,98107,98107,98108,0,1,4
27979,3,1,98110,98110,98111,0,1,2
27980,3,2,98113,98113,98115,0,2,2
27981,6,3,98119,98119,98122,0,3,4
27982,6,2,98125,98125,98127,0,2,3
27983,3,3,98128,98128,98131,0,3,1
27984,4,2,98132,98132,98134,0,2,1
27985,5,3,98137,98137,98140,0,3,3
27986,6,2,98143,98143,98145,0,2,3
27987,1,2,98144,98145,98147,1,3,0
27988,2,3,98146,98147,98150,1,4,0
27989,2,1,98148,98150,98151,2,3,0
27990,3,1,98151,98151,98152,0,1,0
27991,4,3,98155,98155,98158,0,3,3
27992,1,2,98156,98158,98160,2,4,0
27993,3,2,98159,98160,98162,1,3,0
27994,2,3,98161,98162,98165,1,4,0
27995,5,2,98166,98166,98168,0,2,1
27996,1,1,98167,98168,98169,1,2,0
27997,3,2,98170,98170,98172,0,2,1
27998,3,3,98173,98173,98176,0,3,1
27999,6,3,98179,98179,98182,0,3,3
28000,4,3,98183,98183,98186,0,3,1
28001,3,1,98186,98186,98187,0,1,0
28002,6,3,98192,98192,98195,0,3,5
28003,5,2,98197,98197,98199,0,2,2
28004,6,2,98203,98203,98205,0,2,4
28005,3,1,98206,98206,98207,0,1,1
28006,4,2,98210,98210,98212,0,2,3
28007,1,2,98211,98212,98214,1,3,0
28008,1,2,98212,98214,98216,2,4,0
28009,5,1,98217,98217,98218,0,1,1
28010,1,1,98218,98218,98219,0,1,0
28011,2,2,98220,98220,98222,0,2,1
28012,1,3,98221,98222,98225,1,4,0
28013,3,3,98224,98225,98228,1,4,0
28014,6,1,98230,98230,98231,0,1,2
28015,2,2,98232,98232,98234,0,2,1
28016,6,1,98238,98238,98239,0,1,4
28017,4,3,98242,98242,98245,0,3,3
28018,6,1,98248,98248,98249,0,1,3
28019,6,3,98254,98254,98257,0,3,5
28020,4,3,98258,98258,98261,0,3,1
28021,3,2,98261,98261,98263,0,2,0
28022,6,1,98267,98267,98268,0,1,4
28023,6,1,98273,98273,98274,0,1,5
28024,3,3,98276,98276,98279,0,3,2
28025,2,2,98278,98279,98281,1,3,0
28026,6,2,98284,98284,98286,0,2,3
28027,2,1,98286,98286,98287,0,1,0
28028,1,2,98287,98287,98289,0,2,0
28029,4,2,98291,98291,98293,0,2,2
28030,1,1,98292,98293,98294,1,2,0
28031,3,2,98295,98295,98297,0,2,1
28032,1,1,98296,98297,98298,1,2,0
28033,1,3,98297,98298,98301,1,4,0
28034,5,1,98302,98302,98303,0,1,1
28035,2,2,98304,98304,98306,0,2,1
28036,5,1,98309,98309,98310,0,1,3
28037,1,2,98310,98310,98312,0,2,0
28038,5,2,98315,98315,98317,0,2,3
28039,3,2,98318,98318,98320,0,2,1
28040,2,3,98320,98320,98323,0,3,0
28041,1,1,98321,98323,98324,2,3,0
28042,4,3,98325,98325,98328,0,3,1
28043,1,2,98326,98328,98330,2,4,0
28044,6,1,98332,98332,98333,0,1,2
28045,4,1,98336,98336,98337,0,1,3
28046,1,2,98337,98337,98339,0,2,0
28047,1,1,98338,98339,98340,1,2,0
28048,3,2,98341,98341,98343,0,2,1
28049,4,3,98345,98345,98348,0,3,2
28050,3,2,98348,98348,98350,0,2,0
28051,1,2,98349,98350,98352,1,3,0
28052,4,3,98353,98353,98356,0,3,1
28053,5,2,98358,98358,98360,0,2,2
28054,4,2,98362,98362,98364,0,2,2
28055,2,3,98364,98364,98367,0,3,0
28056,5,3,98369,98369,98372,0,3,2
28057,1,3,98370,98372,98375,2,5,0
28058,3,1,98373,98375,98376,2,3,0
28059,5,3,98378,98378,98381,0,3,2
28060,3,3,98381,98381,98384,0,3,0
28061,3,1,98384,98384,98385,0,1,0
28062,5,1,98389,98389,98390,0,1,4
28063,5,1,98394,98394,98395,0,1,4
28064,4,3,98398,98398,98401,0,3,3
28065,5,2,98403,98403,98405,0,2,2
28066,2,3,98405,98405,98408,0,3,0
28067,6,1,98411,98411,98412,0,1,3
28068,6,2,98417,98417,98419,0,2,5
28069,5,2,98422,98422,98424,0,2,3
28070,1,1,98423,98424,98425,1,2,0
28071,1,1,98424,98425,98426,1,2,0
28072,1,2,98425,98426,98428,1,3,0
28073,2,3,98427,98428,98431,1,4,0
28074,4,2,98431,98431,98433,0,2,0
28075,3,3,98434,98434,98437,0,3,1
28076,3,3,98437,98437,98440,0,3,0
28077,4,2,98441,98441,98443,0,2,1
28078,1,2,98442,98443,98445,1,3,0
28079,3,3,98445,98445,98448,0,3,0
28080,1,2,98446,98448,98450,2,4,0
28081,5,2,98451,98451,98453,0,2,1
28082,6,2,98457,98457,98459,0,2,4
28083,3,1,98460,98460,98461,0,1,1
28084,1,3,98461,98461,98464,0,3,0
28085,6,1,98467,98467,98468,0,1,3
28086,1,1,98468,98468,98469,0,1,0
28087,1,1,98469,98469,98470,0,1,0
28088,5,1,98474,98474,98475,0,1,4
28089,5,3,98479,98479,98482,0,3,4
28090,5,3,98484,98484,98487,0,3,2
28091,2,2,98486,98487,98489,1,3,0
28092,6,3,98492,98492,98495,0,3,3
28093,6,2,98498,98498,98500,0,2,3
28094,1,2,98499,98500,98502,1,3,0
28095,5,1,98504,98504,98505,0,1,2
28096,3,3,98507,98507,98510,0,3,2
28097,6,1,98513,98513,98514,0,1,3
28098,6,3,98519,98519,98522,0,3,5
28099,3,2,98522,98522,98524,0,2,0
28100,2,2,98524,98524,98526,0,2,0
28101,3,2,98527,98527,98529,0,2,1
28102,2,2,98529,98529,98531,0,2,0
28103,1,1,98530,98531,98532,1,2,0
28104,6,2,98536,98536,98538,0,2,4
28105,4,3,98540,98540,98543,0,3,2
28106,1,2,98541,98543,98545,2,4,0
28107,3,1,98544,98545,98546,1,2,0
28108,3,2,98547,98547,98549,0,2,1
28109,3,3,98550,98550,98553,0,3,1
28110,6,3,98556,98556,98559,0,3,3
28111,6,2,98562,98562,98564,0,2,3
28112,5,3,98567,98567,98570,0,3,3
28113,4,2,98571,98571,98573,0,2,1
28114,4,3,98575,98575,98578,0,3,2
28115,3,1,98578,98578,98579,0,1,0
28116,2,1,98580,98580,98581,0,1,1
28117,1,2,98581,98581,98583,0,2,0
28118,5,3,98586,98586,98589,0,3,3
28119,3,2,98589,98589,98591,0,2,0
28120,4,2,98593,98593,98595,0,2,2
28121,1,1,98594,98595,98596,1,2,0
28122,2,2,98596,98596,98598,0,2,0
28123,1,1,98597,98598,98599,1,2,0
28124,2,3,98599,98599,98602,0,3,0
28125,2,2,98601,98602,98604,1,3,0
28126,6,3,98607,98607,98610,0,3,3
28127,6,1,98613,98613,98614,0,1,3
28128,3,2,98616,98616,98618,0,2,2
28129,1,3,98617,98618,98621,1,4,0
28130,1,2,98618,98621,98623,3,5,0
28131,5,2,98623,98623,98625,0,2,0
28132,2,1,98625,98625,98626,0,1,0
28133,1,1,98626,98626,98627,0,1,0
28134,6,3,98632,98632,98635,0,3,5
28135,1,1,98633,98635,98636,2,3,0
28136,1,1,98634,98636,98637,2,3,0
28137,4,2,98638,98638,98640,0,2,1
28138,1,1,98639,98640,98641,1,2,0
28139,3,3,98642,98642,98645,0,3,1
28140,6,1,98648,98648,98649,0,1,3
28141,6,3,98654,98654,98657,0,3,5
28142,4,2,98658,98658,98660,0,2,1
28143,1,2,98659,98660,98662,1,3,0
28144,2,2,98661,98662,98664,1,3,0
28145,4,1,98665,98665,98666,0,1,1
28146,2,1,98667,98667,98668,0,1,1
28147,6,2,98673,98673,98675,0,2,5
28148,4,3,98677,98677,98680,0,3,2
28149,2,1,98679,98680,98681,1,2,0
28150,5,2,98684,98684,98686,0,2,3
28151,3,2,98687,98687,98689,0,2,1
28152,3,1,98690,98690,98691,0,1,1
28153,6,2,98696,98696,98698,0,2,5
28154,3,3,98699,98699,98702,0,3,1
28155,3,1,98702,98702,98703,0,1,0
28156,4,3,98706,98706,98709,0,3,3
28157,1,1,98707,98709,98710,2,3,0
28158,5,2,98712,98712,98714,0,2,2
28159,5,2,98717,98717,98719,0,2,3
28160,2,2,98719,98719,98721,0,2,0
28161,2,1,98721,98721,98722,0,1,0
28162,5,1,98726,98726,98727,0,1,4
28163,3,1,98729,98729,98730,0,1,2
28164,1,2,98730,98730,98732,0,2,0
28165,2,3,98732,98732,98735,0,3,0
28166,5,3,98737,98737,98740,0,3,2
28167,6,2,98743,98743,98745,0,2,3
28168,5,2,98748,98748,98750,0,2,3
28169,4,2,98752,98752,98754,0,2,2
28170,3,1,98755,98755,98756,0,1,1
28171,3,3,98758,98758,98761,0,3,2
28172,5,3,98763,98763,98766,0,3,2
28173,1,3,98764,98766,98769,2,5,0
28174,4,2,98768,98769,98771,1,3,0
28175,5,2,98773,98773,98775,0,2,2
28176,3,1,98776,98776,98777,0,1,1
28177,1,3,98777,98777,98780,0,3,0
28178,5,1,98782,98782,98783,0,1,2
28179,3,3,98785,98785,98788,0,3,2
28180,3,3,98788,98788,98791,0,3,0
28181,5,1,98793,98793,98794,0,1,2
28182,2,1,98795,98795,98796,0,1,1
28183,1,3,98796,98796,98799,0,3,0
28184,3,2,98799,98799,98801,0,2,0
28185,3,2,98802,98802,98804,0,2,1
28186,1,3,98803,98804,98807,1,4,0
28187,2,2,98805,98807,98809,2,4,0
28188,2,1,98807,98809,98810,2,3,0
28189,1,1,98808,98810,98811,2,3,0
28190,1,3,98809,98811,98814,2,5,0
28191,2,1,98811,98814,98815,3,4,0
28192,5,3,98816,98816,98819,0,3,1
28193,3,2,98819,98819,98821,0,2,0
28194,2,1,98821,98821,98822,0,1,0
28195,1,2,98822,98822,98824,0,2,0
28196,3,3,98825,98825,98828,0,3,1
28197,1,2,98826,98828,98830,2,4,0
28198,2,1,98828,98830,98831,2,3,0
28199,3,2,98831,98831,98833,0,2,0
28200,1,1,98832,98833,98834,1,2,0
28201,4,2,98836,98836,98838,0,2,2
28202,3,3,98839,98839,98842,0,3,1
28203,3,3,98842,98842,98845,0,3,0
28204,6,3,98848,98848,98851,0,3,3
28205,5,2,98853,98853,98855,0,2,2
28206,4,3,98857,98857,98860,0,3,2
28207,2,3,98859,98860,98863,1,4,0
28208,1,2,98860,98863,98865,3,5,0
28209,6,2,98866,98866,98868,0,2,1
28210,2,2,98868,98868,98870,0,2,0
28211,3,3,98871,98871,98874,0,3,1
28212,2,1,98873,98874,98875,1,2,0
28213,5,3,98878,98878,98881,0,3,3
28214,1,1,98879,98881,98882,2,3,0
28215,2,1,98881,98882,98883,1,2,0
28216,1,1,98882,98883,98884,1,2,0
28217,2,3,98884,98884,98887,0,3,0
28218,1,1,98885,98887,98888,2,3,0
28219,4,3,98889,98889,98892,0,3,1
28220,6,3,98895,98895,98898,0,3,3
28221,1,1,98896,98898,98899,2,3,0
28222,1,3,98897,98899,98902,2,5,0
28223,5,1,98902,98902,98903,0,1,0
28224,5,3,98907,98907,98910,0,3,4
28225,5,1,98912,98912,98913,0,1,2
28226,5,2,98917,98917,98919,0,2,4
28227,2,3,98919,98919,98922,0,3,0
28228,2,1,98921,98922,98923,1,2,0
28229,1,3,98922,98923,98926,1,4,0
28230,1,2,98923,98926,98928,3,5,0
28231,6,1,98929,98929,98930,0,1,1
28232,1,3,98930,98930,98933,0,3,0
28233,1,1,98931,98933,98934,2,3,0
28234,2,3,98933,98934,98937,1,4,0
28235,5,3,98938,98938,98941,0,3,1
28236,1,1,98939,98941,98942,2,3,0
28237,5,3,98944,98944,98947,0,3,2
28238,2,3,98946,98947,98950,1,4,0
28239,5,3,98951,98951,98954,0,3,1
28240,3,1,98954,98954,98955,0,1,0
28241,1,3,98955,98955,98958,0,3,0
28242,3,1,98958,98958,98959,0,1,0
28243,1,3,98959,98959,98962,0,3,0
28244,2,1,98961,98962,98963,1,2,0
28245,4,3,98965,98965,98968,0,3,2
28246,6,3,98971,98971,98974,0,3,3
28247,4,1,98975,98975,98976,0,1,1
28248,1,2,98976,98976,98978,0,2,0
28249,4,1,98980,98980,98981,0,1,2
28250,1,1,98981,98981,98982,0,1,0
28251,4,2,98985,98985,98987,0,2,3
28252,1,1,98986,98987,98988,1,2,0
28253,4,3,98990,98990,98993,0,3,2
28254,5,2,98995,98995,98997,0,2,2
28255,2,2,98997,98997,98999,0,2,0
28256,3,3,99000,99000,99003,0,3,1
28257,4,2,99004,99004,99006,0,2,1
28258,6,3,99010,99010,99013,0,3,4
28259,3,2,99013,99013,99015,0,2,0
28260,1,1,99014,99015,99016,1,2,0
28261,2,1,99016,99016,99017,0,1,0
28262,1,1,99017,99017,99018,0,1,0
28263,2,1,99019,99019,99020,0,1,1
28264,2,2,99021,99021,99023,0,2,1
28265,2,2,99023,99023,99025,0,2,0
28266,2,1,99025,99025,99026,0,1,0
28267,1,2,99026,99026,99028,0,2,0
28268,2,2,99028,99028,99030,0,2,0
28269,2,1,99030,99030,99031,0,1,0
28270,6,3,99036,99036,99039,0,3,5
28271,2,2,99038,99039,99041,1,3,0
28272,5,2,99043,99043,99045,0,2,2
28273,3,2,99046,99046,99048,0,2,1
28274,4,3,99050,99050,99053,0,3,2
28275,5,2,99055,99055,99057,0,2,2
28276,3,1,99058,99058,99059,0,1,1
28277,3,1,99061,99061,99062,0,1,2
28278,4,3,99065,99065,99068,0,3,3
28279,5,1,99070,99070,99071,0,1,2
28280,5,1,99075,99075,99076,0,1,4
28281,2,2,99077,99077,99079,0,2,1
28282,3,2,99080,99080,99082,0,2,1
28283,6,2,99086,99086,99088,0,2,4
28284,2,1,99088,99088,99089,0,1,0
28285,6,3,99094,99094,99097,0,3,5
28286,1,2,99095,99097,99099,2,4,0
28287,1,3,99096,99099,99102,3,6,0
28288,6,1,99102,99102,99103,0,1,0
28289,5,2,99107,99107,99109,0,2,4
28290,5,2,99112,99112,99114,0,2,3
28291,6,2,99118,99118,99120,0,2,4
28292,5,3,99123,99123,99126,0,3,3
28293,3,2,99126,99126,99128,0,2,0
28294,3,3,99129,99129,99132,0,3,1
28295,3,2,99132,99132,99134,0,2,0
28296,6,3,99138,99138,99141,0,3,4
28297,3,1,99141,99141,99142,0,1,0
28298,5,1,99146,99146,99147,0,1,4
28299,2,2,99148,99148,99150,0,2,1
28300,3,2,99151,99151,99153,0,2,1
28301,6,2,99157,99157,99159,0,2,4
28302,2,3,99159,99159,99162,0,3,0
28303,4,3,99163,99163,99166,0,3,1
28304,3,3,99166,99166,99169,0,3,0
28305,1,3,99167,99169,99172,2,5,0
28306,2,1,99169,99172,99173,3,4,0
28307,6,2,99175,99175,99177,0,2,2
28308,2,2,99177,99177,99179,0,2,0
28309,3,3,99180,99180,99183,0,3,1
28310,3,1,99183,99183,99184,0,1,0
28311,5,2,99188,99188,99190,0,2,4
28312,5,3,99193,99193,99196,0,3,3
28313,3,2,99196,99196,99198,0,2,0
28314,1,1,99197,99198,99199,1,2,0
28315,4,2,99201,99201,99203,0,2,2
28316,3,3,99204,99204,99207,0,3,1
28317,6,3,99210,99210,99213,0,3,3
28318,2,2,99212,99213,99215,1,3,0
28319,1,1,99213,99215,99216,2,3,0
28320,1,1,99214,99216,99217,2,3,0
28321,4,3,99218,99218,99221,0,3,1
28322,6,3,99224,99224,99227,0,3,3
28323,2,1,99226,99227,99228,1,2,0
28324,1,3,99227,99228,99231,1,4,0
28325,4,1,99231,99231,99232,0,1,0
28326,5,3,99236,99236,99239,0,3,4
28327,5,3,99241,99241,99244,0,3,2
28328,6,3,99247,99247,99250,0,3,3
28329,4,1,99251,99251,99252,0,1,1
28330,3,2,99254,99254,99256,0,2,2
28331,6,3,99260,99260,99263,0,3,4
28332,2,1,99262,99263,99264,1,2,0
28333,2,1,99264,99264,99265,0,1,0
28334,1,3,99265,99265,99268,0,3,0
28335,4,2,99269,99269,99271,0,2,1
28336,3,2,99272,99272,99274,0,2,1
28337,6,3,99278,99278,99281,0,3,4
28338,1,3,99279,99281,99284,2,5,0
28339,4,3,99283,99284,99287,1,4,0
28340,3,3,99286,99287,99290,1,4,0
28341,4,3,99290,99290,99293,0,3,0
28342,1,3,99291,99293,99296,2,5,0
28343,5,2,99296,99296,99298,0,2,0
28344,1,3,99297,99298,99301,1,4,0
28345,1,1,99298,99301,99302,3,4,0
28346,4,3,99302,99302,99305,0,3,0
28347,4,2,99306,99306,99308,0,2,1
28348,5,3,99311,99311,99314,0,3,3
28349,3,2,99314,99314,99316,0,2,0
28350,4,2,99318,99318,99320,0,2,2
28351,1,2,99319,99320,99322,1,3,0
28352,6,1,99325,99325,99326,0,1,3
28353,6,2,99331,99331,99333,0,2,5
28354,5,2,99336,99336,99338,0,2,3
28355,3,3,99339,99339,99342,0,3,1
28356,3,3,99342,99342,99345,0,3,0
28357,1,2,99343,99345,99347,2,4,0
28358,2,3,99345,99347,99350,2,5,0
28359,2,3,99347,99350,99353,3,6,0
28360,6,3,99353,99353,99356,0,3,0
28361,6,2,99359,99359,99361,0,2,3
28362,4,1,99363,99363,99364,0,1,2
28363,4,2,99367,99367,99369,0,2,3
28364,6,2,99373,99373,99375,0,2,4
28365,6,1,99379,99379,99380,0,1,4
28366,1,1,99380,99380,99381,0,1,0
28367,4,1,99384,99384,99385,0,1,3
28368,2,1,99386,99386,99387,0,1,1
28369,2,1,99388,99388,99389,0,1,1
28370,1,3,99389,99389,99392,0,3,0
28371,4,1,99393,99393,99394,0,1,1
28372,5,2,99398,99398,99400,0,2,4
28373,5,3,99403,99403,99406,0,3,3
28374,5,2,99408,99408,99410,0,2,2
28375,6,3,99414,99414,99417,0,3,4
28376,1,1,99415,99417,99418,2,3,0
28377,3,3,99418,99418,99421,0,3,0
28378,2,1,99420,99421,99422,1,2,0
28379,6,2,99426,99426,99428,0,2,4
28380,5,1,99431,99431,99432,0,1,3
28381,4,2,99435,99435,99437,0,2,3
28382,5,1,99440,99440,99441,0,1,3
28383,3,3,99443,99443,99446,0,3,2
28384,4,3,99447,99447,99450,0,3,1
28385,3,3,99450,99450,99453,0,3,0
28386,5,3,99455,99455,99458,0,3,2
28387,4,3,99459,99459,99462,0,3,1
28388,1,3,99460,99462,99465,2,5,0
28389,6,1,99466,99466,99467,0,1,1
28390,6,3,99472,99472,99475,0,3,5
28391,4,3,99476,99476,99479,0,3,1
28392,6,1,99482,99482,99483,0,1,3
28393,1,1,99483,99483,99484,0,1,0
28394,3,1,99486,99486,99487,0,1,2
28395,6,2,99492,99492,99494,0,2,5
28396,4,1,99496,99496,99497,0,1,2
28397,3,3,99499,99499,99502,0,3,2
28398,5,3,99504,99504,99507,0,3,2
28399,5,2,99509,99509,99511,0,2,2
28400,1,2,99510,99511,99513,1,3,0
28401,4,1,99514,99514,99515,0,1,1
28402,4,2,99518,99518,99520,0,2,3
28403,6,3,99524,99524,99527,0,3,4
28404,2,1,99526,99527,99528,1,2,0
28405,5,3,99531,99531,99534,0,3,3
28406,1,3,99532,99534,99537,2,5,0
28407,4,3,99536,99537,99540,1,4,0
28408,4,1,99540,99540,99541,0,1,0
28409,4,2,99544,99544,99546,0,2,3
28410,3,3,99547,99547,99550,0,3,1
28411,6,2,99553,99553,99555,0,2,3
28412,4,2,99557,99557,99559,0,2,2
28413,6,2,99563,99563,99565,0,2,4
28414,5,2,99568,99568,99570,0,2,3
28415,5,3,99573,99573,99576,0,3,3
28416,5,1,99578,99578,99579,0,1,2
28417,2,3,99580,99580,99583,0,3,1
28418,4,1,99584,99584,99585,0,1,1
28419,3,2,99587,99587,99589,0,2,2
28420,4,3,99591,99591,99594,0,3,2
28421,2,2,99593,99594,99596,1,3,0
28422,1,3,99594,99596,99599,2,5,0
28423,1,3,99595,99599,99602,4,7,0
28424,5,2,99600,99602,99604,2,4,0
28425,3,2,99603,99604,99606,1,3,0
28426,5,2,99608,99608,99610,0,2,2
28427,4,3,99612,99612,99615,0,3,2
28428,3,1,99615,99615,99616,0,1,0
28429,4,2,99619,99619,99621,0,2,3
28430,5,3,99624,99624,99627,0,3,3
28431,1,3,99625,99627,99630,2,5,0
28432,6,1,99631,99631,99632,0,1,1
28433,5,3,99636,99636,99639,0,3,4
28434,3,1,99639,99639,99640,0,1,0
28435,3,1,99642,99642,99643,0,1,2
28436,3,1,99645,99645,99646,0,1,2
28437,2,3,99647,99647,99650,0,3,1
28438,4,1,99651,99651,99652,0,1,1
28439,3,3,99654,99654,99657,0,3,2
28440,1,2,99655,99657,99659,2,4,0
28441,5,1,99660,99660,99661,0,1,1
28442,4,2,99664,99664,99666,0,2,3
28443,1,1,99665,99666,99667,1,2,0
28444,4,1,99669,99669,99670,0,1,2
28445,6,1,99675,99675,99676,0,1,5
28446,6,3,99681,99681,99684,0,3,5
28447,2,3,99683,99684,99687,1,4,0
28448,3,3,99686,99687,99690,1,4,0
28449,1,3,99687,99690,99693,3,6,0
28450,6,2,99693,99693,99695,0,2,0
28451,5,1,99698,99698,99699,0,1,3
28452,5,3,99703,99703,99706,0,3,4
28453,1,1,99704,99706,99707,2,3,0
28454,6,1,99710,99710,99711,0,1,3
28455,2,3,99712,99712,99715,0,3,1
28456,2,3,99714,99715,99718,1,4,0
28457,1,3,99715,99718,99721,3,6,0
28458,5,2,99720,99721,99723,1,3,0
28459,5,1,99725,99725,99726,0,1,2
28460,3,1,99728,99728,99729,0,1,2
28461,2,3,99730,99730,99733,0,3,1
28462,5,1,99735,99735,99736,0,1,2
28463,5,1,99740,99740,99741,0,1,4
28464,1,1,99741,99741,99742,0,1,0
28465,5,2,99746,99746,99748,0,2,4
28466,6,1,99752,99752,99753,0,1,4
28467,1,2,99753,99753,99755,0,2,0
28468,3,2,99756,99756,99758,0,2,1
28469,4,2,99760,99760,99762,0,2,2
28470,3,3,99763,99763,99766,0,3,1
28471,6,2,99769,99769,99771,0,2,3
28472,4,3,99773,99773,99776,0,3,2
28473,1,2,99774,99776,99778,2,4,0
28474,3,1,99777,99778,99779,1,2,0
28475,1,3,99778,99779,99782,1,4,0
28476,4,2,99782,99782,99784,0,2,0
28477,4,1,99786,99786,99787,0,1,2
28478,4,2,99790,99790,99792,0,2,3
28479,1,2,99791,99792,99794,1,3,0
28480,1,1,99792,99794,99795,2,3,0
28481,2,1,99794,99795,99796,1,2,0
28482,5,3,99799,99799,99802,0,3,3
28483,1,2,99800,99802,99804,2,4,0
28484,3,2,99803,99804,99806,1,3,0
28485,2,2,99805,99806,99808,1,3,0
28486,4,2,99809,99809,99811,0,2,1
28487,2,1,99811,99811,99812,0,1,0
28488,5,3,99816,99816,99819,0,3,4
28489,3,1,99819,99819,99820,0,1,0
28490,2,1,99821,99821,99822,0,1,1
28491,6,3,99827,99827,99830,0,3,5
28492,3,2,99830,99830,99832,0,2,0
28493,6,3,99836,99836,99839,0,3,4
28494,4,3,99840,99840,99843,0,3,1
28495,2,2,99842,99843,99845,1,3,0
28496,3,1,99845,99845,99846,0,1,0
28497,1,2,99846,99846,99848,0,2,0
28498,4,2,99850,99850,99852,0,2,2
28499,4,3,99854,99854,99857,0,3,2
28500,4,3,99858,99858,99861,0,3,1
28501,1,3,99859,99861,99864,2,5,0
28502,3,1,99862,99864,99865,2,3,0
28503,6,3,99868,99868,99871,0,3,3
28504,5,1,99873,99873,99874,0,1,2
28505,2,3,99875,99875,99878,0,3,1
28506,5,2,99880,99880,99882,0,2,2
28507,4,1,99884,99884,99885,0,1,2
28508,2,1,99886,99886,99887,0,1,1
28509,1,1,99887,99887,99888,0,1,0
28510,2,1,99889,99889,99890,0,1,1
28511,5,3,99894,99894,99897,0,3,4
28512,6,2,99900,99900,99902,0,2,3
28513,6,3,99906,99906,99909,0,3,4
28514,6,1,99912,99912,99913,0,1,3
28515,6,2,99918,99918,99920,0,2,5
28516,3,2,99921,99921,99923,0,2,1
28517,4,3,99925,99925,99928,0,3,2
28518,2,3,99927,99928,99931,1,4,0
28519,2,3,99929,99931,99934,2,5,0
28520,2,1,99931,99934,99935,3,4,0
28521,5,1,99936,99936,99937,0,1,1
28522,5,3,99941,99941,99944,0,3,4
28523,6,3,99947,99947,99950,0,3,3
28524,2,1,99949,99950,99951,1,2,0
28525,4,3,99953,99953,99956,0,3,2
28526,2,3,99955,99956,99959,1,4,0
28527,4,3,99959,99959,99962,0,3,0
28528,1,1,99960,99962,99963,2,3,0
28529,4,3,99964,99964,99967,0,3,1
28530,2,1,99966,99967,99968,1,2,0
28531,4,1,99970,99970,99971,0,1,2
28532,2,2,99972,99972,99974,0,2,1
28533,6,2,99978,99978,99980,0,2,4
28534,2,2,99980,99980,99982,0,2,0
28535,3,2,99983,99983,99985,0,2,1
28536,2,1,99985,99985,99986,0,1,0
28537,1,1,99986,99986,99987,0,1,0
28538,2,3,99988,99988,99991,0,3,1
28539,5,2,99993,99993,99995,0,2,2
28540,4,2,99997,99997,99999,0,2,2
28541,2,3,99999,99999,100002,0,3,0
28542,2,1,100001,100002,100003,1,2,0
28543,1,2,100002,100003,100005,1,3,0
28544,1,2,100003,100005,100007,2,4,0
28545,1,3,100004,100007,100010,3,6,0
28546,2,2,100006,100010,100012,4,6,0
28547,1,2,100007,100012,100014,5,7,0
28548,4,1,100011,100014,100015,3,4,0
28549,6,3,100017,100017,100020,0,3,2
28550,4,1,100021,100021,100022,0,1,1
28551,6,3,100027,100027,100030,0,3,5
28552,4,1,100031,100031,100032,0,1,1
28553,3,3,100034,100034,100037,0,3,2
28554,5,2,100039,100039,100041,0,2,2
28555,6,3,100045,100045,100048,0,3,4
28556,5,2,100050,100050,100052,0,2,2
28557,3,1,100053,100053,100054,0,1,1
28558,2,2,100055,100055,100057,0,2,1
28559,5,1,100060,100060,100061,0,1,3
28560,3,3,100063,100063,100066,0,3,2
28561,5,2,100068,100068,100070,0,2,2
28562,2,2,100070,100070,100072,0,2,0
28563,1,1,100071,100072,100073,1,2,0
28564,1,2,100072,100073,100075,1,3,0
28565,3,3,100075,100075,100078,0,3,0
28566,5,2,100080,100080,100082,0,2,2
28567,1,3,100081,100082,100085,1,4,0
28568,1,2,100082,100085,100087,3,5,0
28569,6,2,100088,100088,100090,0,2,1
28570,6,3,100094,100094,100097,0,3,4
28571,3,2,100097,100097,100099,0,2,0
28572,3,3,100100,100100,100103,0,3,1
28573,1,3,100101,100103,100106,2,5,0
28574,5,3,100106,100106,100109,0,3,0
28575,5,3,100111,100111,100114,0,3,2
28576,1,3,100112,100114,100117,2,5,0
28577,5,1,100117,100117,100118,0,1,0
28578,4,3,100121,100121,100124,0,3,3
28579,1,3,100122,100124,100127,2,5,0
28580,3,1,100125,100127,100128,2,3,0
28581,5,2,100130,100130,100132,0,2,2
28582,4,2,100134,100134,100136,0,2,2
28583,4,3,100138,100138,100141,0,3,2
28584,6,2,100144,100144,100146,0,2,3
28585,4,2,100148,100148,100150,0,2,2
28586,2,3,100150,100150,100153,0,3,0
28587,2,2,100152,100153,100155,1,3,0
28588,3,3,100155,100155,100158,0,3,0
28589,6,3,100161,100161,100164,0,3,3
28590,5,3,100166,100166,100169,0,3,2
28591,4,2,100170,100170,100172,0,2,1
28592,3,2,100173,100173,100175,0,2,1
28593,4,2,100177,100177,100179,0,2,2
28594,3,2,100180,100180,100182,0,2,1
28595,5,3,100185,100185,100188,0,3,3
28596,1,3,100186,100188,100191,2,5,0
28597,5,2,100191,100191,100193,0,2,0
28598,5,3,100196,100196,100199,0,3,3
28599,6,1,100202,100202,100203,0,1,3
28600,1,2,100203,100203,100205,0,2,0
28601,4,1,100207,100207,100208,0,1,2
28602,4,2,100211,100211,100213,0,2,3
28603,5,2,100216,100216,100218,0,2,3
28604,5,2,100221,100221,100223,0,2,3
28605,4,1,100225,100225,100226,0,1,2
28606,1,1,100226,100226,100227,0,1,0
28607,5,2,100231,100231,100233,0,2,4
28608,6,2,100237,100237,100239,0,2,4
28609,3,3,100240,100240,100243,0,3,1
28610,2,2,100242,100243,100245,1,3,0
28611,4,3,100246,100246,100249,0,3,1
28612,5,2,100251,100251,100253,0,2,2
28613,1,2,100252,100253,100255,1,3,0
28614,6,3,100258,100258,100261,0,3,3
28615,3,1,100261,100261,100262,0,1,0
28616,2,3,100263,100263,100266,0,3,1
28617,4,1,100267,100267,100268,0,1,1
28618,2,2,100269,100269,100271,0,2,1
28619,3,3,100272,100272,100275,0,3,1
28620,1,3,100273,100275,100278,2,5,0
28621,5,2,100278,100278,100280,0,2,0
28622,3,1,100281,100281,100282,0,1,1
28623,1,3,100282,100282,100285,0,3,0
28624,1,2,100283,100285,100287,2,4,0
28625,1,1,100284,100287,100288,3,4,0
28626,4,3,100288,100288,100291,0,3,0
28627,1,2,100289,100291,100293,2,4,0
28628,5,3,100294,100294,100297,0,3,1
28629,2,3,100296,100297,100300,1,4,0
28630,6,3,100302,100302,100305,0,3,2
28631,6,3,100308,100308,100311,0,3,3
28632,1,1,100309,100311,100312,2,3,0
28633,4,2,100313,100313,100315,0,2,1
28634,4,1,100317,100317,100318,0,1,2
28635,6,1,100323,100323,100324,0,1,5
28636,1,2,100324,100324,100326,0,2,0
28637,2,3,100326,100326,100329,0,3,0
28638,6,1,100332,100332,100333,0,1,3
28639,5,2,100337,100337,100339,0,2,4
28640,2,2,100339,100339,100341,0,2,0
28641,5,1,100344,100344,100345,0,1,3
28642,4,1,100348,100348,100349,0,1,3
28643,5,1,100353,100353,100354,0,1,4
28644,2,3,100355,100355,100358,0,3,1
28645,5,2,100360,100360,100362,0,2,2
28646,6,1,100366,100366,100367,0,1,4
28647,6,2,100372,100372,100374,0,2,5
28648,4,2,100376,100376,100378,0,2,2
28649,6,2,100382,100382,100384,0,2,4
28650,2,3,100384,100384,100387,0,3,0
28651,2,2,100386,100387,100389,1,3,0
28652,2,2,100388,100389,100391,1,3,0
28653,6,2,100394,100394,100396,0,2,3
28654,5,2,100399,100399,100401,0,2,3
28655,1,3,100400,100401,100404,1,4,0
28656,4,3,100404,100404,100407,0,3,0
28657,6,1,100410,100410,100411,0,1,3
28658,3,2,100413,100413,100415,0,2,2
28659,2,3,100415,100415,100418,0,3,0
28660,5,2,100420,100420,100422,0,2,2
28661,5,2,100425,100425,100427,0,2,3
28662,4,3,100429,100429,100432,0,3,2
28663,4,1,100433,100433,100434,0,1,1
28664,1,3,100434,100434,100437,0,3,0
28665,2,1,100436,100437,100438,1,2,0
28666,3,2,100439,100439,100441,0,2,1
28667,3,1,100442,100442,100443,0,1,1
28668,6,1,100448,100448,100449,0,1,5
28669,2,2,100450,100450,100452,0,2,1
28670,6,3,100456,100456,100459,0,3,4
28671,3,3,100459,100459,100462,0,3,0
28672,5,1,100464,100464,100465,0,1,2
28673,6,3,100470,100470,100473,0,3,5
28674,5,3,100475,100475,100478,0,3,2
28675,6,2,100481,100481,100483,0,2,3
28676,3,3,100484,100484,100487,0,3,1
28677,6,2,100490,100490,100492,0,2,3
28678,1,1,100491,100492,100493,1,2,0
28679,6,2,100497,100497,100499,0,2,4
28680,3,3,100500,100500,100503,0,3,1
28681,4,1,100504,100504,100505,0,1,1
28682,1,3,100505,100505,100508,0,3,0
28683,2,1,100507,100508,100509,1,2,0
28684,5,1,100512,100512,100513,0,1,3
28685,4,1,100516,100516,100517,0,1,3
28686,1,3,100517,100517,100520,0,3,0
28687,4,3,100521,100521,100524,0,3,1
28688,3,1,100524,100524,100525,0,1,0
28689,3,2,100527,100527,100529,0,2,2
28690,1,2,100528,100529,100531,1,3,0
28691,5,1,100533,100533,100534,0,1,2
28692,1,3,100534,100534,100537,0,3,0
28693,5,3,100539,100539,100542,0,3,2
28694,1,2,100540,100542,100544,2,4,0
28695,5,3,100545,100545,100548,0,3,1
28696,1,3,100546,100548,100551,2,5,0
28697,4,2,100550,100551,100553,1,3,0
28698,4,2,100554,100554,100556,0,2,1
28699,6,3,100560,100560,100563,0,3,4
28700,6,2,100566,100566,100568,0,2,3
28701,6,1,100572,100572,100573,0,1,4
28702,5,1,100577,100577,100578,0,1,4
28703,2,1,100579,100579,100580,0,1,1
28704,3,3,100582,100582,100585,0,3,2
28705,6,2,100588,100588,100590,0,2,3
28706,4,1,100592,100592,100593,0,1,2
28707,1,2,100593,100593,100595,0,2,0
28708,6,1,100599,100599,100600,0,1,4
28709,5,1,100604,100604,100605,0,1,4
28710,2,3,100606,100606,100609,0,3,1
28711,4,1,100610,100610,100611,0,1,1
28712,6,2,100616,100616,100618,0,2,5
28713,4,2,100620,100620,100622,0,2,2
28714,6,2,100626,100626,100628,0,2,4
28715,6,3,100632,100632,100635,0,3,4
28716,3,1,100635,100635,100636,0,1,0
28717,1,3,100636,100636,100639,0,3,0
28718,4,2,100640,100640,100642,0,2,1
28719,6,1,100646,100646,100647,0,1,4
28720,6,2,100652,100652,100654,0,2,5
28721,2,3,100654,100654,100657,0,3,0
28722,1,1,100655,100657,100658,2,3,0
28723,4,3,100659,100659,100662,0,3,1
28724,6,3,100665,100665,100668,0,3,3
28725,5,2,100670,100670,100672,0,2,2
28726,3,2,100673,100673,100675,0,2,1
28727,1,2,100674,100675,100677,1,3,0
28728,4,1,100678,100678,100679,0,1,1
28729,4,2,100682,100682,100684,0,2,3
28730,4,2,100686,100686,100688,0,2,2
28731,2,2,100688,100688,100690,0,2,0
28732,3,3,100691,100691,100694,0,3,1
28733,2,3,100693,100694,100697,1,4,0
28734,1,3,100694,100697,100700,3,6,0
28735,6,1,100700,100700,100701,0,1,0
28736,5,2,100705,100705,100707,0,2,4
28737,5,3,100710,100710,100713,0,3,3
28738,6,3,100716,100716,100719,0,3,3
28739,2,2,100718,100719,100721,1,3,0
28740,6,1,100724,100724,100725,0,1,3
28741,3,3,100727,100727,100730,0,3,2
28742,4,3,100731,100731,100734,0,3,1
28743,6,3,100737,100737,100740,0,3,3
28744,3,3,100740,100740,100743,0,3,0
28745,5,2,100745,100745,100747,0,2,2
28746,4,1,100749,100749,100750,0,1,2
28747,6,3,100755,100755,100758,0,3,5
28748,6,3,100761,100761,100764,0,3,3
28749,2,2,100763,100764,100766,1,3,0
28750,4,2,100767,100767,100769,0,2,1
28751,3,1,100770,100770,100771,0,1,1
28752,6,1,100776,100776,100777,0,1,5
28753,3,3,100779,100779,100782,0,3,2
28754,2,3,100781,100782,100785,1,4,0
28755,6,2,100787,100787,100789,0,2,2
28756,4,3,100791,100791,100794,0,3,2
28757,1,3,100792,100794,100797,2,5,0
28758,5,1,100797,100797,100798,0,1,0
28759,1,2,100798,100798,100800,0,2,0
28760,2,2,100800,100800,100802,0,2,0
28761,3,2,100803,100803,100805,0,2,1
28762,6,3,100809,100809,100812,0,3,4
28763,3,3,100812,100812,100815,0,3,0
28764,3,1,100815,100815,100816,0,1,0
28765,6,3,100821,100821,100824,0,3,5
28766,5,2,100826,100826,100828,0,2,2
28767,6,3,100832,100832,100835,0,3,4
28768,4,1,100836,100836,100837,0,1,1
28769,5,3,100841,100841,100844,0,3,4
28770,1,3,100842,100844,100847,2,5,0
28771,1,1,100843,100847,100848,4,5,0
28772,2,1,100845,100848,100849,3,4,0
28773,2,3,100847,100849,100852,2,5,0
28774,1,1,100848,100852,100853,4,5,0
28775,5,1,100853,100853,100854,0,1,0
28776,3,2,100856,100856,100858,0,2,2
28777,4,3,100860,100860,100863,0,3,2
28778,6,3,100866,100866,100869,0,3,3
28779,2,1,100868,100869,100870,1,2,0
28780,2,3,100870,100870,100873,0,3,0
28781,5,3,100875,100875,100878,0,3,2
28782,2,1,100877,100878,100879,1,2,0
28783,5,2,100882,100882,100884,0,2,3
28784,5,3,100887,100887,100890,0,3,3
28785,6,2,100893,100893,100895,0,2,3
28786,5,2,100898,100898,100900,0,2,3
28787,1,2,100899,100900,100902,1,3,0
28788,1,3,100900,100902,100905,2,5,0
28789,6,3,100906,100906,100909,0,3,1
28790,1,2,100907,100909,100911,2,4,0
28791,3,2,100910,100911,100913,1,3,0
28792,4,2,100914,100914,100916,0,2,1
28793,6,2,100920,100920,100922,0,2,4
28794,3,1,100923,100923,100924,0,1,1
28795,4,3,100927,100927,100930,0,3,3
28796,1,2,100928,100930,100932,2,4,0
28797,1,3,100929,100932,100935,3,6,0
28798,3,2,100932,100935,100937,3,5,0
28799,2,1,100934,100937,100938,3,4,0
28800,4,2,100938,100938,100940,0,2,0
28801,2,2,100940,100940,100942,0,2,0
28802,6,3,100946,100946,100949,0,3,4
28803,5,3,100951,100951,100954,0,3,2
28804,6,2,100957,100957,100959,0,2,3
28805,1,1,100958,100959,100960,1,2,0
28806,2,1,100960,100960,100961,0,1,0
28807,4,3,100964,100964,100967,0,3,3
28808,5,3,100969,100969,100972,0,3,2
28809,4,1,100973,100973,100974,0,1,1
28810,6,2,100979,100979,100981,0,2,5
28811,6,3,100985,100985,100988,0,3,4
28812,5,1,100990,100990,100991,0,1,2
28813,2,2,100992,100992,100994,0,2,1
28814,5,2,100997,100997,100999,0,2,3
28815,1,3,100998,100999,101002,1,4,0
28816,2,2,101000,101002,101004,2,4,0
28817,3,1,101003,101004,101005,1,2,0
28818,2,1,101005,101005,101006,0,1,0
28819,1,1,101006,101006,101007,0,1,0
28820,3,3,101009,101009,101012,0,3,2
28821,5,3,101014,101014,101017,0,3,2
28822,4,2,101018,101018,101020,0,2,1
28823,4,1,101022,101022,101023,0,1,2
28824,3,3,101025,101025,101028,0,3,2
28825,5,3,101030,101030,101033,0,3,2
28826,4,3,101034,101034,101037,0,3,1
28827,2,3,101036,101037,101040,1,4,0
28828,2,3,101038,101040,101043,2,5,0
28829,5,1,101043,101043,101044,0,1,0
28830,6,3,101049,101049,101052,0,3,5
28831,1,1,101050,101052,101053,2,3,0
28832,3,3,101053,101053,101056,0,3,0
28833,1,3,101054,101056,101059,2,5,0
28834,6,3,101060,101060,101063,0,3,1
28835,3,3,101063,101063,101066,0,3,0
28836,1,1,101064,101066,101067,2,3,0
28837,3,1,101067,101067,101068,0,1,0
28838,3,3,101070,101070,101073,0,3,2
28839,5,1,101075,101075,101076,0,1,2
28840,2,2,101077,101077,101079,0,2,1
28841,4,1,101081,101081,101082,0,1,2
28842,4,1,101085,101085,101086,0,1,3
28843,5,2,101090,101090,101092,0,2,4
28844,5,3,101095,101095,101098,0,3,3
28845,3,1,101098,101098,101099,0,1,0
28846,4,2,101102,101102,101104,0,2,3
28847,3,1,101105,101105,101106,0,1,1
28848,3,3,101108,101108,101111,0,3,2
28849,5,1,101113,101113,101114,0,1,2
28850,5,3,101118,101118,101121,0,3,4
28851,5,2,101123,101123,101125,0,2,2
28852,2,1,101125,101125,101126,0,1,0
28853,6,1,101131,101131,101132,0,1,5
28854,2,3,101133,101133,101136,0,3,1
28855,2,3,101135,101136,101139,1,4,0
28856,2,2,101137,101139,101141,2,4,0
28857,4,2,101141,101141,101143,0,2,0
28858,1,2,101142,101143,101145,1,3,0
28859,3,2,101145,101145,101147,0,2,0
28860,6,1,101151,101151,101152,0,1,4
28861,3,1,101154,101154,101155,0,1,2
28862,3,3,101157,101157,101160,0,3,2
28863,1,2,101158,101160,101162,2,4,0
28864,2,1,101160,101162,101163,2,3,0
28865,1,3,101161,101163,101166,2,5,0
28866,5,2,101166,101166,101168,0,2,0
28867,5,2,101171,101171,101173,0,2,3
28868,2,2,101173,101173,101175,0,2,0
28869,3,1,101176,101176,101177,0,1,1
28870,6,3,101182,101182,101185,0,3,5
28871,3,2,101185,101185,101187,0,2,0
28872,5,1,101190,101190,101191,0,1,3
28873,4,1,101194,101194,101195,0,1,3
28874,1,3,101195,101195,101198,0,3,0
28875,2,2,101197,101198,101200,1,3,0
28876,3,3,101200,101200,101203,0,3,0
28877,4,2,101204,101204,101206,0,2,1
28878,4,2,101208,101208,101210,0,2,2
28879,6,2,101214,101214,101216,0,2,4
28880,4,2,101218,101218,101220,0,2,2
28881,2,2,101220,101220,101222,0,2,0
28882,5,1,101225,101225,101226,0,1,3
28883,1,3,101226,101226,101229,0,3,0
28884,1,3,101227,101229,101232,2,5,0
28885,5,3,101232,101232,101235,0,3,0
28886,5,2,101237,101237,101239,0,2,2
28887,3,2,101240,101240,101242,0,2,1
28888,6,1,101246,101246,101247,0,1,4
28889,3,2,101249,101249,101251,0,2,2
28890,4,3,101253,101253,101256,0,3,2
28891,4,3,101257,101257,101260,0,3,1
28892,1,3,101258,101260,101263,2,5,0
28893,6,2,101264,101264,101266,0,2,1
28894,3,2,101267,101267,101269,0,2,1
28895,6,1,101273,101273,101274,0,1,4
28896,5,1,101278,101278,101279,0,1,4
28897,2,3,101280,101280,101283,0,3,1
28898,5,1,101285,101285,101286,0,1,2
28899,4,3,101289,101289,101292,0,3,3
28900,6,3,101295,101295,101298,0,3,3
28901,4,2,101299,101299,101301,0,2,1
28902,4,1,101303,101303,101304,0,1,2
28903,1,1,101304,101304,101305,0,1,0
28904,2,3,101306,101306,101309,0,3,1
28905,3,1,101309,101309,101310,0,1,0
28906,6,3,101315,101315,101318,0,3,5
28907,6,1,101321,101321,101322,0,1,3
28908,4,2,101325,101325,101327,0,2,3
28909,6,3,101331,101331,101334,0,3,4
28910,5,3,101336,101336,101339,0,3,2
28911,6,3,101342,101342,101345,0,3,3
28912,6,1,101348,101348,101349,0,1,3
28913,2,3,101350,101350,101353,0,3,1
28914,2,2,101352,101353,101355,1,3,0
28915,6,1,101358,101358,101359,0,1,3
28916,1,3,101359,101359,101362,0,3,0
28917,1,3,101360,101362,101365,2,5,0
28918,4,3,101364,101365,101368,1,4,0
28919,4,2,101368,101368,101370,0,2,0
28920,6,2,101374,101374,101376,0,2,4
28921,2,3,101376,101376,101379,0,3,0
28922,2,1,101378,101379,101380,1,2,0
28923,6,2,101384,101384,101386,0,2,4
28924,3,1,101387,101387,101388,0,1,1
28925,6,2,101393,101393,101395,0,2,5
28926,3,3,101396,101396,101399,0,3,1
28927,2,3,101398,101399,101402,1,4,0
28928,3,1,101401,101402,101403,1,2,0
28929,4,2,101405,101405,101407,0,2,2
28930,3,2,101408,101408,101410,0,2,1
28931,4,1,101412,101412,101413,0,1,2
28932,4,3,101416,101416,101419,0,3,3
28933,4,3,101420,101420,101423,0,3,1
28934,2,2,101422,101423,101425,1,3,0
28935,3,1,101425,101425,101426,0,1,0
28936,1,3,101426,101426,101429,0,3,0
28937,1,2,101427,101429,101431,2,4,0
28938,5,3,101432,101432,101435,0,3,1
28939,1,1,101433,101435,101436,2,3,0
28940,6,1,101439,101439,101440,0,1,3
28941,1,2,101440,101440,101442,0,2,0
28942,6,3,101446,101446,101449,0,3,4
28943,2,3,101448,101449,101452,1,4,0
28944,6,3,101454,101454,101457,0,3,2
28945,2,3,101456,101457,101460,1,4,0
28946,5,3,101461,101461,101464,0,3,1
28947,1,3,101462,101464,101467,2,5,0
28948,4,3,101466,101467,101470,1,4,0
28949,2,3,101468,101470,101473,2,5,0
28950,4,3,101472,101473,101476,1,4,0
28951,2,1,101474,101476,101477,2,3,0
28952,2,1,101476,101477,101478,1,2,0
28953,4,1,101480,101480,101481,0,1,2
28954,2,1,101482,101482,101483,0,1,1
28955,4,1,101486,101486,101487,0,1,3
28956,2,1,101488,101488,101489,0,1,1
28957,4,1,101492,101492,101493,0,1,3
28958,5,3,101497,101497,101500,0,3,4
28959,6,1,101503,101503,101504,0,1,3
28960,4,1,101507,101507,101508,0,1,3
28961,3,3,101510,101510,101513,0,3,2
28962,3,2,101513,101513,101515,0,2,0
28963,1,1,101514,101515,101516,1,2,0
28964,5,3,101519,101519,101522,0,3,3
28965,3,1,101522,101522,101523,0,1,0
28966,3,1,101525,101525,101526,0,1,2
28967,1,1,101526,101526,101527,0,1,0
28968,5,1,101531,101531,101532,0,1,4
28969,6,1,101537,101537,101538,0,1,5
28970,6,3,101543,101543,101546,0,3,5
28971,1,2,101544,101546,101548,2,4,0
28972,6,3,101550,101550,101553,0,3,2
28973,2,3,101552,101553,101556,1,4,0
28974,1,3,101553,101556,101559,3,6,0
28975,3,1,101556,101559,101560,3,4,0
28976,4,2,101560,101560,101562,0,2,0
28977,2,2,101562,101562,101564,0,2,0
28978,6,3,101568,101568,101571,0,3,4
28979,2,1,101570,101571,101572,1,2,0
28980,3,3,101573,101573,101576,0,3,1
28981,2,1,101575,101576,101577,1,2,0
28982,4,2,101579,101579,101581,0,2,2
28983,2,3,101581,101581,101584,0,3,0
28984,5,2,101586,101586,101588,0,2,2
28985,6,3,101592,101592,101595,0,3,4
28986,2,3,101594,101595,101598,1,4,0
28987,5,1,101599,101599,101600,0,1,1
28988,5,3,101604,101604,101607,0,3,4
28989,3,1,101607,101607,101608,0,1,0
28990,2,2,101609,101609,101611,0,2,1
28991,4,3,101613,101613,101616,0,3,2
28992,4,1,101617,101617,101618,0,1,1
28993,5,3,101622,101622,101625,0,3,4
28994,4,1,101626,101626,101627,0,1,1
28995,6,3,101632,101632,101635,0,3,5
28996,1,2,101633,101635,101637,2,4,0
28997,6,2,101639,101639,101641,0,2,2
28998,3,2,101642,101642,101644,0,2,1
28999,5,3,101647,101647,101650,0,3,3
29000,5,3,101652,101652,101655,0,3,2
29001,1,3,101653,101655,101658,2,5,0
29002,5,3,101658,101658,101661,0,3,0
29003,2,2,101660,101661,101663,1,3,0
29004,1,2,101661,101663,101665,2,4,0
29005,4,2,101665,101665,101667,0,2,0
29006,2,2,101667,101667,101669,0,2,0
29007,1,3,101668,101669,101672,1,4,0
29008,3,1,101671,101672,101673,1,2,0
29009,4,2,101675,101675,101677,0,2,2
29010,1,1,101676,101677,101678,1,2,0
29011,5,2,101681,101681,101683,0,2,3
29012,2,3,101683,101683,101686,0,3,0
29013,1,2,101684,101686,101688,2,4,0
29014,3,3,101687,101688,101691,1,4,0
29015,2,2,101689,101691,101693,2,4,0
29016,1,2,101690,101693,101695,3,5,0
29017,1,3,101691,101695,101698,4,7,0
29018,3,3,101694,101698,101701,4,7,0
29019,5,1,101699,101701,101702,2,3,0
29020,4,3,101703,101703,101706,0,3,1
29021,4,1,101707,101707,101708,0,1,1
29022,4,2,101711,101711,101713,0,2,3
29023,3,3,101714,101714,101717,0,3,1
29024,3,1,101717,101717,101718,0,1,0
29025,5,3,101722,101722,101725,0,3,4
29026,1,2,101723,101725,101727,2,4,0
29027,1,3,101724,101727,101730,3,6,0
29028,5,2,101729,101730,101732,1,3,0
29029,1,1,101730,101732,101733,2,3,0
29030,4,2,101734,101734,101736,0,2,1
29031,6,2,101740,101740,101742,0,2,4
29032,4,2,101744,101744,101746,0,2,2
29033,1,3,101745,101746,101749,1,4,0
29034,4,1,101749,101749,101750,0,1,0
29035,4,3,101753,101753,101756,0,3,3
29036,6,3,101759,101759,101762,0,3,3
29037,6,3,101765,101765,101768,0,3,3
29038,4,1,101769,101769,101770,0,1,1
29039,4,1,101773,101773,101774,0,1,3
29040,6,1,101779,101779,101780,0,1,5
29041,6,3,101785,101785,101788,0,3,5
29042,4,1,101789,101789,101790,0,1,1
29043,2,2,101791,101791,101793,0,2,1
29044,4,2,101795,101795,101797,0,2,2
29045,4,1,101799,101799,101800,0,1,2
29046,6,3,101805,101805,101808,0,3,5
29047,1,1,101806,101808,101809,2,3,0
29048,1,2,101807,101809,101811,2,4,0
29049,4,3,101811,101811,101814,0,3,0
29050,2,2,101813,101814,101816,1,3,0
29051,5,1,101818,101818,101819,0,1,2
29052,6,1,101824,101824,101825,0,1,5
29053,4,3,101828,101828,101831,0,3,3
29054,2,3,101830,101831,101834,1,4,0
29055,5,3,101835,101835,101838,0,3,1
29056,6,2,101841,101841,101843,0,2,3
29057,2,3,101843,101843,101846,0,3,0
29058,2,1,101845,101846,101847,1,2,0
29059,1,3,101846,101847,101850,1,4,0
29060,3,3,101849,101850,101853,1,4,0
29061,3,3,101852,101853,101856,1,4,0
29062,6,2,101858,101858,101860,0,2,2
29063,6,2,101864,101864,101866,0,2,4
29064,6,2,101870,101870,101872,0,2,4
29065,2,2,101872,101872,101874,0,2,0
29066,6,1,101878,101878,101879,0,1,4
29067,5,1,101883,101883,101884,0,1,4
29068,2,2,101885,101885,101887,0,2,1
29069,4,3,101889,101889,101892,0,3,2
29070,5,2,101894,101894,101896,0,2,2
29071,5,3,101899,101899,101902,0,3,3
29072,5,2,101904,101904,101906,0,2,2
29073,4,1,101908,101908,101909,0,1,2
29074,1,2,101909,101909,101911,0,2,0
29075,5,2,101914,101914,101916,0,2,3
29076,1,1,101915,101916,101917,1,2,0
29077,2,1,101917,101917,101918,0,1,0
29078,6,3,101923,101923,101926,0,3,5
29079,1,3,101924,101926,101929,2,5,0
29080,5,2,101929,101929,101931,0,2,0
29081,5,3,101934,101934,101937,0,3,3
29082,6,2,101940,101940,101942,0,2,3
29083,6,2,101946,101946,101948,0,2,4
29084,6,2,101952,101952,101954,0,2,4
29085,5,2,101957,101957,101959,0,2,3
29086,5,3,101962,101962,101965,0,3,3
29087,1,2,101963,101965,101967,2,4,0
29088,2,1,101965,101967,101968,2,3,0
29089,5,3,101970,101970,101973,0,3,2
29090,4,3,101974,101974,101977,0,3,1
29091,5,3,101979,101979,101982,0,3,2
29092,2,1,101981,101982,101983,1,2,0
29093,3,3,101984,101984,101987,0,3,1
29094,6,1,101990,101990,101991,0,1,3
29095,4,3,101994,101994,101997,0,3,3
29096,4,1,101998,101998,101999,0,1,1
29097,1,1,101999,101999,102000,0,1,0
29098,5,1,102004,102004,102005,0,1,4
29099,5,3,102009,102009,102012,0,3,4
29100,3,2,102012,102012,102014,0,2,0
29101,5,1,102017,102017,102018,0,1,3
29102,5,3,102022,102022,102025,0,3,4
29103,6,1,102028,102028,102029,0,1,3
29104,1,1,102029,102029,102030,0,1,0
29105,6,1,102035,102035,102036,0,1,5
29106,4,3,102039,102039,102042,0,3,3
29107,5,3,102044,102044,102047,0,3,2
29108,1,3,102045,102047,102050,2,5,0
29109,1,3,102046,102050,102053,4,7,0
29110,4,2,102050,102053,102055,3,5,0
29111,2,3,102052,102055,102058,3,6,0
29112,5,2,102057,102058,102060,1,3,0
29113,2,1,102059,102060,102061,1,2,0
29114,1,3,102060,102061,102064,1,4,0
29115,3,1,102063,102064,102065,1,2,0
29116,4,2,102067,102067,102069,0,2,2
29117,1,2,102068,102069,102071,1,3,0
29118,3,3,102071,102071,102074,0,3,0
29119,4,2,102075,102075,102077,0,2,1
29120,1,2,102076,102077,102079,1,3,0
29121,1,3,102077,102079,102082,2,5,0
29122,6,2,102083,102083,102085,0,2,1
29123,1,1,102084,102085,102086,1,2,0
29124,1,2,102085,102086,102088,1,3,0
29125,3,3,102088,102088,102091,0,3,0
29126,5,3,102093,102093,102096,0,3,2
29127,5,3,102098,102098,102101,0,3,2
29128,3,1,102101,102101,102102,0,1,0
29129,2,2,102103,102103,102105,0,2,1
29130,1,1,102104,102105,102106,1,2,0
29131,2,1,102106,102106,102107,0,1,0
29132,5,2,102111,102111,102113,0,2,4
29133,5,3,102116,102116,102119,0,3,3
29134,3,2,102119,102119,102121,0,2,0
29135,3,1,102122,102122,102123,0,1,1
29136,2,3,102124,102124,102127,0,3,1
29137,5,3,102129,102129,102132,0,3,2
29138,4,2,102133,102133,102135,0,2,1
29139,1,1,102134,102135,102136,1,2,0
29140,4,2,102138,102138,102140,0,2,2
29141,6,3,102144,102144,102147,0,3,4
29142,4,3,102148,102148,102151,0,3,1
29143,4,1,102152,102152,102153,0,1,1
29144,4,3,102156,102156,102159,0,3,3
29145,6,2,102162,102162,102164,0,2,3
29146,2,1,102164,102164,102165,0,1,0
29147,2,2,102166,102166,102168,0,2,1
29148,4,3,102170,102170,102173,0,3,2
29149,1,1,102171,102173,102174,2,3,0
29150,1,2,102172,102174,102176,2,4,0
29151,2,3,102174,102176,102179,2,5,0
29152,4,1,102178,102179,102180,1,2,0
29153,4,1,102182,102182,102183,0,1,2
29154,2,1,102184,102184,102185,0,1,1
29155,1,3,102185,102185,102188,0,3,0
29156,5,2,102190,102190,102192,0,2,2
29157,1,3,102191,102192,102195,1,4,0
29158,2,3,102193,102195,102198,2,5,0
29159,5,1,102198,102198,102199,0,1,0
29160,6,1,102204,102204,102205,0,1,5
29161,4,3,102208,102208,102211,0,3,3
29162,1,3,102209,102211,102214,2,5,0
29163,6,3,102215,102215,102218,0,3,1
29164,6,1,102221,102221,102222,0,1,3
29165,1,2,102222,102222,102224,0,2,0
29166,1,1,102223,102224,102225,1,2,0
29167,2,1,102225,102225,102226,0,1,0
29168,4,3,102229,102229,102232,0,3,3
29169,2,1,102231,102232,102233,1,2,0
29170,2,2,102233,102233,102235,0,2,0
29171,1,1,102234,102235,102236,1,2,0
29172,6,3,102240,102240,102243,0,3,4
29173,3,3,102243,102243,102246,0,3,0
29174,1,3,102244,102246,102249,2,5,0
29175,1,3,102245,102249,102252,4,7,0
29176,6,2,102251,102252,102254,1,3,0
29177,4,2,102255,102255,102257,0,2,1
29178,5,1,102260,102260,102261,0,1,3
29179,4,2,102264,102264,102266,0,2,3
29180,6,1,102270,102270,102271,0,1,4
29181,6,2,102276,102276,102278,0,2,5
29182,3,3,102279,102279,102282,0,3,1
29183,4,3,102283,102283,102286,0,3,1
29184,3,3,102286,102286,102289,0,3,0
29185,1,2,102287,102289,102291,2,4,0
29186,2,1,102289,102291,102292,2,3,0
29187,6,3,102295,102295,102298,0,3,3
29188,6,1,102301,102301,102302,0,1,3
29189,2,2,102303,102303,102305,0,2,1
29190,6,3,102309,102309,102312,0,3,4
29191,2,1,102311,102312,102313,1,2,0
29192,5,1,102316,102316,102317,0,1,3
29193,2,2,102318,102318,102320,0,2,1
29194,5,1,102323,102323,102324,0,1,3
29195,2,2,102325,102325,102327,0,2,1
29196,4,3,102329,102329,102332,0,3,2
29197,2,1,102331,102332,102333,1,2,0
29198,2,3,102333,102333,102336,0,3,0
29199,3,2,102336,102336,102338,0,2,0
29200,4,2,102340,102340,102342,0,2,2
29201,6,1,102346,102346,102347,0,1,4
29202,2,1,102348,102348,102349,0,1,1
29203,1,2,102349,102349,102351,0,2,0
29204,4,2,102353,102353,102355,0,2,2
29205,6,3,102359,102359,102362,0,3,4
29206,1,1,102360,102362,102363,2,3,0
29207,3,2,102363,102363,102365,0,2,0
29208,2,1,102365,102365,102366,0,1,0
29209,3,1,102368,102368,102369,0,1,2
29210,1,1,102369,102369,102370,0,1,0
29211,3,1,102372,102372,102373,0,1,2
29212,5,2,102377,102377,102379,0,2,4
29213,6,2,102383,102383,102385,0,2,4
29214,4,1,102387,102387,102388,0,1,2
29215,2,2,102389,102389,102391,0,2,1
29216,1,2,102390,102391,102393,1,3,0
29217,6,1,102396,102396,102397,0,1,3
29218,3,2,102399,102399,102401,0,2,2
29219,3,1,102402,102402,102403,0,1,1
29220,2,2,102404,102404,102406,0,2,1
29221,6,3,102410,102410,102413,0,3,4
29222,4,2,102414,102414,102416,0,2,1
29223,1,3,102415,102416,102419,1,4,0
29224,2,3,102417,102419,102422,2,5,0
29225,4,1,102421,102422,102423,1,2,0
29226,2,1,102423,102423,102424,0,1,0
29227,2,2,102425,102425,102427,0,2,1
29228,5,1,102430,102430,102431,0,1,3
29229,2,3,102432,102432,102435,0,3,1
29230,6,1,102438,102438,102439,0,1,3
29231,1,2,102439,102439,102441,0,2,0
29232,1,1,102440,102441,102442,1,2,0
29233,3,3,102443,102443,102446,0,3,1
29234,5,3,102448,102448,102451,0,3,2
29235,2,1,102450,102451,102452,1,2,0
29236,5,2,102455,102455,102457,0,2,3
29237,4,2,102459,102459,102461,0,2,2
29238,6,1,102465,102465,102466,0,1,4
29239,3,1,102468,102468,102469,0,1,2
29240,3,1,102471,102471,102472,0,1,2
29241,5,2,102476,102476,102478,0,2,4
29242,1,3,102477,102478,102481,1,4,0
29243,6,2,102483,102483,102485,0,2,2
29244,2,2,102485,102485,102487,0,2,0
29245,2,1,102487,102487,102488,0,1,0
29246,6,1,102493,102493,102494,0,1,5
29247,5,2,102498,102498,102500,0,2,4
29248,2,2,102500,102500,102502,0,2,0
29249,6,2,102506,102506,102508,0,2,4
29250,6,3,102512,102512,102515,0,3,4
29251,2,1,102514,102515,102516,1,2,0
29252,1,1,102515,102516,102517,1,2,0
29253,1,3,102516,102517,102520,1,4,0
29254,3,2,102519,102520,102522,1,3,0
29255,2,3,102521,102522,102525,1,4,0
29256,6,3,102527,102527,102530,0,3,2
29257,1,1,102528,102530,102531,2,3,0
29258,2,2,102530,102531,102533,1,3,0
29259,3,1,102533,102533,102534,0,1,0
29260,4,2,102537,102537,102539,0,2,3
29261,4,1,102541,102541,102542,0,1,2
29262,6,2,102547,102547,102549,0,2,5
29263,3,2,102550,102550,102552,0,2,1
29264,1,3,102551,102552,102555,1,4,0
29265,3,3,102554,102555,102558,1,4,0
29266,5,2,102559,102559,102561,0,2,1
29267,4,3,102563,102563,102566,0,3,2
29268,2,1,102565,102566,102567,1,2,0
29269,4,1,102569,102569,102570,0,1,2
29270,2,1,102571,102571,102572,0,1,1
29271,5,1,102576,102576,102577,0,1,4
29272,6,1,102582,102582,102583,0,1,5
29273,1,2,102583,102583,102585,0,2,0
29274,2,2,102585,102585,102587,0,2,0
29275,2,2,102587,102587,102589,0,2,0
29276,5,3,102592,102592,102595,0,3,3
29277,5,2,102597,102597,102599,0,2,2
29278,5,2,102602,102602,102604,0,2,3
29279,4,1,102606,102606,102607,0,1,2
29280,4,2,102610,102610,102612,0,2,3
29281,3,2,102613,102613,102615,0,2,1
29282,1,1,102614,102615,102616,1,2,0
29283,2,2,102616,102616,102618,0,2,0
29284,1,1,102617,102618,102619,1,2,0
29285,3,2,102620,102620,102622,0,2,1
29286,2,1,102622,102622,102623,0,1,0
29287,4,2,102626,102626,102628,0,2,3
29288,5,2,102631,102631,102633,0,2,3
29289,5,1,102636,102636,102637,0,1,3
29290,2,2,102638,102638,102640,0,2,1
29291,6,1,102644,102644,102645,0,1,4
29292,5,3,102649,102649,102652,0,3,4
29293,4,2,102653,102653,102655,0,2,1
29294,3,3,102656,102656,102659,0,3,1
29295,4,3,102660,102660,102663,0,3,1
29296,4,3,102664,102664,102667,0,3,1
29297,6,3,102670,102670,102673,0,3,3
29298,4,1,102674,102674,102675,0,1,1
29299,3,1,102677,102677,102678,0,1,2
29300,2,2,102679,102679,102681,0,2,1
29301,6,2,102685,102685,102687,0,2,4
29302,4,3,102689,102689,102692,0,3,2
29303,3,1,102692,102692,102693,0,1,0
29304,5,1,102697,102697,102698,0,1,4
29305,6,1,102703,102703,102704,0,1,5
29306,6,3,102709,102709,102712,0,3,5
29307,3,1,102712,102712,102713,0,1,0
29308,1,3,102713,102713,102716,0,3,0
29309,1,3,102714,102716,102719,2,5,0
29310,4,1,102718,102719,102720,1,2,0
29311,1,2,102719,102720,102722,1,3,0
29312,4,1,102723,102723,102724,0,1,1
29313,2,3,102725,102725,102728,0,3,1
29314,4,3,102729,102729,102732,0,3,1
29315,2,2,102731,102732,102734,1,3,0
29316,2,1,102733,102734,102735,1,2,0
29317,5,2,102738,102738,102740,0,2,3
29318,3,2,102741,102741,102743,0,2,1
29319,4,2,102745,102745,102747,0,2,2
29320,2,1,102747,102747,102748,0,1,0
29321,1,2,102748,102748,102750,0,2,0
29322,3,3,102751,102751,102754,0,3,1
29323,4,3,102755,102755,102758,0,3,1
29324,1,3,102756,102758,102761,2,5,0
29325,3,3,102759,102761,102764,2,5,0
29326,6,1,102765,102765,102766,0,1,1
29327,1,1,102766,102766,102767,0,1,0
29328,2,1,102768,102768,102769,0,1,1
29329,4,3,102772,102772,102775,0,3,3
29330,3,1,102775,102775,102776,0,1,0
29331,4,1,102779,102779,102780,0,1,3
29332,5,1,102784,102784,102785,0,1,4
29333,3,1,102787,102787,102788,0,1,2
29334,6,3,102793,102793,102796,0,3,5
29335,3,1,102796,102796,102797,0,1,0
29336,4,2,102800,102800,102802,0,2,3
29337,1,1,102801,102802,102803,1,2,0
29338,4,2,102805,102805,102807,0,2,2
29339,6,1,102811,102811,102812,0,1,4
29340,6,3,102817,102817,102820,0,3,5
29341,3,1,102820,102820,102821,0,1,0
29342,2,3,102822,102822,102825,0,3,1
29343,4,3,102826,102826,102829,0,3,1
29344,5,2,102831,102831,102833,0,2,2
29345,5,2,102836,102836,102838,0,2,3
29346,2,2,102838,102838,102840,0,2,0
29347,3,1,102841,102841,102842,0,1,1
29348,5,1,102846,102846,102847,0,1,4
29349,5,3,102851,102851,102854,0,3,4
29350,6,1,102857,102857,102858,0,1,3
29351,1,3,102858,102858,102861,0,3,0
29352,1,1,102859,102861,102862,2,3,0
29353,4,3,102863,102863,102866,0,3,1
29354,3,2,102866,102866,102868,0,2,0
29355,4,3,102870,102870,102873,0,3,2
29356,2,3,102872,102873,102876,1,4,0
29357,4,2,102876,102876,102878,0,2,0
29358,5,3,102881,102881,102884,0,3,3
29359,3,2,102884,102884,102886,0,2,0
29360,6,2,102890,102890,102892,0,2,4
29361,6,1,102896,102896,102897,0,1,4
29362,4,2,102900,102900,102902,0,2,3
29363,4,1,102904,102904,102905,0,1,2
29364,2,1,102906,102906,102907,0,1,1
29365,6,2,102912,102912,102914,0,2,5
29366,5,2,102917,102917,102919,0,2,3
29367,5,2,102922,102922,102924,0,2,3
29368,5,2,102927,102927,102929,0,2,3
29369,3,1,102930,102930,102931,0,1,1
29370,5,3,102935,102935,102938,0,3,4
29371,4,1,102939,102939,102940,0,1,1
29372,3,1,102942,102942,102943,0,1,2
29373,6,2,102948,102948,102950,0,2,5
29374,2,1,102950,102950,102951,0,1,0
29375,4,3,102954,102954,102957,0,3,3
29376,3,1,102957,102957,102958,0,1,0
29377,1,3,102958,102958,102961,0,3,0
29378,3,2,102961,102961,102963,0,2,0
29379,1,1,102962,102963,102964,1,2,0
29380,1,1,102963,102964,102965,1,2,0
29381,4,3,102967,102967,102970,0,3,2
29382,3,3,102970,102970,102973,0,3,0
29383,1,3,102971,102973,102976,2,5,0
29384,4,3,102975,102976,102979,1,4,0
29385,4,2,102979,102979,102981,0,2,0
29386,5,2,102984,102984,102986,0,2,3
29387,4,1,102988,102988,102989,0,1,2
29388,3,3,102991,102991,102994,0,3,2
29389,6,3,102997,102997,103000,0,3,3
29390,6,3,103003,103003,103006,0,3,3
29391,5,2,103008,103008,103010,0,2,2
29392,1,2,103009,103010,103012,1,3,0
29393,5,3,103014,103014,103017,0,3,2
29394,5,3,103019,103019,103022,0,3,2
29395,6,1,103025,103025,103026,0,1,3
29396,1,2,103026,103026,103028,0,2,0
29397,3,1,103029,103029,103030,0,1,1
29398,5,2,103034,103034,103036,0,2,4
29399,2,2,103036,103036,103038,0,2,0
29400,2,2,103038,103038,103040,0,2,0
29401,5,1,103043,103043,103044,0,1,3
29402,6,3,103049,103049,103052,0,3,5
29403,6,2,103055,103055,103057,0,2,3
29404,1,2,103056,103057,103059,1,3,0
29405,4,1,103060,103060,103061,0,1,1
29406,2,2,103062,103062,103064,0,2,1
29407,3,3,103065,103065,103068,0,3,1
29408,4,1,103069,103069,103070,0,1,1
29409,2,2,103071,103071,103073,0,2,1
29410,5,1,103076,103076,103077,0,1,3
29411,2,3,103078,103078,103081,0,3,1
29412,2,3,103080,103081,103084,1,4,0
29413,6,1,103086,103086,103087,0,1,2
29414,1,1,103087,103087,103088,0,1,0
29415,5,2,103092,103092,103094,0,2,4
29416,3,2,103095,103095,103097,0,2,1
29417,2,1,103097,103097,103098,0,1,0
29418,6,1,103103,103103,103104,0,1,5
29419,4,2,103107,103107,103109,0,2,3
29420,4,2,103111,103111,103113,0,2,2
29421,4,2,103115,103115,103117,0,2,2
29422,2,1,103117,103117,103118,0,1,0
29423,4,2,103121,103121,103123,0,2,3
29424,6,2,103127,103127,103129,0,2,4
29425,6,3,103133,103133,103136,0,3,4
29426,4,2,103137,103137,103139,0,2,1
29427,1,2,103138,103139,103141,1,3,0
29428,4,2,103142,103142,103144,0,2,1
29429,1,2,103143,103144,103146,1,3,0
29430,6,1,103149,103149,103150,0,1,3
29431,6,3,103155,103155,103158,0,3,5
29432,1,1,103156,103158,103159,2,3,0
29433,3,3,103159,103159,103162,0,3,0
29434,5,1,103164,103164,103165,0,1,2
29435,3,2,103167,103167,103169,0,2,2
29436,2,1,103169,103169,103170,0,1,0
29437,4,2,103173,103173,103175,0,2,3
29438,3,1,103176,103176,103177,0,1,1
29439,1,3,103177,103177,103180,0,3,0
29440,5,2,103182,103182,103184,0,2,2
29441,4,2,103186,103186,103188,0,2,2
29442,4,2,103190,103190,103192,0,2,2
29443,5,3,103195,103195,103198,0,3,3
29444,2,3,103197,103198,103201,1,4,0
29445,1,3,103198,103201,103204,3,6,0
29446,4,1,103202,103204,103205,2,3,0
29447,5,1,103207,103207,103208,0,1,2
29448,6,2,103213,103213,103215,0,2,5
29449,1,3,103214,103215,103218,1,4,0
29450,6,1,103220,103220,103221,0,1,2
29451,5,1,103225,103225,103226,0,1,4
29452,3,3,103228,103228,103231,0,3,2
29453,4,2,103232,103232,103234,0,2,1
29454,2,3,103234,103234,103237,0,3,0
29455,3,3,103237,103237,103240,0,3,0
29456,3,1,103240,103240,103241,0,1,0
29457,4,3,103244,103244,103247,0,3,3
29458,2,1,103246,103247,103248,1,2,0
29459,4,3,103250,103250,103253,0,3,2
29460,6,2,103256,103256,103258,0,2,3
29461,4,1,103260,103260,103261,0,1,2
29462,4,2,103264,103264,103266,0,2,3
29463,4,2,103268,103268,103270,0,2,2
29464,2,3,103270,103270,103273,0,3,0
29465,5,1,103275,103275,103276,0,1,2
29466,4,3,103279,103279,103282,0,3,3
29467,6,1,103285,103285,103286,0,1,3
29468,6,1,103291,103291,103292,0,1,5
29469,6,1,103297,103297,103298,0,1,5
29470,4,3,103301,103301,103304,0,3,3
29471,6,2,103307,103307,103309,0,2,3
29472,6,3,103313,103313,103316,0,3,4
29473,5,1,103318,103318,103319,0,1,2
29474,1,1,103319,103319,103320,0,1,0
29475,3,2,103322,103322,103324,0,2,2
29476,5,3,103327,103327,103330,0,3,3
29477,3,2,103330,103330,103332,0,2,0
29478,1,1,103331,103332,103333,1,2,0
29479,2,1,103333,103333,103334,0,1,0
29480,6,2,103339,103339,103341,0,2,5
29481,5,3,103344,103344,103347,0,3,3
29482,4,1,103348,103348,103349,0,1,1
29483,1,2,103349,103349,103351,0,2,0
29484,6,3,103355,103355,103358,0,3,4
29485,4,3,103359,103359,103362,0,3,1
29486,3,3,103362,103362,103365,0,3,0
29487,3,2,103365,103365,103367,0,2,0
29488,2,1,103367,103367,103368,0,1,0
29489,4,2,103371,103371,103373,0,2,3
29490,6,2,103377,103377,103379,0,2,4
29491,3,1,103380,103380,103381,0,1,1
29492,4,1,103384,103384,103385,0,1,3
29493,5,3,103389,103389,103392,0,3,4
29494,3,2,103392,103392,103394,0,2,0
29495,4,3,103396,103396,103399,0,3,2
29496,5,2,103401,103401,103403,0,2,2
29497,2,2,103403,103403,103405,0,2,0
29498,5,2,103408,103408,103410,0,2,3
29499,2,3,103410,103410,103413,0,3,0
29500,6,2,103416,103416,103418,0,2,3
29501,4,1,103420,103420,103421,0,1,2
29502,3,2,103423,103423,103425,0,2,2
29503,2,2,103425,103425,103427,0,2,0
29504,3,1,103428,103428,103429,0,1,1
29505,2,1,103430,103430,103431,0,1,1
29506,3,2,103433,103433,103435,0,2,2
29507,2,2,103435,103435,103437,0,2,0
29508,3,2,103438,103438,103440,0,2,1
29509,5,3,103443,103443,103446,0,3,3
29510,3,3,103446,103446,103449,0,3,0
29511,4,1,103450,103450,103451,0,1,1
29512,2,3,103452,103452,103455,0,3,1
29513,1,1,103453,103455,103456,2,3,0
29514,4,3,103457,103457,103460,0,3,1
29515,2,3,103459,103460,103463,1,4,0
29516,1,2,103460,103463,103465,3,5,0
29517,6,1,103466,103466,103467,0,1,1
29518,5,1,103471,103471,103472,0,1,4
29519,5,1,103476,103476,103477,0,1,4
29520,3,2,103479,103479,103481,0,2,2
29521,6,3,103485,103485,103488,0,3,4
29522,5,1,103490,103490,103491,0,1,2
29523,4,3,103494,103494,103497,0,3,3
29524,3,3,103497,103497,103500,0,3,0
29525,4,1,103501,103501,103502,0,1,1
29526,6,2,103507,103507,103509,0,2,5
29527,1,3,103508,103509,103512,1,4,0
29528,1,3,103509,103512,103515,3,6,0
29529,5,3,103514,103515,103518,1,4,0
29530,2,1,103516,103518,103519,2,3,0
29531,3,3,103519,103519,103522,0,3,0
29532,4,3,103523,103523,103526,0,3,1
29533,1,3,103524,103526,103529,2,5,0
29534,2,2,103526,103529,103531,3,5,0
29535,2,1,103528,103531,103532,3,4,0
29536,5,1,103533,103533,103534,0,1,1
29537,3,1,103536,103536,103537,0,1,2
29538,4,3,103540,103540,103543,0,3,3
29539,1,3,103541,103543,103546,2,5,0
29540,6,2,103547,103547,103549,0,2,1
29541,6,2,103553,103553,103555,0,2,4
29542,1,1,103554,103555,103556,1,2,0
29543,6,2,103560,103560,103562,0,2,4
29544,4,3,103564,103564,103567,0,3,2
29545,3,2,103567,103567,103569,0,2,0
29546,2,2,103569,103569,103571,0,2,0
29547,6,3,103575,103575,103578,0,3,4
29548,5,1,103580,103580,103581,0,1,2
29549,3,2,103583,103583,103585,0,2,2
29550,3,2,103586,103586,103588,0,2,1
29551,6,2,103592,103592,103594,0,2,4
29552,5,1,103597,103597,103598,0,1,3
29553,3,1,103600,103600,103601,0,1,2
29554,5,1,103605,103605,103606,0,1,4
29555,3,1,103608,103608,103609,0,1,2
29556,6,3,103614,103614,103617,0,3,5
29557,3,2,103617,103617,103619,0,2,0
29558,1,1,103618,103619,103620,1,2,0
29559,6,2,103624,103624,103626,0,2,4
29560,4,2,103628,103628,103630,0,2,2
29561,6,3,103634,103634,103637,0,3,4
29562,3,3,103637,103637,103640,0,3,0
29563,5,3,103642,103642,103645,0,3,2
29564,4,1,103646,103646,103647,0,1,1
29565,6,3,103652,103652,103655,0,3,5
29566,4,2,103656,103656,103658,0,2,1
29567,3,1,103659,103659,103660,0,1,1
29568,1,1,103660,103660,103661,0,1,0
29569,2,3,103662,103662,103665,0,3,1
29570,6,2,103668,103668,103670,0,2,3
29571,1,2,103669,103670,103672,1,3,0
29572,5,1,103674,103674,103675,0,1,2
29573,6,1,103680,103680,103681,0,1,5
29574,2,3,103682,103682,103685,0,3,1
29575,4,1,103686,103686,103687,0,1,1
29576,3,2,103689,103689,103691,0,2,2
29577,5,2,103694,103694,103696,0,2,3
29578,6,3,103700,103700,103703,0,3,4
29579,3,3,103703,103703,103706,0,3,0
29580,4,3,103707,103707,103710,0,3,1
29581,3,2,103710,103710,103712,0,2,0
29582,5,1,103715,103715,103716,0,1,3
29583,3,2,103718,103718,103720,0,2,2
29584,6,1,103724,103724,103725,0,1,4
29585,1,1,103725,103725,103726,0,1,0
29586,2,2,103727,103727,103729,0,2,1
29587,3,1,103730,103730,103731,0,1,1
29588,1,3,103731,103731,103734,0,3,0
29589,2,1,103733,103734,103735,1,2,0
29590,2,3,103735,103735,103738,0,3,0
29591,6,2,103741,103741,103743,0,2,3
29592,3,2,103744,103744,103746,0,2,1
29593,5,2,103749,103749,103751,0,2,3
29594,4,1,103753,103753,103754,0,1,2
29595,1,3,103754,103754,103757,0,3,0
29596,4,2,103758,103758,103760,0,2,1
29597,5,1,103763,103763,103764,0,1,3
29598,2,2,103765,103765,103767,0,2,1
29599,5,2,103770,103770,103772,0,2,3
29600,3,1,103773,103773,103774,0,1,1
29601,3,3,103776,103776,103779,0,3,2
29602,1,1,103777,103779,103780,2,3,0
29603,5,3,103782,103782,103785,0,3,2
29604,3,3,103785,103785,103788,0,3,0
29605,3,2,103788,103788,103790,0,2,0
29606,4,2,103792,103792,103794,0,2,2
29607,3,3,103795,103795,103798,0,3,1
29608,6,1,103801,103801,103802,0,1,3
29609,6,1,103807,103807,103808,0,1,5
29610,1,1,103808,103808,103809,0,1,0
29611,6,2,103814,103814,103816,0,2,5
29612,2,1,103816,103816,103817,0,1,0
29613,5,2,103821,103821,103823,0,2,4
29614,6,1,103827,103827,103828,0,1,4
29615,3,3,103830,103830,103833,0,3,2
29616,1,1,103831,103833,103834,2,3,0
29617,3,3,103834,103834,103837,0,3,0
29618,4,3,103838,103838,103841,0,3,1
29619,3,2,103841,103841,103843,0,2,0
29620,5,2,103846,103846,103848,0,2,3
29621,5,2,103851,103851,103853,0,2,3
29622,3,2,103854,103854,103856,0,2,1
29623,4,3,103858,103858,103861,0,3,2
29624,5,1,103863,103863,103864,0,1,2
29625,5,1,103868,103868,103869,0,1,4
29626,5,1,103873,103873,103874,0,1,4
29627,6,3,103879,103879,103882,0,3,5
29628,6,1,103885,103885,103886,0,1,3
29629,1,3,103886,103886,103889,0,3,0
29630,1,2,103887,103889,103891,2,4,0
29631,6,2,103893,103893,103895,0,2,2
29632,2,3,103895,103895,103898,0,3,0
29633,1,2,103896,103898,103900,2,4,0
29634,4,2,103900,103900,103902,0,2,0
29635,5,1,103905,103905,103906,0,1,3
29636,2,1,103907,103907,103908,0,1,1
29637,6,3,103913,103913,103916,0,3,5
29638,1,2,103914,103916,103918,2,4,0
29639,1,1,103915,103918,103919,3,4,0
29640,6,2,103921,103921,103923,0,2,2
29641,2,3,103923,103923,103926,0,3,0
29642,1,1,103924,103926,103927,2,3,0
29643,4,3,103928,103928,103931,0,3,1
29644,2,3,103930,103931,103934,1,4,0
29645,2,3,103932,103934,103937,2,5,0
29646,6,2,103938,103938,103940,0,2,1
29647,3,2,103941,103941,103943,0,2,1
29648,4,1,103945,103945,103946,0,1,2
29649,4,3,103949,103949,103952,0,3,3
29650,5,3,103954,103954,103957,0,3,2
29651,1,2,103955,103957,103959,2,4,0
29652,6,2,103961,103961,103963,0,2,2
29653,3,1,103964,103964,103965,0,1,1
29654,3,3,103967,103967,103970,0,3,2
29655,2,2,103969,103970,103972,1,3,0
29656,4,1,103973,103973,103974,0,1,1
29657,3,3,103976,103976,103979,0,3,2
29658,6,2,103982,103982,103984,0,2,3
29659,1,2,103983,103984,103986,1,3,0
29660,2,1,103985,103986,103987,1,2,0
29661,3,3,103988,103988,103991,0,3,1
29662,6,3,103994,103994,103997,0,3,3
29663,1,3,103995,103997,104000,2,5,0
29664,2,2,103997,104000,104002,3,5,0
29665,1,2,103998,104002,104004,4,6,0
29666,6,3,104004,104004,104007,0,3,0
29667,3,2,104007,104007,104009,0,2,0
29668,3,3,104010,104010,104013,0,3,1
29669,1,3,104011,104013,104016,2,5,0
29670,1,3,104012,104016,104019,4,7,0
29671,6,2,104018,104019,104021,1,3,0
29672,6,2,104024,104024,104026,0,2,3
29673,6,3,104030,104030,104033,0,3,4
29674,4,1,104034,104034,104035,0,1,1
29675,2,1,104036,104036,104037,0,1,1
29676,6,1,104042,104042,104043,0,1,5
29677,4,3,104046,104046,104049,0,3,3
29678,2,1,104048,104049,104050,1,2,0
29679,4,2,104052,104052,104054,0,2,2
29680,4,2,104056,104056,104058,0,2,2
29681,5,1,104061,104061,104062,0,1,3
29682,1,3,104062,104062,104065,0,3,0
29683,1,1,104063,104065,104066,2,3,0
29684,6,2,104069,104069,104071,0,2,3
29685,2,2,104071,104071,104073,0,2,0
29686,5,3,104076,104076,104079,0,3,3
29687,1,1,104077,104079,104080,2,3,0
29688,4,3,104081,104081,104084,0,3,1
29689,4,2,104085,104085,104087,0,2,1
29690,5,2,104090,104090,104092,0,2,3
29691,4,2,104094,104094,104096,0,2,2
29692,2,1,104096,104096,104097,0,1,0
29693,3,1,104099,104099,104100,0,1,2
29694,4,3,104103,104103,104106,0,3,3
29695,6,3,104109,104109,104112,0,3,3
29696,6,2,104115,104115,104117,0,2,3
29697,5,2,104120,104120,104122,0,2,3
29698,4,3,104124,104124,104127,0,3,2
29699,6,2,104130,104130,104132,0,2,3
29700,3,1,104133,104133,104134,0,1,1
29701,6,2,104139,104139,104141,0,2,5
29702,3,2,104142,104142,104144,0,2,1
29703,3,3,104145,104145,104148,0,3,1
29704,2,1,104147,104148,104149,1,2,0
29705,2,3,104149,104149,104152,0,3,0
29706,4,3,104153,104153,104156,0,3,1
29707,6,3,104159,104159,104162,0,3,3
29708,5,3,104164,104164,104167,0,3,2
29709,4,1,104168,104168,104169,0,1,1
29710,2,3,104170,104170,104173,0,3,1
29711,5,1,104175,104175,104176,0,1,2
29712,1,2,104176,104176,104178,0,2,0
29713,5,2,104181,104181,104183,0,2,3
29714,3,1,104184,104184,104185,0,1,1
29715,3,2,104187,104187,104189,0,2,2
29716,6,2,104193,104193,104195,0,2,4
29717,1,3,104194,104195,104198,1,4,0
29718,3,1,104197,104198,104199,1,2,0
29719,2,2,104199,104199,104201,0,2,0
29720,2,1,104201,104201,104202,0,1,0
29721,5,2,104206,104206,104208,0,2,4
29722,2,1,104208,104208,104209,0,1,0
29723,6,1,104214,104214,104215,0,1,5
29724,5,1,104219,104219,104220,0,1,4
29725,6,3,104225,104225,104228,0,3,5
29726,4,2,104229,104229,104231,0,2,1
29727,2,1,104231,104231,104232,0,1,0
29728,2,3,104233,104233,104236,0,3,1
29729,2,2,104235,104236,104238,1,3,0
29730,4,3,104239,104239,104242,0,3,1
29731,2,3,104241,104242,104245,1,4,0
29732,2,3,104243,104245,104248,2,5,0
29733,2,2,104245,104248,104250,3,5,0
29734,1,3,104246,104250,104253,4,7,0
29735,2,2,104248,104253,104255,5,7,0
29736,5,3,104253,104255,104258,2,5,0
29737,4,3,104257,104258,104261,1,4,0
29738,1,3,104258,104261,104264,3,6,0
29739,5,2,104263,104264,104266,1,3,0
29740,2,3,104265,104266,104269,1,4,0
29741,2,3,104267,104269,104272,2,5,0
29742,5,1,104272,104272,104273,0,1,0
29743,1,3,104273,104273,104276,0,3,0
29744,1,2,104274,104276,104278,2,4,0
29745,2,2,104276,104278,104280,2,4,0
29746,2,1,104278,104280,104281,2,3,0
29747,1,2,104279,104281,104283,2,4,0
29748,5,2,104284,104284,104286,0,2,1
29749,1,1,104285,104286,104287,1,2,0
29750,1,1,104286,104287,104288,1,2,0
29751,3,3,104289,104289,104292,0,3,1
29752,2,2,104291,104292,104294,1,3,0
29753,1,2,104292,104294,104296,2,4,0
29754,5,2,104297,104297,104299,0,2,1
29755,2,2,104299,104299,104301,0,2,0
29756,5,1,104304,104304,104305,0,1,3
29757,6,3,104310,104310,104313,0,3,5
29758,2,3,104312,104313,104316,1,4,0
29759,1,1,104313,104316,104317,3,4,0
29760,6,3,104319,104319,104322,0,3,2
29761,6,3,104325,104325,104328,0,3,3
29762,4,3,104329,104329,104332,0,3,1
29763,2,1,104331,104332,104333,1,2,0
29764,4,2,104335,104335,104337,0,2,2
29765,5,2,104340,104340,104342,0,2,3
29766,1,1,104341,104342,104343,1,2,0
29767,1,1,104342,104343,104344,1,2,0
29768,4,3,104346,104346,104349,0,3,2
29769,5,3,104351,104351,104354,0,3,2
29770,4,3,104355,104355,104358,0,3,1
29771,3,3,104358,104358,104361,0,3,0
29772,4,2,104362,104362,104364,0,2,1
29773,6,1,104368,104368,104369,0,1,4
29774,2,2,104370,104370,104372,0,2,1
29775,6,2,104376,104376,104378,0,2,4
29776,2,1,104378,104378,104379,0,1,0
29777,1,3,104379,104379,104382,0,3,0
29778,3,3,104382,104382,104385,0,3,0
29779,1,3,104383,104385,104388,2,5,0
29780,5,3,104388,104388,104391,0,3,0
29781,6,3,104394,104394,104397,0,3,3
29782,2,1,104396,104397,104398,1,2,0
29783,1,1,104397,104398,104399,1,2,0
29784,1,3,104398,104399,104402,1,4,0
29785,4,1,104402,104402,104403,0,1,0
29786,3,1,104405,104405,104406,0,1,2
29787,6,1,104411,104411,104412,0,1,5
29788,3,3,104414,104414,104417,0,3,2
29789,2,1,104416,104417,104418,1,2,0
29790,2,1,104418,104418,104419,0,1,0
29791,1,2,104419,104419,104421,0,2,0
29792,6,1,104425,104425,104426,0,1,4
29793,4,2,104429,104429,104431,0,2,3
29794,2,2,104431,104431,104433,0,2,0
29795,3,2,104434,104434,104436,0,2,1
29796,6,2,104440,104440,104442,0,2,4
29797,3,3,104443,104443,104446,0,3,1
29798,4,2,104447,104447,104449,0,2,1
29799,6,3,104453,104453,104456,0,3,4
29800,3,1,104456,104456,104457,0,1,0
29801,2,2,104458,104458,104460,0,2,1
29802,2,3,104460,104460,104463,0,3,0
29803,6,3,104466,104466,104469,0,3,3
29804,6,3,104472,104472,104475,0,3,3
29805,3,2,104475,104475,104477,0,2,0
29806,6,1,104481,104481,104482,0,1,4
29807,3,2,104484,104484,104486,0,2,2
29808,4,3,104488,104488,104491,0,3,2
29809,3,3,104491,104491,104494,0,3,0
29810,1,2,104492,104494,104496,2,4,0
29811,1,2,104493,104496,104498,3,5,0
29812,4,3,104497,104498,104501,1,4,0
29813,1,3,104498,104501,104504,3,6,0
29814,1,2,104499,104504,104506,5,7,0
29815,4,2,104503,104506,104508,3,5,0
29816,3,3,104506,104508,104511,2,5,0
29817,5,1,104511,104511,104512,0,1,0
29818,5,3,104516,104516,104519,0,3,4
29819,4,2,104520,104520,104522,0,2,1
29820,2,3,104522,104522,104525,0,3,0
29821,4,2,104526,104526,104528,0,2,1
29822,5,3,104531,104531,104534,0,3,3
29823,6,3,104537,104537,104540,0,3,3
29824,3,3,104540,104540,104543,0,3,0
29825,2,1,104542,104543,104544,1,2,0
29826,5,3,104547,104547,104550,0,3,3
29827,3,2,104550,104550,104552,0,2,0
29828,6,3,104556,104556,104559,0,3,4
29829,2,2,104558,104559,104561,1,3,0
29830,4,1,104562,104562,104563,0,1,1
29831,5,1,104567,104567,104568,0,1,4
29832,3,2,104570,104570,104572,0,2,2
29833,1,3,104571,104572,104575,1,4,0
29834,1,2,104572,104575,104577,3,5,0
29835,6,2,104578,104578,104580,0,2,1
29836,3,2,104581,104581,104583,0,2,1
29837,1,1,104582,104583,104584,1,2,0
29838,4,2,104586,104586,104588,0,2,2
29839,6,3,104592,104592,104595,0,3,4
29840,6,3,104598,104598,104601,0,3,3
29841,4,3,104602,104602,104605,0,3,1
29842,5,1,104607,104607,104608,0,1,2
29843,2,2,104609,104609,104611,0,2,1
29844,1,1,104610,104611,104612,1,2,0
29845,3,3,104613,104613,104616,0,3,1
29846,2,3,104615,104616,104619,1,4,0
29847,4,3,104619,104619,104622,0,3,0
29848,1,1,104620,104622,104623,2,3,0
29849,1,2,104621,104623,104625,2,4,0
29850,2,2,104623,104625,104627,2,4,0
29851,3,3,104626,104627,104630,1,4,0
29852,6,2,104632,104632,104634,0,2,2
29853,2,3,104634,104634,104637,0,3,0
29854,2,3,104636,104637,104640,1,4,0
29855,3,3,104639,104640,104643,1,4,0
29856,3,1,104642,104643,104644,1,2,0
29857,1,2,104643,104644,104646,1,3,0
29858,4,1,104647,104647,104648,0,1,1
29859,1,2,104648,104648,104650,0,2,0
29860,4,1,104652,104652,104653,0,1,2
29861,5,1,104657,104657,104658,0,1,4
29862,3,3,104660,104660,104663,0,3,2
29863,5,2,104665,104665,104667,0,2,2
29864,4,1,104669,104669,104670,0,1,2
29865,2,1,104671,104671,104672,0,1,1
29866,5,2,104676,104676,104678,0,2,4
29867,6,1,104682,104682,104683,0,1,4
29868,2,1,104684,104684,104685,0,1,1
29869,3,2,104687,104687,104689,0,2,2
29870,5,2,104692,104692,104694,0,2,3
29871,5,2,104697,104697,104699,0,2,3
29872,1,2,104698,104699,104701,1,3,0
29873,5,3,104703,104703,104706,0,3,2
29874,6,1,104709,104709,104710,0,1,3
29875,1,2,104710,104710,104712,0,2,0
29876,4,1,104714,104714,104715,0,1,2
29877,3,1,104717,104717,104718,0,1,2
29878,5,3,104722,104722,104725,0,3,4
29879,4,3,104726,104726,104729,0,3,1
29880,3,2,104729,104729,104731,0,2,0
29881,1,3,104730,104731,104734,1,4,0
29882,5,2,104735,104735,104737,0,2,1
29883,6,2,104741,104741,104743,0,2,4
29884,1,1,104742,104743,104744,1,2,0
29885,4,1,104746,104746,104747,0,1,2
29886,3,2,104749,104749,104751,0,2,2
29887,3,3,104752,104752,104755,0,3,1
29888,2,2,104754,104755,104757,1,3,0
29889,6,1,104760,104760,104761,0,1,3
29890,2,2,104762,104762,104764,0,2,1
29891,4,1,104766,104766,104767,0,1,2
29892,3,2,104769,104769,104771,0,2,2
29893,4,2,104773,104773,104775,0,2,2
29894,6,1,104779,104779,104780,0,1,4
29895,3,1,104782,104782,104783,0,1,2
29896,6,1,104788,104788,104789,0,1,5
29897,4,3,104792,104792,104795,0,3,3
29898,2,3,104794,104795,104798,1,4,0
29899,4,1,104798,104798,104799,0,1,0
29900,4,3,104802,104802,104805,0,3,3
29901,2,2,104804,104805,104807,1,3,0
29902,2,2,104806,104807,104809,1,3,0
29903,2,3,104808,104809,104812,1,4,0
29904,6,3,104814,104814,104817,0,3,2
29905,5,1,104819,104819,104820,0,1,2
29906,4,2,104823,104823,104825,0,2,3
29907,5,1,104828,104828,104829,0,1,3
29908,1,2,104829,104829,104831,0,2,0
29909,3,1,104832,104832,104833,0,1,1
29910,4,2,104836,104836,104838,0,2,3
29911,6,3,104842,104842,104845,0,3,4
29912,3,1,104845,104845,104846,0,1,0
29913,3,1,104848,104848,104849,0,1,2
29914,2,3,104850,104850,104853,0,3,1
29915,2,2,104852,104853,104855,1,3,0
29916,1,2,104853,104855,104857,2,4,0
29917,6,3,104859,104859,104862,0,3,2
29918,3,2,104862,104862,104864,0,2,0
29919,5,3,104867,104867,104870,0,3,3
29920,1,1,104868,104870,104871,2,3,0
29921,3,1,104871,104871,104872,0,1,0
29922,4,3,104875,104875,104878,0,3,3
29923,6,1,104881,104881,104882,0,1,3
29924,1,3,104882,104882,104885,0,3,0
29925,6,3,104888,104888,104891,0,3,3
29926,6,1,104894,104894,104895,0,1,3
29927,5,1,104899,104899,104900,0,1,4
29928,4,2,104903,104903,104905,0,2,3
29929,2,1,104905,104905,104906,0,1,0
29930,2,2,104907,104907,104909,0,2,1
29931,3,3,104910,104910,104913,0,3,1
29932,2,1,104912,104913,104914,1,2,0
29933,2,3,104914,104914,104917,0,3,0
29934,5,1,104919,104919,104920,0,1,2
29935,1,1,104920,104920,104921,0,1,0
29936,3,3,104923,104923,104926,0,3,2
29937,1,3,104924,104926,104929,2,5,0
29938,4,2,104928,104929,104931,1,3,0
29939,5,1,104933,104933,104934,0,1,2
29940,4,2,104937,104937,104939,0,2,3
29941,5,3,104942,104942,104945,0,3,3
29942,2,1,104944,104945,104946,1,2,0
29943,6,1,104950,104950,104951,0,1,4
29944,4,3,104954,104954,104957,0,3,3
29945,4,2,104958,104958,104960,0,2,1
29946,4,2,104962,104962,104964,0,2,2
29947,4,3,104966,104966,104969,0,3,2
29948,6,1,104972,104972,104973,0,1,3
29949,1,3,104973,104973,104976,0,3,0
29950,6,1,104979,104979,104980,0,1,3
29951,4,1,104983,104983,104984,0,1,3
29952,5,3,104988,104988,104991,0,3,4
29953,6,3,104994,104994,104997,0,3,3
29954,2,3,104996,104997,105000,1,4,0
29955,4,2,105000,105000,105002,0,2,0
29956,1,3,105001,105002,105005,1,4,0
29957,5,1,105006,105006,105007,0,1,1
29958,4,3,105010,105010,105013,0,3,3
29959,5,2,105015,105015,105017,0,2,2
29960,4,1,105019,105019,105020,0,1,2
29961,3,1,105022,105022,105023,0,1,2
29962,1,2,105023,105023,105025,0,2,0
29963,2,2,105025,105025,105027,0,2,0
29964,4,2,105029,105029,105031,0,2,2
29965,4,2,105033,105033,105035,0,2,2
29966,4,1,105037,105037,105038,0,1,2
29967,1,2,105038,105038,105040,0,2,0
29968,2,1,105040,105040,105041,0,1,0
29969,4,1,105044,105044,105045,0,1,3
29970,5,3,105049,105049,105052,0,3,4
29971,6,3,105055,105055,105058,0,3,3
29972,1,1,105056,105058,105059,2,3,0
29973,2,3,105058,105059,105062,1,4,0
29974,4,2,105062,105062,105064,0,2,0
29975,4,2,105066,105066,105068,0,2,2
29976,1,2,105067,105068,105070,1,3,0
29977,1,1,105068,105070,105071,2,3,0
29978,3,1,105071,105071,105072,0,1,0
29979,2,2,105073,105073,105075,0,2,1
29980,6,3,105079,105079,105082,0,3,4
29981,5,2,105084,105084,105086,0,2,2
29982,6,3,105090,105090,105093,0,3,4
29983,4,3,105094,105094,105097,0,3,1
29984,1,2,105095,105097,105099,2,4,0
29985,1,2,105096,105099,105101,3,5,0
29986,4,2,105100,105101,105103,1,3,0
29987,4,2,105104,105104,105106,0,2,1
29988,3,3,105107,105107,105110,0,3,1
29989,6,3,105113,105113,105116,0,3,3
29990,4,2,105117,105117,105119,0,2,1
29991,3,1,105120,105120,105121,0,1,1
29992,5,1,105125,105125,105126,0,1,4
29993,5,1,105130,105130,105131,0,1,4
29994,1,2,105131,105131,105133,0,2,0
29995,3,1,105134,105134,105135,0,1,1
29996,4,2,105138,105138,105140,0,2,3
29997,3,3,105141,105141,105144,0,3,1
29998,4,2,105145,105145,105147,0,2,1
29999,2,3,105147,105147,105150,0,3,0
30000,4,1,105151,105151,105152,0,1,1
30001,2,1,105153,105153,105154,0,1,1
30002,6,3,105159,105159,105162,0,3,5
30003,5,1,105164,105164,105165,0,1,2
30004,5,2,105169,105169,105171,0,2,4
30005,5,1,105174,105174,105175,0,1,3
30006,6,3,105180,105180,105183,0,3,5
30007,2,2,105182,105183,105185,1,3,0
30008,1,2,105183,105185,105187,2,4,0
30009,2,3,105185,105187,105190,2,5,0
30010,5,2,105190,105190,105192,0,2,0
30011,5,1,105195,105195,105196,0,1,3
30012,4,1,105199,105199,105200,0,1,3
30013,3,3,105202,105202,105205,0,3,2
30014,3,1,105205,105205,105206,0,1,0
30015,4,1,105209,105209,105210,0,1,3
30016,3,2,105212,105212,105214,0,2,2
30017,2,3,105214,105214,105217,0,3,0
30018,1,2,105215,105217,105219,2,4,0
30019,1,1,105216,105219,105220,3,4,0
30020,5,1,105221,105221,105222,0,1,1
30021,4,3,105225,105225,105228,0,3,3
30022,1,1,105226,105228,105229,2,3,0
30023,4,1,105230,105230,105231,0,1,1
30024,5,2,105235,105235,105237,0,2,4
30025,3,2,105238,105238,105240,0,2,1
30026,5,1,105243,105243,105244,0,1,3
30027,4,3,105247,105247,105250,0,3,3
30028,3,2,105250,105250,105252,0,2,0
30029,3,2,105253,105253,105255,0,2,1
30030,6,1,105259,105259,105260,0,1,4
30031,2,2,105261,105261,105263,0,2,1
30032,1,1,105262,105263,105264,1,2,0
30033,1,2,105263,105264,105266,1,3,0
30034,5,1,105268,105268,105269,0,1,2
30035,2,3,105270,105270,105273,0,3,1
30036,6,2,105276,105276,105278,0,2,3
30037,6,3,105282,105282,105285,0,3,4
30038,6,1,105288,105288,105289,0,1,3
30039,1,3,105289,105289,105292,0,3,0
30040,2,1,105291,105292,105293,1,2,0
30041,1,1,105292,105293,105294,1,2,0
30042,5,1,105297,105297,105298,0,1,3
30043,3,2,105300,105300,105302,0,2,2
30044,5,3,105305,105305,105308,0,3,3
30045,6,1,105311,105311,105312,0,1,3
30046,4,1,105315,105315,105316,0,1,3
30047,4,2,105319,105319,105321,0,2,3
30048,3,1,105322,105322,105323,0,1,1
30049,4,3,105326,105326,105329,0,3,3
30050,2,1,105328,105329,105330,1,2,0
30051,3,2,105331,105331,105333,0,2,1
30052,6,3,105337,105337,105340,0,3,4
30053,1,2,105338,105340,105342,2,4,0
30054,5,3,105343,105343,105346,0,3,1
30055,6,2,105349,105349,105351,0,2,3
30056,5,2,105354,105354,105356,0,2,3
30057,6,1,105360,105360,105361,0,1,4
30058,1,1,105361,105361,105362,0,1,0
30059,4,1,105365,105365,105366,0,1,3
30060,4,3,105369,105369,105372,0,3,3
30061,5,3,105374,105374,105377,0,3,2
30062,5,3,105379,105379,105382,0,3,2
30063,5,1,105384,105384,105385,0,1,2
30064,5,1,105389,105389,105390,0,1,4
30065,3,1,105392,105392,105393,0,1,2
30066,5,1,105397,105397,105398,0,1,4
30067,1,2,105398,105398,105400,0,2,0
30068,4,2,105402,105402,105404,0,2,2
30069,1,3,105403,105404,105407,1,4,0
30070,2,2,105405,105407,105409,2,4,0
30071,4,2,105409,105409,105411,0,2,0
30072,3,3,105412,105412,105415,0,3,1
30073,1,1,105413,105415,105416,2,3,0
30074,2,2,105415,105416,105418,1,3,0
30075,4,3,105419,105419,105422,0,3,1
30076,2,1,105421,105422,105423,1,2,0
30077,5,3,105426,105426,105429,0,3,3
30078,2,2,105428,105429,105431,1,3,0
30079,5,1,105433,105433,105434,0,1,2
30080,5,1,105438,105438,105439,0,1,4
30081,1,3,105439,105439,105442,0,3,0
30082,5,2,105444,105444,105446,0,2,2
30083,5,2,105449,105449,105451,0,2,3
30084,2,3,105451,105451,105454,0,3,0
30085,6,2,105457,105457,105459,0,2,3
30086,3,1,105460,105460,105461,0,1,1
30087,4,3,105464,105464,105467,0,3,3
30088,3,3,105467,105467,105470,0,3,0
30089,5,1,105472,105472,105473,0,1,2
30090,4,3,105476,105476,105479,0,3,3
30091,5,3,105481,105481,105484,0,3,2
30092,2,3,105483,105484,105487,1,4,0
30093,3,3,105486,105487,105490,1,4,0
30094,3,1,105489,105490,105491,1,2,0
30095,3,1,105492,105492,105493,0,1,1
30096,2,3,105494,105494,105497,0,3,1
30097,2,3,105496,105497,105500,1,4,0
30098,4,3,105500,105500,105503,0,3,0
30099,5,3,105505,105505,105508,0,3,2
30100,2,2,105507,105508,105510,1,3,0
30101,2,3,105509,105510,105513,1,4,0
30102,1,2,105510,105513,105515,3,5,0
30103,4,3,105514,105515,105518,1,4,0
30104,4,2,105518,105518,105520,0,2,0
30105,6,1,105524,105524,105525,0,1,4
30106,1,2,105525,105525,105527,0,2,0
30107,1,2,105526,105527,105529,1,3,0
30108,2,1,105528,105529,105530,1,2,0
30109,4,2,105532,105532,105534,0,2,2
30110,1,2,105533,105534,105536,1,3,0
30111,6,1,105539,105539,105540,0,1,3
30112,2,1,105541,105541,105542,0,1,1
30113,4,1,105545,105545,105546,0,1,3
30114,4,1,105549,105549,105550,0,1,3
30115,1,1,105550,105550,105551,0,1,0
30116,6,2,105556,105556,105558,0,2,5
30117,4,1,105560,105560,105561,0,1,2
30118,3,2,105563,105563,105565,0,2,2
30119,2,3,105565,105565,105568,0,3,0
30120,6,1,105571,105571,105572,0,1,3
30121,1,1,105572,105572,105573,0,1,0
30122,5,2,105577,105577,105579,0,2,4
30123,3,1,105580,105580,105581,0,1,1
30124,5,3,105585,105585,105588,0,3,4
30125,6,3,105591,105591,105594,0,3,3
30126,6,3,105597,105597,105600,0,3,3
30127,4,1,105601,105601,105602,0,1,1
30128,1,2,105602,105602,105604,0,2,0
30129,6,3,105608,105608,105611,0,3,4
30130,4,2,105612,105612,105614,0,2,1
30131,5,2,105617,105617,105619,0,2,3
30132,6,1,105623,105623,105624,0,1,4
30133,3,2,105626,105626,105628,0,2,2
30134,4,2,105630,105630,105632,0,2,2
30135,1,1,105631,105632,105633,1,2,0
30136,5,2,105636,105636,105638,0,2,3
30137,4,1,105640,105640,105641,0,1,2
30138,2,2,105642,105642,105644,0,2,1
30139,4,1,105646,105646,105647,0,1,2
30140,1,3,105647,105647,105650,0,3,0
30141,3,3,105650,105650,105653,0,3,0
30142,6,1,105656,105656,105657,0,1,3
30143,3,2,105659,105659,105661,0,2,2
30144,1,2,105660,105661,105663,1,3,0
30145,3,2,105663,105663,105665,0,2,0
30146,4,2,105667,105667,105669,0,2,2
30147,4,1,105671,105671,105672,0,1,2
30148,2,3,105673,105673,105676,0,3,1
30149,6,2,105679,105679,105681,0,2,3
30150,1,3,105680,105681,105684,1,4,0
30151,5,1,105685,105685,105686,0,1,1
30152,4,1,105689,105689,105690,0,1,3
30153,6,1,105695,105695,105696,0,1,5
30154,6,2,105701,105701,105703,0,2,5
30155,4,1,105705,105705,105706,0,1,2
30156,2,3,105707,105707,105710,0,3,1
30157,5,1,105712,105712,105713,0,1,2
30158,4,3,105716,105716,105719,0,3,3
30159,1,3,105717,105719,105722,2,5,0
30160,6,3,105723,105723,105726,0,3,1
30161,6,1,105729,105729,105730,0,1,3
30162,2,2,105731,105731,105733,0,2,1
30163,2,3,105733,105733,105736,0,3,0
30164,1,3,105734,105736,105739,2,5,0
30165,6,2,105740,105740,105742,0,2,1
30166,1,1,105741,105742,105743,1,2,0
30167,6,3,105747,105747,105750,0,3,4
30168,6,2,105753,105753,105755,0,2,3
30169,5,2,105758,105758,105760,0,2,3
30170,4,2,105762,105762,105764,0,2,2
30171,3,1,105765,105765,105766,0,1,1
30172,2,1,105767,105767,105768,0,1,1
30173,6,2,105773,105773,105775,0,2,5
30174,5,2,105778,105778,105780,0,2,3
30175,5,3,105783,105783,105786,0,3,3
30176,6,3,105789,105789,105792,0,3,3
30177,2,1,105791,105792,105793,1,2,0
30178,4,2,105795,105795,105797,0,2,2
30179,3,2,105798,105798,105800,0,2,1
30180,1,3,105799,105800,105803,1,4,0
30181,6,2,105805,105805,105807,0,2,2
30182,5,1,105810,105810,105811,0,1,3
30183,6,3,105816,105816,105819,0,3,5
30184,1,3,105817,105819,105822,2,5,0
30185,6,1,105823,105823,105824,0,1,1
30186,1,2,105824,105824,105826,0,2,0
30187,1,2,105825,105826,105828,1,3,0
30188,5,1,105830,105830,105831,0,1,2
30189,3,2,105833,105833,105835,0,2,2
30190,5,3,105838,105838,105841,0,3,3
30191,4,1,105842,105842,105843,0,1,1
30192,4,1,105846,105846,105847,0,1,3
30193,6,2,105852,105852,105854,0,2,5
30194,5,1,105857,105857,105858,0,1,3
30195,2,3,105859,105859,105862,0,3,1
30196,1,3,105860,105862,105865,2,5,0
30197,4,3,105864,105865,105868,1,4,0
30198,1,3,105865,105868,105871,3,6,0
30199,2,3,105867,105871,105874,4,7,0
30200,1,1,105868,105874,105875,6,7,0
30201,1,1,105869,105875,105876,6,7,0
30202,3,2,105872,105876,105878,4,6,0
30203,4,3,105876,105878,105881,2,5,0
30204,6,2,105882,105882,105884,0,2,1
30205,5,2,105887,105887,105889,0,2,3
30206,1,1,105888,105889,105890,1,2,0
30207,1,1,105889,105890,105891,1,2,0
30208,2,1,105891,105891,105892,0,1,0
30209,4,3,105895,105895,105898,0,3,3
30210,1,2,105896,105898,105900,2,4,0
30211,2,1,105898,105900,105901,2,3,0
30212,6,3,105904,105904,105907,0,3,3
30213,6,3,105910,105910,105913,0,3,3
30214,4,3,105914,105914,105917,0,3,1
30215,6,2,105920,105920,105922,0,2,3
30216,1,3,105921,105922,105925,1,4,0
30217,4,3,105925,105925,105928,0,3,0
30218,1,3,105926,105928,105931,2,5,0
30219,1,3,105927,105931,105934,4,7,0
30220,6,1,105933,105934,105935,1,2,0
30221,4,1,105937,105937,105938,0,1,2
30222,5,1,105942,105942,105943,0,1,4
30223,3,2,105945,105945,105947,0,2,2
30224,2,1,105947,105947,105948,0,1,0
30225,3,2,105950,105950,105952,0,2,2
30226,6,3,105956,105956,105959,0,3,4
30227,1,3,105957,105959,105962,2,5,0
30228,5,1,105962,105962,105963,0,1,0
30229,5,3,105967,105967,105970,0,3,4
30230,6,1,105973,105973,105974,0,1,3
30231,4,1,105977,105977,105978,0,1,3
30232,5,3,105982,105982,105985,0,3,4
30233,3,1,105985,105985,105986,0,1,0
30234,6,3,105991,105991,105994,0,3,5
30235,6,3,105997,105997,106000,0,3,3
30236,3,1,106000,106000,106001,0,1,0
30237,4,2,106004,106004,106006,0,2,3
30238,4,3,106008,106008,106011,0,3,2
30239,5,1,106013,106013,106014,0,1,2
30240,6,3,106019,106019,106022,0,3,5
30241,2,3,106021,106022,106025,1,4,0
30242,6,3,106027,106027,106030,0,3,2
30243,2,2,106029,106030,106032,1,3,0
30244,3,3,106032,106032,106035,0,3,0
30245,2,1,106034,106035,106036,1,2,0
30246,3,1,106037,106037,106038,0,1,1
30247,6,3,106043,106043,106046,0,3,5
30248,1,1,106044,106046,106047,2,3,0
30249,4,2,106048,106048,106050,0,2,1
30250,1,3,106049,106050,106053,1,4,0
30251,2,1,106051,106053,106054,2,3,0
30252,3,2,106054,106054,106056,0,2,0
30253,3,1,106057,106057,106058,0,1,1
30254,1,3,106058,106058,106061,0,3,0
30255,1,1,106059,106061,106062,2,3,0
30256,2,1,106061,106062,106063,1,2,0
30257,3,2,106064,106064,106066,0,2,1
30258,5,3,106069,106069,106072,0,3,3
30259,2,3,106071,106072,106075,1,4,0
30260,4,3,106075,106075,106078,0,3,0
30261,1,1,106076,106078,106079,2,3,0
30262,5,3,106081,106081,106084,0,3,2
30263,4,1,106085,106085,106086,0,1,1
30264,6,1,106091,106091,106092,0,1,5
30265,4,3,106095,106095,106098,0,3,3
30266,4,2,106099,106099,106101,0,2,1
30267,6,1,106105,106105,106106,0,1,4
30268,6,1,106111,106111,106112,0,1,5
30269,3,3,106114,106114,106117,0,3,2
30270,1,3,106115,106117,106120,2,5,0
30271,2,2,106117,106120,106122,3,5,0
30272,3,1,106120,106122,106123,2,3,0
30273,4,3,106124,106124,106127,0,3,1
30274,2,1,106126,106127,106128,1,2,0
30275,6,2,106132,106132,106134,0,2,4
30276,6,3,106138,106138,106141,0,3,4
30277,6,1,106144,106144,106145,0,1,3
30278,3,1,106147,106147,106148,0,1,2
30279,4,3,106151,106151,106154,0,3,3
30280,2,3,106153,106154,106157,1,4,0
30281,6,2,106159,106159,106161,0,2,2
30282,6,1,106165,106165,106166,0,1,4
30283,5,3,106170,106170,106173,0,3,4
30284,6,3,106176,106176,106179,0,3,3
30285,5,3,106181,106181,106184,0,3,2
30286,2,1,106183,106184,106185,1,2,0
30287,6,2,106189,106189,106191,0,2,4
30288,6,1,106195,106195,106196,0,1,4
30289,3,3,106198,106198,106201,0,3,2
30290,6,3,106204,106204,106207,0,3,3
30291,6,2,106210,106210,106212,0,2,3
30292,3,1,106213,106213,106214,0,1,1
30293,4,3,106217,106217,106220,0,3,3
30294,5,1,106222,106222,106223,0,1,2
30295,2,3,106224,106224,106227,0,3,1
30296,4,1,106228,106228,106229,0,1,1
30297,5,2,106233,106233,106235,0,2,4
30298,4,3,106237,106237,106240,0,3,2
30299,2,1,106239,106240,106241,1,2,0
30300,6,3,106245,106245,106248,0,3,4
30301,6,3,106251,106251,106254,0,3,3
30302,5,1,106256,106256,106257,0,1,2
30303,1,1,106257,106257,106258,0,1,0
30304,3,3,106260,106260,106263,0,3,2
30305,5,1,106265,106265,106266,0,1,2
30306,3,1,106268,106268,106269,0,1,2
30307,3,3,106271,106271,106274,0,3,2
30308,6,1,106277,106277,106278,0,1,3
30309,3,1,106280,106280,106281,0,1,2
30310,6,1,106286,106286,106287,0,1,5
30311,3,1,106289,106289,106290,0,1,2
30312,1,3,106290,106290,106293,0,3,0
30313,1,3,106291,106293,106296,2,5,0
30314,4,3,106295,106296,106299,1,4,0
30315,4,2,106299,106299,106301,0,2,0
30316,5,2,106304,106304,106306,0,2,3
30317,3,2,106307,106307,106309,0,2,1
30318,6,2,106313,106313,106315,0,2,4
30319,6,3,106319,106319,106322,0,3,4
30320,6,1,106325,106325,106326,0,1,3
30321,4,3,106329,106329,106332,0,3,3
30322,6,2,106335,106335,106337,0,2,3
30323,3,2,106338,106338,106340,0,2,1
30324,6,3,106344,106344,106347,0,3,4
30325,6,2,106350,106350,106352,0,2,3
30326,6,3,106356,106356,106359,0,3,4
30327,5,2,106361,106361,106363,0,2,2
30328,5,3,106366,106366,106369,0,3,3
30329,2,3,106368,106369,106372,1,4,0
30330,2,2,106370,106372,106374,2,4,0
30331,2,2,106372,106374,106376,2,4,0
30332,5,2,106377,106377,106379,0,2,1
30333,1,3,106378,106379,106382,1,4,0
30334,5,3,106383,106383,106386,0,3,1
30335,5,2,106388,106388,106390,0,2,2
30336,3,1,106391,106391,106392,0,1,1
30337,4,1,106395,106395,106396,0,1,3
30338,6,3,106401,106401,106404,0,3,5
30339,1,3,106402,106404,106407,2,5,0
30340,5,3,106407,106407,106410,0,3,0
30341,6,2,106413,106413,106415,0,2,3
30342,1,2,106414,106415,106417,1,3,0
30343,4,3,106418,106418,106421,0,3,1
30344,5,3,106423,106423,106426,0,3,2
30345,4,3,106427,106427,106430,0,3,1
30346,5,2,106432,106432,106434,0,2,2
30347,6,1,106438,106438,106439,0,1,4
30348,5,2,106443,106443,106445,0,2,4
30349,6,2,106449,106449,106451,0,2,4
30350,5,2,106454,106454,106456,0,2,3
30351,1,2,106455,106456,106458,1,3,0
30352,6,1,106461,106461,106462,0,1,3
30353,6,1,106467,106467,106468,0,1,5
30354,6,3,106473,106473,106476,0,3,5
30355,1,2,106474,106476,106478,2,4,0
30356,1,2,106475,106478,106480,3,5,0
30357,5,1,106480,106480,106481,0,1,0
30358,4,3,106484,106484,106487,0,3,3
30359,2,3,106486,106487,106490,1,4,0
30360,1,2,106487,106490,106492,3,5,0
30361,6,2,106493,106493,106495,0,2,1
30362,6,1,106499,106499,106500,0,1,4
30363,5,1,106504,106504,106505,0,1,4
30364,5,2,106509,106509,106511,0,2,4
30365,3,1,106512,106512,106513,0,1,1
30366,4,1,106516,106516,106517,0,1,3
30367,6,2,106522,106522,106524,0,2,5
30368,5,1,106527,106527,106528,0,1,3
30369,3,2,106530,106530,106532,0,2,2
30370,1,3,106531,106532,106535,1,4,0
30371,1,2,106532,106535,106537,3,5,0
30372,6,1,106538,106538,106539,0,1,1
30373,6,3,106544,106544,106547,0,3,5
30374,2,3,106546,106547,106550,1,4,0
30375,3,2,106549,106550,106552,1,3,0
30376,3,3,106552,106552,106555,0,3,0
30377,4,2,106556,106556,106558,0,2,1
30378,4,1,106560,106560,106561,0,1,2
30379,5,3,106565,106565,106568,0,3,4
30380,4,3,106569,106569,106572,0,3,1
30381,2,1,106571,106572,106573,1,2,0
30382,2,1,106573,106573,106574,0,1,0
30383,1,2,106574,106574,106576,0,2,0
30384,4,3,106578,106578,106581,0,3,2
30385,1,2,106579,106581,106583,2,4,0
30386,3,2,106582,106583,106585,1,3,0
30387,1,3,106583,106585,106588,2,5,0
30388,4,2,106587,106588,106590,1,3,0
30389,4,2,106591,106591,106593,0,2,1
30390,1,1,106592,106593,106594,1,2,0
30391,5,1,106597,106597,106598,0,1,3
30392,3,3,106600,106600,106603,0,3,2
30393,6,1,106606,106606,106607,0,1,3
30394,5,1,106611,106611,106612,0,1,4
30395,1,3,106612,106612,106615,0,3,0
30396,6,2,106618,106618,106620,0,2,3
30397,3,1,106621,106621,106622,0,1,1
30398,6,1,106627,106627,106628,0,1,5
30399,5,2,106632,106632,106634,0,2,4
30400,3,2,106635,106635,106637,0,2,1
30401,4,1,106639,106639,106640,0,1,2
30402,6,1,106645,106645,106646,0,1,5
30403,6,1,106651,106651,106652,0,1,5
30404,1,3,106652,106652,106655,0,3,0
30405,2,2,106654,106655,106657,1,3,0
30406,2,1,106656,106657,106658,1,2,0
30407,2,1,106658,106658,106659,0,1,0
30408,2,1,106660,106660,106661,0,1,1
30409,1,1,106661,106661,106662,0,1,0
30410,3,1,106664,106664,106665,0,1,2
30411,1,3,106665,106665,106668,0,3,0
30412,4,2,106669,106669,106671,0,2,1
30413,2,2,106671,106671,106673,0,2,0
30414,5,2,106676,106676,106678,0,2,3
30415,5,3,106681,106681,106684,0,3,3
30416,1,1,106682,106684,106685,2,3,0
30417,5,2,106687,106687,106689,0,2,2
30418,1,3,106688,106689,106692,1,4,0
30419,5,1,106693,106693,106694,0,1,1
30420,4,3,106697,106697,106700,0,3,3
30421,2,1,106699,106700,106701,1,2,0
30422,2,3,106701,106701,106704,0,3,0
30423,2,3,106703,106704,106707,1,4,0
30424,5,2,106708,106708,106710,0,2,1
30425,4,1,106712,106712,106713,0,1,2
30426,3,2,106715,106715,106717,0,2,2
30427,6,3,106721,106721,106724,0,3,4
30428,4,3,106725,106725,106728,0,3,1
30429,5,3,106730,106730,106733,0,3,2
30430,3,3,106733,106733,106736,0,3,0
30431,4,1,106737,106737,106738,0,1,1
30432,4,3,106741,106741,106744,0,3,3
30433,1,1,106742,106744,106745,2,3,0
30434,1,2,106743,106745,106747,2,4,0
30435,6,2,106749,106749,106751,0,2,2
30436,6,3,106755,106755,106758,0,3,4
30437,5,2,106760,106760,106762,0,2,2
30438,1,1,106761,106762,106763,1,2,0
30439,6,3,106767,106767,106770,0,3,4
30440,3,2,106770,106770,106772,0,2,0
30441,5,2,106775,106775,106777,0,2,3
30442,1,1,106776,106777,106778,1,2,0
30443,5,1,106781,106781,106782,0,1,3
30444,6,3,106787,106787,106790,0,3,5
30445,6,2,106793,106793,106795,0,2,3
30446,2,2,106795,106795,106797,0,2,0
30447,1,3,106796,106797,106800,1,4,0
30448,2,1,106798,106800,106801,2,3,0
30449,3,2,106801,106801,106803,0,2,0
30450,4,2,106805,106805,106807,0,2,2
30451,2,3,106807,106807,106810,0,3,0
30452,4,1,106811,106811,106812,0,1,1
30453,4,3,106815,106815,106818,0,3,3
30454,5,3,106820,106820,106823,0,3,2
30455,3,2,106823,106823,106825,0,2,0
30456,2,3,106825,106825,106828,0,3,0
30457,4,3,106829,106829,106832,0,3,1
30458,3,2,106832,106832,106834,0,2,0
30459,3,3,106835,106835,106838,0,3,1
30460,2,2,106837,106838,106840,1,3,0
30461,1,1,106838,106840,106841,2,3,0
30462,6,1,106844,106844,106845,0,1,3
30463,1,2,106845,106845,106847,0,2,0
30464,4,2,106849,106849,106851,0,2,2
30465,1,3,106850,106851,106854,1,4,0
30466,4,1,106854,106854,106855,0,1,0
30467,3,2,106857,106857,106859,0,2,2
30468,4,1,106861,106861,106862,0,1,2
30469,4,3,106865,106865,106868,0,3,3
30470,4,1,106869,106869,106870,0,1,1
30471,1,3,106870,106870,106873,0,3,0
30472,6,3,106876,106876,106879,0,3,3
30473,3,3,106879,106879,106882,0,3,0
30474,1,1,106880,106882,106883,2,3,0
30475,4,1,106884,106884,106885,0,1,1
30476,3,1,106887,106887,106888,0,1,2
30477,4,1,106891,106891,106892,0,1,3
30478,2,1,106893,106893,106894,0,1,1
30479,4,2,106897,106897,106899,0,2,3
30480,2,1,106899,106899,106900,0,1,0
30481,6,3,106905,106905,106908,0,3,5
30482,4,1,106909,106909,106910,0,1,1
30483,3,3,106912,106912,106915,0,3,2
30484,2,2,106914,106915,106917,1,3,0
30485,1,3,106915,106917,106920,2,5,0
30486,1,2,106916,106920,106922,4,6,0
30487,5,3,106921,106922,106925,1,4,0
30488,6,3,106927,106927,106930,0,3,2
30489,5,3,106932,106932,106935,0,3,2
30490,4,2,106936,106936,106938,0,2,1
30491,3,3,106939,106939,106942,0,3,1
30492,2,1,106941,106942,106943,1,2,0
30493,5,3,106946,106946,106949,0,3,3
30494,1,2,106947,106949,106951,2,4,0
30495,3,3,106950,106951,106954,1,4,0
30496,6,2,106956,106956,106958,0,2,2
30497,3,2,106959,106959,106961,0,2,1
30498,1,3,106960,106961,106964,1,4,0
30499,4,3,106964,106964,106967,0,3,0
30500,4,2,106968,106968,106970,0,2,1
30501,4,2,106972,106972,106974,0,2,2
30502,2,3,106974,106974,106977,0,3,0
30503,4,3,106978,106978,106981,0,3,1
30504,6,1,106984,106984,106985,0,1,3
30505,5,3,106989,106989,106992,0,3,4
30506,3,1,106992,106992,106993,0,1,0
30507,4,3,106996,106996,106999,0,3,3
30508,4,2,107000,107000,107002,0,2,1
30509,1,3,107001,107002,107005,1,4,0
30510,2,2,107003,107005,107007,2,4,0
30511,3,1,107006,107007,107008,1,2,0
30512,2,2,107008,107008,107010,0,2,0
30513,6,2,107014,107014,107016,0,2,4
30514,3,1,107017,107017,107018,0,1,1
30515,3,1,107020,107020,107021,0,1,2
30516,6,2,107026,107026,107028,0,2,5
30517,6,1,107032,107032,107033,0,1,4
30518,2,1,107034,107034,107035,0,1,1
30519,6,1,107040,107040,107041,0,1,5
30520,3,3,107043,107043,107046,0,3,2
30521,1,1,107044,107046,107047,2,3,0
30522,4,3,107048,107048,107051,0,3,1
30523,6,1,107054,107054,107055,0,1,3
30524,5,3,107059,107059,107062,0,3,4
30525,4,2,107063,107063,107065,0,2,1
30526,2,3,107065,107065,107068,0,3,0
30527,1,3,107066,107068,107071,2,5,0
30528,2,1,107068,107071,107072,3,4,0
30529,6,2,107074,107074,107076,0,2,2
30530,6,1,107080,107080,107081,0,1,4
30531,5,2,107085,107085,107087,0,2,4
30532,4,1,107089,107089,107090,0,1,2
30533,5,2,107094,107094,107096,0,2,4
30534,4,1,107098,107098,107099,0,1,2
30535,1,1,107099,107099,107100,0,1,0
30536,4,3,107103,107103,107106,0,3,3
30537,5,2,107108,107108,107110,0,2,2
30538,1,2,107109,107110,107112,1,3,0
30539,4,3,107113,107113,107116,0,3,1
30540,1,3,107114,107116,107119,2,5,0
30541,4,1,107118,107119,107120,1,2,0
30542,4,1,107122,107122,107123,0,1,2
30543,5,3,107127,107127,107130,0,3,4
30544,6,2,107133,107133,107135,0,2,3
30545,2,3,107135,107135,107138,0,3,0
30546,5,2,107140,107140,107142,0,2,2
30547,4,2,107144,107144,107146,0,2,2
30548,1,3,107145,107146,107149,1,4,0
30549,1,2,107146,107149,107151,3,5,0
30550,2,2,107148,107151,107153,3,5,0
30551,6,2,107154,107154,107156,0,2,1
30552,5,3,107159,107159,107162,0,3,3
30553,5,2,107164,107164,107166,0,2,2
30554,3,3,107167,107167,107170,0,3,1
30555,6,2,107173,107173,107175,0,2,3
30556,1,2,107174,107175,107177,1,3,0
30557,4,1,107178,107178,107179,0,1,1
30558,6,3,107184,107184,107187,0,3,5
30559,3,3,107187,107187,107190,0,3,0
30560,1,2,107188,107190,107192,2,4,0
30561,6,1,107194,107194,107195,0,1,2
30562,6,1,107200,107200,107201,0,1,5
30563,3,1,107203,107203,107204,0,1,2
30564,3,3,107206,107206,107209,0,3,2
30565,5,2,107211,107211,107213,0,2,2
30566,2,3,107213,107213,107216,0,3,0
30567,2,2,107215,107216,107218,1,3,0
30568,2,3,107217,107218,107221,1,4,0
30569,5,3,107222,107222,107225,0,3,1
30570,2,1,107224,107225,107226,1,2,0
30571,3,2,107227,107227,107229,0,2,1
30572,5,1,107232,107232,107233,0,1,3
30573,5,1,107237,107237,107238,0,1,4
30574,3,1,107240,107240,107241,0,1,2
30575,3,2,107243,107243,107245,0,2,2
30576,4,1,107247,107247,107248,0,1,2
30577,2,1,107249,107249,107250,0,1,1
30578,5,2,107254,107254,107256,0,2,4
30579,6,2,107260,107260,107262,0,2,4
30580,4,2,107264,107264,107266,0,2,2
30581,6,1,107270,107270,107271,0,1,4
30582,6,3,107276,107276,107279,0,3,5
30583,3,3,107279,107279,107282,0,3,0
30584,1,1,107280,107282,107283,2,3,0
30585,6,1,107286,107286,107287,0,1,3
30586,6,1,107292,107292,107293,0,1,5
30587,2,1,107294,107294,107295,0,1,1
30588,2,2,107296,107296,107298,0,2,1
30589,5,3,107301,107301,107304,0,3,3
30590,2,3,107303,107304,107307,1,4,0
30591,4,2,107307,107307,107309,0,2,0
30592,1,3,107308,107309,107312,1,4,0
30593,1,1,107309,107312,107313,3,4,0
30594,6,1,107315,107315,107316,0,1,2
30595,5,2,107320,107320,107322,0,2,4
30596,6,2,107326,107326,107328,0,2,4
30597,4,3,107330,107330,107333,0,3,2
30598,2,1,107332,107333,107334,1,2,0
30599,4,2,107336,107336,107338,0,2,2
30600,3,3,107339,107339,107342,0,3,1
30601,5,2,107344,107344,107346,0,2,2
30602,1,2,107345,107346,107348,1,3,0
30603,6,2,107351,107351,107353,0,2,3
30604,5,1,107356,107356,107357,0,1,3
30605,5,1,107361,107361,107362,0,1,4
30606,6,2,107367,107367,107369,0,2,5
30607,1,3,107368,107369,107372,1,4,0
30608,6,1,107374,107374,107375,0,1,2
30609,4,3,107378,107378,107381,0,3,3
30610,4,2,107382,107382,107384,0,2,1
30611,2,2,107384,107384,107386,0,2,0
30612,6,2,107390,107390,107392,0,2,4
30613,5,1,107395,107395,107396,0,1,3
30614,5,2,107400,107400,107402,0,2,4
30615,4,1,107404,107404,107405,0,1,2
30616,5,2,107409,107409,107411,0,2,4
30617,4,2,107413,107413,107415,0,2,2
30618,3,3,107416,107416,107419,0,3,1
30619,1,1,107417,107419,107420,2,3,0
30620,6,2,107423,107423,107425,0,2,3
30621,4,3,107427,107427,107430,0,3,2
30622,4,1,107431,107431,107432,0,1,1
30623,6,2,107437,107437,107439,0,2,5
30624,2,2,107439,107439,107441,0,2,0
30625,2,1,107441,107441,107442,0,1,0
30626,3,3,107444,107444,107447,0,3,2
30627,5,2,107449,107449,107451,0,2,2
30628,4,3,107453,107453,107456,0,3,2
30629,3,1,107456,107456,107457,0,1,0
30630,6,3,107462,107462,107465,0,3,5
30631,3,3,107465,107465,107468,0,3,0
30632,2,3,107467,107468,107471,1,4,0
30633,4,1,107471,107471,107472,0,1,0
30634,5,1,107476,107476,107477,0,1,4
30635,1,1,107477,107477,107478,0,1,0
30636,1,3,107478,107478,107481,0,3,0
30637,4,2,107482,107482,107484,0,2,1
30638,2,3,107484,107484,107487,0,3,0
30639,5,2,107489,107489,107491,0,2,2
30640,1,2,107490,107491,107493,1,3,0
30641,5,1,107495,107495,107496,0,1,2
30642,6,2,107501,107501,107503,0,2,5
30643,6,2,107507,107507,107509,0,2,4
30644,4,3,107511,107511,107514,0,3,2
30645,6,2,107517,107517,107519,0,2,3
30646,3,3,107520,107520,107523,0,3,1
30647,1,1,107521,107523,107524,2,3,0
30648,1,3,107522,107524,107527,2,5,0
30649,5,3,107527,107527,107530,0,3,0
30650,1,1,107528,107530,107531,2,3,0
30651,5,3,107533,107533,107536,0,3,2
30652,2,3,107535,107536,107539,1,4,0
30653,3,1,107538,107539,107540,1,2,0
30654,1,2,107539,107540,107542,1,3,0
30655,2,3,107541,107542,107545,1,4,0
30656,2,3,107543,107545,107548,2,5,0
30657,3,3,107546,107548,107551,2,5,0
30658,1,1,107547,107551,107552,4,5,0
30659,3,2,107550,107552,107554,2,4,0
30660,3,3,107553,107554,107557,1,4,0
30661,3,1,107556,107557,107558,1,2,0
30662,6,3,107562,107562,107565,0,3,4
30663,3,1,107565,107565,107566,0,1,0
30664,3,1,107568,107568,107569,0,1,2
30665,2,1,107570,107570,107571,0,1,1
30666,5,1,107575,107575,107576,0,1,4
30667,6,2,107581,107581,107583,0,2,5
30668,3,1,107584,107584,107585,0,1,1
30669,3,3,107587,107587,107590,0,3,2
30670,5,1,107592,107592,107593,0,1,2
30671,4,2,107596,107596,107598,0,2,3
30672,4,1,107600,107600,107601,0,1,2
30673,3,3,107603,107603,107606,0,3,2
30674,5,3,107608,107608,107611,0,3,2
30675,1,2,107609,107611,107613,2,4,0
30676,2,2,107611,107613,107615,2,4,0
30677,6,2,107617,107617,107619,0,2,2
30678,4,3,107621,107621,107624,0,3,2
30679,6,3,107627,107627,107630,0,3,3
30680,2,2,107629,107630,107632,1,3,0
30681,1,2,107630,107632,107634,2,4,0
30682,1,3,107631,107634,107637,3,6,0
30683,2,2,107633,107637,107639,4,6,0
30684,4,2,107637,107639,107641,2,4,0
30685,3,1,107640,107641,107642,1,2,0
30686,2,1,107642,107642,107643,0,1,0
30687,3,2,107645,107645,107647,0,2,2
30688,3,1,107648,107648,107649,0,1,1
30689,5,2,107653,107653,107655,0,2,4
30690,6,1,107659,107659,107660,0,1,4
30691,2,1,107661,107661,107662,0,1,1
30692,2,2,107663,107663,107665,0,2,1
30693,2,1,107665,107665,107666,0,1,0
30694,4,1,107669,107669,107670,0,1,3
30695,6,1,107675,107675,107676,0,1,5
30696,6,2,107681,107681,107683,0,2,5
30697,2,2,107683,107683,107685,0,2,0
30698,2,3,107685,107685,107688,0,3,0
30699,5,1,107690,107690,107691,0,1,2
30700,5,3,107695,107695,107698,0,3,4
30701,5,2,107700,107700,107702,0,2,2
30702,3,3,107703,107703,107706,0,3,1
30703,6,2,107709,107709,107711,0,2,3
30704,6,3,107715,107715,107718,0,3,4
30705,1,1,107716,107718,107719,2,3,0
30706,3,3,107719,107719,107722,0,3,0
30707,5,1,107724,107724,107725,0,1,2
30708,2,1,107726,107726,107727,0,1,1
30709,6,1,107732,107732,107733,0,1,5
30710,5,2,107737,107737,107739,0,2,4
30711,3,3,107740,107740,107743,0,3,1
30712,4,3,107744,107744,107747,0,3,1
30713,4,2,107748,107748,107750,0,2,1
30714,3,3,107751,107751,107754,0,3,1
30715,3,3,107754,107754,107757,0,3,0
30716,1,2,107755,107757,107759,2,4,0
30717,2,1,107757,107759,107760,2,3,0
30718,6,1,107763,107763,107764,0,1,3
30719,3,1,107766,107766,107767,0,1,2
30720,1,1,107767,107767,107768,0,1,0
30721,2,3,107769,107769,107772,0,3,1
30722,4,3,107773,107773,107776,0,3,1
30723,2,1,107775,107776,107777,1,2,0
30724,2,3,107777,107777,107780,0,3,0
30725,5,3,107782,107782,107785,0,3,2
30726,1,3,107783,107785,107788,2,5,0
30727,3,2,107786,107788,107790,2,4,0
30728,2,1,107788,107790,107791,2,3,0
30729,2,3,107790,107791,107794,1,4,0
30730,4,2,107794,107794,107796,0,2,0
30731,5,1,107799,107799,107800,0,1,3
30732,4,2,107803,107803,107805,0,2,3
30733,2,3,107805,107805,107808,0,3,0
30734,4,2,107809,107809,107811,0,2,1
30735,1,3,107810,107811,107814,1,4,0
30736,5,3,107815,107815,107818,0,3,1
30737,1,2,107816,107818,107820,2,4,0
30738,4,2,107820,107820,107822,0,2,0
30739,2,2,107822,107822,107824,0,2,0
30740,2,1,107824,107824,107825,0,1,0
30741,5,2,107829,107829,107831,0,2,4
30742,2,3,107831,107831,107834,0,3,0
30743,4,2,107835,107835,107837,0,2,1
30744,5,2,107840,107840,107842,0,2,3
30745,3,2,107843,107843,107845,0,2,1
30746,4,1,107847,107847,107848,0,1,2
30747,6,3,107853,107853,107856,0,3,5
30748,6,3,107859,107859,107862,0,3,3
30749,1,3,107860,107862,107865,2,5,0
30750,6,1,107866,107866,107867,0,1,1
30751,6,1,107872,107872,107873,0,1,5
30752,3,2,107875,107875,107877,0,2,2
30753,4,1,107879,107879,107880,0,1,2
30754,1,2,107880,107880,107882,0,2,0
30755,6,2,107886,107886,107888,0,2,4
30756,2,1,107888,107888,107889,0,1,0
30757,6,3,107894,107894,107897,0,3,5
30758,3,1,107897,107897,107898,0,1,0
30759,3,3,107900,107900,107903,0,3,2
30760,1,3,107901,107903,107906,2,5,0
30761,4,3,107905,107906,107909,1,4,0
30762,6,1,107911,107911,107912,0,1,2
30763,3,3,107914,107914,107917,0,3,2
30764,6,3,107920,107920,107923,0,3,3
30765,1,2,107921,107923,107925,2,4,0
30766,6,3,107927,107927,107930,0,3,2
30767,3,3,107930,107930,107933,0,3,0
30768,4,1,107934,107934,107935,0,1,1
30769,3,2,107937,107937,107939,0,2,2
30770,1,3,107938,107939,107942,1,4,0
30771,2,2,107940,107942,107944,2,4,0
30772,4,1,107944,107944,107945,0,1,0
30773,2,2,107946,107946,107948,0,2,1
30774,3,3,107949,107949,107952,0,3,1
30775,3,2,107952,107952,107954,0,2,0
30776,5,3,107957,107957,107960,0,3,3
30777,1,2,107958,107960,107962,2,4,0
30778,1,3,107959,107962,107965,3,6,0
30779,1,2,107960,107965,107967,5,7,0
30780,4,3,107964,107967,107970,3,6,0
30781,2,1,107966,107970,107971,4,5,0
30782,1,2,107967,107971,107973,4,6,0
30783,2,1,107969,107973,107974,4,5,0
30784,6,2,107975,107975,107977,0,2,1
30785,2,3,107977,107977,107980,0,3,0
30786,4,3,107981,107981,107984,0,3,1
30787,4,3,107985,107985,107988,0,3,1
30788,5,2,107990,107990,107992,0,2,2
30789,1,1,107991,107992,107993,1,2,0
30790,2,2,107993,107993,107995,0,2,0
30791,1,1,107994,107995,107996,1,2,0
30792,2,1,107996,107996,107997,0,1,0
30793,4,2,108000,108000,108002,0,2,3
30794,1,2,108001,108002,108004,1,3,0
30795,1,2,108002,108004,108006,2,4,0
30796,3,1,108005,108006,108007,1,2,0
30797,4,3,108009,108009,108012,0,3,2
30798,6,3,108015,108015,108018,0,3,3
30799,6,3,108021,108021,108024,0,3,3
30800,2,2,108023,108024,108026,1,3,0
30801,4,1,108027,108027,108028,0,1,1
30802,4,2,108031,108031,108033,0,2,3
30803,4,1,108035,108035,108036,0,1,2
30804,1,1,108036,108036,108037,0,1,0
30805,5,1,108041,108041,108042,0,1,4
30806,6,2,108047,108047,108049,0,2,5
30807,3,2,108050,108050,108052,0,2,1
30808,1,2,108051,108052,108054,1,3,0
30809,1,1,108052,108054,108055,2,3,0
30810,1,2,108053,108055,108057,2,4,0
30811,1,3,108054,108057,108060,3,6,0
30812,2,3,108056,108060,108063,4,7,0
30813,4,3,108060,108063,108066,3,6,0
30814,5,1,108065,108066,108067,1,2,0
30815,5,1,108070,108070,108071,0,1,3
30816,5,1,108075,108075,108076,0,1,4
30817,3,2,108078,108078,108080,0,2,2
30818,6,3,108084,108084,108087,0,3,4
30819,2,1,108086,108087,108088,1,2,0
30820,5,1,108091,108091,108092,0,1,3
30821,2,2,108093,108093,108095,0,2,1
30822,4,3,108097,108097,108100,0,3,2
30823,2,2,108099,108100,108102,1,3,0
30824,3,2,108102,108102,108104,0,2,0
30825,2,1,108104,108104,108105,0,1,0
30826,6,2,108110,108110,108112,0,2,5
30827,6,1,108116,108116,108117,0,1,4
30828,4,2,108120,108120,108122,0,2,3
30829,4,3,108124,108124,108127,0,3,2
30830,4,2,108128,108128,108130,0,2,1
30831,2,2,108130,108130,108132,0,2,0
30832,5,2,108135,108135,108137,0,2,3
30833,2,2,108137,108137,108139,0,2,0
30834,3,3,108140,108140,108143,0,3,1
30835,6,3,108146,108146,108149,0,3,3
30836,5,1,108151,108151,108152,0,1,2
30837,3,3,108154,108154,108157,0,3,2
30838,2,1,108156,108157,108158,1,2,0
30839,1,2,108157,108158,108160,1,3,0
30840,4,2,108161,108161,108163,0,2,1
30841,1,3,108162,108163,108166,1,4,0
30842,6,3,108168,108168,108171,0,3,2
30843,3,2,108171,108171,108173,0,2,0
30844,5,1,108176,108176,108177,0,1,3
30845,5,3,108181,108181,108184,0,3,4
30846,2,1,108183,108184,108185,1,2,0
30847,3,2,108186,108186,108188,0,2,1
30848,6,1,108192,108192,108193,0,1,4
30849,4,3,108196,108196,108199,0,3,3
30850,2,3,108198,108199,108202,1,4,0
30851,4,2,108202,108202,108204,0,2,0
30852,5,1,108207,108207,108208,0,1,3
30853,4,1,108211,108211,108212,0,1,3
30854,3,3,108214,108214,108217,0,3,2
30855,3,1,108217,108217,108218,0,1,0
30856,6,3,108223,108223,108226,0,3,5
30857,6,3,108229,108229,108232,0,3,3
30858,5,1,108234,108234,108235,0,1,2
30859,4,3,108238,108238,108241,0,3,3
30860,2,3,108240,108241,108244,1,4,0
30861,6,3,108246,108246,108249,0,3,2
30862,4,3,108250,108250,108253,0,3,1
30863,6,3,108256,108256,108259,0,3,3
30864,2,1,108258,108259,108260,1,2,0
30865,5,1,108263,108263,108264,0,1,3
30866,5,2,108268,108268,108270,0,2,4
30867,5,2,108273,108273,108275,0,2,3
30868,3,2,108276,108276,108278,0,2,1
30869,1,1,108277,108278,108279,1,2,0
30870,6,3,108283,108283,108286,0,3,4
30871,4,1,108287,108287,108288,0,1,1
30872,5,3,108292,108292,108295,0,3,4
30873,2,2,108294,108295,108297,1,3,0
30874,6,3,108300,108300,108303,0,3,3
30875,6,2,108306,108306,108308,0,2,3
30876,1,3,108307,108308,108311,1,4,0
30877,1,2,108308,108311,108313,3,5,0
30878,2,3,108310,108313,108316,3,6,0
30879,2,2,108312,108316,108318,4,6,0
30880,2,1,108314,108318,108319,4,5,0
30881,4,3,108318,108319,108322,1,4,0
30882,2,3,108320,108322,108325,2,5,0
30883,3,1,108323,108325,108326,2,3,0
30884,3,1,108326,108326,108327,0,1,0
30885,3,1,108329,108329,108330,0,1,2
30886,1,3,108330,108330,108333,0,3,0
30887,3,3,108333,108333,108336,0,3,0
30888,5,2,108338,108338,108340,0,2,2
30889,4,2,108342,108342,108344,0,2,2
30890,1,1,108343,108344,108345,1,2,0
30891,3,3,108346,108346,108349,0,3,1
30892,3,2,108349,108349,108351,0,2,0
30893,3,1,108352,108352,108353,0,1,1
30894,6,1,108358,108358,108359,0,1,5
30895,4,3,108362,108362,108365,0,3,3
30896,2,3,108364,108365,108368,1,4,0
30897,6,1,108370,108370,108371,0,1,2
30898,2,1,108372,108372,108373,0,1,1
30899,5,2,108377,108377,108379,0,2,4
30900,4,2,108381,108381,108383,0,2,2
30901,6,1,108387,108387,108388,0,1,4
30902,3,3,108390,108390,108393,0,3,2
30903,4,3,108394,108394,108397,0,3,1
30904,1,1,108395,108397,108398,2,3,0
30905,4,3,108399,108399,108402,0,3,1
30906,1,2,108400,108402,108404,2,4,0
30907,2,3,108402,108404,108407,2,5,0
30908,6,1,108408,108408,108409,0,1,1
30909,5,2,108413,108413,108415,0,2,4
30910,3,3,108416,108416,108419,0,3,1
30911,1,1,108417,108419,108420,2,3,0
30912,3,1,108420,108420,108421,0,1,0
30913,1,2,108421,108421,108423,0,2,0
30914,6,2,108427,108427,108429,0,2,4
30915,3,1,108430,108430,108431,0,1,1
30916,5,3,108435,108435,108438,0,3,4
30917,4,1,108439,108439,108440,0,1,1
30918,4,3,108443,108443,108446,0,3,3
30919,1,1,108444,108446,108447,2,3,0
30920,2,2,108446,108447,108449,1,3,0
30921,6,1,108452,108452,108453,0,1,3
30922,5,2,108457,108457,108459,0,2,4
30923,1,3,108458,108459,108462,1,4,0
30924,2,1,108460,108462,108463,2,3,0
30925,1,1,108461,108463,108464,2,3,0
30926,3,1,108464,108464,108465,0,1,0
30927,3,1,108467,108467,108468,0,1,2
30928,6,1,108473,108473,108474,0,1,5
30929,2,2,108475,108475,108477,0,2,1
30930,1,1,108476,108477,108478,1,2,0
30931,2,3,108478,108478,108481,0,3,0
30932,6,3,108484,108484,108487,0,3,3
30933,4,3,108488,108488,108491,0,3,1
30934,1,1,108489,108491,108492,2,3,0
30935,4,1,108493,108493,108494,0,1,1
30936,6,2,108499,108499,108501,0,2,5
30937,1,1,108500,108501,108502,1,2,0
30938,1,1,108501,108502,108503,1,2,0
30939,4,3,108505,108505,108508,0,3,2
30940,1,3,108506,108508,108511,2,5,0
30941,4,2,108510,108511,108513,1,3,0
30942,4,3,108514,108514,108517,0,3,1
30943,6,2,108520,108520,108522,0,2,3
30944,1,2,108521,108522,108524,1,3,0
30945,6,3,108527,108527,108530,0,3,3
30946,2,3,108529,108530,108533,1,4,0
30947,5,3,108534,108534,108537,0,3,1
30948,1,3,108535,108537,108540,2,5,0
30949,5,2,108540,108540,108542,0,2,0
30950,6,1,108546,108546,108547,0,1,4
30951,1,3,108547,108547,108550,0,3,0
30952,1,1,108548,108550,108551,2,3,0
30953,4,1,108552,108552,108553,0,1,1
30954,4,2,108556,108556,108558,0,2,3
30955,1,1,108557,108558,108559,1,2,0
30956,1,1,108558,108559,108560,1,2,0
30957,4,3,108562,108562,108565,0,3,2
30958,2,2,108564,108565,108567,1,3,0
30959,2,1,108566,108567,108568,1,2,0
30960,6,2,108572,108572,108574,0,2,4
30961,5,2,108577,108577,108579,0,2,3
30962,2,2,108579,108579,108581,0,2,0
30963,4,2,108583,108583,108585,0,2,2
30964,2,1,108585,108585,108586,0,1,0
30965,3,1,108588,108588,108589,0,1,2
30966,4,1,108592,108592,108593,0,1,3
30967,6,3,108598,108598,108601,0,3,5
30968,2,1,108600,108601,108602,1,2,0
30969,6,3,108606,108606,108609,0,3,4
30970,4,2,108610,108610,108612,0,2,1
30971,1,1,108611,108612,108613,1,2,0
30972,3,2,108614,108614,108616,0,2,1
30973,2,2,108616,108616,108618,0,2,0
30974,3,1,108619,108619,108620,0,1,1
30975,2,2,108621,108621,108623,0,2,1
30976,3,2,108624,108624,108626,0,2,1
30977,1,1,108625,108626,108627,1,2,0
30978,5,2,108630,108630,108632,0,2,3
30979,6,3,108636,108636,108639,0,3,4
30980,1,1,108637,108639,108640,2,3,0
30981,2,1,108639,108640,108641,1,2,0
30982,3,3,108642,108642,108645,0,3,1
30983,3,3,108645,108645,108648,0,3,0
30984,5,1,108650,108650,108651,0,1,2
30985,3,1,108653,108653,108654,0,1,2
30986,6,2,108659,108659,108661,0,2,5
30987,4,3,108663,108663,108666,0,3,2
30988,6,2,108669,108669,108671,0,2,3
30989,2,3,108671,108671,108674,0,3,0
30990,5,1,108676,108676,108677,0,1,2
30991,2,1,108678,108678,108679,0,1,1
30992,2,2,108680,108680,108682,0,2,1
30993,5,3,108685,108685,108688,0,3,3
30994,3,1,108688,108688,108689,0,1,0
30995,3,1,108691,108691,108692,0,1,2
30996,5,1,108696,108696,108697,0,1,4
30997,3,2,108699,108699,108701,0,2,2
30998,1,3,108700,108701,108704,1,4,0
30999,5,2,108705,108705,108707,0,2,1
31000,2,1,108707,108707,108708,0,1,0
31001,4,1,108711,108711,108712,0,1,3
31002,6,1,108717,108717,108718,0,1,5
31003,2,3,108719,108719,108722,0,3,1
31004,4,1,108723,108723,108724,0,1,1
31005,6,3,108729,108729,108732,0,3,5
31006,3,1,108732,108732,108733,0,1,0
31007,4,2,108736,108736,108738,0,2,3
31008,5,1,108741,108741,108742,0,1,3
31009,5,2,108746,108746,108748,0,2,4
31010,6,3,108752,108752,108755,0,3,4
31011,6,1,108758,108758,108759,0,1,3
31012,1,1,108759,108759,108760,0,1,0
31013,1,2,108760,108760,108762,0,2,0
31014,5,3,108765,108765,108768,0,3,3
31015,2,2,108767,108768,108770,1,3,0
31016,3,3,108770,108770,108773,0,3,0
31017,4,1,108774,108774,108775,0,1,1
31018,6,3,108780,108780,108783,0,3,5
31019,1,2,108781,108783,108785,2,4,0
31020,4,2,108785,108785,108787,0,2,0
31021,1,1,108786,108787,108788,1,2,0
31022,4,1,108790,108790,108791,0,1,2
31023,1,3,108791,108791,108794,0,3,0
31024,4,1,108795,108795,108796,0,1,1
31025,4,2,108799,108799,108801,0,2,3
31026,1,3,108800,108801,108804,1,4,0
31027,5,2,108805,108805,108807,0,2,1
31028,6,2,108811,108811,108813,0,2,4
31029,3,3,108814,108814,108817,0,3,1
31030,5,2,108819,108819,108821,0,2,2
31031,4,2,108823,108823,108825,0,2,2
31032,5,1,108828,108828,108829,0,1,3
31033,3,1,108831,108831,108832,0,1,2
31034,1,3,108832,108832,108835,0,3,0
31035,2,2,108834,108835,108837,1,3,0
31036,1,1,108835,108837,108838,2,3,0
31037,1,2,108836,108838,108840,2,4,0
31038,3,3,108839,108840,108843,1,4,0
31039,4,3,108843,108843,108846,0,3,0
31040,4,3,108847,108847,108850,0,3,1
31041,6,3,108853,108853,108856,0,3,3
31042,3,2,108856,108856,108858,0,2,0
31043,6,3,108862,108862,108865,0,3,4
31044,6,3,108868,108868,108871,0,3,3
31045,3,2,108871,108871,108873,0,2,0
31046,5,2,108876,108876,108878,0,2,3
31047,5,2,108881,108881,108883,0,2,3
31048,6,3,108887,108887,108890,0,3,4
31049,3,3,108890,108890,108893,0,3,0
31050,4,1,108894,108894,108895,0,1,1
31051,2,1,108896,108896,108897,0,1,1
31052,5,3,108901,108901,108904,0,3,4
31053,5,1,108906,108906,108907,0,1,2
31054,5,2,108911,108911,108913,0,2,4
31055,4,3,108915,108915,108918,0,3,2
31056,3,3,108918,108918,108921,0,3,0
31057,2,2,108920,108921,108923,1,3,0
31058,3,2,108923,108923,108925,0,2,0
31059,3,1,108926,108926,108927,0,1,1
31060,5,2,108931,108931,108933,0,2,4
31061,6,1,108937,108937,108938,0,1,4
31062,2,2,108939,108939,108941,0,2,1
31063,1,2,108940,108941,108943,1,3,0
31064,4,2,108944,108944,108946,0,2,1
31065,6,1,108950,108950,108951,0,1,4
31066,2,1,108952,108952,108953,0,1,1
31067,5,2,108957,108957,108959,0,2,4
31068,5,3,108962,108962,108965,0,3,3
31069,3,2,108965,108965,108967,0,2,0
31070,4,1,108969,108969,108970,0,1,2
31071,6,2,108975,108975,108977,0,2,5
31072,1,2,108976,108977,108979,1,3,0
31073,2,2,108978,108979,108981,1,3,0
31074,4,3,108982,108982,108985,0,3,1
31075,2,2,108984,108985,108987,1,3,0
31076,2,3,108986,108987,108990,1,4,0
31077,6,2,108992,108992,108994,0,2,2
31078,5,2,108997,108997,108999,0,2,3
31079,5,1,109002,109002,109003,0,1,3
31080,4,2,109006,109006,109008,0,2,3
31081,3,2,109009,109009,109011,0,2,1
31082,4,2,109013,109013,109015,0,2,2
31083,4,1,109017,109017,109018,0,1,2
31084,6,2,109023,109023,109025,0,2,5
31085,1,2,109024,109025,109027,1,3,0
31086,4,2,109028,109028,109030,0,2,1
31087,3,2,109031,109031,109033,0,2,1
31088,6,2,109037,109037,109039,0,2,4
31089,4,1,109041,109041,109042,0,1,2
31090,4,1,109045,109045,109046,0,1,3
31091,2,3,109047,109047,109050,0,3,1
31092,4,2,109051,109051,109053,0,2,1
31093,4,2,109055,109055,109057,0,2,2
31094,5,3,109060,109060,109063,0,3,3
31095,1,2,109061,109063,109065,2,4,0
31096,2,3,109063,109065,109068,2,5,0
31097,3,2,109066,109068,109070,2,4,0
31098,1,2,109067,109070,109072,3,5,0
31099,5,1,109072,109072,109073,0,1,0
31100,5,3,109077,109077,109080,0,3,4
31101,1,1,109078,109080,109081,2,3,0
31102,3,2,109081,109081,109083,0,2,0
31103,3,1,109084,109084,109085,0,1,1
31104,4,1,109088,109088,109089,0,1,3
31105,2,2,109090,109090,109092,0,2,1
31106,3,1,109093,109093,109094,0,1,1
31107,1,1,109094,109094,109095,0,1,0
31108,5,2,109099,109099,109101,0,2,4
31109,5,2,109104,109104,109106,0,2,3
31110,5,2,109109,109109,109111,0,2,3
31111,5,1,109114,109114,109115,0,1,3
31112,3,2,109117,109117,109119,0,2,2
31113,2,3,109119,109119,109122,0,3,0
31114,5,2,109124,109124,109126,0,2,2
31115,1,1,109125,109126,109127,1,2,0
31116,4,3,109129,109129,109132,0,3,2
31117,1,1,109130,109132,109133,2,3,0
31118,6,3,109136,109136,109139,0,3,3
31119,4,3,109140,109140,109143,0,3,1
31120,1,1,109141,109143,109144,2,3,0
31121,3,1,109144,109144,109145,0,1,0
31122,1,1,109145,109145,109146,0,1,0
31123,2,2,109147,109147,109149,0,2,1
31124,6,1,109153,109153,109154,0,1,4
31125,3,1,109156,109156,109157,0,1,2
31126,2,1,109158,109158,109159,0,1,1
31127,4,2,109162,109162,109164,0,2,3
31128,5,2,109167,109167,109169,0,2,3
31129,4,1,109171,109171,109172,0,1,2
31130,5,1,109176,109176,109177,0,1,4
31131,5,2,109181,109181,109183,0,2,4
31132,4,2,109185,109185,109187,0,2,2
31133,3,2,109188,109188,109190,0,2,1
31134,5,1,109193,109193,109194,0,1,3
31135,1,1,109194,109194,109195,0,1,0
31136,5,1,109199,109199,109200,0,1,4
31137,3,2,109202,109202,109204,0,2,2
31138,1,3,109203,109204,109207,1,4,0
31139,5,1,109208,109208,109209,0,1,1
31140,1,1,109209,109209,109210,0,1,0
31141,5,2,109214,109214,109216,0,2,4
31142,1,1,109215,109216,109217,1,2,0
31143,4,3,109219,109219,109222,0,3,2
31144,5,2,109224,109224,109226,0,2,2
31145,2,1,109226,109226,109227,0,1,0
31146,6,3,109232,109232,109235,0,3,5
31147,5,2,109237,109237,109239,0,2,2
31148,5,2,109242,109242,109244,0,2,3
31149,3,3,109245,109245,109248,0,3,1
31150,5,2,109250,109250,109252,0,2,2
31151,2,1,109252,109252,109253,0,1,0
31152,5,2,109257,109257,109259,0,2,4
31153,3,2,109260,109260,109262,0,2,1
31154,6,2,109266,109266,109268,0,2,4
31155,5,3,109271,109271,109274,0,3,3
31156,5,3,109276,109276,109279,0,3,2
31157,5,1,109281,109281,109282,0,1,2
31158,3,2,109284,109284,109286,0,2,2
31159,4,1,109288,109288,109289,0,1,2
31160,1,1,109289,109289,109290,0,1,0
31161,5,3,109294,109294,109297,0,3,4
31162,1,3,109295,109297,109300,2,5,0
31163,2,2,109297,109300,109302,3,5,0
31164,4,2,109301,109302,109304,1,3,0
31165,6,1,109307,109307,109308,0,1,3
31166,2,2,109309,109309,109311,0,2,1
31167,4,2,109313,109313,109315,0,2,2
31168,3,1,109316,109316,109317,0,1,1
31169,6,3,109322,109322,109325,0,3,5
31170,4,3,109326,109326,109329,0,3,1
31171,2,3,109328,109329,109332,1,4,0
31172,2,3,109330,109332,109335,2,5,0
31173,1,2,109331,109335,109337,4,6,0
31174,4,2,109335,109337,109339,2,4,0
31175,6,2,109341,109341,109343,0,2,2
31176,6,3,109347,109347,109350,0,3,4
31177,5,1,109352,109352,109353,0,1,2
31178,4,3,109356,109356,109359,0,3,3
31179,1,2,109357,109359,109361,2,4,0
31180,4,1,109361,109361,109362,0,1,0
31181,2,1,109363,109363,109364,0,1,1
31182,6,1,109369,109369,109370,0,1,5
31183,1,3,109370,109370,109373,0,3,0
31184,1,3,109371,109373,109376,2,5,0
31185,6,3,109377,109377,109380,0,3,1
31186,6,3,109383,109383,109386,0,3,3
31187,4,2,109387,109387,109389,0,2,1
31188,3,2,109390,109390,109392,0,2,1
31189,2,1,109392,109392,109393,0,1,0
31190,2,1,109394,109394,109395,0,1,1
31191,4,2,109398,109398,109400,0,2,3
31192,2,3,109400,109400,109403,0,3,0
31193,6,2,109406,109406,109408,0,2,3
31194,4,2,109410,109410,109412,0,2,2
31195,2,3,109412,109412,109415,0,3,0
31196,3,1,109415,109415,109416,0,1,0
31197,5,3,109420,109420,109423,0,3,4
31198,4,1,109424,109424,109425,0,1,1
31199,2,1,109426,109426,109427,0,1,1
31200,5,2,109431,109431,109433,0,2,4
31201,2,3,109433,109433,109436,0,3,0
31202,4,2,109437,109437,109439,0,2,1
31203,5,1,109442,109442,109443,0,1,3
31204,4,1,109446,109446,109447,0,1,3
31205,4,1,109450,109450,109451,0,1,3
31206,3,1,109453,109453,109454,0,1,2
31207,5,1,109458,109458,109459,0,1,4
31208,5,3,109463,109463,109466,0,3,4
31209,2,1,109465,109466,109467,1,2,0
31210,3,1,109468,109468,109469,0,1,1
31211,5,2,109473,109473,109475,0,2,4
31212,3,3,109476,109476,109479,0,3,1
31213,2,2,109478,109479,109481,1,3,0
31214,3,2,109481,109481,109483,0,2,0
31215,3,2,109484,109484,109486,0,2,1
31216,2,1,109486,109486,109487,0,1,0
31217,2,1,109488,109488,109489,0,1,1
31218,5,3,109493,109493,109496,0,3,4
31219,6,2,109499,109499,109501,0,2,3
31220,3,2,109502,109502,109504,0,2,1
31221,1,3,109503,109504,109507,1,4,0
31222,5,1,109508,109508,109509,0,1,1
31223,2,3,109510,109510,109513,0,3,1
31224,4,3,109514,109514,109517,0,3,1
31225,4,1,109518,109518,109519,0,1,1
31226,3,2,109521,109521,109523,0,2,2
31227,5,3,109526,109526,109529,0,3,3
31228,2,1,109528,109529,109530,1,2,0
31229,6,3,109534,109534,109537,0,3,4
31230,6,1,109540,109540,109541,0,1,3
31231,1,1,109541,109541,109542,0,1,0
31232,4,1,109545,109545,109546,0,1,3
31233,6,1,109551,109551,109552,0,1,5
31234,2,1,109553,109553,109554,0,1,1
31235,3,2,109556,109556,109558,0,2,2
31236,3,1,109559,109559,109560,0,1,1
31237,3,3,109562,109562,109565,0,3,2
31238,2,3,109564,109565,109568,1,4,0
31239,3,3,109567,109568,109571,1,4,0
31240,2,3,109569,109571,109574,2,5,0
31241,4,2,109573,109574,109576,1,3,0
31242,3,2,109576,109576,109578,0,2,0
31243,1,1,109577,109578,109579,1,2,0
31244,2,3,109579,109579,109582,0,3,0
31245,1,2,109580,109582,109584,2,4,0
31246,5,1,109585,109585,109586,0,1,1
31247,4,2,109589,109589,109591,0,2,3
31248,1,2,109590,109591,109593,1,3,0
31249,5,3,109595,109595,109598,0,3,2
31250,1,1,109596,109598,109599,2,3,0
31251,4,2,109600,109600,109602,0,2,1
31252,5,3,109605,109605,109608,0,3,3
31253,4,3,109609,109609,109612,0,3,1
31254,3,1,109612,109612,109613,0,1,0
31255,3,3,109615,109615,109618,0,3,2
31256,4,3,109619,109619,109622,0,3,1
31257,5,3,109624,109624,109627,0,3,2
31258,3,2,109627,109627,109629,0,2,0
31259,6,2,109633,109633,109635,0,2,4
31260,5,3,109638,109638,109641,0,3,3
31261,1,1,109639,109641,109642,2,3,0
31262,6,3,109645,109645,109648,0,3,3
31263,3,2,109648,109648,109650,0,2,0
31264,6,3,109654,109654,109657,0,3,4
31265,4,2,109658,109658,109660,0,2,1
31266,6,3,109664,109664,109667,0,3,4
31267,6,1,109670,109670,109671,0,1,3
31268,5,2,109675,109675,109677,0,2,4
31269,1,1,109676,109677,109678,1,2,0
31270,2,1,109678,109678,109679,0,1,0
31271,2,3,109680,109680,109683,0,3,1
31272,2,3,109682,109683,109686,1,4,0
31273,1,2,109683,109686,109688,3,5,0
31274,4,3,109687,109688,109691,1,4,0
31275,5,1,109692,109692,109693,0,1,1
31276,1,1,109693,109693,109694,0,1,0
31277,2,2,109695,109695,109697,0,2,1
31278,2,3,109697,109697,109700,0,3,0
31279,5,1,109702,109702,109703,0,1,2
31280,5,1,109707,109707,109708,0,1,4
31281,3,2,109710,109710,109712,0,2,2
31282,1,3,109711,109712,109715,1,4,0
31283,5,1,109716,109716,109717,0,1,1
31284,5,3,109721,109721,109724,0,3,4
31285,2,1,109723,109724,109725,1,2,0
31286,4,1,109727,109727,109728,0,1,2
31287,5,3,109732,109732,109735,0,3,4
31288,2,1,109734,109735,109736,1,2,0
31289,4,2,109738,109738,109740,0,2,2
31290,2,3,109740,109740,109743,0,3,0
31291,5,3,109745,109745,109748,0,3,2
31292,1,2,109746,109748,109750,2,4,0
31293,3,2,109749,109750,109752,1,3,0
31294,2,1,109751,109752,109753,1,2,0
31295,4,3,109755,109755,109758,0,3,2
31296,1,2,109756,109758,109760,2,4,0
31297,1,3,109757,109760,109763,3,6,0
31298,3,2,109760,109763,109765,3,5,0
31299,2,1,109762,109765,109766,3,4,0
31300,2,1,109764,109766,109767,2,3,0
31301,3,1,109767,109767,109768,0,1,0
31302,5,3,109772,109772,109775,0,3,4
31303,5,2,109777,109777,109779,0,2,2
31304,1,1,109778,109779,109780,1,2,0
31305,1,1,109779,109780,109781,1,2,0
31306,5,2,109784,109784,109786,0,2,3
31307,4,2,109788,109788,109790,0,2,2
31308,4,1,109792,109792,109793,0,1,2
31309,3,3,109795,109795,109798,0,3,2
31310,3,2,109798,109798,109800,0,2,0
31311,5,3,109803,109803,109806,0,3,3
31312,3,3,109806,109806,109809,0,3,0
31313,1,2,109807,109809,109811,2,4,0
31314,3,1,109810,109811,109812,1,2,0
31315,3,2,109813,109813,109815,0,2,1
31316,1,3,109814,109815,109818,1,4,0
31317,6,3,109820,109820,109823,0,3,2
31318,1,3,109821,109823,109826,2,5,0
31319,4,1,109825,109826,109827,1,2,0
31320,3,1,109828,109828,109829,0,1,1
31321,4,3,109832,109832,109835,0,3,3
31322,5,3,109837,109837,109840,0,3,2
31323,1,2,109838,109840,109842,2,4,0
31324,1,3,109839,109842,109845,3,6,0
31325,5,3,109844,109845,109848,1,4,0
31326,3,3,109847,109848,109851,1,4,0
31327,3,2,109850,109851,109853,1,3,0
31328,6,1,109856,109856,109857,0,1,3
31329,4,2,109860,109860,109862,0,2,3
31330,3,1,109863,109863,109864,0,1,1
31331,2,3,109865,109865,109868,0,3,1
31332,4,2,109869,109869,109871,0,2,1
31333,4,3,109873,109873,109876,0,3,2
31334,6,1,109879,109879,109880,0,1,3
31335,5,1,109884,109884,109885,0,1,4
31336,4,3,109888,109888,109891,0,3,3
31337,1,1,109889,109891,109892,2,3,0
31338,3,2,109892,109892,109894,0,2,0
31339,6,2,109898,109898,109900,0,2,4
31340,1,2,109899,109900,109902,1,3,0
31341,4,1,109903,109903,109904,0,1,1
31342,4,1,109907,109907,109908,0,1,3
31343,5,1,109912,109912,109913,0,1,4
31344,5,3,109917,109917,109920,0,3,4
31345,2,1,109919,109920,109921,1,2,0
31346,6,1,109925,109925,109926,0,1,4
31347,2,3,109927,109927,109930,0,3,1
31348,6,1,109933,109933,109934,0,1,3
31349,6,3,109939,109939,109942,0,3,5
31350,2,2,109941,109942,109944,1,3,0
31351,6,1,109947,109947,109948,0,1,3
31352,1,3,109948,109948,109951,0,3,0
31353,2,2,109950,109951,109953,1,3,0
31354,2,3,109952,109953,109956,1,4,0
31355,6,2,109958,109958,109960,0,2,2
31356,6,2,109964,109964,109966,0,2,4
31357,3,1,109967,109967,109968,0,1,1
31358,4,3,109971,109971,109974,0,3,3
31359,1,2,109972,109974,109976,2,4,0
31360,1,3,109973,109976,109979,3,6,0
31361,5,2,109978,109979,109981,1,3,0
31362,1,2,109979,109981,109983,2,4,0
31363,5,3,109984,109984,109987,0,3,1
31364,3,2,109987,109987,109989,0,2,0
31365,6,2,109993,109993,109995,0,2,4
31366,4,1,109997,109997,109998,0,1,2
31367,3,3,110000,110000,110003,0,3,2
31368,3,1,110003,110003,110004,0,1,0
31369,4,3,110007,110007,110010,0,3,3
31370,2,2,110009,110010,110012,1,3,0
31371,2,2,110011,110012,110014,1,3,0
31372,1,2,110012,110014,110016,2,4,0
31373,2,1,110014,110016,110017,2,3,0
31374,4,1,110018,110018,110019,0,1,1
31375,1,1,110019,110019,110020,0,1,0
31376,6,2,110025,110025,110027,0,2,5
31377,3,3,110028,110028,110031,0,3,1
31378,5,3,110033,110033,110036,0,3,2
31379,2,3,110035,110036,110039,1,4,0
31380,3,2,110038,110039,110041,1,3,0
31381,3,3,110041,110041,110044,0,3,0
31382,2,1,110043,110044,110045,1,2,0
31383,2,3,110045,110045,110048,0,3,0
31384,1,2,110046,110048,110050,2,4,0
31385,5,1,110051,110051,110052,0,1,1
31386,6,3,110057,110057,110060,0,3,5
31387,3,2,110060,110060,110062,0,2,0
31388,2,2,110062,110062,110064,0,2,0
31389,1,3,110063,110064,110067,1,4,0
31390,2,1,110065,110067,110068,2,3,0
31391,4,1,110069,110069,110070,0,1,1
31392,1,1,110070,110070,110071,0,1,0
31393,4,3,110074,110074,110077,0,3,3
31394,5,3,110079,110079,110082,0,3,2
31395,2,2,110081,110082,110084,1,3,0
31396,6,1,110087,110087,110088,0,1,3
31397,3,1,110090,110090,110091,0,1,2
31398,2,1,110092,110092,110093,0,1,1
31399,5,2,110097,110097,110099,0,2,4
31400,3,1,110100,110100,110101,0,1,1
31401,2,3,110102,110102,110105,0,3,1
31402,2,2,110104,110105,110107,1,3,0
31403,4,2,110108,110108,110110,0,2,1
31404,1,1,110109,110110,110111,1,2,0
31405,2,3,110111,110111,110114,0,3,0
31406,4,2,110115,110115,110117,0,2,1
31407,3,2,110118,110118,110120,0,2,1
31408,6,3,110124,110124,110127,0,3,4
31409,2,2,110126,110127,110129,1,3,0
31410,5,3,110131,110131,110134,0,3,2
31411,4,3,110135,110135,110138,0,3,1
31412,5,2,110140,110140,110142,0,2,2
31413,6,2,110146,110146,110148,0,2,4
31414,6,2,110152,110152,110154,0,2,4
31415,6,3,110158,110158,110161,0,3,4
31416,4,3,110162,110162,110165,0,3,1
31417,2,1,110164,110165,110166,1,2,0
31418,4,3,110168,110168,110171,0,3,2
31419,3,3,110171,110171,110174,0,3,0
31420,2,3,110173,110174,110177,1,4,0
31421,5,1,110178,110178,110179,0,1,1
31422,2,2,110180,110180,110182,0,2,1
31423,6,1,110186,110186,110187,0,1,4
31424,4,1,110190,110190,110191,0,1,3
31425,3,3,110193,110193,110196,0,3,2
31426,3,3,110196,110196,110199,0,3,0
31427,5,3,110201,110201,110204,0,3,2
31428,1,3,110202,110204,110207,2,5,0
31429,3,3,110205,110207,110210,2,5,0
31430,1,2,110206,110210,110212,4,6,0
31431,2,3,110208,110212,110215,4,7,0
31432,3,1,110211,110215,110216,4,5,0
31433,4,3,110215,110216,110219,1,4,0
31434,5,3,110220,110220,110223,0,3,1
31435,2,3,110222,110223,110226,1,4,0
31436,5,3,110227,110227,110230,0,3,1
31437,6,3,110233,110233,110236,0,3,3
31438,2,1,110235,110236,110237,1,2,0
31439,3,1,110238,110238,110239,0,1,1
31440,3,3,110241,110241,110244,0,3,2
31441,1,2,110242,110244,110246,2,4,0
31442,1,3,110243,110246,110249,3,6,0
31443,6,2,110249,110249,110251,0,2,0
31444,3,3,110252,110252,110255,0,3,1
31445,1,3,110253,110255,110258,2,5,0
31446,4,3,110257,110258,110261,1,4,0
31447,2,2,110259,110261,110263,2,4,0
31448,4,1,110263,110263,110264,0,1,0
31449,3,3,110266,110266,110269,0,3,2
31450,2,2,110268,110269,110271,1,3,0
31451,6,2,110274,110274,110276,0,2,3
31452,1,1,110275,110276,110277,1,2,0
31453,4,1,110279,110279,110280,0,1,2
31454,6,1,110285,110285,110286,0,1,5
31455,1,3,110286,110286,110289,0,3,0
31456,2,1,110288,110289,110290,1,2,0
31457,5,3,110293,110293,110296,0,3,3
31458,1,2,110294,110296,110298,2,4,0
31459,5,1,110299,110299,110300,0,1,1
31460,3,2,110302,110302,110304,0,2,2
31461,3,3,110305,110305,110308,0,3,1
31462,6,3,110311,110311,110314,0,3,3
31463,4,1,110315,110315,110316,0,1,1
31464,1,2,110316,110316,110318,0,2,0
31465,6,1,110322,110322,110323,0,1,4
31466,5,1,110327,110327,110328,0,1,4
31467,6,1,110333,110333,110334,0,1,5
31468,5,1,110338,110338,110339,0,1,4
31469,5,2,110343,110343,110345,0,2,4
31470,3,1,110346,110346,110347,0,1,1
31471,5,2,110351,110351,110353,0,2,4
31472,4,2,110355,110355,110357,0,2,2
31473,5,1,110360,110360,110361,0,1,3
31474,2,2,110362,110362,110364,0,2,1
31475,2,2,110364,110364,110366,0,2,0
31476,5,2,110369,110369,110371,0,2,3
31477,1,2,110370,110371,110373,1,3,0
31478,1,3,110371,110373,110376,2,5,0
31479,2,2,110373,110376,110378,3,5,0
31480,2,2,110375,110378,110380,3,5,0
31481,2,3,110377,110380,110383,3,6,0
31482,1,3,110378,110383,110386,5,8,0
31483,2,2,110380,110386,110388,6,8,0
31484,3,2,110383,110388,110390,5,7,0
31485,6,3,110389,110390,110393,1,4,0
31486,6,2,110395,110395,110397,0,2,2
31487,4,3,110399,110399,110402,0,3,2
31488,3,2,110402,110402,110404,0,2,0
31489,3,1,110405,110405,110406,0,1,1
31490,4,1,110409,110409,110410,0,1,3
31491,2,1,110411,110411,110412,0,1,1
31492,6,3,110417,110417,110420,0,3,5
31493,2,3,110419,110420,110423,1,4,0
31494,5,2,110424,110424,110426,0,2,1
31495,6,2,110430,110430,110432,0,2,4
31496,6,3,110436,110436,110439,0,3,4
31497,6,3,110442,110442,110445,0,3,3
31498,6,3,110448,110448,110451,0,3,3
31499,1,3,110449,110451,110454,2,5,0
31500,5,1,110454,110454,110455,0,1,0
31501,3,2,110457,110457,110459,0,2,2
31502,6,2,110463,110463,110465,0,2,4
31503,6,1,110469,110469,110470,0,1,4
31504,4,1,110473,110473,110474,0,1,3
31505,4,3,110477,110477,110480,0,3,3
31506,4,1,110481,110481,110482,0,1,1
31507,4,2,110485,110485,110487,0,2,3
31508,4,3,110489,110489,110492,0,3,2
31509,1,1,110490,110492,110493,2,3,0
31510,5,2,110495,110495,110497,0,2,2
31511,1,1,110496,110497,110498,1,2,0
31512,1,3,110497,110498,110501,1,4,0
31513,6,1,110503,110503,110504,0,1,2
31514,3,3,110506,110506,110509,0,3,2
31515,5,1,110511,110511,110512,0,1,2
31516,2,2,110513,110513,110515,0,2,1
31517,2,1,110515,110515,110516,0,1,0
31518,4,1,110519,110519,110520,0,1,3
31519,6,3,110525,110525,110528,0,3,5
31520,1,3,110526,110528,110531,2,5,0
31521,3,2,110529,110531,110533,2,4,0
31522,1,2,110530,110533,110535,3,5,0
31523,6,1,110536,110536,110537,0,1,1
31524,4,3,110540,110540,110543,0,3,3
31525,5,1,110545,110545,110546,0,1,2
31526,2,3,110547,110547,110550,0,3,1
31527,6,1,110553,110553,110554,0,1,3
31528,5,2,110558,110558,110560,0,2,4
31529,2,3,110560,110560,110563,0,3,0
31530,3,2,110563,110563,110565,0,2,0
31531,1,2,110564,110565,110567,1,3,0
31532,4,1,110568,110568,110569,0,1,1
31533,6,3,110574,110574,110577,0,3,5
31534,2,2,110576,110577,110579,1,3,0
31535,4,1,110580,110580,110581,0,1,1
31536,5,2,110585,110585,110587,0,2,4
31537,2,3,110587,110587,110590,0,3,0
31538,5,1,110592,110592,110593,0,1,2
31539,4,2,110596,110596,110598,0,2,3
31540,3,1,110599,110599,110600,0,1,1
31541,6,2,110605,110605,110607,0,2,5
31542,3,1,110608,110608,110609,0,1,1
31543,2,1,110610,110610,110611,0,1,1
31544,4,3,110614,110614,110617,0,3,3
31545,2,2,110616,110617,110619,1,3,0
31546,5,1,110621,110621,110622,0,1,2
31547,5,3,110626,110626,110629,0,3,4
31548,2,3,110628,110629,110632,1,4,0
31549,1,3,110629,110632,110635,3,6,0
31550,6,2,110635,110635,110637,0,2,0
31551,3,1,110638,110638,110639,0,1,1
31552,2,3,110640,110640,110643,0,3,1
31553,1,2,110641,110643,110645,2,4,0
31554,2,2,110643,110645,110647,2,4,0
31555,2,1,110645,110647,110648,2,3,0
31556,2,3,110647,110648,110651,1,4,0
31557,1,1,110648,110651,110652,3,4,0
31558,3,1,110651,110652,110653,1,2,0
31559,3,1,110654,110654,110655,0,1,1
31560,3,1,110657,110657,110658,0,1,2
31561,4,1,110661,110661,110662,0,1,3
31562,1,3,110662,110662,110665,0,3,0
31563,3,3,110665,110665,110668,0,3,0
31564,5,1,110670,110670,110671,0,1,2
31565,2,3,110672,110672,110675,0,3,1
31566,2,1,110674,110675,110676,1,2,0
31567,5,3,110679,110679,110682,0,3,3
31568,4,1,110683,110683,110684,0,1,1
31569,4,2,110687,110687,110689,0,2,3
31570,1,1,110688,110689,110690,1,2,0
31571,2,3,110690,110690,110693,0,3,0
31572,5,1,110695,110695,110696,0,1,2
31573,5,3,110700,110700,110703,0,3,4
31574,1,3,110701,110703,110706,2,5,0
31575,4,1,110705,110706,110707,1,2,0
31576,4,3,110709,110709,110712,0,3,2
31577,2,1,110711,110712,110713,1,2,0
31578,1,1,110712,110713,110714,1,2,0
31579,3,1,110715,110715,110716,0,1,1
31580,1,1,110716,110716,110717,0,1,0
31581,3,1,110719,110719,110720,0,1,2
31582,3,3,110722,110722,110725,0,3,2
31583,1,3,110723,110725,110728,2,5,0
31584,2,3,110725,110728,110731,3,6,0
31585,2,1,110727,110731,110732,4,5,0
31586,4,2,110731,110732,110734,1,3,0
31587,4,3,110735,110735,110738,0,3,1
31588,3,3,110738,110738,110741,0,3,0
31589,3,3,110741,110741,110744,0,3,0
31590,6,1,110747,110747,110748,0,1,3
31591,1,2,110748,110748,110750,0,2,0
31592,3,3,110751,110751,110754,0,3,1
31593,3,2,110754,110754,110756,0,2,0
31594,2,1,110756,110756,110757,0,1,0
31595,2,1,110758,110758,110759,0,1,1
31596,4,3,110762,110762,110765,0,3,3
31597,6,1,110768,110768,110769,0,1,3
31598,6,1,110774,110774,110775,0,1,5
31599,1,2,110775,110775,110777,0,2,0
31600,4,2,110779,110779,110781,0,2,2
31601,4,2,110783,110783,110785,0,2,2
31602,2,1,110785,110785,110786,0,1,0
31603,1,1,110786,110786,110787,0,1,0
31604,2,1,110788,110788,110789,0,1,1
31605,3,3,110791,110791,110794,0,3,2
31606,4,2,110795,110795,110797,0,2,1
31607,3,3,110798,110798,110801,0,3,1
31608,2,1,110800,110801,110802,1,2,0
31609,5,1,110805,110805,110806,0,1,3
31610,6,2,110811,110811,110813,0,2,5
31611,4,3,110815,110815,110818,0,3,2
31612,5,3,110820,110820,110823,0,3,2
31613,6,2,110826,110826,110828,0,2,3
31614,6,3,110832,110832,110835,0,3,4
31615,4,1,110836,110836,110837,0,1,1
31616,6,3,110842,110842,110845,0,3,5
31617,6,1,110848,110848,110849,0,1,3
31618,2,1,110850,110850,110851,0,1,1
31619,1,1,110851,110851,110852,0,1,0
31620,2,1,110853,110853,110854,0,1,1
31621,2,1,110855,110855,110856,0,1,1
31622,2,1,110857,110857,110858,0,1,1
31623,6,2,110863,110863,110865,0,2,5
31624,2,3,110865,110865,110868,0,3,0
31625,1,3,110866,110868,110871,2,5,0
31626,6,2,110872,110872,110874,0,2,1
31627,1,1,110873,110874,110875,1,2,0
31628,4,3,110877,110877,110880,0,3,2
31629,6,3,110883,110883,110886,0,3,3
31630,4,3,110887,110887,110890,0,3,1
31631,5,3,110892,110892,110895,0,3,2
31632,5,3,110897,110897,110900,0,3,2
31633,1,2,110898,110900,110902,2,4,0
31634,2,2,110900,110902,110904,2,4,0
31635,2,1,110902,110904,110905,2,3,0
31636,3,1,110905,110905,110906,0,1,0
31637,6,3,110911,110911,110914,0,3,5
31638,2,2,110913,110914,110916,1,3,0
31639,4,2,110917,110917,110919,0,2,1
31640,5,2,110922,110922,110924,0,2,3
31641,1,2,110923,110924,110926,1,3,0
31642,4,2,110927,110927,110929,0,2,1
31643,1,3,110928,110929,110932,1,4,0
31644,4,3,110932,110932,110935,0,3,0
31645,2,1,110934,110935,110936,1,2,0
31646,3,3,110937,110937,110940,0,3,1
31647,1,1,110938,110940,110941,2,3,0
31648,4,3,110942,110942,110945,0,3,1
31649,5,2,110947,110947,110949,0,2,2
31650,1,1,110948,110949,110950,1,2,0
31651,4,3,110952,110952,110955,0,3,2
31652,5,2,110957,110957,110959,0,2,2
31653,6,2,110963,110963,110965,0,2,4
31654,5,2,110968,110968,110970,0,2,3
31655,4,1,110972,110972,110973,0,1,2
31656,6,2,110978,110978,110980,0,2,5
31657,6,1,110984,110984,110985,0,1,4
31658,6,1,110990,110990,110991,0,1,5
31659,4,1,110994,110994,110995,0,1,3
31660,2,2,110996,110996,110998,0,2,1
31661,4,1,111000,111000,111001,0,1,2
31662,4,3,111004,111004,111007,0,3,3
31663,6,3,111010,111010,111013,0,3,3
31664,5,1,111015,111015,111016,0,1,2
31665,6,1,111021,111021,111022,0,1,5
31666,6,1,111027,111027,111028,0,1,5
31667,3,1,111030,111030,111031,0,1,2
31668,1,1,111031,111031,111032,0,1,0
31669,2,2,111033,111033,111035,0,2,1
31670,6,2,111039,111039,111041,0,2,4
31671,3,3,111042,111042,111045,0,3,1
31672,3,1,111045,111045,111046,0,1,0
31673,6,2,111051,111051,111053,0,2,5
31674,5,1,111056,111056,111057,0,1,3
31675,4,1,111060,111060,111061,0,1,3
31676,3,3,111063,111063,111066,0,3,2
31677,6,3,111069,111069,111072,0,3,3
31678,6,3,111075,111075,111078,0,3,3
31679,2,3,111077,111078,111081,1,4,0
31680,6,1,111083,111083,111084,0,1,2
31681,3,3,111086,111086,111089,0,3,2
31682,1,2,111087,111089,111091,2,4,0
31683,2,2,111089,111091,111093,2,4,0
31684,5,3,111094,111094,111097,0,3,1
31685,2,3,111096,111097,111100,1,4,0
31686,3,1,111099,111100,111101,1,2,0
31687,3,1,111102,111102,111103,0,1,1
31688,1,3,111103,111103,111106,0,3,0
31689,1,1,111104,111106,111107,2,3,0
31690,1,2,111105,111107,111109,2,4,0
31691,5,2,111110,111110,111112,0,2,1
31692,2,1,111112,111112,111113,0,1,0
31693,2,1,111114,111114,111115,0,1,1
31694,1,2,111115,111115,111117,0,2,0
31695,3,2,111118,111118,111120,0,2,1
31696,1,3,111119,111120,111123,1,4,0
31697,3,1,111122,111123,111124,1,2,0
31698,3,2,111125,111125,111127,0,2,1
31699,1,1,111126,111127,111128,1,2,0
31700,1,3,111127,111128,111131,1,4,0
31701,1,1,111128,111131,111132,3,4,0
31702,3,2,111131,111132,111134,1,3,0
31703,4,2,111135,111135,111137,0,2,1
31704,2,3,111137,111137,111140,0,3,0
31705,4,1,111141,111141,111142,0,1,1
31706,6,2,111147,111147,111149,0,2,5
31707,6,3,111153,111153,111156,0,3,4
31708,3,3,111156,111156,111159,0,3,0
31709,4,3,111160,111160,111163,0,3,1
31710,2,3,111162,111163,111166,1,4,0
31711,5,3,111167,111167,111170,0,3,1
31712,4,2,111171,111171,111173,0,2,1
31713,4,1,111175,111175,111176,0,1,2
31714,5,3,111180,111180,111183,0,3,4
31715,5,2,111185,111185,111187,0,2,2
31716,2,3,111187,111187,111190,0,3,0
31717,5,2,111192,111192,111194,0,2,2
31718,4,1,111196,111196,111197,0,1,2
31719,5,1,111201,111201,111202,0,1,4
31720,6,3,111207,111207,111210,0,3,5
31721,6,1,111213,111213,111214,0,1,3
31722,2,3,111215,111215,111218,0,3,1
31723,3,3,111218,111218,111221,0,3,0
31724,6,3,111224,111224,111227,0,3,3
31725,5,1,111229,111229,111230,0,1,2
31726,1,2,111230,111230,111232,0,2,0
31727,3,3,111233,111233,111236,0,3,1
31728,3,1,111236,111236,111237,0,1,0
31729,4,2,111240,111240,111242,0,2,3
31730,5,2,111245,111245,111247,0,2,3
31731,5,3,111250,111250,111253,0,3,3
31732,3,2,111253,111253,111255,0,2,0
31733,2,3,111255,111255,111258,0,3,0
31734,6,3,111261,111261,111264,0,3,3
31735,1,3,111262,111264,111267,2,5,0
31736,4,1,111266,111267,111268,1,2,0
31737,1,1,111267,111268,111269,1,2,0
31738,2,3,111269,111269,111272,0,3,0
31739,1,2,111270,111272,111274,2,4,0
31740,6,3,111276,111276,111279,0,3,2
31741,5,3,111281,111281,111284,0,3,2
31742,5,3,111286,111286,111289,0,3,2
31743,5,2,111291,111291,111293,0,2,2
31744,6,3,111297,111297,111300,0,3,4
31745,3,3,111300,111300,111303,0,3,0
31746,6,3,111306,111306,111309,0,3,3
31747,1,2,111307,111309,111311,2,4,0
31748,3,2,111310,111311,111313,1,3,0
31749,5,1,111315,111315,111316,0,1,2
31750,6,2,111321,111321,111323,0,2,5
31751,5,1,111326,111326,111327,0,1,3
31752,5,2,111331,111331,111333,0,2,4
31753,3,1,111334,111334,111335,0,1,1
31754,4,2,111338,111338,111340,0,2,3
31755,5,3,111343,111343,111346,0,3,3
31756,2,2,111345,111346,111348,1,3,0
31757,2,3,111347,111348,111351,1,4,0
31758,1,3,111348,111351,111354,3,6,0
31759,3,3,111351,111354,111357,3,6,0
31760,4,2,111355,111357,111359,2,4,0
31761,6,3,111361,111361,111364,0,3,2
31762,1,2,111362,111364,111366,2,4,0
31763,4,1,111366,111366,111367,0,1,0
31764,6,2,111372,111372,111374,0,2,5
31765,2,1,111374,111374,111375,0,1,0
31766,3,2,111377,111377,111379,0,2,2
31767,1,3,111378,111379,111382,1,4,0
31768,4,1,111382,111382,111383,0,1,0
31769,1,2,111383,111383,111385,0,2,0
31770,4,2,111387,111387,111389,0,2,2
31771,5,1,111392,111392,111393,0,1,3
31772,5,2,111397,111397,111399,0,2,4
31773,5,2,111402,111402,111404,0,2,3
31774,2,2,111404,111404,111406,0,2,0
31775,1,3,111405,111406,111409,1,4,0
31776,3,3,111408,111409,111412,1,4,0
31777,4,3,111412,111412,111415,0,3,0
31778,5,3,111417,111417,111420,0,3,2
31779,6,1,111423,111423,111424,0,1,3
31780,5,3,111428,111428,111431,0,3,4
31781,5,1,111433,111433,111434,0,1,2
31782,6,3,111439,111439,111442,0,3,5
31783,1,3,111440,111442,111445,2,5,0
31784,1,3,111441,111445,111448,4,7,0
31785,6,2,111447,111448,111450,1,3,0
31786,6,3,111453,111453,111456,0,3,3
31787,1,3,111454,111456,111459,2,5,0
31788,5,2,111459,111459,111461,0,2,0
31789,6,2,111465,111465,111467,0,2,4
31790,3,2,111468,111468,111470,0,2,1
31791,4,1,111472,111472,111473,0,1,2
31792,5,2,111477,111477,111479,0,2,4
31793,1,2,111478,111479,111481,1,3,0
31794,1,3,111479,111481,111484,2,5,0
31795,5,3,111484,111484,111487,0,3,0
31796,3,1,111487,111487,111488,0,1,0
31797,2,3,111489,111489,111492,0,3,1
31798,4,2,111493,111493,111495,0,2,1
31799,4,2,111497,111497,111499,0,2,2
31800,6,2,111503,111503,111505,0,2,4
31801,4,2,111507,111507,111509,0,2,2
31802,1,3,111508,111509,111512,1,4,0
31803,4,1,111512,111512,111513,0,1,0
31804,5,3,111517,111517,111520,0,3,4
31805,6,3,111523,111523,111526,0,3,3
31806,2,1,111525,111526,111527,1,2,0
31807,6,2,111531,111531,111533,0,2,4
31808,1,1,111532,111533,111534,1,2,0
31809,5,3,111537,111537,111540,0,3,3
31810,3,1,111540,111540,111541,0,1,0
31811,5,3,111545,111545,111548,0,3,4
31812,2,3,111547,111548,111551,1,4,0
31813,1,2,111548,111551,111553,3,5,0
31814,5,3,111553,111553,111556,0,3,0
31815,6,1,111559,111559,111560,0,1,3
31816,2,3,111561,111561,111564,0,3,1
31817,3,3,111564,111564,111567,0,3,0
31818,3,1,111567,111567,111568,0,1,0
31819,4,3,111571,111571,111574,0,3,3
31820,1,2,111572,111574,111576,2,4,0
31821,4,2,111576,111576,111578,0,2,0
31822,2,2,111578,111578,111580,0,2,0
31823,1,3,111579,111580,111583,1,4,0
31824,6,1,111585,111585,111586,0,1,2
31825,6,3,111591,111591,111594,0,3,5
31826,5,2,111596,111596,111598,0,2,2
31827,2,3,111598,111598,111601,0,3,0
31828,3,3,111601,111601,111604,0,3,0
31829,5,3,111606,111606,111609,0,3,2
31830,4,1,111610,111610,111611,0,1,1
31831,4,2,111614,111614,111616,0,2,3
31832,1,2,111615,111616,111618,1,3,0
31833,5,3,111620,111620,111623,0,3,2
31834,4,1,111624,111624,111625,0,1,1
31835,6,2,111630,111630,111632,0,2,5
31836,1,3,111631,111632,111635,1,4,0
31837,1,1,111632,111635,111636,3,4,0
31838,6,3,111638,111638,111641,0,3,2
31839,1,1,111639,111641,111642,2,3,0
31840,6,3,111645,111645,111648,0,3,3
31841,3,1,111648,111648,111649,0,1,0
31842,3,1,111651,111651,111652,0,1,2
31843,4,2,111655,111655,111657,0,2,3
31844,3,2,111658,111658,111660,0,2,1
31845,2,2,111660,111660,111662,0,2,0
31846,4,3,111664,111664,111667,0,3,2
31847,5,3,111669,111669,111672,0,3,2
31848,2,1,111671,111672,111673,1,2,0
31849,1,2,111672,111673,111675,1,3,0
31850,1,2,111673,111675,111677,2,4,0
31851,3,3,111676,111677,111680,1,4,0
31852,2,3,111678,111680,111683,2,5,0
31853,6,2,111684,111684,111686,0,2,1
31854,3,1,111687,111687,111688,0,1,1
31855,4,1,111691,111691,111692,0,1,3
31856,4,1,111695,111695,111696,0,1,3
31857,4,1,111699,111699,111700,0,1,3
31858,6,3,111705,111705,111708,0,3,5
31859,1,2,111706,111708,111710,2,4,0
31860,6,3,111712,111712,111715,0,3,2
31861,3,3,111715,111715,111718,0,3,0
31862,5,2,111720,111720,111722,0,2,2
31863,2,2,111722,111722,111724,0,2,0
31864,5,2,111727,111727,111729,0,2,3
31865,2,3,111729,111729,111732,0,3,0
31866,4,2,111733,111733,111735,0,2,1
31867,3,3,111736,111736,111739,0,3,1
31868,5,1,111741,111741,111742,0,1,2
31869,3,2,111744,111744,111746,0,2,2
31870,2,3,111746,111746,111749,0,3,0
31871,2,2,111748,111749,111751,1,3,0
31872,5,3,111753,111753,111756,0,3,2
31873,1,2,111754,111756,111758,2,4,0
31874,2,1,111756,111758,111759,2,3,0
31875,4,3,111760,111760,111763,0,3,1
31876,5,3,111765,111765,111768,0,3,2
31877,4,1,111769,111769,111770,0,1,1
31878,5,1,111774,111774,111775,0,1,4
31879,5,2,111779,111779,111781,0,2,4
31880,4,3,111783,111783,111786,0,3,2
31881,3,3,111786,111786,111789,0,3,0
31882,2,1,111788,111789,111790,1,2,0
31883,2,1,111790,111790,111791,0,1,0
31884,4,1,111794,111794,111795,0,1,3
31885,4,2,111798,111798,111800,0,2,3
31886,5,2,111803,111803,111805,0,2,3
31887,4,2,111807,111807,111809,0,2,2
31888,6,2,111813,111813,111815,0,2,4
31889,4,3,111817,111817,111820,0,3,2
31890,4,2,111821,111821,111823,0,2,1
31891,3,3,111824,111824,111827,0,3,1
31892,3,1,111827,111827,111828,0,1,0
31893,4,2,111831,111831,111833,0,2,3
31894,4,2,111835,111835,111837,0,2,2
31895,5,3,111840,111840,111843,0,3,3
31896,6,2,111846,111846,111848,0,2,3
31897,6,2,111852,111852,111854,0,2,4
31898,4,2,111856,111856,111858,0,2,2
31899,5,3,111861,111861,111864,0,3,3
31900,5,1,111866,111866,111867,0,1,2
31901,6,3,111872,111872,111875,0,3,5
31902,2,1,111874,111875,111876,1,2,0
31903,6,1,111880,111880,111881,0,1,4
31904,3,1,111883,111883,111884,0,1,2
31905,3,1,111886,111886,111887,0,1,2
31906,1,2,111887,111887,111889,0,2,0
31907,4,3,111891,111891,111894,0,3,2
31908,6,3,111897,111897,111900,0,3,3
31909,3,2,111900,111900,111902,0,2,0
31910,6,1,111906,111906,111907,0,1,4
31911,2,3,111908,111908,111911,0,3,1
31912,6,1,111914,111914,111915,0,1,3
31913,5,2,111919,111919,111921,0,2,4
31914,1,1,111920,111921,111922,1,2,0
31915,3,1,111923,111923,111924,0,1,1
31916,5,1,111928,111928,111929,0,1,4
31917,1,2,111929,111929,111931,0,2,0
31918,1,3,111930,111931,111934,1,4,0
31919,5,3,111935,111935,111938,0,3,1
31920,4,3,111939,111939,111942,0,3,1
31921,2,1,111941,111942,111943,1,2,0
31922,5,2,111946,111946,111948,0,2,3
31923,1,2,111947,111948,111950,1,3,0
31924,3,3,111950,111950,111953,0,3,0
31925,5,1,111955,111955,111956,0,1,2
31926,2,2,111957,111957,111959,0,2,1
31927,4,2,111961,111961,111963,0,2,2
31928,3,2,111964,111964,111966,0,2,1
31929,5,3,111969,111969,111972,0,3,3
31930,1,3,111970,111972,111975,2,5,0
31931,4,1,111974,111975,111976,1,2,0
31932,2,3,111976,111976,111979,0,3,0
31933,5,2,111981,111981,111983,0,2,2
31934,5,2,111986,111986,111988,0,2,3
31935,3,1,111989,111989,111990,0,1,1
31936,1,1,111990,111990,111991,0,1,0
31937,3,2,111993,111993,111995,0,2,2
31938,6,2,111999,111999,112001,0,2,4
31939,5,1,112004,112004,112005,0,1,3
31940,4,2,112008,112008,112010,0,2,3
31941,5,3,112013,112013,112016,0,3,3
31942,2,3,112015,112016,112019,1,4,0
31943,2,3,112017,112019,112022,2,5,0
31944,2,3,112019,112022,112025,3,6,0
31945,5,1,112024,112025,112026,1,2,0
31946,5,1,112029,112029,112030,0,1,3
31947,1,3,112030,112030,112033,0,3,0
31948,2,1,112032,112033,112034,1,2,0
31949,2,3,112034,112034,112037,0,3,0
31950,2,1,112036,112037,112038,1,2,0
31951,6,3,112042,112042,112045,0,3,4
31952,6,3,112048,112048,112051,0,3,3
31953,3,3,112051,112051,112054,0,3,0
31954,4,1,112055,112055,112056,0,1,1
31955,2,2,112057,112057,112059,0,2,1
31956,2,3,112059,112059,112062,0,3,0
31957,4,2,112063,112063,112065,0,2,1
31958,2,2,112065,112065,112067,0,2,0
31959,6,2,112071,112071,112073,0,2,4
31960,4,1,112075,112075,112076,0,1,2
31961,3,1,112078,112078,112079,0,1,2
31962,6,1,112084,112084,112085,0,1,5
31963,1,3,112085,112085,112088,0,3,0
31964,1,1,112086,112088,112089,2,3,0
31965,6,2,112092,112092,112094,0,2,3
31966,6,1,112098,112098,112099,0,1,4
31967,6,1,112104,112104,112105,0,1,5
31968,6,3,112110,112110,112113,0,3,5
31969,6,2,112116,112116,112118,0,2,3
31970,1,1,112117,112118,112119,1,2,0
31971,5,1,112122,112122,112123,0,1,3
31972,1,2,112123,112123,112125,0,2,0
31973,2,3,112125,112125,112128,0,3,0
31974,1,1,112126,112128,112129,2,3,0
31975,6,1,112132,112132,112133,0,1,3
31976,6,3,112138,112138,112141,0,3,5
31977,2,1,112140,112141,112142,1,2,0
31978,6,3,112146,112146,112149,0,3,4
31979,1,3,112147,112149,112152,2,5,0
31980,2,2,112149,112152,112154,3,5,0
31981,2,3,112151,112154,112157,3,6,0
31982,5,1,112156,112157,112158,1,2,0
31983,4,1,112160,112160,112161,0,1,2
31984,3,1,112163,112163,112164,0,1,2
31985,1,3,112164,112164,112167,0,3,0
31986,2,2,112166,112167,112169,1,3,0
31987,4,2,112170,112170,112172,0,2,1
31988,4,2,112174,112174,112176,0,2,2
31989,5,1,112179,112179,112180,0,1,3
31990,1,2,112180,112180,112182,0,2,0
31991,2,2,112182,112182,112184,0,2,0
31992,4,1,112186,112186,112187,0,1,2
31993,2,3,112188,112188,112191,0,3,1
31994,5,2,112193,112193,112195,0,2,2
31995,4,1,112197,112197,112198,0,1,2
31996,3,3,112200,112200,112203,0,3,2
31997,3,3,112203,112203,112206,0,3,0
31998,1,1,112204,112206,112207,2,3,0
31999,6,2,112210,112210,112212,0,2,3
32000,2,2,112212,112212,112214,0,2,0
32001,6,2,112218,112218,112220,0,2,4
32002,2,1,112220,112220,112221,0,1,0
32003,6,1,112226,112226,112227,0,1,5
32004,1,3,112227,112227,112230,0,3,0
32005,6,1,112233,112233,112234,0,1,3
32006,5,2,112238,112238,112240,0,2,4
32007,4,3,112242,112242,112245,0,3,2
32008,3,3,112245,112245,112248,0,3,0
32009,5,2,112250,112250,112252,0,2,2
32010,5,3,112255,112255,112258,0,3,3
32011,6,2,112261,112261,112263,0,2,3
32012,2,3,112263,112263,112266,0,3,0
32013,6,2,112269,112269,112271,0,2,3
32014,4,3,112273,112273,112276,0,3,2
32015,4,1,112277,112277,112278,0,1,1
32016,3,1,112280,112280,112281,0,1,2
32017,3,2,112283,112283,112285,0,2,2
32018,3,2,112286,112286,112288,0,2,1
32019,5,1,112291,112291,112292,0,1,3
32020,6,1,112297,112297,112298,0,1,5
32021,5,3,112302,112302,112305,0,3,4
32022,1,2,112303,112305,112307,2,4,0
32023,1,2,112304,112307,112309,3,5,0
32024,4,3,112308,112309,112312,1,4,0
32025,4,1,112312,112312,112313,0,1,0
32026,5,3,112317,112317,112320,0,3,4
32027,1,3,112318,112320,112323,2,5,0
32028,3,2,112321,112323,112325,2,4,0
32029,3,1,112324,112325,112326,1,2,0
32030,4,1,112328,112328,112329,0,1,2
32031,6,1,112334,112334,112335,0,1,5
32032,6,3,112340,112340,112343,0,3,5
32033,5,1,112345,112345,112346,0,1,2
32034,6,3,112351,112351,112354,0,3,5
32035,2,1,112353,112354,112355,1,2,0
32036,6,3,112359,112359,112362,0,3,4
32037,2,1,112361,112362,112363,1,2,0
32038,4,1,112365,112365,112366,0,1,2
32039,4,2,112369,112369,112371,0,2,3
32040,5,1,112374,112374,112375,0,1,3
32041,5,3,112379,112379,112382,0,3,4
32042,6,1,112385,112385,112386,0,1,3
32043,5,3,112390,112390,112393,0,3,4
32044,5,3,112395,112395,112398,0,3,2
32045,1,3,112396,112398,112401,2,5,0
32046,3,2,112399,112401,112403,2,4,0
32047,4,2,112403,112403,112405,0,2,0
32048,6,3,112409,112409,112412,0,3,4
32049,4,1,112413,112413,112414,0,1,1
32050,3,1,112416,112416,112417,0,1,2
32051,6,2,112422,112422,112424,0,2,5
32052,3,3,112425,112425,112428,0,3,1
32053,5,1,112430,112430,112431,0,1,2
32054,2,2,112432,112432,112434,0,2,1
32055,3,3,112435,112435,112438,0,3,1
32056,2,2,112437,112438,112440,1,3,0
32057,3,1,112440,112440,112441,0,1,0
32058,2,2,112442,112442,112444,0,2,1
32059,6,3,112448,112448,112451,0,3,4
32060,5,2,112453,112453,112455,0,2,2
32061,5,2,112458,112458,112460,0,2,3
32062,6,3,112464,112464,112467,0,3,4
32063,1,1,112465,112467,112468,2,3,0
32064,5,1,112470,112470,112471,0,1,2
32065,4,3,112474,112474,112477,0,3,3
32066,6,2,112480,112480,112482,0,2,3
32067,6,3,112486,112486,112489,0,3,4
32068,3,2,112489,112489,112491,0,2,0
32069,4,1,112493,112493,112494,0,1,2
32070,5,1,112498,112498,112499,0,1,4
32071,2,3,112500,112500,112503,0,3,1
32072,1,2,112501,112503,112505,2,4,0
32073,6,2,112507,112507,112509,0,2,2
32074,4,1,112511,112511,112512,0,1,2
32075,6,2,112517,112517,112519,0,2,5
32076,1,1,112518,112519,112520,1,2,0
32077,2,2,112520,112520,112522,0,2,0
32078,6,2,112526,112526,112528,0,2,4
32079,5,1,112531,112531,112532,0,1,3
32080,5,1,112536,112536,112537,0,1,4
32081,1,3,112537,112537,112540,0,3,0
32082,4,3,112541,112541,112544,0,3,1
32083,1,2,112542,112544,112546,2,4,0
32084,6,1,112548,112548,112549,0,1,2
32085,5,2,112553,112553,112555,0,2,4
32086,6,1,112559,112559,112560,0,1,4
32087,5,1,112564,112564,112565,0,1,4
32088,2,2,112566,112566,112568,0,2,1
32089,4,3,112570,112570,112573,0,3,2
32090,3,1,112573,112573,112574,0,1,0
32091,2,1,112575,112575,112576,0,1,1
32092,6,2,112581,112581,112583,0,2,5
32093,3,3,112584,112584,112587,0,3,1
32094,1,2,112585,112587,112589,2,4,0
32095,6,1,112591,112591,112592,0,1,2
32096,1,2,112592,112592,112594,0,2,0
32097,1,3,112593,112594,112597,1,4,0
32098,2,1,112595,112597,112598,2,3,0
32099,3,1,112598,112598,112599,0,1,0
32100,2,1,112600,112600,112601,0,1,1
32101,3,2,112603,112603,112605,0,2,2
32102,6,2,112609,112609,112611,0,2,4
32103,6,1,112615,112615,112616,0,1,4
32104,1,3,112616,112616,112619,0,3,0
32105,6,2,112622,112622,112624,0,2,3
32106,6,2,112628,112628,112630,0,2,4
32107,5,1,112633,112633,112634,0,1,3
32108,5,2,112638,112638,112640,0,2,4
32109,6,1,112644,112644,112645,0,1,4
32110,4,3,112648,112648,112651,0,3,3
32111,6,1,112654,112654,112655,0,1,3
32112,3,3,112657,112657,112660,0,3,2
32113,6,2,112663,112663,112665,0,2,3
32114,6,1,112669,112669,112670,0,1,4
32115,2,3,112671,112671,112674,0,3,1
32116,3,2,112674,112674,112676,0,2,0
32117,5,3,112679,112679,112682,0,3,3
32118,6,3,112685,112685,112688,0,3,3
32119,2,3,112687,112688,112691,1,4,0
32120,6,2,112693,112693,112695,0,2,2
32121,3,1,112696,112696,112697,0,1,1
32122,6,1,112702,112702,112703,0,1,5
32123,4,2,112706,112706,112708,0,2,3
32124,5,1,112711,112711,112712,0,1,3
32125,2,2,112713,112713,112715,0,2,1
32126,3,2,112716,112716,112718,0,2,1
32127,3,1,112719,112719,112720,0,1,1
32128,2,1,112721,112721,112722,0,1,1
32129,2,2,112723,112723,112725,0,2,1
32130,2,2,112725,112725,112727,0,2,0
32131,5,1,112730,112730,112731,0,1,3
32132,5,3,112735,112735,112738,0,3,4
32133,5,3,112740,112740,112743,0,3,2
32134,5,2,112745,112745,112747,0,2,2
32135,2,2,112747,112747,112749,0,2,0
32136,3,3,112750,112750,112753,0,3,1
32137,3,1,112753,112753,112754,0,1,0
32138,6,3,112759,112759,112762,0,3,5
32139,6,3,112765,112765,112768,0,3,3
32140,4,1,112769,112769,112770,0,1,1
32141,3,1,112772,112772,112773,0,1,2
32142,5,2,112777,112777,112779,0,2,4
32143,2,1,112779,112779,112780,0,1,0
32144,6,1,112785,112785,112786,0,1,5
32145,4,1,112789,112789,112790,0,1,3
32146,2,2,112791,112791,112793,0,2,1
32147,1,2,112792,112793,112795,1,3,0
32148,2,3,112794,112795,112798,1,4,0
32149,6,1,112800,112800,112801,0,1,2
32150,6,1,112806,112806,112807,0,1,5
32151,5,2,112811,112811,112813,0,2,4
32152,3,1,112814,112814,112815,0,1,1
32153,3,3,112817,112817,112820,0,3,2
32154,6,3,112823,112823,112826,0,3,3
32155,3,3,112826,112826,112829,0,3,0
32156,5,1,112831,112831,112832,0,1,2
32157,5,1,112836,112836,112837,0,1,4
32158,5,3,112841,112841,112844,0,3,4
32159,5,2,112846,112846,112848,0,2,2
32160,1,2,112847,112848,112850,1,3,0
32161,2,1,112849,112850,112851,1,2,0
32162,3,1,112852,112852,112853,0,1,1
32163,3,2,112855,112855,112857,0,2,2
32164,1,1,112856,112857,112858,1,2,0
32165,6,3,112862,112862,112865,0,3,4
32166,1,1,112863,112865,112866,2,3,0
32167,2,1,112865,112866,112867,1,2,0
32168,4,1,112869,112869,112870,0,1,2
32169,2,1,112871,112871,112872,0,1,1
32170,6,3,112877,112877,112880,0,3,5
32171,1,3,112878,112880,112883,2,5,0
32172,4,1,112882,112883,112884,1,2,0
32173,4,1,112886,112886,112887,0,1,2
32174,4,2,112890,112890,112892,0,2,3
32175,5,1,112895,112895,112896,0,1,3
32176,3,1,112898,112898,112899,0,1,2
32177,1,2,112899,112899,112901,0,2,0
32178,3,2,112902,112902,112904,0,2,1
32179,2,1,112904,112904,112905,0,1,0
32180,1,2,112905,112905,112907,0,2,0
32181,2,1,112907,112907,112908,0,1,0
32182,2,1,112909,112909,112910,0,1,1
32183,1,1,112910,112910,112911,0,1,0
32184,2,1,112912,112912,112913,0,1,1
32185,1,1,112913,112913,112914,0,1,0
32186,6,2,112919,112919,112921,0,2,5
32187,3,1,112922,112922,112923,0,1,1
32188,3,3,112925,112925,112928,0,3,2
32189,4,1,112929,112929,112930,0,1,1
32190,3,1,112932,112932,112933,0,1,2
32191,2,1,112934,112934,112935,0,1,1
32192,6,1,112940,112940,112941,0,1,5
32193,4,1,112944,112944,112945,0,1,3
32194,2,1,112946,112946,112947,0,1,1
32195,2,1,112948,112948,112949,0,1,1
32196,6,3,112954,112954,112957,0,3,5
32197,6,1,112960,112960,112961,0,1,3
32198,3,2,112963,112963,112965,0,2,2
32199,3,1,112966,112966,112967,0,1,1
32200,4,1,112970,112970,112971,0,1,3
32201,5,2,112975,112975,112977,0,2,4
32202,6,3,112981,112981,112984,0,3,4
32203,2,3,112983,112984,112987,1,4,0
32204,5,1,112988,112988,112989,0,1,1
32205,4,1,112992,112992,112993,0,1,3
32206,3,1,112995,112995,112996,0,1,2
32207,2,3,112997,112997,113000,0,3,1
32208,5,2,113002,113002,113004,0,2,2
32209,3,3,113005,113005,113008,0,3,1
32210,6,1,113011,113011,113012,0,1,3
32211,6,2,113017,113017,113019,0,2,5
32212,1,2,113018,113019,113021,1,3,0
32213,5,2,113023,113023,113025,0,2,2
32214,1,3,113024,113025,113028,1,4,0
32215,1,1,113025,113028,113029,3,4,0
32216,3,3,113028,113029,113032,1,4,0
32217,4,1,113032,113032,113033,0,1,0
32218,4,2,113036,113036,113038,0,2,3
32219,6,1,113042,113042,113043,0,1,4
32220,3,3,113045,113045,113048,0,3,2
32221,6,3,113051,113051,113054,0,3,3
32222,2,3,113053,113054,113057,1,4,0
32223,3,2,113056,113057,113059,1,3,0
32224,4,2,113060,113060,113062,0,2,1
32225,1,2,113061,113062,113064,1,3,0
32226,4,1,113065,113065,113066,0,1,1
32227,1,1,113066,113066,113067,0,1,0
32228,2,3,113068,113068,113071,0,3,1
32229,4,3,113072,113072,113075,0,3,1
32230,3,1,113075,113075,113076,0,1,0
32231,1,3,113076,113076,113079,0,3,0
32232,4,2,113080,113080,113082,0,2,1
32233,3,2,113083,113083,113085,0,2,1
32234,4,2,113087,113087,113089,0,2,2
32235,3,3,113090,113090,113093,0,3,1
32236,5,2,113095,113095,113097,0,2,2
32237,5,1,113100,113100,113101,0,1,3
32238,2,2,113102,113102,113104,0,2,1
32239,1,3,113103,113104,113107,1,4,0
32240,3,1,113106,113107,113108,1,2,0
32241,4,1,113110,113110,113111,0,1,2
32242,4,2,113114,113114,113116,0,2,3
32243,4,2,113118,113118,113120,0,2,2
32244,2,2,113120,113120,113122,0,2,0
32245,4,2,113124,113124,113126,0,2,2
32246,3,2,113127,113127,113129,0,2,1
32247,3,3,113130,113130,113133,0,3,1
32248,2,1,113132,113133,113134,1,2,0
32249,1,2,113133,113134,113136,1,3,0
32250,2,1,113135,113136,113137,1,2,0
32251,5,2,113140,113140,113142,0,2,3
32252,3,1,113143,113143,113144,0,1,1
32253,3,3,113146,113146,113149,0,3,2
32254,6,3,113152,113152,113155,0,3,3
32255,6,3,113158,113158,113161,0,3,3
32256,3,1,113161,113161,113162,0,1,0
32257,4,2,113165,113165,113167,0,2,3
32258,2,3,113167,113167,113170,0,3,0
32259,6,1,113173,113173,113174,0,1,3
32260,3,3,113176,113176,113179,0,3,2
32261,2,2,113178,113179,113181,1,3,0
32262,2,2,113180,113181,113183,1,3,0
32263,2,3,113182,113183,113186,1,4,0
32264,2,2,113184,113186,113188,2,4,0
32265,2,3,113186,113188,113191,2,5,0
32266,6,1,113192,113192,113193,0,1,1
32267,4,2,113196,113196,113198,0,2,3
32268,5,2,113201,113201,113203,0,2,3
32269,3,2,113204,113204,113206,0,2,1
32270,1,1,113205,113206,113207,1,2,0
32271,6,1,113211,113211,113212,0,1,4
32272,5,1,113216,113216,113217,0,1,4
32273,1,1,113217,113217,113218,0,1,0
32274,2,1,113219,113219,113220,0,1,1
32275,4,1,113223,113223,113224,0,1,3
32276,2,1,113225,113225,113226,0,1,1
32277,4,3,113229,113229,113232,0,3,3
32278,2,3,113231,113232,113235,1,4,0
32279,1,1,113232,113235,113236,3,4,0
32280,2,2,113234,113236,113238,2,4,0
32281,5,2,113239,113239,113241,0,2,1
32282,1,3,113240,113241,113244,1,4,0
32283,1,2,113241,113244,113246,3,5,0
32284,5,3,113246,113246,113249,0,3,0
32285,1,1,113247,113249,113250,2,3,0
32286,3,3,113250,113250,113253,0,3,0
32287,2,2,113252,113253,113255,1,3,0
32288,3,1,113255,113255,113256,0,1,0
32289,3,3,113258,113258,113261,0,3,2
32290,3,3,113261,113261,113264,0,3,0
32291,2,2,113263,113264,113266,1,3,0
32292,2,1,113265,113266,113267,1,2,0
32293,5,2,113270,113270,113272,0,2,3
32294,6,2,113276,113276,113278,0,2,4
32295,5,1,113281,113281,113282,0,1,3
32296,4,2,113285,113285,113287,0,2,3
32297,4,2,113289,113289,113291,0,2,2
32298,1,1,113290,113291,113292,1,2,0
32299,1,2,113291,113292,113294,1,3,0
32300,4,2,113295,113295,113297,0,2,1
32301,5,1,113300,113300,113301,0,1,3
32302,4,1,113304,113304,113305,0,1,3
32303,2,3,113306,113306,113309,0,3,1
32304,4,2,113310,113310,113312,0,2,1
32305,6,1,113316,113316,113317,0,1,4
32306,6,1,113322,113322,113323,0,1,5
32307,4,3,113326,113326,113329,0,3,3
32308,2,1,113328,113329,113330,1,2,0
32309,3,3,113331,113331,113334,0,3,1
32310,6,2,113337,113337,113339,0,2,3
32311,1,3,113338,113339,113342,1,4,0
32312,2,1,113340,113342,113343,2,3,0
32313,6,1,113346,113346,113347,0,1,3
32314,6,1,113352,113352,113353,0,1,5
32315,5,3,113357,113357,113360,0,3,4
32316,1,3,113358,113360,113363,2,5,0
32317,5,2,113363,113363,113365,0,2,0
32318,4,2,113367,113367,113369,0,2,2
32319,5,1,113372,113372,113373,0,1,3
32320,6,1,113378,113378,113379,0,1,5
32321,1,1,113379,113379,113380,0,1,0
32322,2,1,113381,113381,113382,0,1,1
32323,4,3,113385,113385,113388,0,3,3
32324,4,1,113389,113389,113390,0,1,1
32325,5,1,113394,113394,113395,0,1,4
32326,5,2,113399,113399,113401,0,2,4
32327,3,1,113402,113402,113403,0,1,1
32328,3,3,113405,113405,113408,0,3,2
32329,3,2,113408,113408,113410,0,2,0
32330,4,3,113412,113412,113415,0,3,2
32331,3,2,113415,113415,113417,0,2,0
32332,2,1,113417,113417,113418,0,1,0
32333,1,2,113418,113418,113420,0,2,0
32334,5,2,113423,113423,113425,0,2,3
32335,1,2,113424,113425,113427,1,3,0
32336,3,2,113427,113427,113429,0,2,0
32337,1,3,113428,113429,113432,1,4,0
32338,4,2,113432,113432,113434,0,2,0
32339,6,1,113438,113438,113439,0,1,4
32340,1,1,113439,113439,113440,0,1,0
32341,1,3,113440,113440,113443,0,3,0
32342,1,2,113441,113443,113445,2,4,0
32343,3,2,113444,113445,113447,1,3,0
32344,4,1,113448,113448,113449,0,1,1
32345,1,1,113449,113449,113450,0,1,0
32346,2,2,113451,113451,113453,0,2,1
32347,6,3,113457,113457,113460,0,3,4
32348,4,1,113461,113461,113462,0,1,1
32349,1,2,113462,113462,113464,0,2,0
32350,2,1,113464,113464,113465,0,1,0
32351,3,1,113467,113467,113468,0,1,2
32352,4,3,113471,113471,113474,0,3,3
32353,2,1,113473,113474,113475,1,2,0
32354,6,1,113479,113479,113480,0,1,4
32355,2,1,113481,113481,113482,0,1,1
32356,1,1,113482,113482,113483,0,1,0
32357,1,1,113483,113483,113484,0,1,0
32358,4,2,113487,113487,113489,0,2,3
32359,3,3,113490,113490,113493,0,3,1
32360,2,1,113492,113493,113494,1,2,0
32361,3,3,113495,113495,113498,0,3,1
32362,4,3,113499,113499,113502,0,3,1
32363,6,3,113505,113505,113508,0,3,3
32364,3,1,113508,113508,113509,0,1,0
32365,3,1,113511,113511,113512,0,1,2
32366,4,3,113515,113515,113518,0,3,3
32367,3,1,113518,113518,113519,0,1,0
32368,2,2,113520,113520,113522,0,2,1
32369,1,1,113521,113522,113523,1,2,0
32370,3,2,113524,113524,113526,0,2,1
32371,6,3,113530,113530,113533,0,3,4
32372,2,3,113532,113533,113536,1,4,0
32373,2,3,113534,113536,113539,2,5,0
32374,3,2,113537,113539,113541,2,4,0
32375,4,2,113541,113541,113543,0,2,0
32376,4,1,113545,113545,113546,0,1,2
32377,3,2,113548,113548,113550,0,2,2
32378,5,2,113553,113553,113555,0,2,3
32379,5,3,113558,113558,113561,0,3,3
32380,5,2,113563,113563,113565,0,2,2
32381,6,3,113569,113569,113572,0,3,4
32382,1,3,113570,113572,113575,2,5,0
32383,1,1,113571,113575,113576,4,5,0
32384,6,2,113577,113577,113579,0,2,1
32385,1,2,113578,113579,113581,1,3,0
32386,3,3,113581,113581,113584,0,3,0
32387,4,1,113585,113585,113586,0,1,1
32388,3,2,113588,113588,113590,0,2,2
32389,4,1,113592,113592,113593,0,1,2
32390,6,2,113598,113598,113600,0,2,5
32391,1,3,113599,113600,113603,1,4,0
32392,6,2,113605,113605,113607,0,2,2
32393,2,1,113607,113607,113608,0,1,0
32394,5,3,113612,113612,113615,0,3,4
32395,1,3,113613,113615,113618,2,5,0
32396,3,1,113616,113618,113619,2,3,0
32397,2,1,113618,113619,113620,1,2,0
32398,3,3,113621,113621,113624,0,3,1
32399,6,1,113627,113627,113628,0,1,3
32400,1,2,113628,113628,113630,0,2,0
32401,3,1,113631,113631,113632,0,1,1
32402,1,1,113632,113632,113633,0,1,0
32403,6,2,113638,113638,113640,0,2,5
32404,4,1,113642,113642,113643,0,1,2
32405,2,2,113644,113644,113646,0,2,1
32406,1,1,113645,113646,113647,1,2,0
32407,4,1,113649,113649,113650,0,1,2
32408,4,3,113653,113653,113656,0,3,3
32409,3,2,113656,113656,113658,0,2,0
32410,5,1,113661,113661,113662,0,1,3
32411,1,2,113662,113662,113664,0,2,0
32412,6,3,113668,113668,113671,0,3,4
32413,4,1,113672,113672,113673,0,1,1
32414,2,2,113674,113674,113676,0,2,1
32415,6,1,113680,113680,113681,0,1,4
32416,2,3,113682,113682,113685,0,3,1
32417,4,1,113686,113686,113687,0,1,1
32418,3,3,113689,113689,113692,0,3,2
32419,5,2,113694,113694,113696,0,2,2
32420,1,2,113695,113696,113698,1,3,0
32421,2,3,113697,113698,113701,1,4,0
32422,2,3,113699,113701,113704,2,5,0
32423,2,3,113701,113704,113707,3,6,0
32424,3,3,113704,113707,113710,3,6,0
32425,5,1,113709,113710,113711,1,2,0
32426,4,2,113713,113713,113715,0,2,2
32427,5,2,113718,113718,113720,0,2,3
32428,1,1,113719,113720,113721,1,2,0
32429,6,1,113725,113725,113726,0,1,4
32430,5,2,113730,113730,113732,0,2,4
32431,6,2,113736,113736,113738,0,2,4
32432,1,3,113737,113738,113741,1,4,0
32433,6,1,113743,113743,113744,0,1,2
32434,5,1,113748,113748,113749,0,1,4
32435,4,1,113752,113752,113753,0,1,3
32436,3,1,113755,113755,113756,0,1,2
32437,3,2,113758,113758,113760,0,2,2
32438,4,3,113762,113762,113765,0,3,2
32439,6,3,113768,113768,113771,0,3,3
32440,4,3,113772,113772,113775,0,3,1
32441,3,2,113775,113775,113777,0,2,0
32442,4,3,113779,113779,113782,0,3,2
32443,2,2,113781,113782,113784,1,3,0
32444,5,1,113786,113786,113787,0,1,2
32445,4,1,113790,113790,113791,0,1,3
32446,4,3,113794,113794,113797,0,3,3
32447,2,3,113796,113797,113800,1,4,0
32448,3,1,113799,113800,113801,1,2,0
32449,4,1,113803,113803,113804,0,1,2
32450,3,2,113806,113806,113808,0,2,2
32451,4,3,113810,113810,113813,0,3,2
32452,6,1,113816,113816,113817,0,1,3
32453,6,2,113822,113822,113824,0,2,5
32454,5,3,113827,113827,113830,0,3,3
32455,3,3,113830,113830,113833,0,3,0
32456,1,2,113831,113833,113835,2,4,0
32457,5,1,113836,113836,113837,0,1,1
32458,2,1,113838,113838,113839,0,1,1
32459,4,2,113842,113842,113844,0,2,3
32460,1,2,113843,113844,113846,1,3,0
32461,1,3,113844,113846,113849,2,5,0
32462,3,3,113847,113849,113852,2,5,0
32463,3,2,113850,113852,113854,2,4,0
32464,3,3,113853,113854,113857,1,4,0
32465,1,3,113854,113857,113860,3,6,0
32466,5,1,113859,113860,113861,1,2,0
32467,5,1,113864,113864,113865,0,1,3
32468,4,2,113868,113868,113870,0,2,3
32469,3,3,113871,113871,113874,0,3,1
32470,4,1,113875,113875,113876,0,1,1
32471,6,3,113881,113881,113884,0,3,5
32472,1,1,113882,113884,113885,2,3,0
32473,2,2,113884,113885,113887,1,3,0
32474,2,3,113886,113887,113890,1,4,0
32475,3,1,113889,113890,113891,1,2,0
32476,5,3,113894,113894,113897,0,3,3
32477,4,2,113898,113898,113900,0,2,1
32478,4,2,113902,113902,113904,0,2,2
32479,4,3,113906,113906,113909,0,3,2
32480,3,2,113909,113909,113911,0,2,0
32481,3,1,113912,113912,113913,0,1,1
32482,4,3,113916,113916,113919,0,3,3
32483,4,2,113920,113920,113922,0,2,1
32484,5,1,113925,113925,113926,0,1,3
32485,4,1,113929,113929,113930,0,1,3
32486,5,3,113934,113934,113937,0,3,4
32487,3,1,113937,113937,113938,0,1,0
32488,6,2,113943,113943,113945,0,2,5
32489,4,3,113947,113947,113950,0,3,2
32490,5,1,113952,113952,113953,0,1,2
32491,3,3,113955,113955,113958,0,3,2
32492,5,3,113960,113960,113963,0,3,2
32493,1,2,113961,113963,113965,2,4,0
32494,2,1,113963,113965,113966,2,3,0
32495,5,2,113968,113968,113970,0,2,2
32496,6,2,113974,113974,113976,0,2,4
32497,2,2,113976,113976,113978,0,2,0
32498,6,3,113982,113982,113985,0,3,4
32499,1,3,113983,113985,113988,2,5,0
32500,6,2,113989,113989,113991,0,2,1
32501,4,3,113993,113993,113996,0,3,2
32502,1,2,113994,113996,113998,2,4,0
32503,1,1,113995,113998,113999,3,4,0
32504,5,3,114000,114000,114003,0,3,1
32505,6,2,114006,114006,114008,0,2,3
32506,2,1,114008,114008,114009,0,1,0
32507,1,3,114009,114009,114012,0,3,0
32508,3,2,114012,114012,114014,0,2,0
32509,6,3,114018,114018,114021,0,3,4
32510,1,2,114019,114021,114023,2,4,0
32511,3,1,114022,114023,114024,1,2,0
32512,3,2,114025,114025,114027,0,2,1
32513,4,2,114029,114029,114031,0,2,2
32514,2,1,114031,114031,114032,0,1,0
32515,2,2,114033,114033,114035,0,2,1
32516,1,1,114034,114035,114036,1,2,0
32517,1,1,114035,114036,114037,1,2,0
32518,4,3,114039,114039,114042,0,3,2
32519,1,3,114040,114042,114045,2,5,0
32520,3,2,114043,114045,114047,2,4,0
32521,4,2,114047,114047,114049,0,2,0
32522,1,2,114048,114049,114051,1,3,0
32523,5,1,114053,114053,114054,0,1,2
32524,2,3,114055,114055,114058,0,3,1
32525,5,1,114060,114060,114061,0,1,2
32526,3,3,114063,114063,114066,0,3,2
32527,2,3,114065,114066,114069,1,4,0
32528,1,2,114066,114069,114071,3,5,0
32529,1,1,114067,114071,114072,4,5,0
32530,3,1,114070,114072,114073,2,3,0
32531,2,1,114072,114073,114074,1,2,0
32532,1,2,114073,114074,114076,1,3,0
32533,3,2,114076,114076,114078,0,2,0
32534,1,1,114077,114078,114079,1,2,0
32535,6,3,114083,114083,114086,0,3,4
32536,3,3,114086,114086,114089,0,3,0
32537,4,2,114090,114090,114092,0,2,1
32538,2,2,114092,114092,114094,0,2,0
32539,2,1,114094,114094,114095,0,1,0
32540,6,1,114100,114100,114101,0,1,5
32541,2,2,114102,114102,114104,0,2,1
32542,1,1,114103,114104,114105,1,2,0
32543,2,3,114105,114105,114108,0,3,0
32544,3,3,114108,114108,114111,0,3,0
32545,4,2,114112,114112,114114,0,2,1
32546,5,2,114117,114117,114119,0,2,3
32547,6,1,114123,114123,114124,0,1,4
32548,4,1,114127,114127,114128,0,1,3
32549,6,3,114133,114133,114136,0,3,5
32550,1,3,114134,114136,114139,2,5,0
32551,3,3,114137,114139,114142,2,5,0
32552,6,3,114143,114143,114146,0,3,1
32553,6,1,114149,114149,114150,0,1,3
32554,3,3,114152,114152,114155,0,3,2
32555,6,1,114158,114158,114159,0,1,3
32556,6,2,114164,114164,114166,0,2,5
32557,2,2,114166,114166,114168,0,2,0
32558,1,1,114167,114168,114169,1,2,0
32559,1,1,114168,114169,114170,1,2,0
32560,2,2,114170,114170,114172,0,2,0
32561,6,3,114176,114176,114179,0,3,4
32562,6,1,114182,114182,114183,0,1,3
32563,1,2,114183,114183,114185,0,2,0
32564,1,2,114184,114185,114187,1,3,0
32565,3,3,114187,114187,114190,0,3,0
32566,1,1,114188,114190,114191,2,3,0
32567,5,3,114193,114193,114196,0,3,2
32568,1,3,114194,114196,114199,2,5,0
32569,5,3,114199,114199,114202,0,3,0
32570,3,2,114202,114202,114204,0,2,0
32571,1,1,114203,114204,114205,1,2,0
32572,6,3,114209,114209,114212,0,3,4
32573,3,2,114212,114212,114214,0,2,0
32574,6,1,114218,114218,114219,0,1,4
32575,6,3,114224,114224,114227,0,3,5
32576,3,2,114227,114227,114229,0,2,0
32577,4,2,114231,114231,114233,0,2,2
32578,2,3,114233,114233,114236,0,3,0
32579,1,3,114234,114236,114239,2,5,0
32580,5,3,114239,114239,114242,0,3,0
32581,3,1,114242,114242,114243,0,1,0
32582,2,1,114244,114244,114245,0,1,1
32583,3,3,114247,114247,114250,0,3,2
32584,3,2,114250,114250,114252,0,2,0
32585,5,3,114255,114255,114258,0,3,3
32586,5,1,114260,114260,114261,0,1,2
32587,6,3,114266,114266,114269,0,3,5
32588,5,3,114271,114271,114274,0,3,2
32589,4,1,114275,114275,114276,0,1,1
32590,3,2,114278,114278,114280,0,2,2
32591,1,1,114279,114280,114281,1,2,0
32592,6,2,114285,114285,114287,0,2,4
32593,4,3,114289,114289,114292,0,3,2
32594,2,1,114291,114292,114293,1,2,0
32595,1,3,114292,114293,114296,1,4,0
32596,4,2,114296,114296,114298,0,2,0
32597,1,2,114297,114298,114300,1,3,0
32598,3,2,114300,114300,114302,0,2,0
32599,3,2,114303,114303,114305,0,2,1
32600,3,1,114306,114306,114307,0,1,1
32601,5,3,114311,114311,114314,0,3,4
32602,6,1,114317,114317,114318,0,1,3
32603,2,1,114319,114319,114320,0,1,1
32604,3,1,114322,114322,114323,0,1,2
32605,6,1,114328,114328,114329,0,1,5
32606,1,2,114329,114329,114331,0,2,0
32607,4,3,114333,114333,114336,0,3,2
32608,4,1,114337,114337,114338,0,1,1
32609,6,1,114343,114343,114344,0,1,5
32610,6,1,114349,114349,114350,0,1,5
32611,5,2,114354,114354,114356,0,2,4
32612,3,3,114357,114357,114360,0,3,1
32613,6,2,114363,114363,114365,0,2,3
32614,6,3,114369,114369,114372,0,3,4
32615,4,1,114373,114373,114374,0,1,1
32616,1,1,114374,114374,114375,0,1,0
32617,5,2,114379,114379,114381,0,2,4
32618,2,3,114381,114381,114384,0,3,0
32619,4,3,114385,114385,114388,0,3,1
32620,4,1,114389,114389,114390,0,1,1
32621,3,3,114392,114392,114395,0,3,2
32622,5,1,114397,114397,114398,0,1,2
32623,6,3,114403,114403,114406,0,3,5
32624,1,3,114404,114406,114409,2,5,0
32625,3,3,114407,114409,114412,2,5,0
32626,6,1,114413,114413,114414,0,1,1
32627,3,3,114416,114416,114419,0,3,2
32628,3,1,114419,114419,114420,0,1,0
32629,5,2,114424,114424,114426,0,2,4
32630,6,2,114430,114430,114432,0,2,4
32631,5,1,114435,114435,114436,0,1,3
32632,4,1,114439,114439,114440,0,1,3
32633,6,1,114445,114445,114446,0,1,5
32634,4,3,114449,114449,114452,0,3,3
32635,5,2,114454,114454,114456,0,2,2
32636,4,2,114458,114458,114460,0,2,2
32637,1,1,114459,114460,114461,1,2,0
32638,6,2,114465,114465,114467,0,2,4
32639,4,1,114469,114469,114470,0,1,2
32640,1,1,114470,114470,114471,0,1,0
32641,6,1,114476,114476,114477,0,1,5
32642,6,1,114482,114482,114483,0,1,5
32643,5,1,114487,114487,114488,0,1,4
32644,3,2,114490,114490,114492,0,2,2
32645,6,2,114496,114496,114498,0,2,4
32646,4,3,114500,114500,114503,0,3,2
32647,5,2,114505,114505,114507,0,2,2
32648,4,3,114509,114509,114512,0,3,2
32649,3,1,114512,114512,114513,0,1,0
32650,6,2,114518,114518,114520,0,2,5
32651,1,3,114519,114520,114523,1,4,0
32652,5,1,114524,114524,114525,0,1,1
32653,4,2,114528,114528,114530,0,2,3
32654,1,3,114529,114530,114533,1,4,0
32655,4,3,114533,114533,114536,0,3,0
32656,2,1,114535,114536,114537,1,2,0
32657,2,1,114537,114537,114538,0,1,0
32658,4,2,114541,114541,114543,0,2,3
32659,2,3,114543,114543,114546,0,3,0
32660,2,2,114545,114546,114548,1,3,0
32661,3,2,114548,114548,114550,0,2,0
32662,1,1,114549,114550,114551,1,2,0
32663,1,1,114550,114551,114552,1,2,0
32664,3,1,114553,114553,114554,0,1,1
32665,5,1,114558,114558,114559,0,1,4
32666,2,1,114560,114560,114561,0,1,1
32667,6,2,114566,114566,114568,0,2,5
32668,3,2,114569,114569,114571,0,2,1
32669,2,3,114571,114571,114574,0,3,0
32670,2,3,114573,114574,114577,1,4,0
32671,1,1,114574,114577,114578,3,4,0
32672,6,2,114580,114580,114582,0,2,2
32673,3,2,114583,114583,114585,0,2,1
32674,4,1,114587,114587,114588,0,1,2
32675,6,1,114593,114593,114594,0,1,5
32676,3,1,114596,114596,114597,0,1,2
32677,6,3,114602,114602,114605,0,3,5
32678,4,1,114606,114606,114607,0,1,1
32679,5,3,114611,114611,114614,0,3,4
32680,3,1,114614,114614,114615,0,1,0
32681,5,3,114619,114619,114622,0,3,4
32682,2,3,114621,114622,114625,1,4,0
32683,2,2,114623,114625,114627,2,4,0
32684,6,2,114629,114629,114631,0,2,2
32685,3,2,114632,114632,114634,0,2,1
32686,1,3,114633,114634,114637,1,4,0
32687,4,2,114637,114637,114639,0,2,0
32688,2,1,114639,114639,114640,0,1,0
32689,6,1,114645,114645,114646,0,1,5
32690,4,1,114649,114649,114650,0,1,3
32691,4,1,114653,114653,114654,0,1,3
32692,6,1,114659,114659,114660,0,1,5
32693,2,1,114661,114661,114662,0,1,1
32694,1,3,114662,114662,114665,0,3,0
32695,2,1,114664,114665,114666,1,2,0
32696,2,1,114666,114666,114667,0,1,0
32697,3,3,114669,114669,114672,0,3,2
32698,4,1,114673,114673,114674,0,1,1
32699,2,1,114675,114675,114676,0,1,1
32700,5,2,114680,114680,114682,0,2,4
32701,5,1,114685,114685,114686,0,1,3
32702,1,1,114686,114686,114687,0,1,0
32703,3,1,114689,114689,114690,0,1,2
32704,2,1,114691,114691,114692,0,1,1
32705,4,2,114695,114695,114697,0,2,3
32706,1,2,114696,114697,114699,1,3,0
32707,1,1,114697,114699,114700,2,3,0
32708,1,2,114698,114700,114702,2,4,0
32709,3,2,114701,114702,114704,1,3,0
32710,1,3,114702,114704,114707,2,5,0
32711,2,3,114704,114707,114710,3,6,0
32712,4,3,114708,114710,114713,2,5,0
32713,2,3,114710,114713,114716,3,6,0
32714,5,3,114715,114716,114719,1,4,0
32715,5,1,114720,114720,114721,0,1,1
32716,2,2,114722,114722,114724,0,2,1
32717,5,1,114727,114727,114728,0,1,3
32718,3,1,114730,114730,114731,0,1,2
32719,1,3,114731,114731,114734,0,3,0
32720,3,2,114734,114734,114736,0,2,0
32721,4,2,114738,114738,114740,0,2,2
32722,5,1,114743,114743,114744,0,1,3
32723,1,2,114744,114744,114746,0,2,0
32724,4,3,114748,114748,114751,0,3,2
32725,5,1,114753,114753,114754,0,1,2
32726,1,1,114754,114754,114755,0,1,0
32727,5,1,114759,114759,114760,0,1,4
32728,1,3,114760,114760,114763,0,3,0
32729,6,1,114766,114766,114767,0,1,3
32730,5,2,114771,114771,114773,0,2,4
32731,6,1,114777,114777,114778,0,1,4
32732,5,2,114782,114782,114784,0,2,4
32733,6,1,114788,114788,114789,0,1,4
32734,2,1,114790,114790,114791,0,1,1
32735,1,2,114791,114791,114793,0,2,0
32736,6,2,114797,114797,114799,0,2,4
32737,3,2,114800,114800,114802,0,2,1
32738,5,1,114805,114805,114806,0,1,3
32739,3,2,114808,114808,114810,0,2,2
32740,5,1,114813,114813,114814,0,1,3
32741,3,2,114816,114816,114818,0,2,2
32742,4,3,114820,114820,114823,0,3,2
32743,6,2,114826,114826,114828,0,2,3
32744,6,1,114832,114832,114833,0,1,4
32745,3,1,114835,114835,114836,0,1,2
32746,3,3,114838,114838,114841,0,3,2
32747,4,1,114842,114842,114843,0,1,1
32748,2,1,114844,114844,114845,0,1,1
32749,5,1,114849,114849,114850,0,1,4
32750,2,1,114851,114851,114852,0,1,1
32751,6,3,114857,114857,114860,0,3,5
32752,3,1,114860,114860,114861,0,1,0
32753,2,2,114862,114862,114864,0,2,1
32754,5,3,114867,114867,114870,0,3,3
32755,4,3,114871,114871,114874,0,3,1
32756,6,3,114877,114877,114880,0,3,3
32757,1,1,114878,114880,114881,2,3,0
32758,6,2,114884,114884,114886,0,2,3
32759,6,3,114890,114890,114893,0,3,4
32760,4,1,114894,114894,114895,0,1,1
32761,6,3,114900,114900,114903,0,3,5
32762,4,2,114904,114904,114906,0,2,1
32763,2,2,114906,114906,114908,0,2,0
32764,5,3,114911,114911,114914,0,3,3
32765,2,3,114913,114914,114917,1,4,0
32766,5,2,114918,114918,114920,0,2,1
32767,6,1,114924,114924,114925,0,1,4
32768,3,2,114927,114927,114929,0,2,2
32769,5,3,114932,114932,114935,0,3,3
32770,5,3,114937,114937,114940,0,3,2
32771,4,3,114941,114941,114944,0,3,1
32772,6,3,114947,114947,114950,0,3,3
32773,5,3,114952,114952,114955,0,3,2
32774,5,3,114957,114957,114960,0,3,2
32775,6,3,114963,114963,114966,0,3,3
32776,6,1,114969,114969,114970,0,1,3
32777,5,1,114974,114974,114975,0,1,4
32778,2,1,114976,114976,114977,0,1,1
32779,5,2,114981,114981,114983,0,2,4
32780,3,2,114984,114984,114986,0,2,1
32781,6,2,114990,114990,114992,0,2,4
32782,4,2,114994,114994,114996,0,2,2
32783,3,2,114997,114997,114999,0,2,1
32784,3,2,115000,115000,115002,0,2,1
32785,3,2,115003,115003,115005,0,2,1
32786,1,1,115004,115005,115006,1,2,0
32787,2,1,115006,115006,115007,0,1,0
32788,4,2,115010,115010,115012,0,2,3
32789,2,2,115012,115012,115014,0,2,0
32790,1,2,115013,115014,115016,1,3,0
32791,6,1,115019,115019,115020,0,1,3
32792,1,1,115020,115020,115021,0,1,0
32793,1,1,115021,115021,115022,0,1,0
32794,3,1,115024,115024,115025,0,1,2
32795,3,3,115027,115027,115030,0,3,2
32796,3,1,115030,115030,115031,0,1,0
32797,1,3,115031,115031,115034,0,3,0
32798,2,2,115033,115034,115036,1,3,0
32799,6,1,115039,115039,115040,0,1,3
32800,4,2,115043,115043,115045,0,2,3
32801,5,2,115048,115048,115050,0,2,3
32802,5,2,115053,115053,115055,0,2,3
32803,2,3,115055,115055,115058,0,3,0
32804,1,1,115056,115058,115059,2,3,0
32805,1,1,115057,115059,115060,2,3,0
32806,5,3,115062,115062,115065,0,3,2
32807,5,3,115067,115067,115070,0,3,2
32808,5,1,115072,115072,115073,0,1,2
32809,1,2,115073,115073,115075,0,2,0
32810,6,1,115079,115079,115080,0,1,4
32811,5,3,115084,115084,115087,0,3,4
32812,3,2,115087,115087,115089,0,2,0
32813,3,1,115090,115090,115091,0,1,1
32814,5,1,115095,115095,115096,0,1,4
32815,6,2,115101,115101,115103,0,2,5
32816,6,3,115107,115107,115110,0,3,4
32817,2,3,115109,115110,115113,1,4,0
32818,6,3,115115,115115,115118,0,3,2
32819,2,1,115117,115118,115119,1,2,0
32820,1,2,115118,115119,115121,1,3,0
32821,3,2,115121,115121,115123,0,2,0
32822,6,2,115127,115127,115129,0,2,4
32823,6,1,115133,115133,115134,0,1,4
32824,3,2,115136,115136,115138,0,2,2
32825,2,2,115138,115138,115140,0,2,0
32826,2,1,115140,115140,115141,0,1,0
32827,2,1,115142,115142,115143,0,1,1
32828,6,3,115148,115148,115151,0,3,5
32829,5,1,115153,115153,115154,0,1,2
32830,4,1,115157,115157,115158,0,1,3
32831,1,3,115158,115158,115161,0,3,0
32832,4,3,115162,115162,115165,0,3,1
32833,1,2,115163,115165,115167,2,4,0
32834,4,3,115167,115167,115170,0,3,0
32835,4,1,115171,115171,115172,0,1,1
32836,1,2,115172,115172,115174,0,2,0
32837,2,2,115174,115174,115176,0,2,0
32838,3,2,115177,115177,115179,0,2,1
32839,1,2,115178,115179,115181,1,3,0
32840,3,3,115181,115181,115184,0,3,0
32841,4,3,115185,115185,115188,0,3,1
32842,2,1,115187,115188,115189,1,2,0
32843,6,1,115193,115193,115194,0,1,4
32844,6,2,115199,115199,115201,0,2,5
32845,4,1,115203,115203,115204,0,1,2
32846,5,3,115208,115208,115211,0,3,4
32847,3,2,115211,115211,115213,0,2,0
32848,1,1,115212,115213,115214,1,2,0
32849,6,1,115218,115218,115219,0,1,4
32850,6,2,115224,115224,115226,0,2,5
32851,4,2,115228,115228,115230,0,2,2
32852,6,1,115234,115234,115235,0,1,4
32853,3,3,115237,115237,115240,0,3,2
32854,5,3,115242,115242,115245,0,3,2
32855,1,1,115243,115245,115246,2,3,0
32856,4,1,115247,115247,115248,0,1,1
32857,4,3,115251,115251,115254,0,3,3
32858,6,3,115257,115257,115260,0,3,3
32859,5,1,115262,115262,115263,0,1,2
32860,6,2,115268,115268,115270,0,2,5
32861,5,2,115273,115273,115275,0,2,3
32862,4,2,115277,115277,115279,0,2,2
32863,1,2,115278,115279,115281,1,3,0
32864,1,1,115279,115281,115282,2,3,0
32865,1,3,115280,115282,115285,2,5,0
32866,6,3,115286,115286,115289,0,3,1
32867,5,2,115291,115291,115293,0,2,2
32868,2,3,115293,115293,115296,0,3,0
32869,5,1,115298,115298,115299,0,1,2
32870,4,3,115302,115302,115305,0,3,3
32871,2,1,115304,115305,115306,1,2,0
32872,1,2,115305,115306,115308,1,3,0
32873,2,2,115307,115308,115310,1,3,0
32874,6,2,115313,115313,115315,0,2,3
32875,5,2,115318,115318,115320,0,2,3
32876,2,2,115320,115320,115322,0,2,0
32877,4,3,115324,115324,115327,0,3,2
32878,4,1,115328,115328,115329,0,1,1
32879,2,3,115330,115330,115333,0,3,1
32880,4,2,115334,115334,115336,0,2,1
32881,6,3,115340,115340,115343,0,3,4
32882,5,3,115345,115345,115348,0,3,2
32883,3,1,115348,115348,115349,0,1,0
32884,4,1,115352,115352,115353,0,1,3
32885,1,1,115353,115353,115354,0,1,0
32886,3,3,115356,115356,115359,0,3,2
32887,1,1,115357,115359,115360,2,3,0
32888,4,2,115361,115361,115363,0,2,1
32889,1,2,115362,115363,115365,1,3,0
32890,6,3,115368,115368,115371,0,3,3
32891,1,2,115369,115371,115373,2,4,0
32892,3,3,115372,115373,115376,1,4,0
32893,6,3,115378,115378,115381,0,3,2
32894,6,2,115384,115384,115386,0,2,3
32895,1,2,115385,115386,115388,1,3,0
32896,6,2,115391,115391,115393,0,2,3
32897,3,3,115394,115394,115397,0,3,1
32898,3,1,115397,115397,115398,0,1,0
32899,2,3,115399,115399,115402,0,3,1
32900,1,2,115400,115402,115404,2,4,0
32901,4,1,115404,115404,115405,0,1,0
32902,3,3,115407,115407,115410,0,3,2
32903,3,2,115410,115410,115412,0,2,0
32904,3,3,115413,115413,115416,0,3,1
32905,6,3,115419,115419,115422,0,3,3
32906,6,2,115425,115425,115427,0,2,3
32907,3,2,115428,115428,115430,0,2,1
32908,4,1,115432,115432,115433,0,1,2
32909,1,1,115433,115433,115434,0,1,0
32910,5,1,115438,115438,115439,0,1,4
32911,5,1,115443,115443,115444,0,1,4
32912,5,2,115448,115448,115450,0,2,4
32913,2,1,115450,115450,115451,0,1,0
32914,1,3,115451,115451,115454,0,3,0
32915,5,2,115456,115456,115458,0,2,2
32916,5,2,115461,115461,115463,0,2,3
32917,6,2,115467,115467,115469,0,2,4
32918,5,3,115472,115472,115475,0,3,3
32919,6,1,115478,115478,115479,0,1,3
32920,1,1,115479,115479,115480,0,1,0
32921,5,3,115484,115484,115487,0,3,4
32922,1,2,115485,115487,115489,2,4,0
32923,1,2,115486,115489,115491,3,5,0
32924,2,2,115488,115491,115493,3,5,0
32925,2,2,115490,115493,115495,3,5,0
32926,4,2,115494,115495,115497,1,3,0
32927,3,1,115497,115497,115498,0,1,0
32928,6,3,115503,115503,115506,0,3,5
32929,6,1,115509,115509,115510,0,1,3
32930,5,2,115514,115514,115516,0,2,4
32931,3,2,115517,115517,115519,0,2,1
32932,5,3,115522,115522,115525,0,3,3
32933,3,1,115525,115525,115526,0,1,0
32934,4,1,115529,115529,115530,0,1,3
32935,5,2,115534,115534,115536,0,2,4
32936,6,2,115540,115540,115542,0,2,4
32937,6,3,115546,115546,115549,0,3,4
32938,2,2,115548,115549,115551,1,3,0
32939,3,3,115551,115551,115554,0,3,0
32940,1,3,115552,115554,115557,2,5,0
32941,5,3,115557,115557,115560,0,3,0
32942,4,2,115561,115561,115563,0,2,1
32943,2,1,115563,115563,115564,0,1,0
32944,1,1,115564,115564,115565,0,1,0
32945,3,2,115567,115567,115569,0,2,2
32946,3,3,115570,115570,115573,0,3,1
32947,3,2,115573,115573,115575,0,2,0
32948,4,3,115577,115577,115580,0,3,2
32949,5,2,115582,115582,115584,0,2,2
32950,4,3,115586,115586,115589,0,3,2
32951,3,2,115589,115589,115591,0,2,0
32952,4,1,115593,115593,115594,0,1,2
32953,1,1,115594,115594,115595,0,1,0
32954,3,3,115597,115597,115600,0,3,2
32955,6,1,115603,115603,115604,0,1,3
32956,2,2,115605,115605,115607,0,2,1
32957,1,1,115606,115607,115608,1,2,0
32958,2,1,115608,115608,115609,0,1,0
32959,2,3,115610,115610,115613,0,3,1
32960,4,3,115614,115614,115617,0,3,1
32961,5,2,115619,115619,115621,0,2,2
32962,3,1,115622,115622,115623,0,1,1
32963,5,1,115627,115627,115628,0,1,4
32964,5,2,115632,115632,115634,0,2,4
32965,4,2,115636,115636,115638,0,2,2
32966,6,3,115642,115642,115645,0,3,4
32967,4,3,115646,115646,115649,0,3,1
32968,4,1,115650,115650,115651,0,1,1
32969,1,1,115651,115651,115652,0,1,0
32970,4,1,115655,115655,115656,0,1,3
32971,6,2,115661,115661,115663,0,2,5
32972,4,2,115665,115665,115667,0,2,2
32973,2,3,115667,115667,115670,0,3,0
32974,3,3,115670,115670,115673,0,3,0
32975,6,3,115676,115676,115679,0,3,3
32976,4,3,115680,115680,115683,0,3,1
32977,4,2,115684,115684,115686,0,2,1
32978,1,1,115685,115686,115687,1,2,0
32979,4,2,115689,115689,115691,0,2,2
32980,6,3,115695,115695,115698,0,3,4
32981,6,1,115701,115701,115702,0,1,3
32982,5,1,115706,115706,115707,0,1,4
32983,2,1,115708,115708,115709,0,1,1
32984,2,2,115710,115710,115712,0,2,1
32985,6,2,115716,115716,115718,0,2,4
32986,3,3,115719,115719,115722,0,3,1
32987,6,2,115725,115725,115727,0,2,3
32988,3,2,115728,115728,115730,0,2,1
32989,6,2,115734,115734,115736,0,2,4
32990,2,1,115736,115736,115737,0,1,0
32991,4,2,115740,115740,115742,0,2,3
32992,6,1,115746,115746,115747,0,1,4
32993,6,1,115752,115752,115753,0,1,5
32994,1,3,115753,115753,115756,0,3,0
32995,4,3,115757,115757,115760,0,3,1
32996,6,2,115763,115763,115765,0,2,3
32997,5,3,115768,115768,115771,0,3,3
32998,1,3,115769,115771,115774,2,5,0
32999,1,2,115770,115774,115776,4,6,0
33000,4,2,115774,115776,115778,2,4,0
33001,2,3,115776,115778,115781,2,5,0
33002,6,1,115782,115782,115783,0,1,1
33003,3,1,115785,115785,115786,0,1,2
33004,2,1,115787,115787,115788,0,1,1
33005,1,1,115788,115788,115789,0,1,0
33006,1,1,115789,115789,115790,0,1,0
33007,3,2,115792,115792,115794,0,2,2
33008,2,3,115794,115794,115797,0,3,0
33009,3,1,115797,115797,115798,0,1,0
33010,3,2,115800,115800,115802,0,2,2
33011,3,3,115803,115803,115806,0,3,1
33012,6,3,115809,115809,115812,0,3,3
33013,2,2,115811,115812,115814,1,3,0
33014,3,3,115814,115814,115817,0,3,0
33015,4,3,115818,115818,115821,0,3,1
33016,2,2,115820,115821,115823,1,3,0
33017,1,2,115821,115823,115825,2,4,0
33018,6,3,115827,115827,115830,0,3,2
33019,3,2,115830,115830,115832,0,2,0
33020,6,3,115836,115836,115839,0,3,4
33021,3,1,115839,115839,115840,0,1,0
33022,6,1,115845,115845,115846,0,1,5
33023,6,1,115851,115851,115852,0,1,5
33024,6,2,115857,115857,115859,0,2,5
33025,2,1,115859,115859,115860,0,1,0
33026,1,3,115860,115860,115863,0,3,0
33027,3,1,115863,115863,115864,0,1,0
33028,2,3,115865,115865,115868,0,3,1
33029,2,3,115867,115868,115871,1,4,0
33030,1,2,115868,115871,115873,3,5,0
33031,6,3,115874,115874,115877,0,3,1
33032,5,3,115879,115879,115882,0,3,2
33033,2,1,115881,115882,115883,1,2,0
33034,6,2,115887,115887,115889,0,2,4
33035,5,3,115892,115892,115895,0,3,3
33036,5,2,115897,115897,115899,0,2,2
33037,6,2,115903,115903,115905,0,2,4
33038,5,2,115908,115908,115910,0,2,3
33039,6,1,115914,115914,115915,0,1,4
33040,4,2,115918,115918,115920,0,2,3
33041,6,1,115924,115924,115925,0,1,4
33042,1,1,115925,115925,115926,0,1,0
33043,4,2,115929,115929,115931,0,2,3
33044,1,2,115930,115931,115933,1,3,0
33045,3,3,115933,115933,115936,0,3,0
33046,3,1,115936,115936,115937,0,1,0
33047,6,3,115942,115942,115945,0,3,5
33048,3,2,115945,115945,115947,0,2,0
33049,6,2,115951,115951,115953,0,2,4
33050,4,2,115955,115955,115957,0,2,2
33051,6,1,115961,115961,115962,0,1,4
33052,4,1,115965,115965,115966,0,1,3
33053,6,1,115971,115971,115972,0,1,5
33054,6,2,115977,115977,115979,0,2,5
33055,2,1,115979,115979,115980,0,1,0
33056,6,3,115985,115985,115988,0,3,5
33057,3,1,115988,115988,115989,0,1,0
33058,4,1,115992,115992,115993,0,1,3
33059,1,3,115993,115993,115996,0,3,0
33060,5,2,115998,115998,116000,0,2,2
33061,3,3,116001,116001,116004,0,3,1
33062,3,1,116004,116004,116005,0,1,0
33063,2,1,116006,116006,116007,0,1,1
33064,2,1,116008,116008,116009,0,1,1
33065,6,3,116014,116014,116017,0,3,5
33066,3,3,116017,116017,116020,0,3,0
33067,3,1,116020,116020,116021,0,1,0
33068,4,2,116024,116024,116026,0,2,3
33069,2,1,116026,116026,116027,0,1,0
33070,2,1,116028,116028,116029,0,1,1
33071,6,1,116034,116034,116035,0,1,5
33072,1,1,116035,116035,116036,0,1,0
33073,5,2,116040,116040,116042,0,2,4
33074,6,1,116046,116046,116047,0,1,4
33075,4,3,116050,116050,116053,0,3,3
33076,5,1,116055,116055,116056,0,1,2
33077,5,2,116060,116060,116062,0,2,4
33078,1,2,116061,116062,116064,1,3,0
33079,1,2,116062,116064,116066,2,4,0
33080,1,2,116063,116066,116068,3,5,0
33081,3,2,116066,116068,116070,2,4,0
33082,2,2,116068,116070,116072,2,4,0
33083,1,2,116069,116072,116074,3,5,0
33084,5,1,116074,116074,116075,0,1,0
33085,1,3,116075,116075,116078,0,3,0
33086,1,2,116076,116078,116080,2,4,0
33087,4,1,116080,116080,116081,0,1,0
33088,3,1,116083,116083,116084,0,1,2
33089,1,3,116084,116084,116087,0,3,0
33090,5,2,116089,116089,116091,0,2,2
33091,4,2,116093,116093,116095,0,2,2
33092,1,3,116094,116095,116098,1,4,0
33093,6,3,116100,116100,116103,0,3,2
33094,6,2,116106,116106,116108,0,2,3
33095,1,2,116107,116108,116110,1,3,0
33096,4,1,116111,116111,116112,0,1,1
33097,1,1,116112,116112,116113,0,1,0
33098,6,3,116118,116118,116121,0,3,5
33099,5,2,116123,116123,116125,0,2,2
33100,3,1,116126,116126,116127,0,1,1
33101,4,3,116130,116130,116133,0,3,3
33102,6,2,116136,116136,116138,0,2,3
33103,2,2,116138,116138,116140,0,2,0
33104,6,3,116144,116144,116147,0,3,4
33105,4,3,116148,116148,116151,0,3,1
33106,4,1,116152,116152,116153,0,1,1
33107,3,2,116155,116155,116157,0,2,2
33108,6,3,116161,116161,116164,0,3,4
33109,3,3,116164,116164,116167,0,3,0
33110,5,1,116169,116169,116170,0,1,2
33111,5,2,116174,116174,116176,0,2,4
33112,5,3,116179,116179,116182,0,3,3
33113,6,1,116185,116185,116186,0,1,3
33114,3,1,116188,116188,116189,0,1,2
33115,2,3,116190,116190,116193,0,3,1
33116,5,3,116195,116195,116198,0,3,2
33117,6,1,116201,116201,116202,0,1,3
33118,5,3,116206,116206,116209,0,3,4
33119,2,1,116208,116209,116210,1,2,0
33120,6,1,116214,116214,116215,0,1,4
33121,2,2,116216,116216,116218,0,2,1
33122,2,3,116218,116218,116221,0,3,0
33123,3,3,116221,116221,116224,0,3,0
33124,4,3,116225,116225,116228,0,3,1
33125,3,2,116228,116228,116230,0,2,0
33126,4,1,116232,116232,116233,0,1,2
33127,4,1,116236,116236,116237,0,1,3
33128,6,3,116242,116242,116245,0,3,5
33129,6,1,116248,116248,116249,0,1,3
33130,5,1,116253,116253,116254,0,1,4
33131,5,2,116258,116258,116260,0,2,4
33132,1,1,116259,116260,116261,1,2,0
33133,1,1,116260,116261,116262,1,2,0
33134,1,3,116261,116262,116265,1,4,0
33135,5,1,116266,116266,116267,0,1,1
33136,2,2,116268,116268,116270,0,2,1
33137,1,2,116269,116270,116272,1,3,0
33138,3,2,116272,116272,116274,0,2,0
33139,3,2,116275,116275,116277,0,2,1
33140,2,3,116277,116277,116280,0,3,0
33141,6,3,116283,116283,116286,0,3,3
33142,6,3,116289,116289,116292,0,3,3
33143,2,1,116291,116292,116293,1,2,0
33144,2,1,116293,116293,116294,0,1,0
33145,3,1,116296,116296,116297,0,1,2
33146,1,3,116297,116297,116300,0,3,0
33147,2,1,116299,116300,116301,1,2,0
33148,5,1,116304,116304,116305,0,1,3
33149,2,2,116306,116306,116308,0,2,1
33150,5,1,116311,116311,116312,0,1,3
33151,5,3,116316,116316,116319,0,3,4
33152,1,1,116317,116319,116320,2,3,0
33153,2,1,116319,116320,116321,1,2,0
33154,5,1,116324,116324,116325,0,1,3
33155,5,2,116329,116329,116331,0,2,4
33156,5,3,116334,116334,116337,0,3,3
33157,4,2,116338,116338,116340,0,2,1
33158,3,1,116341,116341,116342,0,1,1
33159,6,1,116347,116347,116348,0,1,5
33160,1,3,116348,116348,116351,0,3,0
33161,2,1,116350,116351,116352,1,2,0
33162,1,2,116351,116352,116354,1,3,0
33163,4,3,116355,116355,116358,0,3,1
33164,2,3,116357,116358,116361,1,4,0
33165,3,3,116360,116361,116364,1,4,0
33166,4,1,116364,116364,116365,0,1,0
33167,1,3,116365,116365,116368,0,3,0
33168,4,2,116369,116369,116371,0,2,1
33169,3,1,116372,116372,116373,0,1,1
33170,4,3,116376,116376,116379,0,3,3
33171,6,2,116382,116382,116384,0,2,3
33172,1,1,116383,116384,116385,1,2,0
33173,1,1,116384,116385,116386,1,2,0
33174,5,3,116389,116389,116392,0,3,3
33175,4,3,116393,116393,116396,0,3,1
33176,4,2,116397,116397,116399,0,2,1
33177,1,1,116398,116399,116400,1,2,0
33178,3,3,116401,116401,116404,0,3,1
33179,3,3,116404,116404,116407,0,3,0
33180,3,1,116407,116407,116408,0,1,0
33181,1,3,116408,116408,116411,0,3,0
33182,5,3,116413,116413,116416,0,3,2
33183,2,3,116415,116416,116419,1,4,0
33184,3,1,116418,116419,116420,1,2,0
33185,5,2,116423,116423,116425,0,2,3
33186,6,1,116429,116429,116430,0,1,4
33187,4,3,116433,116433,116436,0,3,3
33188,4,3,116437,116437,116440,0,3,1
33189,5,2,116442,116442,116444,0,2,2
33190,4,3,116446,116446,116449,0,3,2
33191,2,3,116448,116449,116452,1,4,0
33192,3,1,116451,116452,116453,1,2,0
33193,4,1,116455,116455,116456,0,1,2
33194,3,1,116458,116458,116459,0,1,2
33195,4,2,116462,116462,116464,0,2,3
33196,1,3,116463,116464,116467,1,4,0
33197,1,3,116464,116467,116470,3,6,0
33198,4,3,116468,116470,116473,2,5,0
33199,3,1,116471,116473,116474,2,3,0
33200,5,3,116476,116476,116479,0,3,2
33201,1,2,116477,116479,116481,2,4,0
33202,5,1,116482,116482,116483,0,1,1
33203,5,3,116487,116487,116490,0,3,4
33204,6,2,116493,116493,116495,0,2,3
33205,1,1,116494,116495,116496,1,2,0
33206,5,1,116499,116499,116500,0,1,3
33207,1,3,116500,116500,116503,0,3,0
33208,3,1,116503,116503,116504,0,1,0
33209,6,1,116509,116509,116510,0,1,5
33210,2,3,116511,116511,116514,0,3,1
33211,3,1,116514,116514,116515,0,1,0
33212,2,3,116516,116516,116519,0,3,1
33213,3,3,116519,116519,116522,0,3,0
33214,2,3,116521,116522,116525,1,4,0
33215,6,3,116527,116527,116530,0,3,2
33216,6,2,116533,116533,116535,0,2,3
33217,3,2,116536,116536,116538,0,2,1
33218,6,2,116542,116542,116544,0,2,4
33219,5,1,116547,116547,116548,0,1,3
33220,2,2,116549,116549,116551,0,2,1
33221,6,3,116555,116555,116558,0,3,4
33222,2,1,116557,116558,116559,1,2,0
33223,6,2,116563,116563,116565,0,2,4
33224,4,3,116567,116567,116570,0,3,2
33225,3,2,116570,116570,116572,0,2,0
33226,1,1,116571,116572,116573,1,2,0
33227,4,1,116575,116575,116576,0,1,2
33228,5,2,116580,116580,116582,0,2,4
33229,4,1,116584,116584,116585,0,1,2
33230,2,2,116586,116586,116588,0,2,1
33231,2,3,116588,116588,116591,0,3,0
33232,4,3,116592,116592,116595,0,3,1
33233,1,1,116593,116595,116596,2,3,0
33234,4,2,116597,116597,116599,0,2,1
33235,3,3,116600,116600,116603,0,3,1
33236,4,2,116604,116604,116606,0,2,1
33237,3,1,116607,116607,116608,0,1,1
33238,1,3,116608,116608,116611,0,3,0
33239,2,2,116610,116611,116613,1,3,0
33240,3,2,116613,116613,116615,0,2,0
33241,1,1,116614,116615,116616,1,2,0
33242,2,1,116616,116616,116617,0,1,0
33243,4,1,116620,116620,116621,0,1,3
33244,3,3,116623,116623,116626,0,3,2
33245,3,3,116626,116626,116629,0,3,0
33246,1,2,116627,116629,116631,2,4,0
33247,2,2,116629,116631,116633,2,4,0
33248,5,2,116634,116634,116636,0,2,1
33249,2,1,116636,116636,116637,0,1,0
33250,2,1,116638,116638,116639,0,1,1
33251,5,2,116643,116643,116645,0,2,4
33252,2,3,116645,116645,116648,0,3,0
33253,2,1,116647,116648,116649,1,2,0
33254,5,1,116652,116652,116653,0,1,3
33255,3,2,116655,116655,116657,0,2,2
33256,2,3,116657,116657,116660,0,3,0
33257,6,1,116663,116663,116664,0,1,3
33258,2,3,116665,116665,116668,0,3,1
33259,5,3,116670,116670,116673,0,3,2
33260,3,1,116673,116673,116674,0,1,0
33261,1,2,116674,116674,116676,0,2,0
33262,3,1,116677,116677,116678,0,1,1
33263,5,1,116682,116682,116683,0,1,4
33264,5,3,116687,116687,116690,0,3,4
33265,2,3,116689,116690,116693,1,4,0
33266,4,1,116693,116693,116694,0,1,0
33267,5,2,116698,116698,116700,0,2,4
33268,4,1,116702,116702,116703,0,1,2
33269,3,3,116705,116705,116708,0,3,2
33270,5,1,116710,116710,116711,0,1,2
33271,2,2,116712,116712,116714,0,2,1
33272,1,1,116713,116714,116715,1,2,0
33273,1,1,116714,116715,116716,1,2,0
33274,2,3,116716,116716,116719,0,3,0
33275,6,1,116722,116722,116723,0,1,3
33276,6,1,116728,116728,116729,0,1,5
33277,3,3,116731,116731,116734,0,3,2
33278,4,2,116735,116735,116737,0,2,1
33279,6,2,116741,116741,116743,0,2,4
33280,1,3,116742,116743,116746,1,4,0
33281,2,2,116744,116746,116748,2,4,0
33282,1,2,116745,116748,116750,3,5,0
33283,3,1,116748,116750,116751,2,3,0
33284,3,1,116751,116751,116752,0,1,0
33285,5,1,116756,116756,116757,0,1,4
33286,4,1,116760,116760,116761,0,1,3
33287,3,3,116763,116763,116766,0,3,2
33288,5,2,116768,116768,116770,0,2,2
33289,6,2,116774,116774,116776,0,2,4
33290,5,3,116779,116779,116782,0,3,3
33291,1,2,116780,116782,116784,2,4,0
33292,5,2,116785,116785,116787,0,2,1
33293,2,2,116787,116787,116789,0,2,0
33294,5,3,116792,116792,116795,0,3,3
33295,1,3,116793,116795,116798,2,5,0
33296,3,2,116796,116798,116800,2,4,0
33297,6,3,116802,116802,116805,0,3,2
33298,6,2,116808,116808,116810,0,2,3
33299,4,1,116812,116812,116813,0,1,2
33300,4,2,116816,116816,116818,0,2,3
33301,6,3,116822,116822,116825,0,3,4
33302,2,3,116824,116825,116828,1,4,0
33303,2,1,116826,116828,116829,2,3,0
33304,5,2,116831,116831,116833,0,2,2
33305,2,1,116833,116833,116834,0,1,0
33306,1,1,116834,116834,116835,0,1,0
33307,5,3,116839,116839,116842,0,3,4
33308,4,3,116843,116843,116846,0,3,1
33309,1,1,116844,116846,116847,2,3,0
33310,3,3,116847,116847,116850,0,3,0
33311,5,1,116852,116852,116853,0,1,2
33312,1,1,116853,116853,116854,0,1,0
33313,3,3,116856,116856,116859,0,3,2
33314,3,1,116859,116859,116860,0,1,0
33315,5,3,116864,116864,116867,0,3,4
33316,1,1,116865,116867,116868,2,3,0
33317,6,2,116871,116871,116873,0,2,3
33318,3,3,116874,116874,116877,0,3,1
33319,6,1,116880,116880,116881,0,1,3
33320,1,1,116881,116881,116882,0,1,0
33321,1,3,116882,116882,116885,0,3,0
33322,4,1,116886,116886,116887,0,1,1
33323,6,3,116892,116892,116895,0,3,5
33324,2,3,116894,116895,116898,1,4,0
33325,3,3,116897,116898,116901,1,4,0
33326,6,1,116903,116903,116904,0,1,2
33327,4,3,116907,116907,116910,0,3,3
33328,5,3,116912,116912,116915,0,3,2
33329,3,1,116915,116915,116916,0,1,0
33330,3,1,116918,116918,116919,0,1,2
33331,2,3,116920,116920,116923,0,3,1
33332,6,1,116926,116926,116927,0,1,3
33333,4,3,116930,116930,116933,0,3,3
33334,1,3,116931,116933,116936,2,5,0
33335,5,1,116936,116936,116937,0,1,0
33336,3,3,116939,116939,116942,0,3,2
33337,3,3,116942,116942,116945,0,3,0
33338,1,2,116943,116945,116947,2,4,0
33339,3,2,116946,116947,116949,1,3,0
33340,4,1,116950,116950,116951,0,1,1
33341,3,1,116953,116953,116954,0,1,2
33342,1,2,116954,116954,116956,0,2,0
33343,6,1,116960,116960,116961,0,1,4
33344,2,3,116962,116962,116965,0,3,1
33345,3,2,116965,116965,116967,0,2,0
33346,5,3,116970,116970,116973,0,3,3
33347,5,3,116975,116975,116978,0,3,2
33348,2,1,116977,116978,116979,1,2,0
33349,5,1,116982,116982,116983,0,1,3
33350,5,1,116987,116987,116988,0,1,4
33351,4,1,116991,116991,116992,0,1,3
33352,6,2,116997,116997,116999,0,2,5
33353,3,2,117000,117000,117002,0,2,1
33354,6,2,117006,117006,117008,0,2,4
33355,5,2,117011,117011,117013,0,2,3
33356,1,2,117012,117013,117015,1,3,0
33357,1,3,117013,117015,117018,2,5,0
33358,4,3,117017,117018,117021,1,4,0
33359,1,2,117018,117021,117023,3,5,0
33360,3,2,117021,117023,117025,2,4,0
33361,1,3,117022,117025,117028,3,6,0
33362,2,1,117024,117028,117029,4,5,0
33363,5,2,117029,117029,117031,0,2,0
33364,6,1,117035,117035,117036,0,1,4
33365,3,1,117038,117038,117039,0,1,2
33366,5,2,117043,117043,117045,0,2,4
33367,3,3,117046,117046,117049,0,3,1
33368,5,1,117051,117051,117052,0,1,2
33369,3,3,117054,117054,117057,0,3,2
33370,2,1,117056,117057,117058,1,2,0
33371,2,2,117058,117058,117060,0,2,0
33372,5,3,117063,117063,117066,0,3,3
33373,1,1,117064,117066,117067,2,3,0
33374,2,3,117066,117067,117070,1,4,0
33375,5,1,117071,117071,117072,0,1,1
33376,2,1,117073,117073,117074,0,1,1
33377,5,3,117078,117078,117081,0,3,4
33378,1,3,117079,117081,117084,2,5,0
33379,2,3,117081,117084,117087,3,6,0
33380,6,1,117087,117087,117088,0,1,0
33381,5,2,117092,117092,117094,0,2,4
33382,4,1,117096,117096,117097,0,1,2
33383,4,3,117100,117100,117103,0,3,3
33384,1,2,117101,117103,117105,2,4,0
33385,5,1,117106,117106,117107,0,1,1
33386,3,2,117109,117109,117111,0,2,2
33387,2,3,117111,117111,117114,0,3,0
33388,3,3,117114,117114,117117,0,3,0
33389,4,1,117118,117118,117119,0,1,1
33390,5,2,117123,117123,117125,0,2,4
33391,5,3,117128,117128,117131,0,3,3
33392,5,3,117133,117133,117136,0,3,2
33393,3,1,117136,117136,117137,0,1,0
33394,5,3,117141,117141,117144,0,3,4
33395,4,3,117145,117145,117148,0,3,1
33396,6,1,117151,117151,117152,0,1,3
33397,1,1,117152,117152,117153,0,1,0
33398,2,3,117154,117154,117157,0,3,1
33399,4,2,117158,117158,117160,0,2,1
33400,6,3,117164,117164,117167,0,3,4
33401,4,3,117168,117168,117171,0,3,1
33402,3,1,117171,117171,117172,0,1,0
33403,5,2,117176,117176,117178,0,2,4
33404,5,2,117181,117181,117183,0,2,3
33405,5,1,117186,117186,117187,0,1,3
33406,4,3,117190,117190,117193,0,3,3
33407,5,2,117195,117195,117197,0,2,2
33408,1,2,117196,117197,117199,1,3,0
33409,4,1,117200,117200,117201,0,1,1
33410,1,1,117201,117201,117202,0,1,0
33411,6,1,117207,117207,117208,0,1,5
33412,1,2,117208,117208,117210,0,2,0
33413,4,3,117212,117212,117215,0,3,2
33414,6,3,117218,117218,117221,0,3,3
33415,1,2,117219,117221,117223,2,4,0
33416,5,1,117224,117224,117225,0,1,1
33417,5,1,117229,117229,117230,0,1,4
33418,2,3,117231,117231,117234,0,3,1
33419,3,3,117234,117234,117237,0,3,0
33420,5,3,117239,117239,117242,0,3,2
33421,2,3,117241,117242,117245,1,4,0
33422,5,1,117246,117246,117247,0,1,1
33423,5,3,117251,117251,117254,0,3,4
33424,2,1,117253,117254,117255,1,2,0
33425,4,3,117257,117257,117260,0,3,2
33426,3,2,117260,117260,117262,0,2,0
33427,2,1,117262,117262,117263,0,1,0
33428,5,1,117267,117267,117268,0,1,4
33429,3,3,117270,117270,117273,0,3,2
33430,2,3,117272,117273,117276,1,4,0
33431,6,1,117278,117278,117279,0,1,2
33432,2,1,117280,117280,117281,0,1,1
33433,1,2,117281,117281,117283,0,2,0
33434,6,1,117287,117287,117288,0,1,4
33435,4,2,117291,117291,117293,0,2,3
33436,3,2,117294,117294,117296,0,2,1
33437,6,3,117300,117300,117303,0,3,4
33438,2,1,117302,117303,117304,1,2,0
33439,6,3,117308,117308,117311,0,3,4
33440,6,3,117314,117314,117317,0,3,3
33441,2,1,117316,117317,117318,1,2,0
33442,6,1,117322,117322,117323,0,1,4
33443,3,2,117325,117325,117327,0,2,2
33444,5,2,117330,117330,117332,0,2,3
33445,1,3,117331,117332,117335,1,4,0
33446,2,1,117333,117335,117336,2,3,0
33447,1,3,117334,117336,117339,2,5,0
33448,2,2,117336,117339,117341,3,5,0
33449,6,1,117342,117342,117343,0,1,1
33450,1,3,117343,117343,117346,0,3,0
33451,1,3,117344,117346,117349,2,5,0
33452,6,3,117350,117350,117353,0,3,1
33453,2,1,117352,117353,117354,1,2,0
33454,6,2,117358,117358,117360,0,2,4
33455,5,1,117363,117363,117364,0,1,3
33456,2,1,117365,117365,117366,0,1,1
33457,2,2,117367,117367,117369,0,2,1
33458,1,1,117368,117369,117370,1,2,0
33459,4,1,117372,117372,117373,0,1,2
33460,3,2,117375,117375,117377,0,2,2
33461,5,3,117380,117380,117383,0,3,3
33462,1,2,117381,117383,117385,2,4,0
33463,3,1,117384,117385,117386,1,2,0
33464,1,3,117385,117386,117389,1,4,0
33465,1,1,117386,117389,117390,3,4,0
33466,1,3,117387,117390,117393,3,6,0
33467,2,2,117389,117393,117395,4,6,0
33468,2,3,117391,117395,117398,4,7,0
33469,4,2,117395,117398,117400,3,5,0
33470,5,3,117400,117400,117403,0,3,0
33471,2,2,117402,117403,117405,1,3,0
33472,6,1,117408,117408,117409,0,1,3
33473,6,1,117414,117414,117415,0,1,5
33474,3,3,117417,117417,117420,0,3,2
33475,2,2,117419,117420,117422,1,3,0
33476,2,1,117421,117422,117423,1,2,0
33477,5,3,117426,117426,117429,0,3,3
33478,5,3,117431,117431,117434,0,3,2
33479,1,3,117432,117434,117437,2,5,0
33480,6,3,117438,117438,117441,0,3,1
33481,3,1,117441,117441,117442,0,1,0
33482,4,1,117445,117445,117446,0,1,3
33483,5,1,117450,117450,117451,0,1,4
33484,3,3,117453,117453,117456,0,3,2
33485,2,3,117455,117456,117459,1,4,0
33486,2,1,117457,117459,117460,2,3,0
33487,4,2,117461,117461,117463,0,2,1
33488,1,1,117462,117463,117464,1,2,0
33489,4,2,117466,117466,117468,0,2,2
33490,6,3,117472,117472,117475,0,3,4
33491,5,2,117477,117477,117479,0,2,2
33492,1,3,117478,117479,117482,1,4,0
33493,4,1,117482,117482,117483,0,1,0
33494,2,3,117484,117484,117487,0,3,1
33495,6,2,117490,117490,117492,0,2,3
33496,4,2,117494,117494,117496,0,2,2
33497,3,2,117497,117497,117499,0,2,1
33498,6,3,117503,117503,117506,0,3,4
33499,6,3,117509,117509,117512,0,3,3
33500,5,1,117514,117514,117515,0,1,2
33501,1,3,117515,117515,117518,0,3,0
33502,2,2,117517,117518,117520,1,3,0
33503,5,1,117522,117522,117523,0,1,2
33504,3,2,117525,117525,117527,0,2,2
33505,2,1,117527,117527,117528,0,1,0
33506,2,2,117529,117529,117531,0,2,1
33507,3,1,117532,117532,117533,0,1,1
33508,6,3,117538,117538,117541,0,3,5
33509,1,2,117539,117541,117543,2,4,0
33510,5,2,117544,117544,117546,0,2,1
33511,2,3,117546,117546,117549,0,3,0
33512,1,3,117547,117549,117552,2,5,0
33513,4,3,117551,117552,117555,1,4,0
33514,1,3,117552,117555,117558,3,6,0
33515,4,3,117556,117558,117561,2,5,0
33516,4,2,117560,117561,117563,1,3,0
33517,1,2,117561,117563,117565,2,4,0
33518,1,2,117562,117565,117567,3,5,0
33519,4,1,117566,117567,117568,1,2,0
33520,3,2,117569,117569,117571,0,2,1
33521,2,1,117571,117571,117572,0,1,0
33522,1,2,117572,117572,117574,0,2,0
33523,6,3,117578,117578,117581,0,3,4
33524,2,3,117580,117581,117584,1,4,0
33525,5,2,117585,117585,117587,0,2,1
33526,6,3,117591,117591,117594,0,3,4
33527,4,2,117595,117595,117597,0,2,1
33528,2,3,117597,117597,117600,0,3,0
33529,1,1,117598,117600,117601,2,3,0
33530,1,1,117599,117601,117602,2,3,0
33531,5,1,117604,117604,117605,0,1,2
33532,5,2,117609,117609,117611,0,2,4
33533,3,2,117612,117612,117614,0,2,1
33534,2,3,117614,117614,117617,0,3,0
33535,3,1,117617,117617,117618,0,1,0
33536,6,1,117623,117623,117624,0,1,5
33537,4,3,117627,117627,117630,0,3,3
33538,4,1,117631,117631,117632,0,1,1
33539,3,3,117634,117634,117637,0,3,2
33540,5,1,117639,117639,117640,0,1,2
33541,6,2,117645,117645,117647,0,2,5
33542,6,3,117651,117651,117654,0,3,4
33543,1,1,117652,117654,117655,2,3,0
33544,6,3,117658,117658,117661,0,3,3
33545,1,2,117659,117661,117663,2,4,0
33546,4,1,117663,117663,117664,0,1,0
33547,5,1,117668,117668,117669,0,1,4
33548,2,2,117670,117670,117672,0,2,1
33549,5,3,117675,117675,117678,0,3,3
33550,5,3,117680,117680,117683,0,3,2
33551,6,3,117686,117686,117689,0,3,3
33552,4,3,117690,117690,117693,0,3,1
33553,2,1,117692,117693,117694,1,2,0
33554,6,1,117698,117698,117699,0,1,4
33555,1,1,117699,117699,117700,0,1,0
33556,3,3,117702,117702,117705,0,3,2
33557,6,1,117708,117708,117709,0,1,3
33558,6,3,117714,117714,117717,0,3,5
33559,2,3,117716,117717,117720,1,4,0
33560,1,1,117717,117720,117721,3,4,0
33561,6,2,117723,117723,117725,0,2,2
33562,5,1,117728,117728,117729,0,1,3
33563,1,3,117729,117729,117732,0,3,0
33564,4,1,117733,117733,117734,0,1,1
33565,2,2,117735,117735,117737,0,2,1
33566,2,1,117737,117737,117738,0,1,0
33567,2,1,117739,117739,117740,0,1,1
33568,1,2,117740,117740,117742,0,2,0
33569,1,3,117741,117742,117745,1,4,0
33570,1,2,117742,117745,117747,3,5,0
33571,4,3,117746,117747,117750,1,4,0
33572,1,1,117747,117750,117751,3,4,0
33573,4,3,117751,117751,117754,0,3,0
33574,4,1,117755,117755,117756,0,1,1
33575,1,1,117756,117756,117757,0,1,0
33576,5,3,117761,117761,117764,0,3,4
33577,6,2,117767,117767,117769,0,2,3
33578,2,1,117769,117769,117770,0,1,0
33579,5,2,117774,117774,117776,0,2,4
33580,1,2,117775,117776,117778,1,3,0
33581,4,1,117779,117779,117780,0,1,1
33582,5,3,117784,117784,117787,0,3,4
33583,1,2,117785,117787,117789,2,4,0
33584,5,1,117790,117790,117791,0,1,1
33585,5,2,117795,117795,117797,0,2,4
33586,6,2,117801,117801,117803,0,2,4
33587,1,3,117802,117803,117806,1,4,0
33588,3,2,117805,117806,117808,1,3,0
33589,5,2,117810,117810,117812,0,2,2
33590,3,1,117813,117813,117814,0,1,1
33591,5,2,117818,117818,117820,0,2,4
33592,5,3,117823,117823,117826,0,3,3
33593,4,1,117827,117827,117828,0,1,1
33594,4,3,117831,117831,117834,0,3,3
33595,3,1,117834,117834,117835,0,1,0
33596,3,1,117837,117837,117838,0,1,2
33597,1,3,117838,117838,117841,0,3,0
33598,4,1,117842,117842,117843,0,1,1
33599,3,1,117845,117845,117846,0,1,2
33600,5,1,117850,117850,117851,0,1,4
33601,2,3,117852,117852,117855,0,3,1
33602,6,2,117858,117858,117860,0,2,3
33603,4,1,117862,117862,117863,0,1,2
33604,5,1,117867,117867,117868,0,1,4
33605,3,3,117870,117870,117873,0,3,2
33606,5,3,117875,117875,117878,0,3,2
33607,5,3,117880,117880,117883,0,3,2
33608,1,1,117881,117883,117884,2,3,0
33609,4,2,117885,117885,117887,0,2,1
33610,2,2,117887,117887,117889,0,2,0
33611,5,2,117892,117892,117894,0,2,3
33612,5,2,117897,117897,117899,0,2,3
33613,2,3,117899,117899,117902,0,3,0
33614,6,1,117905,117905,117906,0,1,3
33615,2,3,117907,117907,117910,0,3,1
33616,5,1,117912,117912,117913,0,1,2
33617,6,1,117918,117918,117919,0,1,5
33618,1,1,117919,117919,117920,0,1,0
33619,3,3,117922,117922,117925,0,3,2
33620,6,3,117928,117928,117931,0,3,3
33621,2,1,117930,117931,117932,1,2,0
33622,3,2,117933,117933,117935,0,2,1
33623,3,2,117936,117936,117938,0,2,1
33624,2,3,117938,117938,117941,0,3,0
33625,2,3,117940,117941,117944,1,4,0
33626,4,2,117944,117944,117946,0,2,0
33627,5,2,117949,117949,117951,0,2,3
33628,1,1,117950,117951,117952,1,2,0
33629,6,2,117956,117956,117958,0,2,4
33630,5,2,117961,117961,117963,0,2,3
33631,6,2,117967,117967,117969,0,2,4
33632,1,2,117968,117969,117971,1,3,0
33633,5,3,117973,117973,117976,0,3,2
33634,4,3,117977,117977,117980,0,3,1
33635,4,3,117981,117981,117984,0,3,1
33636,6,3,117987,117987,117990,0,3,3
33637,1,1,117988,117990,117991,2,3,0
33638,2,1,117990,117991,117992,1,2,0
33639,6,2,117996,117996,117998,0,2,4
33640,4,1,118000,118000,118001,0,1,2
33641,1,1,118001,118001,118002,0,1,0
33642,5,2,118006,118006,118008,0,2,4
33643,5,3,118011,118011,118014,0,3,3
33644,4,3,118015,118015,118018,0,3,1
33645,3,3,118018,118018,118021,0,3,0
33646,6,3,118024,118024,118027,0,3,3
33647,4,2,118028,118028,118030,0,2,1
33648,6,3,118034,118034,118037,0,3,4
33649,6,3,118040,118040,118043,0,3,3
33650,3,1,118043,118043,118044,0,1,0
33651,5,3,118048,118048,118051,0,3,4
33652,5,3,118053,118053,118056,0,3,2
33653,2,2,118055,118056,118058,1,3,0
33654,1,2,118056,118058,118060,2,4,0
33655,5,2,118061,118061,118063,0,2,1
33656,3,2,118064,118064,118066,0,2,1
33657,3,3,118067,118067,118070,0,3,1
33658,3,3,118070,118070,118073,0,3,0
33659,6,3,118076,118076,118079,0,3,3
33660,5,3,118081,118081,118084,0,3,2
33661,6,1,118087,118087,118088,0,1,3
33662,5,1,118092,118092,118093,0,1,4
33663,3,1,118095,118095,118096,0,1,2
33664,6,2,118101,118101,118103,0,2,5
33665,3,1,118104,118104,118105,0,1,1
33666,4,3,118108,118108,118111,0,3,3
33667,2,1,118110,118111,118112,1,2,0
33668,6,2,118116,118116,118118,0,2,4
33669,1,3,118117,118118,118121,1,4,0
33670,1,3,118118,118121,118124,3,6,0
33671,2,1,118120,118124,118125,4,5,0
33672,1,2,118121,118125,118127,4,6,0
33673,6,2,118127,118127,118129,0,2,0
33674,6,2,118133,118133,118135,0,2,4
33675,3,2,118136,118136,118138,0,2,1
33676,6,2,118142,118142,118144,0,2,4
33677,1,1,118143,118144,118145,1,2,0
33678,1,1,118144,118145,118146,1,2,0
33679,5,3,118149,118149,118152,0,3,3
33680,1,2,118150,118152,118154,2,4,0
33681,2,2,118152,118154,118156,2,4,0
33682,6,2,118158,118158,118160,0,2,2
33683,5,3,118163,118163,118166,0,3,3
33684,5,1,118168,118168,118169,0,1,2
33685,4,2,118172,118172,118174,0,2,3
33686,5,1,118177,118177,118178,0,1,3
33687,5,3,118182,118182,118185,0,3,4
33688,5,1,118187,118187,118188,0,1,2
33689,3,2,118190,118190,118192,0,2,2
33690,5,1,118195,118195,118196,0,1,3
33691,6,2,118201,118201,118203,0,2,5
33692,6,3,118207,118207,118210,0,3,4
33693,1,2,118208,118210,118212,2,4,0
33694,2,2,118210,118212,118214,2,4,0
33695,1,2,118211,118214,118216,3,5,0
33696,6,1,118217,118217,118218,0,1,1
33697,5,3,118222,118222,118225,0,3,4
33698,5,1,118227,118227,118228,0,1,2
33699,2,1,118229,118229,118230,0,1,1
33700,3,2,118232,118232,118234,0,2,2
33701,2,2,118234,118234,118236,0,2,0
33702,4,3,118238,118238,118241,0,3,2
33703,1,2,118239,118241,118243,2,4,0
33704,6,1,118245,118245,118246,0,1,2
33705,6,2,118251,118251,118253,0,2,5
33706,4,2,118255,118255,118257,0,2,2
33707,4,3,118259,118259,118262,0,3,2
33708,4,2,118263,118263,118265,0,2,1
33709,3,1,118266,118266,118267,0,1,1
33710,5,3,118271,118271,118274,0,3,4
33711,1,1,118272,118274,118275,2,3,0
33712,3,2,118275,118275,118277,0,2,0
33713,2,2,118277,118277,118279,0,2,0
33714,2,1,118279,118279,118280,0,1,0
33715,1,3,118280,118280,118283,0,3,0
33716,4,3,118284,118284,118287,0,3,1
33717,4,3,118288,118288,118291,0,3,1
33718,6,1,118294,118294,118295,0,1,3
33719,6,1,118300,118300,118301,0,1,5
33720,4,2,118304,118304,118306,0,2,3
33721,2,1,118306,118306,118307,0,1,0
33722,4,2,118310,118310,118312,0,2,3
33723,1,2,118311,118312,118314,1,3,0
33724,6,1,118317,118317,118318,0,1,3
33725,2,2,118319,118319,118321,0,2,1
33726,2,3,118321,118321,118324,0,3,0
33727,6,3,118327,118327,118330,0,3,3
33728,6,1,118333,118333,118334,0,1,3
33729,5,1,118338,118338,118339,0,1,4
33730,1,3,118339,118339,118342,0,3,0
33731,2,3,118341,118342,118345,1,4,0
33732,6,1,118347,118347,118348,0,1,2
33733,6,3,118353,118353,118356,0,3,5
33734,1,3,118354,118356,118359,2,5,0
33735,2,1,118356,118359,118360,3,4,0
33736,4,1,118360,118360,118361,0,1,0
33737,4,1,118364,118364,118365,0,1,3
33738,2,3,118366,118366,118369,0,3,1
33739,3,2,118369,118369,118371,0,2,0
33740,5,1,118374,118374,118375,0,1,3
33741,3,2,118377,118377,118379,0,2,2
33742,6,3,118383,118383,118386,0,3,4
33743,5,2,118388,118388,118390,0,2,2
33744,6,1,118394,118394,118395,0,1,4
33745,5,3,118399,118399,118402,0,3,4
33746,5,3,118404,118404,118407,0,3,2
33747,4,2,118408,118408,118410,0,2,1
33748,5,2,118413,118413,118415,0,2,3
33749,5,1,118418,118418,118419,0,1,3
33750,3,3,118421,118421,118424,0,3,2
33751,5,1,118426,118426,118427,0,1,2
33752,6,2,118432,118432,118434,0,2,5
33753,4,3,118436,118436,118439,0,3,2
33754,1,1,118437,118439,118440,2,3,0
33755,5,2,118442,118442,118444,0,2,2
33756,2,1,118444,118444,118445,0,1,0
33757,3,3,118447,118447,118450,0,3,2
33758,4,1,118451,118451,118452,0,1,1
33759,6,1,118457,118457,118458,0,1,5
33760,3,1,118460,118460,118461,0,1,2
33761,6,1,118466,118466,118467,0,1,5
33762,3,2,118469,118469,118471,0,2,2
33763,4,2,118473,118473,118475,0,2,2
33764,4,3,118477,118477,118480,0,3,2
33765,5,3,118482,118482,118485,0,3,2
33766,2,1,118484,118485,118486,1,2,0
33767,3,3,118487,118487,118490,0,3,1
33768,4,2,118491,118491,118493,0,2,1
33769,1,1,118492,118493,118494,1,2,0
33770,5,1,118497,118497,118498,0,1,3
33771,5,2,118502,118502,118504,0,2,4
33772,1,1,118503,118504,118505,1,2,0
33773,5,2,118508,118508,118510,0,2,3
33774,6,1,118514,118514,118515,0,1,4
33775,6,3,118520,118520,118523,0,3,5
33776,1,3,118521,118523,118526,2,5,0
33777,2,2,118523,118526,118528,3,5,0
33778,1,3,118524,118528,118531,4,7,0
33779,6,1,118530,118531,118532,1,2,0
33780,3,3,118533,118533,118536,0,3,1
33781,5,3,118538,118538,118541,0,3,2
33782,5,1,118543,118543,118544,0,1,2
33783,5,1,118548,118548,118549,0,1,4
33784,5,2,118553,118553,118555,0,2,4
33785,6,3,118559,118559,118562,0,3,4
33786,2,1,118561,118562,118563,1,2,0
33787,1,2,118562,118563,118565,1,3,0
33788,1,2,118563,118565,118567,2,4,0
33789,6,2,118569,118569,118571,0,2,2
33790,5,3,118574,118574,118577,0,3,3
33791,4,1,118578,118578,118579,0,1,1
33792,3,2,118581,118581,118583,0,2,2
33793,5,3,118586,118586,118589,0,3,3
33794,3,1,118589,118589,118590,0,1,0
33795,3,3,118592,118592,118595,0,3,2
33796,6,3,118598,118598,118601,0,3,3
33797,3,2,118601,118601,118603,0,2,0
33798,5,3,118606,118606,118609,0,3,3
33799,1,1,118607,118609,118610,2,3,0
33800,1,1,118608,118610,118611,2,3,0
33801,1,1,118609,118611,118612,2,3,0
33802,3,2,118612,118612,118614,0,2,0
33803,6,2,118618,118618,118620,0,2,4
33804,5,2,118623,118623,118625,0,2,3
33805,1,2,118624,118625,118627,1,3,0
33806,6,3,118630,118630,118633,0,3,3
33807,4,3,118634,118634,118637,0,3,1
33808,5,3,118639,118639,118642,0,3,2
33809,1,2,118640,118642,118644,2,4,0
33810,2,2,118642,118644,118646,2,4,0
33811,1,1,118643,118646,118647,3,4,0
33812,3,3,118646,118647,118650,1,4,0
33813,3,1,118649,118650,118651,1,2,0
33814,1,1,118650,118651,118652,1,2,0
33815,5,2,118655,118655,118657,0,2,3
33816,1,1,118656,118657,118658,1,2,0
33817,5,1,118661,118661,118662,0,1,3
33818,4,1,118665,118665,118666,0,1,3
33819,5,3,118670,118670,118673,0,3,4
33820,5,1,118675,118675,118676,0,1,2
33821,1,2,118676,118676,118678,0,2,0
33822,2,3,118678,118678,118681,0,3,0
33823,2,3,118680,118681,118684,1,4,0
33824,2,3,118682,118684,118687,2,5,0
33825,1,2,118683,118687,118689,4,6,0
33826,4,3,118687,118689,118692,2,5,0
33827,2,1,118689,118692,118693,3,4,0
33828,2,2,118691,118693,118695,2,4,0
33829,1,3,118692,118695,118698,3,6,0
33830,6,1,118698,118698,118699,0,1,0
33831,1,3,118699,118699,118702,0,3,0
33832,6,2,118705,118705,118707,0,2,3
33833,4,1,118709,118709,118710,0,1,2
33834,3,2,118712,118712,118714,0,2,2
33835,1,3,118713,118714,118717,1,4,0
33836,5,3,118718,118718,118721,0,3,1
33837,2,3,118720,118721,118724,1,4,0
33838,4,2,118724,118724,118726,0,2,0
33839,2,1,118726,118726,118727,0,1,0
33840,4,2,118730,118730,118732,0,2,3
33841,4,2,118734,118734,118736,0,2,2
33842,6,1,118740,118740,118741,0,1,4
33843,6,3,118746,118746,118749,0,3,5
33844,2,1,118748,118749,118750,1,2,0
33845,5,1,118753,118753,118754,0,1,3
33846,1,3,118754,118754,118757,0,3,0
33847,5,1,118759,118759,118760,0,1,2
33848,6,1,118765,118765,118766,0,1,5
33849,6,3,118771,118771,118774,0,3,5
33850,1,3,118772,118774,118777,2,5,0
33851,2,2,118774,118777,118779,3,5,0
33852,5,1,118779,118779,118780,0,1,0
33853,3,2,118782,118782,118784,0,2,2
33854,1,1,118783,118784,118785,1,2,0
33855,5,2,118788,118788,118790,0,2,3
33856,2,1,118790,118790,118791,0,1,0
33857,5,1,118795,118795,118796,0,1,4
33858,4,1,118799,118799,118800,0,1,3
33859,2,3,118801,118801,118804,0,3,1
33860,2,2,118803,118804,118806,1,3,0
33861,4,3,118807,118807,118810,0,3,1
33862,5,2,118812,118812,118814,0,2,2
33863,4,2,118816,118816,118818,0,2,2
33864,4,3,118820,118820,118823,0,3,2
33865,4,3,118824,118824,118827,0,3,1
33866,3,1,118827,118827,118828,0,1,0
33867,3,2,118830,118830,118832,0,2,2
33868,5,2,118835,118835,118837,0,2,3
33869,1,2,118836,118837,118839,1,3,0
33870,1,3,118837,118839,118842,2,5,0
33871,3,2,118840,118842,118844,2,4,0
33872,6,2,118846,118846,118848,0,2,2
33873,4,2,118850,118850,118852,0,2,2
33874,1,3,118851,118852,118855,1,4,0
33875,4,1,118855,118855,118856,0,1,0
33876,6,1,118861,118861,118862,0,1,5
33877,3,2,118864,118864,118866,0,2,2
33878,6,3,118870,118870,118873,0,3,4
33879,1,2,118871,118873,118875,2,4,0
33880,1,3,118872,118875,118878,3,6,0
33881,5,1,118877,118878,118879,1,2,0
33882,4,3,118881,118881,118884,0,3,2
33883,4,3,118885,118885,118888,0,3,1
33884,2,3,118887,118888,118891,1,4,0
33885,4,2,118891,118891,118893,0,2,0
33886,2,3,118893,118893,118896,0,3,0
33887,3,2,118896,118896,118898,0,2,0
33888,2,2,118898,118898,118900,0,2,0
33889,3,1,118901,118901,118902,0,1,1
33890,6,3,118907,118907,118910,0,3,5
33891,6,2,118913,118913,118915,0,2,3
33892,2,1,118915,118915,118916,0,1,0
33893,6,3,118921,118921,118924,0,3,5
33894,5,3,118926,118926,118929,0,3,2
33895,6,3,118932,118932,118935,0,3,3
33896,6,1,118938,118938,118939,0,1,3
33897,1,2,118939,118939,118941,0,2,0
33898,6,2,118945,118945,118947,0,2,4
33899,3,1,118948,118948,118949,0,1,1
33900,1,2,118949,118949,118951,0,2,0
33901,5,3,118954,118954,118957,0,3,3
33902,5,3,118959,118959,118962,0,3,2
33903,3,1,118962,118962,118963,0,1,0
33904,4,3,118966,118966,118969,0,3,3
33905,5,2,118971,118971,118973,0,2,2
33906,4,1,118975,118975,118976,0,1,2
33907,1,1,118976,118976,118977,0,1,0
33908,4,3,118980,118980,118983,0,3,3
33909,5,1,118985,118985,118986,0,1,2
33910,2,3,118987,118987,118990,0,3,1
33911,6,3,118993,118993,118996,0,3,3
33912,1,2,118994,118996,118998,2,4,0
33913,1,2,118995,118998,119000,3,5,0
33914,3,2,118998,119000,119002,2,4,0
33915,2,3,119000,119002,119005,2,5,0
33916,4,1,119004,119005,119006,1,2,0
33917,3,3,119007,119007,119010,0,3,1
33918,4,3,119011,119011,119014,0,3,1
33919,5,3,119016,119016,119019,0,3,2
33920,6,2,119022,119022,119024,0,2,3
33921,5,2,119027,119027,119029,0,2,3
33922,3,3,119030,119030,119033,0,3,1
33923,2,3,119032,119033,119036,1,4,0
33924,2,2,119034,119036,119038,2,4,0
33925,5,1,119039,119039,119040,0,1,1
33926,2,2,119041,119041,119043,0,2,1
33927,4,2,119045,119045,119047,0,2,2
33928,4,2,119049,119049,119051,0,2,2
33929,3,3,119052,119052,119055,0,3,1
33930,3,1,119055,119055,119056,0,1,0
33931,2,1,119057,119057,119058,0,1,1
33932,6,1,119063,119063,119064,0,1,5
33933,2,2,119065,119065,119067,0,2,1
33934,5,3,119070,119070,119073,0,3,3
33935,4,1,119074,119074,119075,0,1,1
33936,4,1,119078,119078,119079,0,1,3
33937,1,2,119079,119079,119081,0,2,0
33938,6,3,119085,119085,119088,0,3,4
33939,4,2,119089,119089,119091,0,2,1
33940,3,1,119092,119092,119093,0,1,1
33941,4,1,119096,119096,119097,0,1,3
33942,2,2,119098,119098,119100,0,2,1
33943,6,3,119104,119104,119107,0,3,4
33944,6,1,119110,119110,119111,0,1,3
33945,1,3,119111,119111,119114,0,3,0
33946,1,3,119112,119114,119117,2,5,0
33947,5,1,119117,119117,119118,0,1,0
33948,5,2,119122,119122,119124,0,2,4
33949,5,3,119127,119127,119130,0,3,3
33950,3,3,119130,119130,119133,0,3,0
33951,2,1,119132,119133,119134,1,2,0
33952,1,3,119133,119134,119137,1,4,0
33953,6,2,119139,119139,119141,0,2,2
33954,5,2,119144,119144,119146,0,2,3
33955,2,1,119146,119146,119147,0,1,0
33956,2,3,119148,119148,119151,0,3,1
33957,2,3,119150,119151,119154,1,4,0
33958,4,3,119154,119154,119157,0,3,0
33959,1,2,119155,119157,119159,2,4,0
33960,5,2,119160,119160,119162,0,2,1
33961,5,1,119165,119165,119166,0,1,3
33962,3,2,119168,119168,119170,0,2,2
33963,4,2,119172,119172,119174,0,2,2
33964,4,3,119176,119176,119179,0,3,2
33965,6,3,119182,119182,119185,0,3,3
33966,4,1,119186,119186,119187,0,1,1
33967,5,3,119191,119191,119194,0,3,4
33968,4,3,119195,119195,119198,0,3,1
33969,3,1,119198,119198,119199,0,1,0
33970,6,1,119204,119204,119205,0,1,5
33971,3,2,119207,119207,119209,0,2,2
33972,1,1,119208,119209,119210,1,2,0
33973,4,3,119212,119212,119215,0,3,2
33974,5,1,119217,119217,119218,0,1,2
33975,3,1,119220,119220,119221,0,1,2
33976,5,2,119225,119225,119227,0,2,4
33977,1,2,119226,119227,119229,1,3,0
33978,3,2,119229,119229,119231,0,2,0
33979,3,2,119232,119232,119234,0,2,1
33980,3,1,119235,119235,119236,0,1,1
33981,6,3,119241,119241,119244,0,3,5
33982,6,1,119247,119247,119248,0,1,3
33983,6,3,119253,119253,119256,0,3,5
33984,2,1,119255,119256,119257,1,2,0
33985,2,2,119257,119257,119259,0,2,0
33986,5,3,119262,119262,119265,0,3,3
33987,2,3,119264,119265,119268,1,4,0
33988,2,3,119266,119268,119271,2,5,0
33989,6,2,119272,119272,119274,0,2,1
33990,1,1,119273,119274,119275,1,2,0
33991,6,2,119279,119279,119281,0,2,4
33992,5,3,119284,119284,119287,0,3,3
33993,6,1,119290,119290,119291,0,1,3
33994,3,3,119293,119293,119296,0,3,2
33995,1,1,119294,119296,119297,2,3,0
33996,2,2,119296,119297,119299,1,3,0
33997,5,1,119301,119301,119302,0,1,2
33998,6,1,119307,119307,119308,0,1,5
33999,1,1,119308,119308,119309,0,1,0
34000,3,3,119311,119311,119314,0,3,2
34001,3,3,119314,119314,119317,0,3,0
34002,6,2,119320,119320,119322,0,2,3
34003,6,2,119326,119326,119328,0,2,4
34004,5,1,119331,119331,119332,0,1,3
34005,3,1,119334,119334,119335,0,1,2
34006,1,3,119335,119335,119338,0,3,0
34007,2,3,119337,119338,119341,1,4,0
34008,2,3,119339,119341,119344,2,5,0
34009,5,2,119344,119344,119346,0,2,0
34010,3,2,119347,119347,119349,0,2,1
34011,3,3,119350,119350,119353,0,3,1
34012,4,1,119354,119354,119355,0,1,1
34013,2,3,119356,119356,119359,0,3,1
34014,6,1,119362,119362,119363,0,1,3
34015,5,2,119367,119367,119369,0,2,4
34016,4,2,119371,119371,119373,0,2,2
34017,4,3,119375,119375,119378,0,3,2
34018,2,2,119377,119378,119380,1,3,0
34019,5,3,119382,119382,119385,0,3,2
34020,6,1,119388,119388,119389,0,1,3
34021,5,3,119393,119393,119396,0,3,4
34022,3,1,119396,119396,119397,0,1,0
34023,2,3,119398,119398,119401,0,3,1
34024,3,2,119401,119401,119403,0,2,0
34025,1,2,119402,119403,119405,1,3,0
34026,2,3,119404,119405,119408,1,4,0
34027,4,1,119408,119408,119409,0,1,0
34028,2,2,119410,119410,119412,0,2,1
34029,6,3,119416,119416,119419,0,3,4
34030,4,1,119420,119420,119421,0,1,1
34031,6,2,119426,119426,119428,0,2,5
34032,6,1,119432,119432,119433,0,1,4
34033,6,3,119438,119438,119441,0,3,5
34034,2,2,119440,119441,119443,1,3,0
34035,6,1,119446,119446,119447,0,1,3
34036,3,1,119449,119449,119450,0,1,2
34037,4,1,119453,119453,119454,0,1,3
34038,2,1,119455,119455,119456,0,1,1
34039,1,2,119456,119456,119458,0,2,0
34040,5,1,119461,119461,119462,0,1,3
34041,3,1,119464,119464,119465,0,1,2
34042,1,1,119465,119465,119466,0,1,0
34043,3,2,119468,119468,119470,0,2,2
34044,2,1,119470,119470,119471,0,1,0
34045,3,2,119473,119473,119475,0,2,2
34046,1,2,119474,119475,119477,1,3,0
34047,3,1,119477,119477,119478,0,1,0
34048,2,1,119479,119479,119480,0,1,1
34049,5,1,119484,119484,119485,0,1,4
34050,3,2,119487,119487,119489,0,2,2
34051,5,1,119492,119492,119493,0,1,3
34052,5,3,119497,119497,119500,0,3,4
34053,1,3,119498,119500,119503,2,5,0
34054,5,2,119503,119503,119505,0,2,0
34055,5,1,119508,119508,119509,0,1,3
34056,2,2,119510,119510,119512,0,2,1
34057,3,1,119513,119513,119514,0,1,1
34058,3,1,119516,119516,119517,0,1,2
34059,6,2,119522,119522,119524,0,2,5
34060,2,1,119524,119524,119525,0,1,0
34061,1,3,119525,119525,119528,0,3,0
34062,2,1,119527,119528,119529,1,2,0
34063,3,3,119530,119530,119533,0,3,1
34064,6,2,119536,119536,119538,0,2,3
34065,3,1,119539,119539,119540,0,1,1
34066,2,2,119541,119541,119543,0,2,1
34067,3,1,119544,119544,119545,0,1,1
34068,1,3,119545,119545,119548,0,3,0
34069,4,1,119549,119549,119550,0,1,1
34070,5,1,119554,119554,119555,0,1,4
34071,1,2,119555,119555,119557,0,2,0
34072,5,3,119560,119560,119563,0,3,3
34073,1,1,119561,119563,119564,2,3,0
34074,3,1,119564,119564,119565,0,1,0
34075,4,2,119568,119568,119570,0,2,3
34076,4,2,119572,119572,119574,0,2,2
34077,5,2,119577,119577,119579,0,2,3
34078,4,3,119581,119581,119584,0,3,2
34079,6,1,119587,119587,119588,0,1,3
34080,1,3,119588,119588,119591,0,3,0
34081,2,3,119590,119591,119594,1,4,0
34082,6,2,119596,119596,119598,0,2,2
34083,5,2,119601,119601,119603,0,2,3
34084,5,1,119606,119606,119607,0,1,3
34085,1,1,119607,119607,119608,0,1,0
34086,3,3,119610,119610,119613,0,3,2
34087,2,1,119612,119613,119614,1,2,0
34088,3,2,119615,119615,119617,0,2,1
34089,2,3,119617,119617,119620,0,3,0
34090,4,1,119621,119621,119622,0,1,1
34091,4,2,119625,119625,119627,0,2,3
34092,3,1,119628,119628,119629,0,1,1
34093,1,2,119629,119629,119631,0,2,0
34094,5,1,119634,119634,119635,0,1,3
34095,4,3,119638,119638,119641,0,3,3
34096,2,1,119640,119641,119642,1,2,0
34097,6,2,119646,119646,119648,0,2,4
34098,4,1,119650,119650,119651,0,1,2
34099,4,3,119654,119654,119657,0,3,3
34100,6,3,119660,119660,119663,0,3,3
34101,4,3,119664,119664,119667,0,3,1
34102,5,3,119669,119669,119672,0,3,2
34103,4,2,119673,119673,119675,0,2,1
34104,3,3,119676,119676,119679,0,3,1
34105,4,3,119680,119680,119683,0,3,1
34106,1,2,119681,119683,119685,2,4,0
34107,6,2,119687,119687,119689,0,2,2
34108,1,2,119688,119689,119691,1,3,0
34109,5,3,119693,119693,119696,0,3,2
34110,1,1,119694,119696,119697,2,3,0
34111,6,1,119700,119700,119701,0,1,3
34112,3,2,119703,119703,119705,0,2,2
34113,6,3,119709,119709,119712,0,3,4
34114,4,1,119713,119713,119714,0,1,1
34115,1,1,119714,119714,119715,0,1,0
34116,4,3,119718,119718,119721,0,3,3
34117,4,2,119722,119722,119724,0,2,1
34118,4,1,119726,119726,119727,0,1,2
34119,6,3,119732,119732,119735,0,3,5
34120,2,2,119734,119735,119737,1,3,0
34121,6,2,119740,119740,119742,0,2,3
34122,2,3,119742,119742,119745,0,3,0
34123,3,1,119745,119745,119746,0,1,0
34124,1,1,119746,119746,119747,0,1,0
34125,2,3,119748,119748,119751,0,3,1
34126,3,2,119751,119751,119753,0,2,0
34127,3,2,119754,119754,119756,0,2,1
34128,3,3,119757,119757,119760,0,3,1
34129,3,2,119760,119760,119762,0,2,0
34130,4,3,119764,119764,119767,0,3,2
34131,6,2,119770,119770,119772,0,2,3
34132,6,3,119776,119776,119779,0,3,4
34133,6,3,119782,119782,119785,0,3,3
34134,2,3,119784,119785,119788,1,4,0
34135,3,2,119787,119788,119790,1,3,0
34136,1,3,119788,119790,119793,2,5,0
34137,6,3,119794,119794,119797,0,3,1
34138,2,1,119796,119797,119798,1,2,0
34139,1,3,119797,119798,119801,1,4,0
34140,4,1,119801,119801,119802,0,1,0
34141,5,3,119806,119806,119809,0,3,4
34142,1,2,119807,119809,119811,2,4,0
34143,1,2,119808,119811,119813,3,5,0
34144,3,2,119811,119813,119815,2,4,0
34145,5,2,119816,119816,119818,0,2,1
34146,1,1,119817,119818,119819,1,2,0
34147,5,1,119822,119822,119823,0,1,3
34148,4,2,119826,119826,119828,0,2,3
34149,6,3,119832,119832,119835,0,3,4
34150,4,3,119836,119836,119839,0,3,1
34151,2,2,119838,119839,119841,1,3,0
34152,1,3,119839,119841,119844,2,5,0
34153,3,1,119842,119844,119845,2,3,0
34154,2,3,119844,119845,119848,1,4,0
34155,2,3,119846,119848,119851,2,5,0
34156,6,2,119852,119852,119854,0,2,1
34157,2,3,119854,119854,119857,0,3,0
34158,2,1,119856,119857,119858,1,2,0
34159,4,2,119860,119860,119862,0,2,2
34160,3,2,119863,119863,119865,0,2,1
34161,2,1,119865,119865,119866,0,1,0
34162,1,3,119866,119866,119869,0,3,0
34163,6,2,119872,119872,119874,0,2,3
34164,3,3,119875,119875,119878,0,3,1
34165,4,2,119879,119879,119881,0,2,1
34166,6,1,119885,119885,119886,0,1,4
34167,6,3,119891,119891,119894,0,3,5
34168,3,3,119894,119894,119897,0,3,0
34169,4,1,119898,119898,119899,0,1,1
34170,4,1,119902,119902,119903,0,1,3
34171,6,2,119908,119908,119910,0,2,5
34172,2,3,119910,119910,119913,0,3,0
34173,4,2,119914,119914,119916,0,2,1
34174,2,1,119916,119916,119917,0,1,0
34175,5,1,119921,119921,119922,0,1,4
34176,6,2,119927,119927,119929,0,2,5
34177,3,1,119930,119930,119931,0,1,1
34178,3,2,119933,119933,119935,0,2,2
34179,4,1,119937,119937,119938,0,1,2
34180,2,3,119939,119939,119942,0,3,1
34181,4,2,119943,119943,119945,0,2,1
34182,2,2,119945,119945,119947,0,2,0
34183,4,2,119949,119949,119951,0,2,2
34184,2,3,119951,119951,119954,0,3,0
34185,1,2,119952,119954,119956,2,4,0
34186,3,3,119955,119956,119959,1,4,0
34187,3,2,119958,119959,119961,1,3,0
34188,3,2,119961,119961,119963,0,2,0
34189,4,2,119965,119965,119967,0,2,2
34190,6,2,119971,119971,119973,0,2,4
34191,5,1,119976,119976,119977,0,1,3
34192,6,3,119982,119982,119985,0,3,5
34193,2,1,119984,119985,119986,1,2,0
34194,3,2,119987,119987,119989,0,2,1
34195,1,3,119988,119989,119992,1,4,0
34196,5,3,119993,119993,119996,0,3,1
34197,5,2,119998,119998,120000,0,2,2
34198,2,2,120000,120000,120002,0,2,0
34199,2,3,120002,120002,120005,0,3,0
34200,5,1,120007,120007,120008,0,1,2
34201,2,2,120009,120009,120011,0,2,1
34202,5,2,120014,120014,120016,0,2,3
34203,2,1,120016,120016,120017,0,1,0
34204,2,3,120018,120018,120021,0,3,1
34205,6,3,120024,120024,120027,0,3,3
34206,2,3,120026,120027,120030,1,4,0
34207,3,2,120029,120030,120032,1,3,0
34208,2,3,120031,120032,120035,1,4,0
34209,2,3,120033,120035,120038,2,5,0
34210,3,1,120036,120038,120039,2,3,0
34211,5,1,120041,120041,120042,0,1,2
34212,1,2,120042,120042,120044,0,2,0
34213,4,2,120046,120046,120048,0,2,2
34214,2,2,120048,120048,120050,0,2,0
34215,1,1,120049,120050,120051,1,2,0
34216,1,3,120050,120051,120054,1,4,0
34217,1,2,120051,120054,120056,3,5,0
34218,6,2,120057,120057,120059,0,2,1
34219,5,2,120062,120062,120064,0,2,3
34220,2,3,120064,120064,120067,0,3,0
34221,1,2,120065,120067,120069,2,4,0
34222,3,2,120068,120069,120071,1,3,0
34223,5,1,120073,120073,120074,0,1,2
34224,2,2,120075,120075,120077,0,2,1
34225,3,2,120078,120078,120080,0,2,1
34226,4,1,120082,120082,120083,0,1,2
34227,1,2,120083,120083,120085,0,2,0
34228,4,1,120087,120087,120088,0,1,2
34229,2,1,120089,120089,120090,0,1,1
34230,4,1,120093,120093,120094,0,1,3
34231,3,1,120096,120096,120097,0,1,2
34232,5,1,120101,120101,120102,0,1,4
34233,6,2,120107,120107,120109,0,2,5
34234,4,2,120111,120111,120113,0,2,2
34235,2,3,120113,120113,120116,0,3,0
34236,6,3,120119,120119,120122,0,3,3
34237,5,1,120124,120124,120125,0,1,2
34238,5,2,120129,120129,120131,0,2,4
34239,2,2,120131,120131,120133,0,2,0
34240,5,2,120136,120136,120138,0,2,3
34241,4,3,120140,120140,120143,0,3,2
34242,3,1,120143,120143,120144,0,1,0
34243,3,3,120146,120146,120149,0,3,2
34244,3,3,120149,120149,120152,0,3,0
34245,3,3,120152,120152,120155,0,3,0
34246,3,3,120155,120155,120158,0,3,0
34247,3,1,120158,120158,120159,0,1,0
34248,2,3,120160,120160,120163,0,3,1
34249,6,1,120166,120166,120167,0,1,3
34250,2,1,120168,120168,120169,0,1,1
34251,1,3,120169,120169,120172,0,3,0
34252,6,1,120175,120175,120176,0,1,3
34253,1,3,120176,120176,120179,0,3,0
34254,2,3,120178,120179,120182,1,4,0
34255,1,1,120179,120182,120183,3,4,0
34256,1,2,120180,120183,120185,3,5,0
34257,5,1,120185,120185,120186,0,1,0
34258,2,3,120187,120187,120190,0,3,1
34259,2,1,120189,120190,120191,1,2,0
34260,4,2,120193,120193,120195,0,2,2
34261,1,1,120194,120195,120196,1,2,0
34262,3,3,120197,120197,120200,0,3,1
34263,3,3,120200,120200,120203,0,3,0
34264,1,3,120201,120203,120206,2,5,0
34265,3,3,120204,120206,120209,2,5,0
34266,6,2,120210,120210,120212,0,2,1
34267,1,3,120211,120212,120215,1,4,0
34268,3,3,120214,120215,120218,1,4,0
34269,3,2,120217,120218,120220,1,3,0
34270,3,2,120220,120220,120222,0,2,0
34271,6,2,120226,120226,120228,0,2,4
34272,3,1,120229,120229,120230,0,1,1
34273,2,3,120231,120231,120234,0,3,1
34274,1,1,120232,120234,120235,2,3,0
34275,6,2,120238,120238,120240,0,2,3
34276,5,3,120243,120243,120246,0,3,3
34277,5,2,120248,120248,120250,0,2,2
34278,1,1,120249,120250,120251,1,2,0
34279,6,1,120255,120255,120256,0,1,4
34280,3,2,120258,120258,120260,0,2,2
34281,4,3,120262,120262,120265,0,3,2
34282,4,3,120266,120266,120269,0,3,1
34283,1,3,120267,120269,120272,2,5,0
34284,3,1,120270,120272,120273,2,3,0
34285,2,1,120272,120273,120274,1,2,0
34286,6,1,120278,120278,120279,0,1,4
34287,6,1,120284,120284,120285,0,1,5
34288,4,3,120288,120288,120291,0,3,3
34289,2,2,120290,120291,120293,1,3,0
34290,4,2,120294,120294,120296,0,2,1
34291,1,3,120295,120296,120299,1,4,0
34292,2,3,120297,120299,120302,2,5,0
34293,5,1,120302,120302,120303,0,1,0
34294,3,2,120305,120305,120307,0,2,2
34295,4,2,120309,120309,120311,0,2,2
34296,3,3,120312,120312,120315,0,3,1
34297,5,2,120317,120317,120319,0,2,2
34298,2,2,120319,120319,120321,0,2,0
34299,3,1,120322,120322,120323,0,1,1
34300,2,2,120324,120324,120326,0,2,1
34301,6,3,120330,120330,120333,0,3,4
34302,2,2,120332,120333,120335,1,3,0
34303,3,1,120335,120335,120336,0,1,0
34304,2,2,120337,120337,120339,0,2,1
34305,1,3,120338,120339,120342,1,4,0
34306,2,3,120340,120342,120345,2,5,0
34307,2,3,120342,120345,120348,3,6,0
34308,1,1,120343,120348,120349,5,6,0
34309,2,3,120345,120349,120352,4,7,0
34310,6,1,120351,120352,120353,1,2,0
34311,3,3,120354,120354,120357,0,3,1
34312,2,2,120356,120357,120359,1,3,0
34313,2,2,120358,120359,120361,1,3,0
34314,5,2,120363,120363,120365,0,2,2
34315,6,3,120369,120369,120372,0,3,4
34316,2,2,120371,120372,120374,1,3,0
34317,2,3,120373,120374,120377,1,4,0
34318,2,1,120375,120377,120378,2,3,0
34319,4,1,120379,120379,120380,0,1,1
34320,4,2,120383,120383,120385,0,2,3
34321,4,2,120387,120387,120389,0,2,2
34322,4,1,120391,120391,120392,0,1,2
34323,3,3,120394,120394,120397,0,3,2
34324,2,2,120396,120397,120399,1,3,0
34325,1,2,120397,120399,120401,2,4,0
34326,5,2,120402,120402,120404,0,2,1
34327,5,3,120407,120407,120410,0,3,3
34328,6,2,120413,120413,120415,0,2,3
34329,4,2,120417,120417,120419,0,2,2
34330,1,1,120418,120419,120420,1,2,0
34331,2,3,120420,120420,120423,0,3,0
34332,4,2,120424,120424,120426,0,2,1
34333,5,2,120429,120429,120431,0,2,3
34334,5,1,120434,120434,120435,0,1,3
34335,3,2,120437,120437,120439,0,2,2
34336,2,2,120439,120439,120441,0,2,0
34337,2,2,120441,120441,120443,0,2,0
34338,3,3,120444,120444,120447,0,3,1
34339,3,2,120447,120447,120449,0,2,0
34340,3,3,120450,120450,120453,0,3,1
34341,5,1,120455,120455,120456,0,1,2
34342,6,2,120461,120461,120463,0,2,5
34343,2,2,120463,120463,120465,0,2,0
34344,5,1,120468,120468,120469,0,1,3
34345,1,2,120469,120469,120471,0,2,0
34346,2,1,120471,120471,120472,0,1,0
34347,3,1,120474,120474,120475,0,1,2
34348,3,1,120477,120477,120478,0,1,2
34349,5,2,120482,120482,120484,0,2,4
34350,2,2,120484,120484,120486,0,2,0
34351,2,1,120486,120486,120487,0,1,0
34352,1,2,120487,120487,120489,0,2,0
34353,5,3,120492,120492,120495,0,3,3
34354,5,1,120497,120497,120498,0,1,2
34355,6,2,120503,120503,120505,0,2,5
34356,5,3,120508,120508,120511,0,3,3
34357,3,2,120511,120511,120513,0,2,0
34358,3,3,120514,120514,120517,0,3,1
34359,1,2,120515,120517,120519,2,4,0
34360,4,1,120519,120519,120520,0,1,0
34361,3,2,120522,120522,120524,0,2,2
34362,3,3,120525,120525,120528,0,3,1
34363,3,3,120528,120528,120531,0,3,0
34364,5,3,120533,120533,120536,0,3,2
34365,4,1,120537,120537,120538,0,1,1
34366,6,3,120543,120543,120546,0,3,5
34367,5,3,120548,120548,120551,0,3,2
34368,6,2,120554,120554,120556,0,2,3
34369,5,2,120559,120559,120561,0,2,3
34370,6,2,120565,120565,120567,0,2,4
34371,1,1,120566,120567,120568,1,2,0
34372,3,3,120569,120569,120572,0,3,1
34373,4,2,120573,120573,120575,0,2,1
34374,2,3,120575,120575,120578,0,3,0
34375,6,1,120581,120581,120582,0,1,3
34376,1,2,120582,120582,120584,0,2,0
34377,5,3,120587,120587,120590,0,3,3
34378,1,1,120588,120590,120591,2,3,0
34379,5,3,120593,120593,120596,0,3,2
34380,6,2,120599,120599,120601,0,2,3
34381,4,3,120603,120603,120606,0,3,2
34382,1,3,120604,120606,120609,2,5,0
34383,2,3,120606,120609,120612,3,6,0
34384,5,2,120611,120612,120614,1,3,0
34385,3,3,120614,120614,120617,0,3,0
34386,2,3,120616,120617,120620,1,4,0
34387,4,2,120620,120620,120622,0,2,0
34388,1,2,120621,120622,120624,1,3,0
34389,4,3,120625,120625,120628,0,3,1
34390,1,1,120626,120628,120629,2,3,0
34391,4,1,120630,120630,120631,0,1,1
34392,1,2,120631,120631,120633,0,2,0
34393,4,2,120635,120635,120637,0,2,2
34394,1,3,120636,120637,120640,1,4,0
34395,1,1,120637,120640,120641,3,4,0
34396,2,1,120639,120641,120642,2,3,0
34397,3,1,120642,120642,120643,0,1,0
34398,1,3,120643,120643,120646,0,3,0
34399,3,2,120646,120646,120648,0,2,0
34400,5,3,120651,120651,120654,0,3,3
34401,5,3,120656,120656,120659,0,3,2
34402,1,1,120657,120659,120660,2,3,0
34403,4,3,120661,120661,120664,0,3,1
34404,6,3,120667,120667,120670,0,3,3
34405,4,3,120671,120671,120674,0,3,1
34406,6,3,120677,120677,120680,0,3,3
34407,3,2,120680,120680,120682,0,2,0
34408,4,2,120684,120684,120686,0,2,2
34409,3,3,120687,120687,120690,0,3,1
34410,6,1,120693,120693,120694,0,1,3
34411,2,1,120695,120695,120696,0,1,1
34412,5,2,120700,120700,120702,0,2,4
34413,2,1,120702,120702,120703,0,1,0
34414,1,2,120703,120703,120705,0,2,0
34415,6,1,120709,120709,120710,0,1,4
34416,2,3,120711,120711,120714,0,3,1
34417,5,1,120716,120716,120717,0,1,2
34418,4,3,120720,120720,120723,0,3,3
34419,6,1,120726,120726,120727,0,1,3
34420,2,1,120728,120728,120729,0,1,1
34421,3,3,120731,120731,120734,0,3,2
34422,2,3,120733,120734,120737,1,4,0
34423,6,2,120739,120739,120741,0,2,2
34424,5,1,120744,120744,120745,0,1,3
34425,1,1,120745,120745,120746,0,1,0
34426,1,1,120746,120746,120747,0,1,0
34427,6,1,120752,120752,120753,0,1,5
34428,6,3,120758,120758,120761,0,3,5
34429,1,3,120759,120761,120764,2,5,0
34430,6,1,120765,120765,120766,0,1,1
34431,2,2,120767,120767,120769,0,2,1
34432,4,2,120771,120771,120773,0,2,2
34433,6,2,120777,120777,120779,0,2,4
34434,2,1,120779,120779,120780,0,1,0
34435,2,1,120781,120781,120782,0,1,1
34436,6,3,120787,120787,120790,0,3,5
34437,4,3,120791,120791,120794,0,3,1
34438,3,1,120794,120794,120795,0,1,0
34439,1,2,120795,120795,120797,0,2,0
34440,6,1,120801,120801,120802,0,1,4
34441,1,2,120802,120802,120804,0,2,0
34442,6,2,120808,120808,120810,0,2,4
34443,4,2,120812,120812,120814,0,2,2
34444,1,1,120813,120814,120815,1,2,0
34445,6,2,120819,120819,120821,0,2,4
34446,1,2,120820,120821,120823,1,3,0
34447,3,2,120823,120823,120825,0,2,0
34448,5,2,120828,120828,120830,0,2,3
34449,2,3,120830,120830,120833,0,3,0
34450,6,2,120836,120836,120838,0,2,3
34451,5,2,120841,120841,120843,0,2,3
34452,1,2,120842,120843,120845,1,3,0
34453,1,1,120843,120845,120846,2,3,0
34454,1,3,120844,120846,120849,2,5,0
34455,5,1,120849,120849,120850,0,1,0
34456,5,3,120854,120854,120857,0,3,4
34457,6,2,120860,120860,120862,0,2,3
34458,4,1,120864,120864,120865,0,1,2
34459,4,3,120868,120868,120871,0,3,3
34460,2,3,120870,120871,120874,1,4,0
34461,2,2,120872,120874,120876,2,4,0
34462,3,1,120875,120876,120877,1,2,0
34463,6,2,120881,120881,120883,0,2,4
34464,3,1,120884,120884,120885,0,1,1
34465,2,3,120886,120886,120889,0,3,1
34466,6,1,120892,120892,120893,0,1,3
34467,3,1,120895,120895,120896,0,1,2
34468,5,1,120900,120900,120901,0,1,4
34469,2,2,120902,120902,120904,0,2,1
34470,1,3,120903,120904,120907,1,4,0
34471,6,1,120909,120909,120910,0,1,2
34472,4,1,120913,120913,120914,0,1,3
34473,2,3,120915,120915,120918,0,3,1
34474,5,3,120920,120920,120923,0,3,2
34475,1,2,120921,120923,120925,2,4,0
34476,5,1,120926,120926,120927,0,1,1
34477,2,3,120928,120928,120931,0,3,1
34478,2,3,120930,120931,120934,1,4,0
34479,3,1,120933,120934,120935,1,2,0
34480,2,1,120935,120935,120936,0,1,0
34481,3,1,120938,120938,120939,0,1,2
34482,6,2,120944,120944,120946,0,2,5
34483,4,2,120948,120948,120950,0,2,2
34484,6,1,120954,120954,120955,0,1,4
34485,3,2,120957,120957,120959,0,2,2
34486,1,1,120958,120959,120960,1,2,0
34487,1,2,120959,120960,120962,1,3,0
34488,2,1,120961,120962,120963,1,2,0
34489,5,1,120966,120966,120967,0,1,3
34490,3,3,120969,120969,120972,0,3,2
34491,4,3,120973,120973,120976,0,3,1
34492,4,2,120977,120977,120979,0,2,1
34493,6,2,120983,120983,120985,0,2,4
34494,1,3,120984,120985,120988,1,4,0
34495,5,3,120989,120989,120992,0,3,1
34496,5,1,120994,120994,120995,0,1,2
34497,5,2,120999,120999,121001,0,2,4
34498,6,2,121005,121005,121007,0,2,4
34499,3,3,121008,121008,121011,0,3,1
34500,1,3,121009,121011,121014,2,5,0
34501,2,1,121011,121014,121015,3,4,0
34502,1,1,121012,121015,121016,3,4,0
34503,1,3,121013,121016,121019,3,6,0
34504,3,3,121016,121019,121022,3,6,0
34505,2,3,121018,121022,121025,4,7,0
34506,6,2,121024,121025,121027,1,3,0
34507,1,2,121025,121027,121029,2,4,0
34508,3,3,121028,121029,121032,1,4,0
34509,1,1,121029,121032,121033,3,4,0
34510,4,2,121033,121033,121035,0,2,0
34511,2,3,121035,121035,121038,0,3,0
34512,6,3,121041,121041,121044,0,3,3
34513,4,3,121045,121045,121048,0,3,1
34514,6,2,121051,121051,121053,0,2,3
34515,1,1,121052,121053,121054,1,2,0
34516,3,3,121055,121055,121058,0,3,1
34517,3,1,121058,121058,121059,0,1,0
34518,2,1,121060,121060,121061,0,1,1
34519,4,3,121064,121064,121067,0,3,3
34520,4,2,121068,121068,121070,0,2,1
34521,2,2,121070,121070,121072,0,2,0
34522,1,2,121071,121072,121074,1,3,0
34523,6,3,121077,121077,121080,0,3,3
34524,1,1,121078,121080,121081,2,3,0
34525,4,1,121082,121082,121083,0,1,1
34526,2,2,121084,121084,121086,0,2,1
34527,5,1,121089,121089,121090,0,1,3
34528,2,3,121091,121091,121094,0,3,1
34529,2,3,121093,121094,121097,1,4,0
34530,4,3,121097,121097,121100,0,3,0
34531,1,2,121098,121100,121102,2,4,0
34532,2,3,121100,121102,121105,2,5,0
34533,3,3,121103,121105,121108,2,5,0
34534,6,1,121109,121109,121110,0,1,1
34535,3,1,121112,121112,121113,0,1,2
34536,2,2,121114,121114,121116,0,2,1
34537,3,3,121117,121117,121120,0,3,1
34538,4,2,121121,121121,121123,0,2,1
34539,6,2,121127,121127,121129,0,2,4
34540,2,3,121129,121129,121132,0,3,0
34541,6,1,121135,121135,121136,0,1,3
34542,1,2,121136,121136,121138,0,2,0
34543,1,1,121137,121138,121139,1,2,0
34544,4,2,121141,121141,121143,0,2,2
34545,1,3,121142,121143,121146,1,4,0
34546,1,2,121143,121146,121148,3,5,0
34547,1,2,121144,121148,121150,4,6,0
34548,5,2,121149,121150,121152,1,3,0
34549,1,2,121150,121152,121154,2,4,0
34550,6,2,121156,121156,121158,0,2,2
34551,2,1,121158,121158,121159,0,1,0
34552,5,2,121163,121163,121165,0,2,4
34553,3,3,121166,121166,121169,0,3,1
34554,4,1,121170,121170,121171,0,1,1
34555,5,3,121175,121175,121178,0,3,4
34556,5,3,121180,121180,121183,0,3,2
34557,5,2,121185,121185,121187,0,2,2
34558,3,1,121188,121188,121189,0,1,1
34559,3,1,121191,121191,121192,0,1,2
34560,4,1,121195,121195,121196,0,1,3
34561,4,2,121199,121199,121201,0,2,3
34562,6,3,121205,121205,121208,0,3,4
34563,6,1,121211,121211,121212,0,1,3
34564,1,1,121212,121212,121213,0,1,0
34565,4,3,121216,121216,121219,0,3,3
34566,2,2,121218,121219,121221,1,3,0
34567,3,3,121221,121221,121224,0,3,0
34568,6,1,121227,121227,121228,0,1,3
34569,5,3,121232,121232,121235,0,3,4
34570,6,2,121238,121238,121240,0,2,3
34571,6,2,121244,121244,121246,0,2,4
34572,4,3,121248,121248,121251,0,3,2
34573,3,2,121251,121251,121253,0,2,0
34574,4,3,121255,121255,121258,0,3,2
34575,3,3,121258,121258,121261,0,3,0
34576,1,1,121259,121261,121262,2,3,0
34577,6,3,121265,121265,121268,0,3,3
34578,5,1,121270,121270,121271,0,1,2
34579,5,1,121275,121275,121276,0,1,4
34580,3,3,121278,121278,121281,0,3,2
34581,4,1,121282,121282,121283,0,1,1
34582,4,3,121286,121286,121289,0,3,3
34583,4,3,121290,121290,121293,0,3,1
34584,2,2,121292,121293,121295,1,3,0
34585,6,2,121298,121298,121300,0,2,3
34586,5,3,121303,121303,121306,0,3,3
34587,3,1,121306,121306,121307,0,1,0
34588,3,3,121309,121309,121312,0,3,2
34589,1,2,121310,121312,121314,2,4,0
34590,1,3,121311,121314,121317,3,6,0
34591,1,1,121312,121317,121318,5,6,0
34592,1,3,121313,121318,121321,5,8,0
34593,5,3,121318,121321,121324,3,6,0
34594,2,1,121320,121324,121325,4,5,0
34595,4,2,121324,121325,121327,1,3,0
34596,2,2,121326,121327,121329,1,3,0
34597,4,2,121330,121330,121332,0,2,1
34598,3,2,121333,121333,121335,0,2,1
34599,3,2,121336,121336,121338,0,2,1
34600,4,1,121340,121340,121341,0,1,2
34601,1,1,121341,121341,121342,0,1,0
34602,5,1,121346,121346,121347,0,1,4
34603,5,2,121351,121351,121353,0,2,4
34604,1,3,121352,121353,121356,1,4,0
34605,3,3,121355,121356,121359,1,4,0
34606,4,2,121359,121359,121361,0,2,0
34607,3,2,121362,121362,121364,0,2,1
34608,6,3,121368,121368,121371,0,3,4
34609,1,3,121369,121371,121374,2,5,0
34610,1,1,121370,121374,121375,4,5,0
34611,5,2,121375,121375,121377,0,2,0
34612,1,2,121376,121377,121379,1,3,0
34613,2,2,121378,121379,121381,1,3,0
34614,6,2,121384,121384,121386,0,2,3
34615,5,2,121389,121389,121391,0,2,3
34616,1,3,121390,121391,121394,1,4,0
34617,3,1,121393,121394,121395,1,2,0
34618,6,1,121399,121399,121400,0,1,4
34619,1,1,121400,121400,121401,0,1,0
34620,5,3,121405,121405,121408,0,3,4
34621,3,1,121408,121408,121409,0,1,0
34622,5,2,121413,121413,121415,0,2,4
34623,2,1,121415,121415,121416,0,1,0
34624,3,2,121418,121418,121420,0,2,2
34625,4,1,121422,121422,121423,0,1,2
34626,2,3,121424,121424,121427,0,3,1
34627,5,2,121429,121429,121431,0,2,2
34628,2,2,121431,121431,121433,0,2,0
34629,5,3,121436,121436,121439,0,3,3
34630,2,1,121438,121439,121440,1,2,0
34631,6,2,121444,121444,121446,0,2,4
34632,6,2,121450,121450,121452,0,2,4
34633,1,2,121451,121452,121454,1,3,0
34634,2,2,121453,121454,121456,1,3,0
34635,2,3,121455,121456,121459,1,4,0
34636,1,1,121456,121459,121460,3,4,0
34637,6,3,121462,121462,121465,0,3,2
34638,2,2,121464,121465,121467,1,3,0
34639,2,3,121466,121467,121470,1,4,0
34640,6,2,121472,121472,121474,0,2,2
34641,5,2,121477,121477,121479,0,2,3
34642,5,2,121482,121482,121484,0,2,3
34643,1,2,121483,121484,121486,1,3,0
34644,5,2,121488,121488,121490,0,2,2
34645,6,3,121494,121494,121497,0,3,4
34646,6,1,121500,121500,121501,0,1,3
34647,5,1,121505,121505,121506,0,1,4
34648,2,3,121507,121507,121510,0,3,1
34649,1,1,121508,121510,121511,2,3,0
34650,6,3,121514,121514,121517,0,3,3
34651,3,3,121517,121517,121520,0,3,0
34652,5,3,121522,121522,121525,0,3,2
34653,3,2,121525,121525,121527,0,2,0
34654,4,1,121529,121529,121530,0,1,2
34655,4,1,121533,121533,121534,0,1,3
34656,3,1,121536,121536,121537,0,1,2
34657,6,1,121542,121542,121543,0,1,5
34658,3,3,121545,121545,121548,0,3,2
34659,3,3,121548,121548,121551,0,3,0
34660,4,3,121552,121552,121555,0,3,1
34661,6,3,121558,121558,121561,0,3,3
34662,3,2,121561,121561,121563,0,2,0
34663,3,2,121564,121564,121566,0,2,1
34664,1,2,121565,121566,121568,1,3,0
34665,5,1,121570,121570,121571,0,1,2
34666,3,1,121573,121573,121574,0,1,2
34667,5,3,121578,121578,121581,0,3,4
34668,5,1,121583,121583,121584,0,1,2
34669,2,2,121585,121585,121587,0,2,1
34670,5,1,121590,121590,121591,0,1,3
34671,6,2,121596,121596,121598,0,2,5
34672,5,2,121601,121601,121603,0,2,3
34673,2,3,121603,121603,121606,0,3,0
34674,2,2,121605,121606,121608,1,3,0
34675,4,3,121609,121609,121612,0,3,1
34676,2,1,121611,121612,121613,1,2,0
34677,1,2,121612,121613,121615,1,3,0
34678,3,3,121615,121615,121618,0,3,0
34679,1,2,121616,121618,121620,2,4,0
34680,6,1,121622,121622,121623,0,1,2
34681,6,1,121628,121628,121629,0,1,5
34682,2,3,121630,121630,121633,0,3,1
34683,2,1,121632,121633,121634,1,2,0
34684,5,2,121637,121637,121639,0,2,3
34685,2,1,121639,121639,121640,0,1,0
34686,5,2,121644,121644,121646,0,2,4
34687,3,1,121647,121647,121648,0,1,1
34688,4,2,121651,121651,121653,0,2,3
34689,2,1,121653,121653,121654,0,1,0
34690,5,2,121658,121658,121660,0,2,4
34691,6,2,121664,121664,121666,0,2,4
34692,6,1,121670,121670,121671,0,1,4
34693,4,2,121674,121674,121676,0,2,3
34694,3,3,121677,121677,121680,0,3,1
34695,1,3,121678,121680,121683,2,5,0
34696,2,1,121680,121683,121684,3,4,0
34697,1,3,121681,121684,121687,3,6,0
34698,4,3,121685,121687,121690,2,5,0
34699,4,3,121689,121690,121693,1,4,0
34700,6,2,121695,121695,121697,0,2,2
34701,6,1,121701,121701,121702,0,1,4
34702,5,2,121706,121706,121708,0,2,4
34703,4,3,121710,121710,121713,0,3,2
34704,2,2,121712,121713,121715,1,3,0
34705,5,2,121717,121717,121719,0,2,2
34706,3,2,121720,121720,121722,0,2,1
34707,4,2,121724,121724,121726,0,2,2
34708,4,1,121728,121728,121729,0,1,2
34709,1,1,121729,121729,121730,0,1,0
34710,4,1,121733,121733,121734,0,1,3
34711,1,1,121734,121734,121735,0,1,0
34712,5,2,121739,121739,121741,0,2,4
34713,1,2,121740,121741,121743,1,3,0
34714,2,2,121742,121743,121745,1,3,0
34715,4,3,121746,121746,121749,0,3,1
34716,5,2,121751,121751,121753,0,2,2
34717,6,2,121757,121757,121759,0,2,4
34718,2,1,121759,121759,121760,0,1,0
34719,4,3,121763,121763,121766,0,3,3
34720,5,1,121768,121768,121769,0,1,2
34721,3,2,121771,121771,121773,0,2,2
34722,5,1,121776,121776,121777,0,1,3
34723,5,2,121781,121781,121783,0,2,4
34724,2,2,121783,121783,121785,0,2,0
34725,4,3,121787,121787,121790,0,3,2
34726,5,1,121792,121792,121793,0,1,2
34727,2,2,121794,121794,121796,0,2,1
34728,5,2,121799,121799,121801,0,2,3
34729,4,2,121803,121803,121805,0,2,2
34730,3,2,121806,121806,121808,0,2,1
34731,2,2,121808,121808,121810,0,2,0
34732,2,2,121810,121810,121812,0,2,0
34733,6,3,121816,121816,121819,0,3,4
34734,2,2,121818,121819,121821,1,3,0
34735,6,2,121824,121824,121826,0,2,3
34736,1,1,121825,121826,121827,1,2,0
34737,2,2,121827,121827,121829,0,2,0
34738,5,3,121832,121832,121835,0,3,3
34739,6,1,121838,121838,121839,0,1,3
34740,6,2,121844,121844,121846,0,2,5
34741,1,3,121845,121846,121849,1,4,0
34742,2,1,121847,121849,121850,2,3,0
34743,5,1,121852,121852,121853,0,1,2
34744,2,3,121854,121854,121857,0,3,1
34745,3,2,121857,121857,121859,0,2,0
34746,2,2,121859,121859,121861,0,2,0
34747,3,2,121862,121862,121864,0,2,1
34748,3,3,121865,121865,121868,0,3,1
34749,5,1,121870,121870,121871,0,1,2
34750,2,2,121872,121872,121874,0,2,1
34751,5,2,121877,121877,121879,0,2,3
34752,1,3,121878,121879,121882,1,4,0
34753,4,1,121882,121882,121883,0,1,0
34754,6,2,121888,121888,121890,0,2,5
34755,5,3,121893,121893,121896,0,3,3
34756,6,3,121899,121899,121902,0,3,3
34757,2,3,121901,121902,121905,1,4,0
34758,5,2,121906,121906,121908,0,2,1
34759,1,3,121907,121908,121911,1,4,0
34760,2,2,121909,121911,121913,2,4,0
34761,6,2,121915,121915,121917,0,2,2
34762,1,3,121916,121917,121920,1,4,0
34763,4,1,121920,121920,121921,0,1,0
34764,4,1,121924,121924,121925,0,1,3
34765,3,2,121927,121927,121929,0,2,2
34766,3,3,121930,121930,121933,0,3,1
34767,6,1,121936,121936,121937,0,1,3
34768,4,2,121940,121940,121942,0,2,3
34769,5,3,121945,121945,121948,0,3,3
34770,2,3,121947,121948,121951,1,4,0
34771,1,2,121948,121951,121953,3,5,0
34772,1,3,121949,121953,121956,4,7,0
34773,6,3,121955,121956,121959,1,4,0
34774,5,3,121960,121960,121963,0,3,1
34775,6,3,121966,121966,121969,0,3,3
34776,3,3,121969,121969,121972,0,3,0
34777,1,1,121970,121972,121973,2,3,0
34778,1,3,121971,121973,121976,2,5,0
34779,4,3,121975,121976,121979,1,4,0
34780,5,1,121980,121980,121981,0,1,1
34781,5,1,121985,121985,121986,0,1,4
34782,1,2,121986,121986,121988,0,2,0
34783,2,3,121988,121988,121991,0,3,0
34784,5,3,121993,121993,121996,0,3,2
34785,5,1,121998,121998,121999,0,1,2
34786,6,2,122004,122004,122006,0,2,5
34787,1,1,122005,122006,122007,1,2,0
34788,2,2,122007,122007,122009,0,2,0
34789,6,2,122013,122013,122015,0,2,4
34790,6,3,122019,122019,122022,0,3,4
34791,5,3,122024,122024,122027,0,3,2
34792,5,1,122029,122029,122030,0,1,2
34793,4,1,122033,122033,122034,0,1,3
34794,3,1,122036,122036,122037,0,1,2
34795,2,1,122038,122038,122039,0,1,1
34796,2,1,122040,122040,122041,0,1,1
34797,3,2,122043,122043,122045,0,2,2
34798,6,3,122049,122049,122052,0,3,4
34799,5,1,122054,122054,122055,0,1,2
34800,6,2,122060,122060,122062,0,2,5
34801,3,1,122063,122063,122064,0,1,1
34802,2,3,122065,122065,122068,0,3,1
34803,2,3,122067,122068,122071,1,4,0
34804,3,1,122070,122071,122072,1,2,0
34805,1,2,122071,122072,122074,1,3,0
34806,3,1,122074,122074,122075,0,1,0
34807,3,2,122077,122077,122079,0,2,2
34808,2,1,122079,122079,122080,0,1,0
34809,4,2,122083,122083,122085,0,2,3
34810,6,1,122089,122089,122090,0,1,4
34811,2,1,122091,122091,122092,0,1,1
34812,3,1,122094,122094,122095,0,1,2
34813,2,3,122096,122096,122099,0,3,1
34814,2,1,122098,122099,122100,1,2,0
34815,2,1,122100,122100,122101,0,1,0
34816,3,2,122103,122103,122105,0,2,2
34817,4,2,122107,122107,122109,0,2,2
34818,2,2,122109,122109,122111,0,2,0
34819,2,2,122111,122111,122113,0,2,0
34820,4,3,122115,122115,122118,0,3,2
34821,2,3,122117,122118,122121,1,4,0
34822,2,1,122119,122121,122122,2,3,0
34823,5,3,122124,122124,122127,0,3,2
34824,3,2,122127,122127,122129,0,2,0
34825,4,3,122131,122131,122134,0,3,2
34826,4,2,122135,122135,122137,0,2,1
34827,2,2,122137,122137,122139,0,2,0
34828,2,1,122139,122139,122140,0,1,0
34829,4,2,122143,122143,122145,0,2,3
34830,4,3,122147,122147,122150,0,3,2
34831,5,1,122152,122152,122153,0,1,2
34832,3,3,122155,122155,122158,0,3,2
34833,4,3,122159,122159,122162,0,3,1
34834,3,2,122162,122162,122164,0,2,0
34835,6,1,122168,122168,122169,0,1,4
34836,4,1,122172,122172,122173,0,1,3
34837,6,1,122178,122178,122179,0,1,5
34838,4,2,122182,122182,122184,0,2,3
34839,3,2,122185,122185,122187,0,2,1
34840,1,2,122186,122187,122189,1,3,0
34841,5,2,122191,122191,122193,0,2,2
34842,4,1,122195,122195,122196,0,1,2
34843,5,2,122200,122200,122202,0,2,4
34844,4,1,122204,122204,122205,0,1,2
34845,4,2,122208,122208,122210,0,2,3
34846,3,1,122211,122211,122212,0,1,1
34847,1,2,122212,122212,122214,0,2,0
34848,2,3,122214,122214,122217,0,3,0
34849,4,3,122218,122218,122221,0,3,1
34850,5,2,122223,122223,122225,0,2,2
34851,2,2,122225,122225,122227,0,2,0
34852,6,3,122231,122231,122234,0,3,4
34853,6,3,122237,122237,122240,0,3,3
34854,6,2,122243,122243,122245,0,2,3
34855,1,1,122244,122245,122246,1,2,0
34856,1,2,122245,122246,122248,1,3,0
34857,2,2,122247,122248,122250,1,3,0
34858,3,1,122250,122250,122251,0,1,0
34859,1,3,122251,122251,122254,0,3,0
34860,4,2,122255,122255,122257,0,2,1
34861,1,3,122256,122257,122260,1,4,0
34862,1,2,122257,122260,122262,3,5,0
34863,6,1,122263,122263,122264,0,1,1
34864,1,2,122264,122264,122266,0,2,0
34865,3,2,122267,122267,122269,0,2,1
34866,6,2,122273,122273,122275,0,2,4
34867,3,2,122276,122276,122278,0,2,1
34868,2,2,122278,122278,122280,0,2,0
34869,6,2,122284,122284,122286,0,2,4
34870,2,1,122286,122286,122287,0,1,0
34871,6,1,122292,122292,122293,0,1,5
34872,3,3,122295,122295,122298,0,3,2
34873,5,1,122300,122300,122301,0,1,2
34874,2,1,122302,122302,122303,0,1,1
34875,2,1,122304,122304,122305,0,1,1
34876,6,3,122310,122310,122313,0,3,5
34877,5,3,122315,122315,122318,0,3,2
34878,2,1,122317,122318,122319,1,2,0
34879,6,2,122323,122323,122325,0,2,4
34880,3,3,122326,122326,122329,0,3,1
34881,1,1,122327,122329,122330,2,3,0
34882,6,3,122333,122333,122336,0,3,3
34883,6,2,122339,122339,122341,0,2,3
34884,3,2,122342,122342,122344,0,2,1
34885,1,3,122343,122344,122347,1,4,0
34886,6,3,122349,122349,122352,0,3,2
34887,1,2,122350,122352,122354,2,4,0
34888,5,1,122355,122355,122356,0,1,1
34889,5,3,122360,122360,122363,0,3,4
34890,2,2,122362,122363,122365,1,3,0
34891,4,2,122366,122366,122368,0,2,1
34892,4,3,122370,122370,122373,0,3,2
34893,3,1,122373,122373,122374,0,1,0
34894,1,2,122374,122374,122376,0,2,0
34895,4,1,122378,122378,122379,0,1,2
34896,4,2,122382,122382,122384,0,2,3
34897,6,1,122388,122388,122389,0,1,4
34898,2,2,122390,122390,122392,0,2,1
34899,3,3,122393,122393,122396,0,3,1
34900,1,1,122394,122396,122397,2,3,0
34901,1,3,122395,122397,122400,2,5,0
34902,6,1,122401,122401,122402,0,1,1
34903,6,1,122407,122407,122408,0,1,5
34904,5,2,122412,122412,122414,0,2,4
34905,2,1,122414,122414,122415,0,1,0
34906,2,2,122416,122416,122418,0,2,1
34907,1,2,122417,122418,122420,1,3,0
34908,6,1,122423,122423,122424,0,1,3
34909,2,2,122425,122425,122427,0,2,1
34910,5,1,122430,122430,122431,0,1,3
34911,2,3,122432,122432,122435,0,3,1
34912,5,3,122437,122437,122440,0,3,2
34913,4,2,122441,122441,122443,0,2,1
34914,3,2,122444,122444,122446,0,2,1
34915,6,2,122450,122450,122452,0,2,4
34916,5,3,122455,122455,122458,0,3,3
34917,5,2,122460,122460,122462,0,2,2
34918,3,1,122463,122463,122464,0,1,1
34919,1,3,122464,122464,122467,0,3,0
34920,6,1,122470,122470,122471,0,1,3
34921,2,1,122472,122472,122473,0,1,1
34922,6,1,122478,122478,122479,0,1,5
34923,2,1,122480,122480,122481,0,1,1
34924,4,3,122484,122484,122487,0,3,3
34925,2,2,122486,122487,122489,1,3,0
34926,2,3,122488,122489,122492,1,4,0
34927,6,2,122494,122494,122496,0,2,2
34928,3,1,122497,122497,122498,0,1,1
34929,6,3,122503,122503,122506,0,3,5
34930,6,1,122509,122509,122510,0,1,3
34931,4,2,122513,122513,122515,0,2,3
34932,1,2,122514,122515,122517,1,3,0
34933,4,3,122518,122518,122521,0,3,1
34934,1,2,122519,122521,122523,2,4,0
34935,5,2,122524,122524,122526,0,2,1
34936,5,3,122529,122529,122532,0,3,3
34937,2,1,122531,122532,122533,1,2,0
34938,2,1,122533,122533,122534,0,1,0
34939,1,3,122534,122534,122537,0,3,0
34940,6,2,122540,122540,122542,0,2,3
34941,3,1,122543,122543,122544,0,1,1
34942,2,2,122545,122545,122547,0,2,1
34943,6,2,122551,122551,122553,0,2,4
34944,2,1,122553,122553,122554,0,1,0
34945,1,3,122554,122554,122557,0,3,0
34946,2,2,122556,122557,122559,1,3,0
34947,4,2,122560,122560,122562,0,2,1
34948,6,1,122566,122566,122567,0,1,4
34949,3,1,122569,122569,122570,0,1,2
34950,1,2,122570,122570,122572,0,2,0
34951,3,3,122573,122573,122576,0,3,1
34952,1,1,122574,122576,122577,2,3,0
34953,4,1,122578,122578,122579,0,1,1
34954,2,2,122580,122580,122582,0,2,1
34955,1,1,122581,122582,122583,1,2,0
34956,2,3,122583,122583,122586,0,3,0
34957,6,1,122589,122589,122590,0,1,3
34958,6,2,122595,122595,122597,0,2,5
34959,4,1,122599,122599,122600,0,1,2
34960,5,2,122604,122604,122606,0,2,4
34961,6,3,122610,122610,122613,0,3,4
34962,5,1,122615,122615,122616,0,1,2
34963,6,3,122621,122621,122624,0,3,5
34964,3,3,122624,122624,122627,0,3,0
34965,2,3,122626,122627,122630,1,4,0
34966,5,3,122631,122631,122634,0,3,1
34967,6,1,122637,122637,122638,0,1,3
34968,4,2,122641,122641,122643,0,2,3
34969,6,2,122647,122647,122649,0,2,4
34970,2,3,122649,122649,122652,0,3,0
34971,4,3,122653,122653,122656,0,3,1
34972,3,1,122656,122656,122657,0,1,0
34973,1,2,122657,122657,122659,0,2,0
34974,2,3,122659,122659,122662,0,3,0
34975,2,1,122661,122662,122663,1,2,0
34976,5,1,122666,122666,122667,0,1,3
34977,1,2,122667,122667,122669,0,2,0
34978,3,2,122670,122670,122672,0,2,1
34979,1,3,122671,122672,122675,1,4,0
34980,4,1,122675,122675,122676,0,1,0
34981,6,3,122681,122681,122684,0,3,5
34982,4,1,122685,122685,122686,0,1,1
34983,2,2,122687,122687,122689,0,2,1
34984,4,1,122691,122691,122692,0,1,2
34985,3,3,122694,122694,122697,0,3,2
34986,1,1,122695,122697,122698,2,3,0
34987,6,3,122701,122701,122704,0,3,3
34988,1,1,122702,122704,122705,2,3,0
34989,3,1,122705,122705,122706,0,1,0
34990,1,3,122706,122706,122709,0,3,0
34991,1,3,122707,122709,122712,2,5,0
34992,2,3,122709,122712,122715,3,6,0
34993,4,3,122713,122715,122718,2,5,0
34994,6,1,122719,122719,122720,0,1,1
34995,4,3,122723,122723,122726,0,3,3
34996,2,3,122725,122726,122729,1,4,0
34997,4,3,122729,122729,122732,0,3,0
34998,2,1,122731,122732,122733,1,2,0
34999,3,1,122734,122734,122735,0,1,1
35000,2,2,122736,122736,122738,0,2,1
35001,6,2,122742,122742,122744,0,2,4
35002,6,2,122748,122748,122750,0,2,4
35003,3,1,122751,122751,122752,0,1,1
35004,5,3,122756,122756,122759,0,3,4
35005,2,2,122758,122759,122761,1,3,0
35006,3,3,122761,122761,122764,0,3,0
35007,1,1,122762,122764,122765,2,3,0
35008,2,2,122764,122765,122767,1,3,0
35009,1,3,122765,122767,122770,2,5,0
35010,3,2,122768,122770,122772,2,4,0
35011,6,3,122774,122774,122777,0,3,2
35012,6,3,122780,122780,122783,0,3,3
35013,4,3,122784,122784,122787,0,3,1
35014,4,1,122788,122788,122789,0,1,1
35015,4,2,122792,122792,122794,0,2,3
35016,1,2,122793,122794,122796,1,3,0
35017,4,3,122797,122797,122800,0,3,1
35018,4,1,122801,122801,122802,0,1,1
35019,1,3,122802,122802,122805,0,3,0
35020,6,1,122808,122808,122809,0,1,3
35021,4,1,122812,122812,122813,0,1,3
35022,1,1,122813,122813,122814,0,1,0
35023,4,2,122817,122817,122819,0,2,3
35024,3,2,122820,122820,122822,0,2,1
35025,6,1,122826,122826,122827,0,1,4
35026,3,3,122829,122829,122832,0,3,2
35027,5,3,122834,122834,122837,0,3,2
35028,2,2,122836,122837,122839,1,3,0
35029,1,1,122837,122839,122840,2,3,0
35030,3,2,122840,122840,122842,0,2,0
35031,3,3,122843,122843,122846,0,3,1
35032,2,2,122845,122846,122848,1,3,0
35033,6,2,122851,122851,122853,0,2,3
35034,3,2,122854,122854,122856,0,2,1
35035,5,3,122859,122859,122862,0,3,3
35036,3,2,122862,122862,122864,0,2,0
35037,4,3,122866,122866,122869,0,3,2
35038,6,2,122872,122872,122874,0,2,3
35039,4,1,122876,122876,122877,0,1,2
35040,1,3,122877,122877,122880,0,3,0
35041,2,1,122879,122880,122881,1,2,0
35042,4,3,122883,122883,122886,0,3,2
35043,1,1,122884,122886,122887,2,3,0
35044,6,2,122890,122890,122892,0,2,3
35045,2,2,122892,122892,122894,0,2,0
35046,3,2,122895,122895,122897,0,2,1
35047,3,1,122898,122898,122899,0,1,1
35048,3,3,122901,122901,122904,0,3,2
35049,5,1,122906,122906,122907,0,1,2
35050,6,3,122912,122912,122915,0,3,5
35051,4,2,122916,122916,122918,0,2,1
35052,6,2,122922,122922,122924,0,2,4
35053,6,3,122928,122928,122931,0,3,4
35054,1,2,122929,122931,122933,2,4,0
35055,3,3,122932,122933,122936,1,4,0
35056,5,3,122937,122937,122940,0,3,1
35057,5,1,122942,122942,122943,0,1,2
35058,3,1,122945,122945,122946,0,1,2
35059,2,2,122947,122947,122949,0,2,1
35060,6,1,122953,122953,122954,0,1,4
35061,4,2,122957,122957,122959,0,2,3
35062,4,3,122961,122961,122964,0,3,2
35063,1,1,122962,122964,122965,2,3,0
35064,3,1,122965,122965,122966,0,1,0
35065,6,1,122971,122971,122972,0,1,5
35066,4,3,122975,122975,122978,0,3,3
35067,1,1,122976,122978,122979,2,3,0
35068,6,2,122982,122982,122984,0,2,3
35069,6,3,122988,122988,122991,0,3,4
35070,6,2,122994,122994,122996,0,2,3
35071,6,1,123000,123000,123001,0,1,4
35072,4,1,123004,123004,123005,0,1,3
35073,4,1,123008,123008,123009,0,1,3
35074,5,2,123013,123013,123015,0,2,4
35075,5,3,123018,123018,123021,0,3,3
35076,2,3,123020,123021,123024,1,4,0
35077,5,3,123025,123025,123028,0,3,1
35078,1,1,123026,123028,123029,2,3,0
35079,4,2,123030,123030,123032,0,2,1
35080,3,1,123033,123033,123034,0,1,1
35081,2,2,123035,123035,123037,0,2,1
35082,5,3,123040,123040,123043,0,3,3
35083,2,2,123042,123043,123045,1,3,0
35084,6,2,123048,123048,123050,0,2,3
35085,2,2,123050,123050,123052,0,2,0
35086,6,2,123056,123056,123058,0,2,4
35087,6,2,123062,123062,123064,0,2,4
35088,5,3,123067,123067,123070,0,3,3
35089,2,2,123069,123070,123072,1,3,0
35090,3,1,123072,123072,123073,0,1,0
35091,3,3,123075,123075,123078,0,3,2
35092,6,3,123081,123081,123084,0,3,3
35093,4,2,123085,123085,123087,0,2,1
35094,1,3,123086,123087,123090,1,4,0
35095,5,2,123091,123091,123093,0,2,1
35096,1,1,123092,123093,123094,1,2,0
35097,5,3,123097,123097,123100,0,3,3
35098,5,1,123102,123102,123103,0,1,2
35099,5,1,123107,123107,123108,0,1,4
35100,4,3,123111,123111,123114,0,3,3
35101,4,1,123115,123115,123116,0,1,1
35102,4,1,123119,123119,123120,0,1,3
35103,6,3,123125,123125,123128,0,3,5
35104,6,1,123131,123131,123132,0,1,3
35105,5,3,123136,123136,123139,0,3,4
35106,3,1,123139,123139,123140,0,1,0
35107,5,2,123144,123144,123146,0,2,4
35108,6,1,123150,123150,123151,0,1,4
35109,4,3,123154,123154,123157,0,3,3
35110,3,3,123157,123157,123160,0,3,0
35111,5,2,123162,123162,123164,0,2,2
35112,1,1,123163,123164,123165,1,2,0
35113,1,1,123164,123165,123166,1,2,0
35114,4,1,123168,123168,123169,0,1,2
35115,5,1,123173,123173,123174,0,1,4
35116,1,1,123174,123174,123175,0,1,0
35117,2,2,123176,123176,123178,0,2,1
35118,5,3,123181,123181,123184,0,3,3
35119,6,2,123187,123187,123189,0,2,3
35120,6,3,123193,123193,123196,0,3,4
35121,2,1,123195,123196,123197,1,2,0
35122,3,3,123198,123198,123201,0,3,1
35123,1,3,123199,123201,123204,2,5,0
35124,5,3,123204,123204,123207,0,3,0
35125,4,2,123208,123208,123210,0,2,1
35126,6,2,123214,123214,123216,0,2,4
35127,1,3,123215,123216,123219,1,4,0
35128,6,2,123221,123221,123223,0,2,2
35129,3,1,123224,123224,123225,0,1,1
35130,1,2,123225,123225,123227,0,2,0
35131,1,2,123226,123227,123229,1,3,0
35132,6,3,123232,123232,123235,0,3,3
35133,2,2,123234,123235,123237,1,3,0
35134,5,1,123239,123239,123240,0,1,2
35135,3,3,123242,123242,123245,0,3,2
35136,4,1,123246,123246,123247,0,1,1
35137,1,2,123247,123247,123249,0,2,0
35138,3,2,123250,123250,123252,0,2,1
35139,2,1,123252,123252,123253,0,1,0
35140,2,3,123254,123254,123257,0,3,1
35141,5,3,123259,123259,123262,0,3,2
35142,4,2,123263,123263,123265,0,2,1
35143,2,2,123265,123265,123267,0,2,0
35144,3,1,123268,123268,123269,0,1,1
35145,1,1,123269,123269,123270,0,1,0
35146,1,2,123270,123270,123272,0,2,0
35147,1,2,123271,123272,123274,1,3,0
35148,6,2,123277,123277,123279,0,2,3
35149,6,1,123283,123283,123284,0,1,4
35150,5,3,123288,123288,123291,0,3,4
35151,6,2,123294,123294,123296,0,2,3
35152,6,2,123300,123300,123302,0,2,4
35153,3,1,123303,123303,123304,0,1,1
35154,6,3,123309,123309,123312,0,3,5
35155,5,2,123314,123314,123316,0,2,2
35156,4,2,123318,123318,123320,0,2,2
35157,6,1,123324,123324,123325,0,1,4
35158,4,2,123328,123328,123330,0,2,3
35159,1,1,123329,123330,123331,1,2,0
35160,3,3,123332,123332,123335,0,3,1
35161,1,2,123333,123335,123337,2,4,0
35162,3,3,123336,123337,123340,1,4,0
35163,4,1,123340,123340,123341,0,1,0
35164,5,3,123345,123345,123348,0,3,4
35165,6,1,123351,123351,123352,0,1,3
35166,3,2,123354,123354,123356,0,2,2
35167,4,2,123358,123358,123360,0,2,2
35168,4,2,123362,123362,123364,0,2,2
35169,4,3,123366,123366,123369,0,3,2
35170,2,3,123368,123369,123372,1,4,0
35171,4,1,123372,123372,123373,0,1,0
35172,2,3,123374,123374,123377,0,3,1
35173,1,3,123375,123377,123380,2,5,0
35174,3,1,123378,123380,123381,2,3,0
35175,5,2,123383,123383,123385,0,2,2
35176,2,1,123385,123385,123386,0,1,0
35177,1,1,123386,123386,123387,0,1,0
35178,2,3,123388,123388,123391,0,3,1
35179,4,2,123392,123392,123394,0,2,1
35180,4,1,123396,123396,123397,0,1,2
35181,6,2,123402,123402,123404,0,2,5
35182,5,2,123407,123407,123409,0,2,3
35183,3,2,123410,123410,123412,0,2,1
35184,6,1,123416,123416,123417,0,1,4
35185,5,2,123421,123421,123423,0,2,4
35186,2,3,123423,123423,123426,0,3,0
35187,4,2,123427,123427,123429,0,2,1
35188,4,2,123431,123431,123433,0,2,2
35189,6,3,123437,123437,123440,0,3,4
35190,4,2,123441,123441,123443,0,2,1
35191,3,1,123444,123444,123445,0,1,1
35192,2,3,123446,123446,123449,0,3,1
35193,3,2,123449,123449,123451,0,2,0
35194,2,1,123451,123451,123452,0,1,0
35195,6,1,123457,123457,123458,0,1,5
35196,6,3,123463,123463,123466,0,3,5
35197,3,2,123466,123466,123468,0,2,0
35198,4,1,123470,123470,123471,0,1,2
35199,3,2,123473,123473,123475,0,2,2
35200,1,2,123474,123475,123477,1,3,0
35201,1,1,123475,123477,123478,2,3,0
35202,3,1,123478,123478,123479,0,1,0
35203,1,2,123479,123479,123481,0,2,0
35204,4,2,123483,123483,123485,0,2,2
35205,6,3,123489,123489,123492,0,3,4
35206,2,3,123491,123492,123495,1,4,0
35207,2,2,123493,123495,123497,2,4,0
35208,1,1,123494,123497,123498,3,4,0
35209,3,3,123497,123498,123501,1,4,0
35210,5,3,123502,123502,123505,0,3,1
35211,5,3,123507,123507,123510,0,3,2
35212,5,3,123512,123512,123515,0,3,2
35213,3,3,123515,123515,123518,0,3,0
35214,3,2,123518,123518,123520,0,2,0
35215,5,2,123523,123523,123525,0,2,3
35216,1,1,123524,123525,123526,1,2,0
35217,1,1,123525,123526,123527,1,2,0
35218,4,1,123529,123529,123530,0,1,2
35219,6,1,123535,123535,123536,0,1,5
35220,1,2,123536,123536,123538,0,2,0
35221,1,1,123537,123538,123539,1,2,0
35222,5,1,123542,123542,123543,0,1,3
35223,6,3,123548,123548,123551,0,3,5
35224,2,2,123550,123551,123553,1,3,0
35225,6,2,123556,123556,123558,0,2,3
35226,2,1,123558,123558,123559,0,1,0
35227,2,3,123560,123560,123563,0,3,1
35228,2,2,123562,123563,123565,1,3,0
35229,4,1,123566,123566,123567,0,1,1
35230,1,2,123567,123567,123569,0,2,0
35231,5,2,123572,123572,123574,0,2,3
35232,5,1,123577,123577,123578,0,1,3
35233,2,2,123579,123579,123581,0,2,1
35234,6,3,123585,123585,123588,0,3,4
35235,3,2,123588,123588,123590,0,2,0
35236,1,1,123589,123590,123591,1,2,0
35237,3,2,123592,123592,123594,0,2,1
35238,4,3,123596,123596,123599,0,3,2
35239,2,3,123598,123599,123602,1,4,0
35240,4,2,123602,123602,123604,0,2,0
35241,2,1,123604,123604,123605,0,1,0
35242,1,1,123605,123605,123606,0,1,0
35243,3,1,123608,123608,123609,0,1,2
35244,1,1,123609,123609,123610,0,1,0
35245,3,3,123612,123612,123615,0,3,2
35246,5,2,123617,123617,123619,0,2,2
35247,4,1,123621,123621,123622,0,1,2
35248,5,3,123626,123626,123629,0,3,4
35249,2,3,123628,123629,123632,1,4,0
35250,1,3,123629,123632,123635,3,6,0
35251,3,2,123632,123635,123637,3,5,0
35252,5,2,123637,123637,123639,0,2,0
35253,1,1,123638,123639,123640,1,2,0
35254,6,3,123644,123644,123647,0,3,4
35255,4,2,123648,123648,123650,0,2,1
35256,5,1,123653,123653,123654,0,1,3
35257,1,1,123654,123654,123655,0,1,0
35258,1,1,123655,123655,123656,0,1,0
35259,4,3,123659,123659,123662,0,3,3
35260,5,3,123664,123664,123667,0,3,2
35261,1,2,123665,123667,123669,2,4,0
35262,4,2,123669,123669,123671,0,2,0
35263,1,2,123670,123671,123673,1,3,0
35264,4,1,123674,123674,123675,0,1,1
35265,5,1,123679,123679,123680,0,1,4
35266,2,2,123681,123681,123683,0,2,1
35267,2,1,123683,123683,123684,0,1,0
35268,6,3,123689,123689,123692,0,3,5
35269,2,2,123691,123692,123694,1,3,0
35270,4,1,123695,123695,123696,0,1,1
35271,2,1,123697,123697,123698,0,1,1
35272,1,3,123698,123698,123701,0,3,0
35273,5,1,123703,123703,123704,0,1,2
35274,3,1,123706,123706,123707,0,1,2
35275,5,2,123711,123711,123713,0,2,4
35276,3,2,123714,123714,123716,0,2,1
35277,3,3,123717,123717,123720,0,3,1
35278,1,2,123718,123720,123722,2,4,0
35279,5,1,123723,123723,123724,0,1,1
35280,6,3,123729,123729,123732,0,3,5
35281,6,2,123735,123735,123737,0,2,3
35282,2,3,123737,123737,123740,0,3,0
35283,2,3,123739,123740,123743,1,4,0
35284,5,1,123744,123744,123745,0,1,1
35285,4,2,123748,123748,123750,0,2,3
35286,5,3,123753,123753,123756,0,3,3
35287,6,1,123759,123759,123760,0,1,3
35288,2,1,123761,123761,123762,0,1,1
35289,1,2,123762,123762,123764,0,2,0
35290,4,2,123766,123766,123768,0,2,2
35291,4,1,123770,123770,123771,0,1,2
35292,2,1,123772,123772,123773,0,1,1
35293,2,3,123774,123774,123777,0,3,1
35294,2,1,123776,123777,123778,1,2,0
35295,2,3,123778,123778,123781,0,3,0
35296,2,1,123780,123781,123782,1,2,0
35297,4,3,123784,123784,123787,0,3,2
35298,1,3,123785,123787,123790,2,5,0
35299,1,2,123786,123790,123792,4,6,0
35300,1,2,123787,123792,123794,5,7,0
35301,1,2,123788,123794,123796,6,8,0
35302,3,3,123791,123796,123799,5,8,0
35303,6,1,123797,123799,123800,2,3,0
35304,3,1,123800,123800,123801,0,1,0
35305,4,1,123804,123804,123805,0,1,3
35306,5,1,123809,123809,123810,0,1,4
35307,4,2,123813,123813,123815,0,2,3
35308,3,2,123816,123816,123818,0,2,1
35309,6,1,123822,123822,123823,0,1,4
35310,2,1,123824,123824,123825,0,1,1
35311,3,1,123827,123827,123828,0,1,2
35312,5,1,123832,123832,123833,0,1,4
35313,5,2,123837,123837,123839,0,2,4
35314,3,1,123840,123840,123841,0,1,1
35315,2,3,123842,123842,123845,0,3,1
35316,2,2,123844,123845,123847,1,3,0
35317,5,3,123849,123849,123852,0,3,2
35318,3,3,123852,123852,123855,0,3,0
35319,6,2,123858,123858,123860,0,2,3
35320,6,1,123864,123864,123865,0,1,4
35321,2,2,123866,123866,123868,0,2,1
35322,4,3,123870,123870,123873,0,3,2
35323,5,3,123875,123875,123878,0,3,2
35324,5,3,123880,123880,123883,0,3,2
35325,5,1,123885,123885,123886,0,1,2
35326,6,1,123891,123891,123892,0,1,5
35327,5,3,123896,123896,123899,0,3,4
35328,6,3,123902,123902,123905,0,3,3
35329,3,3,123905,123905,123908,0,3,0
35330,2,3,123907,123908,123911,1,4,0
35331,2,1,123909,123911,123912,2,3,0
35332,3,2,123912,123912,123914,0,2,0
35333,2,1,123914,123914,123915,0,1,0
35334,2,3,123916,123916,123919,0,3,1
35335,2,1,123918,123919,123920,1,2,0
35336,1,1,123919,123920,123921,1,2,0
35337,3,1,123922,123922,123923,0,1,1
35338,4,3,123926,123926,123929,0,3,3
35339,2,1,123928,123929,123930,1,2,0
35340,5,1,123933,123933,123934,0,1,3
35341,5,1,123938,123938,123939,0,1,4
35342,2,3,123940,123940,123943,0,3,1
35343,1,1,123941,123943,123944,2,3,0
35344,3,2,123944,123944,123946,0,2,0
35345,5,2,123949,123949,123951,0,2,3
35346,5,1,123954,123954,123955,0,1,3
35347,5,3,123959,123959,123962,0,3,4
35348,2,3,123961,123962,123965,1,4,0
35349,2,1,123963,123965,123966,2,3,0
35350,1,1,123964,123966,123967,2,3,0
35351,2,2,123966,123967,123969,1,3,0
35352,4,3,123970,123970,123973,0,3,1
35353,1,1,123971,123973,123974,2,3,0
35354,6,1,123977,123977,123978,0,1,3
35355,4,2,123981,123981,123983,0,2,3
35356,4,2,123985,123985,123987,0,2,2
35357,4,1,123989,123989,123990,0,1,2
35358,4,2,123993,123993,123995,0,2,3
35359,6,3,123999,123999,124002,0,3,4
35360,3,3,124002,124002,124005,0,3,0
35361,5,3,124007,124007,124010,0,3,2
35362,5,1,124012,124012,124013,0,1,2
35363,2,1,124014,124014,124015,0,1,1
35364,2,3,124016,124016,124019,0,3,1
35365,1,1,124017,124019,124020,2,3,0
35366,4,2,124021,124021,124023,0,2,1
35367,5,3,124026,124026,124029,0,3,3
35368,1,1,124027,124029,124030,2,3,0
35369,2,2,124029,124030,124032,1,3,0
35370,4,3,124033,124033,124036,0,3,1
35371,3,1,124036,124036,124037,0,1,0
35372,4,1,124040,124040,124041,0,1,3
35373,3,3,124043,124043,124046,0,3,2
35374,4,1,124047,124047,124048,0,1,1
35375,5,1,124052,124052,124053,0,1,4
35376,1,1,124053,124053,124054,0,1,0
35377,4,2,124057,124057,124059,0,2,3
35378,4,3,124061,124061,124064,0,3,2
35379,1,3,124062,124064,124067,2,5,0
35380,5,1,124067,124067,124068,0,1,0
35381,6,1,124073,124073,124074,0,1,5
35382,5,3,124078,124078,124081,0,3,4
35383,3,1,124081,124081,124082,0,1,0
35384,5,2,124086,124086,124088,0,2,4
35385,3,2,124089,124089,124091,0,2,1
35386,3,1,124092,124092,124093,0,1,1
35387,1,3,124093,124093,124096,0,3,0
35388,2,3,124095,124096,124099,1,4,0
35389,1,1,124096,124099,124100,3,4,0
35390,6,3,124102,124102,124105,0,3,2
35391,6,1,124108,124108,124109,0,1,3
35392,3,1,124111,124111,124112,0,1,2
35393,5,3,124116,124116,124119,0,3,4
35394,3,1,124119,124119,124120,0,1,0
35395,4,2,124123,124123,124125,0,2,3
35396,5,3,124128,124128,124131,0,3,3
35397,2,3,124130,124131,124134,1,4,0
35398,5,1,124135,124135,124136,0,1,1
35399,4,1,124139,124139,124140,0,1,3
35400,1,3,124140,124140,124143,0,3,0
35401,5,2,124145,124145,124147,0,2,2
35402,2,1,124147,124147,124148,0,1,0
35403,5,2,124152,124152,124154,0,2,4
35404,4,3,124156,124156,124159,0,3,2
35405,2,1,124158,124159,124160,1,2,0
35406,6,3,124164,124164,124167,0,3,4
35407,4,2,124168,124168,124170,0,2,1
35408,5,1,124173,124173,124174,0,1,3
35409,6,3,124179,124179,124182,0,3,5
35410,5,2,124184,124184,124186,0,2,2
35411,5,3,124189,124189,124192,0,3,3
35412,4,1,124193,124193,124194,0,1,1
35413,4,1,124197,124197,124198,0,1,3
35414,6,2,124203,124203,124205,0,2,5
35415,4,1,124207,124207,124208,0,1,2
35416,5,2,124212,124212,124214,0,2,4
35417,2,2,124214,124214,124216,0,2,0
35418,2,2,124216,124216,124218,0,2,0
35419,5,2,124221,124221,124223,0,2,3
35420,6,1,124227,124227,124228,0,1,4
35421,1,3,124228,124228,124231,0,3,0
35422,4,1,124232,124232,124233,0,1,1
35423,3,3,124235,124235,124238,0,3,2
35424,2,3,124237,124238,124241,1,4,0
35425,2,3,124239,124241,124244,2,5,0
35426,1,1,124240,124244,124245,4,5,0
35427,4,1,124244,124245,124246,1,2,0
35428,4,2,124248,124248,124250,0,2,2
35429,3,3,124251,124251,124254,0,3,1
35430,6,1,124257,124257,124258,0,1,3
35431,6,3,124263,124263,124266,0,3,5
35432,5,1,124268,124268,124269,0,1,2
35433,5,3,124273,124273,124276,0,3,4
35434,4,1,124277,124277,124278,0,1,1
35435,3,1,124280,124280,124281,0,1,2
35436,4,1,124284,124284,124285,0,1,3
35437,6,1,124290,124290,124291,0,1,5
35438,3,2,124293,124293,124295,0,2,2
35439,5,1,124298,124298,124299,0,1,3
35440,6,2,124304,124304,124306,0,2,5
35441,6,2,124310,124310,124312,0,2,4
35442,3,2,124313,124313,124315,0,2,1
35443,1,3,124314,124315,124318,1,4,0
35444,6,3,124320,124320,124323,0,3,2
35445,2,1,124322,124323,124324,1,2,0
35446,2,2,124324,124324,124326,0,2,0
35447,6,1,124330,124330,124331,0,1,4
35448,1,1,124331,124331,124332,0,1,0
35449,3,3,124334,124334,124337,0,3,2
35450,6,3,124340,124340,124343,0,3,3
35451,1,2,124341,124343,124345,2,4,0
35452,4,1,124345,124345,124346,0,1,0
35453,5,1,124350,124350,124351,0,1,4
35454,5,3,124355,124355,124358,0,3,4
35455,6,2,124361,124361,124363,0,2,3
35456,6,2,124367,124367,124369,0,2,4
35457,3,2,124370,124370,124372,0,2,1
35458,5,2,124375,124375,124377,0,2,3
35459,3,1,124378,124378,124379,0,1,1
35460,3,3,124381,124381,124384,0,3,2
35461,5,2,124386,124386,124388,0,2,2
35462,6,3,124392,124392,124395,0,3,4
35463,4,2,124396,124396,124398,0,2,1
35464,3,3,124399,124399,124402,0,3,1
35465,5,2,124404,124404,124406,0,2,2
35466,2,2,124406,124406,124408,0,2,0
35467,2,2,124408,124408,124410,0,2,0
35468,6,3,124414,124414,124417,0,3,4
35469,1,3,124415,124417,124420,2,5,0
35470,6,3,124421,124421,124424,0,3,1
35471,6,1,124427,124427,124428,0,1,3
35472,1,1,124428,124428,124429,0,1,0
35473,2,1,124430,124430,124431,0,1,1
35474,2,1,124432,124432,124433,0,1,1
35475,4,1,124436,124436,124437,0,1,3
35476,5,3,124441,124441,124444,0,3,4
35477,6,3,124447,124447,124450,0,3,3
35478,1,2,124448,124450,124452,2,4,0
35479,5,1,124453,124453,124454,0,1,1
35480,3,2,124456,124456,124458,0,2,2
35481,3,2,124459,124459,124461,0,2,1
35482,1,1,124460,124461,124462,1,2,0
35483,3,2,124463,124463,124465,0,2,1
35484,2,3,124465,124465,124468,0,3,0
35485,6,3,124471,124471,124474,0,3,3
35486,3,1,124474,124474,124475,0,1,0
35487,4,1,124478,124478,124479,0,1,3
35488,3,1,124481,124481,124482,0,1,2
35489,3,1,124484,124484,124485,0,1,2
35490,6,3,124490,124490,124493,0,3,5
35491,3,3,124493,124493,124496,0,3,0
35492,6,1,124499,124499,124500,0,1,3
35493,1,2,124500,124500,124502,0,2,0
35494,4,1,124504,124504,124505,0,1,2
35495,4,3,124508,124508,124511,0,3,3
35496,4,3,124512,124512,124515,0,3,1
35497,2,2,124514,124515,124517,1,3,0
35498,5,1,124519,124519,124520,0,1,2
35499,3,2,124522,124522,124524,0,2,2
35500,3,2,124525,124525,124527,0,2,1
35501,6,3,124531,124531,124534,0,3,4
35502,2,1,124533,124534,124535,1,2,0
35503,4,2,124537,124537,124539,0,2,2
35504,1,3,124538,124539,124542,1,4,0
35505,4,3,124542,124542,124545,0,3,0
35506,3,3,124545,124545,124548,0,3,0
35507,6,2,124551,124551,124553,0,2,3
35508,6,3,124557,124557,124560,0,3,4
35509,6,2,124563,124563,124565,0,2,3
35510,3,1,124566,124566,124567,0,1,1
35511,5,2,124571,124571,124573,0,2,4
35512,2,1,124573,124573,124574,0,1,0
35513,1,2,124574,124574,124576,0,2,0
35514,5,1,124579,124579,124580,0,1,3
35515,2,3,124581,124581,124584,0,3,1
35516,5,2,124586,124586,124588,0,2,2
35517,1,3,124587,124588,124591,1,4,0
35518,4,1,124591,124591,124592,0,1,0
35519,1,1,124592,124592,124593,0,1,0
35520,3,1,124595,124595,124596,0,1,2
35521,4,3,124599,124599,124602,0,3,3
35522,1,2,124600,124602,124604,2,4,0
35523,5,2,124605,124605,124607,0,2,1
35524,5,1,124610,124610,124611,0,1,3
35525,5,1,124615,124615,124616,0,1,4
35526,5,3,124620,124620,124623,0,3,4
35527,4,3,124624,124624,124627,0,3,1
35528,4,2,124628,124628,124630,0,2,1
35529,1,3,124629,124630,124633,1,4,0
35530,4,2,124633,124633,124635,0,2,0
35531,5,3,124638,124638,124641,0,3,3
35532,6,3,124644,124644,124647,0,3,3
35533,1,3,124645,124647,124650,2,5,0
35534,4,3,124649,124650,124653,1,4,0
35535,4,3,124653,124653,124656,0,3,0
35536,5,1,124658,124658,124659,0,1,2
35537,5,2,124663,124663,124665,0,2,4
35538,3,3,124666,124666,124669,0,3,1
35539,3,2,124669,124669,124671,0,2,0
35540,3,2,124672,124672,124674,0,2,1
35541,5,3,124677,124677,124680,0,3,3
35542,2,3,124679,124680,124683,1,4,0
35543,5,2,124684,124684,124686,0,2,1
35544,3,1,124687,124687,124688,0,1,1
35545,4,2,124691,124691,124693,0,2,3
35546,2,2,124693,124693,124695,0,2,0
35547,4,2,124697,124697,124699,0,2,2
35548,4,3,124701,124701,124704,0,3,2
35549,5,2,124706,124706,124708,0,2,2
35550,3,3,124709,124709,124712,0,3,1
35551,1,3,124710,124712,124715,2,5,0
35552,3,3,124713,124715,124718,2,5,0
35553,3,1,124716,124718,124719,2,3,0
35554,2,3,124718,124719,124722,1,4,0
35555,5,2,124723,124723,124725,0,2,1
35556,6,1,124729,124729,124730,0,1,4
35557,4,1,124733,124733,124734,0,1,3
35558,1,2,124734,124734,124736,0,2,0
35559,6,2,124740,124740,124742,0,2,4
35560,5,2,124745,124745,124747,0,2,3
35561,5,3,124750,124750,124753,0,3,3
35562,4,2,124754,124754,124756,0,2,1
35563,3,2,124757,124757,124759,0,2,1
35564,4,2,124761,124761,124763,0,2,2
35565,1,3,124762,124763,124766,1,4,0
35566,3,2,124765,124766,124768,1,3,0
35567,2,1,124767,124768,124769,1,2,0
35568,6,1,124773,124773,124774,0,1,4
35569,2,2,124775,124775,124777,0,2,1
35570,6,3,124781,124781,124784,0,3,4
35571,1,1,124782,124784,124785,2,3,0
35572,5,3,124787,124787,124790,0,3,2
35573,5,3,124792,124792,124795,0,3,2
35574,1,1,124793,124795,124796,2,3,0
35575,5,2,124798,124798,124800,0,2,2
35576,4,2,124802,124802,124804,0,2,2
35577,1,3,124803,124804,124807,1,4,0
35578,6,1,124809,124809,124810,0,1,2
35579,5,3,124814,124814,124817,0,3,4
35580,1,1,124815,124817,124818,2,3,0
35581,3,2,124818,124818,124820,0,2,0
35582,4,3,124822,124822,124825,0,3,2
35583,5,2,124827,124827,124829,0,2,2
35584,5,3,124832,124832,124835,0,3,3
35585,4,2,124836,124836,124838,0,2,1
35586,6,2,124842,124842,124844,0,2,4
35587,1,1,124843,124844,124845,1,2,0
35588,6,1,124849,124849,124850,0,1,4
35589,4,3,124853,124853,124856,0,3,3
35590,6,1,124859,124859,124860,0,1,3
35591,2,3,124861,124861,124864,0,3,1
35592,6,2,124867,124867,124869,0,2,3
35593,5,3,124872,124872,124875,0,3,3
35594,6,2,124878,124878,124880,0,2,3
35595,2,2,124880,124880,124882,0,2,0
35596,4,3,124884,124884,124887,0,3,2
35597,4,2,124888,124888,124890,0,2,1
35598,4,2,124892,124892,124894,0,2,2
35599,5,2,124897,124897,124899,0,2,3
35600,2,1,124899,124899,124900,0,1,0
35601,2,3,124901,124901,124904,0,3,1
35602,6,2,124907,124907,124909,0,2,3
35603,2,2,124909,124909,124911,0,2,0
35604,3,2,124912,124912,124914,0,2,1
35605,5,2,124917,124917,124919,0,2,3
35606,6,3,124923,124923,124926,0,3,4
35607,3,3,124926,124926,124929,0,3,0
35608,1,1,124927,124929,124930,2,3,0
35609,3,3,124930,124930,124933,0,3,0
35610,3,2,124933,124933,124935,0,2,0
35611,5,2,124938,124938,124940,0,2,3
35612,5,3,124943,124943,124946,0,3,3
35613,4,1,124947,124947,124948,0,1,1
35614,5,1,124952,124952,124953,0,1,4
35615,1,3,124953,124953,124956,0,3,0
35616,3,3,124956,124956,124959,0,3,0
35617,1,1,124957,124959,124960,2,3,0
35618,3,1,124960,124960,124961,0,1,0
35619,1,3,124961,124961,124964,0,3,0
35620,5,3,124966,124966,124969,0,3,2
35621,4,2,124970,124970,124972,0,2,1
35622,5,1,124975,124975,124976,0,1,3
35623,1,1,124976,124976,124977,0,1,0
35624,2,1,124978,124978,124979,0,1,1
35625,2,1,124980,124980,124981,0,1,1
35626,3,3,124983,124983,124986,0,3,2
35627,4,3,124987,124987,124990,0,3,1
35628,3,2,124990,124990,124992,0,2,0
35629,3,3,124993,124993,124996,0,3,1
35630,5,1,124998,124998,124999,0,1,2
35631,4,1,125002,125002,125003,0,1,3
35632,3,3,125005,125005,125008,0,3,2
35633,3,2,125008,125008,125010,0,2,0
35634,4,3,125012,125012,125015,0,3,2
35635,4,2,125016,125016,125018,0,2,1
35636,1,2,125017,125018,125020,1,3,0
35637,1,3,125018,125020,125023,2,5,0
35638,6,3,125024,125024,125027,0,3,1
35639,2,3,125026,125027,125030,1,4,0
35640,4,2,125030,125030,125032,0,2,0
35641,5,1,125035,125035,125036,0,1,3
35642,3,3,125038,125038,125041,0,3,2
35643,4,1,125042,125042,125043,0,1,1
35644,1,2,125043,125043,125045,0,2,0
35645,6,2,125049,125049,125051,0,2,4
35646,3,1,125052,125052,125053,0,1,1
35647,6,2,125058,125058,125060,0,2,5
35648,1,3,125059,125060,125063,1,4,0
35649,3,2,125062,125063,125065,1,3,0
35650,6,1,125068,125068,125069,0,1,3
35651,2,2,125070,125070,125072,0,2,1
35652,2,2,125072,125072,125074,0,2,0
35653,3,3,125075,125075,125078,0,3,1
35654,1,2,125076,125078,125080,2,4,0
35655,3,3,125079,125080,125083,1,4,0
35656,1,1,125080,125083,125084,3,4,0
35657,6,1,125086,125086,125087,0,1,2
35658,6,3,125092,125092,125095,0,3,5
35659,5,3,125097,125097,125100,0,3,2
35660,1,2,125098,125100,125102,2,4,0
35661,6,2,125104,125104,125106,0,2,2
35662,1,2,125105,125106,125108,1,3,0
35663,4,3,125109,125109,125112,0,3,1
35664,3,3,125112,125112,125115,0,3,0
35665,6,3,125118,125118,125121,0,3,3
35666,5,3,125123,125123,125126,0,3,2
35667,6,1,125129,125129,125130,0,1,3
35668,2,2,125131,125131,125133,0,2,1
35669,5,3,125136,125136,125139,0,3,3
35670,3,2,125139,125139,125141,0,2,0
35671,6,1,125145,125145,125146,0,1,4
35672,5,2,125150,125150,125152,0,2,4
35673,3,1,125153,125153,125154,0,1,1
35674,3,1,125156,125156,125157,0,1,2
35675,4,1,125160,125160,125161,0,1,3
35676,6,3,125166,125166,125169,0,3,5
35677,3,3,125169,125169,125172,0,3,0
35678,2,1,125171,125172,125173,1,2,0
35679,3,3,125174,125174,125177,0,3,1
35680,6,2,125180,125180,125182,0,2,3
35681,4,3,125184,125184,125187,0,3,2
35682,1,2,125185,125187,125189,2,4,0
35683,2,1,125187,125189,125190,2,3,0
35684,6,3,125193,125193,125196,0,3,3
35685,4,2,125197,125197,125199,0,2,1
35686,5,3,125202,125202,125205,0,3,3
35687,5,3,125207,125207,125210,0,3,2
35688,2,2,125209,125210,125212,1,3,0
35689,3,2,125212,125212,125214,0,2,0
35690,3,3,125215,125215,125218,0,3,1
35691,3,1,125218,125218,125219,0,1,0
35692,2,2,125220,125220,125222,0,2,1
35693,2,1,125222,125222,125223,0,1,0
35694,6,3,125228,125228,125231,0,3,5
35695,4,2,125232,125232,125234,0,2,1
35696,6,2,125238,125238,125240,0,2,4
35697,3,3,125241,125241,125244,0,3,1
35698,6,3,125247,125247,125250,0,3,3
35699,1,1,125248,125250,125251,2,3,0
35700,6,2,125254,125254,125256,0,2,3
35701,2,1,125256,125256,125257,0,1,0
35702,5,2,125261,125261,125263,0,2,4
35703,2,2,125263,125263,125265,0,2,0
35704,1,3,125264,125265,125268,1,4,0
35705,4,1,125268,125268,125269,0,1,0
35706,4,3,125272,125272,125275,0,3,3
35707,3,2,125275,125275,125277,0,2,0
35708,5,2,125280,125280,125282,0,2,3
35709,4,1,125284,125284,125285,0,1,2
35710,3,3,125287,125287,125290,0,3,2
35711,6,1,125293,125293,125294,0,1,3
35712,5,3,125298,125298,125301,0,3,4
35713,1,1,125299,125301,125302,2,3,0
35714,4,2,125303,125303,125305,0,2,1
35715,2,3,125305,125305,125308,0,3,0
35716,5,2,125310,125310,125312,0,2,2
35717,4,2,125314,125314,125316,0,2,2
35718,2,3,125316,125316,125319,0,3,0
35719,3,2,125319,125319,125321,0,2,0
35720,2,2,125321,125321,125323,0,2,0
35721,1,3,125322,125323,125326,1,4,0
35722,3,1,125325,125326,125327,1,2,0
35723,4,1,125329,125329,125330,0,1,2
35724,1,2,125330,125330,125332,0,2,0
35725,4,1,125334,125334,125335,0,1,2
35726,1,3,125335,125335,125338,0,3,0
35727,4,3,125339,125339,125342,0,3,1
35728,1,2,125340,125342,125344,2,4,0
35729,1,2,125341,125344,125346,3,5,0
35730,3,2,125344,125346,125348,2,4,0
35731,3,2,125347,125348,125350,1,3,0
35732,6,3,125353,125353,125356,0,3,3
35733,5,1,125358,125358,125359,0,1,2
35734,4,1,125362,125362,125363,0,1,3
35735,5,3,125367,125367,125370,0,3,4
35736,5,2,125372,125372,125374,0,2,2
35737,5,1,125377,125377,125378,0,1,3
35738,1,2,125378,125378,125380,0,2,0
35739,4,1,125382,125382,125383,0,1,2
35740,6,3,125388,125388,125391,0,3,5
35741,4,3,125392,125392,125395,0,3,1
35742,6,3,125398,125398,125401,0,3,3
35743,2,2,125400,125401,125403,1,3,0
35744,6,1,125406,125406,125407,0,1,3
35745,2,2,125408,125408,125410,0,2,1
35746,4,2,125412,125412,125414,0,2,2
35747,5,1,125417,125417,125418,0,1,3
35748,4,3,125421,125421,125424,0,3,3
35749,6,2,125427,125427,125429,0,2,3
35750,5,3,125432,125432,125435,0,3,3
35751,2,1,125434,125435,125436,1,2,0
35752,2,3,125436,125436,125439,0,3,0
35753,4,2,125440,125440,125442,0,2,1
35754,3,2,125443,125443,125445,0,2,1
35755,4,1,125447,125447,125448,0,1,2
35756,5,1,125452,125452,125453,0,1,4
35757,6,3,125458,125458,125461,0,3,5
35758,5,1,125463,125463,125464,0,1,2
35759,6,2,125469,125469,125471,0,2,5
35760,4,3,125473,125473,125476,0,3,2
35761,3,1,125476,125476,125477,0,1,0
35762,6,1,125482,125482,125483,0,1,5
35763,3,2,125485,125485,125487,0,2,2
35764,3,2,125488,125488,125490,0,2,1
35765,2,3,125490,125490,125493,0,3,0
35766,4,1,125494,125494,125495,0,1,1
35767,1,2,125495,125495,125497,0,2,0
35768,2,2,125497,125497,125499,0,2,0
35769,3,1,125500,125500,125501,0,1,1
35770,5,3,125505,125505,125508,0,3,4
35771,6,1,125511,125511,125512,0,1,3
35772,1,1,125512,125512,125513,0,1,0
35773,5,3,125517,125517,125520,0,3,4
35774,2,3,125519,125520,125523,1,4,0
35775,6,1,125525,125525,125526,0,1,2
35776,6,1,125531,125531,125532,0,1,5
35777,6,2,125537,125537,125539,0,2,5
35778,6,3,125543,125543,125546,0,3,4
35779,1,3,125544,125546,125549,2,5,0
35780,2,3,125546,125549,125552,3,6,0
35781,5,1,125551,125552,125553,1,2,0
35782,1,1,125552,125553,125554,1,2,0
35783,6,1,125558,125558,125559,0,1,4
35784,5,3,125563,125563,125566,0,3,4
35785,2,2,125565,125566,125568,1,3,0
35786,3,3,125568,125568,125571,0,3,0
35787,3,1,125571,125571,125572,0,1,0
35788,5,2,125576,125576,125578,0,2,4
35789,2,3,125578,125578,125581,0,3,0
35790,2,1,125580,125581,125582,1,2,0
35791,5,1,125585,125585,125586,0,1,3
35792,6,3,125591,125591,125594,0,3,5
35793,6,2,125597,125597,125599,0,2,3
35794,3,3,125600,125600,125603,0,3,1
35795,2,3,125602,125603,125606,1,4,0
35796,4,1,125606,125606,125607,0,1,0
35797,1,1,125607,125607,125608,0,1,0
35798,3,2,125610,125610,125612,0,2,2
35799,6,2,125616,125616,125618,0,2,4
35800,4,1,125620,125620,125621,0,1,2
35801,2,1,125622,125622,125623,0,1,1
35802,6,2,125628,125628,125630,0,2,5
35803,5,1,125633,125633,125634,0,1,3
35804,2,1,125635,125635,125636,0,1,1
35805,5,3,125640,125640,125643,0,3,4
35806,4,2,125644,125644,125646,0,2,1
35807,1,1,125645,125646,125647,1,2,0
35808,3,3,125648,125648,125651,0,3,1
35809,3,1,125651,125651,125652,0,1,0
35810,2,2,125653,125653,125655,0,2,1
35811,4,3,125657,125657,125660,0,3,2
35812,1,2,125658,125660,125662,2,4,0
35813,3,1,125661,125662,125663,1,2,0
35814,4,1,125665,125665,125666,0,1,2
35815,3,3,125668,125668,125671,0,3,2
35816,5,2,125673,125673,125675,0,2,2
35817,1,2,125674,125675,125677,1,3,0
35818,5,3,125679,125679,125682,0,3,2
35819,2,2,125681,125682,125684,1,3,0
35820,6,3,125687,125687,125690,0,3,3
35821,4,3,125691,125691,125694,0,3,1
35822,4,1,125695,125695,125696,0,1,1
35823,4,1,125699,125699,125700,0,1,3
35824,6,3,125705,125705,125708,0,3,5
35825,5,2,125710,125710,125712,0,2,2
35826,3,1,125713,125713,125714,0,1,1
35827,2,3,125715,125715,125718,0,3,1
35828,3,2,125718,125718,125720,0,2,0
35829,5,3,125723,125723,125726,0,3,3
35830,5,1,125728,125728,125729,0,1,2
35831,3,3,125731,125731,125734,0,3,2
35832,4,1,125735,125735,125736,0,1,1
35833,1,3,125736,125736,125739,0,3,0
35834,4,3,125740,125740,125743,0,3,1
35835,5,3,125745,125745,125748,0,3,2
35836,6,1,125751,125751,125752,0,1,3
35837,4,1,125755,125755,125756,0,1,3
35838,4,3,125759,125759,125762,0,3,3
35839,5,3,125764,125764,125767,0,3,2
35840,2,3,125766,125767,125770,1,4,0
35841,6,2,125772,125772,125774,0,2,2
35842,6,1,125778,125778,125779,0,1,4
35843,5,3,125783,125783,125786,0,3,4
35844,6,1,125789,125789,125790,0,1,3
35845,2,3,125791,125791,125794,0,3,1
35846,5,2,125796,125796,125798,0,2,2
35847,4,3,125800,125800,125803,0,3,2
35848,1,2,125801,125803,125805,2,4,0
35849,1,1,125802,125805,125806,3,4,0
35850,6,3,125808,125808,125811,0,3,2
35851,2,3,125810,125811,125814,1,4,0
35852,1,3,125811,125814,125817,3,6,0
35853,2,2,125813,125817,125819,4,6,0
35854,4,1,125817,125819,125820,2,3,0
35855,3,1,125820,125820,125821,0,1,0
35856,1,3,125821,125821,125824,0,3,0
35857,3,1,125824,125824,125825,0,1,0
35858,4,1,125828,125828,125829,0,1,3
35859,1,3,125829,125829,125832,0,3,0
35860,3,1,125832,125832,125833,0,1,0
35861,5,3,125837,125837,125840,0,3,4
35862,2,3,125839,125840,125843,1,4,0
35863,3,3,125842,125843,125846,1,4,0
35864,1,2,125843,125846,125848,3,5,0
35865,2,3,125845,125848,125851,3,6,0
35866,4,3,125849,125851,125854,2,5,0
35867,2,2,125851,125854,125856,3,5,0
35868,1,1,125852,125856,125857,4,5,0
35869,5,1,125857,125857,125858,0,1,0
35870,5,1,125862,125862,125863,0,1,4
35871,1,1,125863,125863,125864,0,1,0
35872,5,1,125868,125868,125869,0,1,4
35873,4,1,125872,125872,125873,0,1,3
35874,3,3,125875,125875,125878,0,3,2
35875,2,1,125877,125878,125879,1,2,0
35876,4,1,125881,125881,125882,0,1,2
35877,3,1,125884,125884,125885,0,1,2
35878,1,1,125885,125885,125886,0,1,0
35879,5,3,125890,125890,125893,0,3,4
35880,5,2,125895,125895,125897,0,2,2
35881,3,2,125898,125898,125900,0,2,1
35882,3,3,125901,125901,125904,0,3,1
35883,6,2,125907,125907,125909,0,2,3
35884,2,1,125909,125909,125910,0,1,0
35885,2,1,125911,125911,125912,0,1,1
35886,3,2,125914,125914,125916,0,2,2
35887,4,2,125918,125918,125920,0,2,2
35888,2,3,125920,125920,125923,0,3,0
35889,3,1,125923,125923,125924,0,1,0
35890,2,3,125925,125925,125928,0,3,1
35891,4,1,125929,125929,125930,0,1,1
35892,1,1,125930,125930,125931,0,1,0
35893,2,3,125932,125932,125935,0,3,1
35894,6,3,125938,125938,125941,0,3,3
35895,3,2,125941,125941,125943,0,2,0
35896,2,2,125943,125943,125945,0,2,0
35897,6,2,125949,125949,125951,0,2,4
35898,2,3,125951,125951,125954,0,3,0
35899,5,3,125956,125956,125959,0,3,2
35900,4,3,125960,125960,125963,0,3,1
35901,5,2,125965,125965,125967,0,2,2
35902,5,1,125970,125970,125971,0,1,3
35903,1,1,125971,125971,125972,0,1,0
35904,5,2,125976,125976,125978,0,2,4
35905,1,1,125977,125978,125979,1,2,0
35906,1,1,125978,125979,125980,1,2,0
35907,6,2,125984,125984,125986,0,2,4
35908,5,1,125989,125989,125990,0,1,3
35909,5,3,125994,125994,125997,0,3,4
35910,6,3,126000,126000,126003,0,3,3
35911,1,2,126001,126003,126005,2,4,0
35912,4,3,126005,126005,126008,0,3,0
35913,1,2,126006,126008,126010,2,4,0
35914,5,2,126011,126011,126013,0,2,1
35915,5,3,126016,126016,126019,0,3,3
35916,4,2,126020,126020,126022,0,2,1
35917,6,1,126026,126026,126027,0,1,4
35918,2,1,126028,126028,126029,0,1,1
35919,3,1,126031,126031,126032,0,1,2
35920,4,3,126035,126035,126038,0,3,3
35921,2,3,126037,126038,126041,1,4,0
35922,6,3,126043,126043,126046,0,3,2
35923,5,3,126048,126048,126051,0,3,2
35924,4,2,126052,126052,126054,0,2,1
35925,6,2,126058,126058,126060,0,2,4
35926,5,2,126063,126063,126065,0,2,3
35927,6,3,126069,126069,126072,0,3,4
35928,5,3,126074,126074,126077,0,3,2
35929,6,3,126080,126080,126083,0,3,3
35930,1,3,126081,126083,126086,2,5,0
35931,4,2,126085,126086,126088,1,3,0
35932,1,1,126086,126088,126089,2,3,0
35933,4,3,126090,126090,126093,0,3,1
35934,4,3,126094,126094,126097,0,3,1
35935,3,2,126097,126097,126099,0,2,0
35936,5,1,126102,126102,126103,0,1,3
35937,2,3,126104,126104,126107,0,3,1
35938,1,2,126105,126107,126109,2,4,0
35939,3,2,126108,126109,126111,1,3,0
35940,2,3,126110,126111,126114,1,4,0
35941,6,1,126116,126116,126117,0,1,2
35942,4,1,126120,126120,126121,0,1,3
35943,5,2,126125,126125,126127,0,2,4
35944,3,1,126128,126128,126129,0,1,1
35945,6,2,126134,126134,126136,0,2,5
35946,5,1,126139,126139,126140,0,1,3
35947,3,1,126142,126142,126143,0,1,2
35948,5,2,126147,126147,126149,0,2,4
35949,3,2,126150,126150,126152,0,2,1
35950,1,1,126151,126152,126153,1,2,0
35951,5,3,126156,126156,126159,0,3,3
35952,4,3,126160,126160,126163,0,3,1
35953,4,1,126164,126164,126165,0,1,1
35954,5,2,126169,126169,126171,0,2,4
35955,4,1,126173,126173,126174,0,1,2
35956,5,3,126178,126178,126181,0,3,4
35957,3,3,126181,126181,126184,0,3,0
35958,6,2,126187,126187,126189,0,2,3
35959,4,2,126191,126191,126193,0,2,2
35960,3,3,126194,126194,126197,0,3,1
35961,2,1,126196,126197,126198,1,2,0
35962,6,3,126202,126202,126205,0,3,4
35963,3,3,126205,126205,126208,0,3,0
35964,6,2,126211,126211,126213,0,2,3
35965,4,2,126215,126215,126217,0,2,2
35966,4,1,126219,126219,126220,0,1,2
35967,5,3,126224,126224,126227,0,3,4
35968,5,3,126229,126229,126232,0,3,2
35969,4,3,126233,126233,126236,0,3,1
35970,6,2,126239,126239,126241,0,2,3
35971,2,2,126241,126241,126243,0,2,0
35972,2,1,126243,126243,126244,0,1,0
35973,4,2,126247,126247,126249,0,2,3
35974,1,3,126248,126249,126252,1,4,0
35975,3,3,126251,126252,126255,1,4,0
35976,4,1,126255,126255,126256,0,1,0
35977,3,2,126258,126258,126260,0,2,2
35978,3,2,126261,126261,126263,0,2,1
35979,4,3,126265,126265,126268,0,3,2
35980,4,2,126269,126269,126271,0,2,1
35981,5,2,126274,126274,126276,0,2,3
35982,1,3,126275,126276,126279,1,4,0
35983,3,2,126278,126279,126281,1,3,0
35984,3,3,126281,126281,126284,0,3,0
35985,1,1,126282,126284,126285,2,3,0
35986,5,1,126287,126287,126288,0,1,2
35987,1,3,126288,126288,126291,0,3,0
35988,6,3,126294,126294,126297,0,3,3
35989,2,3,126296,126297,126300,1,4,0
35990,5,2,126301,126301,126303,0,2,1
35991,6,2,126307,126307,126309,0,2,4
35992,5,2,126312,126312,126314,0,2,3
35993,5,2,126317,126317,126319,0,2,3
35994,3,1,126320,126320,126321,0,1,1
35995,1,2,126321,126321,126323,0,2,0
35996,6,3,126327,126327,126330,0,3,4
35997,6,1,126333,126333,126334,0,1,3
35998,6,3,126339,126339,126342,0,3,5
35999,5,3,126344,126344,126347,0,3,2
36000,5,3,126349,126349,126352,0,3,2
36001,1,3,126350,126352,126355,2,5,0
36002,2,2,126352,126355,126357,3,5,0
36003,4,1,126356,126357,126358,1,2,0
36004,4,3,126360,126360,126363,0,3,2
36005,4,3,126364,126364,126367,0,3,1
36006,6,3,126370,126370,126373,0,3,3
36007,2,3,126372,126373,126376,1,4,0
36008,5,3,126377,126377,126380,0,3,1
36009,4,2,126381,126381,126383,0,2,1
36010,3,2,126384,126384,126386,0,2,1
36011,5,1,126389,126389,126390,0,1,3
36012,1,3,126390,126390,126393,0,3,0
36013,1,2,126391,126393,126395,2,4,0
36014,4,1,126395,126395,126396,0,1,0
36015,5,2,126400,126400,126402,0,2,4
36016,4,2,126404,126404,126406,0,2,2
36017,1,1,126405,126406,126407,1,2,0
36018,5,2,126410,126410,126412,0,2,3
36019,6,3,126416,126416,126419,0,3,4
36020,1,2,126417,126419,126421,2,4,0
36021,3,3,126420,126421,126424,1,4,0
36022,1,2,126421,126424,126426,3,5,0
36023,1,2,126422,126426,126428,4,6,0
36024,5,1,126427,126428,126429,1,2,0
36025,5,1,126432,126432,126433,0,1,3
36026,6,2,126438,126438,126440,0,2,5
36027,5,2,126443,126443,126445,0,2,3
36028,4,3,126447,126447,126450,0,3,2
36029,5,3,126452,126452,126455,0,3,2
36030,3,2,126455,126455,126457,0,2,0
36031,6,1,126461,126461,126462,0,1,4
36032,4,1,126465,126465,126466,0,1,3
36033,5,2,126470,126470,126472,0,2,4
36034,6,1,126476,126476,126477,0,1,4
36035,1,1,126477,126477,126478,0,1,0
36036,3,1,126480,126480,126481,0,1,2
36037,6,3,126486,126486,126489,0,3,5
36038,5,3,126491,126491,126494,0,3,2
36039,1,3,126492,126494,126497,2,5,0
36040,5,1,126497,126497,126498,0,1,0
36041,1,1,126498,126498,126499,0,1,0
36042,2,3,126500,126500,126503,0,3,1
36043,1,1,126501,126503,126504,2,3,0
36044,3,3,126504,126504,126507,0,3,0
36045,4,1,126508,126508,126509,0,1,1
36046,4,3,126512,126512,126515,0,3,3
36047,2,3,126514,126515,126518,1,4,0
36048,2,3,126516,126518,126521,2,5,0
36049,1,1,126517,126521,126522,4,5,0
36050,4,2,126521,126522,126524,1,3,0
36051,2,3,126523,126524,126527,1,4,0
36052,5,2,126528,126528,126530,0,2,1
36053,1,2,126529,126530,126532,1,3,0
36054,5,1,126534,126534,126535,0,1,2
36055,3,3,126537,126537,126540,0,3,2
36056,1,3,126538,126540,126543,2,5,0
36057,3,2,126541,126543,126545,2,4,0
36058,5,1,126546,126546,126547,0,1,1
36059,6,1,126552,126552,126553,0,1,5
36060,3,3,126555,126555,126558,0,3,2
36061,2,2,126557,126558,126560,1,3,0
36062,6,2,126563,126563,126565,0,2,3
36063,3,2,126566,126566,126568,0,2,1
36064,3,3,126569,126569,126572,0,3,1
36065,1,1,126570,126572,126573,2,3,0
36066,6,2,126576,126576,126578,0,2,3
36067,2,2,126578,126578,126580,0,2,0
36068,6,1,126584,126584,126585,0,1,4
36069,4,3,126588,126588,126591,0,3,3
36070,3,3,126591,126591,126594,0,3,0
36071,6,1,126597,126597,126598,0,1,3
36072,1,1,126598,126598,126599,0,1,0
36073,5,1,126603,126603,126604,0,1,4
36074,5,3,126608,126608,126611,0,3,4
36075,4,1,126612,126612,126613,0,1,1
36076,3,2,126615,126615,126617,0,2,2
36077,6,1,126621,126621,126622,0,1,4
36078,2,3,126623,126623,126626,0,3,1
36079,6,1,126629,126629,126630,0,1,3
36080,6,2,126635,126635,126637,0,2,5
36081,4,2,126639,126639,126641,0,2,2
36082,4,2,126643,126643,126645,0,2,2
36083,4,1,126647,126647,126648,0,1,2
36084,5,1,126652,126652,126653,0,1,4
36085,1,1,126653,126653,126654,0,1,0
36086,5,3,126658,126658,126661,0,3,4
36087,1,2,126659,126661,126663,2,4,0
36088,5,1,126664,126664,126665,0,1,1
36089,3,2,126667,126667,126669,0,2,2
36090,6,3,126673,126673,126676,0,3,4
36091,4,1,126677,126677,126678,0,1,1
36092,4,2,126681,126681,126683,0,2,3
36093,3,2,126684,126684,126686,0,2,1
36094,1,1,126685,126686,126687,1,2,0
36095,6,2,126691,126691,126693,0,2,4
36096,2,2,126693,126693,126695,0,2,0
36097,6,3,126699,126699,126702,0,3,4
36098,5,1,126704,126704,126705,0,1,2
36099,5,3,126709,126709,126712,0,3,4
36100,1,2,126710,126712,126714,2,4,0
36101,6,3,126716,126716,126719,0,3,2
36102,5,1,126721,126721,126722,0,1,2
36103,1,3,126722,126722,126725,0,3,0
36104,6,3,126728,126728,126731,0,3,3
36105,6,1,126734,126734,126735,0,1,3
36106,6,1,126740,126740,126741,0,1,5
36107,2,2,126742,126742,126744,0,2,1
36108,4,2,126746,126746,126748,0,2,2
36109,5,1,126751,126751,126752,0,1,3
36110,3,1,126754,126754,126755,0,1,2
36111,4,3,126758,126758,126761,0,3,3
36112,1,2,126759,126761,126763,2,4,0
36113,1,2,126760,126763,126765,3,5,0
36114,1,3,126761,126765,126768,4,7,0
36115,3,3,126764,126768,126771,4,7,0
36116,5,1,126769,126771,126772,2,3,0
36117,4,2,126773,126773,126775,0,2,1
36118,6,1,126779,126779,126780,0,1,4
36119,3,3,126782,126782,126785,0,3,2
36120,1,3,126783,126785,126788,2,5,0
36121,1,2,126784,126788,126790,4,6,0
36122,6,2,126790,126790,126792,0,2,0
36123,4,2,126794,126794,126796,0,2,2
36124,2,3,126796,126796,126799,0,3,0
36125,5,2,126801,126801,126803,0,2,2
36126,5,3,126806,126806,126809,0,3,3
36127,5,2,126811,126811,126813,0,2,2
36128,1,3,126812,126813,126816,1,4,0
36129,4,2,126816,126816,126818,0,2,0
36130,1,1,126817,126818,126819,1,2,0
36131,3,2,126820,126820,126822,0,2,1
36132,6,2,126826,126826,126828,0,2,4
36133,4,1,126830,126830,126831,0,1,2
36134,5,1,126835,126835,126836,0,1,4
36135,6,2,126841,126841,126843,0,2,5
36136,2,2,126843,126843,126845,0,2,0
36137,1,3,126844,126845,126848,1,4,0
36138,4,1,126848,126848,126849,0,1,0
36139,2,1,126850,126850,126851,0,1,1
36140,1,1,126851,126851,126852,0,1,0
36141,4,1,126855,126855,126856,0,1,3
36142,1,3,126856,126856,126859,0,3,0
36143,3,1,126859,126859,126860,0,1,0
36144,2,3,126861,126861,126864,0,3,1
36145,1,3,126862,126864,126867,2,5,0
36146,5,1,126867,126867,126868,0,1,0
36147,6,1,126873,126873,126874,0,1,5
36148,2,2,126875,126875,126877,0,2,1
36149,2,1,126877,126877,126878,0,1,0
36150,3,2,126880,126880,126882,0,2,2
36151,3,3,126883,126883,126886,0,3,1
36152,2,2,126885,126886,126888,1,3,0
36153,2,3,126887,126888,126891,1,4,0
36154,5,1,126892,126892,126893,0,1,1
36155,1,2,126893,126893,126895,0,2,0
36156,5,2,126898,126898,126900,0,2,3
36157,3,2,126901,126901,126903,0,2,1
36158,2,3,126903,126903,126906,0,3,0
36159,4,3,126907,126907,126910,0,3,1
36160,2,2,126909,126910,126912,1,3,0
36161,1,2,126910,126912,126914,2,4,0
36162,2,2,126912,126914,126916,2,4,0
36163,4,1,126916,126916,126917,0,1,0
36164,3,1,126919,126919,126920,0,1,2
36165,3,1,126922,126922,126923,0,1,2
36166,4,3,126926,126926,126929,0,3,3
36167,3,2,126929,126929,126931,0,2,0
36168,4,3,126933,126933,126936,0,3,2
36169,4,3,126937,126937,126940,0,3,1
36170,3,3,126940,126940,126943,0,3,0
36171,3,3,126943,126943,126946,0,3,0
36172,3,3,126946,126946,126949,0,3,0
36173,4,1,126950,126950,126951,0,1,1
36174,6,3,126956,126956,126959,0,3,5
36175,4,2,126960,126960,126962,0,2,1
36176,6,2,126966,126966,126968,0,2,4
36177,2,2,126968,126968,126970,0,2,0
36178,6,1,126974,126974,126975,0,1,4
36179,2,3,126976,126976,126979,0,3,1
36180,3,2,126979,126979,126981,0,2,0
36181,3,1,126982,126982,126983,0,1,1
36182,3,2,126985,126985,126987,0,2,2
36183,2,2,126987,126987,126989,0,2,0
36184,5,2,126992,126992,126994,0,2,3
36185,3,1,126995,126995,126996,0,1,1
36186,2,2,126997,126997,126999,0,2,1
36187,5,1,127002,127002,127003,0,1,3
36188,4,2,127006,127006,127008,0,2,3
36189,3,3,127009,127009,127012,0,3,1
36190,2,1,127011,127012,127013,1,2,0
36191,3,1,127014,127014,127015,0,1,1
36192,6,2,127020,127020,127022,0,2,5
36193,1,2,127021,127022,127024,1,3,0
36194,6,1,127027,127027,127028,0,1,3
36195,3,1,127030,127030,127031,0,1,2
36196,3,2,127033,127033,127035,0,2,2
36197,3,1,127036,127036,127037,0,1,1
36198,5,1,127041,127041,127042,0,1,4
36199,6,1,127047,127047,127048,0,1,5
36200,5,3,127052,127052,127055,0,3,4
36201,1,2,127053,127055,127057,2,4,0
36202,1,3,127054,127057,127060,3,6,0
36203,1,1,127055,127060,127061,5,6,0
36204,2,1,127057,127061,127062,4,5,0
36205,6,3,127063,127063,127066,0,3,1
36206,2,3,127065,127066,127069,1,4,0
36207,6,3,127071,127071,127074,0,3,2
36208,4,1,127075,127075,127076,0,1,1
36209,2,1,127077,127077,127078,0,1,1
36210,4,1,127081,127081,127082,0,1,3
36211,6,2,127087,127087,127089,0,2,5
36212,2,3,127089,127089,127092,0,3,0
36213,5,1,127094,127094,127095,0,1,2
36214,6,1,127100,127100,127101,0,1,5
36215,6,2,127106,127106,127108,0,2,5
36216,4,2,127110,127110,127112,0,2,2
36217,4,1,127114,127114,127115,0,1,2
36218,1,1,127115,127115,127116,0,1,0
36219,6,2,127121,127121,127123,0,2,5
36220,1,2,127122,127123,127125,1,3,0
36221,5,1,127127,127127,127128,0,1,2
36222,6,1,127133,127133,127134,0,1,5
36223,5,3,127138,127138,127141,0,3,4
36224,2,3,127140,127141,127144,1,4,0
36225,3,1,127143,127144,127145,1,2,0
36226,1,1,127144,127145,127146,1,2,0
36227,4,3,127148,127148,127151,0,3,2
36228,3,2,127151,127151,127153,0,2,0
36229,5,3,127156,127156,127159,0,3,3
36230,3,2,127159,127159,127161,0,2,0
36231,1,3,127160,127161,127164,1,4,0
36232,2,1,127162,127164,127165,2,3,0
36233,2,2,127164,127165,127167,1,3,0
36234,2,2,127166,127167,127169,1,3,0
36235,1,1,127167,127169,127170,2,3,0
36236,3,2,127170,127170,127172,0,2,0
36237,4,2,127174,127174,127176,0,2,2
36238,4,2,127178,127178,127180,0,2,2
36239,1,2,127179,127180,127182,1,3,0
36240,3,2,127182,127182,127184,0,2,0
36241,4,3,127186,127186,127189,0,3,2
36242,6,1,127192,127192,127193,0,1,3
36243,5,2,127197,127197,127199,0,2,4
36244,2,3,127199,127199,127202,0,3,0
36245,2,2,127201,127202,127204,1,3,0
36246,3,3,127204,127204,127207,0,3,0
36247,1,1,127205,127207,127208,2,3,0
36248,6,2,127211,127211,127213,0,2,3
36249,4,2,127215,127215,127217,0,2,2
36250,5,3,127220,127220,127223,0,3,3
36251,5,2,127225,127225,127227,0,2,2
36252,3,3,127228,127228,127231,0,3,1
36253,1,3,127229,127231,127234,2,5,0
36254,1,3,127230,127234,127237,4,7,0
36255,3,2,127233,127237,127239,4,6,0
36256,5,2,127238,127239,127241,1,3,0
36257,4,3,127242,127242,127245,0,3,1
36258,4,1,127246,127246,127247,0,1,1
36259,2,2,127248,127248,127250,0,2,1
36260,3,2,127251,127251,127253,0,2,1
36261,3,2,127254,127254,127256,0,2,1
36262,5,1,127259,127259,127260,0,1,3
36263,4,3,127263,127263,127266,0,3,3
36264,3,1,127266,127266,127267,0,1,0
36265,3,3,127269,127269,127272,0,3,2
36266,1,1,127270,127272,127273,2,3,0
36267,4,1,127274,127274,127275,0,1,1
36268,5,3,127279,127279,127282,0,3,4
36269,2,2,127281,127282,127284,1,3,0
36270,5,2,127286,127286,127288,0,2,2
36271,5,3,127291,127291,127294,0,3,3
36272,5,2,127296,127296,127298,0,2,2
36273,3,1,127299,127299,127300,0,1,1
36274,4,1,127303,127303,127304,0,1,3
36275,4,1,127307,127307,127308,0,1,3
36276,6,1,127313,127313,127314,0,1,5
36277,4,1,127317,127317,127318,0,1,3
36278,6,1,127323,127323,127324,0,1,5
36279,4,1,127327,127327,127328,0,1,3
36280,1,1,127328,127328,127329,0,1,0
36281,4,3,127332,127332,127335,0,3,3
36282,5,2,127337,127337,127339,0,2,2
36283,6,1,127343,127343,127344,0,1,4
36284,3,3,127346,127346,127349,0,3,2
36285,6,1,127352,127352,127353,0,1,3
36286,6,1,127358,127358,127359,0,1,5
36287,6,2,127364,127364,127366,0,2,5
36288,2,3,127366,127366,127369,0,3,0
36289,1,2,127367,127369,127371,2,4,0
36290,5,3,127372,127372,127375,0,3,1
36291,2,2,127374,127375,127377,1,3,0
36292,1,1,127375,127377,127378,2,3,0
36293,6,3,127381,127381,127384,0,3,3
36294,6,2,127387,127387,127389,0,2,3
36295,3,3,127390,127390,127393,0,3,1
36296,2,1,127392,127393,127394,1,2,0
36297,6,1,127398,127398,127399,0,1,4
36298,1,3,127399,127399,127402,0,3,0
36299,1,1,127400,127402,127403,2,3,0
36300,2,1,127402,127403,127404,1,2,0
36301,3,1,127405,127405,127406,0,1,1
36302,2,2,127407,127407,127409,0,2,1
36303,2,1,127409,127409,127410,0,1,0
36304,3,3,127412,127412,127415,0,3,2
36305,5,1,127417,127417,127418,0,1,2
36306,5,1,127422,127422,127423,0,1,4
36307,5,3,127427,127427,127430,0,3,4
36308,4,3,127431,127431,127434,0,3,1
36309,6,3,127437,127437,127440,0,3,3
36310,3,1,127440,127440,127441,0,1,0
36311,5,2,127445,127445,127447,0,2,4
36312,3,2,127448,127448,127450,0,2,1
36313,1,2,127449,127450,127452,1,3,0
36314,6,2,127455,127455,127457,0,2,3
36315,6,3,127461,127461,127464,0,3,4
36316,2,3,127463,127464,127467,1,4,0
36317,2,2,127465,127467,127469,2,4,0
36318,4,1,127469,127469,127470,0,1,0
36319,4,3,127473,127473,127476,0,3,3
36320,1,2,127474,127476,127478,2,4,0
36321,1,1,127475,127478,127479,3,4,0
36322,5,3,127480,127480,127483,0,3,1
36323,5,1,127485,127485,127486,0,1,2
36324,5,1,127490,127490,127491,0,1,4
36325,6,3,127496,127496,127499,0,3,5
36326,5,1,127501,127501,127502,0,1,2
36327,2,2,127503,127503,127505,0,2,1
36328,4,2,127507,127507,127509,0,2,2
36329,6,3,127513,127513,127516,0,3,4
36330,6,2,127519,127519,127521,0,2,3
36331,3,3,127522,127522,127525,0,3,1
36332,4,1,127526,127526,127527,0,1,1
36333,3,3,127529,127529,127532,0,3,2
36334,6,3,127535,127535,127538,0,3,3
36335,3,2,127538,127538,127540,0,2,0
36336,2,1,127540,127540,127541,0,1,0
36337,1,2,127541,127541,127543,0,2,0
36338,6,1,127547,127547,127548,0,1,4
36339,6,2,127553,127553,127555,0,2,5
36340,5,1,127558,127558,127559,0,1,3
36341,4,3,127562,127562,127565,0,3,3
36342,6,1,127568,127568,127569,0,1,3
36343,5,1,127573,127573,127574,0,1,4
36344,5,2,127578,127578,127580,0,2,4
36345,5,1,127583,127583,127584,0,1,3
36346,4,1,127587,127587,127588,0,1,3
36347,4,3,127591,127591,127594,0,3,3
36348,4,1,127595,127595,127596,0,1,1
36349,1,2,127596,127596,127598,0,2,0
36350,6,3,127602,127602,127605,0,3,4
36351,1,3,127603,127605,127608,2,5,0
36352,1,2,127604,127608,127610,4,6,0
36353,3,1,127607,127610,127611,3,4,0
36354,6,3,127613,127613,127616,0,3,2
36355,3,2,127616,127616,127618,0,2,0
36356,2,1,127618,127618,127619,0,1,0
36357,2,3,127620,127620,127623,0,3,1
36358,2,1,127622,127623,127624,1,2,0
36359,1,1,127623,127624,127625,1,2,0
36360,2,1,127625,127625,127626,0,1,0
36361,6,2,127631,127631,127633,0,2,5
36362,3,2,127634,127634,127636,0,2,1
36363,1,3,127635,127636,127639,1,4,0
36364,2,2,127637,127639,127641,2,4,0
36365,3,2,127640,127641,127643,1,3,0
36366,3,2,127643,127643,127645,0,2,0
36367,2,2,127645,127645,127647,0,2,0
36368,4,3,127649,127649,127652,0,3,2
36369,2,2,127651,127652,127654,1,3,0
36370,2,1,127653,127654,127655,1,2,0
36371,4,3,127657,127657,127660,0,3,2
36372,6,1,127663,127663,127664,0,1,3
36373,1,2,127664,127664,127666,0,2,0
36374,6,3,127670,127670,127673,0,3,4
36375,3,3,127673,127673,127676,0,3,0
36376,6,2,127679,127679,127681,0,2,3
36377,5,3,127684,127684,127687,0,3,3
36378,4,1,127688,127688,127689,0,1,1
36379,3,1,127691,127691,127692,0,1,2
36380,4,1,127695,127695,127696,0,1,3
36381,2,2,127697,127697,127699,0,2,1
36382,5,2,127702,127702,127704,0,2,3
36383,2,1,127704,127704,127705,0,1,0
36384,3,3,127707,127707,127710,0,3,2
36385,1,1,127708,127710,127711,2,3,0
36386,3,3,127711,127711,127714,0,3,0
36387,2,3,127713,127714,127717,1,4,0
36388,5,2,127718,127718,127720,0,2,1
36389,3,2,127721,127721,127723,0,2,1
36390,5,1,127726,127726,127727,0,1,3
36391,6,3,127732,127732,127735,0,3,5
36392,6,1,127738,127738,127739,0,1,3
36393,5,3,127743,127743,127746,0,3,4
36394,4,2,127747,127747,127749,0,2,1
36395,6,2,127753,127753,127755,0,2,4
36396,1,1,127754,127755,127756,1,2,0
36397,4,3,127758,127758,127761,0,3,2
36398,4,2,127762,127762,127764,0,2,1
36399,2,3,127764,127764,127767,0,3,0
36400,6,1,127770,127770,127771,0,1,3
36401,5,1,127775,127775,127776,0,1,4
36402,4,2,127779,127779,127781,0,2,3
36403,3,2,127782,127782,127784,0,2,1
36404,4,2,127786,127786,127788,0,2,2
36405,2,1,127788,127788,127789,0,1,0
36406,2,2,127790,127790,127792,0,2,1
36407,4,1,127794,127794,127795,0,1,2
36408,1,1,127795,127795,127796,0,1,0
36409,3,1,127798,127798,127799,0,1,2
36410,2,3,127800,127800,127803,0,3,1
36411,3,1,127803,127803,127804,0,1,0
36412,2,2,127805,127805,127807,0,2,1
36413,4,1,127809,127809,127810,0,1,2
36414,4,2,127813,127813,127815,0,2,3
36415,3,1,127816,127816,127817,0,1,1
36416,6,1,127822,127822,127823,0,1,5
36417,5,1,127827,127827,127828,0,1,4
36418,1,2,127828,127828,127830,0,2,0
36419,3,1,127831,127831,127832,0,1,1
36420,6,2,127837,127837,127839,0,2,5
36421,5,3,127842,127842,127845,0,3,3
36422,4,3,127846,127846,127849,0,3,1
36423,1,1,127847,127849,127850,2,3,0
36424,2,3,127849,127850,127853,1,4,0
36425,1,2,127850,127853,127855,3,5,0
36426,4,3,127854,127855,127858,1,4,0
36427,6,3,127860,127860,127863,0,3,2
36428,2,3,127862,127863,127866,1,4,0
36429,5,3,127867,127867,127870,0,3,1
36430,2,3,127869,127870,127873,1,4,0
36431,5,2,127874,127874,127876,0,2,1
36432,4,2,127878,127878,127880,0,2,2
36433,2,3,127880,127880,127883,0,3,0
36434,4,2,127884,127884,127886,0,2,1
36435,2,2,127886,127886,127888,0,2,0
36436,3,2,127889,127889,127891,0,2,1
36437,6,3,127895,127895,127898,0,3,4
36438,4,3,127899,127899,127902,0,3,1
36439,5,2,127904,127904,127906,0,2,2
36440,5,1,127909,127909,127910,0,1,3
36441,5,2,127914,127914,127916,0,2,4
36442,1,2,127915,127916,127918,1,3,0
36443,6,3,127921,127921,127924,0,3,3
36444,3,1,127924,127924,127925,0,1,0
36445,2,3,127926,127926,127929,0,3,1
36446,2,2,127928,127929,127931,1,3,0
36447,2,2,127930,127931,127933,1,3,0
36448,1,2,127931,127933,127935,2,4,0
36449,4,3,127935,127935,127938,0,3,0
36450,3,1,127938,127938,127939,0,1,0
36451,1,2,127939,127939,127941,0,2,0
36452,4,3,127943,127943,127946,0,3,2
36453,2,2,127945,127946,127948,1,3,0
36454,2,2,127947,127948,127950,1,3,0
36455,5,2,127952,127952,127954,0,2,2
36456,4,1,127956,127956,127957,0,1,2
36457,2,1,127958,127958,127959,0,1,1
36458,4,3,127962,127962,127965,0,3,3
36459,4,2,127966,127966,127968,0,2,1
36460,1,3,127967,127968,127971,1,4,0
36461,3,1,127970,127971,127972,1,2,0
36462,1,3,127971,127972,127975,1,4,0
36463,1,1,127972,127975,127976,3,4,0
36464,4,3,127976,127976,127979,0,3,0
36465,4,1,127980,127980,127981,0,1,1
36466,5,3,127985,127985,127988,0,3,4
36467,2,2,127987,127988,127990,1,3,0
36468,6,2,127993,127993,127995,0,2,3
36469,2,2,127995,127995,127997,0,2,0
36470,6,2,128001,128001,128003,0,2,4
36471,1,3,128002,128003,128006,1,4,0
36472,4,1,128006,128006,128007,0,1,0
36473,2,2,128008,128008,128010,0,2,1
36474,4,1,128012,128012,128013,0,1,2
36475,5,1,128017,128017,128018,0,1,4
36476,4,3,128021,128021,128024,0,3,3
36477,4,2,128025,128025,128027,0,2,1
36478,4,1,128029,128029,128030,0,1,2
36479,6,1,128035,128035,128036,0,1,5
36480,3,2,128038,128038,128040,0,2,2
36481,1,3,128039,128040,128043,1,4,0
36482,4,1,128043,128043,128044,0,1,0
36483,1,3,128044,128044,128047,0,3,0
36484,3,1,128047,128047,128048,0,1,0
36485,3,1,128050,128050,128051,0,1,2
36486,3,2,128053,128053,128055,0,2,2
36487,3,2,128056,128056,128058,0,2,1
36488,1,2,128057,128058,128060,1,3,0
36489,6,3,128063,128063,128066,0,3,3
36490,2,2,128065,128066,128068,1,3,0
36491,4,2,128069,128069,128071,0,2,1
36492,2,3,128071,128071,128074,0,3,0
36493,3,2,128074,128074,128076,0,2,0
36494,1,1,128075,128076,128077,1,2,0
36495,2,2,128077,128077,128079,0,2,0
36496,1,1,128078,128079,128080,1,2,0
36497,1,3,128079,128080,128083,1,4,0
36498,6,1,128085,128085,128086,0,1,2
36499,1,2,128086,128086,128088,0,2,0
36500,6,2,128092,128092,128094,0,2,4
36501,3,1,128095,128095,128096,0,1,1
36502,5,1,128100,128100,128101,0,1,4
36503,6,3,128106,128106,128109,0,3,5
36504,4,1,128110,128110,128111,0,1,1
36505,3,1,128113,128113,128114,0,1,2
36506,6,2,128119,128119,128121,0,2,5
36507,5,2,128124,128124,128126,0,2,3
36508,3,1,128127,128127,128128,0,1,1
36509,3,3,128130,128130,128133,0,3,2
36510,1,3,128131,128133,128136,2,5,0
36511,3,3,128134,128136,128139,2,5,0
36512,1,2,128135,128139,128141,4,6,0
36513,3,2,128138,128141,128143,3,5,0
36514,3,3,128141,128143,128146,2,5,0
36515,1,2,128142,128146,128148,4,6,0
36516,4,3,128146,128148,128151,2,5,0
36517,3,2,128149,128151,128153,2,4,0
36518,3,1,128152,128153,128154,1,2,0
36519,4,1,128156,128156,128157,0,1,2
36520,3,2,128159,128159,128161,0,2,2
36521,1,3,128160,128161,128164,1,4,0
36522,4,2,128164,128164,128166,0,2,0
36523,4,1,128168,128168,128169,0,1,2
36524,4,2,128172,128172,128174,0,2,3
36525,6,2,128178,128178,128180,0,2,4
36526,1,1,128179,128180,128181,1,2,0
36527,5,2,128184,128184,128186,0,2,3
36528,1,3,128185,128186,128189,1,4,0
36529,4,2,128189,128189,128191,0,2,0
36530,5,2,128194,128194,128196,0,2,3
36531,1,2,128195,128196,128198,1,3,0
36532,6,1,128201,128201,128202,0,1,3
36533,4,2,128205,128205,128207,0,2,3
36534,2,2,128207,128207,128209,0,2,0
36535,6,3,128213,128213,128216,0,3,4
36536,6,2,128219,128219,128221,0,2,3
36537,3,3,128222,128222,128225,0,3,1
36538,4,2,128226,128226,128228,0,2,1
36539,5,3,128231,128231,128234,0,3,3
36540,3,3,128234,128234,128237,0,3,0
36541,6,1,128240,128240,128241,0,1,3
36542,1,3,128241,128241,128244,0,3,0
36543,5,2,128246,128246,128248,0,2,2
36544,4,1,128250,128250,128251,0,1,2
36545,6,1,128256,128256,128257,0,1,5
36546,4,3,128260,128260,128263,0,3,3
36547,5,1,128265,128265,128266,0,1,2
36548,6,1,128271,128271,128272,0,1,5
36549,1,3,128272,128272,128275,0,3,0
36550,1,3,128273,128275,128278,2,5,0
36551,1,2,128274,128278,128280,4,6,0
36552,4,3,128278,128280,128283,2,5,0
36553,6,3,128284,128284,128287,0,3,1
36554,6,1,128290,128290,128291,0,1,3
36555,2,3,128292,128292,128295,0,3,1
36556,4,2,128296,128296,128298,0,2,1
36557,1,2,128297,128298,128300,1,3,0
36558,3,3,128300,128300,128303,0,3,0
36559,6,3,128306,128306,128309,0,3,3
36560,2,3,128308,128309,128312,1,4,0
36561,5,3,128313,128313,128316,0,3,1
36562,2,2,128315,128316,128318,1,3,0
36563,1,3,128316,128318,128321,2,5,0
36564,1,2,128317,128321,128323,4,6,0
36565,2,2,128319,128323,128325,4,6,0
36566,4,3,128323,128325,128328,2,5,0
36567,1,2,128324,128328,128330,4,6,0
36568,6,3,128330,128330,128333,0,3,0
36569,6,1,128336,128336,128337,0,1,3
36570,2,3,128338,128338,128341,0,3,1
36571,6,2,128344,128344,128346,0,2,3
36572,4,3,128348,128348,128351,0,3,2
36573,4,1,128352,128352,128353,0,1,1
36574,1,1,128353,128353,128354,0,1,0
36575,3,2,128356,128356,128358,0,2,2
36576,1,3,128357,128358,128361,1,4,0
36577,6,3,128363,128363,128366,0,3,2
36578,1,1,128364,128366,128367,2,3,0
36579,4,2,128368,128368,128370,0,2,1
36580,4,2,128372,128372,128374,0,2,2
36581,4,3,128376,128376,128379,0,3,2
36582,5,2,128381,128381,128383,0,2,2
36583,5,1,128386,128386,128387,0,1,3
36584,6,3,128392,128392,128395,0,3,5
36585,6,3,128398,128398,128401,0,3,3
36586,3,1,128401,128401,128402,0,1,0
36587,6,1,128407,128407,128408,0,1,5
36588,1,1,128408,128408,128409,0,1,0
36589,3,1,128411,128411,128412,0,1,2
36590,2,2,128413,128413,128415,0,2,1
36591,2,1,128415,128415,128416,0,1,0
36592,1,3,128416,128416,128419,0,3,0
36593,2,3,128418,128419,128422,1,4,0
36594,5,3,128423,128423,128426,0,3,1
36595,2,2,128425,128426,128428,1,3,0
36596,2,1,128427,128428,128429,1,2,0
36597,5,1,128432,128432,128433,0,1,3
36598,3,2,128435,128435,128437,0,2,2
36599,2,2,128437,128437,128439,0,2,0
36600,2,3,128439,128439,128442,0,3,0
36601,4,1,128443,128443,128444,0,1,1
36602,6,3,128449,128449,128452,0,3,5
36603,6,3,128455,128455,128458,0,3,3
36604,1,1,128456,128458,128459,2,3,0
36605,5,1,128461,128461,128462,0,1,2
36606,4,3,128465,128465,128468,0,3,3
36607,1,1,128466,128468,128469,2,3,0
36608,4,1,128470,128470,128471,0,1,1
36609,2,3,128472,128472,128475,0,3,1
36610,4,3,128476,128476,128479,0,3,1
36611,1,2,128477,128479,128481,2,4,0
36612,1,3,128478,128481,128484,3,6,0
36613,5,2,128483,128484,128486,1,3,0
36614,5,2,128488,128488,128490,0,2,2
36615,1,2,128489,128490,128492,1,3,0
36616,4,2,128493,128493,128495,0,2,1
36617,2,3,128495,128495,128498,0,3,0
36618,2,3,128497,128498,128501,1,4,0
36619,6,3,128503,128503,128506,0,3,2
36620,1,2,128504,128506,128508,2,4,0
36621,1,1,128505,128508,128509,3,4,0
36622,3,1,128508,128509,128510,1,2,0
36623,3,2,128511,128511,128513,0,2,1
36624,3,3,128514,128514,128517,0,3,1
36625,2,1,128516,128517,128518,1,2,0
36626,3,2,128519,128519,128521,0,2,1
36627,5,2,128524,128524,128526,0,2,3
36628,3,3,128527,128527,128530,0,3,1
36629,1,1,128528,128530,128531,2,3,0
36630,5,3,128533,128533,128536,0,3,2
36631,6,1,128539,128539,128540,0,1,3
36632,4,3,128543,128543,128546,0,3,3
36633,3,3,128546,128546,128549,0,3,0
36634,3,1,128549,128549,128550,0,1,0
36635,4,1,128553,128553,128554,0,1,3
36636,6,3,128559,128559,128562,0,3,5
36637,3,2,128562,128562,128564,0,2,0
36638,2,2,128564,128564,128566,0,2,0
36639,2,3,128566,128566,128569,0,3,0
36640,6,1,128572,128572,128573,0,1,3
36641,2,2,128574,128574,128576,0,2,1
36642,4,2,128578,128578,128580,0,2,2
36643,1,2,128579,128580,128582,1,3,0
36644,5,3,128584,128584,128587,0,3,2
36645,5,1,128589,128589,128590,0,1,2
36646,2,2,128591,128591,128593,0,2,1
36647,3,2,128594,128594,128596,0,2,1
36648,6,1,128600,128600,128601,0,1,4
36649,4,2,128604,128604,128606,0,2,3
36650,5,2,128609,128609,128611,0,2,3
36651,6,2,128615,128615,128617,0,2,4
36652,2,3,128617,128617,128620,0,3,0
36653,6,1,128623,128623,128624,0,1,3
36654,5,3,128628,128628,128631,0,3,4
36655,4,3,128632,128632,128635,0,3,1
36656,5,1,128637,128637,128638,0,1,2
36657,6,2,128643,128643,128645,0,2,5
36658,2,3,128645,128645,128648,0,3,0
36659,6,3,128651,128651,128654,0,3,3
36660,1,1,128652,128654,128655,2,3,0
36661,5,1,128657,128657,128658,0,1,2
36662,6,1,128663,128663,128664,0,1,5
36663,3,2,128666,128666,128668,0,2,2
36664,1,1,128667,128668,128669,1,2,0
36665,2,1,128669,128669,128670,0,1,0
36666,5,1,128674,128674,128675,0,1,4
36667,3,1,128677,128677,128678,0,1,2
36668,1,2,128678,128678,128680,0,2,0
36669,2,1,128680,128680,128681,0,1,0
36670,5,2,128685,128685,128687,0,2,4
36671,6,1,128691,128691,128692,0,1,4
36672,4,2,128695,128695,128697,0,2,3
36673,4,3,128699,128699,128702,0,3,2
36674,1,1,128700,128702,128703,2,3,0
36675,5,1,128705,128705,128706,0,1,2
36676,5,1,128710,128710,128711,0,1,4
36677,1,2,128711,128711,128713,0,2,0
36678,5,2,128716,128716,128718,0,2,3
36679,1,1,128717,128718,128719,1,2,0
36680,2,1,128719,128719,128720,0,1,0
36681,5,3,128724,128724,128727,0,3,4
36682,3,2,128727,128727,128729,0,2,0
36683,1,2,128728,128729,128731,1,3,0
36684,6,1,128734,128734,128735,0,1,3
36685,4,3,128738,128738,128741,0,3,3
36686,2,3,128740,128741,128744,1,4,0
36687,4,1,128744,128744,128745,0,1,0
36688,5,2,128749,128749,128751,0,2,4
36689,3,2,128752,128752,128754,0,2,1
36690,4,1,128756,128756,128757,0,1,2
36691,3,1,128759,128759,128760,0,1,2
36692,5,2,128764,128764,128766,0,2,4
36693,5,1,128769,128769,128770,0,1,3
36694,2,2,128771,128771,128773,0,2,1
36695,6,2,128777,128777,128779,0,2,4
36696,1,1,128778,128779,128780,1,2,0
36697,2,3,128780,128780,128783,0,3,0
36698,4,3,128784,128784,128787,0,3,1
36699,6,3,128790,128790,128793,0,3,3
36700,6,2,128796,128796,128798,0,2,3
36701,4,3,128800,128800,128803,0,3,2
36702,3,1,128803,128803,128804,0,1,0
36703,1,3,128804,128804,128807,0,3,0
36704,5,2,128809,128809,128811,0,2,2
36705,2,3,128811,128811,128814,0,3,0
36706,6,1,128817,128817,128818,0,1,3
36707,1,2,128818,128818,128820,0,2,0
36708,3,1,128821,128821,128822,0,1,1
36709,6,2,128827,128827,128829,0,2,5
36710,5,3,128832,128832,128835,0,3,3
36711,6,2,128838,128838,128840,0,2,3
36712,4,1,128842,128842,128843,0,1,2
36713,1,3,128843,128843,128846,0,3,0
36714,4,3,128847,128847,128850,0,3,1
36715,6,1,128853,128853,128854,0,1,3
36716,1,3,128854,128854,128857,0,3,0
36717,4,1,128858,128858,128859,0,1,1
36718,6,3,128864,128864,128867,0,3,5
36719,3,2,128867,128867,128869,0,2,0
36720,4,3,128871,128871,128874,0,3,2
36721,5,2,128876,128876,128878,0,2,2
36722,5,2,128881,128881,128883,0,2,3
36723,1,3,128882,128883,128886,1,4,0
36724,6,2,128888,128888,128890,0,2,2
36725,2,3,128890,128890,128893,0,3,0
36726,6,3,128896,128896,128899,0,3,3
36727,6,3,128902,128902,128905,0,3,3
36728,4,3,128906,128906,128909,0,3,1
36729,1,1,128907,128909,128910,2,3,0
36730,3,3,128910,128910,128913,0,3,0
36731,6,2,128916,128916,128918,0,2,3
36732,6,3,128922,128922,128925,0,3,4
36733,3,2,128925,128925,128927,0,2,0
36734,2,3,128927,128927,128930,0,3,0
36735,1,3,128928,128930,128933,2,5,0
36736,4,2,128932,128933,128935,1,3,0
36737,4,3,128936,128936,128939,0,3,1
36738,2,3,128938,128939,128942,1,4,0
36739,6,3,128944,128944,128947,0,3,2
36740,5,3,128949,128949,128952,0,3,2
36741,2,3,128951,128952,128955,1,4,0
36742,3,2,128954,128955,128957,1,3,0
36743,3,2,128957,128957,128959,0,2,0
36744,5,2,128962,128962,128964,0,2,3
36745,4,1,128966,128966,128967,0,1,2
36746,5,1,128971,128971,128972,0,1,4
36747,4,3,128975,128975,128978,0,3,3
36748,3,1,128978,128978,128979,0,1,0
36749,4,3,128982,128982,128985,0,3,3
36750,4,3,128986,128986,128989,0,3,1
36751,4,1,128990,128990,128991,0,1,1
36752,4,3,128994,128994,128997,0,3,3
36753,5,2,128999,128999,129001,0,2,2
36754,1,2,129000,129001,129003,1,3,0
36755,5,1,129005,129005,129006,0,1,2
36756,3,1,129008,129008,129009,0,1,2
36757,3,1,129011,129011,129012,0,1,2
36758,3,2,129014,129014,129016,0,2,2
36759,6,3,129020,129020,129023,0,3,4
36760,2,1,129022,129023,129024,1,2,0
36761,2,2,129024,129024,129026,0,2,0
36762,4,2,129028,129028,129030,0,2,2
36763,1,3,129029,129030,129033,1,4,0
36764,2,2,129031,129033,129035,2,4,0
36765,4,2,129035,129035,129037,0,2,0
36766,3,2,129038,129038,129040,0,2,1
36767,6,1,129044,129044,129045,0,1,4
36768,4,2,129048,129048,129050,0,2,3
36769,6,2,129054,129054,129056,0,2,4
36770,5,1,129059,129059,129060,0,1,3
36771,2,3,129061,129061,129064,0,3,1
36772,3,2,129064,129064,129066,0,2,0
36773,4,1,129068,129068,129069,0,1,2
36774,1,3,129069,129069,129072,0,3,0
36775,5,3,129074,129074,129077,0,3,2
36776,6,3,129080,129080,129083,0,3,3
36777,2,1,129082,129083,129084,1,2,0
36778,1,3,129083,129084,129087,1,4,0
36779,3,2,129086,129087,129089,1,3,0
36780,1,3,129087,129089,129092,2,5,0
36781,1,2,129088,129092,129094,4,6,0
36782,1,1,129089,129094,129095,5,6,0
36783,3,1,129092,129095,129096,3,4,0
36784,4,1,129096,129096,129097,0,1,0
36785,2,1,129098,129098,129099,0,1,1
36786,2,2,129100,129100,129102,0,2,1
36787,6,2,129106,129106,129108,0,2,4
36788,4,2,129110,129110,129112,0,2,2
36789,6,2,129116,129116,129118,0,2,4
36790,3,3,129119,129119,129122,0,3,1
36791,6,1,129125,129125,129126,0,1,3
36792,4,3,129129,129129,129132,0,3,3
36793,5,2,129134,129134,129136,0,2,2
36794,6,3,129140,129140,129143,0,3,4
36795,4,1,129144,129144,129145,0,1,1
36796,1,1,129145,129145,129146,0,1,0
36797,6,1,129151,129151,129152,0,1,5
36798,6,3,129157,129157,129160,0,3,5
36799,6,2,129163,129163,129165,0,2,3
36800,1,1,129164,129165,129166,1,2,0
36801,1,3,129165,129166,129169,1,4,0
36802,6,2,129171,129171,129173,0,2,2
36803,3,2,129174,129174,129176,0,2,1
36804,4,2,129178,129178,129180,0,2,2
36805,1,1,129179,129180,129181,1,2,0
36806,4,3,129183,129183,129186,0,3,2
36807,2,2,129185,129186,129188,1,3,0
36808,1,3,129186,129188,129191,2,5,0
36809,5,2,129191,129191,129193,0,2,0
36810,1,3,129192,129193,129196,1,4,0
36811,3,3,129195,129196,129199,1,4,0
36812,5,2,129200,129200,129202,0,2,1
36813,1,3,129201,129202,129205,1,4,0
36814,4,1,129205,129205,129206,0,1,0
36815,3,3,129208,129208,129211,0,3,2
36816,1,1,129209,129211,129212,2,3,0
36817,6,2,129215,129215,129217,0,2,3
36818,4,3,129219,129219,129222,0,3,2
36819,4,2,129223,129223,129225,0,2,1
36820,3,1,129226,129226,129227,0,1,1
36821,2,1,129228,129228,129229,0,1,1
36822,5,2,129233,129233,129235,0,2,4
36823,3,3,129236,129236,129239,0,3,1
36824,4,2,129240,129240,129242,0,2,1
36825,2,2,129242,129242,129244,0,2,0
36826,3,2,129245,129245,129247,0,2,1
36827,6,1,129251,129251,129252,0,1,4
36828,2,1,129253,129253,129254,0,1,1
36829,2,2,129255,129255,129257,0,2,1
36830,5,2,129260,129260,129262,0,2,3
36831,6,1,129266,129266,129267,0,1,4
36832,5,3,129271,129271,129274,0,3,4
36833,5,2,129276,129276,129278,0,2,2
36834,4,2,129280,129280,129282,0,2,2
36835,3,2,129283,129283,129285,0,2,1
36836,6,1,129289,129289,129290,0,1,4
36837,4,1,129293,129293,129294,0,1,3
36838,2,2,129295,129295,129297,0,2,1
36839,3,2,129298,129298,129300,0,2,1
36840,3,1,129301,129301,129302,0,1,1
36841,4,3,129305,129305,129308,0,3,3
36842,6,3,129311,129311,129314,0,3,3
36843,2,2,129313,129314,129316,1,3,0
36844,1,3,129314,129316,129319,2,5,0
36845,3,1,129317,129319,129320,2,3,0
36846,3,1,129320,129320,129321,0,1,0
36847,5,3,129325,129325,129328,0,3,4
36848,4,1,129329,129329,129330,0,1,1
36849,3,1,129332,129332,129333,0,1,2
36850,4,2,129336,129336,129338,0,2,3
36851,4,2,129340,129340,129342,0,2,2
36852,6,1,129346,129346,129347,0,1,4
36853,4,3,129350,129350,129353,0,3,3
36854,2,2,129352,129353,129355,1,3,0
36855,6,2,129358,129358,129360,0,2,3
36856,4,1,129362,129362,129363,0,1,2
36857,2,1,129364,129364,129365,0,1,1
36858,2,3,129366,129366,129369,0,3,1
36859,3,3,129369,129369,129372,0,3,0
36860,5,2,129374,129374,129376,0,2,2
36861,6,3,129380,129380,129383,0,3,4
36862,3,3,129383,129383,129386,0,3,0
36863,6,2,129389,129389,129391,0,2,3
36864,1,1,129390,129391,129392,1,2,0
36865,5,1,129395,129395,129396,0,1,3
36866,1,1,129396,129396,129397,0,1,0
36867,5,3,129401,129401,129404,0,3,4
36868,4,1,129405,129405,129406,0,1,1
36869,4,2,129409,129409,129411,0,2,3
36870,4,1,129413,129413,129414,0,1,2
36871,4,2,129417,129417,129419,0,2,3
36872,4,3,129421,129421,129424,0,3,2
36873,5,1,129426,129426,129427,0,1,2
36874,4,1,129430,129430,129431,0,1,3
36875,4,1,129434,129434,129435,0,1,3
36876,4,3,129438,129438,129441,0,3,3
36877,2,1,129440,129441,129442,1,2,0
36878,4,3,129444,129444,129447,0,3,2
36879,4,2,129448,129448,129450,0,2,1
36880,2,1,129450,129450,129451,0,1,0
36881,3,2,129453,129453,129455,0,2,2
36882,3,2,129456,129456,129458,0,2,1
36883,6,2,129462,129462,129464,0,2,4
36884,2,3,129464,129464,129467,0,3,0
36885,2,1,129466,129467,129468,1,2,0
36886,1,1,129467,129468,129469,1,2,0
36887,4,1,129471,129471,129472,0,1,2
36888,5,2,129476,129476,129478,0,2,4
36889,6,2,129482,129482,129484,0,2,4
36890,5,2,129487,129487,129489,0,2,3
36891,2,3,129489,129489,129492,0,3,0
36892,5,3,129494,129494,129497,0,3,2
36893,5,1,129499,129499,129500,0,1,2
36894,2,3,129501,129501,129504,0,3,1
36895,1,1,129502,129504,129505,2,3,0
36896,6,3,129508,129508,129511,0,3,3
36897,1,3,129509,129511,129514,2,5,0
36898,4,1,129513,129514,129515,1,2,0
36899,1,2,129514,129515,129517,1,3,0
36900,5,2,129519,129519,129521,0,2,2
36901,3,2,129522,129522,129524,0,2,1
36902,3,1,129525,129525,129526,0,1,1
36903,3,1,129528,129528,129529,0,1,2
36904,2,2,129530,129530,129532,0,2,1
36905,2,2,129532,129532,129534,0,2,0
36906,6,3,129538,129538,129541,0,3,4
36907,4,3,129542,129542,129545,0,3,1
36908,6,3,129548,129548,129551,0,3,3
36909,2,2,129550,129551,129553,1,3,0
36910,3,3,129553,129553,129556,0,3,0
36911,5,3,129558,129558,129561,0,3,2
36912,4,1,129562,129562,129563,0,1,1
36913,3,2,129565,129565,129567,0,2,2
36914,5,3,129570,129570,129573,0,3,3
36915,2,2,129572,129573,129575,1,3,0
36916,4,1,129576,129576,129577,0,1,1
36917,5,2,129581,129581,129583,0,2,4
36918,1,3,129582,129583,129586,1,4,0
36919,3,1,129585,129586,129587,1,2,0
36920,4,1,129589,129589,129590,0,1,2
36921,2,3,129591,129591,129594,0,3,1
36922,1,3,129592,129594,129597,2,5,0
36923,3,1,129595,129597,129598,2,3,0
36924,4,3,129599,129599,129602,0,3,1
36925,6,1,129605,129605,129606,0,1,3
36926,4,2,129609,129609,129611,0,2,3
36927,4,1,129613,129613,129614,0,1,2
36928,1,3,129614,129614,129617,0,3,0
36929,3,2,129617,129617,129619,0,2,0
36930,2,1,129619,129619,129620,0,1,0
36931,6,2,129625,129625,129627,0,2,5
36932,3,3,129628,129628,129631,0,3,1
36933,6,3,129634,129634,129637,0,3,3
36934,1,2,129635,129637,129639,2,4,0
36935,1,2,129636,129639,129641,3,5,0
36936,3,1,129639,129641,129642,2,3,0
36937,6,1,129645,129645,129646,0,1,3
36938,6,2,129651,129651,129653,0,2,5
36939,3,2,129654,129654,129656,0,2,1
36940,6,3,129660,129660,129663,0,3,4
36941,6,1,129666,129666,129667,0,1,3
36942,1,1,129667,129667,129668,0,1,0
36943,4,2,129671,129671,129673,0,2,3
36944,2,1,129673,129673,129674,0,1,0
36945,6,3,129679,129679,129682,0,3,5
36946,1,1,129680,129682,129683,2,3,0
36947,6,1,129686,129686,129687,0,1,3
36948,3,2,129689,129689,129691,0,2,2
36949,1,2,129690,129691,129693,1,3,0
36950,1,1,129691,129693,129694,2,3,0
36951,5,3,129696,129696,129699,0,3,2
36952,1,2,129697,129699,129701,2,4,0
36953,2,3,129699,129701,129704,2,5,0
36954,6,1,129705,129705,129706,0,1,1
36955,6,1,129711,129711,129712,0,1,5
36956,3,1,129714,129714,129715,0,1,2
36957,1,2,129715,129715,129717,0,2,0
36958,2,1,129717,129717,129718,0,1,0
36959,3,3,129720,129720,129723,0,3,2
36960,5,2,129725,129725,129727,0,2,2
36961,5,2,129730,129730,129732,0,2,3
36962,1,1,129731,129732,129733,1,2,0
36963,1,3,129732,129733,129736,1,4,0
36964,6,2,129738,129738,129740,0,2,2
36965,1,1,129739,129740,129741,1,2,0
36966,1,2,129740,129741,129743,1,3,0
36967,3,1,129743,129743,129744,0,1,0
36968,4,1,129747,129747,129748,0,1,3
36969,5,1,129752,129752,129753,0,1,4
36970,3,3,129755,129755,129758,0,3,2
36971,3,2,129758,129758,129760,0,2,0
36972,4,2,129762,129762,129764,0,2,2
36973,5,3,129767,129767,129770,0,3,3
36974,1,3,129768,129770,129773,2,5,0
36975,6,3,129774,129774,129777,0,3,1
36976,3,2,129777,129777,129779,0,2,0
36977,5,2,129782,129782,129784,0,2,3
36978,2,3,129784,129784,129787,0,3,0
36979,3,1,129787,129787,129788,0,1,0
36980,2,1,129789,129789,129790,0,1,1
36981,3,3,129792,129792,129795,0,3,2
36982,6,1,129798,129798,129799,0,1,3
36983,2,1,129800,129800,129801,0,1,1
36984,5,2,129805,129805,129807,0,2,4
36985,2,1,129807,129807,129808,0,1,0
36986,6,3,129813,129813,129816,0,3,5
36987,6,3,129819,129819,129822,0,3,3
36988,1,3,129820,129822,129825,2,5,0
36989,2,2,129822,129825,129827,3,5,0
36990,2,3,129824,129827,129830,3,6,0
36991,3,2,129827,129830,129832,3,5,0
36992,2,3,129829,129832,129835,3,6,0
36993,6,3,129835,129835,129838,0,3,0
36994,3,2,129838,129838,129840,0,2,0
36995,3,1,129841,129841,129842,0,1,1
36996,5,2,129846,129846,129848,0,2,4
36997,2,2,129848,129848,129850,0,2,0
36998,5,3,129853,129853,129856,0,3,3
36999,3,2,129856,129856,129858,0,2,0
37000,2,1,129858,129858,129859,0,1,0
37001,5,1,129863,129863,129864,0,1,4
37002,5,3,129868,129868,129871,0,3,4
37003,5,2,129873,129873,129875,0,2,2
37004,1,1,129874,129875,129876,1,2,0
37005,4,1,129878,129878,129879,0,1,2
37006,1,3,129879,129879,129882,0,3,0
37007,1,1,129880,129882,129883,2,3,0
37008,6,2,129886,129886,129888,0,2,3
37009,5,3,129891,129891,129894,0,3,3
37010,3,1,129894,129894,129895,0,1,0
37011,2,1,129896,129896,129897,0,1,1
37012,3,3,129899,129899,129902,0,3,2
37013,3,2,129902,129902,129904,0,2,0
37014,5,1,129907,129907,129908,0,1,3
37015,2,1,129909,129909,129910,0,1,1
37016,2,1,129911,129911,129912,0,1,1
37017,1,2,129912,129912,129914,0,2,0
37018,5,2,129917,129917,129919,0,2,3
37019,2,2,129919,129919,129921,0,2,0
37020,6,1,129925,129925,129926,0,1,4
37021,5,2,129930,129930,129932,0,2,4
37022,1,3,129931,129932,129935,1,4,0
37023,2,3,129933,129935,129938,2,5,0
37024,2,2,129935,129938,129940,3,5,0
37025,4,1,129939,129940,129941,1,2,0
37026,3,1,129942,129942,129943,0,1,1
37027,4,2,129946,129946,129948,0,2,3
37028,2,1,129948,129948,129949,0,1,0
37029,4,2,129952,129952,129954,0,2,3
37030,3,1,129955,129955,129956,0,1,1
37031,4,1,129959,129959,129960,0,1,3
37032,6,3,129965,129965,129968,0,3,5
37033,1,2,129966,129968,129970,2,4,0
37034,6,2,129972,129972,129974,0,2,2
37035,3,2,129975,129975,129977,0,2,1
37036,5,2,129980,129980,129982,0,2,3
37037,3,1,129983,129983,129984,0,1,1
37038,4,3,129987,129987,129990,0,3,3
37039,1,2,129988,129990,129992,2,4,0
37040,6,2,129994,129994,129996,0,2,2
37041,5,3,129999,129999,130002,0,3,3
37042,6,3,130005,130005,130008,0,3,3
37043,1,2,130006,130008,130010,2,4,0
37044,4,1,130010,130010,130011,0,1,0
37045,6,3,130016,130016,130019,0,3,5
37046,3,3,130019,130019,130022,0,3,0
37047,4,3,130023,130023,130026,0,3,1
37048,6,3,130029,130029,130032,0,3,3
37049,4,2,130033,130033,130035,0,2,1
37050,3,2,130036,130036,130038,0,2,1
37051,4,1,130040,130040,130041,0,1,2
37052,3,2,130043,130043,130045,0,2,2
37053,5,2,130048,130048,130050,0,2,3
37054,1,1,130049,130050,130051,1,2,0
37055,4,3,130053,130053,130056,0,3,2
37056,4,2,130057,130057,130059,0,2,1
37057,2,1,130059,130059,130060,0,1,0
37058,3,1,130062,130062,130063,0,1,2
37059,6,1,130068,130068,130069,0,1,5
37060,2,2,130070,130070,130072,0,2,1
37061,4,3,130074,130074,130077,0,3,2
37062,1,1,130075,130077,130078,2,3,0
37063,6,1,130081,130081,130082,0,1,3
37064,5,3,130086,130086,130089,0,3,4
37065,6,1,130092,130092,130093,0,1,3
37066,2,1,130094,130094,130095,0,1,1
37067,1,3,130095,130095,130098,0,3,0
37068,2,1,130097,130098,130099,1,2,0
37069,6,1,130103,130103,130104,0,1,4
37070,3,2,130106,130106,130108,0,2,2
37071,1,3,130107,130108,130111,1,4,0
37072,6,3,130113,130113,130116,0,3,2
37073,4,1,130117,130117,130118,0,1,1
37074,4,3,130121,130121,130124,0,3,3
37075,6,3,130127,130127,130130,0,3,3
37076,1,2,130128,130130,130132,2,4,0
37077,5,3,130133,130133,130136,0,3,1
37078,6,1,130139,130139,130140,0,1,3
37079,1,2,130140,130140,130142,0,2,0
37080,3,1,130143,130143,130144,0,1,1
37081,3,1,130146,130146,130147,0,1,2
37082,4,2,130150,130150,130152,0,2,3
37083,6,3,130156,130156,130159,0,3,4
37084,4,3,130160,130160,130163,0,3,1
37085,1,2,130161,130163,130165,2,4,0
37086,6,2,130167,130167,130169,0,2,2
37087,5,1,130172,130172,130173,0,1,3
37088,1,2,130173,130173,130175,0,2,0
37089,1,3,130174,130175,130178,1,4,0
37090,6,1,130180,130180,130181,0,1,2
37091,2,2,130182,130182,130184,0,2,1
37092,3,2,130185,130185,130187,0,2,1
37093,4,2,130189,130189,130191,0,2,2
37094,5,2,130194,130194,130196,0,2,3
37095,3,1,130197,130197,130198,0,1,1
37096,4,1,130201,130201,130202,0,1,3
37097,3,3,130204,130204,130207,0,3,2
37098,3,3,130207,130207,130210,0,3,0
37099,5,2,130212,130212,130214,0,2,2
37100,5,3,130217,130217,130220,0,3,3
37101,2,2,130219,130220,130222,1,3,0
37102,3,1,130222,130222,130223,0,1,0
37103,4,1,130226,130226,130227,0,1,3
37104,5,3,130231,130231,130234,0,3,4
37105,1,2,130232,130234,130236,2,4,0
37106,5,1,130237,130237,130238,0,1,1
37107,1,3,130238,130238,130241,0,3,0
37108,3,1,130241,130241,130242,0,1,0
37109,6,1,130247,130247,130248,0,1,5
37110,5,1,130252,130252,130253,0,1,4
37111,3,2,130255,130255,130257,0,2,2
37112,2,2,130257,130257,130259,0,2,0
37113,2,1,130259,130259,130260,0,1,0
37114,2,3,130261,130261,130264,0,3,1
37115,4,3,130265,130265,130268,0,3,1
37116,2,1,130267,130268,130269,1,2,0
37117,4,3,130271,130271,130274,0,3,2
37118,5,1,130276,130276,130277,0,1,2
37119,5,3,130281,130281,130284,0,3,4
37120,5,1,130286,130286,130287,0,1,2
37121,2,1,130288,130288,130289,0,1,1
37122,5,3,130293,130293,130296,0,3,4
37123,3,1,130296,130296,130297,0,1,0
37124,3,2,130299,130299,130301,0,2,2
37125,4,2,130303,130303,130305,0,2,2
37126,2,2,130305,130305,130307,0,2,0
37127,5,1,130310,130310,130311,0,1,3
37128,3,3,130313,130313,130316,0,3,2
37129,5,1,130318,130318,130319,0,1,2
37130,4,2,130322,130322,130324,0,2,3
37131,1,3,130323,130324,130327,1,4,0
37132,5,3,130328,130328,130331,0,3,1
37133,2,1,130330,130331,130332,1,2,0
37134,6,3,130336,130336,130339,0,3,4
37135,1,3,130337,130339,130342,2,5,0
37136,5,3,130342,130342,130345,0,3,0
37137,6,2,130348,130348,130350,0,2,3
37138,2,1,130350,130350,130351,0,1,0
37139,1,3,130351,130351,130354,0,3,0
37140,5,3,130356,130356,130359,0,3,2
37141,3,2,130359,130359,130361,0,2,0
37142,4,3,130363,130363,130366,0,3,2
37143,5,1,130368,130368,130369,0,1,2
37144,4,3,130372,130372,130375,0,3,3
37145,6,1,130378,130378,130379,0,1,3
37146,4,2,130382,130382,130384,0,2,3
37147,5,3,130387,130387,130390,0,3,3
37148,3,2,130390,130390,130392,0,2,0
37149,4,1,130394,130394,130395,0,1,2
37150,1,3,130395,130395,130398,0,3,0
37151,2,2,130397,130398,130400,1,3,0
37152,4,3,130401,130401,130404,0,3,1
37153,6,2,130407,130407,130409,0,2,3
37154,5,3,130412,130412,130415,0,3,3
37155,3,1,130415,130415,130416,0,1,0
37156,2,2,130417,130417,130419,0,2,1
37157,6,1,130423,130423,130424,0,1,4
37158,2,1,130425,130425,130426,0,1,1
37159,5,2,130430,130430,130432,0,2,4
37160,6,1,130436,130436,130437,0,1,4
37161,5,2,130441,130441,130443,0,2,4
37162,3,3,130444,130444,130447,0,3,1
37163,1,1,130445,130447,130448,2,3,0
37164,4,2,130449,130449,130451,0,2,1
37165,6,1,130455,130455,130456,0,1,4
37166,1,3,130456,130456,130459,0,3,0
37167,4,1,130460,130460,130461,0,1,1
37168,4,2,130464,130464,130466,0,2,3
37169,6,3,130470,130470,130473,0,3,4
37170,1,3,130471,130473,130476,2,5,0
37171,1,2,130472,130476,130478,4,6,0
37172,4,3,130476,130478,130481,2,5,0
37173,6,3,130482,130482,130485,0,3,1
37174,2,3,130484,130485,130488,1,4,0
37175,2,2,130486,130488,130490,2,4,0
37176,6,2,130492,130492,130494,0,2,2
37177,2,2,130494,130494,130496,0,2,0
37178,5,2,130499,130499,130501,0,2,3
37179,3,3,130502,130502,130505,0,3,1
37180,1,3,130503,130505,130508,2,5,0
37181,2,3,130505,130508,130511,3,6,0
37182,5,1,130510,130511,130512,1,2,0
37183,1,1,130511,130512,130513,1,2,0
37184,5,1,130516,130516,130517,0,1,3
37185,2,3,130518,130518,130521,0,3,1
37186,4,3,130522,130522,130525,0,3,1
37187,4,3,130526,130526,130529,0,3,1
37188,5,2,130531,130531,130533,0,2,2
37189,1,3,130532,130533,130536,1,4,0
37190,4,1,130536,130536,130537,0,1,0
37191,4,1,130540,130540,130541,0,1,3
37192,1,3,130541,130541,130544,0,3,0
37193,2,3,130543,130544,130547,1,4,0
37194,3,3,130546,130547,130550,1,4,0
37195,6,3,130552,130552,130555,0,3,2
37196,4,3,130556,130556,130559,0,3,1
37197,6,1,130562,130562,130563,0,1,3
37198,4,2,130566,130566,130568,0,2,3
37199,1,1,130567,130568,130569,1,2,0
37200,5,3,130572,130572,130575,0,3,3
37201,4,1,130576,130576,130577,0,1,1
37202,6,1,130582,130582,130583,0,1,5
37203,6,3,130588,130588,130591,0,3,5
37204,3,2,130591,130591,130593,0,2,0
37205,5,2,130596,130596,130598,0,2,3
37206,3,1,130599,130599,130600,0,1,1
37207,1,2,130600,130600,130602,0,2,0
37208,1,1,130601,130602,130603,1,2,0
37209,6,2,130607,130607,130609,0,2,4
37210,1,1,130608,130609,130610,1,2,0
37211,6,3,130614,130614,130617,0,3,4
37212,2,3,130616,130617,130620,1,4,0
37213,3,1,130619,130620,130621,1,2,0
37214,1,3,130620,130621,130624,1,4,0
37215,2,2,130622,130624,130626,2,4,0
37216,5,2,130627,130627,130629,0,2,1
37217,6,2,130633,130633,130635,0,2,4
37218,3,2,130636,130636,130638,0,2,1
37219,2,1,130638,130638,130639,0,1,0
37220,2,3,130640,130640,130643,0,3,1
37221,5,1,130645,130645,130646,0,1,2
37222,4,1,130649,130649,130650,0,1,3
37223,6,1,130655,130655,130656,0,1,5
37224,3,2,130658,130658,130660,0,2,2
37225,5,2,130663,130663,130665,0,2,3
37226,2,1,130665,130665,130666,0,1,0
37227,2,3,130667,130667,130670,0,3,1
37228,4,1,130671,130671,130672,0,1,1
37229,3,1,130674,130674,130675,0,1,2
37230,6,3,130680,130680,130683,0,3,5
37231,6,3,130686,130686,130689,0,3,3
37232,3,3,130689,130689,130692,0,3,0
37233,3,3,130692,130692,130695,0,3,0
37234,6,3,130698,130698,130701,0,3,3
37235,6,3,130704,130704,130707,0,3,3
37236,1,1,130705,130707,130708,2,3,0
37237,5,3,130710,130710,130713,0,3,2
37238,1,1,130711,130713,130714,2,3,0
37239,5,2,130716,130716,130718,0,2,2
37240,2,2,130718,130718,130720,0,2,0
37241,3,1,130721,130721,130722,0,1,1
37242,5,2,130726,130726,130728,0,2,4
37243,1,1,130727,130728,130729,1,2,0
37244,6,1,130733,130733,130734,0,1,4
37245,3,1,130736,130736,130737,0,1,2
37246,1,3,130737,130737,130740,0,3,0
37247,5,3,130742,130742,130745,0,3,2
37248,5,1,130747,130747,130748,0,1,2
37249,3,1,130750,130750,130751,0,1,2
37250,2,3,130752,130752,130755,0,3,1
37251,4,3,130756,130756,130759,0,3,1
37252,4,2,130760,130760,130762,0,2,1
37253,2,1,130762,130762,130763,0,1,0
37254,4,2,130766,130766,130768,0,2,3
37255,2,3,130768,130768,130771,0,3,0
37256,5,2,130773,130773,130775,0,2,2
37257,1,1,130774,130775,130776,1,2,0
37258,5,1,130779,130779,130780,0,1,3
37259,2,1,130781,130781,130782,0,1,1
37260,3,2,130784,130784,130786,0,2,2
37261,1,1,130785,130786,130787,1,2,0
37262,6,2,130791,130791,130793,0,2,4
37263,6,2,130797,130797,130799,0,2,4
37264,1,3,130798,130799,130802,1,4,0
37265,2,2,130800,130802,130804,2,4,0
37266,1,3,130801,130804,130807,3,6,0
37267,4,1,130805,130807,130808,2,3,0
37268,5,1,130810,130810,130811,0,1,2
37269,4,3,130814,130814,130817,0,3,3
37270,6,2,130820,130820,130822,0,2,3
37271,6,2,130826,130826,130828,0,2,4
37272,4,3,130830,130830,130833,0,3,2
37273,4,1,130834,130834,130835,0,1,1
37274,2,3,130836,130836,130839,0,3,1
37275,5,3,130841,130841,130844,0,3,2
37276,4,1,130845,130845,130846,0,1,1
37277,6,2,130851,130851,130853,0,2,5
37278,2,3,130853,130853,130856,0,3,0
37279,2,1,130855,130856,130857,1,2,0
37280,6,1,130861,130861,130862,0,1,4
37281,3,2,130864,130864,130866,0,2,2
37282,2,3,130866,130866,130869,0,3,0
37283,1,1,130867,130869,130870,2,3,0
37284,6,1,130873,130873,130874,0,1,3
37285,1,2,130874,130874,130876,0,2,0
37286,1,2,130875,130876,130878,1,3,0
37287,6,2,130881,130881,130883,0,2,3
37288,2,1,130883,130883,130884,0,1,0
37289,4,3,130887,130887,130890,0,3,3
37290,6,1,130893,130893,130894,0,1,3
37291,3,3,130896,130896,130899,0,3,2
37292,4,2,130900,130900,130902,0,2,1
37293,3,2,130903,130903,130905,0,2,1
37294,4,1,130907,130907,130908,0,1,2
37295,5,1,130912,130912,130913,0,1,4
37296,4,1,130916,130916,130917,0,1,3
37297,5,2,130921,130921,130923,0,2,4
37298,2,3,130923,130923,130926,0,3,0
37299,3,1,130926,130926,130927,0,1,0
37300,6,1,130932,130932,130933,0,1,5
37301,6,1,130938,130938,130939,0,1,5
37302,1,1,130939,130939,130940,0,1,0
37303,5,3,130944,130944,130947,0,3,4
37304,2,1,130946,130947,130948,1,2,0
37305,6,3,130952,130952,130955,0,3,4
37306,3,1,130955,130955,130956,0,1,0
37307,6,1,130961,130961,130962,0,1,5
37308,4,2,130965,130965,130967,0,2,3
37309,4,1,130969,130969,130970,0,1,2
37310,1,2,130970,130970,130972,0,2,0
37311,4,1,130974,130974,130975,0,1,2
37312,6,3,130980,130980,130983,0,3,5
37313,3,1,130983,130983,130984,0,1,0
37314,6,3,130989,130989,130992,0,3,5
37315,3,1,130992,130992,130993,0,1,0
37316,6,3,130998,130998,131001,0,3,5
37317,6,2,131004,131004,131006,0,2,3
37318,3,3,131007,131007,131010,0,3,1
37319,6,1,131013,131013,131014,0,1,3
37320,4,1,131017,131017,131018,0,1,3
37321,1,3,131018,131018,131021,0,3,0
37322,6,1,131024,131024,131025,0,1,3
37323,1,1,131025,131025,131026,0,1,0
37324,1,3,131026,131026,131029,0,3,0
37325,5,2,131031,131031,131033,0,2,2
37326,2,3,131033,131033,131036,0,3,0
37327,3,2,131036,131036,131038,0,2,0
37328,3,1,131039,131039,131040,0,1,1
37329,1,1,131040,131040,131041,0,1,0
37330,5,1,131045,131045,131046,0,1,4
37331,1,1,131046,131046,131047,0,1,0
37332,4,3,131050,131050,131053,0,3,3
37333,4,2,131054,131054,131056,0,2,1
37334,5,2,131059,131059,131061,0,2,3
37335,1,3,131060,131061,131064,1,4,0
37336,2,1,131062,131064,131065,2,3,0
37337,3,1,131065,131065,131066,0,1,0
37338,3,3,131068,131068,131071,0,3,2
37339,6,1,131074,131074,131075,0,1,3
37340,2,3,131076,131076,131079,0,3,1
37341,4,1,131080,131080,131081,0,1,1
37342,2,2,131082,131082,131084,0,2,1
37343,2,2,131084,131084,131086,0,2,0
37344,1,2,131085,131086,131088,1,3,0
37345,2,2,131087,131088,131090,1,3,0
37346,2,2,131089,131090,131092,1,3,0
37347,4,1,131093,131093,131094,0,1,1
37348,3,1,131096,131096,131097,0,1,2
37349,2,2,131098,131098,131100,0,2,1
37350,5,1,131103,131103,131104,0,1,3
37351,5,3,131108,131108,131111,0,3,4
37352,3,3,131111,131111,131114,0,3,0
37353,3,2,131114,131114,131116,0,2,0
37354,2,3,131116,131116,131119,0,3,0
37355,6,2,131122,131122,131124,0,2,3
37356,2,3,131124,131124,131127,0,3,0
37357,3,3,131127,131127,131130,0,3,0
37358,1,3,131128,131130,131133,2,5,0
37359,5,2,131133,131133,131135,0,2,0
37360,3,1,131136,131136,131137,0,1,1
37361,3,2,131139,131139,131141,0,2,2
37362,2,2,131141,131141,131143,0,2,0
37363,4,3,131145,131145,131148,0,3,2
37364,6,1,131151,131151,131152,0,1,3
37365,3,3,131154,131154,131157,0,3,2
37366,5,2,131159,131159,131161,0,2,2
37367,1,2,131160,131161,131163,1,3,0
37368,1,3,131161,131163,131166,2,5,0
37369,4,3,131165,131166,131169,1,4,0
37370,3,2,131168,131169,131171,1,3,0
37371,3,3,131171,131171,131174,0,3,0
37372,1,3,131172,131174,131177,2,5,0
37373,4,2,131176,131177,131179,1,3,0
37374,1,2,131177,131179,131181,2,4,0
37375,4,2,131181,131181,131183,0,2,0
37376,6,2,131187,131187,131189,0,2,4
37377,1,3,131188,131189,131192,1,4,0
37378,1,3,131189,131192,131195,3,6,0
37379,3,3,131192,131195,131198,3,6,0
37380,4,1,131196,131198,131199,2,3,0
37381,2,2,131198,131199,131201,1,3,0
37382,6,3,131204,131204,131207,0,3,3
37383,1,3,131205,131207,131210,2,5,0
37384,5,1,131210,131210,131211,0,1,0
37385,4,1,131214,131214,131215,0,1,3
37386,1,3,131215,131215,131218,0,3,0
37387,1,1,131216,131218,131219,2,3,0
37388,3,2,131219,131219,131221,0,2,0
37389,2,3,131221,131221,131224,0,3,0
37390,2,2,131223,131224,131226,1,3,0
37391,6,3,131229,131229,131232,0,3,3
37392,4,2,131233,131233,131235,0,2,1
37393,6,1,131239,131239,131240,0,1,4
37394,1,2,131240,131240,131242,0,2,0
37395,6,3,131246,131246,131249,0,3,4
37396,6,1,131252,131252,131253,0,1,3
37397,4,1,131256,131256,131257,0,1,3
37398,1,1,131257,131257,131258,0,1,0
37399,6,2,131263,131263,131265,0,2,5
37400,1,3,131264,131265,131268,1,4,0
37401,4,1,131268,131268,131269,0,1,0
37402,6,1,131274,131274,131275,0,1,5
37403,2,3,131276,131276,131279,0,3,1
37404,3,1,131279,131279,131280,0,1,0
37405,3,2,131282,131282,131284,0,2,2
37406,3,2,131285,131285,131287,0,2,1
37407,5,2,131290,131290,131292,0,2,3
37408,4,3,131294,131294,131297,0,3,2
37409,4,2,131298,131298,131300,0,2,1
37410,3,1,131301,131301,131302,0,1,1
37411,4,1,131305,131305,131306,0,1,3
37412,5,2,131310,131310,131312,0,2,4
37413,4,2,131314,131314,131316,0,2,2
37414,3,2,131317,131317,131319,0,2,1
37415,1,3,131318,131319,131322,1,4,0
37416,2,2,131320,131322,131324,2,4,0
37417,1,1,131321,131324,131325,3,4,0
37418,4,1,131325,131325,131326,0,1,0
37419,4,2,131329,131329,131331,0,2,3
37420,2,3,131331,131331,131334,0,3,0
37421,2,3,131333,131334,131337,1,4,0
37422,1,1,131334,131337,131338,3,4,0
37423,6,2,131340,131340,131342,0,2,2
37424,5,2,131345,131345,131347,0,2,3
37425,4,1,131349,131349,131350,0,1,2
37426,3,1,131352,131352,131353,0,1,2
37427,3,2,131355,131355,131357,0,2,2
37428,6,1,131361,131361,131362,0,1,4
37429,2,3,131363,131363,131366,0,3,1
37430,1,2,131364,131366,131368,2,4,0
37431,1,3,131365,131368,131371,3,6,0
37432,2,1,131367,131371,131372,4,5,0
37433,4,1,131371,131372,131373,1,2,0
37434,2,1,131373,131373,131374,0,1,0
37435,1,2,131374,131374,131376,0,2,0
37436,4,2,131378,131378,131380,0,2,2
37437,3,1,131381,131381,131382,0,1,1
37438,2,3,131383,131383,131386,0,3,1
37439,1,3,131384,131386,131389,2,5,0
37440,6,1,131390,131390,131391,0,1,1
37441,1,2,131391,131391,131393,0,2,0
37442,3,1,131394,131394,131395,0,1,1
37443,2,1,131396,131396,131397,0,1,1
37444,5,1,131401,131401,131402,0,1,4
37445,4,1,131405,131405,131406,0,1,3
37446,6,2,131411,131411,131413,0,2,5
37447,2,2,131413,131413,131415,0,2,0
37448,1,2,131414,131415,131417,1,3,0
37449,3,1,131417,131417,131418,0,1,0
37450,2,2,131419,131419,131421,0,2,1
37451,3,2,131422,131422,131424,0,2,1
37452,5,3,131427,131427,131430,0,3,3
37453,6,2,131433,131433,131435,0,2,3
37454,4,3,131437,131437,131440,0,3,2
37455,4,3,131441,131441,131444,0,3,1
37456,6,3,131447,131447,131450,0,3,3
37457,3,2,131450,131450,131452,0,2,0
37458,2,3,131452,131452,131455,0,3,0
37459,5,3,131457,131457,131460,0,3,2
37460,4,3,131461,131461,131464,0,3,1
37461,6,1,131467,131467,131468,0,1,3
37462,2,1,131469,131469,131470,0,1,1
37463,1,1,131470,131470,131471,0,1,0
37464,1,2,131471,131471,131473,0,2,0
37465,3,3,131474,131474,131477,0,3,1
37466,4,1,131478,131478,131479,0,1,1
37467,1,2,131479,131479,131481,0,2,0
37468,5,2,131484,131484,131486,0,2,3
37469,6,1,131490,131490,131491,0,1,4
37470,1,2,131491,131491,131493,0,2,0
37471,2,3,131493,131493,131496,0,3,0
37472,3,1,131496,131496,131497,0,1,0
37473,3,1,131499,131499,131500,0,1,2
37474,5,2,131504,131504,131506,0,2,4
37475,5,1,131509,131509,131510,0,1,3
37476,1,2,131510,131510,131512,0,2,0
37477,5,2,131515,131515,131517,0,2,3
37478,2,1,131517,131517,131518,0,1,0
37479,1,3,131518,131518,131521,0,3,0
37480,5,3,131523,131523,131526,0,3,2
37481,1,3,131524,131526,131529,2,5,0
37482,2,1,131526,131529,131530,3,4,0
37483,6,3,131532,131532,131535,0,3,2
37484,6,1,131538,131538,131539,0,1,3
37485,2,1,131540,131540,131541,0,1,1
37486,3,1,131543,131543,131544,0,1,2
37487,1,3,131544,131544,131547,0,3,0
37488,5,1,131549,131549,131550,0,1,2
37489,4,2,131553,131553,131555,0,2,3
37490,5,2,131558,131558,131560,0,2,3
37491,6,2,131564,131564,131566,0,2,4
37492,5,1,131569,131569,131570,0,1,3
37493,5,3,131574,131574,131577,0,3,4
37494,5,2,131579,131579,131581,0,2,2
37495,3,3,131582,131582,131585,0,3,1
37496,4,2,131586,131586,131588,0,2,1
37497,3,3,131589,131589,131592,0,3,1
37498,3,2,131592,131592,131594,0,2,0
37499,4,3,131596,131596,131599,0,3,2
37500,3,1,131599,131599,131600,0,1,0
37501,5,2,131604,131604,131606,0,2,4
37502,4,2,131608,131608,131610,0,2,2
37503,4,1,131612,131612,131613,0,1,2
37504,5,2,131617,131617,131619,0,2,4
37505,3,2,131620,131620,131622,0,2,1
37506,4,1,131624,131624,131625,0,1,2
37507,2,2,131626,131626,131628,0,2,1
37508,2,3,131628,131628,131631,0,3,0
37509,4,2,131632,131632,131634,0,2,1
37510,4,2,131636,131636,131638,0,2,2
37511,2,2,131638,131638,131640,0,2,0
37512,6,3,131644,131644,131647,0,3,4
37513,2,1,131646,131647,131648,1,2,0
37514,3,1,131649,131649,131650,0,1,1
37515,3,2,131652,131652,131654,0,2,2
37516,1,3,131653,131654,131657,1,4,0
37517,3,3,131656,131657,131660,1,4,0
37518,4,3,131660,131660,131663,0,3,0
37519,3,3,131663,131663,131666,0,3,0
37520,5,3,131668,131668,131671,0,3,2
37521,4,3,131672,131672,131675,0,3,1
37522,2,1,131674,131675,131676,1,2,0
37523,2,2,131676,131676,131678,0,2,0
37524,2,2,131678,131678,131680,0,2,0
37525,3,3,131681,131681,131684,0,3,1
37526,5,3,131686,131686,131689,0,3,2
37527,3,1,131689,131689,131690,0,1,0
37528,3,2,131692,131692,131694,0,2,2
37529,3,3,131695,131695,131698,0,3,1
37530,1,1,131696,131698,131699,2,3,0
37531,4,1,131700,131700,131701,0,1,1
37532,1,2,131701,131701,131703,0,2,0
37533,1,3,131702,131703,131706,1,4,0
37534,1,3,131703,131706,131709,3,6,0
37535,1,1,131704,131709,131710,5,6,0
37536,2,3,131706,131710,131713,4,7,0
37537,2,2,131708,131713,131715,5,7,0
37538,2,3,131710,131715,131718,5,8,0
37539,1,1,131711,131718,131719,7,8,0
37540,3,2,131714,131719,131721,5,7,0
37541,1,2,131715,131721,131723,6,8,0
37542,4,1,131719,131723,131724,4,5,0
37543,4,2,131723,131724,131726,1,3,0
37544,6,1,131729,131729,131730,0,1,3
37545,1,3,131730,131730,131733,0,3,0
37546,6,2,131736,131736,131738,0,2,3
37547,3,3,131739,131739,131742,0,3,1
37548,6,2,131745,131745,131747,0,2,3
37549,2,3,131747,131747,131750,0,3,0
37550,5,3,131752,131752,131755,0,3,2
37551,4,2,131756,131756,131758,0,2,1
37552,4,1,131760,131760,131761,0,1,2
37553,3,1,131763,131763,131764,0,1,2
37554,2,1,131765,131765,131766,0,1,1
37555,1,3,131766,131766,131769,0,3,0
37556,2,3,131768,131769,131772,1,4,0
37557,6,2,131774,131774,131776,0,2,2
37558,3,3,131777,131777,131780,0,3,1
37559,5,1,131782,131782,131783,0,1,2
37560,5,1,131787,131787,131788,0,1,4
37561,2,3,131789,131789,131792,0,3,1
37562,5,3,131794,131794,131797,0,3,2
37563,6,3,131800,131800,131803,0,3,3
37564,2,1,131802,131803,131804,1,2,0
37565,3,3,131805,131805,131808,0,3,1
37566,3,1,131808,131808,131809,0,1,0
37567,2,1,131810,131810,131811,0,1,1
37568,6,3,131816,131816,131819,0,3,5
37569,6,1,131822,131822,131823,0,1,3
37570,3,3,131825,131825,131828,0,3,2
37571,6,3,131831,131831,131834,0,3,3
37572,6,1,131837,131837,131838,0,1,3
37573,2,2,131839,131839,131841,0,2,1
37574,2,2,131841,131841,131843,0,2,0
37575,5,1,131846,131846,131847,0,1,3
37576,3,1,131849,131849,131850,0,1,2
37577,2,2,131851,131851,131853,0,2,1
37578,5,3,131856,131856,131859,0,3,3
37579,2,2,131858,131859,131861,1,3,0
37580,5,3,131863,131863,131866,0,3,2
37581,1,1,131864,131866,131867,2,3,0
37582,1,2,131865,131867,131869,2,4,0
37583,4,2,131869,131869,131871,0,2,0
37584,3,3,131872,131872,131875,0,3,1
37585,2,3,131874,131875,131878,1,4,0
37586,3,2,131877,131878,131880,1,3,0
37587,4,1,131881,131881,131882,0,1,1
37588,1,1,131882,131882,131883,0,1,0
37589,6,2,131888,131888,131890,0,2,5
37590,2,3,131890,131890,131893,0,3,0
37591,3,2,131893,131893,131895,0,2,0
37592,2,3,131895,131895,131898,0,3,0
37593,1,1,131896,131898,131899,2,3,0
37594,2,3,131898,131899,131902,1,4,0
37595,1,1,131899,131902,131903,3,4,0
37596,4,2,131903,131903,131905,0,2,0
37597,5,2,131908,131908,131910,0,2,3
37598,4,2,131912,131912,131914,0,2,2
37599,1,1,131913,131914,131915,1,2,0
37600,4,2,131917,131917,131919,0,2,2
37601,3,1,131920,131920,131921,0,1,1
37602,3,1,131923,131923,131924,0,1,2
37603,1,2,131924,131924,131926,0,2,0
37604,2,2,131926,131926,131928,0,2,0
37605,4,2,131930,131930,131932,0,2,2
37606,2,2,131932,131932,131934,0,2,0
37607,3,2,131935,131935,131937,0,2,1
37608,5,3,131940,131940,131943,0,3,3
37609,4,1,131944,131944,131945,0,1,1
37610,5,3,131949,131949,131952,0,3,4
37611,3,3,131952,131952,131955,0,3,0
37612,1,3,131953,131955,131958,2,5,0
37613,6,1,131959,131959,131960,0,1,1
37614,1,3,131960,131960,131963,0,3,0
37615,5,3,131965,131965,131968,0,3,2
37616,4,2,131969,131969,131971,0,2,1
37617,3,2,131972,131972,131974,0,2,1
37618,4,1,131976,131976,131977,0,1,2
37619,3,3,131979,131979,131982,0,3,2
37620,1,3,131980,131982,131985,2,5,0
37621,6,2,131986,131986,131988,0,2,1
37622,1,2,131987,131988,131990,1,3,0
37623,4,2,131991,131991,131993,0,2,1
37624,2,1,131993,131993,131994,0,1,0
37625,6,1,131999,131999,132000,0,1,5
37626,6,3,132005,132005,132008,0,3,5
37627,5,1,132010,132010,132011,0,1,2
37628,6,2,132016,132016,132018,0,2,5
37629,4,3,132020,132020,132023,0,3,2
37630,3,2,132023,132023,132025,0,2,0
37631,5,1,132028,132028,132029,0,1,3
37632,5,3,132033,132033,132036,0,3,4
37633,6,3,132039,132039,132042,0,3,3
37634,1,3,132040,132042,132045,2,5,0
37635,2,2,132042,132045,132047,3,5,0
37636,6,1,132048,132048,132049,0,1,1
37637,4,2,132052,132052,132054,0,2,3
37638,3,1,132055,132055,132056,0,1,1
37639,3,1,132058,132058,132059,0,1,2
37640,6,2,132064,132064,132066,0,2,5
37641,6,2,132070,132070,132072,0,2,4
37642,1,1,132071,132072,132073,1,2,0
37643,2,2,132073,132073,132075,0,2,0
37644,1,2,132074,132075,132077,1,3,0
37645,4,2,132078,132078,132080,0,2,1
37646,3,2,132081,132081,132083,0,2,1
37647,6,2,132087,132087,132089,0,2,4
37648,2,1,132089,132089,132090,0,1,0
37649,5,3,132094,132094,132097,0,3,4
37650,2,1,132096,132097,132098,1,2,0
37651,6,3,132102,132102,132105,0,3,4
37652,4,2,132106,132106,132108,0,2,1
37653,1,3,132107,132108,132111,1,4,0
37654,2,3,132109,132111,132114,2,5,0
37655,2,2,132111,132114,132116,3,5,0
37656,1,1,132112,132116,132117,4,5,0
37657,1,2,132113,132117,132119,4,6,0
37658,2,3,132115,132119,132122,4,7,0
37659,2,1,132117,132122,132123,5,6,0
37660,1,3,132118,132123,132126,5,8,0
37661,6,3,132124,132126,132129,2,5,0
37662,3,3,132127,132129,132132,2,5,0
37663,5,1,132132,132132,132133,0,1,0
37664,1,3,132133,132133,132136,0,3,0
37665,1,2,132134,132136,132138,2,4,0
37666,6,2,132140,132140,132142,0,2,2
37667,6,3,132146,132146,132149,0,3,4
37668,3,1,132149,132149,132150,0,1,0
37669,3,2,132152,132152,132154,0,2,2
37670,1,2,132153,132154,132156,1,3,0
37671,5,2,132158,132158,132160,0,2,2
37672,2,2,132160,132160,132162,0,2,0
37673,5,2,132165,132165,132167,0,2,3
37674,6,1,132171,132171,132172,0,1,4
37675,2,3,132173,132173,132176,0,3,1
37676,5,1,132178,132178,132179,0,1,2
37677,4,1,132182,132182,132183,0,1,3
37678,2,1,132184,132184,132185,0,1,1
37679,5,2,132189,132189,132191,0,2,4
37680,6,3,132195,132195,132198,0,3,4
37681,6,1,132201,132201,132202,0,1,3
37682,6,3,132207,132207,132210,0,3,5
37683,2,2,132209,132210,132212,1,3,0
37684,1,3,132210,132212,132215,2,5,0
37685,3,2,132213,132215,132217,2,4,0
37686,4,1,132217,132217,132218,0,1,0
37687,5,3,132222,132222,132225,0,3,4
37688,3,3,132225,132225,132228,0,3,0
37689,4,1,132229,132229,132230,0,1,1
37690,3,1,132232,132232,132233,0,1,2
37691,1,3,132233,132233,132236,0,3,0
37692,4,1,132237,132237,132238,0,1,1
37693,4,2,132241,132241,132243,0,2,3
37694,5,3,132246,132246,132249,0,3,3
37695,3,3,132249,132249,132252,0,3,0
37696,2,1,132251,132252,132253,1,2,0
37697,5,3,132256,132256,132259,0,3,3
37698,4,2,132260,132260,132262,0,2,1
37699,3,2,132263,132263,132265,0,2,1
37700,4,1,132267,132267,132268,0,1,2
37701,5,3,132272,132272,132275,0,3,4
37702,3,1,132275,132275,132276,0,1,0
37703,6,3,132281,132281,132284,0,3,5
37704,1,2,132282,132284,132286,2,4,0
37705,1,2,132283,132286,132288,3,5,0
37706,6,1,132289,132289,132290,0,1,1
37707,5,1,132294,132294,132295,0,1,4
37708,2,3,132296,132296,132299,0,3,1
37709,1,2,132297,132299,132301,2,4,0
37710,1,2,132298,132301,132303,3,5,0
37711,1,3,132299,132303,132306,4,7,0
37712,3,2,132302,132306,132308,4,6,0
37713,3,1,132305,132308,132309,3,4,0
37714,6,3,132311,132311,132314,0,3,2
37715,6,1,132317,132317,132318,0,1,3
37716,1,1,132318,132318,132319,0,1,0
37717,4,2,132322,132322,132324,0,2,3
37718,4,3,132326,132326,132329,0,3,2
37719,3,1,132329,132329,132330,0,1,0
37720,1,1,132330,132330,132331,0,1,0
37721,5,1,132335,132335,132336,0,1,4
37722,2,3,132337,132337,132340,0,3,1
37723,6,2,132343,132343,132345,0,2,3
37724,4,1,132347,132347,132348,0,1,2
37725,2,1,132349,132349,132350,0,1,1
37726,2,3,132351,132351,132354,0,3,1
37727,4,1,132355,132355,132356,0,1,1
37728,6,3,132361,132361,132364,0,3,5
37729,1,3,132362,132364,132367,2,5,0
37730,3,2,132365,132367,132369,2,4,0
37731,1,1,132366,132369,132370,3,4,0
37732,4,3,132370,132370,132373,0,3,0
37733,5,3,132375,132375,132378,0,3,2
37734,3,1,132378,132378,132379,0,1,0
37735,1,2,132379,132379,132381,0,2,0
37736,5,3,132384,132384,132387,0,3,3
37737,1,1,132385,132387,132388,2,3,0
37738,2,1,132387,132388,132389,1,2,0
37739,4,3,132391,132391,132394,0,3,2
37740,3,3,132394,132394,132397,0,3,0
37741,1,1,132395,132397,132398,2,3,0
37742,5,1,132400,132400,132401,0,1,2
37743,3,1,132403,132403,132404,0,1,2
37744,4,1,132407,132407,132408,0,1,3
37745,4,1,132411,132411,132412,0,1,3
37746,1,2,132412,132412,132414,0,2,0
37747,5,1,132417,132417,132418,0,1,3
37748,2,2,132419,132419,132421,0,2,1
37749,5,1,132424,132424,132425,0,1,3
37750,6,2,132430,132430,132432,0,2,5
37751,1,3,132431,132432,132435,1,4,0
37752,3,3,132434,132435,132438,1,4,0
37753,1,2,132435,132438,132440,3,5,0
37754,2,2,132437,132440,132442,3,5,0
37755,3,2,132440,132442,132444,2,4,0
37756,2,2,132442,132444,132446,2,4,0
37757,3,1,132445,132446,132447,1,2,0
37758,2,1,132447,132447,132448,0,1,0
37759,2,3,132449,132449,132452,0,3,1
37760,1,2,132450,132452,132454,2,4,0
37761,1,2,132451,132454,132456,3,5,0
37762,6,2,132457,132457,132459,0,2,1
37763,2,3,132459,132459,132462,0,3,0
37764,1,1,132460,132462,132463,2,3,0
37765,6,2,132466,132466,132468,0,2,3
37766,4,2,132470,132470,132472,0,2,2
37767,5,2,132475,132475,132477,0,2,3
37768,5,1,132480,132480,132481,0,1,3
37769,4,1,132484,132484,132485,0,1,3
37770,2,2,132486,132486,132488,0,2,1
37771,4,3,132490,132490,132493,0,3,2
37772,6,3,132496,132496,132499,0,3,3
37773,6,1,132502,132502,132503,0,1,3
37774,1,3,132503,132503,132506,0,3,0
37775,1,3,132504,132506,132509,2,5,0
37776,5,1,132509,132509,132510,0,1,0
37777,2,3,132511,132511,132514,0,3,1
37778,6,3,132517,132517,132520,0,3,3
37779,2,2,132519,132520,132522,1,3,0
37780,5,2,132524,132524,132526,0,2,2
37781,5,1,132529,132529,132530,0,1,3
37782,5,3,132534,132534,132537,0,3,4
37783,5,1,132539,132539,132540,0,1,2
37784,2,3,132541,132541,132544,0,3,1
37785,1,3,132542,132544,132547,2,5,0
37786,4,1,132546,132547,132548,1,2,0
37787,5,3,132551,132551,132554,0,3,3
37788,6,3,132557,132557,132560,0,3,3
37789,2,3,132559,132560,132563,1,4,0
37790,3,2,132562,132563,132565,1,3,0
37791,5,2,132567,132567,132569,0,2,2
37792,2,3,132569,132569,132572,0,3,0
37793,4,1,132573,132573,132574,0,1,1
37794,6,3,132579,132579,132582,0,3,5
37795,5,3,132584,132584,132587,0,3,2
37796,3,1,132587,132587,132588,0,1,0
37797,2,3,132589,132589,132592,0,3,1
37798,6,1,132595,132595,132596,0,1,3
37799,6,1,132601,132601,132602,0,1,5
37800,5,2,132606,132606,132608,0,2,4
37801,3,1,132609,132609,132610,0,1,1
37802,5,2,132614,132614,132616,0,2,4
37803,5,2,132619,132619,132621,0,2,3
37804,1,2,132620,132621,132623,1,3,0
37805,1,1,132621,132623,132624,2,3,0
37806,3,2,132624,132624,132626,0,2,0
37807,3,1,132627,132627,132628,0,1,1
37808,5,1,132632,132632,132633,0,1,4
37809,6,3,132638,132638,132641,0,3,5
37810,2,1,132640,132641,132642,1,2,0
37811,1,1,132641,132642,132643,1,2,0
37812,2,1,132643,132643,132644,0,1,0
37813,1,1,132644,132644,132645,0,1,0
37814,6,2,132650,132650,132652,0,2,5
37815,1,2,132651,132652,132654,1,3,0
37816,4,2,132655,132655,132657,0,2,1
37817,4,2,132659,132659,132661,0,2,2
37818,3,2,132662,132662,132664,0,2,1
37819,5,2,132667,132667,132669,0,2,3
37820,6,3,132673,132673,132676,0,3,4
37821,4,2,132677,132677,132679,0,2,1
37822,6,3,132683,132683,132686,0,3,4
37823,3,3,132686,132686,132689,0,3,0
37824,3,1,132689,132689,132690,0,1,0
37825,5,1,132694,132694,132695,0,1,4
37826,5,3,132699,132699,132702,0,3,4
37827,3,2,132702,132702,132704,0,2,0
37828,5,1,132707,132707,132708,0,1,3
37829,2,1,132709,132709,132710,0,1,1
37830,4,1,132713,132713,132714,0,1,3
37831,3,2,132716,132716,132718,0,2,2
37832,3,2,132719,132719,132721,0,2,1
37833,1,3,132720,132721,132724,1,4,0
37834,1,1,132721,132724,132725,3,4,0
37835,6,1,132727,132727,132728,0,1,2
37836,4,1,132731,132731,132732,0,1,3
37837,3,2,132734,132734,132736,0,2,2
37838,3,1,132737,132737,132738,0,1,1
37839,3,2,132740,132740,132742,0,2,2
37840,5,1,132745,132745,132746,0,1,3
37841,4,2,132749,132749,132751,0,2,3
37842,3,3,132752,132752,132755,0,3,1
37843,6,2,132758,132758,132760,0,2,3
37844,6,3,132764,132764,132767,0,3,4
37845,3,3,132767,132767,132770,0,3,0
37846,1,1,132768,132770,132771,2,3,0
37847,4,2,132772,132772,132774,0,2,1
37848,6,2,132778,132778,132780,0,2,4
37849,5,1,132783,132783,132784,0,1,3
37850,5,1,132788,132788,132789,0,1,4
37851,2,3,132790,132790,132793,0,3,1
37852,5,1,132795,132795,132796,0,1,2
37853,6,3,132801,132801,132804,0,3,5
37854,4,2,132805,132805,132807,0,2,1
37855,1,3,132806,132807,132810,1,4,0
37856,4,2,132810,132810,132812,0,2,0
37857,3,3,132813,132813,132816,0,3,1
37858,3,1,132816,132816,132817,0,1,0
37859,6,3,132822,132822,132825,0,3,5
37860,6,1,132828,132828,132829,0,1,3
37861,2,3,132830,132830,132833,0,3,1
37862,5,2,132835,132835,132837,0,2,2
37863,1,1,132836,132837,132838,1,2,0
37864,5,3,132841,132841,132844,0,3,3
37865,5,2,132846,132846,132848,0,2,2
37866,2,1,132848,132848,132849,0,1,0
37867,3,1,132851,132851,132852,0,1,2
37868,6,1,132857,132857,132858,0,1,5
37869,3,1,132860,132860,132861,0,1,2
37870,1,1,132861,132861,132862,0,1,0
37871,5,2,132866,132866,132868,0,2,4
37872,2,1,132868,132868,132869,0,1,0
37873,3,1,132871,132871,132872,0,1,2
37874,4,1,132875,132875,132876,0,1,3
37875,1,3,132876,132876,132879,0,3,0
37876,1,1,132877,132879,132880,2,3,0
37877,5,2,132882,132882,132884,0,2,2
37878,3,2,132885,132885,132887,0,2,1
37879,4,1,132889,132889,132890,0,1,2
37880,6,3,132895,132895,132898,0,3,5
37881,5,3,132900,132900,132903,0,3,2
37882,4,2,132904,132904,132906,0,2,1
37883,6,3,132910,132910,132913,0,3,4
37884,2,3,132912,132913,132916,1,4,0
37885,5,2,132917,132917,132919,0,2,1
37886,3,3,132920,132920,132923,0,3,1
37887,4,2,132924,132924,132926,0,2,1
37888,4,2,132928,132928,132930,0,2,2
37889,4,1,132932,132932,132933,0,1,2
37890,6,2,132938,132938,132940,0,2,5
37891,6,2,132944,132944,132946,0,2,4
37892,4,1,132948,132948,132949,0,1,2
37893,1,2,132949,132949,132951,0,2,0
37894,2,1,132951,132951,132952,0,1,0
37895,2,3,132953,132953,132956,0,3,1
37896,1,1,132954,132956,132957,2,3,0
37897,2,1,132956,132957,132958,1,2,0
37898,4,3,132960,132960,132963,0,3,2
37899,5,1,132965,132965,132966,0,1,2
37900,6,3,132971,132971,132974,0,3,5
37901,4,1,132975,132975,132976,0,1,1
37902,3,1,132978,132978,132979,0,1,2
37903,5,1,132983,132983,132984,0,1,4
37904,2,2,132985,132985,132987,0,2,1
37905,4,1,132989,132989,132990,0,1,2
37906,6,2,132995,132995,132997,0,2,5
37907,2,2,132997,132997,132999,0,2,0
37908,5,3,133002,133002,133005,0,3,3
37909,6,3,133008,133008,133011,0,3,3
37910,4,2,133012,133012,133014,0,2,1
37911,5,3,133017,133017,133020,0,3,3
37912,5,3,133022,133022,133025,0,3,2
37913,5,2,133027,133027,133029,0,2,2
37914,4,1,133031,133031,133032,0,1,2
37915,5,1,133036,133036,133037,0,1,4
37916,2,1,133038,133038,133039,0,1,1
37917,6,3,133044,133044,133047,0,3,5
37918,4,2,133048,133048,133050,0,2,1
37919,1,2,133049,133050,133052,1,3,0
37920,6,3,133055,133055,133058,0,3,3
37921,6,1,133061,133061,133062,0,1,3
37922,2,2,133063,133063,133065,0,2,1
37923,2,2,133065,133065,133067,0,2,0
37924,3,3,133068,133068,133071,0,3,1
37925,2,1,133070,133071,133072,1,2,0
37926,5,3,133075,133075,133078,0,3,3
37927,3,1,133078,133078,133079,0,1,0
37928,2,1,133080,133080,133081,0,1,1
37929,4,3,133084,133084,133087,0,3,3
37930,1,3,133085,133087,133090,2,5,0
37931,4,2,133089,133090,133092,1,3,0
37932,2,3,133091,133092,133095,1,4,0
37933,5,3,133096,133096,133099,0,3,1
37934,1,2,133097,133099,133101,2,4,0
37935,6,2,133103,133103,133105,0,2,2
37936,5,3,133108,133108,133111,0,3,3
37937,3,2,133111,133111,133113,0,2,0
37938,2,3,133113,133113,133116,0,3,0
37939,6,1,133119,133119,133120,0,1,3
37940,1,1,133120,133120,133121,0,1,0
37941,2,2,133122,133122,133124,0,2,1
37942,4,1,133126,133126,133127,0,1,2
37943,5,2,133131,133131,133133,0,2,4
37944,6,1,133137,133137,133138,0,1,4
37945,2,3,133139,133139,133142,0,3,1
37946,5,1,133144,133144,133145,0,1,2
37947,3,2,133147,133147,133149,0,2,2
37948,6,2,133153,133153,133155,0,2,4
37949,2,2,133155,133155,133157,0,2,0
37950,5,1,133160,133160,133161,0,1,3
37951,6,1,133166,133166,133167,0,1,5
37952,3,2,133169,133169,133171,0,2,2
37953,5,2,133174,133174,133176,0,2,3
37954,4,2,133178,133178,133180,0,2,2
37955,5,1,133183,133183,133184,0,1,3
37956,2,1,133185,133185,133186,0,1,1
37957,6,3,133191,133191,133194,0,3,5
37958,6,2,133197,133197,133199,0,2,3
37959,4,1,133201,133201,133202,0,1,2
37960,6,1,133207,133207,133208,0,1,5
37961,1,1,133208,133208,133209,0,1,0
37962,6,2,133214,133214,133216,0,2,5
37963,2,2,133216,133216,133218,0,2,0
37964,3,3,133219,133219,133222,0,3,1
37965,5,1,133224,133224,133225,0,1,2
37966,3,2,133227,133227,133229,0,2,2
37967,1,3,133228,133229,133232,1,4,0
37968,1,3,133229,133232,133235,3,6,0
37969,4,3,133233,133235,133238,2,5,0
37970,6,1,133239,133239,133240,0,1,1
37971,1,3,133240,133240,133243,0,3,0
37972,3,2,133243,133243,133245,0,2,0
37973,4,1,133247,133247,133248,0,1,2
37974,5,3,133252,133252,133255,0,3,4
37975,1,2,133253,133255,133257,2,4,0
37976,2,3,133255,133257,133260,2,5,0
37977,1,2,133256,133260,133262,4,6,0
37978,6,3,133262,133262,133265,0,3,0
37979,4,1,133266,133266,133267,0,1,1
37980,1,2,133267,133267,133269,0,2,0
37981,3,1,133270,133270,133271,0,1,1
37982,2,2,133272,133272,133274,0,2,1
37983,5,1,133277,133277,133278,0,1,3
37984,2,1,133279,133279,133280,0,1,1
37985,1,3,133280,133280,133283,0,3,0
37986,4,2,133284,133284,133286,0,2,1
37987,1,2,133285,133286,133288,1,3,0
37988,4,2,133289,133289,133291,0,2,1
37989,3,2,133292,133292,133294,0,2,1
37990,2,1,133294,133294,133295,0,1,0
37991,1,3,133295,133295,133298,0,3,0
37992,3,2,133298,133298,133300,0,2,0
37993,5,3,133303,133303,133306,0,3,3
37994,2,3,133305,133306,133309,1,4,0
37995,6,2,133311,133311,133313,0,2,2
37996,6,3,133317,133317,133320,0,3,4
37997,2,1,133319,133320,133321,1,2,0
37998,5,1,133324,133324,133325,0,1,3
37999,5,3,133329,133329,133332,0,3,4
38000,5,2,133334,133334,133336,0,2,2
38001,6,3,133340,133340,133343,0,3,4
38002,3,2,133343,133343,133345,0,2,0
38003,3,2,133346,133346,133348,0,2,1
38004,6,3,133352,133352,133355,0,3,4
38005,6,1,133358,133358,133359,0,1,3
38006,5,3,133363,133363,133366,0,3,4
38007,5,1,133368,133368,133369,0,1,2
38008,1,1,133369,133369,133370,0,1,0
38009,6,1,133375,133375,133376,0,1,5
38010,1,1,133376,133376,133377,0,1,0
38011,1,2,133377,133377,133379,0,2,0
38012,6,1,133383,133383,133384,0,1,4
38013,4,3,133387,133387,133390,0,3,3
38014,5,1,133392,133392,133393,0,1,2
38015,5,1,133397,133397,133398,0,1,4
38016,2,3,133399,133399,133402,0,3,1
38017,4,1,133403,133403,133404,0,1,1
38018,2,1,133405,133405,133406,0,1,1
38019,3,3,133408,133408,133411,0,3,2
38020,4,3,133412,133412,133415,0,3,1
38021,6,3,133418,133418,133421,0,3,3
38022,3,3,133421,133421,133424,0,3,0
38023,2,3,133423,133424,133427,1,4,0
38024,6,3,133429,133429,133432,0,3,2
38025,4,2,133433,133433,133435,0,2,1
38026,4,3,133437,133437,133440,0,3,2
38027,4,3,133441,133441,133444,0,3,1
38028,5,3,133446,133446,133449,0,3,2
38029,4,3,133450,133450,133453,0,3,1
38030,1,1,133451,133453,133454,2,3,0
38031,4,1,133455,133455,133456,0,1,1
38032,1,2,133456,133456,133458,0,2,0
38033,5,3,133461,133461,133464,0,3,3
38034,5,2,133466,133466,133468,0,2,2
38035,5,2,133471,133471,133473,0,2,3
38036,6,3,133477,133477,133480,0,3,4
38037,6,3,133483,133483,133486,0,3,3
38038,6,1,133489,133489,133490,0,1,3
38039,2,1,133491,133491,133492,0,1,1
38040,1,1,133492,133492,133493,0,1,0
38041,2,1,133494,133494,133495,0,1,1
38042,3,3,133497,133497,133500,0,3,2
38043,1,2,133498,133500,133502,2,4,0
38044,4,3,133502,133502,133505,0,3,0
38045,2,2,133504,133505,133507,1,3,0
38046,5,2,133509,133509,133511,0,2,2
38047,2,1,133511,133511,133512,0,1,0
38048,6,3,133517,133517,133520,0,3,5
38049,5,1,133522,133522,133523,0,1,2
38050,6,1,133528,133528,133529,0,1,5
38051,1,1,133529,133529,133530,0,1,0
38052,3,1,133532,133532,133533,0,1,2
38053,3,3,133535,133535,133538,0,3,2
38054,5,1,133540,133540,133541,0,1,2
38055,2,1,133542,133542,133543,0,1,1
38056,4,3,133546,133546,133549,0,3,3
38057,5,1,133551,133551,133552,0,1,2
38058,4,1,133555,133555,133556,0,1,3
38059,6,1,133561,133561,133562,0,1,5
38060,1,2,133562,133562,133564,0,2,0
38061,1,3,133563,133564,133567,1,4,0
38062,5,3,133568,133568,133571,0,3,1
38063,3,1,133571,133571,133572,0,1,0
38064,2,1,133573,133573,133574,0,1,1
38065,1,2,133574,133574,133576,0,2,0
38066,5,3,133579,133579,133582,0,3,3
38067,4,1,133583,133583,133584,0,1,1
38068,6,3,133589,133589,133592,0,3,5
38069,3,1,133592,133592,133593,0,1,0
38070,3,3,133595,133595,133598,0,3,2
38071,1,3,133596,133598,133601,2,5,0
38072,2,2,133598,133601,133603,3,5,0
38073,1,3,133599,133603,133606,4,7,0
38074,4,3,133603,133606,133609,3,6,0
38075,2,1,133605,133609,133610,4,5,0
38076,6,1,133611,133611,133612,0,1,1
38077,6,3,133617,133617,133620,0,3,5
38078,5,3,133622,133622,133625,0,3,2
38079,2,3,133624,133625,133628,1,4,0
38080,2,2,133626,133628,133630,2,4,0
38081,3,3,133629,133630,133633,1,4,0
38082,2,1,133631,133633,133634,2,3,0
38083,6,3,133637,133637,133640,0,3,3
38084,3,3,133640,133640,133643,0,3,0
38085,4,3,133644,133644,133647,0,3,1
38086,6,2,133650,133650,133652,0,2,3
38087,6,3,133656,133656,133659,0,3,4
38088,2,3,133658,133659,133662,1,4,0
38089,4,1,133662,133662,133663,0,1,0
38090,6,2,133668,133668,133670,0,2,5
38091,5,1,133673,133673,133674,0,1,3
38092,6,3,133679,133679,133682,0,3,5
38093,2,3,133681,133682,133685,1,4,0
38094,5,1,133686,133686,133687,0,1,1
38095,1,2,133687,133687,133689,0,2,0
38096,5,1,133692,133692,133693,0,1,3
38097,2,2,133694,133694,133696,0,2,1
38098,2,1,133696,133696,133697,0,1,0
38099,2,1,133698,133698,133699,0,1,1
38100,3,1,133701,133701,133702,0,1,2
38101,4,2,133705,133705,133707,0,2,3
38102,2,3,133707,133707,133710,0,3,0
38103,4,2,133711,133711,133713,0,2,1
38104,6,3,133717,133717,133720,0,3,4
38105,6,3,133723,133723,133726,0,3,3
38106,5,3,133728,133728,133731,0,3,2
38107,1,1,133729,133731,133732,2,3,0
38108,5,1,133734,133734,133735,0,1,2
38109,6,1,133740,133740,133741,0,1,5
38110,5,3,133745,133745,133748,0,3,4
38111,2,1,133747,133748,133749,1,2,0
38112,2,2,133749,133749,133751,0,2,0
38113,2,1,133751,133751,133752,0,1,0
38114,5,1,133756,133756,133757,0,1,4
38115,2,1,133758,133758,133759,0,1,1
38116,2,2,133760,133760,133762,0,2,1
38117,3,3,133763,133763,133766,0,3,1
38118,3,2,133766,133766,133768,0,2,0
38119,1,1,133767,133768,133769,1,2,0
38120,5,1,133772,133772,133773,0,1,3
38121,3,2,133775,133775,133777,0,2,2
38122,6,3,133781,133781,133784,0,3,4
38123,4,1,133785,133785,133786,0,1,1
38124,2,1,133787,133787,133788,0,1,1
38125,2,1,133789,133789,133790,0,1,1
38126,3,3,133792,133792,133795,0,3,2
38127,5,1,133797,133797,133798,0,1,2
38128,3,2,133800,133800,133802,0,2,2
38129,6,1,133806,133806,133807,0,1,4
38130,2,3,133808,133808,133811,0,3,1
38131,5,3,133813,133813,133816,0,3,2
38132,4,2,133817,133817,133819,0,2,1
38133,1,1,133818,133819,133820,1,2,0
38134,6,3,133824,133824,133827,0,3,4
38135,2,1,133826,133827,133828,1,2,0
38136,4,2,133830,133830,133832,0,2,2
38137,5,3,133835,133835,133838,0,3,3
38138,3,3,133838,133838,133841,0,3,0
38139,2,1,133840,133841,133842,1,2,0
38140,2,2,133842,133842,133844,0,2,0
38141,2,3,133844,133844,133847,0,3,0
38142,6,3,133850,133850,133853,0,3,3
38143,5,1,133855,133855,133856,0,1,2
38144,6,3,133861,133861,133864,0,3,5
38145,1,1,133862,133864,133865,2,3,0
38146,3,2,133865,133865,133867,0,2,0
38147,1,2,133866,133867,133869,1,3,0
38148,6,3,133872,133872,133875,0,3,3
38149,5,3,133877,133877,133880,0,3,2
38150,2,1,133879,133880,133881,1,2,0
38151,2,2,133881,133881,133883,0,2,0
38152,6,3,133887,133887,133890,0,3,4
38153,3,1,133890,133890,133891,0,1,0
38154,5,2,133895,133895,133897,0,2,4
38155,6,3,133901,133901,133904,0,3,4
38156,2,1,133903,133904,133905,1,2,0
38157,1,3,133904,133905,133908,1,4,0
38158,2,1,133906,133908,133909,2,3,0
38159,6,3,133912,133912,133915,0,3,3
38160,3,3,133915,133915,133918,0,3,0
38161,6,3,133921,133921,133924,0,3,3
38162,6,1,133927,133927,133928,0,1,3
38163,5,3,133932,133932,133935,0,3,4
38164,4,2,133936,133936,133938,0,2,1
38165,1,1,133937,133938,133939,1,2,0
38166,2,3,133939,133939,133942,0,3,0
38167,2,1,133941,133942,133943,1,2,0
38168,2,1,133943,133943,133944,0,1,0
38169,4,3,133947,133947,133950,0,3,3
38170,6,2,133953,133953,133955,0,2,3
38171,5,1,133958,133958,133959,0,1,3
38172,6,2,133964,133964,133966,0,2,5
38173,2,3,133966,133966,133969,0,3,0
38174,5,1,133971,133971,133972,0,1,2
38175,3,2,133974,133974,133976,0,2,2
38176,6,2,133980,133980,133982,0,2,4
38177,1,2,133981,133982,133984,1,3,0
38178,5,3,133986,133986,133989,0,3,2
38179,2,2,133988,133989,133991,1,3,0
38180,1,1,133989,133991,133992,2,3,0
38181,1,2,133990,133992,133994,2,4,0
38182,4,3,133994,133994,133997,0,3,0
38183,6,1,134000,134000,134001,0,1,3
38184,2,2,134002,134002,134004,0,2,1
38185,4,1,134006,134006,134007,0,1,2
38186,3,1,134009,134009,134010,0,1,2
38187,6,1,134015,134015,134016,0,1,5
38188,3,1,134018,134018,134019,0,1,2
38189,1,3,134019,134019,134022,0,3,0
38190,6,1,134025,134025,134026,0,1,3
38191,5,1,134030,134030,134031,0,1,4
38192,3,2,134033,134033,134035,0,2,2
38193,1,2,134034,134035,134037,1,3,0
38194,5,1,134039,134039,134040,0,1,2
38195,1,2,134040,134040,134042,0,2,0
38196,5,1,134045,134045,134046,0,1,3
38197,1,2,134046,134046,134048,0,2,0
38198,6,3,134052,134052,134055,0,3,4
38199,3,3,134055,134055,134058,0,3,0
38200,1,2,134056,134058,134060,2,4,0
38201,2,1,134058,134060,134061,2,3,0
38202,4,3,134062,134062,134065,0,3,1
38203,1,1,134063,134065,134066,2,3,0
38204,2,3,134065,134066,134069,1,4,0
38205,2,2,134067,134069,134071,2,4,0
38206,6,2,134073,134073,134075,0,2,2
38207,3,2,134076,134076,134078,0,2,1
38208,4,3,134080,134080,134083,0,3,2
38209,4,3,134084,134084,134087,0,3,1
38210,3,1,134087,134087,134088,0,1,0
38211,3,3,134090,134090,134093,0,3,2
38212,2,3,134092,134093,134096,1,4,0
38213,3,1,134095,134096,134097,1,2,0
38214,1,3,134096,134097,134100,1,4,0
38215,1,2,134097,134100,134102,3,5,0
38216,1,2,134098,134102,134104,4,6,0
38217,5,1,134103,134104,134105,1,2,0
38218,3,3,134106,134106,134109,0,3,1
38219,6,2,134112,134112,134114,0,2,3
38220,3,3,134115,134115,134118,0,3,1
38221,1,1,134116,134118,134119,2,3,0
38222,2,3,134118,134119,134122,1,4,0
38223,5,2,134123,134123,134125,0,2,1
38224,2,1,134125,134125,134126,0,1,0
38225,5,1,134130,134130,134131,0,1,4
38226,2,2,134132,134132,134134,0,2,1
38227,6,3,134138,134138,134141,0,3,4
38228,6,2,134144,134144,134146,0,2,3
38229,5,1,134149,134149,134150,0,1,3
38230,5,3,134154,134154,134157,0,3,4
38231,1,3,134155,134157,134160,2,5,0
38232,2,3,134157,134160,134163,3,6,0
38233,3,3,134160,134163,134166,3,6,0
38234,5,1,134165,134166,134167,1,2,0
38235,5,2,134170,134170,134172,0,2,3
38236,2,1,134172,134172,134173,0,1,0
38237,2,2,134174,134174,134176,0,2,1
38238,1,2,134175,134176,134178,1,3,0
38239,5,3,134180,134180,134183,0,3,2
38240,6,1,134186,134186,134187,0,1,3
38241,5,3,134191,134191,134194,0,3,4
38242,3,3,134194,134194,134197,0,3,0
38243,4,2,134198,134198,134200,0,2,1
38244,2,3,134200,134200,134203,0,3,0
38245,4,2,134204,134204,134206,0,2,1
38246,2,3,134206,134206,134209,0,3,0
38247,6,1,134212,134212,134213,0,1,3
38248,4,1,134216,134216,134217,0,1,3
38249,6,2,134222,134222,134224,0,2,5
38250,4,2,134226,134226,134228,0,2,2
38251,4,2,134230,134230,134232,0,2,2
38252,5,2,134235,134235,134237,0,2,3
38253,1,2,134236,134237,134239,1,3,0
38254,1,2,134237,134239,134241,2,4,0
38255,3,2,134240,134241,134243,1,3,0
38256,1,2,134241,134243,134245,2,4,0
38257,1,3,134242,134245,134248,3,6,0
38258,2,1,134244,134248,134249,4,5,0
38259,3,3,134247,134249,134252,2,5,0
38260,2,1,134249,134252,134253,3,4,0
38261,1,1,134250,134253,134254,3,4,0
38262,5,2,134255,134255,134257,0,2,1
38263,6,2,134261,134261,134263,0,2,4
38264,1,3,134262,134263,134266,1,4,0
38265,6,3,134268,134268,134271,0,3,2
38266,2,3,134270,134271,134274,1,4,0
38267,5,1,134275,134275,134276,0,1,1
38268,3,1,134278,134278,134279,0,1,2
38269,4,1,134282,134282,134283,0,1,3
38270,5,2,134287,134287,134289,0,2,4
38271,1,3,134288,134289,134292,1,4,0
38272,4,1,134292,134292,134293,0,1,0
38273,2,3,134294,134294,134297,0,3,1
38274,3,2,134297,134297,134299,0,2,0
38275,2,3,134299,134299,134302,0,3,0
38276,1,1,134300,134302,134303,2,3,0
38277,6,1,134306,134306,134307,0,1,3
38278,4,1,134310,134310,134311,0,1,3
38279,2,3,134312,134312,134315,0,3,1
38280,3,2,134315,134315,134317,0,2,0
38281,4,3,134319,134319,134322,0,3,2
38282,2,1,134321,134322,134323,1,2,0
38283,2,3,134323,134323,134326,0,3,0
38284,5,3,134328,134328,134331,0,3,2
38285,2,3,134330,134331,134334,1,4,0
38286,6,1,134336,134336,134337,0,1,2
38287,6,2,134342,134342,134344,0,2,5
38288,5,3,134347,134347,134350,0,3,3
38289,3,2,134350,134350,134352,0,2,0
38290,5,3,134355,134355,134358,0,3,3
38291,1,1,134356,134358,134359,2,3,0
38292,6,2,134362,134362,134364,0,2,3
38293,4,1,134366,134366,134367,0,1,2
38294,6,2,134372,134372,134374,0,2,5
38295,5,2,134377,134377,134379,0,2,3
38296,1,1,134378,134379,134380,1,2,0
38297,6,2,134384,134384,134386,0,2,4
38298,5,2,134389,134389,134391,0,2,3
38299,4,2,134393,134393,134395,0,2,2
38300,5,2,134398,134398,134400,0,2,3
38301,2,3,134400,134400,134403,0,3,0
38302,4,1,134404,134404,134405,0,1,1
38303,1,1,134405,134405,134406,0,1,0
38304,6,1,134411,134411,134412,0,1,5
38305,6,2,134417,134417,134419,0,2,5
38306,2,2,134419,134419,134421,0,2,0
38307,2,3,134421,134421,134424,0,3,0
38308,6,1,134427,134427,134428,0,1,3
38309,4,1,134431,134431,134432,0,1,3
38310,3,2,134434,134434,134436,0,2,2
38311,3,2,134437,134437,134439,0,2,1
38312,5,1,134442,134442,134443,0,1,3
38313,4,2,134446,134446,134448,0,2,3
38314,6,2,134452,134452,134454,0,2,4
38315,2,2,134454,134454,134456,0,2,0
38316,3,2,134457,134457,134459,0,2,1
38317,1,1,134458,134459,134460,1,2,0
38318,6,2,134464,134464,134466,0,2,4
38319,6,1,134470,134470,134471,0,1,4
38320,3,3,134473,134473,134476,0,3,2
38321,5,2,134478,134478,134480,0,2,2
38322,3,2,134481,134481,134483,0,2,1
38323,3,3,134484,134484,134487,0,3,1
38324,2,2,134486,134487,134489,1,3,0
38325,4,1,134490,134490,134491,0,1,1
38326,6,2,134496,134496,134498,0,2,5
38327,6,3,134502,134502,134505,0,3,4
38328,3,1,134505,134505,134506,0,1,0
38329,1,1,134506,134506,134507,0,1,0
38330,4,1,134510,134510,134511,0,1,3
38331,1,2,134511,134511,134513,0,2,0
38332,5,1,134516,134516,134517,0,1,3
38333,6,1,134522,134522,134523,0,1,5
38334,4,1,134526,134526,134527,0,1,3
38335,1,2,134527,134527,134529,0,2,0
38336,4,2,134531,134531,134533,0,2,2
38337,4,1,134535,134535,134536,0,1,2
38338,2,1,134537,134537,134538,0,1,1
38339,1,2,134538,134538,134540,0,2,0
38340,6,2,134544,134544,134546,0,2,4
38341,4,1,134548,134548,134549,0,1,2
38342,2,1,134550,134550,134551,0,1,1
38343,3,3,134553,134553,134556,0,3,2
38344,3,2,134556,134556,134558,0,2,0
38345,6,3,134562,134562,134565,0,3,4
38346,1,1,134563,134565,134566,2,3,0
38347,6,2,134569,134569,134571,0,2,3
38348,6,1,134575,134575,134576,0,1,4
38349,3,2,134578,134578,134580,0,2,2
38350,2,1,134580,134580,134581,0,1,0
38351,3,2,134583,134583,134585,0,2,2
38352,1,3,134584,134585,134588,1,4,0
38353,5,2,134589,134589,134591,0,2,1
38354,5,3,134594,134594,134597,0,3,3
38355,4,1,134598,134598,134599,0,1,1
38356,5,1,134603,134603,134604,0,1,4
38357,4,3,134607,134607,134610,0,3,3
38358,5,1,134612,134612,134613,0,1,2
38359,6,1,134618,134618,134619,0,1,5
38360,3,1,134621,134621,134622,0,1,2
38361,3,1,134624,134624,134625,0,1,2
38362,6,3,134630,134630,134633,0,3,5
38363,6,2,134636,134636,134638,0,2,3
38364,3,2,134639,134639,134641,0,2,1
38365,3,3,134642,134642,134645,0,3,1
38366,2,2,134644,134645,134647,1,3,0
38367,3,3,134647,134647,134650,0,3,0
38368,5,1,134652,134652,134653,0,1,2
38369,3,1,134655,134655,134656,0,1,2
38370,4,2,134659,134659,134661,0,2,3
38371,4,1,134663,134663,134664,0,1,2
38372,4,2,134667,134667,134669,0,2,3
38373,6,2,134673,134673,134675,0,2,4
38374,3,2,134676,134676,134678,0,2,1
38375,4,3,134680,134680,134683,0,3,2
38376,4,3,134684,134684,134687,0,3,1
38377,5,2,134689,134689,134691,0,2,2
38378,3,1,134692,134692,134693,0,1,1
38379,5,1,134697,134697,134698,0,1,4
38380,2,2,134699,134699,134701,0,2,1
38381,3,2,134702,134702,134704,0,2,1
38382,6,3,134708,134708,134711,0,3,4
38383,5,3,134713,134713,134716,0,3,2
38384,5,3,134718,134718,134721,0,3,2
38385,5,2,134723,134723,134725,0,2,2
38386,3,2,134726,134726,134728,0,2,1
38387,3,2,134729,134729,134731,0,2,1
38388,1,2,134730,134731,134733,1,3,0
38389,5,3,134735,134735,134738,0,3,2
38390,6,1,134741,134741,134742,0,1,3
38391,1,2,134742,134742,134744,0,2,0
38392,1,3,134743,134744,134747,1,4,0
38393,1,2,134744,134747,134749,3,5,0
38394,2,1,134746,134749,134750,3,4,0
38395,2,2,134748,134750,134752,2,4,0
38396,4,3,134752,134752,134755,0,3,0
38397,1,2,134753,134755,134757,2,4,0
38398,6,1,134759,134759,134760,0,1,2
38399,4,3,134763,134763,134766,0,3,3
38400,1,2,134764,134766,134768,2,4,0
38401,5,1,134769,134769,134770,0,1,1
38402,6,2,134775,134775,134777,0,2,5
38403,6,2,134781,134781,134783,0,2,4
38404,6,1,134787,134787,134788,0,1,4
38405,1,3,134788,134788,134791,0,3,0
38406,3,2,134791,134791,134793,0,2,0
38407,6,3,134797,134797,134800,0,3,4
38408,6,2,134803,134803,134805,0,2,3
38409,5,3,134808,134808,134811,0,3,3
38410,3,1,134811,134811,134812,0,1,0
38411,1,1,134812,134812,134813,0,1,0
38412,5,1,134817,134817,134818,0,1,4
38413,3,3,134820,134820,134823,0,3,2
38414,3,2,134823,134823,134825,0,2,0
38415,3,1,134826,134826,134827,0,1,1
38416,4,2,134830,134830,134832,0,2,3
38417,2,1,134832,134832,134833,0,1,0
38418,3,2,134835,134835,134837,0,2,2
38419,3,1,134838,134838,134839,0,1,1
38420,3,3,134841,134841,134844,0,3,2
38421,3,3,134844,134844,134847,0,3,0
38422,4,1,134848,134848,134849,0,1,1
38423,2,2,134850,134850,134852,0,2,1
38424,2,1,134852,134852,134853,0,1,0
38425,2,3,134854,134854,134857,0,3,1
38426,3,2,134857,134857,134859,0,2,0
38427,4,3,134861,134861,134864,0,3,2
38428,4,3,134865,134865,134868,0,3,1
38429,5,1,134870,134870,134871,0,1,2
38430,1,2,134871,134871,134873,0,2,0
38431,1,3,134872,134873,134876,1,4,0
38432,6,3,134878,134878,134881,0,3,2
38433,3,1,134881,134881,134882,0,1,0
38434,6,3,134887,134887,134890,0,3,5
38435,6,2,134893,134893,134895,0,2,3
38436,4,2,134897,134897,134899,0,2,2
38437,4,3,134901,134901,134904,0,3,2
38438,5,3,134906,134906,134909,0,3,2
38439,3,3,134909,134909,134912,0,3,0
38440,1,1,134910,134912,134913,2,3,0
38441,3,3,134913,134913,134916,0,3,0
38442,5,1,134918,134918,134919,0,1,2
38443,2,3,134920,134920,134923,0,3,1
38444,3,3,134923,134923,134926,0,3,0
38445,6,3,134929,134929,134932,0,3,3
38446,5,1,134934,134934,134935,0,1,2
38447,3,2,134937,134937,134939,0,2,2
38448,1,3,134938,134939,134942,1,4,0
38449,5,2,134943,134943,134945,0,2,1
38450,2,1,134945,134945,134946,0,1,0
38451,4,1,134949,134949,134950,0,1,3
38452,6,1,134955,134955,134956,0,1,5
38453,5,3,134960,134960,134963,0,3,4
38454,3,3,134963,134963,134966,0,3,0
38455,5,2,134968,134968,134970,0,2,2
38456,6,1,134974,134974,134975,0,1,4
38457,1,3,134975,134975,134978,0,3,0
38458,1,3,134976,134978,134981,2,5,0
38459,6,3,134982,134982,134985,0,3,1
38460,6,2,134988,134988,134990,0,2,3
38461,6,1,134994,134994,134995,0,1,4
38462,5,2,134999,134999,135001,0,2,4
38463,4,2,135003,135003,135005,0,2,2
38464,1,1,135004,135005,135006,1,2,0
38465,1,2,135005,135006,135008,1,3,0
38466,6,3,135011,135011,135014,0,3,3
38467,2,2,135013,135014,135016,1,3,0
38468,6,3,135019,135019,135022,0,3,3
38469,5,3,135024,135024,135027,0,3,2
38470,1,2,135025,135027,135029,2,4,0
38471,1,1,135026,135029,135030,3,4,0
38472,4,3,135030,135030,135033,0,3,0
38473,5,3,135035,135035,135038,0,3,2
38474,6,2,135041,135041,135043,0,2,3
38475,4,1,135045,135045,135046,0,1,2
38476,3,3,135048,135048,135051,0,3,2
38477,3,3,135051,135051,135054,0,3,0
38478,5,1,135056,135056,135057,0,1,2
38479,4,2,135060,135060,135062,0,2,3
38480,4,2,135064,135064,135066,0,2,2
38481,6,1,135070,135070,135071,0,1,4
38482,5,1,135075,135075,135076,0,1,4
38483,2,1,135077,135077,135078,0,1,1
38484,6,1,135083,135083,135084,0,1,5
38485,6,3,135089,135089,135092,0,3,5
38486,1,2,135090,135092,135094,2,4,0
38487,6,2,135096,135096,135098,0,2,2
38488,3,3,135099,135099,135102,0,3,1
38489,1,1,135100,135102,135103,2,3,0
38490,1,3,135101,135103,135106,2,5,0
38491,1,3,135102,135106,135109,4,7,0
38492,5,3,135107,135109,135112,2,5,0
38493,4,2,135111,135112,135114,1,3,0
38494,5,3,135116,135116,135119,0,3,2
38495,5,3,135121,135121,135124,0,3,2
38496,3,1,135124,135124,135125,0,1,0
38497,2,2,135126,135126,135128,0,2,1
38498,5,3,135131,135131,135134,0,3,3
38499,2,3,135133,135134,135137,1,4,0
38500,5,3,135138,135138,135141,0,3,1
38501,3,3,135141,135141,135144,0,3,0
38502,4,1,135145,135145,135146,0,1,1
38503,3,3,135148,135148,135151,0,3,2
38504,5,1,135153,135153,135154,0,1,2
38505,1,3,135154,135154,135157,0,3,0
38506,3,1,135157,135157,135158,0,1,0
38507,6,2,135163,135163,135165,0,2,5
38508,6,3,135169,135169,135172,0,3,4
38509,2,2,135171,135172,135174,1,3,0
38510,4,2,135175,135175,135177,0,2,1
38511,3,2,135178,135178,135180,0,2,1
38512,1,3,135179,135180,135183,1,4,0
38513,4,3,135183,135183,135186,0,3,0
38514,1,1,135184,135186,135187,2,3,0
38515,5,1,135189,135189,135190,0,1,2
38516,1,1,135190,135190,135191,0,1,0
38517,3,3,135193,135193,135196,0,3,2
38518,3,2,135196,135196,135198,0,2,0
38519,3,1,135199,135199,135200,0,1,1
38520,6,1,135205,135205,135206,0,1,5
38521,1,1,135206,135206,135207,0,1,0
38522,4,3,135210,135210,135213,0,3,3
38523,3,1,135213,135213,135214,0,1,0
38524,1,3,135214,135214,135217,0,3,0
38525,1,2,135215,135217,135219,2,4,0
38526,4,2,135219,135219,135221,0,2,0
38527,4,2,135223,135223,135225,0,2,2
38528,1,2,135224,135225,135227,1,3,0
38529,3,3,135227,135227,135230,0,3,0
38530,4,2,135231,135231,135233,0,2,1
38531,1,3,135232,135233,135236,1,4,0
38532,5,3,135237,135237,135240,0,3,1
38533,5,1,135242,135242,135243,0,1,2
38534,1,2,135243,135243,135245,0,2,0
38535,5,1,135248,135248,135249,0,1,3
38536,2,3,135250,135250,135253,0,3,1
38537,1,2,135251,135253,135255,2,4,0
38538,1,3,135252,135255,135258,3,6,0
38539,2,1,135254,135258,135259,4,5,0
38540,3,3,135257,135259,135262,2,5,0
38541,4,1,135261,135262,135263,1,2,0
38542,1,1,135262,135263,135264,1,2,0
38543,3,3,135265,135265,135268,0,3,1
38544,5,1,135270,135270,135271,0,1,2
38545,1,2,135271,135271,135273,0,2,0
38546,4,2,135275,135275,135277,0,2,2
38547,2,2,135277,135277,135279,0,2,0
38548,2,3,135279,135279,135282,0,3,0
38549,3,3,135282,135282,135285,0,3,0
38550,2,1,135284,135285,135286,1,2,0
38551,2,2,135286,135286,135288,0,2,0
38552,5,1,135291,135291,135292,0,1,3
38553,5,1,135296,135296,135297,0,1,4
38554,5,1,135301,135301,135302,0,1,4
38555,3,1,135304,135304,135305,0,1,2
38556,4,1,135308,135308,135309,0,1,3
38557,2,3,135310,135310,135313,0,3,1
38558,3,3,135313,135313,135316,0,3,0
38559,1,3,135314,135316,135319,2,5,0
38560,4,3,135318,135319,135322,1,4,0
38561,1,2,135319,135322,135324,3,5,0
38562,5,1,135324,135324,135325,0,1,0
38563,5,3,135329,135329,135332,0,3,4
38564,1,3,135330,135332,135335,2,5,0
38565,2,2,135332,135335,135337,3,5,0
38566,1,3,135333,135337,135340,4,7,0
38567,4,3,135337,135340,135343,3,6,0
38568,1,2,135338,135343,135345,5,7,0
38569,2,1,135340,135345,135346,5,6,0
38570,2,3,135342,135346,135349,4,7,0
38571,2,3,135344,135349,135352,5,8,0
38572,2,2,135346,135352,135354,6,8,0
38573,6,2,135352,135354,135356,2,4,0
38574,6,2,135358,135358,135360,0,2,2
38575,6,3,135364,135364,135367,0,3,4
38576,4,1,135368,135368,135369,0,1,1
38577,2,1,135370,135370,135371,0,1,1
38578,5,2,135375,135375,135377,0,2,4
38579,6,1,135381,135381,135382,0,1,4
38580,1,2,135382,135382,135384,0,2,0
38581,2,3,135384,135384,135387,0,3,0
38582,1,2,135385,135387,135389,2,4,0
38583,1,1,135386,135389,135390,3,4,0
38584,4,2,135390,135390,135392,0,2,0
38585,2,1,135392,135392,135393,0,1,0
38586,6,3,135398,135398,135401,0,3,5
38587,6,1,135404,135404,135405,0,1,3
38588,5,1,135409,135409,135410,0,1,4
38589,5,2,135414,135414,135416,0,2,4
38590,4,2,135418,135418,135420,0,2,2
38591,6,1,135424,135424,135425,0,1,4
38592,2,1,135426,135426,135427,0,1,1
38593,5,3,135431,135431,135434,0,3,4
38594,2,1,135433,135434,135435,1,2,0
38595,2,2,135435,135435,135437,0,2,0
38596,4,2,135439,135439,135441,0,2,2
38597,2,1,135441,135441,135442,0,1,0
38598,2,2,135443,135443,135445,0,2,1
38599,3,3,135446,135446,135449,0,3,1
38600,2,3,135448,135449,135452,1,4,0
38601,1,3,135449,135452,135455,3,6,0
38602,4,3,135453,135455,135458,2,5,0
38603,4,3,135457,135458,135461,1,4,0
38604,5,3,135462,135462,135465,0,3,1
38605,3,3,135465,135465,135468,0,3,0
38606,3,3,135468,135468,135471,0,3,0
38607,5,2,135473,135473,135475,0,2,2
38608,1,2,135474,135475,135477,1,3,0
38609,6,2,135480,135480,135482,0,2,3
38610,2,3,135482,135482,135485,0,3,0
38611,3,1,135485,135485,135486,0,1,0
38612,5,1,135490,135490,135491,0,1,4
38613,2,3,135492,135492,135495,0,3,1
38614,3,2,135495,135495,135497,0,2,0
38615,3,2,135498,135498,135500,0,2,1
38616,3,1,135501,135501,135502,0,1,1
38617,2,3,135503,135503,135506,0,3,1
38618,4,1,135507,135507,135508,0,1,1
38619,6,2,135513,135513,135515,0,2,5
38620,4,2,135517,135517,135519,0,2,2
38621,1,3,135518,135519,135522,1,4,0
38622,5,1,135523,135523,135524,0,1,1
38623,2,1,135525,135525,135526,0,1,1
38624,2,2,135527,135527,135529,0,2,1
38625,1,3,135528,135529,135532,1,4,0
38626,1,1,135529,135532,135533,3,4,0
38627,2,1,135531,135533,135534,2,3,0
38628,5,3,135536,135536,135539,0,3,2
38629,3,3,135539,135539,135542,0,3,0
38630,1,1,135540,135542,135543,2,3,0
38631,4,2,135544,135544,135546,0,2,1
38632,3,1,135547,135547,135548,0,1,1
38633,5,1,135552,135552,135553,0,1,4
38634,4,3,135556,135556,135559,0,3,3
38635,4,1,135560,135560,135561,0,1,1
38636,4,2,135564,135564,135566,0,2,3
38637,5,3,135569,135569,135572,0,3,3
38638,4,2,135573,135573,135575,0,2,1
38639,1,1,135574,135575,135576,1,2,0
38640,4,2,135578,135578,135580,0,2,2
38641,3,3,135581,135581,135584,0,3,1
38642,4,3,135585,135585,135588,0,3,1
38643,6,1,135591,135591,135592,0,1,3
38644,2,2,135593,135593,135595,0,2,1
38645,3,2,135596,135596,135598,0,2,1
38646,3,2,135599,135599,135601,0,2,1
38647,2,2,135601,135601,135603,0,2,0
38648,2,1,135603,135603,135604,0,1,0
38649,5,3,135608,135608,135611,0,3,4
38650,5,1,135613,135613,135614,0,1,2
38651,3,1,135616,135616,135617,0,1,2
38652,2,2,135618,135618,135620,0,2,1
38653,4,1,135622,135622,135623,0,1,2
38654,5,1,135627,135627,135628,0,1,4
38655,1,1,135628,135628,135629,0,1,0
38656,5,1,135633,135633,135634,0,1,4
38657,2,3,135635,135635,135638,0,3,1
38658,1,3,135636,135638,135641,2,5,0
38659,3,2,135639,135641,135643,2,4,0
38660,5,1,135644,135644,135645,0,1,1
38661,4,2,135648,135648,135650,0,2,3
38662,5,3,135653,135653,135656,0,3,3
38663,3,1,135656,135656,135657,0,1,0
38664,3,1,135659,135659,135660,0,1,2
38665,1,1,135660,135660,135661,0,1,0
38666,1,2,135661,135661,135663,0,2,0
38667,2,1,135663,135663,135664,0,1,0
38668,1,2,135664,135664,135666,0,2,0
38669,6,1,135670,135670,135671,0,1,4
38670,3,3,135673,135673,135676,0,3,2
38671,4,3,135677,135677,135680,0,3,1
38672,2,2,135679,135680,135682,1,3,0
38673,3,1,135682,135682,135683,0,1,0
38674,1,2,135683,135683,135685,0,2,0
38675,1,3,135684,135685,135688,1,4,0
38676,1,2,135685,135688,135690,3,5,0
38677,1,3,135686,135690,135693,4,7,0
38678,4,1,135690,135693,135694,3,4,0
38679,5,3,135695,135695,135698,0,3,1
38680,2,1,135697,135698,135699,1,2,0
38681,5,2,135702,135702,135704,0,2,3
38682,3,3,135705,135705,135708,0,3,1
38683,1,2,135706,135708,135710,2,4,0
38684,3,2,135709,135710,135712,1,3,0
38685,5,3,135714,135714,135717,0,3,2
38686,1,1,135715,135717,135718,2,3,0
38687,4,1,135719,135719,135720,0,1,1
38688,6,2,135725,135725,135727,0,2,5
38689,5,3,135730,135730,135733,0,3,3
38690,3,1,135733,135733,135734,0,1,0
38691,1,1,135734,135734,135735,0,1,0
38692,6,3,135740,135740,135743,0,3,5
38693,6,3,135746,135746,135749,0,3,3
38694,1,1,135747,135749,135750,2,3,0
38695,6,3,135753,135753,135756,0,3,3
38696,5,3,135758,135758,135761,0,3,2
38697,3,1,135761,135761,135762,0,1,0
38698,3,3,135764,135764,135767,0,3,2
38699,1,1,135765,135767,135768,2,3,0
38700,3,3,135768,135768,135771,0,3,0
38701,1,3,135769,135771,135774,2,5,0
38702,5,3,135774,135774,135777,0,3,0
38703,6,1,135780,135780,135781,0,1,3
38704,5,1,135785,135785,135786,0,1,4
38705,4,2,135789,135789,135791,0,2,3
38706,4,2,135793,135793,135795,0,2,2
38707,2,2,135795,135795,135797,0,2,0
38708,5,2,135800,135800,135802,0,2,3
38709,1,3,135801,135802,135805,1,4,0
38710,5,3,135806,135806,135809,0,3,1
38711,4,3,135810,135810,135813,0,3,1
38712,5,1,135815,135815,135816,0,1,2
38713,4,3,135819,135819,135822,0,3,3
38714,6,3,135825,135825,135828,0,3,3
38715,2,1,135827,135828,135829,1,2,0
38716,6,3,135833,135833,135836,0,3,4
38717,5,3,135838,135838,135841,0,3,2
38718,4,2,135842,135842,135844,0,2,1
38719,6,2,135848,135848,135850,0,2,4
38720,5,1,135853,135853,135854,0,1,3
38721,1,1,135854,135854,135855,0,1,0
38722,5,3,135859,135859,135862,0,3,4
38723,3,2,135862,135862,135864,0,2,0
38724,6,3,135868,135868,135871,0,3,4
38725,3,1,135871,135871,135872,0,1,0
38726,5,1,135876,135876,135877,0,1,4
38727,3,2,135879,135879,135881,0,2,2
38728,5,2,135884,135884,135886,0,2,3
38729,5,3,135889,135889,135892,0,3,3
38730,6,1,135895,135895,135896,0,1,3
38731,6,2,135901,135901,135903,0,2,5
38732,6,2,135907,135907,135909,0,2,4
38733,1,1,135908,135909,135910,1,2,0
38734,3,2,135911,135911,135913,0,2,1
38735,2,1,135913,135913,135914,0,1,0
38736,5,2,135918,135918,135920,0,2,4
38737,2,3,135920,135920,135923,0,3,0
38738,2,3,135922,135923,135926,1,4,0
38739,5,2,135927,135927,135929,0,2,1
38740,4,1,135931,135931,135932,0,1,2
38741,1,2,135932,135932,135934,0,2,0
38742,2,1,135934,135934,135935,0,1,0
38743,3,3,135937,135937,135940,0,3,2
38744,3,1,135940,135940,135941,0,1,0
38745,4,2,135944,135944,135946,0,2,3
38746,1,1,135945,135946,135947,1,2,0
38747,3,1,135948,135948,135949,0,1,1
38748,4,1,135952,135952,135953,0,1,3
38749,1,2,135953,135953,135955,0,2,0
38750,6,3,135959,135959,135962,0,3,4
38751,3,3,135962,135962,135965,0,3,0
38752,4,1,135966,135966,135967,0,1,1
38753,2,3,135968,135968,135971,0,3,1
38754,3,1,135971,135971,135972,0,1,0
38755,4,3,135975,135975,135978,0,3,3
38756,1,3,135976,135978,135981,2,5,0
38757,5,3,135981,135981,135984,0,3,0
38758,3,1,135984,135984,135985,0,1,0
38759,2,2,135986,135986,135988,0,2,1
38760,6,1,135992,135992,135993,0,1,4
38761,1,3,135993,135993,135996,0,3,0
38762,6,3,135999,135999,136002,0,3,3
38763,4,2,136003,136003,136005,0,2,1
38764,3,2,136006,136006,136008,0,2,1
38765,6,1,136012,136012,136013,0,1,4
38766,6,3,136018,136018,136021,0,3,5
38767,3,3,136021,136021,136024,0,3,0
38768,5,1,136026,136026,136027,0,1,2
38769,4,3,136030,136030,136033,0,3,3
38770,3,1,136033,136033,136034,0,1,0
38771,6,1,136039,136039,136040,0,1,5
38772,5,2,136044,136044,136046,0,2,4
38773,5,1,136049,136049,136050,0,1,3
38774,6,2,136055,136055,136057,0,2,5
38775,6,1,136061,136061,136062,0,1,4
38776,5,2,136066,136066,136068,0,2,4
38777,4,3,136070,136070,136073,0,3,2
38778,4,3,136074,136074,136077,0,3,1
38779,2,1,136076,136077,136078,1,2,0
38780,5,2,136081,136081,136083,0,2,3
38781,5,2,136086,136086,136088,0,2,3
38782,6,1,136092,136092,136093,0,1,4
38783,2,1,136094,136094,136095,0,1,1
38784,5,1,136099,136099,136100,0,1,4
38785,5,2,136104,136104,136106,0,2,4
38786,5,1,136109,136109,136110,0,1,3
38787,4,2,136113,136113,136115,0,2,3
38788,1,1,136114,136115,136116,1,2,0
38789,4,1,136118,136118,136119,0,1,2
38790,1,2,136119,136119,136121,0,2,0
38791,6,3,136125,136125,136128,0,3,4
38792,5,3,136130,136130,136133,0,3,2
38793,3,1,136133,136133,136134,0,1,0
38794,4,1,136137,136137,136138,0,1,3
38795,2,1,136139,136139,136140,0,1,1
38796,2,2,136141,136141,136143,0,2,1
38797,3,1,136144,136144,136145,0,1,1
38798,3,2,136147,136147,136149,0,2,2
38799,1,2,136148,136149,136151,1,3,0
38800,5,1,136153,136153,136154,0,1,2
38801,1,1,136154,136154,136155,0,1,0
38802,1,3,136155,136155,136158,0,3,0
38803,1,3,136156,136158,136161,2,5,0
38804,1,2,136157,136161,136163,4,6,0
38805,2,2,136159,136163,136165,4,6,0
38806,4,3,136163,136165,136168,2,5,0
38807,1,3,136164,136168,136171,4,7,0
38808,5,3,136169,136171,136174,2,5,0
38809,2,2,136171,136174,136176,3,5,0
38810,5,3,136176,136176,136179,0,3,0
38811,3,1,136179,136179,136180,0,1,0
38812,3,3,136182,136182,136185,0,3,2
38813,3,3,136185,136185,136188,0,3,0
38814,1,1,136186,136188,136189,2,3,0
38815,5,3,136191,136191,136194,0,3,2
38816,2,2,136193,136194,136196,1,3,0
38817,2,1,136195,136196,136197,1,2,0
38818,1,1,136196,136197,136198,1,2,0
38819,4,2,136200,136200,136202,0,2,2
38820,5,1,136205,136205,136206,0,1,3
38821,4,1,136209,136209,136210,0,1,3
38822,4,1,136213,136213,136214,0,1,3
38823,6,1,136219,136219,136220,0,1,5
38824,3,3,136222,136222,136225,0,3,2
38825,4,2,136226,136226,136228,0,2,1
38826,5,3,136231,136231,136234,0,3,3
38827,2,1,136233,136234,136235,1,2,0
38828,5,3,136238,136238,136241,0,3,3
38829,6,2,136244,136244,136246,0,2,3
38830,6,3,136250,136250,136253,0,3,4
38831,4,1,136254,136254,136255,0,1,1
38832,1,2,136255,136255,136257,0,2,0
38833,6,2,136261,136261,136263,0,2,4
38834,2,1,136263,136263,136264,0,1,0
38835,1,3,136264,136264,136267,0,3,0
38836,2,1,136266,136267,136268,1,2,0
38837,6,3,136272,136272,136275,0,3,4
38838,5,1,136277,136277,136278,0,1,2
38839,5,2,136282,136282,136284,0,2,4
38840,6,3,136288,136288,136291,0,3,4
38841,6,2,136294,136294,136296,0,2,3
38842,4,3,136298,136298,136301,0,3,2
38843,1,1,136299,136301,136302,2,3,0
38844,2,1,136301,136302,136303,1,2,0
38845,2,3,136303,136303,136306,0,3,0
38846,1,3,136304,136306,136309,2,5,0
38847,3,3,136307,136309,136312,2,5,0
38848,5,1,136312,136312,136313,0,1,0
38849,3,3,136315,136315,136318,0,3,2
38850,4,1,136319,136319,136320,0,1,1
38851,6,1,136325,136325,136326,0,1,5
38852,6,2,136331,136331,136333,0,2,5
38853,1,1,136332,136333,136334,1,2,0
38854,3,1,136335,136335,136336,0,1,1
38855,5,3,136340,136340,136343,0,3,4
38856,6,3,136346,136346,136349,0,3,3
38857,3,1,136349,136349,136350,0,1,0
38858,2,1,136351,136351,136352,0,1,1
38859,6,2,136357,136357,136359,0,2,5
38860,5,3,136362,136362,136365,0,3,3
38861,4,1,136366,136366,136367,0,1,1
38862,2,1,136368,136368,136369,0,1,1
38863,6,2,136374,136374,136376,0,2,5
38864,2,1,136376,136376,136377,0,1,0
38865,1,2,136377,136377,136379,0,2,0
38866,3,2,136380,136380,136382,0,2,1
38867,6,2,136386,136386,136388,0,2,4
38868,4,2,136390,136390,136392,0,2,2
38869,5,3,136395,136395,136398,0,3,3
38870,6,2,136401,136401,136403,0,2,3
38871,3,1,136404,136404,136405,0,1,1
38872,1,2,136405,136405,136407,0,2,0
38873,6,3,136411,136411,136414,0,3,4
38874,1,3,136412,136414,136417,2,5,0
38875,1,2,136413,136417,136419,4,6,0
38876,5,1,136418,136419,136420,1,2,0
38877,6,2,136424,136424,136426,0,2,4
38878,6,1,136430,136430,136431,0,1,4
38879,3,2,136433,136433,136435,0,2,2
38880,3,3,136436,136436,136439,0,3,1
38881,6,1,136442,136442,136443,0,1,3
38882,3,3,136445,136445,136448,0,3,2
38883,3,3,136448,136448,136451,0,3,0
38884,2,3,136450,136451,136454,1,4,0
38885,2,2,136452,136454,136456,2,4,0
38886,6,3,136458,136458,136461,0,3,2
38887,5,3,136463,136463,136466,0,3,2
38888,4,3,136467,136467,136470,0,3,1
38889,4,1,136471,136471,136472,0,1,1
38890,5,1,136476,136476,136477,0,1,4
38891,6,1,136482,136482,136483,0,1,5
38892,6,2,136488,136488,136490,0,2,5
38893,5,1,136493,136493,136494,0,1,3
38894,5,3,136498,136498,136501,0,3,4
38895,1,3,136499,136501,136504,2,5,0
38896,4,1,136503,136504,136505,1,2,0
38897,3,2,136506,136506,136508,0,2,1
38898,1,2,136507,136508,136510,1,3,0
38899,5,3,136512,136512,136515,0,3,2
38900,1,1,136513,136515,136516,2,3,0
38901,4,1,136517,136517,136518,0,1,1
38902,5,1,136522,136522,136523,0,1,4
38903,6,2,136528,136528,136530,0,2,5
38904,1,1,136529,136530,136531,1,2,0
38905,4,2,136533,136533,136535,0,2,2
38906,4,1,136537,136537,136538,0,1,2
38907,2,2,136539,136539,136541,0,2,1
38908,4,1,136543,136543,136544,0,1,2
38909,4,2,136547,136547,136549,0,2,3
38910,3,3,136550,136550,136553,0,3,1
38911,4,1,136554,136554,136555,0,1,1
38912,2,2,136556,136556,136558,0,2,1
38913,2,3,136558,136558,136561,0,3,0
38914,4,2,136562,136562,136564,0,2,1
38915,2,1,136564,136564,136565,0,1,0
38916,6,2,136570,136570,136572,0,2,5
38917,5,1,136575,136575,136576,0,1,3
38918,5,3,136580,136580,136583,0,3,4
38919,1,2,136581,136583,136585,2,4,0
38920,6,2,136587,136587,136589,0,2,2
38921,2,2,136589,136589,136591,0,2,0
38922,2,1,136591,136591,136592,0,1,0
38923,6,3,136597,136597,136600,0,3,5
38924,2,1,136599,136600,136601,1,2,0
38925,2,2,136601,136601,136603,0,2,0
38926,5,3,136606,136606,136609,0,3,3
38927,2,2,136608,136609,136611,1,3,0
38928,3,3,136611,136611,136614,0,3,0
38929,2,3,136613,136614,136617,1,4,0
38930,6,2,136619,136619,136621,0,2,2
38931,5,3,136624,136624,136627,0,3,3
38932,4,2,136628,136628,136630,0,2,1
38933,3,2,136631,136631,136633,0,2,1
38934,4,3,136635,136635,136638,0,3,2
38935,3,3,136638,136638,136641,0,3,0
38936,1,1,136639,136641,136642,2,3,0
38937,4,1,136643,136643,136644,0,1,1
38938,5,2,136648,136648,136650,0,2,4
38939,4,3,136652,136652,136655,0,3,2
38940,3,3,136655,136655,136658,0,3,0
38941,5,3,136660,136660,136663,0,3,2
38942,3,3,136663,136663,136666,0,3,0
38943,6,2,136669,136669,136671,0,2,3
38944,3,2,136672,136672,136674,0,2,1
38945,5,3,136677,136677,136680,0,3,3
38946,2,1,136679,136680,136681,1,2,0
38947,5,1,136684,136684,136685,0,1,3
38948,5,1,136689,136689,136690,0,1,4
38949,2,1,136691,136691,136692,0,1,1
38950,4,1,136695,136695,136696,0,1,3
38951,5,3,136700,136700,136703,0,3,4
38952,1,3,136701,136703,136706,2,5,0
38953,3,1,136704,136706,136707,2,3,0
38954,6,3,136710,136710,136713,0,3,3
38955,2,1,136712,136713,136714,1,2,0
38956,5,2,136717,136717,136719,0,2,3
38957,5,1,136722,136722,136723,0,1,3
38958,2,3,136724,136724,136727,0,3,1
38959,6,3,136730,136730,136733,0,3,3
38960,4,1,136734,136734,136735,0,1,1
38961,3,2,136737,136737,136739,0,2,2
38962,2,1,136739,136739,136740,0,1,0
38963,1,2,136740,136740,136742,0,2,0
38964,5,2,136745,136745,136747,0,2,3
38965,4,3,136749,136749,136752,0,3,2
38966,6,1,136755,136755,136756,0,1,3
38967,3,2,136758,136758,136760,0,2,2
38968,3,1,136761,136761,136762,0,1,1
38969,5,2,136766,136766,136768,0,2,4
38970,3,2,136769,136769,136771,0,2,1
38971,5,2,136774,136774,136776,0,2,3
38972,6,1,136780,136780,136781,0,1,4
38973,5,3,136785,136785,136788,0,3,4
38974,2,2,136787,136788,136790,1,3,0
38975,4,2,136791,136791,136793,0,2,1
38976,4,3,136795,136795,136798,0,3,2
38977,1,2,136796,136798,136800,2,4,0
38978,1,2,136797,136800,136802,3,5,0
38979,2,1,136799,136802,136803,3,4,0
38980,6,2,136805,136805,136807,0,2,2
38981,4,1,136809,136809,136810,0,1,2
38982,2,2,136811,136811,136813,0,2,1
38983,1,1,136812,136813,136814,1,2,0
38984,1,1,136813,136814,136815,1,2,0
38985,3,3,136816,136816,136819,0,3,1
38986,2,3,136818,136819,136822,1,4,0
38987,1,3,136819,136822,136825,3,6,0
38988,5,2,136824,136825,136827,1,3,0
38989,6,2,136830,136830,136832,0,2,3
38990,6,2,136836,136836,136838,0,2,4
38991,1,3,136837,136838,136841,1,4,0
38992,4,2,136841,136841,136843,0,2,0
38993,4,2,136845,136845,136847,0,2,2
38994,2,2,136847,136847,136849,0,2,0
38995,2,1,136849,136849,136850,0,1,0
38996,5,1,136854,136854,136855,0,1,4
38997,2,1,136856,136856,136857,0,1,1
38998,1,2,136857,136857,136859,0,2,0
38999,3,1,136860,136860,136861,0,1,1
39000,5,2,136865,136865,136867,0,2,4
39001,1,2,136866,136867,136869,1,3,0
39002,4,2,136870,136870,136872,0,2,1
39003,3,2,136873,136873,136875,0,2,1
39004,6,1,136879,136879,136880,0,1,4
39005,6,2,136885,136885,136887,0,2,5
39006,4,1,136889,136889,136890,0,1,2
39007,5,2,136894,136894,136896,0,2,4
39008,4,2,136898,136898,136900,0,2,2
39009,2,3,136900,136900,136903,0,3,0
39010,2,2,136902,136903,136905,1,3,0
39011,6,1,136908,136908,136909,0,1,3
39012,3,3,136911,136911,136914,0,3,2
39013,5,2,136916,136916,136918,0,2,2
39014,6,3,136922,136922,136925,0,3,4
39015,6,2,136928,136928,136930,0,2,3
39016,2,2,136930,136930,136932,0,2,0
39017,1,1,136931,136932,136933,1,2,0
39018,5,3,136936,136936,136939,0,3,3
39019,4,2,136940,136940,136942,0,2,1
39020,5,3,136945,136945,136948,0,3,3
39021,1,1,136946,136948,136949,2,3,0
39022,3,1,136949,136949,136950,0,1,0
39023,3,3,136952,136952,136955,0,3,2
39024,5,3,136957,136957,136960,0,3,2
39025,1,2,136958,136960,136962,2,4,0
39026,5,3,136963,136963,136966,0,3,1
39027,3,1,136966,136966,136967,0,1,0
39028,4,3,136970,136970,136973,0,3,3
39029,6,3,136976,136976,136979,0,3,3
39030,3,2,136979,136979,136981,0,2,0
39031,6,1,136985,136985,136986,0,1,4
39032,2,3,136987,136987,136990,0,3,1
39033,4,2,136991,136991,136993,0,2,1
39034,3,3,136994,136994,136997,0,3,1
39035,5,1,136999,136999,137000,0,1,2
39036,2,3,137001,137001,137004,0,3,1
39037,3,2,137004,137004,137006,0,2,0
39038,1,2,137005,137006,137008,1,3,0
39039,4,1,137009,137009,137010,0,1,1
39040,2,1,137011,137011,137012,0,1,1
39041,1,3,137012,137012,137015,0,3,0
39042,6,2,137018,137018,137020,0,2,3
39043,5,1,137023,137023,137024,0,1,3
39044,3,3,137026,137026,137029,0,3,2
39045,3,3,137029,137029,137032,0,3,0
39046,1,2,137030,137032,137034,2,4,0
39047,6,3,137036,137036,137039,0,3,2
39048,1,1,137037,137039,137040,2,3,0
39049,1,2,137038,137040,137042,2,4,0
39050,2,2,137040,137042,137044,2,4,0
39051,4,2,137044,137044,137046,0,2,0
39052,1,2,137045,137046,137048,1,3,0
39053,2,2,137047,137048,137050,1,3,0
39054,6,1,137053,137053,137054,0,1,3
39055,6,1,137059,137059,137060,0,1,5
39056,5,3,137064,137064,137067,0,3,4
39057,3,2,137067,137067,137069,0,2,0
39058,6,2,137073,137073,137075,0,2,4
39059,6,3,137079,137079,137082,0,3,4
39060,4,1,137083,137083,137084,0,1,1
39061,6,2,137089,137089,137091,0,2,5
39062,6,1,137095,137095,137096,0,1,4
39063,6,3,137101,137101,137104,0,3,5
39064,3,2,137104,137104,137106,0,2,0
39065,4,3,137108,137108,137111,0,3,2
39066,6,1,137114,137114,137115,0,1,3
39067,4,3,137118,137118,137121,0,3,3
39068,2,2,137120,137121,137123,1,3,0
39069,3,2,137123,137123,137125,0,2,0
39070,6,3,137129,137129,137132,0,3,4
39071,6,1,137135,137135,137136,0,1,3
39072,1,2,137136,137136,137138,0,2,0
39073,4,3,137140,137140,137143,0,3,2
39074,2,3,137142,137143,137146,1,4,0
39075,2,2,137144,137146,137148,2,4,0
39076,6,3,137150,137150,137153,0,3,2
39077,5,2,137155,137155,137157,0,2,2
39078,4,3,137159,137159,137162,0,3,2
39079,1,1,137160,137162,137163,2,3,0
39080,3,2,137163,137163,137165,0,2,0
39081,5,3,137168,137168,137171,0,3,3
39082,5,1,137173,137173,137174,0,1,2
39083,2,3,137175,137175,137178,0,3,1
39084,6,3,137181,137181,137184,0,3,3
39085,6,1,137187,137187,137188,0,1,3
39086,1,2,137188,137188,137190,0,2,0
39087,5,2,137193,137193,137195,0,2,3
39088,1,2,137194,137195,137197,1,3,0
39089,3,3,137197,137197,137200,0,3,0
39090,2,3,137199,137200,137203,1,4,0
39091,3,3,137202,137203,137206,1,4,0
39092,3,3,137205,137206,137209,1,4,0
39093,4,1,137209,137209,137210,0,1,0
39094,2,2,137211,137211,137213,0,2,1
39095,3,2,137214,137214,137216,0,2,1
39096,6,1,137220,137220,137221,0,1,4
39097,6,1,137226,137226,137227,0,1,5
39098,5,3,137231,137231,137234,0,3,4
39099,3,2,137234,137234,137236,0,2,0
39100,5,1,137239,137239,137240,0,1,3
39101,5,2,137244,137244,137246,0,2,4
39102,6,2,137250,137250,137252,0,2,4
39103,3,1,137253,137253,137254,0,1,1
39104,6,2,137259,137259,137261,0,2,5
39105,3,3,137262,137262,137265,0,3,1
39106,4,3,137266,137266,137269,0,3,1
39107,2,1,137268,137269,137270,1,2,0
39108,2,1,137270,137270,137271,0,1,0
39109,3,1,137273,137273,137274,0,1,2
39110,6,1,137279,137279,137280,0,1,5
39111,6,3,137285,137285,137288,0,3,5
39112,5,1,137290,137290,137291,0,1,2
39113,4,2,137294,137294,137296,0,2,3
39114,6,1,137300,137300,137301,0,1,4
39115,3,2,137303,137303,137305,0,2,2
39116,4,1,137307,137307,137308,0,1,2
39117,1,2,137308,137308,137310,0,2,0
39118,2,1,137310,137310,137311,0,1,0
39119,3,1,137313,137313,137314,0,1,2
39120,3,2,137316,137316,137318,0,2,2
39121,1,1,137317,137318,137319,1,2,0
39122,1,3,137318,137319,137322,1,4,0
39123,5,3,137323,137323,137326,0,3,1
39124,5,3,137328,137328,137331,0,3,2
39125,3,2,137331,137331,137333,0,2,0
39126,3,1,137334,137334,137335,0,1,1
39127,4,1,137338,137338,137339,0,1,3
39128,2,1,137340,137340,137341,0,1,1
39129,4,1,137344,137344,137345,0,1,3
39130,6,3,137350,137350,137353,0,3,5
39131,1,3,137351,137353,137356,2,5,0
39132,3,2,137354,137356,137358,2,4,0
39133,4,1,137358,137358,137359,0,1,0
39134,4,3,137362,137362,137365,0,3,3
39135,1,2,137363,137365,137367,2,4,0
39136,1,3,137364,137367,137370,3,6,0
39137,2,1,137366,137370,137371,4,5,0
39138,5,1,137371,137371,137372,0,1,0
39139,3,3,137374,137374,137377,0,3,2
39140,6,2,137380,137380,137382,0,2,3
39141,3,2,137383,137383,137385,0,2,1
39142,2,3,137385,137385,137388,0,3,0
39143,6,1,137391,137391,137392,0,1,3
39144,2,3,137393,137393,137396,0,3,1
39145,1,3,137394,137396,137399,2,5,0
39146,1,3,137395,137399,137402,4,7,0
39147,1,3,137396,137402,137405,6,9,0
39148,1,3,137397,137405,137408,8,11,0
39149,3,2,137400,137408,137410,8,10,0
39150,2,1,137402,137410,137411,8,9,0
39151,6,1,137408,137411,137412,3,4,0
39152,6,3,137414,137414,137417,0,3,2
39153,5,1,137419,137419,137420,0,1,2
39154,6,3,137425,137425,137428,0,3,5
39155,6,1,137431,137431,137432,0,1,3
39156,6,1,137437,137437,137438,0,1,5
39157,6,1,137443,137443,137444,0,1,5
39158,4,1,137447,137447,137448,0,1,3
39159,6,3,137453,137453,137456,0,3,5
39160,6,1,137459,137459,137460,0,1,3
39161,4,3,137463,137463,137466,0,3,3
39162,2,1,137465,137466,137467,1,2,0
39163,6,1,137471,137471,137472,0,1,4
39164,5,1,137476,137476,137477,0,1,4
39165,1,1,137477,137477,137478,0,1,0
39166,5,3,137482,137482,137485,0,3,4
39167,4,2,137486,137486,137488,0,2,1
39168,2,1,137488,137488,137489,0,1,0
39169,2,1,137490,137490,137491,0,1,1
39170,3,3,137493,137493,137496,0,3,2
39171,6,3,137499,137499,137502,0,3,3
39172,2,3,137501,137502,137505,1,4,0
39173,3,2,137504,137505,137507,1,3,0
39174,6,3,137510,137510,137513,0,3,3
39175,3,3,137513,137513,137516,0,3,0
39176,3,2,137516,137516,137518,0,2,0
39177,1,1,137517,137518,137519,1,2,0
39178,2,3,137519,137519,137522,0,3,0
39179,5,2,137524,137524,137526,0,2,2
39180,4,1,137528,137528,137529,0,1,2
39181,3,2,137531,137531,137533,0,2,2
39182,1,3,137532,137533,137536,1,4,0
39183,4,2,137536,137536,137538,0,2,0
39184,4,1,137540,137540,137541,0,1,2
39185,5,1,137545,137545,137546,0,1,4
39186,2,3,137547,137547,137550,0,3,1
39187,2,2,137549,137550,137552,1,3,0
39188,1,1,137550,137552,137553,2,3,0
39189,3,2,137553,137553,137555,0,2,0
39190,1,3,137554,137555,137558,1,4,0
39191,5,2,137559,137559,137561,0,2,1
39192,1,2,137560,137561,137563,1,3,0
39193,4,1,137564,137564,137565,0,1,1
39194,5,1,137569,137569,137570,0,1,4
39195,1,1,137570,137570,137571,0,1,0
39196,3,3,137573,137573,137576,0,3,2
39197,2,3,137575,137576,137579,1,4,0
39198,4,1,137579,137579,137580,0,1,0
39199,4,2,137583,137583,137585,0,2,3
39200,2,3,137585,137585,137588,0,3,0
39201,3,3,137588,137588,137591,0,3,0
39202,3,3,137591,137591,137594,0,3,0
39203,3,1,137594,137594,137595,0,1,0
39204,1,2,137595,137595,137597,0,2,0
39205,5,3,137600,137600,137603,0,3,3
39206,6,2,137606,137606,137608,0,2,3
39207,1,2,137607,137608,137610,1,3,0
39208,1,3,137608,137610,137613,2,5,0
39209,4,3,137612,137613,137616,1,4,0
39210,5,1,137617,137617,137618,0,1,1
39211,3,3,137620,137620,137623,0,3,2
39212,3,1,137623,137623,137624,0,1,0
39213,6,2,137629,137629,137631,0,2,5
39214,2,3,137631,137631,137634,0,3,0
39215,4,2,137635,137635,137637,0,2,1
39216,6,2,137641,137641,137643,0,2,4
39217,5,3,137646,137646,137649,0,3,3
39218,6,3,137652,137652,137655,0,3,3
39219,5,2,137657,137657,137659,0,2,2
39220,2,3,137659,137659,137662,0,3,0
39221,4,1,137663,137663,137664,0,1,1
39222,4,2,137667,137667,137669,0,2,3
39223,3,1,137670,137670,137671,0,1,1
39224,4,3,137674,137674,137677,0,3,3
39225,5,1,137679,137679,137680,0,1,2
39226,1,2,137680,137680,137682,0,2,0
39227,4,2,137684,137684,137686,0,2,2
39228,2,1,137686,137686,137687,0,1,0
39229,1,1,137687,137687,137688,0,1,0
39230,3,1,137690,137690,137691,0,1,2
39231,4,1,137694,137694,137695,0,1,3
39232,5,1,137699,137699,137700,0,1,4
39233,1,2,137700,137700,137702,0,2,0
39234,5,3,137705,137705,137708,0,3,3
39235,5,2,137710,137710,137712,0,2,2
39236,3,3,137713,137713,137716,0,3,1
39237,6,2,137719,137719,137721,0,2,3
39238,2,2,137721,137721,137723,0,2,0
39239,4,2,137725,137725,137727,0,2,2
39240,1,1,137726,137727,137728,1,2,0
39241,3,2,137729,137729,137731,0,2,1
39242,5,3,137734,137734,137737,0,3,3
39243,5,1,137739,137739,137740,0,1,2
39244,3,1,137742,137742,137743,0,1,2
39245,6,1,137748,137748,137749,0,1,5
39246,2,1,137750,137750,137751,0,1,1
39247,1,1,137751,137751,137752,0,1,0
39248,5,3,137756,137756,137759,0,3,4
39249,6,3,137762,137762,137765,0,3,3
39250,4,2,137766,137766,137768,0,2,1
39251,2,2,137768,137768,137770,0,2,0
39252,4,2,137772,137772,137774,0,2,2
39253,4,1,137776,137776,137777,0,1,2
39254,4,2,137780,137780,137782,0,2,3
39255,5,1,137785,137785,137786,0,1,3
39256,4,3,137789,137789,137792,0,3,3
39257,4,3,137793,137793,137796,0,3,1
39258,4,1,137797,137797,137798,0,1,1
39259,4,1,137801,137801,137802,0,1,3
39260,2,1,137803,137803,137804,0,1,1
39261,1,3,137804,137804,137807,0,3,0
39262,4,1,137808,137808,137809,0,1,1
39263,1,2,137809,137809,137811,0,2,0
39264,1,3,137810,137811,137814,1,4,0
39265,4,1,137814,137814,137815,0,1,0
39266,3,1,137817,137817,137818,0,1,2
39267,1,2,137818,137818,137820,0,2,0
39268,5,1,137823,137823,137824,0,1,3
39269,3,1,137826,137826,137827,0,1,2
39270,4,2,137830,137830,137832,0,2,3
39271,5,1,137835,137835,137836,0,1,3
39272,1,3,137836,137836,137839,0,3,0
39273,5,3,137841,137841,137844,0,3,2
39274,4,2,137845,137845,137847,0,2,1
39275,5,1,137850,137850,137851,0,1,3
39276,4,3,137854,137854,137857,0,3,3
39277,4,1,137858,137858,137859,0,1,1
39278,3,2,137861,137861,137863,0,2,2
39279,6,3,137867,137867,137870,0,3,4
39280,6,3,137873,137873,137876,0,3,3
39281,4,3,137877,137877,137880,0,3,1
39282,4,3,137881,137881,137884,0,3,1
39283,3,1,137884,137884,137885,0,1,0
39284,3,1,137887,137887,137888,0,1,2
39285,2,1,137889,137889,137890,0,1,1
39286,2,3,137891,137891,137894,0,3,1
39287,4,3,137895,137895,137898,0,3,1
39288,2,1,137897,137898,137899,1,2,0
39289,4,2,137901,137901,137903,0,2,2
39290,5,2,137906,137906,137908,0,2,3
39291,4,1,137910,137910,137911,0,1,2
39292,2,1,137912,137912,137913,0,1,1
39293,5,1,137917,137917,137918,0,1,4
39294,6,3,137923,137923,137926,0,3,5
39295,2,3,137925,137926,137929,1,4,0
39296,2,1,137927,137929,137930,2,3,0
39297,1,1,137928,137930,137931,2,3,0
39298,1,3,137929,137931,137934,2,5,0
39299,2,3,137931,137934,137937,3,6,0
39300,1,1,137932,137937,137938,5,6,0
39301,5,2,137937,137938,137940,1,3,0
39302,1,2,137938,137940,137942,2,4,0
39303,1,1,137939,137942,137943,3,4,0
39304,5,3,137944,137944,137947,0,3,1
39305,2,1,137946,137947,137948,1,2,0
39306,6,3,137952,137952,137955,0,3,4
39307,2,3,137954,137955,137958,1,4,0
39308,6,1,137960,137960,137961,0,1,2
39309,6,2,137966,137966,137968,0,2,5
39310,3,3,137969,137969,137972,0,3,1
39311,2,2,137971,137972,137974,1,3,0
39312,4,1,137975,137975,137976,0,1,1
39313,6,2,137981,137981,137983,0,2,5
39314,2,1,137983,137983,137984,0,1,0
39315,1,1,137984,137984,137985,0,1,0
39316,6,3,137990,137990,137993,0,3,5
39317,3,2,137993,137993,137995,0,2,0
39318,4,1,137997,137997,137998,0,1,2
39319,3,2,138000,138000,138002,0,2,2
39320,4,3,138004,138004,138007,0,3,2
39321,6,1,138010,138010,138011,0,1,3
39322,1,1,138011,138011,138012,0,1,0
39323,4,3,138015,138015,138018,0,3,3
39324,5,1,138020,138020,138021,0,1,2
39325,1,1,138021,138021,138022,0,1,0
39326,5,3,138026,138026,138029,0,3,4
39327,1,3,138027,138029,138032,2,5,0
39328,1,3,138028,138032,138035,4,7,0
39329,6,3,138034,138035,138038,1,4,0
39330,1,1,138035,138038,138039,3,4,0
39331,6,2,138041,138041,138043,0,2,2
39332,4,1,138045,138045,138046,0,1,2
39333,2,3,138047,138047,138050,0,3,1
39334,5,1,138052,138052,138053,0,1,2
39335,6,3,138058,138058,138061,0,3,5
39336,2,3,138060,138061,138064,1,4,0
39337,2,3,138062,138064,138067,2,5,0
39338,3,3,138065,138067,138070,2,5,0
39339,3,1,138068,138070,138071,2,3,0
39340,2,3,138070,138071,138074,1,4,0
39341,5,1,138075,138075,138076,0,1,1
39342,1,2,138076,138076,138078,0,2,0
39343,2,1,138078,138078,138079,0,1,0
39344,2,1,138080,138080,138081,0,1,1
39345,5,1,138085,138085,138086,0,1,4
39346,6,3,138091,138091,138094,0,3,5
39347,5,1,138096,138096,138097,0,1,2
39348,6,1,138102,138102,138103,0,1,5
39349,3,3,138105,138105,138108,0,3,2
39350,1,2,138106,138108,138110,2,4,0
39351,6,2,138112,138112,138114,0,2,2
39352,1,3,138113,138114,138117,1,4,0
39353,1,1,138114,138117,138118,3,4,0
39354,1,3,138115,138118,138121,3,6,0
39355,1,3,138116,138121,138124,5,8,0
39356,1,1,138117,138124,138125,7,8,0
39357,2,2,138119,138125,138127,6,8,0
39358,2,2,138121,138127,138129,6,8,0
39359,3,2,138124,138129,138131,5,7,0
39360,3,2,138127,138131,138133,4,6,0
39361,3,1,138130,138133,138134,3,4,0
39362,6,3,138136,138136,138139,0,3,2
39363,3,3,138139,138139,138142,0,3,0
39364,5,3,138144,138144,138147,0,3,2
39365,4,2,138148,138148,138150,0,2,1
39366,1,3,138149,138150,138153,1,4,0
39367,6,1,138155,138155,138156,0,1,2
39368,2,1,138157,138157,138158,0,1,1
39369,5,1,138162,138162,138163,0,1,4
39370,5,2,138167,138167,138169,0,2,4
39371,2,3,138169,138169,138172,0,3,0
39372,3,1,138172,138172,138173,0,1,0
39373,6,1,138178,138178,138179,0,1,5
39374,3,1,138181,138181,138182,0,1,2
39375,2,1,138183,138183,138184,0,1,1
39376,4,3,138187,138187,138190,0,3,3
39377,2,1,138189,138190,138191,1,2,0
39378,6,3,138195,138195,138198,0,3,4
39379,2,2,138197,138198,138200,1,3,0
39380,6,1,138203,138203,138204,0,1,3
39381,5,1,138208,138208,138209,0,1,4
39382,6,1,138214,138214,138215,0,1,5
39383,5,3,138219,138219,138222,0,3,4
39384,1,3,138220,138222,138225,2,5,0
39385,2,1,138222,138225,138226,3,4,0
39386,2,1,138224,138226,138227,2,3,0
39387,4,2,138228,138228,138230,0,2,1
39388,1,1,138229,138230,138231,1,2,0
39389,6,1,138235,138235,138236,0,1,4
39390,4,3,138239,138239,138242,0,3,3
39391,4,1,138243,138243,138244,0,1,1
39392,5,2,138248,138248,138250,0,2,4
39393,3,2,138251,138251,138253,0,2,1
39394,2,1,138253,138253,138254,0,1,0
39395,3,2,138256,138256,138258,0,2,2
39396,2,1,138258,138258,138259,0,1,0
39397,2,1,138260,138260,138261,0,1,1
39398,3,3,138263,138263,138266,0,3,2
39399,1,1,138264,138266,138267,2,3,0
39400,6,2,138270,138270,138272,0,2,3
39401,3,3,138273,138273,138276,0,3,1
39402,4,3,138277,138277,138280,0,3,1
39403,5,2,138282,138282,138284,0,2,2
39404,1,3,138283,138284,138287,1,4,0
39405,2,1,138285,138287,138288,2,3,0
39406,2,3,138287,138288,138291,1,4,0
39407,3,3,138290,138291,138294,1,4,0
39408,2,3,138292,138294,138297,2,5,0
39409,6,3,138298,138298,138301,0,3,1
39410,4,1,138302,138302,138303,0,1,1
39411,4,3,138306,138306,138309,0,3,3
39412,1,1,138307,138309,138310,2,3,0
39413,3,3,138310,138310,138313,0,3,0
39414,3,2,138313,138313,138315,0,2,0
39415,6,1,138319,138319,138320,0,1,4
39416,4,1,138323,138323,138324,0,1,3
39417,1,1,138324,138324,138325,0,1,0
39418,3,1,138327,138327,138328,0,1,2
39419,6,2,138333,138333,138335,0,2,5
39420,6,2,138339,138339,138341,0,2,4
39421,4,2,138343,138343,138345,0,2,2
39422,2,2,138345,138345,138347,0,2,0
39423,4,2,138349,138349,138351,0,2,2
39424,2,1,138351,138351,138352,0,1,0
39425,3,1,138354,138354,138355,0,1,2
39426,4,2,138358,138358,138360,0,2,3
39427,1,1,138359,138360,138361,1,2,0
39428,6,3,138365,138365,138368,0,3,4
39429,6,2,138371,138371,138373,0,2,3
39430,3,2,138374,138374,138376,0,2,1
39431,5,1,138379,138379,138380,0,1,3
39432,3,2,138382,138382,138384,0,2,2
39433,6,2,138388,138388,138390,0,2,4
39434,3,1,138391,138391,138392,0,1,1
39435,4,2,138395,138395,138397,0,2,3
39436,5,1,138400,138400,138401,0,1,3
39437,5,1,138405,138405,138406,0,1,4
39438,1,1,138406,138406,138407,0,1,0
39439,5,3,138411,138411,138414,0,3,4
39440,4,1,138415,138415,138416,0,1,1
39441,2,2,138417,138417,138419,0,2,1
39442,1,1,138418,138419,138420,1,2,0
39443,5,3,138423,138423,138426,0,3,3
39444,3,2,138426,138426,138428,0,2,0
39445,1,2,138427,138428,138430,1,3,0
39446,4,2,138431,138431,138433,0,2,1
39447,2,1,138433,138433,138434,0,1,0
39448,3,3,138436,138436,138439,0,3,2
39449,4,1,138440,138440,138441,0,1,1
39450,4,2,138444,138444,138446,0,2,3
39451,4,3,138448,138448,138451,0,3,2
39452,1,3,138449,138451,138454,2,5,0
39453,6,2,138455,138455,138457,0,2,1
39454,1,1,138456,138457,138458,1,2,0
39455,4,2,138460,138460,138462,0,2,2
39456,5,1,138465,138465,138466,0,1,3
39457,1,3,138466,138466,138469,0,3,0
39458,2,2,138468,138469,138471,1,3,0
39459,5,3,138473,138473,138476,0,3,2
39460,2,2,138475,138476,138478,1,3,0
39461,6,1,138481,138481,138482,0,1,3
39462,6,3,138487,138487,138490,0,3,5
39463,1,3,138488,138490,138493,2,5,0
39464,5,2,138493,138493,138495,0,2,0
39465,6,2,138499,138499,138501,0,2,4
39466,5,3,138504,138504,138507,0,3,3
39467,2,1,138506,138507,138508,1,2,0
39468,4,1,138510,138510,138511,0,1,2
39469,6,1,138516,138516,138517,0,1,5
39470,1,2,138517,138517,138519,0,2,0
39471,6,3,138523,138523,138526,0,3,4
39472,5,3,138528,138528,138531,0,3,2
39473,6,2,138534,138534,138536,0,2,3
39474,1,1,138535,138536,138537,1,2,0
39475,1,2,138536,138537,138539,1,3,0
39476,2,3,138538,138539,138542,1,4,0
39477,6,2,138544,138544,138546,0,2,2
39478,6,3,138550,138550,138553,0,3,4
39479,2,3,138552,138553,138556,1,4,0
39480,1,3,138553,138556,138559,3,6,0
39481,6,2,138559,138559,138561,0,2,0
39482,6,1,138565,138565,138566,0,1,4
39483,6,3,138571,138571,138574,0,3,5
39484,6,3,138577,138577,138580,0,3,3
39485,4,2,138581,138581,138583,0,2,1
39486,3,3,138584,138584,138587,0,3,1
39487,4,1,138588,138588,138589,0,1,1
39488,1,3,138589,138589,138592,0,3,0
39489,1,3,138590,138592,138595,2,5,0
39490,5,1,138595,138595,138596,0,1,0
39491,3,1,138598,138598,138599,0,1,2
39492,3,2,138601,138601,138603,0,2,2
39493,2,1,138603,138603,138604,0,1,0
39494,5,2,138608,138608,138610,0,2,4
39495,6,1,138614,138614,138615,0,1,4
39496,5,1,138619,138619,138620,0,1,4
39497,5,2,138624,138624,138626,0,2,4
39498,6,1,138630,138630,138631,0,1,4
39499,6,2,138636,138636,138638,0,2,5
39500,4,2,138640,138640,138642,0,2,2
39501,5,2,138645,138645,138647,0,2,3
39502,2,3,138647,138647,138650,0,3,0
39503,6,2,138653,138653,138655,0,2,3
39504,1,1,138654,138655,138656,1,2,0
39505,5,1,138659,138659,138660,0,1,3
39506,3,3,138662,138662,138665,0,3,2
39507,4,2,138666,138666,138668,0,2,1
39508,4,2,138670,138670,138672,0,2,2
39509,3,3,138673,138673,138676,0,3,1
39510,6,2,138679,138679,138681,0,2,3
39511,5,1,138684,138684,138685,0,1,3
39512,3,3,138687,138687,138690,0,3,2
39513,5,1,138692,138692,138693,0,1,2
39514,1,2,138693,138693,138695,0,2,0
39515,2,2,138695,138695,138697,0,2,0
39516,5,2,138700,138700,138702,0,2,3
39517,6,2,138706,138706,138708,0,2,4
39518,3,1,138709,138709,138710,0,1,1
39519,2,2,138711,138711,138713,0,2,1
39520,4,3,138715,138715,138718,0,3,2
39521,6,3,138721,138721,138724,0,3,3
39522,4,2,138725,138725,138727,0,2,1
39523,1,2,138726,138727,138729,1,3,0
39524,1,1,138727,138729,138730,2,3,0
39525,2,3,138729,138730,138733,1,4,0
39526,5,2,138734,138734,138736,0,2,1
39527,6,3,138740,138740,138743,0,3,4
39528,2,3,138742,138743,138746,1,4,0
39529,1,1,138743,138746,138747,3,4,0
39530,1,2,138744,138747,138749,3,5,0
39531,2,2,138746,138749,138751,3,5,0
39532,4,3,138750,138751,138754,1,4,0
39533,2,2,138752,138754,138756,2,4,0
39534,5,1,138757,138757,138758,0,1,1
39535,2,2,138759,138759,138761,0,2,1
39536,1,1,138760,138761,138762,1,2,0
39537,1,2,138761,138762,138764,1,3,0
39538,1,2,138762,138764,138766,2,4,0
39539,1,2,138763,138766,138768,3,5,0
39540,3,1,138766,138768,138769,2,3,0
39541,4,2,138770,138770,138772,0,2,1
39542,3,1,138773,138773,138774,0,1,1
39543,5,3,138778,138778,138781,0,3,4
39544,2,2,138780,138781,138783,1,3,0
39545,6,3,138786,138786,138789,0,3,3
39546,4,2,138790,138790,138792,0,2,1
39547,3,1,138793,138793,138794,0,1,1
39548,1,1,138794,138794,138795,0,1,0
39549,5,3,138799,138799,138802,0,3,4
39550,3,1,138802,138802,138803,0,1,0
39551,4,1,138806,138806,138807,0,1,3
39552,5,2,138811,138811,138813,0,2,4
39553,6,3,138817,138817,138820,0,3,4
39554,5,2,138822,138822,138824,0,2,2
39555,3,1,138825,138825,138826,0,1,1
39556,2,2,138827,138827,138829,0,2,1
39557,2,1,138829,138829,138830,0,1,0
39558,6,1,138835,138835,138836,0,1,5
39559,5,3,138840,138840,138843,0,3,4
39560,1,1,138841,138843,138844,2,3,0
39561,5,3,138846,138846,138849,0,3,2
39562,3,1,138849,138849,138850,0,1,0
39563,1,2,138850,138850,138852,0,2,0
39564,4,3,138854,138854,138857,0,3,2
39565,2,1,138856,138857,138858,1,2,0
39566,1,1,138857,138858,138859,1,2,0
39567,6,2,138863,138863,138865,0,2,4
39568,6,3,138869,138869,138872,0,3,4
39569,3,2,138872,138872,138874,0,2,0
39570,6,1,138878,138878,138879,0,1,4
39571,6,2,138884,138884,138886,0,2,5
39572,4,3,138888,138888,138891,0,3,2
39573,4,1,138892,138892,138893,0,1,1
39574,4,3,138896,138896,138899,0,3,3
39575,5,3,138901,138901,138904,0,3,2
39576,1,2,138902,138904,138906,2,4,0
39577,2,1,138904,138906,138907,2,3,0
39578,3,2,138907,138907,138909,0,2,0
39579,6,3,138913,138913,138916,0,3,4
39580,3,2,138916,138916,138918,0,2,0
39581,6,2,138922,138922,138924,0,2,4
39582,6,3,138928,138928,138931,0,3,4
39583,3,1,138931,138931,138932,0,1,0
39584,4,1,138935,138935,138936,0,1,3
39585,4,1,138939,138939,138940,0,1,3
39586,2,2,138941,138941,138943,0,2,1
39587,3,3,138944,138944,138947,0,3,1
39588,2,3,138946,138947,138950,1,4,0
39589,3,2,138949,138950,138952,1,3,0
39590,4,3,138953,138953,138956,0,3,1
39591,2,2,138955,138956,138958,1,3,0
39592,1,1,138956,138958,138959,2,3,0
39593,1,1,138957,138959,138960,2,3,0
39594,1,1,138958,138960,138961,2,3,0
39595,4,3,138962,138962,138965,0,3,1
39596,3,1,138965,138965,138966,0,1,0
39597,6,3,138971,138971,138974,0,3,5
39598,2,3,138973,138974,138977,1,4,0
39599,4,2,138977,138977,138979,0,2,0
39600,5,3,138982,138982,138985,0,3,3
39601,2,2,138984,138985,138987,1,3,0
39602,3,3,138987,138987,138990,0,3,0
39603,6,1,138993,138993,138994,0,1,3
39604,5,3,138998,138998,139001,0,3,4
39605,2,3,139000,139001,139004,1,4,0
39606,2,1,139002,139004,139005,2,3,0
39607,3,2,139005,139005,139007,0,2,0
39608,1,3,139006,139007,139010,1,4,0
39609,3,1,139009,139010,139011,1,2,0
39610,5,1,139014,139014,139015,0,1,3
39611,1,3,139015,139015,139018,0,3,0
39612,6,2,139021,139021,139023,0,2,3
39613,3,1,139024,139024,139025,0,1,1
39614,6,1,139030,139030,139031,0,1,5
39615,5,3,139035,139035,139038,0,3,4
39616,1,2,139036,139038,139040,2,4,0
39617,6,3,139042,139042,139045,0,3,2
39618,4,1,139046,139046,139047,0,1,1
39619,4,1,139050,139050,139051,0,1,3
39620,2,1,139052,139052,139053,0,1,1
39621,3,3,139055,139055,139058,0,3,2
39622,2,2,139057,139058,139060,1,3,0
39623,1,1,139058,139060,139061,2,3,0
39624,6,3,139064,139064,139067,0,3,3
39625,4,2,139068,139068,139070,0,2,1
39626,1,2,139069,139070,139072,1,3,0
39627,6,2,139075,139075,139077,0,2,3
39628,1,1,139076,139077,139078,1,2,0
39629,5,2,139081,139081,139083,0,2,3
39630,3,3,139084,139084,139087,0,3,1
39631,4,1,139088,139088,139089,0,1,1
39632,1,3,139089,139089,139092,0,3,0
39633,5,1,139094,139094,139095,0,1,2
39634,4,1,139098,139098,139099,0,1,3
39635,5,3,139103,139103,139106,0,3,4
39636,1,3,139104,139106,139109,2,5,0
39637,3,1,139107,139109,139110,2,3,0
39638,1,3,139108,139110,139113,2,5,0
39639,1,3,139109,139113,139116,4,7,0
39640,5,3,139114,139116,139119,2,5,0
39641,1,2,139115,139119,139121,4,6,0
39642,6,2,139121,139121,139123,0,2,0
39643,1,1,139122,139123,139124,1,2,0
39644,5,2,139127,139127,139129,0,2,3
39645,3,3,139130,139130,139133,0,3,1
39646,3,3,139133,139133,139136,0,3,0
39647,2,1,139135,139136,139137,1,2,0
39648,4,1,139139,139139,139140,0,1,2
39649,2,3,139141,139141,139144,0,3,1
39650,3,2,139144,139144,139146,0,2,0
39651,4,3,139148,139148,139151,0,3,2
39652,1,3,139149,139151,139154,2,5,0
39653,6,3,139155,139155,139158,0,3,1
39654,5,2,139160,139160,139162,0,2,2
39655,6,2,139166,139166,139168,0,2,4
39656,2,2,139168,139168,139170,0,2,0
39657,6,3,139174,139174,139177,0,3,4
39658,1,3,139175,139177,139180,2,5,0
39659,3,2,139178,139180,139182,2,4,0
39660,5,1,139183,139183,139184,0,1,1
39661,1,1,139184,139184,139185,0,1,0
39662,4,1,139188,139188,139189,0,1,3
39663,3,1,139191,139191,139192,0,1,2
39664,2,1,139193,139193,139194,0,1,1
39665,4,3,139197,139197,139200,0,3,3
39666,3,3,139200,139200,139203,0,3,0
39667,3,1,139203,139203,139204,0,1,0
39668,1,3,139204,139204,139207,0,3,0
39669,2,1,139206,139207,139208,1,2,0
39670,3,2,139209,139209,139211,0,2,1
39671,2,3,139211,139211,139214,0,3,0
39672,2,2,139213,139214,139216,1,3,0
39673,1,3,139214,139216,139219,2,5,0
39674,3,1,139217,139219,139220,2,3,0
39675,6,1,139223,139223,139224,0,1,3
39676,3,1,139226,139226,139227,0,1,2
39677,1,3,139227,139227,139230,0,3,0
39678,6,2,139233,139233,139235,0,2,3
39679,3,2,139236,139236,139238,0,2,1
39680,2,3,139238,139238,139241,0,3,0
39681,4,3,139242,139242,139245,0,3,1
39682,4,3,139246,139246,139249,0,3,1
39683,1,1,139247,139249,139250,2,3,0
39684,1,1,139248,139250,139251,2,3,0
39685,1,1,139249,139251,139252,2,3,0
39686,1,3,139250,139252,139255,2,5,0
39687,6,1,139256,139256,139257,0,1,1
39688,1,2,139257,139257,139259,0,2,0
39689,3,3,139260,139260,139263,0,3,1
39690,4,3,139264,139264,139267,0,3,1
39691,6,3,139270,139270,139273,0,3,3
39692,1,1,139271,139273,139274,2,3,0
39693,4,2,139275,139275,139277,0,2,1
39694,6,2,139281,139281,139283,0,2,4
39695,1,1,139282,139283,139284,1,2,0
39696,3,3,139285,139285,139288,0,3,1
39697,3,2,139288,139288,139290,0,2,0
39698,4,3,139292,139292,139295,0,3,2
39699,6,3,139298,139298,139301,0,3,3
39700,2,3,139300,139301,139304,1,4,0
39701,3,2,139303,139304,139306,1,3,0
39702,1,3,139304,139306,139309,2,5,0
39703,4,3,139308,139309,139312,1,4,0
39704,5,2,139313,139313,139315,0,2,1
39705,4,2,139317,139317,139319,0,2,2
39706,5,1,139322,139322,139323,0,1,3
39707,6,2,139328,139328,139330,0,2,5
39708,3,2,139331,139331,139333,0,2,1
39709,3,1,139334,139334,139335,0,1,1
39710,2,1,139336,139336,139337,0,1,1
39711,6,1,139342,139342,139343,0,1,5
39712,1,3,139343,139343,139346,0,3,0
39713,6,3,139349,139349,139352,0,3,3
39714,1,3,139350,139352,139355,2,5,0
39715,1,2,139351,139355,139357,4,6,0
39716,4,2,139355,139357,139359,2,4,0
39717,4,2,139359,139359,139361,0,2,0
39718,4,3,139363,139363,139366,0,3,2
39719,4,3,139367,139367,139370,0,3,1
39720,6,2,139373,139373,139375,0,2,3
39721,5,1,139378,139378,139379,0,1,3
39722,1,3,139379,139379,139382,0,3,0
39723,2,1,139381,139382,139383,1,2,0
39724,3,1,139384,139384,139385,0,1,1
39725,3,1,139387,139387,139388,0,1,2
39726,4,1,139391,139391,139392,0,1,3
39727,2,3,139393,139393,139396,0,3,1
39728,3,1,139396,139396,139397,0,1,0
39729,2,2,139398,139398,139400,0,2,1
39730,1,1,139399,139400,139401,1,2,0
39731,4,3,139403,139403,139406,0,3,2
39732,6,3,139409,139409,139412,0,3,3
39733,1,2,139410,139412,139414,2,4,0
39734,2,3,139412,139414,139417,2,5,0
39735,3,2,139415,139417,139419,2,4,0
39736,5,2,139420,139420,139422,0,2,1
39737,5,1,139425,139425,139426,0,1,3
39738,2,1,139427,139427,139428,0,1,1
39739,2,3,139429,139429,139432,0,3,1
39740,3,2,139432,139432,139434,0,2,0
39741,5,2,139437,139437,139439,0,2,3
39742,4,1,139441,139441,139442,0,1,2
39743,3,1,139444,139444,139445,0,1,2
39744,1,1,139445,139445,139446,0,1,0
39745,1,2,139446,139446,139448,0,2,0
39746,4,3,139450,139450,139453,0,3,2
39747,5,3,139455,139455,139458,0,3,2
39748,4,1,139459,139459,139460,0,1,1
39749,6,1,139465,139465,139466,0,1,5
39750,2,2,139467,139467,139469,0,2,1
39751,6,2,139473,139473,139475,0,2,4
39752,1,3,139474,139475,139478,1,4,0
39753,5,1,139479,139479,139480,0,1,1
39754,6,2,139485,139485,139487,0,2,5
39755,3,1,139488,139488,139489,0,1,1
39756,5,2,139493,139493,139495,0,2,4
39757,3,1,139496,139496,139497,0,1,1
39758,2,1,139498,139498,139499,0,1,1
39759,6,3,139504,139504,139507,0,3,5
39760,3,3,139507,139507,139510,0,3,0
39761,5,1,139512,139512,139513,0,1,2
39762,4,1,139516,139516,139517,0,1,3
39763,5,3,139521,139521,139524,0,3,4
39764,3,2,139524,139524,139526,0,2,0
39765,6,2,139530,139530,139532,0,2,4
39766,6,1,139536,139536,139537,0,1,4
39767,2,1,139538,139538,139539,0,1,1
39768,2,1,139540,139540,139541,0,1,1
39769,2,1,139542,139542,139543,0,1,1
39770,4,3,139546,139546,139549,0,3,3
39771,3,2,139549,139549,139551,0,2,0
39772,4,1,139553,139553,139554,0,1,2
39773,5,3,139558,139558,139561,0,3,4
39774,2,3,139560,139561,139564,1,4,0
39775,3,2,139563,139564,139566,1,3,0
39776,6,2,139569,139569,139571,0,2,3
39777,5,2,139574,139574,139576,0,2,3
39778,6,1,139580,139580,139581,0,1,4
39779,6,2,139586,139586,139588,0,2,5
39780,2,3,139588,139588,139591,0,3,0
39781,3,2,139591,139591,139593,0,2,0
39782,4,2,139595,139595,139597,0,2,2
39783,1,1,139596,139597,139598,1,2,0
39784,6,1,139602,139602,139603,0,1,4
39785,5,3,139607,139607,139610,0,3,4
39786,5,1,139612,139612,139613,0,1,2
39787,5,2,139617,139617,139619,0,2,4
39788,1,1,139618,139619,139620,1,2,0
39789,4,2,139622,139622,139624,0,2,2
39790,5,1,139627,139627,139628,0,1,3
39791,3,3,139630,139630,139633,0,3,2
39792,1,1,139631,139633,139634,2,3,0
39793,4,1,139635,139635,139636,0,1,1
39794,4,1,139639,139639,139640,0,1,3
39795,2,1,139641,139641,139642,0,1,1
39796,4,2,139645,139645,139647,0,2,3
39797,4,1,139649,139649,139650,0,1,2
39798,2,1,139651,139651,139652,0,1,1
39799,1,2,139652,139652,139654,0,2,0
39800,6,1,139658,139658,139659,0,1,4
39801,3,3,139661,139661,139664,0,3,2
39802,4,3,139665,139665,139668,0,3,1
39803,4,3,139669,139669,139672,0,3,1
39804,5,3,139674,139674,139677,0,3,2
39805,3,2,139677,139677,139679,0,2,0
39806,4,2,139681,139681,139683,0,2,2
39807,3,2,139684,139684,139686,0,2,1
39808,4,3,139688,139688,139691,0,3,2
39809,6,1,139694,139694,139695,0,1,3
39810,2,3,139696,139696,139699,0,3,1
39811,3,3,139699,139699,139702,0,3,0
39812,2,2,139701,139702,139704,1,3,0
39813,5,1,139706,139706,139707,0,1,2
39814,2,2,139708,139708,139710,0,2,1
39815,4,3,139712,139712,139715,0,3,2
39816,5,2,139717,139717,139719,0,2,2
39817,4,1,139721,139721,139722,0,1,2
39818,1,3,139722,139722,139725,0,3,0
39819,6,2,139728,139728,139730,0,2,3
39820,1,2,139729,139730,139732,1,3,0
39821,2,3,139731,139732,139735,1,4,0
39822,6,1,139737,139737,139738,0,1,2
39823,3,3,139740,139740,139743,0,3,2
39824,2,3,139742,139743,139746,1,4,0
39825,5,2,139747,139747,139749,0,2,1
39826,2,2,139749,139749,139751,0,2,0
39827,1,2,139750,139751,139753,1,3,0
39828,6,2,139756,139756,139758,0,2,3
39829,4,1,139760,139760,139761,0,1,2
39830,5,3,139765,139765,139768,0,3,4
39831,1,1,139766,139768,139769,2,3,0
39832,2,2,139768,139769,139771,1,3,0
39833,1,2,139769,139771,139773,2,4,0
39834,5,3,139774,139774,139777,0,3,1
39835,1,3,139775,139777,139780,2,5,0
39836,6,3,139781,139781,139784,0,3,1
39837,6,2,139787,139787,139789,0,2,3
39838,5,3,139792,139792,139795,0,3,3
39839,3,3,139795,139795,139798,0,3,0
39840,3,1,139798,139798,139799,0,1,0
39841,5,3,139803,139803,139806,0,3,4
39842,6,3,139809,139809,139812,0,3,3
39843,5,3,139814,139814,139817,0,3,2
39844,6,2,139820,139820,139822,0,2,3
39845,2,1,139822,139822,139823,0,1,0
39846,1,3,139823,139823,139826,0,3,0
39847,6,2,139829,139829,139831,0,2,3
39848,4,1,139833,139833,139834,0,1,2
39849,1,1,139834,139834,139835,0,1,0
39850,2,3,139836,139836,139839,0,3,1
39851,5,1,139841,139841,139842,0,1,2
39852,6,1,139847,139847,139848,0,1,5
39853,3,2,139850,139850,139852,0,2,2
39854,6,1,139856,139856,139857,0,1,4
39855,1,2,139857,139857,139859,0,2,0
39856,6,1,139863,139863,139864,0,1,4
39857,2,2,139865,139865,139867,0,2,1
39858,4,1,139869,139869,139870,0,1,2
39859,6,3,139875,139875,139878,0,3,5
39860,1,2,139876,139878,139880,2,4,0
39861,2,2,139878,139880,139882,2,4,0
39862,5,2,139883,139883,139885,0,2,1
39863,4,3,139887,139887,139890,0,3,2
39864,2,2,139889,139890,139892,1,3,0
39865,3,2,139892,139892,139894,0,2,0
39866,5,3,139897,139897,139900,0,3,3
39867,4,1,139901,139901,139902,0,1,1
39868,1,3,139902,139902,139905,0,3,0
39869,4,3,139906,139906,139909,0,3,1
39870,1,2,139907,139909,139911,2,4,0
39871,5,2,139912,139912,139914,0,2,1
39872,1,3,139913,139914,139917,1,4,0
39873,3,1,139916,139917,139918,1,2,0
39874,5,1,139921,139921,139922,0,1,3
39875,1,1,139922,139922,139923,0,1,0
39876,6,1,139928,139928,139929,0,1,5
39877,6,1,139934,139934,139935,0,1,5
39878,6,2,139940,139940,139942,0,2,5
39879,4,3,139944,139944,139947,0,3,2
39880,2,2,139946,139947,139949,1,3,0
39881,1,2,139947,139949,139951,2,4,0
39882,2,1,139949,139951,139952,2,3,0
39883,2,2,139951,139952,139954,1,3,0
39884,2,3,139953,139954,139957,1,4,0
39885,1,1,139954,139957,139958,3,4,0
39886,3,1,139957,139958,139959,1,2,0
39887,6,1,139963,139963,139964,0,1,4
39888,5,1,139968,139968,139969,0,1,4
39889,2,2,139970,139970,139972,0,2,1
39890,4,3,139974,139974,139977,0,3,2
39891,4,2,139978,139978,139980,0,2,1
39892,4,2,139982,139982,139984,0,2,2
39893,4,1,139986,139986,139987,0,1,2
39894,3,2,139989,139989,139991,0,2,2
39895,1,2,139990,139991,139993,1,3,0
39896,3,3,139993,139993,139996,0,3,0
39897,2,1,139995,139996,139997,1,2,0
39898,2,3,139997,139997,140000,0,3,0
39899,5,1,140002,140002,140003,0,1,2
39900,2,3,140004,140004,140007,0,3,1
39901,5,1,140009,140009,140010,0,1,2
39902,3,2,140012,140012,140014,0,2,2
39903,5,1,140017,140017,140018,0,1,3
39904,3,2,140020,140020,140022,0,2,2
39905,5,2,140025,140025,140027,0,2,3
39906,2,2,140027,140027,140029,0,2,0
39907,1,3,140028,140029,140032,1,4,0
39908,5,3,140033,140033,140036,0,3,1
39909,1,2,140034,140036,140038,2,4,0
39910,1,3,140035,140038,140041,3,6,0
39911,1,1,140036,140041,140042,5,6,0
39912,1,2,140037,140042,140044,5,7,0
39913,5,3,140042,140044,140047,2,5,0
39914,5,2,140047,140047,140049,0,2,0
39915,4,1,140051,140051,140052,0,1,2
39916,3,1,140054,140054,140055,0,1,2
39917,5,2,140059,140059,140061,0,2,4
39918,2,1,140061,140061,140062,0,1,0
39919,6,3,140067,140067,140070,0,3,5
39920,4,2,140071,140071,140073,0,2,1
39921,5,1,140076,140076,140077,0,1,3
39922,3,3,140079,140079,140082,0,3,2
39923,1,1,140080,140082,140083,2,3,0
39924,4,2,140084,140084,140086,0,2,1
39925,4,1,140088,140088,140089,0,1,2
39926,5,2,140093,140093,140095,0,2,4
39927,5,1,140098,140098,140099,0,1,3
39928,6,2,140104,140104,140106,0,2,5
39929,1,2,140105,140106,140108,1,3,0
39930,1,2,140106,140108,140110,2,4,0
39931,1,1,140107,140110,140111,3,4,0
39932,4,3,140111,140111,140114,0,3,0
39933,2,3,140113,140114,140117,1,4,0
39934,6,2,140119,140119,140121,0,2,2
39935,1,3,140120,140121,140124,1,4,0
39936,1,2,140121,140124,140126,3,5,0
39937,4,3,140125,140126,140129,1,4,0
39938,2,2,140127,140129,140131,2,4,0
39939,5,2,140132,140132,140134,0,2,1
39940,4,2,140136,140136,140138,0,2,2
39941,6,3,140142,140142,140145,0,3,4
39942,4,2,140146,140146,140148,0,2,1
39943,1,1,140147,140148,140149,1,2,0
39944,2,2,140149,140149,140151,0,2,0
39945,2,1,140151,140151,140152,0,1,0
39946,5,1,140156,140156,140157,0,1,4
39947,5,3,140161,140161,140164,0,3,4
39948,6,2,140167,140167,140169,0,2,3
39949,1,2,140168,140169,140171,1,3,0
39950,3,1,140171,140171,140172,0,1,0
39951,1,1,140172,140172,140173,0,1,0
39952,4,1,140176,140176,140177,0,1,3
39953,5,2,140181,140181,140183,0,2,4
39954,4,3,140185,140185,140188,0,3,2
39955,3,1,140188,140188,140189,0,1,0
39956,1,3,140189,140189,140192,0,3,0
39957,4,1,140193,140193,140194,0,1,1
39958,2,2,140195,140195,140197,0,2,1
39959,1,1,140196,140197,140198,1,2,0
39960,3,1,140199,140199,140200,0,1,1
39961,2,1,140201,140201,140202,0,1,1
39962,1,3,140202,140202,140205,0,3,0
39963,4,3,140206,140206,140209,0,3,1
39964,1,3,140207,140209,140212,2,5,0
39965,4,1,140211,140212,140213,1,2,0
39966,1,3,140212,140213,140216,1,4,0
39967,2,3,140214,140216,140219,2,5,0
39968,3,2,140217,140219,140221,2,4,0
39969,3,3,140220,140221,140224,1,4,0
39970,1,2,140221,140224,140226,3,5,0
39971,5,2,140226,140226,140228,0,2,0
39972,1,1,140227,140228,140229,1,2,0
39973,4,1,140231,140231,140232,0,1,2
39974,5,2,140236,140236,140238,0,2,4
39975,4,1,140240,140240,140241,0,1,2
39976,2,3,140242,140242,140245,0,3,1
39977,4,3,140246,140246,140249,0,3,1
39978,1,2,140247,140249,140251,2,4,0
39979,5,1,140252,140252,140253,0,1,1
39980,3,1,140255,140255,140256,0,1,2
39981,6,1,140261,140261,140262,0,1,5
39982,6,2,140267,140267,140269,0,2,5
39983,4,2,140271,140271,140273,0,2,2
39984,6,1,140277,140277,140278,0,1,4
39985,5,3,140282,140282,140285,0,3,4
39986,5,3,140287,140287,140290,0,3,2
39987,5,2,140292,140292,140294,0,2,2
39988,2,3,140294,140294,140297,0,3,0
39989,4,2,140298,140298,140300,0,2,1
39990,5,3,140303,140303,140306,0,3,3
39991,1,1,140304,140306,140307,2,3,0
39992,2,2,140306,140307,140309,1,3,0
39993,4,1,140310,140310,140311,0,1,1
39994,2,2,140312,140312,140314,0,2,1
39995,3,2,140315,140315,140317,0,2,1
39996,3,1,140318,140318,140319,0,1,1
39997,4,1,140322,140322,140323,0,1,3
39998,3,2,140325,140325,140327,0,2,2
39999,6,1,140331,140331,140332,0,1,4
40000,1,1,140332,140332,140333,0,1,0
40001,1,1,140333,140333,140334,0,1,0
40002,4,3,140337,140337,140340,0,3,3
40003,2,2,140339,140340,140342,1,3,0
40004,3,3,140342,140342,140345,0,3,0
40005,6,2,140348,140348,140350,0,2,3
40006,6,1,140354,140354,140355,0,1,4
40007,4,1,140358,140358,140359,0,1,3
40008,5,1,140363,140363,140364,0,1,4
40009,4,2,140367,140367,140369,0,2,3
40010,2,2,140369,140369,140371,0,2,0
40011,1,2,140370,140371,140373,1,3,0
40012,2,3,140372,140373,140376,1,4,0
40013,3,3,140375,140376,140379,1,4,0
40014,6,1,140381,140381,140382,0,1,2
40015,6,2,140387,140387,140389,0,2,5
40016,5,2,140392,140392,140394,0,2,3
40017,6,1,140398,140398,140399,0,1,4
40018,2,1,140400,140400,140401,0,1,1
40019,5,3,140405,140405,140408,0,3,4
40020,2,2,140407,140408,140410,1,3,0
40021,3,1,140410,140410,140411,0,1,0
40022,2,2,140412,140412,140414,0,2,1
40023,2,3,140414,140414,140417,0,3,0
40024,5,3,140419,140419,140422,0,3,2
40025,2,3,140421,140422,140425,1,4,0
40026,3,2,140424,140425,140427,1,3,0
40027,2,2,140426,140427,140429,1,3,0
40028,3,2,140429,140429,140431,0,2,0
40029,1,3,140430,140431,140434,1,4,0
40030,5,3,140435,140435,140438,0,3,1
40031,2,3,140437,140438,140441,1,4,0
40032,4,2,140441,140441,140443,0,2,0
40033,3,3,140444,140444,140447,0,3,1
40034,6,3,140450,140450,140453,0,3,3
40035,4,1,140454,140454,140455,0,1,1
40036,6,2,140460,140460,140462,0,2,5
40037,3,2,140463,140463,140465,0,2,1
40038,4,2,140467,140467,140469,0,2,2
40039,5,3,140472,140472,140475,0,3,3
40040,5,2,140477,140477,140479,0,2,2
40041,4,3,140481,140481,140484,0,3,2
40042,1,2,140482,140484,140486,2,4,0
40043,6,2,140488,140488,140490,0,2,2
40044,4,1,140492,140492,140493,0,1,2
40045,4,2,140496,140496,140498,0,2,3
40046,5,2,140501,140501,140503,0,2,3
40047,6,2,140507,140507,140509,0,2,4
40048,4,3,140511,140511,140514,0,3,2
40049,2,3,140513,140514,140517,1,4,0
40050,6,1,140519,140519,140520,0,1,2
40051,6,2,140525,140525,140527,0,2,5
40052,3,1,140528,140528,140529,0,1,1
40053,6,1,140534,140534,140535,0,1,5
40054,4,1,140538,140538,140539,0,1,3
40055,2,3,140540,140540,140543,0,3,1
40056,2,1,140542,140543,140544,1,2,0
40057,5,1,140547,140547,140548,0,1,3
40058,4,3,140551,140551,140554,0,3,3
40059,2,2,140553,140554,140556,1,3,0
40060,4,3,140557,140557,140560,0,3,1
40061,1,1,140558,140560,140561,2,3,0
40062,4,2,140562,140562,140564,0,2,1
40063,4,1,140566,140566,140567,0,1,2
40064,3,2,140569,140569,140571,0,2,2
40065,1,1,140570,140571,140572,1,2,0
40066,2,1,140572,140572,140573,0,1,0
40067,6,2,140578,140578,140580,0,2,5
40068,2,2,140580,140580,140582,0,2,0
40069,3,3,140583,140583,140586,0,3,1
40070,3,2,140586,140586,140588,0,2,0
40071,5,2,140591,140591,140593,0,2,3
40072,6,3,140597,140597,140600,0,3,4
40073,5,3,140602,140602,140605,0,3,2
40074,5,1,140607,140607,140608,0,1,2
40075,2,3,140609,140609,140612,0,3,1
40076,6,2,140615,140615,140617,0,2,3
40077,2,3,140617,140617,140620,0,3,0
40078,6,2,140623,140623,140625,0,2,3
40079,1,3,140624,140625,140628,1,4,0
40080,4,2,140628,140628,140630,0,2,0
40081,2,1,140630,140630,140631,0,1,0
40082,5,3,140635,140635,140638,0,3,4
40083,4,2,140639,140639,140641,0,2,1
40084,6,1,140645,140645,140646,0,1,4
40085,1,3,140646,140646,140649,0,3,0
40086,4,2,140650,140650,140652,0,2,1
40087,4,3,140654,140654,140657,0,3,2
40088,6,3,140660,140660,140663,0,3,3
40089,2,2,140662,140663,140665,1,3,0
40090,5,2,140667,140667,140669,0,2,2
40091,6,3,140673,140673,140676,0,3,4
40092,6,3,140679,140679,140682,0,3,3
40093,4,3,140683,140683,140686,0,3,1
40094,1,2,140684,140686,140688,2,4,0
40095,1,1,140685,140688,140689,3,4,0
40096,1,1,140686,140689,140690,3,4,0
40097,6,3,140692,140692,140695,0,3,2
40098,6,1,140698,140698,140699,0,1,3
40099,1,3,140699,140699,140702,0,3,0
40100,2,2,140701,140702,140704,1,3,0
40101,4,3,140705,140705,140708,0,3,1
40102,3,2,140708,140708,140710,0,2,0
40103,3,2,140711,140711,140713,0,2,1
40104,5,2,140716,140716,140718,0,2,3
40105,4,1,140720,140720,140721,0,1,2
40106,2,2,140722,140722,140724,0,2,1
40107,1,1,140723,140724,140725,1,2,0
40108,6,1,140729,140729,140730,0,1,4
40109,5,1,140734,140734,140735,0,1,4
40110,2,3,140736,140736,140739,0,3,1
40111,6,1,140742,140742,140743,0,1,3
40112,3,3,140745,140745,140748,0,3,2
40113,2,2,140747,140748,140750,1,3,0
40114,5,3,140752,140752,140755,0,3,2
40115,3,1,140755,140755,140756,0,1,0
40116,5,2,140760,140760,140762,0,2,4
40117,2,3,140762,140762,140765,0,3,0
40118,5,1,140767,140767,140768,0,1,2
40119,1,3,140768,140768,140771,0,3,0
40120,2,1,140770,140771,140772,1,2,0
40121,6,2,140776,140776,140778,0,2,4
40122,4,3,140780,140780,140783,0,3,2
40123,2,3,140782,140783,140786,1,4,0
40124,4,2,140786,140786,140788,0,2,0
40125,2,2,140788,140788,140790,0,2,0
40126,5,3,140793,140793,140796,0,3,3
40127,1,1,140794,140796,140797,2,3,0
40128,1,1,140795,140797,140798,2,3,0
40129,2,1,140797,140798,140799,1,2,0
40130,6,3,140803,140803,140806,0,3,4
40131,1,1,140804,140806,140807,2,3,0
40132,3,1,140807,140807,140808,0,1,0
40133,1,3,140808,140808,140811,0,3,0
40134,6,2,140814,140814,140816,0,2,3
40135,5,1,140819,140819,140820,0,1,3
40136,6,1,140825,140825,140826,0,1,5
40137,4,2,140829,140829,140831,0,2,3
40138,2,3,140831,140831,140834,0,3,0
40139,4,1,140835,140835,140836,0,1,1
40140,1,3,140836,140836,140839,0,3,0
40141,3,1,140839,140839,140840,0,1,0
40142,3,3,140842,140842,140845,0,3,2
40143,4,2,140846,140846,140848,0,2,1
40144,3,3,140849,140849,140852,0,3,1
40145,1,1,140850,140852,140853,2,3,0
40146,6,3,140856,140856,140859,0,3,3
40147,3,3,140859,140859,140862,0,3,0
40148,6,2,140865,140865,140867,0,2,3
40149,3,2,140868,140868,140870,0,2,1
40150,6,2,140874,140874,140876,0,2,4
40151,5,3,140879,140879,140882,0,3,3
40152,1,2,140880,140882,140884,2,4,0
40153,5,1,140885,140885,140886,0,1,1
40154,1,3,140886,140886,140889,0,3,0
40155,5,3,140891,140891,140894,0,3,2
40156,4,2,140895,140895,140897,0,2,1
40157,2,1,140897,140897,140898,0,1,0
40158,5,3,140902,140902,140905,0,3,4
40159,6,2,140908,140908,140910,0,2,3
40160,4,3,140912,140912,140915,0,3,2
40161,3,2,140915,140915,140917,0,2,0
40162,1,3,140916,140917,140920,1,4,0
40163,6,3,140922,140922,140925,0,3,2
40164,3,3,140925,140925,140928,0,3,0
40165,6,2,140931,140931,140933,0,2,3
40166,1,3,140932,140933,140936,1,4,0
40167,2,3,140934,140936,140939,2,5,0
40168,3,2,140937,140939,140941,2,4,0
40169,4,2,140941,140941,140943,0,2,0
40170,2,3,140943,140943,140946,0,3,0
40171,1,1,140944,140946,140947,2,3,0
40172,1,2,140945,140947,140949,2,4,0
40173,5,2,140950,140950,140952,0,2,1
40174,4,2,140954,140954,140956,0,2,2
40175,6,1,140960,140960,140961,0,1,4
40176,3,2,140963,140963,140965,0,2,2
40177,1,2,140964,140965,140967,1,3,0
40178,3,3,140967,140967,140970,0,3,0
40179,3,1,140970,140970,140971,0,1,0
40180,6,3,140976,140976,140979,0,3,5
40181,1,1,140977,140979,140980,2,3,0
40182,1,1,140978,140980,140981,2,3,0
40183,5,3,140983,140983,140986,0,3,2
40184,6,3,140989,140989,140992,0,3,3
40185,3,1,140992,140992,140993,0,1,0
40186,5,2,140997,140997,140999,0,2,4
40187,6,2,141003,141003,141005,0,2,4
40188,1,3,141004,141005,141008,1,4,0
40189,5,1,141009,141009,141010,0,1,1
40190,3,3,141012,141012,141015,0,3,2
40191,3,2,141015,141015,141017,0,2,0
40192,6,3,141021,141021,141024,0,3,4
40193,5,3,141026,141026,141029,0,3,2
40194,6,2,141032,141032,141034,0,2,3
40195,6,1,141038,141038,141039,0,1,4
40196,6,3,141044,141044,141047,0,3,5
40197,4,1,141048,141048,141049,0,1,1
40198,2,3,141050,141050,141053,0,3,1
40199,4,2,141054,141054,141056,0,2,1
40200,3,2,141057,141057,141059,0,2,1
40201,5,3,141062,141062,141065,0,3,3
40202,6,3,141068,141068,141071,0,3,3
40203,1,3,141069,141071,141074,2,5,0
40204,1,3,141070,141074,141077,4,7,0
40205,5,2,141075,141077,141079,2,4,0
40206,3,1,141078,141079,141080,1,2,0
40207,1,1,141079,141080,141081,1,2,0
40208,1,2,141080,141081,141083,1,3,0
40209,1,1,141081,141083,141084,2,3,0
40210,2,3,141083,141084,141087,1,4,0
40211,6,1,141089,141089,141090,0,1,2
40212,2,1,141091,141091,141092,0,1,1
40213,3,3,141094,141094,141097,0,3,2
40214,5,3,141099,141099,141102,0,3,2
40215,6,3,141105,141105,141108,0,3,3
40216,6,3,141111,141111,141114,0,3,3
40217,6,1,141117,141117,141118,0,1,3
40218,4,2,141121,141121,141123,0,2,3
40219,6,2,141127,141127,141129,0,2,4
40220,4,2,141131,141131,141133,0,2,2
40221,6,2,141137,141137,141139,0,2,4
40222,2,1,141139,141139,141140,0,1,0
40223,5,3,141144,141144,141147,0,3,4
40224,2,2,141146,141147,141149,1,3,0
40225,3,2,141149,141149,141151,0,2,0
40226,1,1,141150,141151,141152,1,2,0
40227,1,2,141151,141152,141154,1,3,0
40228,6,1,141157,141157,141158,0,1,3
40229,1,1,141158,141158,141159,0,1,0
40230,5,2,141163,141163,141165,0,2,4
40231,6,2,141169,141169,141171,0,2,4
40232,6,2,141175,141175,141177,0,2,4
40233,4,2,141179,141179,141181,0,2,2
40234,5,1,141184,141184,141185,0,1,3
40235,2,3,141186,141186,141189,0,3,1
40236,1,1,141187,141189,141190,2,3,0
40237,5,3,141192,141192,141195,0,3,2
40238,4,1,141196,141196,141197,0,1,1
40239,1,3,141197,141197,141200,0,3,0
40240,6,1,141203,141203,141204,0,1,3
40241,3,3,141206,141206,141209,0,3,2
40242,2,1,141208,141209,141210,1,2,0
40243,1,3,141209,141210,141213,1,4,0
40244,3,1,141212,141213,141214,1,2,0
40245,3,3,141215,141215,141218,0,3,1
40246,5,1,141220,141220,141221,0,1,2
40247,1,2,141221,141221,141223,0,2,0
40248,4,2,141225,141225,141227,0,2,2
40249,5,1,141230,141230,141231,0,1,3
40250,5,3,141235,141235,141238,0,3,4
40251,6,1,141241,141241,141242,0,1,3
40252,6,2,141247,141247,141249,0,2,5
40253,1,2,141248,141249,141251,1,3,0
40254,4,2,141252,141252,141254,0,2,1
40255,5,2,141257,141257,141259,0,2,3
40256,3,2,141260,141260,141262,0,2,1
40257,6,3,141266,141266,141269,0,3,4
40258,6,2,141272,141272,141274,0,2,3
40259,3,2,141275,141275,141277,0,2,1
40260,4,3,141279,141279,141282,0,3,2
40261,3,1,141282,141282,141283,0,1,0
40262,2,2,141284,141284,141286,0,2,1
40263,6,2,141290,141290,141292,0,2,4
40264,2,2,141292,141292,141294,0,2,0
40265,2,3,141294,141294,141297,0,3,0
40266,6,3,141300,141300,141303,0,3,3
40267,6,2,141306,141306,141308,0,2,3
40268,6,2,141312,141312,141314,0,2,4
40269,1,2,141313,141314,141316,1,3,0
40270,4,3,141317,141317,141320,0,3,1
40271,6,3,141323,141323,141326,0,3,3
40272,6,3,141329,141329,141332,0,3,3
40273,1,2,141330,141332,141334,2,4,0
40274,2,3,141332,141334,141337,2,5,0
40275,5,1,141337,141337,141338,0,1,0
40276,4,3,141341,141341,141344,0,3,3
40277,3,2,141344,141344,141346,0,2,0
40278,3,2,141347,141347,141349,0,2,1
40279,3,2,141350,141350,141352,0,2,1
40280,4,2,141354,141354,141356,0,2,2
40281,1,2,141355,141356,141358,1,3,0
40282,6,1,141361,141361,141362,0,1,3
40283,2,1,141363,141363,141364,0,1,1
40284,3,1,141366,141366,141367,0,1,2
40285,4,1,141370,141370,141371,0,1,3
40286,3,2,141373,141373,141375,0,2,2
40287,2,3,141375,141375,141378,0,3,0
40288,4,2,141379,141379,141381,0,2,1
40289,2,3,141381,141381,141384,0,3,0
40290,6,2,141387,141387,141389,0,2,3
40291,5,3,141392,141392,141395,0,3,3
40292,5,1,141397,141397,141398,0,1,2
40293,4,3,141401,141401,141404,0,3,3
40294,1,3,141402,141404,141407,2,5,0
40295,1,1,141403,141407,141408,4,5,0
40296,6,2,141409,141409,141411,0,2,1
40297,1,1,141410,141411,141412,1,2,0
40298,5,3,141415,141415,141418,0,3,3
40299,1,3,141416,141418,141421,2,5,0
40300,3,3,141419,141421,141424,2,5,0
40301,3,3,141422,141424,141427,2,5,0
40302,5,3,141427,141427,141430,0,3,0
40303,1,1,141428,141430,141431,2,3,0
40304,6,1,141434,141434,141435,0,1,3
40305,4,1,141438,141438,141439,0,1,3
40306,3,1,141441,141441,141442,0,1,2
40307,4,3,141445,141445,141448,0,3,3
40308,2,3,141447,141448,141451,1,4,0
40309,5,2,141452,141452,141454,0,2,1
40310,2,3,141454,141454,141457,0,3,0
40311,2,3,141456,141457,141460,1,4,0
40312,4,2,141460,141460,141462,0,2,0
40313,2,2,141462,141462,141464,0,2,0
40314,6,2,141468,141468,141470,0,2,4
40315,4,3,141472,141472,141475,0,3,2
40316,1,3,141473,141475,141478,2,5,0
40317,2,1,141475,141478,141479,3,4,0
40318,4,1,141479,141479,141480,0,1,0
40319,1,2,141480,141480,141482,0,2,0
40320,1,3,141481,141482,141485,1,4,0
40321,5,2,141486,141486,141488,0,2,1
40322,2,1,141488,141488,141489,0,1,0
40323,2,1,141490,141490,141491,0,1,1
40324,2,2,141492,141492,141494,0,2,1
40325,3,1,141495,141495,141496,0,1,1
40326,2,3,141497,141497,141500,0,3,1
40327,6,1,141503,141503,141504,0,1,3
40328,4,2,141507,141507,141509,0,2,3
40329,1,1,141508,141509,141510,1,2,0
40330,6,2,141514,141514,141516,0,2,4
40331,3,3,141517,141517,141520,0,3,1
40332,5,2,141522,141522,141524,0,2,2
40333,2,2,141524,141524,141526,0,2,0
40334,2,1,141526,141526,141527,0,1,0
40335,5,3,141531,141531,141534,0,3,4
40336,3,3,141534,141534,141537,0,3,0
40337,4,1,141538,141538,141539,0,1,1
40338,1,3,141539,141539,141542,0,3,0
40339,2,3,141541,141542,141545,1,4,0
40340,6,2,141547,141547,141549,0,2,2
40341,5,1,141552,141552,141553,0,1,3
40342,2,2,141554,141554,141556,0,2,1
40343,4,2,141558,141558,141560,0,2,2
40344,6,2,141564,141564,141566,0,2,4
40345,6,1,141570,141570,141571,0,1,4
40346,5,3,141575,141575,141578,0,3,4
40347,1,2,141576,141578,141580,2,4,0
40348,5,2,141581,141581,141583,0,2,1
40349,4,2,141585,141585,141587,0,2,2
40350,4,3,141589,141589,141592,0,3,2
40351,4,3,141593,141593,141596,0,3,1
40352,1,3,141594,141596,141599,2,5,0
40353,4,1,141598,141599,141600,1,2,0
40354,6,3,141604,141604,141607,0,3,4
40355,6,3,141610,141610,141613,0,3,3
40356,2,1,141612,141613,141614,1,2,0
40357,5,2,141617,141617,141619,0,2,3
40358,4,2,141621,141621,141623,0,2,2
40359,2,2,141623,141623,141625,0,2,0
40360,4,3,141627,141627,141630,0,3,2
40361,6,3,141633,141633,141636,0,3,3
40362,4,1,141637,141637,141638,0,1,1
40363,3,2,141640,141640,141642,0,2,2
40364,5,3,141645,141645,141648,0,3,3
40365,3,1,141648,141648,141649,0,1,0
40366,3,1,141651,141651,141652,0,1,2
40367,6,3,141657,141657,141660,0,3,5
40368,1,2,141658,141660,141662,2,4,0
40369,1,3,141659,141662,141665,3,6,0
40370,1,3,141660,141665,141668,5,8,0
40371,3,1,141663,141668,141669,5,6,0
40372,4,2,141667,141669,141671,2,4,0
40373,1,2,141668,141671,141673,3,5,0
40374,6,3,141674,141674,141677,0,3,1
40375,1,3,141675,141677,141680,2,5,0
40376,6,2,141681,141681,141683,0,2,1
40377,2,3,141683,141683,141686,0,3,0
40378,2,1,141685,141686,141687,1,2,0
40379,1,2,141686,141687,141689,1,3,0
40380,5,3,141691,141691,141694,0,3,2
40381,5,3,141696,141696,141699,0,3,2
40382,4,1,141700,141700,141701,0,1,1
40383,6,1,141706,141706,141707,0,1,5
40384,2,3,141708,141708,141711,0,3,1
40385,1,2,141709,141711,141713,2,4,0
40386,6,1,141715,141715,141716,0,1,2
40387,6,1,141721,141721,141722,0,1,5
40388,2,2,141723,141723,141725,0,2,1
40389,2,2,141725,141725,141727,0,2,0
40390,6,2,141731,141731,141733,0,2,4
40391,1,3,141732,141733,141736,1,4,0
40392,2,2,141734,141736,141738,2,4,0
40393,6,2,141740,141740,141742,0,2,2
40394,2,1,141742,141742,141743,0,1,0
40395,1,1,141743,141743,141744,0,1,0
40396,1,3,141744,141744,141747,0,3,0
40397,5,3,141749,141749,141752,0,3,2
40398,4,1,141753,141753,141754,0,1,1
40399,4,1,141757,141757,141758,0,1,3
40400,4,1,141761,141761,141762,0,1,3
40401,2,1,141763,141763,141764,0,1,1
40402,6,3,141769,141769,141772,0,3,5
40403,1,3,141770,141772,141775,2,5,0
40404,6,2,141776,141776,141778,0,2,1
40405,4,3,141780,141780,141783,0,3,2
40406,1,2,141781,141783,141785,2,4,0
40407,2,2,141783,141785,141787,2,4,0
40408,3,1,141786,141787,141788,1,2,0
40409,4,1,141790,141790,141791,0,1,2
40410,4,3,141794,141794,141797,0,3,3
40411,3,1,141797,141797,141798,0,1,0
40412,5,3,141802,141802,141805,0,3,4
40413,4,2,141806,141806,141808,0,2,1
40414,2,3,141808,141808,141811,0,3,0
40415,5,1,141813,141813,141814,0,1,2
40416,3,1,141816,141816,141817,0,1,2
40417,5,2,141821,141821,141823,0,2,4
40418,4,2,141825,141825,141827,0,2,2
40419,5,2,141830,141830,141832,0,2,3
40420,4,2,141834,141834,141836,0,2,2
40421,4,2,141838,141838,141840,0,2,2
40422,2,3,141840,141840,141843,0,3,0
40423,5,1,141845,141845,141846,0,1,2
40424,3,1,141848,141848,141849,0,1,2
40425,4,2,141852,141852,141854,0,2,3
40426,1,2,141853,141854,141856,1,3,0
40427,6,2,141859,141859,141861,0,2,3
40428,1,2,141860,141861,141863,1,3,0
40429,6,3,141866,141866,141869,0,3,3
40430,5,3,141871,141871,141874,0,3,2
40431,4,1,141875,141875,141876,0,1,1
40432,6,1,141881,141881,141882,0,1,5
40433,5,3,141886,141886,141889,0,3,4
40434,1,2,141887,141889,141891,2,4,0
40435,5,2,141892,141892,141894,0,2,1
40436,6,1,141898,141898,141899,0,1,4
40437,1,1,141899,141899,141900,0,1,0
40438,3,2,141902,141902,141904,0,2,2
40439,6,1,141908,141908,141909,0,1,4
40440,3,3,141911,141911,141914,0,3,2
40441,5,1,141916,141916,141917,0,1,2
40442,6,1,141922,141922,141923,0,1,5
40443,3,1,141925,141925,141926,0,1,2
40444,1,3,141926,141926,141929,0,3,0
40445,3,3,141929,141929,141932,0,3,0
40446,3,3,141932,141932,141935,0,3,0
40447,6,2,141938,141938,141940,0,2,3
40448,5,3,141943,141943,141946,0,3,3
40449,5,1,141948,141948,141949,0,1,2
40450,3,1,141951,141951,141952,0,1,2
40451,5,1,141956,141956,141957,0,1,4
40452,2,1,141958,141958,141959,0,1,1
40453,2,2,141960,141960,141962,0,2,1
40454,3,2,141963,141963,141965,0,2,1
40455,4,1,141967,141967,141968,0,1,2
40456,1,3,141968,141968,141971,0,3,0
40457,4,1,141972,141972,141973,0,1,1
40458,3,2,141975,141975,141977,0,2,2
40459,2,3,141977,141977,141980,0,3,0
40460,2,2,141979,141980,141982,1,3,0
40461,3,3,141982,141982,141985,0,3,0
40462,5,3,141987,141987,141990,0,3,2
40463,3,3,141990,141990,141993,0,3,0
40464,3,3,141993,141993,141996,0,3,0
40465,6,1,141999,141999,142000,0,1,3
40466,4,1,142003,142003,142004,0,1,3
40467,6,3,142009,142009,142012,0,3,5
40468,3,2,142012,142012,142014,0,2,0
40469,4,1,142016,142016,142017,0,1,2
40470,1,3,142017,142017,142020,0,3,0
40471,1,1,142018,142020,142021,2,3,0
40472,6,2,142024,142024,142026,0,2,3
40473,2,3,142026,142026,142029,0,3,0
40474,2,3,142028,142029,142032,1,4,0
40475,4,3,142032,142032,142035,0,3,0
40476,4,3,142036,142036,142039,0,3,1
40477,3,3,142039,142039,142042,0,3,0
40478,5,2,142044,142044,142046,0,2,2
40479,2,2,142046,142046,142048,0,2,0
40480,4,2,142050,142050,142052,0,2,2
40481,5,3,142055,142055,142058,0,3,3
40482,1,1,142056,142058,142059,2,3,0
40483,1,2,142057,142059,142061,2,4,0
40484,2,1,142059,142061,142062,2,3,0
40485,2,3,142061,142062,142065,1,4,0
40486,1,3,142062,142065,142068,3,6,0
40487,4,2,142066,142068,142070,2,4,0
40488,5,1,142071,142071,142072,0,1,1
40489,2,1,142073,142073,142074,0,1,1
40490,2,1,142075,142075,142076,0,1,1
40491,2,2,142077,142077,142079,0,2,1
40492,3,2,142080,142080,142082,0,2,1
40493,1,2,142081,142082,142084,1,3,0
40494,6,1,142087,142087,142088,0,1,3
40495,5,3,142092,142092,142095,0,3,4
40496,1,2,142093,142095,142097,2,4,0
40497,5,3,142098,142098,142101,0,3,1
40498,1,2,142099,142101,142103,2,4,0
40499,5,3,142104,142104,142107,0,3,1
40500,4,1,142108,142108,142109,0,1,1
40501,1,3,142109,142109,142112,0,3,0
40502,3,3,142112,142112,142115,0,3,0
40503,3,2,142115,142115,142117,0,2,0
40504,3,2,142118,142118,142120,0,2,1
40505,4,3,142122,142122,142125,0,3,2
40506,5,1,142127,142127,142128,0,1,2
40507,1,3,142128,142128,142131,0,3,0
40508,1,3,142129,142131,142134,2,5,0
40509,6,1,142135,142135,142136,0,1,1
40510,4,2,142139,142139,142141,0,2,3
40511,2,2,142141,142141,142143,0,2,0
40512,3,1,142144,142144,142145,0,1,1
40513,5,1,142149,142149,142150,0,1,4
40514,1,3,142150,142150,142153,0,3,0
40515,5,3,142155,142155,142158,0,3,2
40516,5,2,142160,142160,142162,0,2,2
40517,5,3,142165,142165,142168,0,3,3
40518,6,3,142171,142171,142174,0,3,3
40519,6,3,142177,142177,142180,0,3,3
40520,6,3,142183,142183,142186,0,3,3
40521,5,2,142188,142188,142190,0,2,2
40522,6,3,142194,142194,142197,0,3,4
40523,1,3,142195,142197,142200,2,5,0
40524,3,2,142198,142200,142202,2,4,0
40525,1,2,142199,142202,142204,3,5,0
40526,5,1,142204,142204,142205,0,1,0
40527,1,2,142205,142205,142207,0,2,0
40528,5,3,142210,142210,142213,0,3,3
40529,5,1,142215,142215,142216,0,1,2
40530,1,1,142216,142216,142217,0,1,0
40531,2,2,142218,142218,142220,0,2,1
40532,5,1,142223,142223,142224,0,1,3
40533,1,2,142224,142224,142226,0,2,0
40534,3,2,142227,142227,142229,0,2,1
40535,2,2,142229,142229,142231,0,2,0
40536,6,2,142235,142235,142237,0,2,4
40537,2,1,142237,142237,142238,0,1,0
40538,4,3,142241,142241,142244,0,3,3
40539,1,1,142242,142244,142245,2,3,0
40540,1,2,142243,142245,142247,2,4,0
40541,4,1,142247,142247,142248,0,1,0
40542,3,1,142250,142250,142251,0,1,2
40543,5,2,142255,142255,142257,0,2,4
40544,6,2,142261,142261,142263,0,2,4
40545,2,2,142263,142263,142265,0,2,0
40546,6,3,142269,142269,142272,0,3,4
40547,2,2,142271,142272,142274,1,3,0
40548,1,3,142272,142274,142277,2,5,0
40549,3,3,142275,142277,142280,2,5,0
40550,5,2,142280,142280,142282,0,2,0
40551,4,1,142284,142284,142285,0,1,2
40552,6,2,142290,142290,142292,0,2,5
40553,5,1,142295,142295,142296,0,1,3
40554,4,1,142299,142299,142300,0,1,3
40555,6,2,142305,142305,142307,0,2,5
40556,4,1,142309,142309,142310,0,1,2
40557,3,1,142312,142312,142313,0,1,2
40558,1,1,142313,142313,142314,0,1,0
40559,1,2,142314,142314,142316,0,2,0
40560,2,3,142316,142316,142319,0,3,0
40561,4,3,142320,142320,142323,0,3,1
40562,2,3,142322,142323,142326,1,4,0
40563,3,3,142325,142326,142329,1,4,0
40564,5,3,142330,142330,142333,0,3,1
40565,1,2,142331,142333,142335,2,4,0
40566,3,3,142334,142335,142338,1,4,0
40567,6,3,142340,142340,142343,0,3,2
40568,1,3,142341,142343,142346,2,5,0
40569,6,3,142347,142347,142350,0,3,1
40570,2,1,142349,142350,142351,1,2,0
40571,1,3,142350,142351,142354,1,4,0
40572,1,3,142351,142354,142357,3,6,0
40573,5,1,142356,142357,142358,1,2,0
40574,4,1,142360,142360,142361,0,1,2
40575,2,2,142362,142362,142364,0,2,1
40576,6,2,142368,142368,142370,0,2,4
40577,5,3,142373,142373,142376,0,3,3
40578,4,1,142377,142377,142378,0,1,1
40579,5,3,142382,142382,142385,0,3,4
40580,2,2,142384,142385,142387,1,3,0
40581,5,2,142389,142389,142391,0,2,2
40582,2,2,142391,142391,142393,0,2,0
40583,5,3,142396,142396,142399,0,3,3
40584,1,2,142397,142399,142401,2,4,0
40585,6,1,142403,142403,142404,0,1,2
40586,4,3,142407,142407,142410,0,3,3
40587,1,2,142408,142410,142412,2,4,0
40588,4,2,142412,142412,142414,0,2,0
40589,2,3,142414,142414,142417,0,3,0
40590,3,2,142417,142417,142419,0,2,0
40591,1,2,142418,142419,142421,1,3,0
40592,5,3,142423,142423,142426,0,3,2
40593,2,3,142425,142426,142429,1,4,0
40594,1,1,142426,142429,142430,3,4,0
40595,4,1,142430,142430,142431,0,1,0
40596,4,3,142434,142434,142437,0,3,3
40597,1,2,142435,142437,142439,2,4,0
40598,3,1,142438,142439,142440,1,2,0
40599,4,2,142442,142442,142444,0,2,2
40600,3,1,142445,142445,142446,0,1,1
40601,4,3,142449,142449,142452,0,3,3
40602,4,1,142453,142453,142454,0,1,1
40603,5,2,142458,142458,142460,0,2,4
40604,3,3,142461,142461,142464,0,3,1
40605,6,2,142467,142467,142469,0,2,3
40606,5,3,142472,142472,142475,0,3,3
40607,4,2,142476,142476,142478,0,2,1
40608,1,2,142477,142478,142480,1,3,0
40609,5,1,142482,142482,142483,0,1,2
40610,1,1,142483,142483,142484,0,1,0
40611,1,1,142484,142484,142485,0,1,0
40612,3,3,142487,142487,142490,0,3,2
40613,5,1,142492,142492,142493,0,1,2
40614,4,2,142496,142496,142498,0,2,3
40615,1,2,142497,142498,142500,1,3,0
40616,4,3,142501,142501,142504,0,3,1
40617,4,2,142505,142505,142507,0,2,1
40618,3,3,142508,142508,142511,0,3,1
40619,5,3,142513,142513,142516,0,3,2
40620,4,1,142517,142517,142518,0,1,1
40621,5,3,142522,142522,142525,0,3,4
40622,5,3,142527,142527,142530,0,3,2
40623,4,3,142531,142531,142534,0,3,1
40624,6,3,142537,142537,142540,0,3,3
40625,1,2,142538,142540,142542,2,4,0
40626,6,1,142544,142544,142545,0,1,2
40627,4,3,142548,142548,142551,0,3,3
40628,3,1,142551,142551,142552,0,1,0
40629,3,3,142554,142554,142557,0,3,2
40630,3,3,142557,142557,142560,0,3,0
40631,1,3,142558,142560,142563,2,5,0
40632,5,1,142563,142563,142564,0,1,0
40633,3,1,142566,142566,142567,0,1,2
40634,5,1,142571,142571,142572,0,1,4
40635,5,2,142576,142576,142578,0,2,4
40636,4,3,142580,142580,142583,0,3,2
40637,5,3,142585,142585,142588,0,3,2
40638,5,3,142590,142590,142593,0,3,2
40639,6,3,142596,142596,142599,0,3,3
40640,6,3,142602,142602,142605,0,3,3
40641,1,2,142603,142605,142607,2,4,0
40642,6,1,142609,142609,142610,0,1,2
40643,6,2,142615,142615,142617,0,2,5
40644,5,1,142620,142620,142621,0,1,3
40645,2,1,142622,142622,142623,0,1,1
40646,5,1,142627,142627,142628,0,1,4
40647,6,2,142633,142633,142635,0,2,5
40648,6,1,142639,142639,142640,0,1,4
40649,1,2,142640,142640,142642,0,2,0
40650,4,3,142644,142644,142647,0,3,2
40651,6,3,142650,142650,142653,0,3,3
40652,4,2,142654,142654,142656,0,2,1
40653,1,3,142655,142656,142659,1,4,0
40654,2,2,142657,142659,142661,2,4,0
40655,3,3,142660,142661,142664,1,4,0
40656,4,3,142664,142664,142667,0,3,0
40657,2,2,142666,142667,142669,1,3,0
40658,4,3,142670,142670,142673,0,3,1
40659,5,3,142675,142675,142678,0,3,2
40660,3,3,142678,142678,142681,0,3,0
40661,2,3,142680,142681,142684,1,4,0
40662,1,2,142681,142684,142686,3,5,0
40663,6,2,142687,142687,142689,0,2,1
40664,4,2,142691,142691,142693,0,2,2
40665,4,2,142695,142695,142697,0,2,2
40666,4,1,142699,142699,142700,0,1,2
40667,1,2,142700,142700,142702,0,2,0
40668,3,3,142703,142703,142706,0,3,1
40669,4,3,142707,142707,142710,0,3,1
40670,1,2,142708,142710,142712,2,4,0
40671,1,3,142709,142712,142715,3,6,0
40672,4,3,142713,142715,142718,2,5,0
40673,1,1,142714,142718,142719,4,5,0
40674,1,2,142715,142719,142721,4,6,0
40675,6,2,142721,142721,142723,0,2,0
40676,3,1,142724,142724,142725,0,1,1
40677,1,3,142725,142725,142728,0,3,0
40678,5,2,142730,142730,142732,0,2,2
40679,1,2,142731,142732,142734,1,3,0
40680,6,2,142737,142737,142739,0,2,3
40681,3,2,142740,142740,142742,0,2,1
40682,5,3,142745,142745,142748,0,3,3
40683,5,3,142750,142750,142753,0,3,2
40684,5,1,142755,142755,142756,0,1,2
40685,3,1,142758,142758,142759,0,1,2
40686,6,3,142764,142764,142767,0,3,5
40687,5,3,142769,142769,142772,0,3,2
40688,2,1,142771,142772,142773,1,2,0
40689,3,3,142774,142774,142777,0,3,1
40690,3,2,142777,142777,142779,0,2,0
40691,5,1,142782,142782,142783,0,1,3
40692,1,3,142783,142783,142786,0,3,0
40693,5,2,142788,142788,142790,0,2,2
40694,1,2,142789,142790,142792,1,3,0
40695,4,1,142793,142793,142794,0,1,1
40696,4,2,142797,142797,142799,0,2,3
40697,1,3,142798,142799,142802,1,4,0
40698,5,1,142803,142803,142804,0,1,1
40699,4,1,142807,142807,142808,0,1,3
40700,2,1,142809,142809,142810,0,1,1
40701,5,1,142814,142814,142815,0,1,4
40702,4,3,142818,142818,142821,0,3,3
40703,1,1,142819,142821,142822,2,3,0
40704,5,3,142824,142824,142827,0,3,2
40705,5,1,142829,142829,142830,0,1,2
40706,4,3,142833,142833,142836,0,3,3
40707,6,1,142839,142839,142840,0,1,3
40708,4,3,142843,142843,142846,0,3,3
40709,5,3,142848,142848,142851,0,3,2
40710,3,3,142851,142851,142854,0,3,0
40711,2,3,142853,142854,142857,1,4,0
40712,6,3,142859,142859,142862,0,3,2
40713,5,1,142864,142864,142865,0,1,2
40714,5,1,142869,142869,142870,0,1,4
40715,3,2,142872,142872,142874,0,2,2
40716,4,2,142876,142876,142878,0,2,2
40717,1,1,142877,142878,142879,1,2,0
40718,4,1,142881,142881,142882,0,1,2
40719,6,1,142887,142887,142888,0,1,5
40720,5,2,142892,142892,142894,0,2,4
40721,4,3,142896,142896,142899,0,3,2
40722,3,3,142899,142899,142902,0,3,0
40723,3,2,142902,142902,142904,0,2,0
40724,3,2,142905,142905,142907,0,2,1
40725,5,1,142910,142910,142911,0,1,3
40726,5,2,142915,142915,142917,0,2,4
40727,6,3,142921,142921,142924,0,3,4
40728,2,1,142923,142924,142925,1,2,0
40729,1,1,142924,142925,142926,1,2,0
40730,5,3,142929,142929,142932,0,3,3
40731,6,2,142935,142935,142937,0,2,3
40732,6,2,142941,142941,142943,0,2,4
40733,2,2,142943,142943,142945,0,2,0
40734,5,1,142948,142948,142949,0,1,3
40735,6,2,142954,142954,142956,0,2,5
40736,2,2,142956,142956,142958,0,2,0
40737,5,3,142961,142961,142964,0,3,3
40738,3,1,142964,142964,142965,0,1,0
40739,2,1,142966,142966,142967,0,1,1
40740,6,3,142972,142972,142975,0,3,5
40741,2,2,142974,142975,142977,1,3,0
40742,3,1,142977,142977,142978,0,1,0
40743,2,3,142979,142979,142982,0,3,1
40744,2,2,142981,142982,142984,1,3,0
40745,4,3,142985,142985,142988,0,3,1
40746,2,1,142987,142988,142989,1,2,0
40747,1,1,142988,142989,142990,1,2,0
40748,1,2,142989,142990,142992,1,3,0
40749,5,3,142994,142994,142997,0,3,2
40750,2,3,142996,142997,143000,1,4,0
40751,1,2,142997,143000,143002,3,5,0
40752,5,1,143002,143002,143003,0,1,0
40753,6,1,143008,143008,143009,0,1,5
40754,2,1,143010,143010,143011,0,1,1
40755,4,3,143014,143014,143017,0,3,3
40756,1,1,143015,143017,143018,2,3,0
40757,4,1,143019,143019,143020,0,1,1
40758,1,3,143020,143020,143023,0,3,0
40759,6,2,143026,143026,143028,0,2,3
40760,1,3,143027,143028,143031,1,4,0
40761,2,3,143029,143031,143034,2,5,0
40762,5,3,143034,143034,143037,0,3,0
40763,3,1,143037,143037,143038,0,1,0
40764,2,3,143039,143039,143042,0,3,1
40765,6,2,143045,143045,143047,0,2,3
40766,1,3,143046,143047,143050,1,4,0
40767,3,3,143049,143050,143053,1,4,0
40768,1,1,143050,143053,143054,3,4,0
40769,6,3,143056,143056,143059,0,3,2
40770,4,3,143060,143060,143063,0,3,1
40771,2,3,143062,143063,143066,1,4,0
40772,2,2,143064,143066,143068,2,4,0
40773,1,2,143065,143068,143070,3,5,0
40774,4,2,143069,143070,143072,1,3,0
40775,2,2,143071,143072,143074,1,3,0
40776,4,3,143075,143075,143078,0,3,1
40777,5,2,143080,143080,143082,0,2,2
40778,3,3,143083,143083,143086,0,3,1
40779,5,3,143088,143088,143091,0,3,2
40780,2,2,143090,143091,143093,1,3,0
40781,4,2,143094,143094,143096,0,2,1
40782,4,1,143098,143098,143099,0,1,2
40783,5,2,143103,143103,143105,0,2,4
40784,4,1,143107,143107,143108,0,1,2
40785,6,1,143113,143113,143114,0,1,5
40786,4,1,143117,143117,143118,0,1,3
40787,2,1,143119,143119,143120,0,1,1
40788,6,3,143125,143125,143128,0,3,5
40789,1,2,143126,143128,143130,2,4,0
40790,5,2,143131,143131,143133,0,2,1
40791,1,1,143132,143133,143134,1,2,0
40792,5,1,143137,143137,143138,0,1,3
40793,1,2,143138,143138,143140,0,2,0
40794,5,3,143143,143143,143146,0,3,3
40795,2,1,143145,143146,143147,1,2,0
40796,6,3,143151,143151,143154,0,3,4
40797,5,3,143156,143156,143159,0,3,2
40798,3,2,143159,143159,143161,0,2,0
40799,5,3,143164,143164,143167,0,3,3
40800,1,3,143165,143167,143170,2,5,0
40801,1,1,143166,143170,143171,4,5,0
40802,3,2,143169,143171,143173,2,4,0
40803,3,1,143172,143173,143174,1,2,0
40804,3,3,143175,143175,143178,0,3,1
40805,3,2,143178,143178,143180,0,2,0
40806,3,1,143181,143181,143182,0,1,1
40807,6,3,143187,143187,143190,0,3,5
40808,1,3,143188,143190,143193,2,5,0
40809,2,2,143190,143193,143195,3,5,0
40810,5,1,143195,143195,143196,0,1,0
40811,2,2,143197,143197,143199,0,2,1
40812,3,2,143200,143200,143202,0,2,1
40813,5,2,143205,143205,143207,0,2,3
40814,5,2,143210,143210,143212,0,2,3
40815,1,3,143211,143212,143215,1,4,0
40816,6,3,143217,143217,143220,0,3,2
40817,6,2,143223,143223,143225,0,2,3
40818,1,3,143224,143225,143228,1,4,0
40819,1,2,143225,143228,143230,3,5,0
40820,6,3,143231,143231,143234,0,3,1
40821,2,2,143233,143234,143236,1,3,0
40822,4,2,143237,143237,143239,0,2,1
40823,5,1,143242,143242,143243,0,1,3
40824,4,3,143246,143246,143249,0,3,3
40825,3,3,143249,143249,143252,0,3,0
40826,1,1,143250,143252,143253,2,3,0
40827,1,2,143251,143253,143255,2,4,0
40828,5,2,143256,143256,143258,0,2,1
40829,5,1,143261,143261,143262,0,1,3
40830,3,3,143264,143264,143267,0,3,2
40831,2,3,143266,143267,143270,1,4,0
40832,1,3,143267,143270,143273,3,6,0
40833,6,1,143273,143273,143274,0,1,0
40834,2,3,143275,143275,143278,0,3,1
40835,2,1,143277,143278,143279,1,2,0
40836,4,2,143281,143281,143283,0,2,2
40837,5,2,143286,143286,143288,0,2,3
40838,5,2,143291,143291,143293,0,2,3
40839,4,3,143295,143295,143298,0,3,2
40840,6,1,143301,143301,143302,0,1,3
40841,1,2,143302,143302,143304,0,2,0
40842,1,1,143303,143304,143305,1,2,0
40843,5,2,143308,143308,143310,0,2,3
40844,2,1,143310,143310,143311,0,1,0
40845,1,2,143311,143311,143313,0,2,0
40846,4,2,143315,143315,143317,0,2,2
40847,1,2,143316,143317,143319,1,3,0
40848,2,3,143318,143319,143322,1,4,0
40849,2,2,143320,143322,143324,2,4,0
40850,2,1,143322,143324,143325,2,3,0
40851,1,2,143323,143325,143327,2,4,0
40852,5,1,143328,143328,143329,0,1,1
40853,5,1,143333,143333,143334,0,1,4
40854,6,1,143339,143339,143340,0,1,5
40855,6,3,143345,143345,143348,0,3,5
40856,6,1,143351,143351,143352,0,1,3
40857,1,1,143352,143352,143353,0,1,0
40858,3,2,143355,143355,143357,0,2,2
40859,1,3,143356,143357,143360,1,4,0
40860,3,1,143359,143360,143361,1,2,0
40861,4,3,143363,143363,143366,0,3,2
40862,3,1,143366,143366,143367,0,1,0
40863,5,3,143371,143371,143374,0,3,4
40864,6,2,143377,143377,143379,0,2,3
40865,2,1,143379,143379,143380,0,1,0
40866,6,3,143385,143385,143388,0,3,5
40867,4,3,143389,143389,143392,0,3,1
40868,6,3,143395,143395,143398,0,3,3
40869,1,3,143396,143398,143401,2,5,0
40870,3,2,143399,143401,143403,2,4,0
40871,6,1,143405,143405,143406,0,1,2
40872,5,3,143410,143410,143413,0,3,4
40873,1,2,143411,143413,143415,2,4,0
40874,1,2,143412,143415,143417,3,5,0
40875,5,3,143417,143417,143420,0,3,0
40876,2,1,143419,143420,143421,1,2,0
40877,2,1,143421,143421,143422,0,1,0
40878,6,2,143427,143427,143429,0,2,5
40879,1,1,143428,143429,143430,1,2,0
40880,3,1,143431,143431,143432,0,1,1
40881,2,3,143433,143433,143436,0,3,1
40882,6,3,143439,143439,143442,0,3,3
40883,5,2,143444,143444,143446,0,2,2
40884,5,3,143449,143449,143452,0,3,3
40885,5,2,143454,143454,143456,0,2,2
40886,3,3,143457,143457,143460,0,3,1
40887,1,2,143458,143460,143462,2,4,0
40888,5,3,143463,143463,143466,0,3,1
40889,6,2,143469,143469,143471,0,2,3
40890,3,2,143472,143472,143474,0,2,1
40891,3,1,143475,143475,143476,0,1,1
40892,6,3,143481,143481,143484,0,3,5
40893,1,3,143482,143484,143487,2,5,0
40894,4,2,143486,143487,143489,1,3,0
40895,1,1,143487,143489,143490,2,3,0
40896,2,1,143489,143490,143491,1,2,0
40897,4,3,143493,143493,143496,0,3,2
40898,5,1,143498,143498,143499,0,1,2
40899,1,2,143499,143499,143501,0,2,0
40900,1,2,143500,143501,143503,1,3,0
40901,5,1,143505,143505,143506,0,1,2
40902,3,3,143508,143508,143511,0,3,2
40903,6,3,143514,143514,143517,0,3,3
40904,2,1,143516,143517,143518,1,2,0
40905,2,1,143518,143518,143519,0,1,0
40906,1,2,143519,143519,143521,0,2,0
40907,1,1,143520,143521,143522,1,2,0
40908,5,2,143525,143525,143527,0,2,3
40909,5,2,143530,143530,143532,0,2,3
40910,3,2,143533,143533,143535,0,2,1
40911,2,1,143535,143535,143536,0,1,0
40912,1,1,143536,143536,143537,0,1,0
40913,2,3,143538,143538,143541,0,3,1
40914,5,2,143543,143543,143545,0,2,2
40915,5,3,143548,143548,143551,0,3,3
40916,4,1,143552,143552,143553,0,1,1
40917,6,3,143558,143558,143561,0,3,5
40918,4,1,143562,143562,143563,0,1,1
40919,6,2,143568,143568,143570,0,2,5
40920,1,2,143569,143570,143572,1,3,0
40921,5,1,143574,143574,143575,0,1,2
40922,2,1,143576,143576,143577,0,1,1
40923,1,2,143577,143577,143579,0,2,0
40924,2,1,143579,143579,143580,0,1,0
40925,6,3,143585,143585,143588,0,3,5
40926,4,3,143589,143589,143592,0,3,1
40927,5,3,143594,143594,143597,0,3,2
40928,2,2,143596,143597,143599,1,3,0
40929,1,2,143597,143599,143601,2,4,0
40930,4,3,143601,143601,143604,0,3,0
40931,2,1,143603,143604,143605,1,2,0
40932,4,3,143607,143607,143610,0,3,2
40933,6,2,143613,143613,143615,0,2,3
40934,2,2,143615,143615,143617,0,2,0
40935,1,3,143616,143617,143620,1,4,0
40936,2,2,143618,143620,143622,2,4,0
40937,3,1,143621,143622,143623,1,2,0
40938,6,1,143627,143627,143628,0,1,4
40939,1,2,143628,143628,143630,0,2,0
40940,5,1,143633,143633,143634,0,1,3
40941,4,2,143637,143637,143639,0,2,3
40942,4,1,143641,143641,143642,0,1,2
40943,6,2,143647,143647,143649,0,2,5
40944,1,1,143648,143649,143650,1,2,0
40945,6,2,143654,143654,143656,0,2,4
40946,3,3,143657,143657,143660,0,3,1
40947,6,3,143663,143663,143666,0,3,3
40948,2,1,143665,143666,143667,1,2,0
40949,3,1,143668,143668,143669,0,1,1
40950,3,1,143671,143671,143672,0,1,2
40951,2,3,143673,143673,143676,0,3,1
40952,3,3,143676,143676,143679,0,3,0
40953,1,1,143677,143679,143680,2,3,0
40954,5,1,143682,143682,143683,0,1,2
40955,1,1,143683,143683,143684,0,1,0
40956,5,3,143688,143688,143691,0,3,4
40957,4,1,143692,143692,143693,0,1,1
40958,3,1,143695,143695,143696,0,1,2
40959,1,2,143696,143696,143698,0,2,0
40960,4,3,143700,143700,143703,0,3,2
40961,5,3,143705,143705,143708,0,3,2
40962,5,2,143710,143710,143712,0,2,2
40963,2,3,143712,143712,143715,0,3,0
40964,5,2,143717,143717,143719,0,2,2
40965,2,2,143719,143719,143721,0,2,0
40966,5,2,143724,143724,143726,0,2,3
40967,2,1,143726,143726,143727,0,1,0
40968,3,3,143729,143729,143732,0,3,2
40969,5,3,143734,143734,143737,0,3,2
40970,1,2,143735,143737,143739,2,4,0
40971,3,2,143738,143739,143741,1,3,0
40972,2,1,143740,143741,143742,1,2,0
40973,2,1,143742,143742,143743,0,1,0
40974,3,3,143745,143745,143748,0,3,2
40975,6,2,143751,143751,143753,0,2,3
40976,3,3,143754,143754,143757,0,3,1
40977,6,2,143760,143760,143762,0,2,3
40978,5,2,143765,143765,143767,0,2,3
40979,1,3,143766,143767,143770,1,4,0
40980,6,3,143772,143772,143775,0,3,2
40981,1,3,143773,143775,143778,2,5,0
40982,3,3,143776,143778,143781,2,5,0
40983,1,3,143777,143781,143784,4,7,0
40984,4,3,143781,143784,143787,3,6,0
40985,6,2,143787,143787,143789,0,2,0
40986,4,1,143791,143791,143792,0,1,2
40987,2,1,143793,143793,143794,0,1,1
40988,1,2,143794,143794,143796,0,2,0
40989,3,3,143797,143797,143800,0,3,1
40990,5,1,143802,143802,143803,0,1,2
40991,6,1,143808,143808,143809,0,1,5
40992,4,1,143812,143812,143813,0,1,3
40993,4,3,143816,143816,143819,0,3,3
40994,3,1,143819,143819,143820,0,1,0
40995,5,1,143824,143824,143825,0,1,4
40996,6,3,143830,143830,143833,0,3,5
40997,6,2,143836,143836,143838,0,2,3
40998,3,3,143839,143839,143842,0,3,1
40999,4,3,143843,143843,143846,0,3,1
41000,5,2,143848,143848,143850,0,2,2
41001,1,2,143849,143850,143852,1,3,0
41002,4,2,143853,143853,143855,0,2,1
41003,1,2,143854,143855,143857,1,3,0
41004,3,2,143857,143857,143859,0,2,0
41005,6,1,143863,143863,143864,0,1,4
41006,3,2,143866,143866,143868,0,2,2
41007,2,1,143868,143868,143869,0,1,0
41008,4,3,143872,143872,143875,0,3,3
41009,4,1,143876,143876,143877,0,1,1
41010,2,1,143878,143878,143879,0,1,1
41011,6,3,143884,143884,143887,0,3,5
41012,1,1,143885,143887,143888,2,3,0
41013,1,1,143886,143888,143889,2,3,0
41014,4,2,143890,143890,143892,0,2,1
41015,6,2,143896,143896,143898,0,2,4
41016,4,2,143900,143900,143902,0,2,2
41017,3,1,143903,143903,143904,0,1,1
41018,5,3,143908,143908,143911,0,3,4
41019,2,1,143910,143911,143912,1,2,0
41020,2,1,143912,143912,143913,0,1,0
41021,5,2,143917,143917,143919,0,2,4
41022,3,1,143920,143920,143921,0,1,1
41023,5,2,143925,143925,143927,0,2,4
41024,2,3,143927,143927,143930,0,3,0
41025,5,3,143932,143932,143935,0,3,2
41026,6,2,143938,143938,143940,0,2,3
41027,5,2,143943,143943,143945,0,2,3
41028,5,2,143948,143948,143950,0,2,3
41029,5,3,143953,143953,143956,0,3,3
41030,4,2,143957,143957,143959,0,2,1
41031,6,1,143963,143963,143964,0,1,4
41032,4,3,143967,143967,143970,0,3,3
41033,2,1,143969,143970,143971,1,2,0
41034,1,2,143970,143971,143973,1,3,0
41035,1,2,143971,143973,143975,2,4,0
41036,6,3,143977,143977,143980,0,3,2
41037,3,1,143980,143980,143981,0,1,0
41038,6,3,143986,143986,143989,0,3,5
41039,1,1,143987,143989,143990,2,3,0
41040,1,1,143988,143990,143991,2,3,0
41041,5,3,143993,143993,143996,0,3,2
41042,2,3,143995,143996,143999,1,4,0
41043,4,3,143999,143999,144002,0,3,0
41044,1,2,144000,144002,144004,2,4,0
41045,4,2,144004,144004,144006,0,2,0
41046,2,3,144006,144006,144009,0,3,0
41047,1,1,144007,144009,144010,2,3,0
41048,4,1,144011,144011,144012,0,1,1
41049,5,3,144016,144016,144019,0,3,4
41050,4,2,144020,144020,144022,0,2,1
41051,1,3,144021,144022,144025,1,4,0
41052,5,3,144026,144026,144029,0,3,1
41053,3,1,144029,144029,144030,0,1,0
41054,6,3,144035,144035,144038,0,3,5
41055,6,1,144041,144041,144042,0,1,3
41056,3,2,144044,144044,144046,0,2,2
41057,2,1,144046,144046,144047,0,1,0
41058,5,3,144051,144051,144054,0,3,4
41059,3,2,144054,144054,144056,0,2,0
41060,5,1,144059,144059,144060,0,1,3
41061,4,2,144063,144063,144065,0,2,3
41062,3,2,144066,144066,144068,0,2,1
41063,3,2,144069,144069,144071,0,2,1
41064,4,3,144073,144073,144076,0,3,2
41065,6,2,144079,144079,144081,0,2,3
41066,4,3,144083,144083,144086,0,3,2
41067,3,2,144086,144086,144088,0,2,0
41068,1,1,144087,144088,144089,1,2,0
41069,1,3,144088,144089,144092,1,4,0
41070,3,1,144091,144092,144093,1,2,0
41071,2,2,144093,144093,144095,0,2,0
41072,3,1,144096,144096,144097,0,1,1
41073,5,3,144101,144101,144104,0,3,4
41074,4,2,144105,144105,144107,0,2,1
41075,5,2,144110,144110,144112,0,2,3
41076,1,3,144111,144112,144115,1,4,0
41077,1,3,144112,144115,144118,3,6,0
41078,2,1,144114,144118,144119,4,5,0
41079,6,2,144120,144120,144122,0,2,1
41080,5,1,144125,144125,144126,0,1,3
41081,3,2,144128,144128,144130,0,2,2
41082,5,3,144133,144133,144136,0,3,3
41083,1,2,144134,144136,144138,2,4,0
41084,1,2,144135,144138,144140,3,5,0
41085,1,3,144136,144140,144143,4,7,0
41086,3,3,144139,144143,144146,4,7,0
41087,2,3,144141,144146,144149,5,8,0
41088,5,2,144146,144149,144151,3,5,0
41089,4,3,144150,144151,144154,1,4,0
41090,5,1,144155,144155,144156,0,1,1
41091,2,3,144157,144157,144160,0,3,1
41092,6,2,144163,144163,144165,0,2,3
41093,3,1,144166,144166,144167,0,1,1
41094,6,3,144172,144172,144175,0,3,5
41095,5,1,144177,144177,144178,0,1,2
41096,4,2,144181,144181,144183,0,2,3
41097,4,1,144185,144185,144186,0,1,2
41098,1,3,144186,144186,144189,0,3,0
41099,2,3,144188,144189,144192,1,4,0
41100,1,3,144189,144192,144195,3,6,0
41101,3,1,144192,144195,144196,3,4,0
41102,3,1,144195,144196,144197,1,2,0
41103,5,2,144200,144200,144202,0,2,3
41104,1,1,144201,144202,144203,1,2,0
41105,3,3,144204,144204,144207,0,3,1
41106,3,3,144207,144207,144210,0,3,0
41107,5,2,144212,144212,144214,0,2,2
41108,2,3,144214,144214,144217,0,3,0
41109,1,1,144215,144217,144218,2,3,0
41110,1,2,144216,144218,144220,2,4,0
41111,1,1,144217,144220,144221,3,4,0
41112,1,2,144218,144221,144223,3,5,0
41113,3,1,144221,144223,144224,2,3,0
41114,3,2,144224,144224,144226,0,2,0
41115,3,3,144227,144227,144230,0,3,1
41116,4,1,144231,144231,144232,0,1,1
41117,1,1,144232,144232,144233,0,1,0
41118,2,2,144234,144234,144236,0,2,1
41119,6,1,144240,144240,144241,0,1,4
41120,2,3,144242,144242,144245,0,3,1
41121,4,1,144246,144246,144247,0,1,1
41122,2,3,144248,144248,144251,0,3,1
41123,1,2,144249,144251,144253,2,4,0
41124,4,1,144253,144253,144254,0,1,0
41125,2,2,144255,144255,144257,0,2,1
41126,1,1,144256,144257,144258,1,2,0
41127,2,1,144258,144258,144259,0,1,0
41128,6,3,144264,144264,144267,0,3,5
41129,5,2,144269,144269,144271,0,2,2
41130,5,3,144274,144274,144277,0,3,3
41131,1,2,144275,144277,144279,2,4,0
41132,1,2,144276,144279,144281,3,5,0
41133,1,3,144277,144281,144284,4,7,0
41134,4,3,144281,144284,144287,3,6,0
41135,5,3,144286,144287,144290,1,4,0
41136,5,3,144291,144291,144294,0,3,1
41137,5,3,144296,144296,144299,0,3,2
41138,1,2,144297,144299,144301,2,4,0
41139,1,3,144298,144301,144304,3,6,0
41140,3,2,144301,144304,144306,3,5,0
41141,1,2,144302,144306,144308,4,6,0
41142,4,3,144306,144308,144311,2,5,0
41143,4,2,144310,144311,144313,1,3,0
41144,2,3,144312,144313,144316,1,4,0
41145,6,1,144318,144318,144319,0,1,2
41146,6,3,144324,144324,144327,0,3,5
41147,1,2,144325,144327,144329,2,4,0
41148,3,2,144328,144329,144331,1,3,0
41149,1,3,144329,144331,144334,2,5,0
41150,5,2,144334,144334,144336,0,2,0
41151,6,3,144340,144340,144343,0,3,4
41152,5,2,144345,144345,144347,0,2,2
41153,1,1,144346,144347,144348,1,2,0
41154,1,2,144347,144348,144350,1,3,0
41155,5,3,144352,144352,144355,0,3,2
41156,1,1,144353,144355,144356,2,3,0
41157,5,3,144358,144358,144361,0,3,2
41158,1,1,144359,144361,144362,2,3,0
41159,5,2,144364,144364,144366,0,2,2
41160,1,1,144365,144366,144367,1,2,0
41161,3,2,144368,144368,144370,0,2,1
41162,2,1,144370,144370,144371,0,1,0
41163,2,1,144372,144372,144373,0,1,1
41164,3,3,144375,144375,144378,0,3,2
41165,5,2,144380,144380,144382,0,2,2
41166,4,1,144384,144384,144385,0,1,2
41167,1,3,144385,144385,144388,0,3,0
41168,3,3,144388,144388,144391,0,3,0
41169,1,1,144389,144391,144392,2,3,0
41170,6,2,144395,144395,144397,0,2,3
41171,2,1,144397,144397,144398,0,1,0
41172,3,3,144400,144400,144403,0,3,2
41173,6,2,144406,144406,144408,0,2,3
41174,3,3,144409,144409,144412,0,3,1
41175,1,2,144410,144412,144414,2,4,0
41176,2,2,144412,144414,144416,2,4,0
41177,6,3,144418,144418,144421,0,3,2
41178,5,1,144423,144423,144424,0,1,2
41179,1,2,144424,144424,144426,0,2,0
41180,4,1,144428,144428,144429,0,1,2
41181,6,3,144434,144434,144437,0,3,5
41182,3,2,144437,144437,144439,0,2,0
41183,5,1,144442,144442,144443,0,1,3
41184,5,2,144447,144447,144449,0,2,4
41185,6,3,144453,144453,144456,0,3,4
41186,3,1,144456,144456,144457,0,1,0
41187,3,2,144459,144459,144461,0,2,2
41188,5,3,144464,144464,144467,0,3,3
41189,2,2,144466,144467,144469,1,3,0
41190,3,2,144469,144469,144471,0,2,0
41191,5,1,144474,144474,144475,0,1,3
41192,4,3,144478,144478,144481,0,3,3
41193,5,2,144483,144483,144485,0,2,2
41194,5,2,144488,144488,144490,0,2,3
41195,1,2,144489,144490,144492,1,3,0
41196,5,2,144494,144494,144496,0,2,2
41197,2,3,144496,144496,144499,0,3,0
41198,1,3,144497,144499,144502,2,5,0
41199,3,2,144500,144502,144504,2,4,0
41200,3,3,144503,144504,144507,1,4,0
41201,2,1,144505,144507,144508,2,3,0
41202,4,2,144509,144509,144511,0,2,1
41203,6,2,144515,144515,144517,0,2,4
41204,1,2,144516,144517,144519,1,3,0
41205,3,1,144519,144519,144520,0,1,0
41206,4,1,144523,144523,144524,0,1,3
41207,2,1,144525,144525,144526,0,1,1
41208,2,2,144527,144527,144529,0,2,1
41209,1,3,144528,144529,144532,1,4,0
41210,1,1,144529,144532,144533,3,4,0
41211,2,2,144531,144533,144535,2,4,0
41212,6,3,144537,144537,144540,0,3,2
41213,6,2,144543,144543,144545,0,2,3
41214,5,3,144548,144548,144551,0,3,3
41215,6,3,144554,144554,144557,0,3,3
41216,1,1,144555,144557,144558,2,3,0
41217,6,3,144561,144561,144564,0,3,3
41218,3,3,144564,144564,144567,0,3,0
41219,3,1,144567,144567,144568,0,1,0
41220,6,2,144573,144573,144575,0,2,5
41221,1,2,144574,144575,144577,1,3,0
41222,4,2,144578,144578,144580,0,2,1
41223,4,3,144582,144582,144585,0,3,2
41224,4,2,144586,144586,144588,0,2,1
41225,4,2,144590,144590,144592,0,2,2
41226,2,1,144592,144592,144593,0,1,0
41227,2,2,144594,144594,144596,0,2,1
41228,1,3,144595,144596,144599,1,4,0
41229,5,3,144600,144600,144603,0,3,1
41230,3,2,144603,144603,144605,0,2,0
41231,3,3,144606,144606,144609,0,3,1
41232,3,3,144609,144609,144612,0,3,0
41233,2,2,144611,144612,144614,1,3,0
41234,2,3,144613,144614,144617,1,4,0
41235,2,3,144615,144617,144620,2,5,0
41236,3,3,144618,144620,144623,2,5,0
41237,2,1,144620,144623,144624,3,4,0
41238,2,2,144622,144624,144626,2,4,0
41239,6,2,144628,144628,144630,0,2,2
41240,3,3,144631,144631,144634,0,3,1
41241,2,1,144633,144634,144635,1,2,0
41242,1,2,144634,144635,144637,1,3,0
41243,1,1,144635,144637,144638,2,3,0
41244,6,2,144641,144641,144643,0,2,3
41245,3,2,144644,144644,144646,0,2,1
41246,6,1,144650,144650,144651,0,1,4
41247,5,1,144655,144655,144656,0,1,4
41248,3,2,144658,144658,144660,0,2,2
41249,4,2,144662,144662,144664,0,2,2
41250,4,1,144666,144666,144667,0,1,2
41251,5,3,144671,144671,144674,0,3,4
41252,2,3,144673,144674,144677,1,4,0
41253,2,3,144675,144677,144680,2,5,0
41254,3,1,144678,144680,144681,2,3,0
41255,2,2,144680,144681,144683,1,3,0
41256,4,2,144684,144684,144686,0,2,1
41257,2,3,144686,144686,144689,0,3,0
41258,2,1,144688,144689,144690,1,2,0
41259,2,2,144690,144690,144692,0,2,0
41260,2,1,144692,144692,144693,0,1,0
41261,6,2,144698,144698,144700,0,2,5
41262,5,1,144703,144703,144704,0,1,3
41263,1,1,144704,144704,144705,0,1,0
41264,6,1,144710,144710,144711,0,1,5
41265,4,3,144714,144714,144717,0,3,3
41266,5,3,144719,144719,144722,0,3,2
41267,5,2,144724,144724,144726,0,2,2
41268,5,1,144729,144729,144730,0,1,3
41269,5,2,144734,144734,144736,0,2,4
41270,2,3,144736,144736,144739,0,3,0
41271,3,2,144739,144739,144741,0,2,0
41272,1,1,144740,144741,144742,1,2,0
41273,2,1,144742,144742,144743,0,1,0
41274,6,3,144748,144748,144751,0,3,5
41275,4,2,144752,144752,144754,0,2,1
41276,6,1,144758,144758,144759,0,1,4
41277,4,1,144762,144762,144763,0,1,3
41278,3,3,144765,144765,144768,0,3,2
41279,1,2,144766,144768,144770,2,4,0
41280,4,3,144770,144770,144773,0,3,0
41281,2,3,144772,144773,144776,1,4,0
41282,6,3,144778,144778,144781,0,3,2
41283,2,3,144780,144781,144784,1,4,0
41284,2,1,144782,144784,144785,2,3,0
41285,3,2,144785,144785,144787,0,2,0
41286,4,1,144789,144789,144790,0,1,2
41287,3,2,144792,144792,144794,0,2,2
41288,2,1,144794,144794,144795,0,1,0
41289,1,3,144795,144795,144798,0,3,0
41290,4,2,144799,144799,144801,0,2,1
41291,4,2,144803,144803,144805,0,2,2
41292,3,3,144806,144806,144809,0,3,1
41293,3,1,144809,144809,144810,0,1,0
41294,6,1,144815,144815,144816,0,1,5
41295,6,2,144821,144821,144823,0,2,5
41296,2,3,144823,144823,144826,0,3,0
41297,3,3,144826,144826,144829,0,3,0
41298,3,3,144829,144829,144832,0,3,0
41299,3,2,144832,144832,144834,0,2,0
41300,5,2,144837,144837,144839,0,2,3
41301,2,2,144839,144839,144841,0,2,0
41302,6,3,144845,144845,144848,0,3,4
41303,6,2,144851,144851,144853,0,2,3
41304,1,3,144852,144853,144856,1,4,0
41305,3,1,144855,144856,144857,1,2,0
41306,3,1,144858,144858,144859,0,1,1
41307,4,2,144862,144862,144864,0,2,3
41308,2,2,144864,144864,144866,0,2,0
41309,1,1,144865,144866,144867,1,2,0
41310,5,1,144870,144870,144871,0,1,3
41311,5,2,144875,144875,144877,0,2,4
41312,6,2,144881,144881,144883,0,2,4
41313,2,3,144883,144883,144886,0,3,0
41314,2,3,144885,144886,144889,1,4,0
41315,5,2,144890,144890,144892,0,2,1
41316,3,2,144893,144893,144895,0,2,1
41317,1,2,144894,144895,144897,1,3,0
41318,2,1,144896,144897,144898,1,2,0
41319,2,3,144898,144898,144901,0,3,0
41320,1,1,144899,144901,144902,2,3,0
41321,5,3,144904,144904,144907,0,3,2
41322,4,1,144908,144908,144909,0,1,1
41323,3,3,144911,144911,144914,0,3,2
41324,2,3,144913,144914,144917,1,4,0
41325,6,1,144919,144919,144920,0,1,2
41326,6,1,144925,144925,144926,0,1,5
41327,1,2,144926,144926,144928,0,2,0
41328,3,1,144929,144929,144930,0,1,1
41329,4,3,144933,144933,144936,0,3,3
41330,3,3,144936,144936,144939,0,3,0
41331,1,2,144937,144939,144941,2,4,0
41332,2,2,144939,144941,144943,2,4,0
41333,3,3,144942,144943,144946,1,4,0
41334,5,1,144947,144947,144948,0,1,1
41335,5,1,144952,144952,144953,0,1,4
41336,6,2,144958,144958,144960,0,2,5
41337,4,2,144962,144962,144964,0,2,2
41338,2,2,144964,144964,144966,0,2,0
41339,1,2,144965,144966,144968,1,3,0
41340,2,1,144967,144968,144969,1,2,0
41341,3,2,144970,144970,144972,0,2,1
41342,5,2,144975,144975,144977,0,2,3
41343,6,1,144981,144981,144982,0,1,4
41344,3,2,144984,144984,144986,0,2,2
41345,3,3,144987,144987,144990,0,3,1
41346,3,3,144990,144990,144993,0,3,0
41347,5,2,144995,144995,144997,0,2,2
41348,2,1,144997,144997,144998,0,1,0
41349,1,3,144998,144998,145001,0,3,0
41350,5,2,145003,145003,145005,0,2,2
41351,4,2,145007,145007,145009,0,2,2
41352,4,1,145011,145011,145012,0,1,2
41353,1,3,145012,145012,145015,0,3,0
41354,1,1,145013,145015,145016,2,3,0
41355,6,1,145019,145019,145020,0,1,3
41356,3,1,145022,145022,145023,0,1,2
41357,4,3,145026,145026,145029,0,3,3
41358,6,3,145032,145032,145035,0,3,3
41359,3,2,145035,145035,145037,0,2,0
41360,4,2,145039,145039,145041,0,2,2
41361,3,1,145042,145042,145043,0,1,1
41362,5,3,145047,145047,145050,0,3,4
41363,5,2,145052,145052,145054,0,2,2
41364,6,3,145058,145058,145061,0,3,4
41365,3,3,145061,145061,145064,0,3,0
41366,1,2,145062,145064,145066,2,4,0
41367,1,3,145063,145066,145069,3,6,0
41368,1,2,145064,145069,145071,5,7,0
41369,1,2,145065,145071,145073,6,8,0
41370,2,2,145067,145073,145075,6,8,0
41371,4,1,145071,145075,145076,4,5,0
41372,6,1,145077,145077,145078,0,1,1
41373,5,1,145082,145082,145083,0,1,4
41374,5,1,145087,145087,145088,0,1,4
41375,5,2,145092,145092,145094,0,2,4
41376,2,1,145094,145094,145095,0,1,0
41377,4,1,145098,145098,145099,0,1,3
41378,1,2,145099,145099,145101,0,2,0
41379,4,3,145103,145103,145106,0,3,2
41380,5,2,145108,145108,145110,0,2,2
41381,2,3,145110,145110,145113,0,3,0
41382,5,3,145115,145115,145118,0,3,2
41383,6,1,145121,145121,145122,0,1,3
41384,3,1,145124,145124,145125,0,1,2
41385,3,2,145127,145127,145129,0,2,2
41386,2,1,145129,145129,145130,0,1,0
41387,2,1,145131,145131,145132,0,1,1
41388,1,1,145132,145132,145133,0,1,0
41389,4,1,145136,145136,145137,0,1,3
41390,6,3,145142,145142,145145,0,3,5
41391,4,3,145146,145146,145149,0,3,1
41392,1,3,145147,145149,145152,2,5,0
41393,3,3,145150,145152,145155,2,5,0
41394,4,3,145154,145155,145158,1,4,0
41395,6,3,145160,145160,145163,0,3,2
41396,2,1,145162,145163,145164,1,2,0
41397,1,1,145163,145164,145165,1,2,0
41398,2,1,145165,145165,145166,0,1,0
41399,3,2,145168,145168,145170,0,2,2
41400,1,1,145169,145170,145171,1,2,0
41401,5,1,145174,145174,145175,0,1,3
41402,2,3,145176,145176,145179,0,3,1
41403,5,2,145181,145181,145183,0,2,2
41404,3,3,145184,145184,145187,0,3,1
41405,1,2,145185,145187,145189,2,4,0
41406,2,1,145187,145189,145190,2,3,0
41407,3,1,145190,145190,145191,0,1,0
41408,5,1,145195,145195,145196,0,1,4
41409,6,3,145201,145201,145204,0,3,5
41410,5,1,145206,145206,145207,0,1,2
41411,4,3,145210,145210,145213,0,3,3
41412,3,3,145213,145213,145216,0,3,0
41413,3,3,145216,145216,145219,0,3,0
41414,4,3,145220,145220,145223,0,3,1
41415,6,1,145226,145226,145227,0,1,3
41416,3,2,145229,145229,145231,0,2,2
41417,6,2,145235,145235,145237,0,2,4
41418,4,2,145239,145239,145241,0,2,2
41419,6,2,145245,145245,145247,0,2,4
41420,4,2,145249,145249,145251,0,2,2
41421,6,3,145255,145255,145258,0,3,4
41422,1,1,145256,145258,145259,2,3,0
41423,1,1,145257,145259,145260,2,3,0
41424,4,1,145261,145261,145262,0,1,1
41425,6,1,145267,145267,145268,0,1,5
41426,2,1,145269,145269,145270,0,1,1
41427,5,2,145274,145274,145276,0,2,4
41428,2,1,145276,145276,145277,0,1,0
41429,1,2,145277,145277,145279,0,2,0
41430,4,2,145281,145281,145283,0,2,2
41431,6,3,145287,145287,145290,0,3,4
41432,5,2,145292,145292,145294,0,2,2
41433,2,1,145294,145294,145295,0,1,0
41434,5,1,145299,145299,145300,0,1,4
41435,3,2,145302,145302,145304,0,2,2
41436,3,3,145305,145305,145308,0,3,1
41437,3,1,145308,145308,145309,0,1,0
41438,3,1,145311,145311,145312,0,1,2
41439,2,3,145313,145313,145316,0,3,1
41440,1,2,145314,145316,145318,2,4,0
41441,2,3,145316,145318,145321,2,5,0
41442,2,1,145318,145321,145322,3,4,0
41443,2,2,145320,145322,145324,2,4,0
41444,5,1,145325,145325,145326,0,1,1
41445,1,2,145326,145326,145328,0,2,0
41446,3,2,145329,145329,145331,0,2,1
41447,4,2,145333,145333,145335,0,2,2
41448,1,3,145334,145335,145338,1,4,0
41449,4,2,145338,145338,145340,0,2,0
41450,3,3,145341,145341,145344,0,3,1
41451,6,3,145347,145347,145350,0,3,3
41452,1,1,145348,145350,145351,2,3,0
41453,6,1,145354,145354,145355,0,1,3
41454,3,3,145357,145357,145360,0,3,2
41455,5,3,145362,145362,145365,0,3,2
41456,2,3,145364,145365,145368,1,4,0
41457,5,3,145369,145369,145372,0,3,1
41458,5,3,145374,145374,145377,0,3,2
41459,4,1,145378,145378,145379,0,1,1
41460,3,3,145381,145381,145384,0,3,2
41461,1,2,145382,145384,145386,2,4,0
41462,6,1,145388,145388,145389,0,1,2
41463,6,3,145394,145394,145397,0,3,5
41464,1,2,145395,145397,145399,2,4,0
41465,3,2,145398,145399,145401,1,3,0
41466,6,3,145404,145404,145407,0,3,3
41467,3,2,145407,145407,145409,0,2,0
41468,3,3,145410,145410,145413,0,3,1
41469,3,3,145413,145413,145416,0,3,0
41470,2,3,145415,145416,145419,1,4,0
41471,4,3,145419,145419,145422,0,3,0
41472,2,3,145421,145422,145425,1,4,0
41473,6,1,145427,145427,145428,0,1,2
41474,6,3,145433,145433,145436,0,3,5
41475,1,3,145434,145436,145439,2,5,0
41476,2,3,145436,145439,145442,3,6,0
41477,5,3,145441,145442,145445,1,4,0
41478,4,3,145445,145445,145448,0,3,0
41479,1,1,145446,145448,145449,2,3,0
41480,1,1,145447,145449,145450,2,3,0
41481,2,2,145449,145450,145452,1,3,0
41482,6,3,145455,145455,145458,0,3,3
41483,6,2,145461,145461,145463,0,2,3
41484,4,2,145465,145465,145467,0,2,2
41485,5,1,145470,145470,145471,0,1,3
41486,3,2,145473,145473,145475,0,2,2
41487,5,3,145478,145478,145481,0,3,3
41488,6,3,145484,145484,145487,0,3,3
41489,4,1,145488,145488,145489,0,1,1
41490,3,1,145491,145491,145492,0,1,2
41491,4,3,145495,145495,145498,0,3,3
41492,2,3,145497,145498,145501,1,4,0
41493,4,1,145501,145501,145502,0,1,0
41494,3,1,145504,145504,145505,0,1,2
41495,4,2,145508,145508,145510,0,2,3
41496,2,1,145510,145510,145511,0,1,0
41497,2,2,145512,145512,145514,0,2,1
41498,5,2,145517,145517,145519,0,2,3
41499,1,3,145518,145519,145522,1,4,0
41500,1,3,145519,145522,145525,3,6,0
41501,4,1,145523,145525,145526,2,3,0
41502,1,3,145524,145526,145529,2,5,0
41503,2,2,145526,145529,145531,3,5,0
41504,5,2,145531,145531,145533,0,2,0
41505,4,1,145535,145535,145536,0,1,2
41506,6,2,145541,145541,145543,0,2,5
41507,1,1,145542,145543,145544,1,2,0
41508,4,1,145546,145546,145547,0,1,2
41509,2,3,145548,145548,145551,0,3,1
41510,1,1,145549,145551,145552,2,3,0
41511,3,3,145552,145552,145555,0,3,0
41512,2,3,145554,145555,145558,1,4,0
41513,2,2,145556,145558,145560,2,4,0
41514,1,3,145557,145560,145563,3,6,0
41515,4,1,145561,145563,145564,2,3,0
41516,2,3,145563,145564,145567,1,4,0
41517,2,3,145565,145567,145570,2,5,0
41518,4,3,145569,145570,145573,1,4,0
41519,5,3,145574,145574,145577,0,3,1
41520,2,1,145576,145577,145578,1,2,0
41521,2,2,145578,145578,145580,0,2,0
41522,3,1,145581,145581,145582,0,1,1
41523,2,1,145583,145583,145584,0,1,1
41524,2,3,145585,145585,145588,0,3,1
41525,1,1,145586,145588,145589,2,3,0
41526,6,1,145592,145592,145593,0,1,3
41527,4,1,145596,145596,145597,0,1,3
41528,3,1,145599,145599,145600,0,1,2
41529,4,2,145603,145603,145605,0,2,3
41530,1,2,145604,145605,145607,1,3,0
41531,2,3,145606,145607,145610,1,4,0
41532,2,1,145608,145610,145611,2,3,0
41533,6,2,145614,145614,145616,0,2,3
41534,3,1,145617,145617,145618,0,1,1
41535,4,2,145621,145621,145623,0,2,3
41536,4,3,145625,145625,145628,0,3,2
41537,4,3,145629,145629,145632,0,3,1
41538,2,3,145631,145632,145635,1,4,0
41539,5,2,145636,145636,145638,0,2,1
41540,2,2,145638,145638,145640,0,2,0
41541,4,1,145642,145642,145643,0,1,2
41542,1,1,145643,145643,145644,0,1,0
41543,1,1,145644,145644,145645,0,1,0
41544,6,3,145650,145650,145653,0,3,5
41545,3,1,145653,145653,145654,0,1,0
41546,3,3,145656,145656,145659,0,3,2
41547,3,3,145659,145659,145662,0,3,0
41548,4,3,145663,145663,145666,0,3,1
41549,4,2,145667,145667,145669,0,2,1
41550,6,3,145673,145673,145676,0,3,4
41551,3,3,145676,145676,145679,0,3,0
41552,6,3,145682,145682,145685,0,3,3
41553,4,2,145686,145686,145688,0,2,1
41554,6,3,145692,145692,145695,0,3,4
41555,4,3,145696,145696,145699,0,3,1
41556,5,2,145701,145701,145703,0,2,2
41557,4,1,145705,145705,145706,0,1,2
41558,4,2,145709,145709,145711,0,2,3
41559,1,1,145710,145711,145712,1,2,0
41560,3,3,145713,145713,145716,0,3,1
41561,4,2,145717,145717,145719,0,2,1
41562,2,3,145719,145719,145722,0,3,0
41563,2,2,145721,145722,145724,1,3,0
41564,6,1,145727,145727,145728,0,1,3
41565,4,2,145731,145731,145733,0,2,3
41566,1,2,145732,145733,145735,1,3,0
41567,2,1,145734,145735,145736,1,2,0
41568,6,2,145740,145740,145742,0,2,4
41569,5,3,145745,145745,145748,0,3,3
41570,3,3,145748,145748,145751,0,3,0
41571,6,1,145754,145754,145755,0,1,3
41572,4,3,145758,145758,145761,0,3,3
41573,2,2,145760,145761,145763,1,3,0
41574,6,1,145766,145766,145767,0,1,3
41575,1,2,145767,145767,145769,0,2,0
41576,4,1,145771,145771,145772,0,1,2
41577,5,1,145776,145776,145777,0,1,4
41578,5,2,145781,145781,145783,0,2,4
41579,3,2,145784,145784,145786,0,2,1
41580,6,2,145790,145790,145792,0,2,4
41581,5,1,145795,145795,145796,0,1,3
41582,2,1,145797,145797,145798,0,1,1
41583,4,2,145801,145801,145803,0,2,3
41584,2,2,145803,145803,145805,0,2,0
41585,6,1,145809,145809,145810,0,1,4
41586,2,3,145811,145811,145814,0,3,1
41587,3,1,145814,145814,145815,0,1,0
41588,4,3,145818,145818,145821,0,3,3
41589,6,2,145824,145824,145826,0,2,3
41590,3,1,145827,145827,145828,0,1,1
41591,2,1,145829,145829,145830,0,1,1
41592,2,1,145831,145831,145832,0,1,1
41593,5,1,145836,145836,145837,0,1,4
41594,1,2,145837,145837,145839,0,2,0
41595,6,3,145843,145843,145846,0,3,4
41596,3,3,145846,145846,145849,0,3,0
41597,4,2,145850,145850,145852,0,2,1
41598,3,1,145853,145853,145854,0,1,1
41599,5,3,145858,145858,145861,0,3,4
41600,2,2,145860,145861,145863,1,3,0
41601,4,3,145864,145864,145867,0,3,1
41602,3,2,145867,145867,145869,0,2,0
41603,4,1,145871,145871,145872,0,1,2
41604,3,2,145874,145874,145876,0,2,2
41605,5,2,145879,145879,145881,0,2,3
41606,6,2,145885,145885,145887,0,2,4
41607,5,1,145890,145890,145891,0,1,3
41608,2,3,145892,145892,145895,0,3,1
41609,2,3,145894,145895,145898,1,4,0
41610,2,3,145896,145898,145901,2,5,0
41611,2,1,145898,145901,145902,3,4,0
41612,6,2,145904,145904,145906,0,2,2
41613,1,3,145905,145906,145909,1,4,0
41614,4,3,145909,145909,145912,0,3,0
41615,3,1,145912,145912,145913,0,1,0
41616,2,1,145914,145914,145915,0,1,1
41617,6,3,145920,145920,145923,0,3,5
41618,5,3,145925,145925,145928,0,3,2
41619,5,2,145930,145930,145932,0,2,2
41620,3,3,145933,145933,145936,0,3,1
41621,2,3,145935,145936,145939,1,4,0
41622,3,3,145938,145939,145942,1,4,0
41623,2,1,145940,145942,145943,2,3,0
41624,2,2,145942,145943,145945,1,3,0
41625,3,1,145945,145945,145946,0,1,0
41626,4,3,145949,145949,145952,0,3,3
41627,5,1,145954,145954,145955,0,1,2
41628,4,3,145958,145958,145961,0,3,3
41629,5,3,145963,145963,145966,0,3,2
41630,6,1,145969,145969,145970,0,1,3
41631,4,1,145973,145973,145974,0,1,3
41632,6,2,145979,145979,145981,0,2,5
41633,2,1,145981,145981,145982,0,1,0
41634,5,2,145986,145986,145988,0,2,4
41635,3,1,145989,145989,145990,0,1,1
41636,5,1,145994,145994,145995,0,1,4
41637,6,3,146000,146000,146003,0,3,5
41638,5,1,146005,146005,146006,0,1,2
41639,1,2,146006,146006,146008,0,2,0
41640,4,1,146010,146010,146011,0,1,2
41641,4,1,146014,146014,146015,0,1,3
41642,2,2,146016,146016,146018,0,2,1
41643,1,3,146017,146018,146021,1,4,0
41644,4,2,146021,146021,146023,0,2,0
41645,6,3,146027,146027,146030,0,3,4
41646,3,2,146030,146030,146032,0,2,0
41647,4,2,146034,146034,146036,0,2,2
41648,5,2,146039,146039,146041,0,2,3
41649,3,2,146042,146042,146044,0,2,1
41650,2,1,146044,146044,146045,0,1,0
41651,4,1,146048,146048,146049,0,1,3
41652,6,1,146054,146054,146055,0,1,5
41653,2,3,146056,146056,146059,0,3,1
41654,1,2,146057,146059,146061,2,4,0
41655,1,3,146058,146061,146064,3,6,0
41656,4,3,146062,146064,146067,2,5,0
41657,6,2,146068,146068,146070,0,2,1
41658,4,2,146072,146072,146074,0,2,2
41659,4,3,146076,146076,146079,0,3,2
41660,4,2,146080,146080,146082,0,2,1
41661,4,3,146084,146084,146087,0,3,2
41662,6,3,146090,146090,146093,0,3,3
41663,4,1,146094,146094,146095,0,1,1
41664,3,3,146097,146097,146100,0,3,2
41665,5,2,146102,146102,146104,0,2,2
41666,2,2,146104,146104,146106,0,2,0
41667,1,2,146105,146106,146108,1,3,0
41668,2,1,146107,146108,146109,1,2,0
41669,3,3,146110,146110,146113,0,3,1
41670,5,3,146115,146115,146118,0,3,2
41671,5,3,146120,146120,146123,0,3,2
41672,6,1,146126,146126,146127,0,1,3
41673,5,3,146131,146131,146134,0,3,4
41674,6,3,146137,146137,146140,0,3,3
41675,4,3,146141,146141,146144,0,3,1
41676,2,3,146143,146144,146147,1,4,0
41677,3,3,146146,146147,146150,1,4,0
41678,6,2,146152,146152,146154,0,2,2
41679,3,2,146155,146155,146157,0,2,1
41680,1,1,146156,146157,146158,1,2,0
41681,5,2,146161,146161,146163,0,2,3
41682,5,2,146166,146166,146168,0,2,3
41683,2,3,146168,146168,146171,0,3,0
41684,6,1,146174,146174,146175,0,1,3
41685,5,1,146179,146179,146180,0,1,4
41686,3,1,146182,146182,146183,0,1,2
41687,3,1,146185,146185,146186,0,1,2
41688,5,3,146190,146190,146193,0,3,4
41689,5,2,146195,146195,146197,0,2,2
41690,3,1,146198,146198,146199,0,1,1
41691,4,1,146202,146202,146203,0,1,3
41692,6,2,146208,146208,146210,0,2,5
41693,3,2,146211,146211,146213,0,2,1
41694,5,2,146216,146216,146218,0,2,3
41695,3,1,146219,146219,146220,0,1,1
41696,2,2,146221,146221,146223,0,2,1
41697,2,2,146223,146223,146225,0,2,0
41698,1,3,146224,146225,146228,1,4,0
41699,6,2,146230,146230,146232,0,2,2
41700,2,2,146232,146232,146234,0,2,0
41701,6,2,146238,146238,146240,0,2,4
41702,2,3,146240,146240,146243,0,3,0
41703,6,1,146246,146246,146247,0,1,3
41704,3,1,146249,146249,146250,0,1,2
41705,5,2,146254,146254,146256,0,2,4
41706,6,3,146260,146260,146263,0,3,4
41707,6,3,146266,146266,146269,0,3,3
41708,6,2,146272,146272,146274,0,2,3
41709,1,3,146273,146274,146277,1,4,0
41710,2,1,146275,146277,146278,2,3,0
41711,6,3,146281,146281,146284,0,3,3
41712,6,1,146287,146287,146288,0,1,3
41713,6,2,146293,146293,146295,0,2,5
41714,4,2,146297,146297,146299,0,2,2
41715,3,3,146300,146300,146303,0,3,1
41716,4,2,146304,146304,146306,0,2,1
41717,2,2,146306,146306,146308,0,2,0
41718,3,2,146309,146309,146311,0,2,1
41719,3,1,146312,146312,146313,0,1,1
41720,5,1,146317,146317,146318,0,1,4
41721,4,1,146321,146321,146322,0,1,3
41722,4,1,146325,146325,146326,0,1,3
41723,2,1,146327,146327,146328,0,1,1
41724,6,2,146333,146333,146335,0,2,5
41725,2,3,146335,146335,146338,0,3,0
41726,3,1,146338,146338,146339,0,1,0
41727,5,2,146343,146343,146345,0,2,4
41728,2,1,146345,146345,146346,0,1,0
41729,5,1,146350,146350,146351,0,1,4
41730,4,3,146354,146354,146357,0,3,3
41731,3,3,146357,146357,146360,0,3,0
41732,5,1,146362,146362,146363,0,1,2
41733,1,3,146363,146363,146366,0,3,0
41734,4,3,146367,146367,146370,0,3,1
41735,4,3,146371,146371,146374,0,3,1
41736,1,1,146372,146374,146375,2,3,0
41737,2,3,146374,146375,146378,1,4,0
41738,5,1,146379,146379,146380,0,1,1
41739,1,2,146380,146380,146382,0,2,0
41740,4,3,146384,146384,146387,0,3,2
41741,6,3,146390,146390,146393,0,3,3
41742,1,2,146391,146393,146395,2,4,0
41743,3,2,146394,146395,146397,1,3,0
41744,2,1,146396,146397,146398,1,2,0
41745,4,2,146400,146400,146402,0,2,2
41746,4,1,146404,146404,146405,0,1,2
41747,4,2,146408,146408,146410,0,2,3
41748,1,1,146409,146410,146411,1,2,0
41749,6,3,146415,146415,146418,0,3,4
41750,4,2,146419,146419,146421,0,2,1
41751,4,3,146423,146423,146426,0,3,2
41752,6,1,146429,146429,146430,0,1,3
41753,6,2,146435,146435,146437,0,2,5
41754,5,3,146440,146440,146443,0,3,3
41755,5,3,146445,146445,146448,0,3,2
41756,5,3,146450,146450,146453,0,3,2
41757,5,1,146455,146455,146456,0,1,2
41758,6,2,146461,146461,146463,0,2,5
41759,6,2,146467,146467,146469,0,2,4
41760,2,1,146469,146469,146470,0,1,0
41761,1,1,146470,146470,146471,0,1,0
41762,6,3,146476,146476,146479,0,3,5
41763,6,3,146482,146482,146485,0,3,3
41764,5,1,146487,146487,146488,0,1,2
41765,6,1,146493,146493,146494,0,1,5
41766,1,1,146494,146494,146495,0,1,0
41767,2,1,146496,146496,146497,0,1,1
41768,1,3,146497,146497,146500,0,3,0
41769,6,2,146503,146503,146505,0,2,3
41770,1,2,146504,146505,146507,1,3,0
41771,6,2,146510,146510,146512,0,2,3
41772,5,1,146515,146515,146516,0,1,3
41773,6,1,146521,146521,146522,0,1,5
41774,2,3,146523,146523,146526,0,3,1
41775,1,1,146524,146526,146527,2,3,0
41776,6,2,146530,146530,146532,0,2,3
41777,4,1,146534,146534,146535,0,1,2
41778,2,1,146536,146536,146537,0,1,1
41779,4,1,146540,146540,146541,0,1,3
41780,1,2,146541,146541,146543,0,2,0
41781,3,3,146544,146544,146547,0,3,1
41782,5,2,146549,146549,146551,0,2,2
41783,5,2,146554,146554,146556,0,2,3
41784,6,2,146560,146560,146562,0,2,4
41785,6,2,146566,146566,146568,0,2,4
41786,4,2,146570,146570,146572,0,2,2
41787,2,3,146572,146572,146575,0,3,0
41788,1,2,146573,146575,146577,2,4,0
41789,4,3,146577,146577,146580,0,3,0
41790,6,3,146583,146583,146586,0,3,3
41791,2,1,146585,146586,146587,1,2,0
41792,2,3,146587,146587,146590,0,3,0
41793,6,2,146593,146593,146595,0,2,3
41794,1,3,146594,146595,146598,1,4,0
41795,2,2,146596,146598,146600,2,4,0
41796,4,3,146600,146600,146603,0,3,0
41797,5,2,146605,146605,146607,0,2,2
41798,2,1,146607,146607,146608,0,1,0
41799,3,2,146610,146610,146612,0,2,2
41800,6,2,146616,146616,146618,0,2,4
41801,5,1,146621,146621,146622,0,1,3
41802,4,2,146625,146625,146627,0,2,3
41803,5,3,146630,146630,146633,0,3,3
41804,4,1,146634,146634,146635,0,1,1
41805,6,1,146640,146640,146641,0,1,5
41806,3,1,146643,146643,146644,0,1,2
41807,2,2,146645,146645,146647,0,2,1
41808,1,3,146646,146647,146650,1,4,0
41809,3,2,146649,146650,146652,1,3,0
41810,6,3,146655,146655,146658,0,3,3
41811,6,2,146661,146661,146663,0,2,3
41812,1,3,146662,146663,146666,1,4,0
41813,6,2,146668,146668,146670,0,2,2
41814,2,1,146670,146670,146671,0,1,0
41815,6,2,146676,146676,146678,0,2,5
41816,1,3,146677,146678,146681,1,4,0
41817,4,3,146681,146681,146684,0,3,0
41818,4,1,146685,146685,146686,0,1,1
41819,6,1,146691,146691,146692,0,1,5
41820,2,2,146693,146693,146695,0,2,1
41821,3,1,146696,146696,146697,0,1,1
41822,5,2,146701,146701,146703,0,2,4
41823,4,3,146705,146705,146708,0,3,2
41824,2,2,146707,146708,146710,1,3,0
41825,6,3,146713,146713,146716,0,3,3
41826,2,3,146715,146716,146719,1,4,0
41827,6,1,146721,146721,146722,0,1,2
41828,5,3,146726,146726,146729,0,3,4
41829,3,1,146729,146729,146730,0,1,0
41830,6,1,146735,146735,146736,0,1,5
41831,5,2,146740,146740,146742,0,2,4
41832,5,1,146745,146745,146746,0,1,3
41833,6,2,146751,146751,146753,0,2,5
41834,6,1,146757,146757,146758,0,1,4
41835,4,1,146761,146761,146762,0,1,3
41836,2,3,146763,146763,146766,0,3,1
41837,2,1,146765,146766,146767,1,2,0
41838,2,2,146767,146767,146769,0,2,0
41839,2,1,146769,146769,146770,0,1,0
41840,6,3,146775,146775,146778,0,3,5
41841,3,1,146778,146778,146779,0,1,0
41842,2,2,146780,146780,146782,0,2,1
41843,1,3,146781,146782,146785,1,4,0
41844,5,1,146786,146786,146787,0,1,1
41845,2,1,146788,146788,146789,0,1,1
41846,4,2,146792,146792,146794,0,2,3
41847,4,3,146796,146796,146799,0,3,2
41848,1,2,146797,146799,146801,2,4,0
41849,6,2,146803,146803,146805,0,2,2
41850,5,3,146808,146808,146811,0,3,3
41851,6,3,146814,146814,146817,0,3,3
41852,1,3,146815,146817,146820,2,5,0
41853,3,3,146818,146820,146823,2,5,0
41854,6,2,146824,146824,146826,0,2,1
41855,2,2,146826,146826,146828,0,2,0
41856,5,3,146831,146831,146834,0,3,3
41857,5,3,146836,146836,146839,0,3,2
41858,2,2,146838,146839,146841,1,3,0
41859,2,1,146840,146841,146842,1,2,0
41860,4,1,146844,146844,146845,0,1,2
41861,4,1,146848,146848,146849,0,1,3
41862,4,2,146852,146852,146854,0,2,3
41863,6,3,146858,146858,146861,0,3,4
41864,1,2,146859,146861,146863,2,4,0
41865,1,2,146860,146863,146865,3,5,0
41866,3,2,146863,146865,146867,2,4,0
41867,3,3,146866,146867,146870,1,4,0
41868,6,2,146872,146872,146874,0,2,2
41869,3,3,146875,146875,146878,0,3,1
41870,4,1,146879,146879,146880,0,1,1
41871,6,2,146885,146885,146887,0,2,5
41872,1,2,146886,146887,146889,1,3,0
41873,1,2,146887,146889,146891,2,4,0
41874,2,2,146889,146891,146893,2,4,0
41875,3,3,146892,146893,146896,1,4,0
41876,6,2,146898,146898,146900,0,2,2
41877,5,1,146903,146903,146904,0,1,3
41878,2,1,146905,146905,146906,0,1,1
41879,2,3,146907,146907,146910,0,3,1
41880,1,3,146908,146910,146913,2,5,0
41881,6,3,146914,146914,146917,0,3,1
41882,5,3,146919,146919,146922,0,3,2
41883,1,2,146920,146922,146924,2,4,0
41884,4,3,146924,146924,146927,0,3,0
41885,4,1,146928,146928,146929,0,1,1
41886,4,1,146932,146932,146933,0,1,3
41887,1,1,146933,146933,146934,0,1,0
41888,3,2,146936,146936,146938,0,2,2
41889,3,3,146939,146939,146942,0,3,1
41890,1,1,146940,146942,146943,2,3,0
41891,5,2,146945,146945,146947,0,2,2
41892,1,2,146946,146947,146949,1,3,0
41893,3,1,146949,146949,146950,0,1,0
41894,6,2,146955,146955,146957,0,2,5
41895,5,2,146960,146960,146962,0,2,3
41896,4,3,146964,146964,146967,0,3,2
41897,3,1,146967,146967,146968,0,1,0
41898,6,1,146973,146973,146974,0,1,5
41899,3,3,146976,146976,146979,0,3,2
41900,4,3,146980,146980,146983,0,3,1
41901,1,3,146981,146983,146986,2,5,0
41902,6,2,146987,146987,146989,0,2,1
41903,1,1,146988,146989,146990,1,2,0
41904,4,2,146992,146992,146994,0,2,2
41905,4,2,146996,146996,146998,0,2,2
41906,2,2,146998,146998,147000,0,2,0
41907,1,2,146999,147000,147002,1,3,0
41908,6,1,147005,147005,147006,0,1,3
41909,3,3,147008,147008,147011,0,3,2
41910,2,2,147010,147011,147013,1,3,0
41911,4,3,147014,147014,147017,0,3,1
41912,5,1,147019,147019,147020,0,1,2
41913,5,2,147024,147024,147026,0,2,4
41914,6,3,147030,147030,147033,0,3,4
41915,2,2,147032,147033,147035,1,3,0
41916,5,2,147037,147037,147039,0,2,2
41917,4,2,147041,147041,147043,0,2,2
41918,5,3,147046,147046,147049,0,3,3
41919,3,3,147049,147049,147052,0,3,0
41920,5,1,147054,147054,147055,0,1,2
41921,1,1,147055,147055,147056,0,1,0
41922,2,3,147057,147057,147060,0,3,1
41923,3,1,147060,147060,147061,0,1,0
41924,1,3,147061,147061,147064,0,3,0
41925,2,2,147063,147064,147066,1,3,0
41926,4,1,147067,147067,147068,0,1,1
41927,2,1,147069,147069,147070,0,1,1
41928,2,2,147071,147071,147073,0,2,1
41929,2,2,147073,147073,147075,0,2,0
41930,3,3,147076,147076,147079,0,3,1
41931,1,3,147077,147079,147082,2,5,0
41932,3,2,147080,147082,147084,2,4,0
41933,4,2,147084,147084,147086,0,2,0
41934,1,3,147085,147086,147089,1,4,0
41935,1,2,147086,147089,147091,3,5,0
41936,1,2,147087,147091,147093,4,6,0
41937,4,3,147091,147093,147096,2,5,0
41938,5,3,147096,147096,147099,0,3,0
41939,1,3,147097,147099,147102,2,5,0
41940,4,3,147101,147102,147105,1,4,0
41941,6,2,147107,147107,147109,0,2,2
41942,2,2,147109,147109,147111,0,2,0
41943,5,1,147114,147114,147115,0,1,3
41944,3,3,147117,147117,147120,0,3,2
41945,6,1,147123,147123,147124,0,1,3
41946,5,2,147128,147128,147130,0,2,4
41947,5,3,147133,147133,147136,0,3,3
41948,1,2,147134,147136,147138,2,4,0
41949,1,1,147135,147138,147139,3,4,0
41950,4,2,147139,147139,147141,0,2,0
41951,2,3,147141,147141,147144,0,3,0
41952,1,3,147142,147144,147147,2,5,0
41953,1,1,147143,147147,147148,4,5,0
41954,3,1,147146,147148,147149,2,3,0
41955,2,1,147148,147149,147150,1,2,0
41956,6,3,147154,147154,147157,0,3,4
41957,3,3,147157,147157,147160,0,3,0
41958,5,2,147162,147162,147164,0,2,2
41959,1,2,147163,147164,147166,1,3,0
41960,2,1,147165,147166,147167,1,2,0
41961,4,3,147169,147169,147172,0,3,2
41962,3,2,147172,147172,147174,0,2,0
41963,6,2,147178,147178,147180,0,2,4
41964,1,1,147179,147180,147181,1,2,0
41965,1,1,147180,147181,147182,1,2,0
41966,6,2,147186,147186,147188,0,2,4
41967,6,2,147192,147192,147194,0,2,4
41968,2,2,147194,147194,147196,0,2,0
41969,4,1,147198,147198,147199,0,1,2
41970,5,1,147203,147203,147204,0,1,4
41971,5,1,147208,147208,147209,0,1,4
41972,5,2,147213,147213,147215,0,2,4
41973,5,2,147218,147218,147220,0,2,3
41974,1,1,147219,147220,147221,1,2,0
41975,1,2,147220,147221,147223,1,3,0
41976,6,2,147226,147226,147228,0,2,3
41977,1,1,147227,147228,147229,1,2,0
41978,5,3,147232,147232,147235,0,3,3
41979,4,2,147236,147236,147238,0,2,1
41980,1,2,147237,147238,147240,1,3,0
41981,4,1,147241,147241,147242,0,1,1
41982,1,3,147242,147242,147245,0,3,0
41983,6,3,147248,147248,147251,0,3,3
41984,6,2,147254,147254,147256,0,2,3
41985,6,2,147260,147260,147262,0,2,4
41986,3,2,147263,147263,147265,0,2,1
41987,2,1,147265,147265,147266,0,1,0
41988,6,1,147271,147271,147272,0,1,5
41989,3,2,147274,147274,147276,0,2,2
41990,6,1,147280,147280,147281,0,1,4
41991,1,2,147281,147281,147283,0,2,0
41992,5,3,147286,147286,147289,0,3,3
41993,3,3,147289,147289,147292,0,3,0
41994,4,3,147293,147293,147296,0,3,1
41995,1,3,147294,147296,147299,2,5,0
41996,6,2,147300,147300,147302,0,2,1
41997,1,3,147301,147302,147305,1,4,0
41998,5,3,147306,147306,147309,0,3,1
41999,1,2,147307,147309,147311,2,4,0
42000,5,2,147312,147312,147314,0,2,1
42001,1,2,147313,147314,147316,1,3,0
42002,3,2,147316,147316,147318,0,2,0
42003,1,2,147317,147318,147320,1,3,0
42004,1,2,147318,147320,147322,2,4,0
42005,3,3,147321,147322,147325,1,4,0
42006,4,3,147325,147325,147328,0,3,0
42007,4,2,147329,147329,147331,0,2,1
42008,5,2,147334,147334,147336,0,2,3
42009,3,3,147337,147337,147340,0,3,1
42010,3,2,147340,147340,147342,0,2,0
42011,6,2,147346,147346,147348,0,2,4
42012,6,3,147352,147352,147355,0,3,4
42013,3,2,147355,147355,147357,0,2,0
42014,1,1,147356,147357,147358,1,2,0
42015,3,1,147359,147359,147360,0,1,1
42016,3,1,147362,147362,147363,0,1,2
42017,6,3,147368,147368,147371,0,3,5
42018,2,2,147370,147371,147373,1,3,0
42019,6,3,147376,147376,147379,0,3,3
42020,6,1,147382,147382,147383,0,1,3
42021,6,2,147388,147388,147390,0,2,5
42022,2,2,147390,147390,147392,0,2,0
42023,3,3,147393,147393,147396,0,3,1
42024,4,3,147397,147397,147400,0,3,1
42025,6,1,147403,147403,147404,0,1,3
42026,4,1,147407,147407,147408,0,1,3
42027,2,3,147409,147409,147412,0,3,1
42028,3,1,147412,147412,147413,0,1,0
42029,1,1,147413,147413,147414,0,1,0
42030,1,2,147414,147414,147416,0,2,0
42031,4,3,147418,147418,147421,0,3,2
42032,1,3,147419,147421,147424,2,5,0
42033,4,1,147423,147424,147425,1,2,0
42034,1,3,147424,147425,147428,1,4,0
42035,3,2,147427,147428,147430,1,3,0
42036,6,3,147433,147433,147436,0,3,3
42037,3,1,147436,147436,147437,0,1,0
42038,6,1,147442,147442,147443,0,1,5
42039,3,1,147445,147445,147446,0,1,2
42040,3,1,147448,147448,147449,0,1,2
42041,1,3,147449,147449,147452,0,3,0
42042,2,2,147451,147452,147454,1,3,0
42043,5,3,147456,147456,147459,0,3,2
42044,3,2,147459,147459,147461,0,2,0
42045,6,1,147465,147465,147466,0,1,4
42046,1,3,147466,147466,147469,0,3,0
42047,5,1,147471,147471,147472,0,1,2
42048,1,3,147472,147472,147475,0,3,0
42049,1,1,147473,147475,147476,2,3,0
42050,6,3,147479,147479,147482,0,3,3
42051,3,3,147482,147482,147485,0,3,0
42052,3,1,147485,147485,147486,0,1,0
42053,2,2,147487,147487,147489,0,2,1
42054,5,3,147492,147492,147495,0,3,3
42055,4,1,147496,147496,147497,0,1,1
42056,2,1,147498,147498,147499,0,1,1
42057,3,2,147501,147501,147503,0,2,2
42058,6,3,147507,147507,147510,0,3,4
42059,4,3,147511,147511,147514,0,3,1
42060,6,3,147517,147517,147520,0,3,3
42061,6,1,147523,147523,147524,0,1,3
42062,5,3,147528,147528,147531,0,3,4
42063,1,2,147529,147531,147533,2,4,0
42064,2,3,147531,147533,147536,2,5,0
42065,3,3,147534,147536,147539,2,5,0
42066,6,2,147540,147540,147542,0,2,1
42067,2,1,147542,147542,147543,0,1,0
42068,5,1,147547,147547,147548,0,1,4
42069,4,3,147551,147551,147554,0,3,3
42070,4,3,147555,147555,147558,0,3,1
42071,4,3,147559,147559,147562,0,3,1
42072,3,2,147562,147562,147564,0,2,0
42073,1,1,147563,147564,147565,1,2,0
42074,2,1,147565,147565,147566,0,1,0
42075,3,2,147568,147568,147570,0,2,2
42076,3,3,147571,147571,147574,0,3,1
42077,4,1,147575,147575,147576,0,1,1
42078,5,1,147580,147580,147581,0,1,4
42079,5,2,147585,147585,147587,0,2,4
42080,6,3,147591,147591,147594,0,3,4
42081,3,1,147594,147594,147595,0,1,0
42082,5,3,147599,147599,147602,0,3,4
42083,4,2,147603,147603,147605,0,2,1
42084,3,3,147606,147606,147609,0,3,1
42085,3,2,147609,147609,147611,0,2,0
42086,5,2,147614,147614,147616,0,2,3
42087,4,1,147618,147618,147619,0,1,2
42088,5,2,147623,147623,147625,0,2,4
42089,4,2,147627,147627,147629,0,2,2
42090,2,1,147629,147629,147630,0,1,0
42091,5,3,147634,147634,147637,0,3,4
42092,3,2,147637,147637,147639,0,2,0
42093,3,3,147640,147640,147643,0,3,1
42094,3,2,147643,147643,147645,0,2,0
42095,4,2,147647,147647,147649,0,2,2
42096,3,3,147650,147650,147653,0,3,1
42097,3,3,147653,147653,147656,0,3,0
42098,5,3,147658,147658,147661,0,3,2
42099,5,1,147663,147663,147664,0,1,2
42100,3,1,147666,147666,147667,0,1,2
42101,1,2,147667,147667,147669,0,2,0
42102,5,3,147672,147672,147675,0,3,3
42103,1,2,147673,147675,147677,2,4,0
42104,5,1,147678,147678,147679,0,1,1
42105,5,2,147683,147683,147685,0,2,4
42106,3,3,147686,147686,147689,0,3,1
42107,4,3,147690,147690,147693,0,3,1
42108,4,2,147694,147694,147696,0,2,1
42109,3,2,147697,147697,147699,0,2,1
42110,3,2,147700,147700,147702,0,2,1
42111,4,3,147704,147704,147707,0,3,2
42112,2,2,147706,147707,147709,1,3,0
42113,3,1,147709,147709,147710,0,1,0
42114,2,3,147711,147711,147714,0,3,1
42115,1,3,147712,147714,147717,2,5,0
42116,1,1,147713,147717,147718,4,5,0
42117,3,3,147716,147718,147721,2,5,0
42118,2,3,147718,147721,147724,3,6,0
42119,2,2,147720,147724,147726,4,6,0
42120,1,1,147721,147726,147727,5,6,0
42121,3,1,147724,147727,147728,3,4,0
42122,6,2,147730,147730,147732,0,2,2
42123,1,1,147731,147732,147733,1,2,0
42124,5,2,147736,147736,147738,0,2,3
42125,1,1,147737,147738,147739,1,2,0
42126,3,3,147740,147740,147743,0,3,1
42127,5,2,147745,147745,147747,0,2,2
42128,6,3,147751,147751,147754,0,3,4
42129,3,1,147754,147754,147755,0,1,0
42130,2,2,147756,147756,147758,0,2,1
42131,5,3,147761,147761,147764,0,3,3
42132,2,1,147763,147764,147765,1,2,0
42133,4,1,147767,147767,147768,0,1,2
42134,4,1,147771,147771,147772,0,1,3
42135,4,3,147775,147775,147778,0,3,3
42136,1,3,147776,147778,147781,2,5,0
42137,4,1,147780,147781,147782,1,2,0
42138,5,2,147785,147785,147787,0,2,3
42139,2,2,147787,147787,147789,0,2,0
42140,6,2,147793,147793,147795,0,2,4
42141,6,2,147799,147799,147801,0,2,4
42142,5,1,147804,147804,147805,0,1,3
42143,4,2,147808,147808,147810,0,2,3
42144,5,3,147813,147813,147816,0,3,3
42145,2,3,147815,147816,147819,1,4,0
42146,1,2,147816,147819,147821,3,5,0
42147,2,1,147818,147821,147822,3,4,0
42148,4,2,147822,147822,147824,0,2,0
42149,5,3,147827,147827,147830,0,3,3
42150,2,1,147829,147830,147831,1,2,0
42151,3,2,147832,147832,147834,0,2,1
42152,3,1,147835,147835,147836,0,1,1
42153,5,3,147840,147840,147843,0,3,4
42154,1,2,147841,147843,147845,2,4,0
42155,6,2,147847,147847,147849,0,2,2
42156,5,3,147852,147852,147855,0,3,3
42157,4,2,147856,147856,147858,0,2,1
42158,3,1,147859,147859,147860,0,1,1
42159,1,1,147860,147860,147861,0,1,0
42160,3,3,147863,147863,147866,0,3,2
42161,1,1,147864,147866,147867,2,3,0
42162,6,3,147870,147870,147873,0,3,3
42163,2,2,147872,147873,147875,1,3,0
42164,6,3,147878,147878,147881,0,3,3
42165,1,2,147879,147881,147883,2,4,0
42166,1,2,147880,147883,147885,3,5,0
42167,6,2,147886,147886,147888,0,2,1
42168,2,3,147888,147888,147891,0,3,0
42169,3,3,147891,147891,147894,0,3,0
42170,2,1,147893,147894,147895,1,2,0
42171,5,3,147898,147898,147901,0,3,3
42172,1,3,147899,147901,147904,2,5,0
42173,5,3,147904,147904,147907,0,3,0
42174,2,1,147906,147907,147908,1,2,0
42175,1,1,147907,147908,147909,1,2,0
42176,4,3,147911,147911,147914,0,3,2
42177,5,2,147916,147916,147918,0,2,2
42178,5,2,147921,147921,147923,0,2,3
42179,4,2,147925,147925,147927,0,2,2
42180,5,1,147930,147930,147931,0,1,3
42181,4,1,147934,147934,147935,0,1,3
42182,1,2,147935,147935,147937,0,2,0
42183,6,2,147941,147941,147943,0,2,4
42184,6,1,147947,147947,147948,0,1,4
42185,1,2,147948,147948,147950,0,2,0
42186,5,2,147953,147953,147955,0,2,3
42187,5,2,147958,147958,147960,0,2,3
42188,4,2,147962,147962,147964,0,2,2
42189,1,3,147963,147964,147967,1,4,0
42190,6,1,147969,147969,147970,0,1,2
42191,6,3,147975,147975,147978,0,3,5
42192,2,3,147977,147978,147981,1,4,0
42193,1,3,147978,147981,147984,3,6,0
42194,1,2,147979,147984,147986,5,7,0
42195,6,3,147985,147986,147989,1,4,0
42196,1,1,147986,147989,147990,3,4,0
42197,6,1,147992,147992,147993,0,1,2
42198,2,1,147994,147994,147995,0,1,1
42199,4,2,147998,147998,148000,0,2,3
42200,5,2,148003,148003,148005,0,2,3
42201,1,1,148004,148005,148006,1,2,0
42202,1,3,148005,148006,148009,1,4,0
42203,4,3,148009,148009,148012,0,3,0
42204,2,1,148011,148012,148013,1,2,0
42205,6,2,148017,148017,148019,0,2,4
42206,4,1,148021,148021,148022,0,1,2
42207,5,2,148026,148026,148028,0,2,4
42208,5,3,148031,148031,148034,0,3,3
42209,4,1,148035,148035,148036,0,1,1
42210,5,1,148040,148040,148041,0,1,4
42211,2,1,148042,148042,148043,0,1,1
42212,5,2,148047,148047,148049,0,2,4
42213,3,1,148050,148050,148051,0,1,1
42214,3,1,148053,148053,148054,0,1,2
42215,1,1,148054,148054,148055,0,1,0
42216,3,3,148057,148057,148060,0,3,2
42217,1,3,148058,148060,148063,2,5,0
42218,4,3,148062,148063,148066,1,4,0
42219,6,1,148068,148068,148069,0,1,2
42220,3,1,148071,148071,148072,0,1,2
42221,3,3,148074,148074,148077,0,3,2
42222,1,2,148075,148077,148079,2,4,0
42223,6,1,148081,148081,148082,0,1,2
42224,1,1,148082,148082,148083,0,1,0
42225,3,1,148085,148085,148086,0,1,2
42226,3,2,148088,148088,148090,0,2,2
42227,4,2,148092,148092,148094,0,2,2
42228,3,3,148095,148095,148098,0,3,1
42229,4,3,148099,148099,148102,0,3,1
42230,3,1,148102,148102,148103,0,1,0
42231,3,2,148105,148105,148107,0,2,2
42232,6,1,148111,148111,148112,0,1,4
42233,4,1,148115,148115,148116,0,1,3
42234,1,3,148116,148116,148119,0,3,0
42235,6,3,148122,148122,148125,0,3,3
42236,3,3,148125,148125,148128,0,3,0
42237,2,1,148127,148128,148129,1,2,0
42238,3,1,148130,148130,148131,0,1,1
42239,1,3,148131,148131,148134,0,3,0
42240,2,1,148133,148134,148135,1,2,0
42241,3,1,148136,148136,148137,0,1,1
42242,2,2,148138,148138,148140,0,2,1
42243,1,2,148139,148140,148142,1,3,0
42244,5,3,148144,148144,148147,0,3,2
42245,3,1,148147,148147,148148,0,1,0
42246,6,1,148153,148153,148154,0,1,5
42247,2,2,148155,148155,148157,0,2,1
42248,1,1,148156,148157,148158,1,2,0
42249,2,3,148158,148158,148161,0,3,0
42250,5,1,148163,148163,148164,0,1,2
42251,4,2,148167,148167,148169,0,2,3
42252,2,3,148169,148169,148172,0,3,0
42253,2,1,148171,148172,148173,1,2,0
42254,5,3,148176,148176,148179,0,3,3
42255,5,1,148181,148181,148182,0,1,2
42256,1,3,148182,148182,148185,0,3,0
42257,6,2,148188,148188,148190,0,2,3
42258,1,1,148189,148190,148191,1,2,0
42259,5,1,148194,148194,148195,0,1,3
42260,2,3,148196,148196,148199,0,3,1
42261,3,1,148199,148199,148200,0,1,0
42262,4,3,148203,148203,148206,0,3,3
42263,6,2,148209,148209,148211,0,2,3
42264,5,3,148214,148214,148217,0,3,3
42265,3,2,148217,148217,148219,0,2,0
42266,2,2,148219,148219,148221,0,2,0
42267,2,1,148221,148221,148222,0,1,0
42268,3,3,148224,148224,148227,0,3,2
42269,4,3,148228,148228,148231,0,3,1
42270,2,2,148230,148231,148233,1,3,0
42271,1,1,148231,148233,148234,2,3,0
42272,2,2,148233,148234,148236,1,3,0
42273,5,3,148238,148238,148241,0,3,2
42274,3,1,148241,148241,148242,0,1,0
42275,4,2,148245,148245,148247,0,2,3
42276,6,1,148251,148251,148252,0,1,4
42277,1,3,148252,148252,148255,0,3,0
42278,2,3,148254,148255,148258,1,4,0
42279,2,2,148256,148258,148260,2,4,0
42280,6,3,148262,148262,148265,0,3,2
42281,1,2,148263,148265,148267,2,4,0
42282,3,1,148266,148267,148268,1,2,0
42283,1,2,148267,148268,148270,1,3,0
42284,4,1,148271,148271,148272,0,1,1
42285,2,1,148273,148273,148274,0,1,1
42286,1,1,148274,148274,148275,0,1,0
42287,6,1,148280,148280,148281,0,1,5
42288,6,1,148286,148286,148287,0,1,5
42289,4,2,148290,148290,148292,0,2,3
42290,4,3,148294,148294,148297,0,3,2
42291,6,3,148300,148300,148303,0,3,3
42292,5,3,148305,148305,148308,0,3,2
42293,2,1,148307,148308,148309,1,2,0
42294,3,1,148310,148310,148311,0,1,1
42295,1,2,148311,148311,148313,0,2,0
42296,4,1,148315,148315,148316,0,1,2
42297,2,2,148317,148317,148319,0,2,1
42298,5,1,148322,148322,148323,0,1,3
42299,1,3,148323,148323,148326,0,3,0
42300,2,3,148325,148326,148329,1,4,0
42301,5,2,148330,148330,148332,0,2,1
42302,3,3,148333,148333,148336,0,3,1
42303,6,1,148339,148339,148340,0,1,3
42304,4,3,148343,148343,148346,0,3,3
42305,3,2,148346,148346,148348,0,2,0
42306,4,1,148350,148350,148351,0,1,2
42307,1,1,148351,148351,148352,0,1,0
42308,1,3,148352,148352,148355,0,3,0
42309,6,2,148358,148358,148360,0,2,3
42310,3,3,148361,148361,148364,0,3,1
42311,2,1,148363,148364,148365,1,2,0
42312,4,2,148367,148367,148369,0,2,2
42313,3,2,148370,148370,148372,0,2,1
42314,2,2,148372,148372,148374,0,2,0
42315,6,3,148378,148378,148381,0,3,4
42316,6,1,148384,148384,148385,0,1,3
42317,2,2,148386,148386,148388,0,2,1
42318,5,1,148391,148391,148392,0,1,3
42319,6,1,148397,148397,148398,0,1,5
42320,5,2,148402,148402,148404,0,2,4
42321,3,1,148405,148405,148406,0,1,1
42322,4,3,148409,148409,148412,0,3,3
42323,2,3,148411,148412,148415,1,4,0
42324,4,1,148415,148415,148416,0,1,0
42325,1,2,148416,148416,148418,0,2,0
42326,4,1,148420,148420,148421,0,1,2
42327,5,3,148425,148425,148428,0,3,4
42328,2,2,148427,148428,148430,1,3,0
42329,3,3,148430,148430,148433,0,3,0
42330,5,2,148435,148435,148437,0,2,2
42331,2,3,148437,148437,148440,0,3,0
42332,4,2,148441,148441,148443,0,2,1
42333,2,2,148443,148443,148445,0,2,0
42334,3,2,148446,148446,148448,0,2,1
42335,1,2,148447,148448,148450,1,3,0
42336,3,2,148450,148450,148452,0,2,0
42337,4,1,148454,148454,148455,0,1,2
42338,6,2,148460,148460,148462,0,2,5
42339,2,2,148462,148462,148464,0,2,0
42340,1,2,148463,148464,148466,1,3,0
42341,2,1,148465,148466,148467,1,2,0
42342,2,1,148467,148467,148468,0,1,0
42343,1,2,148468,148468,148470,0,2,0
42344,5,3,148473,148473,148476,0,3,3
42345,5,1,148478,148478,148479,0,1,2
42346,5,2,148483,148483,148485,0,2,4
42347,5,3,148488,148488,148491,0,3,3
42348,2,3,148490,148491,148494,1,4,0
42349,6,3,148496,148496,148499,0,3,2
42350,3,2,148499,148499,148501,0,2,0
42351,6,2,148505,148505,148507,0,2,4
42352,5,3,148510,148510,148513,0,3,3
42353,4,3,148514,148514,148517,0,3,1
42354,5,2,148519,148519,148521,0,2,2
42355,4,3,148523,148523,148526,0,3,2
42356,4,3,148527,148527,148530,0,3,1
42357,2,2,148529,148530,148532,1,3,0
42358,5,2,148534,148534,148536,0,2,2
42359,6,2,148540,148540,148542,0,2,4
42360,4,3,148544,148544,148547,0,3,2
42361,4,3,148548,148548,148551,0,3,1
42362,2,2,148550,148551,148553,1,3,0
42363,1,2,148551,148553,148555,2,4,0
42364,2,1,148553,148555,148556,2,3,0
42365,1,2,148554,148556,148558,2,4,0
42366,6,1,148560,148560,148561,0,1,2
42367,4,3,148564,148564,148567,0,3,3
42368,5,1,148569,148569,148570,0,1,2
42369,3,3,148572,148572,148575,0,3,2
42370,1,2,148573,148575,148577,2,4,0
42371,5,2,148578,148578,148580,0,2,1
42372,3,3,148581,148581,148584,0,3,1
42373,3,1,148584,148584,148585,0,1,0
42374,5,2,148589,148589,148591,0,2,4
42375,6,3,148595,148595,148598,0,3,4
42376,4,3,148599,148599,148602,0,3,1
42377,5,3,148604,148604,148607,0,3,2
42378,5,2,148609,148609,148611,0,2,2
42379,3,1,148612,148612,148613,0,1,1
42380,5,1,148617,148617,148618,0,1,4
42381,2,3,148619,148619,148622,0,3,1
42382,5,3,148624,148624,148627,0,3,2
42383,6,3,148630,148630,148633,0,3,3
42384,6,3,148636,148636,148639,0,3,3
42385,3,2,148639,148639,148641,0,2,0
42386,2,1,148641,148641,148642,0,1,0
42387,3,1,148644,148644,148645,0,1,2
42388,6,3,148650,148650,148653,0,3,5
42389,5,3,148655,148655,148658,0,3,2
42390,2,1,148657,148658,148659,1,2,0
42391,5,1,148662,148662,148663,0,1,3
42392,5,1,148667,148667,148668,0,1,4
42393,5,3,148672,148672,148675,0,3,4
42394,2,1,148674,148675,148676,1,2,0
42395,5,1,148679,148679,148680,0,1,3
42396,2,2,148681,148681,148683,0,2,1
42397,4,2,148685,148685,148687,0,2,2
42398,4,3,148689,148689,148692,0,3,2
42399,2,2,148691,148692,148694,1,3,0
42400,6,1,148697,148697,148698,0,1,3
42401,4,2,148701,148701,148703,0,2,3
42402,1,3,148702,148703,148706,1,4,0
42403,3,1,148705,148706,148707,1,2,0
42404,3,1,148708,148708,148709,0,1,1
42405,2,1,148710,148710,148711,0,1,1
42406,6,3,148716,148716,148719,0,3,5
42407,6,3,148722,148722,148725,0,3,3
42408,3,2,148725,148725,148727,0,2,0
42409,4,2,148729,148729,148731,0,2,2
42410,6,2,148735,148735,148737,0,2,4
42411,3,3,148738,148738,148741,0,3,1
42412,3,2,148741,148741,148743,0,2,0
42413,4,3,148745,148745,148748,0,3,2
42414,5,2,148750,148750,148752,0,2,2
42415,2,2,148752,148752,148754,0,2,0
42416,6,2,148758,148758,148760,0,2,4
42417,4,1,148762,148762,148763,0,1,2
42418,5,2,148767,148767,148769,0,2,4
42419,4,1,148771,148771,148772,0,1,2
42420,6,3,148777,148777,148780,0,3,5
42421,4,2,148781,148781,148783,0,2,1
42422,6,2,148787,148787,148789,0,2,4
42423,5,2,148792,148792,148794,0,2,3
42424,5,3,148797,148797,148800,0,3,3
42425,1,1,148798,148800,148801,2,3,0
42426,6,3,148804,148804,148807,0,3,3
42427,6,2,148810,148810,148812,0,2,3
42428,3,1,148813,148813,148814,0,1,1
42429,2,1,148815,148815,148816,0,1,1
42430,1,2,148816,148816,148818,0,2,0
42431,2,3,148818,148818,148821,0,3,0
42432,6,1,148824,148824,148825,0,1,3
42433,5,2,148829,148829,148831,0,2,4
42434,5,2,148834,148834,148836,0,2,3
42435,3,1,148837,148837,148838,0,1,1
42436,3,3,148840,148840,148843,0,3,2
42437,1,1,148841,148843,148844,2,3,0
42438,2,2,148843,148844,148846,1,3,0
42439,5,3,148848,148848,148851,0,3,2
42440,5,1,148853,148853,148854,0,1,2
42441,3,3,148856,148856,148859,0,3,2
42442,5,3,148861,148861,148864,0,3,2
42443,5,1,148866,148866,148867,0,1,2
42444,4,2,148870,148870,148872,0,2,3
42445,3,3,148873,148873,148876,0,3,1
42446,3,1,148876,148876,148877,0,1,0
42447,3,1,148879,148879,148880,0,1,2
42448,1,2,148880,148880,148882,0,2,0
42449,4,1,148884,148884,148885,0,1,2
42450,5,1,148889,148889,148890,0,1,4
42451,5,3,148894,148894,148897,0,3,4
42452,3,2,148897,148897,148899,0,2,0
42453,3,3,148900,148900,148903,0,3,1
42454,1,1,148901,148903,148904,2,3,0
42455,3,3,148904,148904,148907,0,3,0
42456,3,2,148907,148907,148909,0,2,0
42457,2,1,148909,148909,148910,0,1,0
42458,5,2,148914,148914,148916,0,2,4
42459,5,2,148919,148919,148921,0,2,3
42460,5,1,148924,148924,148925,0,1,3
42461,4,3,148928,148928,148931,0,3,3
42462,1,1,148929,148931,148932,2,3,0
42463,4,3,148933,148933,148936,0,3,1
42464,4,3,148937,148937,148940,0,3,1
42465,2,1,148939,148940,148941,1,2,0
42466,2,3,148941,148941,148944,0,3,0
42467,5,2,148946,148946,148948,0,2,2
42468,1,1,148947,148948,148949,1,2,0
42469,4,1,148951,148951,148952,0,1,2
42470,6,2,148957,148957,148959,0,2,5
42471,6,3,148963,148963,148966,0,3,4
42472,1,2,148964,148966,148968,2,4,0
42473,3,3,148967,148968,148971,1,4,0
42474,5,3,148972,148972,148975,0,3,1
42475,6,1,148978,148978,148979,0,1,3
42476,4,2,148982,148982,148984,0,2,3
42477,2,2,148984,148984,148986,0,2,0
42478,1,2,148985,148986,148988,1,3,0
42479,4,2,148989,148989,148991,0,2,1
42480,3,2,148992,148992,148994,0,2,1
42481,6,2,148998,148998,149000,0,2,4
42482,5,2,149003,149003,149005,0,2,3
42483,1,2,149004,149005,149007,1,3,0
42484,1,1,149005,149007,149008,2,3,0
42485,3,2,149008,149008,149010,0,2,0
42486,6,2,149014,149014,149016,0,2,4
42487,4,3,149018,149018,149021,0,3,2
42488,4,3,149022,149022,149025,0,3,1
42489,1,2,149023,149025,149027,2,4,0
42490,6,2,149029,149029,149031,0,2,2
42491,3,2,149032,149032,149034,0,2,1
42492,5,1,149037,149037,149038,0,1,3
42493,4,3,149041,149041,149044,0,3,3
42494,4,3,149045,149045,149048,0,3,1
42495,2,3,149047,149048,149051,1,4,0
42496,1,3,149048,149051,149054,3,6,0
42497,2,1,149050,149054,149055,4,5,0
42498,6,1,149056,149056,149057,0,1,1
42499,3,2,149059,149059,149061,0,2,2
42500,2,2,149061,149061,149063,0,2,0
42501,3,1,149064,149064,149065,0,1,1
42502,5,2,149069,149069,149071,0,2,4
42503,5,2,149074,149074,149076,0,2,3
42504,3,1,149077,149077,149078,0,1,1
42505,2,2,149079,149079,149081,0,2,1
42506,2,3,149081,149081,149084,0,3,0
42507,3,2,149084,149084,149086,0,2,0
42508,1,2,149085,149086,149088,1,3,0
42509,5,2,149090,149090,149092,0,2,2
42510,3,1,149093,149093,149094,0,1,1
42511,5,1,149098,149098,149099,0,1,4
42512,3,3,149101,149101,149104,0,3,2
42513,4,1,149105,149105,149106,0,1,1
42514,1,1,149106,149106,149107,0,1,0
42515,5,1,149111,149111,149112,0,1,4
42516,4,3,149115,149115,149118,0,3,3
42517,1,1,149116,149118,149119,2,3,0
42518,4,3,149120,149120,149123,0,3,1
42519,5,1,149125,149125,149126,0,1,2
42520,4,3,149129,149129,149132,0,3,3
42521,6,2,149135,149135,149137,0,2,3
42522,4,1,149139,149139,149140,0,1,2
42523,3,3,149142,149142,149145,0,3,2
42524,4,3,149146,149146,149149,0,3,1
42525,5,3,149151,149151,149154,0,3,2
42526,2,3,149153,149154,149157,1,4,0
42527,4,2,149157,149157,149159,0,2,0
42528,2,2,149159,149159,149161,0,2,0
42529,3,3,149162,149162,149165,0,3,1
42530,2,1,149164,149165,149166,1,2,0
42531,2,2,149166,149166,149168,0,2,0
42532,3,1,149169,149169,149170,0,1,1
42533,5,2,149174,149174,149176,0,2,4
42534,1,3,149175,149176,149179,1,4,0
42535,6,2,149181,149181,149183,0,2,2
42536,1,1,149182,149183,149184,1,2,0
42537,4,2,149186,149186,149188,0,2,2
42538,1,3,149187,149188,149191,1,4,0
42539,6,1,149193,149193,149194,0,1,2
42540,6,3,149199,149199,149202,0,3,5
42541,2,2,149201,149202,149204,1,3,0
42542,4,1,149205,149205,149206,0,1,1
42543,3,3,149208,149208,149211,0,3,2
42544,4,1,149212,149212,149213,0,1,1
42545,2,2,149214,149214,149216,0,2,1
42546,1,1,149215,149216,149217,1,2,0
42547,1,3,149216,149217,149220,1,4,0
42548,1,2,149217,149220,149222,3,5,0
42549,5,2,149222,149222,149224,0,2,0
42550,4,1,149226,149226,149227,0,1,2
42551,6,3,149232,149232,149235,0,3,5
42552,4,2,149236,149236,149238,0,2,1
42553,4,3,149240,149240,149243,0,3,2
42554,1,3,149241,149243,149246,2,5,0
42555,6,2,149247,149247,149249,0,2,1
42556,5,1,149252,149252,149253,0,1,3
42557,3,3,149255,149255,149258,0,3,2
42558,2,3,149257,149258,149261,1,4,0
42559,5,2,149262,149262,149264,0,2,1
42560,4,1,149266,149266,149267,0,1,2
42561,1,2,149267,149267,149269,0,2,0
42562,4,1,149271,149271,149272,0,1,2
42563,1,2,149272,149272,149274,0,2,0
42564,3,2,149275,149275,149277,0,2,1
42565,4,1,149279,149279,149280,0,1,2
42566,4,1,149283,149283,149284,0,1,3
42567,3,2,149286,149286,149288,0,2,2
42568,2,2,149288,149288,149290,0,2,0
42569,5,2,149293,149293,149295,0,2,3
42570,1,1,149294,149295,149296,1,2,0
42571,2,2,149296,149296,149298,0,2,0
42572,2,2,149298,149298,149300,0,2,0
42573,3,2,149301,149301,149303,0,2,1
42574,1,2,149302,149303,149305,1,3,0
42575,6,3,149308,149308,149311,0,3,3
42576,6,1,149314,149314,149315,0,1,3
42577,4,1,149318,149318,149319,0,1,3
42578,1,3,149319,149319,149322,0,3,0
42579,1,2,149320,149322,149324,2,4,0
42580,6,1,149326,149326,149327,0,1,2
42581,3,3,149329,149329,149332,0,3,2
42582,4,1,149333,149333,149334,0,1,1
42583,3,3,149336,149336,149339,0,3,2
42584,2,1,149338,149339,149340,1,2,0
42585,6,1,149344,149344,149345,0,1,4
42586,6,1,149350,149350,149351,0,1,5
42587,3,3,149353,149353,149356,0,3,2
42588,3,2,149356,149356,149358,0,2,0
42589,6,1,149362,149362,149363,0,1,4
42590,4,3,149366,149366,149369,0,3,3
42591,5,1,149371,149371,149372,0,1,2
42592,2,2,149373,149373,149375,0,2,1
42593,1,2,149374,149375,149377,1,3,0
42594,5,3,149379,149379,149382,0,3,2
42595,1,3,149380,149382,149385,2,5,0
42596,3,1,149383,149385,149386,2,3,0
42597,1,1,149384,149386,149387,2,3,0
42598,1,3,149385,149387,149390,2,5,0
42599,2,2,149387,149390,149392,3,5,0
42600,4,2,149391,149392,149394,1,3,0
42601,5,3,149396,149396,149399,0,3,2
42602,4,2,149400,149400,149402,0,2,1
42603,2,2,149402,149402,149404,0,2,0
42604,1,2,149403,149404,149406,1,3,0
42605,2,1,149405,149406,149407,1,2,0
42606,4,3,149409,149409,149412,0,3,2
42607,1,2,149410,149412,149414,2,4,0
42608,2,1,149412,149414,149415,2,3,0
42609,6,2,149418,149418,149420,0,2,3
42610,1,2,149419,149420,149422,1,3,0
42611,4,1,149423,149423,149424,0,1,1
42612,3,1,149426,149426,149427,0,1,2
42613,4,1,149430,149430,149431,0,1,3
42614,4,1,149434,149434,149435,0,1,3
42615,1,3,149435,149435,149438,0,3,0
42616,3,1,149438,149438,149439,0,1,0
42617,1,2,149439,149439,149441,0,2,0
42618,2,3,149441,149441,149444,0,3,0
42619,1,1,149442,149444,149445,2,3,0
42620,4,1,149446,149446,149447,0,1,1
42621,3,2,149449,149449,149451,0,2,2
42622,2,1,149451,149451,149452,0,1,0
42623,4,3,149455,149455,149458,0,3,3
42624,2,3,149457,149458,149461,1,4,0
42625,3,1,149460,149461,149462,1,2,0
42626,5,3,149465,149465,149468,0,3,3
42627,1,1,149466,149468,149469,2,3,0
42628,4,2,149470,149470,149472,0,2,1
42629,4,3,149474,149474,149477,0,3,2
42630,2,2,149476,149477,149479,1,3,0
42631,1,2,149477,149479,149481,2,4,0
42632,2,3,149479,149481,149484,2,5,0
42633,4,3,149483,149484,149487,1,4,0
42634,5,1,149488,149488,149489,0,1,1
42635,6,3,149494,149494,149497,0,3,5
42636,5,2,149499,149499,149501,0,2,2
42637,6,3,149505,149505,149508,0,3,4
42638,1,3,149506,149508,149511,2,5,0
42639,6,3,149512,149512,149515,0,3,1
42640,1,2,149513,149515,149517,2,4,0
42641,4,3,149517,149517,149520,0,3,0
42642,6,2,149523,149523,149525,0,2,3
42643,2,2,149525,149525,149527,0,2,0
42644,4,1,149529,149529,149530,0,1,2
42645,6,3,149535,149535,149538,0,3,5
42646,3,3,149538,149538,149541,0,3,0
42647,6,3,149544,149544,149547,0,3,3
42648,3,2,149547,149547,149549,0,2,0
42649,1,3,149548,149549,149552,1,4,0
42650,6,3,149554,149554,149557,0,3,2
42651,5,3,149559,149559,149562,0,3,2
42652,2,1,149561,149562,149563,1,2,0
42653,4,2,149565,149565,149567,0,2,2
42654,4,2,149569,149569,149571,0,2,2
42655,6,2,149575,149575,149577,0,2,4
42656,3,2,149578,149578,149580,0,2,1
42657,4,1,149582,149582,149583,0,1,2
42658,4,2,149586,149586,149588,0,2,3
42659,1,1,149587,149588,149589,1,2,0
42660,2,3,149589,149589,149592,0,3,0
42661,5,1,149594,149594,149595,0,1,2
42662,2,2,149596,149596,149598,0,2,1
42663,6,1,149602,149602,149603,0,1,4
42664,1,3,149603,149603,149606,0,3,0
42665,2,1,149605,149606,149607,1,2,0
42666,5,2,149610,149610,149612,0,2,3
42667,3,2,149613,149613,149615,0,2,1
42668,5,3,149618,149618,149621,0,3,3
42669,5,2,149623,149623,149625,0,2,2
42670,5,2,149628,149628,149630,0,2,3
42671,6,2,149634,149634,149636,0,2,4
42672,2,3,149636,149636,149639,0,3,0
42673,1,2,149637,149639,149641,2,4,0
42674,4,1,149641,149641,149642,0,1,0
42675,6,3,149647,149647,149650,0,3,5
42676,6,3,149653,149653,149656,0,3,3
42677,1,3,149654,149656,149659,2,5,0
42678,3,3,149657,149659,149662,2,5,0
42679,6,3,149663,149663,149666,0,3,1
42680,4,3,149667,149667,149670,0,3,1
42681,2,1,149669,149670,149671,1,2,0
42682,4,1,149673,149673,149674,0,1,2
42683,3,1,149676,149676,149677,0,1,2
42684,3,2,149679,149679,149681,0,2,2
42685,3,3,149682,149682,149685,0,3,1
42686,3,3,149685,149685,149688,0,3,0
42687,6,3,149691,149691,149694,0,3,3
42688,5,2,149696,149696,149698,0,2,2
42689,3,2,149699,149699,149701,0,2,1
42690,2,3,149701,149701,149704,0,3,0
42691,3,3,149704,149704,149707,0,3,0
42692,3,2,149707,149707,149709,0,2,0
42693,5,1,149712,149712,149713,0,1,3
42694,5,1,149717,149717,149718,0,1,4
42695,1,3,149718,149718,149721,0,3,0
42696,1,2,149719,149721,149723,2,4,0
42697,2,3,149721,149723,149726,2,5,0
42698,1,3,149722,149726,149729,4,7,0
42699,2,3,149724,149729,149732,5,8,0
42700,6,1,149730,149732,149733,2,3,0
42701,6,1,149736,149736,149737,0,1,3
42702,2,2,149738,149738,149740,0,2,1
42703,3,3,149741,149741,149744,0,3,1
42704,3,2,149744,149744,149746,0,2,0
42705,3,1,149747,149747,149748,0,1,1
42706,5,3,149752,149752,149755,0,3,4
42707,1,1,149753,149755,149756,2,3,0
42708,5,1,149758,149758,149759,0,1,2
42709,2,1,149760,149760,149761,0,1,1
42710,2,1,149762,149762,149763,0,1,1
42711,5,2,149767,149767,149769,0,2,4
42712,4,1,149771,149771,149772,0,1,2
42713,6,3,149777,149777,149780,0,3,5
42714,1,2,149778,149780,149782,2,4,0
42715,3,3,149781,149782,149785,1,4,0
42716,5,2,149786,149786,149788,0,2,1
42717,2,1,149788,149788,149789,0,1,0
42718,3,1,149791,149791,149792,0,1,2
42719,6,2,149797,149797,149799,0,2,5
42720,3,1,149800,149800,149801,0,1,1
42721,6,2,149806,149806,149808,0,2,5
42722,2,2,149808,149808,149810,0,2,0
42723,1,2,149809,149810,149812,1,3,0
42724,1,2,149810,149812,149814,2,4,0
42725,3,2,149813,149814,149816,1,3,0
42726,4,3,149817,149817,149820,0,3,1
42727,5,2,149822,149822,149824,0,2,2
42728,6,3,149828,149828,149831,0,3,4
42729,2,2,149830,149831,149833,1,3,0
42730,6,3,149836,149836,149839,0,3,3
42731,4,1,149840,149840,149841,0,1,1
42732,5,2,149845,149845,149847,0,2,4
42733,2,1,149847,149847,149848,0,1,0
42734,3,1,149850,149850,149851,0,1,2
42735,3,1,149853,149853,149854,0,1,2
42736,5,3,149858,149858,149861,0,3,4
42737,5,1,149863,149863,149864,0,1,2
42738,3,1,149866,149866,149867,0,1,2
42739,5,2,149871,149871,149873,0,2,4
42740,5,2,149876,149876,149878,0,2,3
42741,5,3,149881,149881,149884,0,3,3
42742,2,3,149883,149884,149887,1,4,0
42743,1,3,149884,149887,149890,3,6,0
42744,4,2,149888,149890,149892,2,4,0
42745,1,3,149889,149892,149895,3,6,0
42746,6,1,149895,149895,149896,0,1,0
42747,4,3,149899,149899,149902,0,3,3
42748,1,1,149900,149902,149903,2,3,0
42749,1,1,149901,149903,149904,2,3,0
42750,1,3,149902,149904,149907,2,5,0
42751,6,1,149908,149908,149909,0,1,1
42752,3,1,149911,149911,149912,0,1,2
42753,4,2,149915,149915,149917,0,2,3
42754,2,3,149917,149917,149920,0,3,0
42755,6,3,149923,149923,149926,0,3,3
42756,1,3,149924,149926,149929,2,5,0
42757,1,2,149925,149929,149931,4,6,0
42758,4,2,149929,149931,149933,2,4,0
42759,4,1,149933,149933,149934,0,1,0
42760,4,3,149937,149937,149940,0,3,3
42761,4,3,149941,149941,149944,0,3,1
42762,1,2,149942,149944,149946,2,4,0
42763,5,1,149947,149947,149948,0,1,1
42764,2,3,149949,149949,149952,0,3,1
42765,6,2,149955,149955,149957,0,2,3
42766,3,2,149958,149958,149960,0,2,1
42767,1,3,149959,149960,149963,1,4,0
42768,2,1,149961,149963,149964,2,3,0
42769,3,3,149964,149964,149967,0,3,0
42770,3,3,149967,149967,149970,0,3,0
42771,4,2,149971,149971,149973,0,2,1
42772,1,3,149972,149973,149976,1,4,0
42773,4,1,149976,149976,149977,0,1,0
42774,3,3,149979,149979,149982,0,3,2
42775,1,3,149980,149982,149985,2,5,0
42776,5,1,149985,149985,149986,0,1,0
42777,2,3,149987,149987,149990,0,3,1
42778,2,3,149989,149990,149993,1,4,0
42779,4,3,149993,149993,149996,0,3,0
42780,3,3,149996,149996,149999,0,3,0
42781,1,2,149997,149999,150001,2,4,0
42782,3,1,150000,150001,150002,1,2,0
42783,2,1,150002,150002,150003,0,1,0
42784,5,2,150007,150007,150009,0,2,4
42785,1,2,150008,150009,150011,1,3,0
42786,1,1,150009,150011,150012,2,3,0
42787,2,2,150011,150012,150014,1,3,0
42788,2,2,150013,150014,150016,1,3,0
42789,3,2,150016,150016,150018,0,2,0
42790,5,1,150021,150021,150022,0,1,3
42791,4,3,150025,150025,150028,0,3,3
42792,2,1,150027,150028,150029,1,2,0
42793,5,1,150032,150032,150033,0,1,3
42794,1,2,150033,150033,150035,0,2,0
42795,2,2,150035,150035,150037,0,2,0
42796,4,2,150039,150039,150041,0,2,2
42797,5,3,150044,150044,150047,0,3,3
42798,4,2,150048,150048,150050,0,2,1
42799,5,1,150053,150053,150054,0,1,3
42800,6,1,150059,150059,150060,0,1,5
42801,3,3,150062,150062,150065,0,3,2
42802,4,2,150066,150066,150068,0,2,1
42803,5,2,150071,150071,150073,0,2,3
42804,2,2,150073,150073,150075,0,2,0
42805,6,2,150079,150079,150081,0,2,4
42806,1,2,150080,150081,150083,1,3,0
42807,1,3,150081,150083,150086,2,5,0
42808,4,2,150085,150086,150088,1,3,0
42809,6,1,150091,150091,150092,0,1,3
42810,1,3,150092,150092,150095,0,3,0
42811,4,1,150096,150096,150097,0,1,1
42812,4,3,150100,150100,150103,0,3,3
42813,3,1,150103,150103,150104,0,1,0
42814,4,2,150107,150107,150109,0,2,3
42815,5,3,150112,150112,150115,0,3,3
42816,4,2,150116,150116,150118,0,2,1
42817,5,3,150121,150121,150124,0,3,3
42818,5,1,150126,150126,150127,0,1,2
42819,3,1,150129,150129,150130,0,1,2
42820,1,1,150130,150130,150131,0,1,0
42821,3,1,150133,150133,150134,0,1,2
42822,1,3,150134,150134,150137,0,3,0
42823,1,2,150135,150137,150139,2,4,0
42824,3,3,150138,150139,150142,1,4,0
42825,6,1,150144,150144,150145,0,1,2
42826,4,3,150148,150148,150151,0,3,3
42827,1,3,150149,150151,150154,2,5,0
42828,2,3,150151,150154,150157,3,6,0
42829,4,3,150155,150157,150160,2,5,0
42830,6,1,150161,150161,150162,0,1,1
42831,6,3,150167,150167,150170,0,3,5
42832,6,1,150173,150173,150174,0,1,3
42833,4,3,150177,150177,150180,0,3,3
42834,6,1,150183,150183,150184,0,1,3
42835,2,1,150185,150185,150186,0,1,1
42836,5,1,150190,150190,150191,0,1,4
42837,6,3,150196,150196,150199,0,3,5
42838,2,2,150198,150199,150201,1,3,0
42839,6,1,150204,150204,150205,0,1,3
42840,6,1,150210,150210,150211,0,1,5
42841,4,2,150214,150214,150216,0,2,3
42842,6,3,150220,150220,150223,0,3,4
42843,3,2,150223,150223,150225,0,2,0
42844,4,2,150227,150227,150229,0,2,2
42845,2,3,150229,150229,150232,0,3,0
42846,3,1,150232,150232,150233,0,1,0
42847,3,3,150235,150235,150238,0,3,2
42848,6,1,150241,150241,150242,0,1,3
42849,4,1,150245,150245,150246,0,1,3
42850,6,2,150251,150251,150253,0,2,5
42851,1,3,150252,150253,150256,1,4,0
42852,5,3,150257,150257,150260,0,3,1
42853,3,2,150260,150260,150262,0,2,0
42854,5,2,150265,150265,150267,0,2,3
42855,1,2,150266,150267,150269,1,3,0
42856,4,3,150270,150270,150273,0,3,1
42857,1,1,150271,150273,150274,2,3,0
42858,3,3,150274,150274,150277,0,3,0
42859,5,1,150279,150279,150280,0,1,2
42860,6,3,150285,150285,150288,0,3,5
42861,1,3,150286,150288,150291,2,5,0
42862,2,1,150288,150291,150292,3,4,0
42863,5,3,150293,150293,150296,0,3,1
42864,3,2,150296,150296,150298,0,2,0
42865,4,2,150300,150300,150302,0,2,2
42866,5,1,150305,150305,150306,0,1,3
42867,3,1,150308,150308,150309,0,1,2
42868,4,3,150312,150312,150315,0,3,3
42869,2,2,150314,150315,150317,1,3,0
42870,5,1,150319,150319,150320,0,1,2
42871,2,3,150321,150321,150324,0,3,1
42872,2,2,150323,150324,150326,1,3,0
42873,2,3,150325,150326,150329,1,4,0
42874,3,3,150328,150329,150332,1,4,0
42875,5,3,150333,150333,150336,0,3,1
42876,5,2,150338,150338,150340,0,2,2
42877,3,1,150341,150341,150342,0,1,1
42878,5,3,150346,150346,150349,0,3,4
42879,6,2,150352,150352,150354,0,2,3
42880,3,2,150355,150355,150357,0,2,1
42881,4,3,150359,150359,150362,0,3,2
42882,5,1,150364,150364,150365,0,1,2
42883,3,2,150367,150367,150369,0,2,2
42884,1,1,150368,150369,150370,1,2,0
42885,2,1,150370,150370,150371,0,1,0
42886,4,3,150374,150374,150377,0,3,3
42887,6,3,150380,150380,150383,0,3,3
42888,3,3,150383,150383,150386,0,3,0
42889,6,1,150389,150389,150390,0,1,3
42890,2,2,150391,150391,150393,0,2,1
42891,3,3,150394,150394,150397,0,3,1
42892,5,2,150399,150399,150401,0,2,2
42893,2,1,150401,150401,150402,0,1,0
42894,6,1,150407,150407,150408,0,1,5
42895,5,3,150412,150412,150415,0,3,4
42896,1,3,150413,150415,150418,2,5,0
42897,2,3,150415,150418,150421,3,6,0
42898,1,1,150416,150421,150422,5,6,0
42899,3,3,150419,150422,150425,3,6,0
42900,4,2,150423,150425,150427,2,4,0
42901,6,3,150429,150429,150432,0,3,2
42902,3,3,150432,150432,150435,0,3,0
42903,1,1,150433,150435,150436,2,3,0
42904,1,2,150434,150436,150438,2,4,0
42905,1,2,150435,150438,150440,3,5,0
42906,5,2,150440,150440,150442,0,2,0
42907,3,1,150443,150443,150444,0,1,1
42908,1,1,150444,150444,150445,0,1,0
42909,5,2,150449,150449,150451,0,2,4
42910,3,2,150452,150452,150454,0,2,1
42911,3,1,150455,150455,150456,0,1,1
42912,5,1,150460,150460,150461,0,1,4
42913,2,3,150462,150462,150465,0,3,1
42914,3,2,150465,150465,150467,0,2,0
42915,4,1,150469,150469,150470,0,1,2
42916,4,1,150473,150473,150474,0,1,3
42917,3,2,150476,150476,150478,0,2,2
42918,5,1,150481,150481,150482,0,1,3
42919,2,1,150483,150483,150484,0,1,1
42920,1,2,150484,150484,150486,0,2,0
42921,3,3,150487,150487,150490,0,3,1
42922,3,2,150490,150490,150492,0,2,0
42923,5,3,150495,150495,150498,0,3,3
42924,6,2,150501,150501,150503,0,2,3
42925,3,2,150504,150504,150506,0,2,1
42926,2,3,150506,150506,150509,0,3,0
42927,6,1,150512,150512,150513,0,1,3
42928,5,1,150517,150517,150518,0,1,4
42929,1,3,150518,150518,150521,0,3,0
42930,5,3,150523,150523,150526,0,3,2
42931,5,2,150528,150528,150530,0,2,2
42932,2,3,150530,150530,150533,0,3,0
42933,6,3,150536,150536,150539,0,3,3
42934,4,2,150540,150540,150542,0,2,1
42935,3,2,150543,150543,150545,0,2,1
42936,1,2,150544,150545,150547,1,3,0
42937,4,1,150548,150548,150549,0,1,1
42938,5,3,150553,150553,150556,0,3,4
42939,5,1,150558,150558,150559,0,1,2
42940,3,2,150561,150561,150563,0,2,2
42941,1,2,150562,150563,150565,1,3,0
42942,5,3,150567,150567,150570,0,3,2
42943,1,2,150568,150570,150572,2,4,0
42944,5,2,150573,150573,150575,0,2,1
42945,3,2,150576,150576,150578,0,2,1
42946,4,3,150580,150580,150583,0,3,2
42947,3,1,150583,150583,150584,0,1,0
42948,5,1,150588,150588,150589,0,1,4
42949,2,3,150590,150590,150593,0,3,1
42950,6,1,150596,150596,150597,0,1,3
42951,2,1,150598,150598,150599,0,1,1
42952,1,1,150599,150599,150600,0,1,0
42953,5,3,150604,150604,150607,0,3,4
42954,6,1,150610,150610,150611,0,1,3
42955,5,2,150615,150615,150617,0,2,4
42956,5,1,150620,150620,150621,0,1,3
42957,2,1,150622,150622,150623,0,1,1
42958,1,2,150623,150623,150625,0,2,0
42959,5,1,150628,150628,150629,0,1,3
42960,5,1,150633,150633,150634,0,1,4
42961,1,3,150634,150634,150637,0,3,0
42962,1,3,150635,150637,150640,2,5,0
42963,3,1,150638,150640,150641,2,3,0
42964,4,2,150642,150642,150644,0,2,1
42965,5,2,150647,150647,150649,0,2,3
42966,3,2,150650,150650,150652,0,2,1
42967,1,2,150651,150652,150654,1,3,0
42968,5,1,150656,150656,150657,0,1,2
42969,3,3,150659,150659,150662,0,3,2
42970,6,1,150665,150665,150666,0,1,3
42971,2,1,150667,150667,150668,0,1,1
42972,3,1,150670,150670,150671,0,1,2
42973,2,2,150672,150672,150674,0,2,1
42974,1,2,150673,150674,150676,1,3,0
42975,2,3,150675,150676,150679,1,4,0
42976,1,3,150676,150679,150682,3,6,0
42977,2,1,150678,150682,150683,4,5,0
42978,2,1,150680,150683,150684,3,4,0
42979,5,3,150685,150685,150688,0,3,1
42980,2,2,150687,150688,150690,1,3,0
42981,1,1,150688,150690,150691,2,3,0
42982,5,3,150693,150693,150696,0,3,2
42983,2,1,150695,150696,150697,1,2,0
42984,2,2,150697,150697,150699,0,2,0
42985,2,2,150699,150699,150701,0,2,0
42986,4,3,150703,150703,150706,0,3,2
42987,2,3,150705,150706,150709,1,4,0
42988,3,1,150708,150709,150710,1,2,0
42989,2,2,150710,150710,150712,0,2,0
42990,5,1,150715,150715,150716,0,1,3
42991,3,2,150718,150718,150720,0,2,2
42992,1,2,150719,150720,150722,1,3,0
42993,3,2,150722,150722,150724,0,2,0
42994,1,1,150723,150724,150725,1,2,0
42995,3,2,150726,150726,150728,0,2,1
42996,1,2,150727,150728,150730,1,3,0
42997,5,1,150732,150732,150733,0,1,2
42998,1,3,150733,150733,150736,0,3,0
42999,5,3,150738,150738,150741,0,3,2
43000,4,2,150742,150742,150744,0,2,1
43001,6,3,150748,150748,150751,0,3,4
43002,4,3,150752,150752,150755,0,3,1
43003,4,3,150756,150756,150759,0,3,1
43004,3,2,150759,150759,150761,0,2,0
43005,2,1,150761,150761,150762,0,1,0
43006,4,1,150765,150765,150766,0,1,3
43007,4,2,150769,150769,150771,0,2,3
43008,5,2,150774,150774,150776,0,2,3
43009,6,3,150780,150780,150783,0,3,4
43010,2,1,150782,150783,150784,1,2,0
43011,3,2,150785,150785,150787,0,2,1
43012,1,1,150786,150787,150788,1,2,0
43013,1,3,150787,150788,150791,1,4,0
43014,2,2,150789,150791,150793,2,4,0
43015,4,3,150793,150793,150796,0,3,0
43016,1,3,150794,150796,150799,2,5,0
43017,4,2,150798,150799,150801,1,3,0
43018,5,3,150803,150803,150806,0,3,2
43019,6,2,150809,150809,150811,0,2,3
43020,3,2,150812,150812,150814,0,2,1
43021,3,1,150815,150815,150816,0,1,1
43022,4,3,150819,150819,150822,0,3,3
43023,5,3,150824,150824,150827,0,3,2
43024,5,3,150829,150829,150832,0,3,2
43025,1,1,150830,150832,150833,2,3,0
43026,4,3,150834,150834,150837,0,3,1
43027,2,1,150836,150837,150838,1,2,0
43028,3,2,150839,150839,150841,0,2,1
43029,3,2,150842,150842,150844,0,2,1
43030,2,2,150844,150844,150846,0,2,0
43031,5,3,150849,150849,150852,0,3,3
43032,5,2,150854,150854,150856,0,2,2
43033,4,3,150858,150858,150861,0,3,2
43034,6,3,150864,150864,150867,0,3,3
43035,1,2,150865,150867,150869,2,4,0
43036,1,3,150866,150869,150872,3,6,0
43037,1,1,150867,150872,150873,5,6,0
43038,1,2,150868,150873,150875,5,7,0
43039,2,1,150870,150875,150876,5,6,0
43040,6,1,150876,150876,150877,0,1,0
43041,6,1,150882,150882,150883,0,1,5
43042,2,1,150884,150884,150885,0,1,1
43043,4,2,150888,150888,150890,0,2,3
43044,4,1,150892,150892,150893,0,1,2
43045,1,3,150893,150893,150896,0,3,0
43046,1,2,150894,150896,150898,2,4,0
43047,4,1,150898,150898,150899,0,1,0
43048,1,1,150899,150899,150900,0,1,0
43049,6,3,150905,150905,150908,0,3,5
43050,6,1,150911,150911,150912,0,1,3
43051,2,2,150913,150913,150915,0,2,1
43052,4,3,150917,150917,150920,0,3,2
43053,4,1,150921,150921,150922,0,1,1
43054,5,2,150926,150926,150928,0,2,4
43055,2,1,150928,150928,150929,0,1,0
43056,5,3,150933,150933,150936,0,3,4
43057,5,3,150938,150938,150941,0,3,2
43058,5,2,150943,150943,150945,0,2,2
43059,3,2,150946,150946,150948,0,2,1
43060,1,1,150947,150948,150949,1,2,0
43061,6,1,150953,150953,150954,0,1,4
43062,1,3,150954,150954,150957,0,3,0
43063,3,1,150957,150957,150958,0,1,0
43064,1,3,150958,150958,150961,0,3,0
43065,5,3,150963,150963,150966,0,3,2
43066,5,3,150968,150968,150971,0,3,2
43067,1,2,150969,150971,150973,2,4,0
43068,1,1,150970,150973,150974,3,4,0
43069,4,3,150974,150974,150977,0,3,0
43070,6,1,150980,150980,150981,0,1,3
43071,1,2,150981,150981,150983,0,2,0
43072,3,3,150984,150984,150987,0,3,1
43073,3,1,150987,150987,150988,0,1,0
43074,2,1,150989,150989,150990,0,1,1
43075,1,2,150990,150990,150992,0,2,0
43076,2,1,150992,150992,150993,0,1,0
43077,6,2,150998,150998,151000,0,2,5
43078,4,1,151002,151002,151003,0,1,2
43079,5,3,151007,151007,151010,0,3,4
43080,3,1,151010,151010,151011,0,1,0
43081,1,2,151011,151011,151013,0,2,0
43082,2,3,151013,151013,151016,0,3,0
43083,4,1,151017,151017,151018,0,1,1
43084,1,3,151018,151018,151021,0,3,0
43085,4,3,151022,151022,151025,0,3,1
43086,5,2,151027,151027,151029,0,2,2
43087,1,1,151028,151029,151030,1,2,0
43088,5,2,151033,151033,151035,0,2,3
43089,6,3,151039,151039,151042,0,3,4
43090,6,2,151045,151045,151047,0,2,3
43091,2,2,151047,151047,151049,0,2,0
43092,5,3,151052,151052,151055,0,3,3
43093,4,3,151056,151056,151059,0,3,1
43094,3,3,151059,151059,151062,0,3,0
43095,4,1,151063,151063,151064,0,1,1
43096,5,3,151068,151068,151071,0,3,4
43097,1,3,151069,151071,151074,2,5,0
43098,6,2,151075,151075,151077,0,2,1
43099,5,2,151080,151080,151082,0,2,3
43100,3,2,151083,151083,151085,0,2,1
43101,3,1,151086,151086,151087,0,1,1
43102,3,1,151089,151089,151090,0,1,2
43103,2,1,151091,151091,151092,0,1,1
43104,3,2,151094,151094,151096,0,2,2
43105,2,1,151096,151096,151097,0,1,0
43106,3,3,151099,151099,151102,0,3,2
43107,5,1,151104,151104,151105,0,1,2
43108,1,3,151105,151105,151108,0,3,0
43109,1,2,151106,151108,151110,2,4,0
43110,5,1,151111,151111,151112,0,1,1
43111,2,2,151113,151113,151115,0,2,1
43112,3,3,151116,151116,151119,0,3,1
43113,2,2,151118,151119,151121,1,3,0
43114,6,1,151124,151124,151125,0,1,3
43115,6,2,151130,151130,151132,0,2,5
43116,4,3,151134,151134,151137,0,3,2
43117,6,3,151140,151140,151143,0,3,3
43118,2,2,151142,151143,151145,1,3,0
43119,4,2,151146,151146,151148,0,2,1
43120,5,2,151151,151151,151153,0,2,3
43121,4,2,151155,151155,151157,0,2,2
43122,5,3,151160,151160,151163,0,3,3
43123,1,3,151161,151163,151166,2,5,0
43124,6,2,151167,151167,151169,0,2,1
43125,1,2,151168,151169,151171,1,3,0
43126,4,1,151172,151172,151173,0,1,1
43127,6,1,151178,151178,151179,0,1,5
43128,4,1,151182,151182,151183,0,1,3
43129,1,3,151183,151183,151186,0,3,0
43130,6,2,151189,151189,151191,0,2,3
43131,2,2,151191,151191,151193,0,2,0
43132,4,3,151195,151195,151198,0,3,2
43133,1,1,151196,151198,151199,2,3,0
43134,5,2,151201,151201,151203,0,2,2
43135,4,1,151205,151205,151206,0,1,2
43136,2,2,151207,151207,151209,0,2,1
43137,6,1,151213,151213,151214,0,1,4
43138,5,1,151218,151218,151219,0,1,4
43139,2,3,151220,151220,151223,0,3,1
43140,5,2,151225,151225,151227,0,2,2
43141,6,1,151231,151231,151232,0,1,4
43142,4,3,151235,151235,151238,0,3,3
43143,6,2,151241,151241,151243,0,2,3
43144,3,3,151244,151244,151247,0,3,1
43145,5,2,151249,151249,151251,0,2,2
43146,4,1,151253,151253,151254,0,1,2
43147,3,3,151256,151256,151259,0,3,2
43148,4,3,151260,151260,151263,0,3,1
43149,3,1,151263,151263,151264,0,1,0
43150,4,3,151267,151267,151270,0,3,3
43151,1,1,151268,151270,151271,2,3,0
43152,6,1,151274,151274,151275,0,1,3
43153,4,1,151278,151278,151279,0,1,3
43154,5,2,151283,151283,151285,0,2,4
43155,5,3,151288,151288,151291,0,3,3
43156,1,2,151289,151291,151293,2,4,0
43157,4,1,151293,151293,151294,0,1,0
43158,6,1,151299,151299,151300,0,1,5
43159,5,3,151304,151304,151307,0,3,4
43160,6,1,151310,151310,151311,0,1,3
43161,4,3,151314,151314,151317,0,3,3
43162,6,3,151320,151320,151323,0,3,3
43163,2,1,151322,151323,151324,1,2,0
43164,3,2,151325,151325,151327,0,2,1
43165,3,1,151328,151328,151329,0,1,1
43166,5,2,151333,151333,151335,0,2,4
43167,2,3,151335,151335,151338,0,3,0
43168,3,1,151338,151338,151339,0,1,0
43169,4,1,151342,151342,151343,0,1,3
43170,3,3,151345,151345,151348,0,3,2
43171,6,1,151351,151351,151352,0,1,3
43172,3,3,151354,151354,151357,0,3,2
43173,6,2,151360,151360,151362,0,2,3
43174,2,2,151362,151362,151364,0,2,0
43175,2,3,151364,151364,151367,0,3,0
43176,3,3,151367,151367,151370,0,3,0
43177,4,2,151371,151371,151373,0,2,1
43178,4,1,151375,151375,151376,0,1,2
43179,5,2,151380,151380,151382,0,2,4
43180,4,1,151384,151384,151385,0,1,2
43181,6,3,151390,151390,151393,0,3,5
43182,4,2,151394,151394,151396,0,2,1
43183,3,1,151397,151397,151398,0,1,1
43184,4,3,151401,151401,151404,0,3,3
43185,4,1,151405,151405,151406,0,1,1
43186,5,1,151410,151410,151411,0,1,4
43187,3,1,151413,151413,151414,0,1,2
43188,2,2,151415,151415,151417,0,2,1
43189,4,3,151419,151419,151422,0,3,2
43190,1,1,151420,151422,151423,2,3,0
43191,4,3,151424,151424,151427,0,3,1
43192,5,1,151429,151429,151430,0,1,2
43193,4,1,151433,151433,151434,0,1,3
43194,2,1,151435,151435,151436,0,1,1
43195,3,2,151438,151438,151440,0,2,2
43196,3,2,151441,151441,151443,0,2,1
43197,6,2,151447,151447,151449,0,2,4
43198,5,3,151452,151452,151455,0,3,3
43199,1,2,151453,151455,151457,2,4,0
43200,5,1,151458,151458,151459,0,1,1
43201,2,2,151460,151460,151462,0,2,1
43202,6,3,151466,151466,151469,0,3,4
43203,1,3,151467,151469,151472,2,5,0
43204,5,2,151472,151472,151474,0,2,0
43205,4,1,151476,151476,151477,0,1,2
43206,5,2,151481,151481,151483,0,2,4
43207,6,2,151487,151487,151489,0,2,4
43208,4,2,151491,151491,151493,0,2,2
43209,2,2,151493,151493,151495,0,2,0
43210,3,2,151496,151496,151498,0,2,1
43211,6,2,151502,151502,151504,0,2,4
43212,4,1,151506,151506,151507,0,1,2
43213,1,3,151507,151507,151510,0,3,0
43214,4,2,151511,151511,151513,0,2,1
43215,3,2,151514,151514,151516,0,2,1
43216,6,2,151520,151520,151522,0,2,4
43217,2,1,151522,151522,151523,0,1,0
43218,3,1,151525,151525,151526,0,1,2
43219,3,2,151528,151528,151530,0,2,2
43220,3,2,151531,151531,151533,0,2,1
43221,2,2,151533,151533,151535,0,2,0
43222,4,1,151537,151537,151538,0,1,2
43223,4,1,151541,151541,151542,0,1,3
43224,3,2,151544,151544,151546,0,2,2
43225,1,3,151545,151546,151549,1,4,0
43226,2,2,151547,151549,151551,2,4,0
43227,3,2,151550,151551,151553,1,3,0
43228,1,1,151551,151553,151554,2,3,0
43229,6,1,151557,151557,151558,0,1,3
43230,5,3,151562,151562,151565,0,3,4
43231,6,1,151568,151568,151569,0,1,3
43232,4,1,151572,151572,151573,0,1,3
43233,6,1,151578,151578,151579,0,1,5
43234,3,1,151581,151581,151582,0,1,2
43235,5,2,151586,151586,151588,0,2,4
43236,4,3,151590,151590,151593,0,3,2
43237,6,1,151596,151596,151597,0,1,3
43238,3,1,151599,151599,151600,0,1,2
43239,4,3,151603,151603,151606,0,3,3
43240,6,3,151609,151609,151612,0,3,3
43241,4,1,151613,151613,151614,0,1,1
43242,6,1,151619,151619,151620,0,1,5
43243,1,3,151620,151620,151623,0,3,0
43244,3,3,151623,151623,151626,0,3,0
43245,3,3,151626,151626,151629,0,3,0
43246,6,3,151632,151632,151635,0,3,3
43247,1,1,151633,151635,151636,2,3,0
43248,1,3,151634,151636,151639,2,5,0
43249,1,3,151635,151639,151642,4,7,0
43250,5,1,151640,151642,151643,2,3,0
43251,1,3,151641,151643,151646,2,5,0
43252,6,3,151647,151647,151650,0,3,1
43253,6,3,151653,151653,151656,0,3,3
43254,2,2,151655,151656,151658,1,3,0
43255,6,2,151661,151661,151663,0,2,3
43256,4,1,151665,151665,151666,0,1,2
43257,1,1,151666,151666,151667,0,1,0
43258,4,2,151670,151670,151672,0,2,3
43259,6,2,151676,151676,151678,0,2,4
43260,5,2,151681,151681,151683,0,2,3
43261,4,2,151685,151685,151687,0,2,2
43262,6,1,151691,151691,151692,0,1,4
43263,4,3,151695,151695,151698,0,3,3
43264,5,2,151700,151700,151702,0,2,2
43265,2,2,151702,151702,151704,0,2,0
43266,5,1,151707,151707,151708,0,1,3
43267,5,2,151712,151712,151714,0,2,4
43268,1,3,151713,151714,151717,1,4,0
43269,4,2,151717,151717,151719,0,2,0
43270,2,1,151719,151719,151720,0,1,0
43271,1,2,151720,151720,151722,0,2,0
43272,1,1,151721,151722,151723,1,2,0
43273,3,2,151724,151724,151726,0,2,1
43274,3,2,151727,151727,151729,0,2,1
43275,4,3,151731,151731,151734,0,3,2
43276,5,2,151736,151736,151738,0,2,2
43277,3,2,151739,151739,151741,0,2,1
43278,5,1,151744,151744,151745,0,1,3
43279,3,1,151747,151747,151748,0,1,2
43280,1,3,151748,151748,151751,0,3,0
43281,1,2,151749,151751,151753,2,4,0
43282,2,3,151751,151753,151756,2,5,0
43283,2,1,151753,151756,151757,3,4,0
43284,4,3,151757,151757,151760,0,3,0
43285,6,2,151763,151763,151765,0,2,3
43286,5,3,151768,151768,151771,0,3,3
43287,3,2,151771,151771,151773,0,2,0
43288,6,1,151777,151777,151778,0,1,4
43289,1,1,151778,151778,151779,0,1,0
43290,1,3,151779,151779,151782,0,3,0
43291,5,1,151784,151784,151785,0,1,2
43292,2,2,151786,151786,151788,0,2,1
43293,6,1,151792,151792,151793,0,1,4
43294,5,2,151797,151797,151799,0,2,4
43295,4,3,151801,151801,151804,0,3,2
43296,4,3,151805,151805,151808,0,3,1
43297,6,1,151811,151811,151812,0,1,3
43298,4,3,151815,151815,151818,0,3,3
43299,4,3,151819,151819,151822,0,3,1
43300,3,3,151822,151822,151825,0,3,0
43301,6,2,151828,151828,151830,0,2,3
43302,4,2,151832,151832,151834,0,2,2
43303,4,3,151836,151836,151839,0,3,2
43304,5,3,151841,151841,151844,0,3,2
43305,4,3,151845,151845,151848,0,3,1
43306,1,3,151846,151848,151851,2,5,0
43307,2,3,151848,151851,151854,3,6,0
43308,3,1,151851,151854,151855,3,4,0
43309,5,1,151856,151856,151857,0,1,1
43310,3,3,151859,151859,151862,0,3,2
43311,3,2,151862,151862,151864,0,2,0
43312,2,3,151864,151864,151867,0,3,0
43313,1,3,151865,151867,151870,2,5,0
43314,3,2,151868,151870,151872,2,4,0
43315,2,3,151870,151872,151875,2,5,0
43316,3,2,151873,151875,151877,2,4,0
43317,2,2,151875,151877,151879,2,4,0
43318,4,2,151879,151879,151881,0,2,0
43319,1,2,151880,151881,151883,1,3,0
43320,2,3,151882,151883,151886,1,4,0
43321,5,2,151887,151887,151889,0,2,1
43322,3,3,151890,151890,151893,0,3,1
43323,2,2,151892,151893,151895,1,3,0
43324,6,1,151898,151898,151899,0,1,3
43325,6,1,151904,151904,151905,0,1,5
43326,5,3,151909,151909,151912,0,3,4
43327,6,2,151915,151915,151917,0,2,3
43328,3,1,151918,151918,151919,0,1,1
43329,4,1,151922,151922,151923,0,1,3
43330,4,3,151926,151926,151929,0,3,3
43331,1,1,151927,151929,151930,2,3,0
43332,2,1,151929,151930,151931,1,2,0
43333,3,2,151932,151932,151934,0,2,1
43334,3,1,151935,151935,151936,0,1,1
43335,6,2,151941,151941,151943,0,2,5
43336,6,2,151947,151947,151949,0,2,4
43337,6,2,151953,151953,151955,0,2,4
43338,4,2,151957,151957,151959,0,2,2
43339,5,2,151962,151962,151964,0,2,3
43340,6,1,151968,151968,151969,0,1,4
43341,6,3,151974,151974,151977,0,3,5
43342,1,2,151975,151977,151979,2,4,0
43343,3,2,151978,151979,151981,1,3,0
43344,4,1,151982,151982,151983,0,1,1
43345,1,3,151983,151983,151986,0,3,0
43346,6,2,151989,151989,151991,0,2,3
43347,6,3,151995,151995,151998,0,3,4
43348,5,1,152000,152000,152001,0,1,2
43349,5,3,152005,152005,152008,0,3,4
43350,5,2,152010,152010,152012,0,2,2
43351,2,2,152012,152012,152014,0,2,0
43352,6,1,152018,152018,152019,0,1,4
43353,2,3,152020,152020,152023,0,3,1
43354,1,3,152021,152023,152026,2,5,0
43355,4,2,152025,152026,152028,1,3,0
43356,1,3,152026,152028,152031,2,5,0
43357,6,3,152032,152032,152035,0,3,1
43358,3,2,152035,152035,152037,0,2,0
43359,1,2,152036,152037,152039,1,3,0
43360,3,3,152039,152039,152042,0,3,0
43361,1,2,152040,152042,152044,2,4,0
43362,1,3,152041,152044,152047,3,6,0
43363,6,2,152047,152047,152049,0,2,0
43364,2,1,152049,152049,152050,0,1,0
43365,5,2,152054,152054,152056,0,2,4
43366,4,3,152058,152058,152061,0,3,2
43367,3,2,152061,152061,152063,0,2,0
43368,5,2,152066,152066,152068,0,2,3
43369,5,2,152071,152071,152073,0,2,3
43370,4,1,152075,152075,152076,0,1,2
43371,3,1,152078,152078,152079,0,1,2
43372,4,2,152082,152082,152084,0,2,3
43373,4,3,152086,152086,152089,0,3,2
43374,6,1,152092,152092,152093,0,1,3
43375,5,3,152097,152097,152100,0,3,4
43376,4,1,152101,152101,152102,0,1,1
43377,6,1,152107,152107,152108,0,1,5
43378,4,3,152111,152111,152114,0,3,3
43379,3,1,152114,152114,152115,0,1,0
43380,5,3,152119,152119,152122,0,3,4
43381,2,3,152121,152122,152125,1,4,0
43382,6,1,152127,152127,152128,0,1,2
43383,2,1,152129,152129,152130,0,1,1
43384,2,2,152131,152131,152133,0,2,1
43385,2,2,152133,152133,152135,0,2,0
43386,2,3,152135,152135,152138,0,3,0
43387,1,1,152136,152138,152139,2,3,0
43388,3,1,152139,152139,152140,0,1,0
43389,6,3,152145,152145,152148,0,3,5
43390,6,3,152151,152151,152154,0,3,3
43391,3,1,152154,152154,152155,0,1,0
43392,5,2,152159,152159,152161,0,2,4
43393,5,2,152164,152164,152166,0,2,3
43394,1,1,152165,152166,152167,1,2,0
43395,6,1,152171,152171,152172,0,1,4
43396,6,2,152177,152177,152179,0,2,5
43397,5,3,152182,152182,152185,0,3,3
43398,1,2,152183,152185,152187,2,4,0
43399,4,1,152187,152187,152188,0,1,0
43400,3,2,152190,152190,152192,0,2,2
43401,6,1,152196,152196,152197,0,1,4
43402,5,3,152201,152201,152204,0,3,4
43403,1,2,152202,152204,152206,2,4,0
43404,3,3,152205,152206,152209,1,4,0
43405,1,3,152206,152209,152212,3,6,0
43406,4,2,152210,152212,152214,2,4,0
43407,1,2,152211,152214,152216,3,5,0
43408,2,2,152213,152216,152218,3,5,0
43409,3,1,152216,152218,152219,2,3,0
43410,3,1,152219,152219,152220,0,1,0
43411,1,2,152220,152220,152222,0,2,0
43412,6,2,152226,152226,152228,0,2,4
43413,1,3,152227,152228,152231,1,4,0
43414,6,3,152233,152233,152236,0,3,2
43415,1,3,152234,152236,152239,2,5,0
43416,1,2,152235,152239,152241,4,6,0
43417,3,1,152238,152241,152242,3,4,0
43418,1,3,152239,152242,152245,3,6,0
43419,2,1,152241,152245,152246,4,5,0
43420,2,2,152243,152246,152248,3,5,0
43421,1,1,152244,152248,152249,4,5,0
43422,4,1,152248,152249,152250,1,2,0
43423,6,1,152254,152254,152255,0,1,4
43424,2,1,152256,152256,152257,0,1,1
43425,6,2,152262,152262,152264,0,2,5
43426,4,1,152266,152266,152267,0,1,2
43427,1,1,152267,152267,152268,0,1,0
43428,5,3,152272,152272,152275,0,3,4
43429,5,2,152277,152277,152279,0,2,2
43430,5,2,152282,152282,152284,0,2,3
43431,6,1,152288,152288,152289,0,1,4
43432,4,1,152292,152292,152293,0,1,3
43433,2,3,152294,152294,152297,0,3,1
43434,6,1,152300,152300,152301,0,1,3
43435,3,3,152303,152303,152306,0,3,2
43436,3,3,152306,152306,152309,0,3,0
43437,3,1,152309,152309,152310,0,1,0
43438,5,2,152314,152314,152316,0,2,4
43439,1,1,152315,152316,152317,1,2,0
43440,1,2,152316,152317,152319,1,3,0
43441,2,1,152318,152319,152320,1,2,0
43442,6,3,152324,152324,152327,0,3,4
43443,5,2,152329,152329,152331,0,2,2
43444,6,3,152335,152335,152338,0,3,4
43445,3,3,152338,152338,152341,0,3,0
43446,1,2,152339,152341,152343,2,4,0
43447,1,1,152340,152343,152344,3,4,0
43448,4,3,152344,152344,152347,0,3,0
43449,6,2,152350,152350,152352,0,2,3
43450,1,3,152351,152352,152355,1,4,0
43451,5,1,152356,152356,152357,0,1,1
43452,1,1,152357,152357,152358,0,1,0
43453,1,3,152358,152358,152361,0,3,0
43454,1,1,152359,152361,152362,2,3,0
43455,5,2,152364,152364,152366,0,2,2
43456,5,1,152369,152369,152370,0,1,3
43457,1,3,152370,152370,152373,0,3,0
43458,5,1,152375,152375,152376,0,1,2
43459,5,1,152380,152380,152381,0,1,4
43460,3,1,152383,152383,152384,0,1,2
43461,2,3,152385,152385,152388,0,3,1
43462,4,1,152389,152389,152390,0,1,1
43463,6,2,152395,152395,152397,0,2,5
43464,1,2,152396,152397,152399,1,3,0
43465,3,3,152399,152399,152402,0,3,0
43466,6,3,152405,152405,152408,0,3,3
43467,1,3,152406,152408,152411,2,5,0
43468,5,1,152411,152411,152412,0,1,0
43469,4,2,152415,152415,152417,0,2,3
43470,6,3,152421,152421,152424,0,3,4
43471,6,1,152427,152427,152428,0,1,3
43472,6,2,152433,152433,152435,0,2,5
43473,1,3,152434,152435,152438,1,4,0
43474,4,2,152438,152438,152440,0,2,0
43475,3,2,152441,152441,152443,0,2,1
43476,5,1,152446,152446,152447,0,1,3
43477,6,3,152452,152452,152455,0,3,5
43478,6,2,152458,152458,152460,0,2,3
43479,2,3,152460,152460,152463,0,3,0
43480,2,2,152462,152463,152465,1,3,0
43481,2,3,152464,152465,152468,1,4,0
43482,5,2,152469,152469,152471,0,2,1
43483,4,2,152473,152473,152475,0,2,2
43484,4,1,152477,152477,152478,0,1,2
43485,4,2,152481,152481,152483,0,2,3
43486,3,2,152484,152484,152486,0,2,1
43487,1,2,152485,152486,152488,1,3,0
43488,6,3,152491,152491,152494,0,3,3
43489,3,1,152494,152494,152495,0,1,0
43490,4,3,152498,152498,152501,0,3,3
43491,1,3,152499,152501,152504,2,5,0
43492,3,1,152502,152504,152505,2,3,0
43493,2,3,152504,152505,152508,1,4,0
43494,3,3,152507,152508,152511,1,4,0
43495,1,2,152508,152511,152513,3,5,0
43496,3,2,152511,152513,152515,2,4,0
43497,1,2,152512,152515,152517,3,5,0
43498,5,2,152517,152517,152519,0,2,0
43499,6,3,152523,152523,152526,0,3,4
43500,2,1,152525,152526,152527,1,2,0
43501,6,1,152531,152531,152532,0,1,4
43502,6,1,152537,152537,152538,0,1,5
43503,2,2,152539,152539,152541,0,2,1
43504,6,3,152545,152545,152548,0,3,4
43505,3,1,152548,152548,152549,0,1,0
43506,2,1,152550,152550,152551,0,1,1
43507,4,3,152554,152554,152557,0,3,3
43508,5,2,152559,152559,152561,0,2,2
43509,1,3,152560,152561,152564,1,4,0
43510,2,3,152562,152564,152567,2,5,0
43511,5,3,152567,152567,152570,0,3,0
43512,1,3,152568,152570,152573,2,5,0
43513,5,1,152573,152573,152574,0,1,0
43514,5,1,152578,152578,152579,0,1,4
43515,4,3,152582,152582,152585,0,3,3
43516,3,1,152585,152585,152586,0,1,0
43517,1,2,152586,152586,152588,0,2,0
43518,3,3,152589,152589,152592,0,3,1
43519,3,3,152592,152592,152595,0,3,0
43520,6,2,152598,152598,152600,0,2,3
43521,2,2,152600,152600,152602,0,2,0
43522,3,2,152603,152603,152605,0,2,1
43523,2,2,152605,152605,152607,0,2,0
43524,5,1,152610,152610,152611,0,1,3
43525,2,1,152612,152612,152613,0,1,1
43526,1,1,152613,152613,152614,0,1,0
43527,2,2,152615,152615,152617,0,2,1
43528,2,3,152617,152617,152620,0,3,0
43529,1,2,152618,152620,152622,2,4,0
43530,3,1,152621,152622,152623,1,2,0
43531,4,2,152625,152625,152627,0,2,2
43532,3,3,152628,152628,152631,0,3,1
43533,4,1,152632,152632,152633,0,1,1
43534,6,1,152638,152638,152639,0,1,5
43535,6,1,152644,152644,152645,0,1,5
43536,5,1,152649,152649,152650,0,1,4
43537,5,2,152654,152654,152656,0,2,4
43538,6,2,152660,152660,152662,0,2,4
43539,6,1,152666,152666,152667,0,1,4
43540,3,1,152669,152669,152670,0,1,2
43541,6,2,152675,152675,152677,0,2,5
43542,1,2,152676,152677,152679,1,3,0
43543,6,2,152682,152682,152684,0,2,3
43544,1,2,152683,152684,152686,1,3,0
43545,3,3,152686,152686,152689,0,3,0
43546,1,2,152687,152689,152691,2,4,0
43547,1,2,152688,152691,152693,3,5,0
43548,5,3,152693,152693,152696,0,3,0
43549,3,2,152696,152696,152698,0,2,0
43550,5,1,152701,152701,152702,0,1,3
43551,2,1,152703,152703,152704,0,1,1
43552,2,3,152705,152705,152708,0,3,1
43553,4,3,152709,152709,152712,0,3,1
43554,1,3,152710,152712,152715,2,5,0
43555,1,3,152711,152715,152718,4,7,0
43556,6,1,152717,152718,152719,1,2,0
43557,3,3,152720,152720,152723,0,3,1
43558,6,1,152726,152726,152727,0,1,3
43559,3,3,152729,152729,152732,0,3,2
43560,2,1,152731,152732,152733,1,2,0
43561,1,2,152732,152733,152735,1,3,0
43562,1,2,152733,152735,152737,2,4,0
43563,4,3,152737,152737,152740,0,3,0
43564,6,3,152743,152743,152746,0,3,3
43565,2,1,152745,152746,152747,1,2,0
43566,6,1,152751,152751,152752,0,1,4
43567,6,1,152757,152757,152758,0,1,5
43568,4,1,152761,152761,152762,0,1,3
43569,6,1,152767,152767,152768,0,1,5
43570,6,3,152773,152773,152776,0,3,5
43571,4,2,152777,152777,152779,0,2,1
43572,3,2,152780,152780,152782,0,2,1
43573,4,1,152784,152784,152785,0,1,2
43574,6,2,152790,152790,152792,0,2,5
43575,5,3,152795,152795,152798,0,3,3
43576,5,2,152800,152800,152802,0,2,2
43577,3,2,152803,152803,152805,0,2,1
43578,5,3,152808,152808,152811,0,3,3
43579,1,3,152809,152811,152814,2,5,0
43580,4,3,152813,152814,152817,1,4,0
43581,3,3,152816,152817,152820,1,4,0
43582,6,3,152822,152822,152825,0,3,2
43583,2,2,152824,152825,152827,1,3,0
43584,2,2,152826,152827,152829,1,3,0
43585,5,2,152831,152831,152833,0,2,2
43586,3,2,152834,152834,152836,0,2,1
43587,1,3,152835,152836,152839,1,4,0
43588,4,1,152839,152839,152840,0,1,0
43589,1,2,152840,152840,152842,0,2,0
43590,5,3,152845,152845,152848,0,3,3
43591,1,3,152846,152848,152851,2,5,0
43592,3,2,152849,152851,152853,2,4,0
43593,2,2,152851,152853,152855,2,4,0
43594,2,3,152853,152855,152858,2,5,0
43595,3,1,152856,152858,152859,2,3,0
43596,6,1,152862,152862,152863,0,1,3
43597,6,1,152868,152868,152869,0,1,5
43598,4,1,152872,152872,152873,0,1,3
43599,6,2,152878,152878,152880,0,2,5
43600,1,1,152879,152880,152881,1,2,0
43601,4,1,152883,152883,152884,0,1,2
43602,4,1,152887,152887,152888,0,1,3
43603,1,1,152888,152888,152889,0,1,0
43604,3,3,152891,152891,152894,0,3,2
43605,6,3,152897,152897,152900,0,3,3
43606,2,3,152899,152900,152903,1,4,0
43607,1,2,152900,152903,152905,3,5,0
43608,4,3,152904,152905,152908,1,4,0
43609,5,1,152909,152909,152910,0,1,1
43610,3,1,152912,152912,152913,0,1,2
43611,1,3,152913,152913,152916,0,3,0
43612,1,3,152914,152916,152919,2,5,0
43613,3,1,152917,152919,152920,2,3,0
43614,1,1,152918,152920,152921,2,3,0
43615,3,2,152921,152921,152923,0,2,0
43616,6,1,152927,152927,152928,0,1,4
43617,3,1,152930,152930,152931,0,1,2
43618,1,3,152931,152931,152934,0,3,0
43619,4,3,152935,152935,152938,0,3,1
43620,3,1,152938,152938,152939,0,1,0
43621,4,2,152942,152942,152944,0,2,3
43622,5,2,152947,152947,152949,0,2,3
43623,2,3,152949,152949,152952,0,3,0
43624,4,1,152953,152953,152954,0,1,1
43625,6,1,152959,152959,152960,0,1,5
43626,5,2,152964,152964,152966,0,2,4
43627,1,3,152965,152966,152969,1,4,0
43628,2,3,152967,152969,152972,2,5,0
43629,6,2,152973,152973,152975,0,2,1
43630,3,2,152976,152976,152978,0,2,1
43631,3,3,152979,152979,152982,0,3,1
43632,2,1,152981,152982,152983,1,2,0
43633,6,2,152987,152987,152989,0,2,4
43634,5,1,152992,152992,152993,0,1,3
43635,3,2,152995,152995,152997,0,2,2
43636,3,3,152998,152998,153001,0,3,1
43637,2,3,153000,153001,153004,1,4,0
43638,6,3,153006,153006,153009,0,3,2
43639,6,1,153012,153012,153013,0,1,3
43640,6,3,153018,153018,153021,0,3,5
43641,2,1,153020,153021,153022,1,2,0
43642,3,2,153023,153023,153025,0,2,1
43643,4,2,153027,153027,153029,0,2,2
43644,6,2,153033,153033,153035,0,2,4
43645,3,1,153036,153036,153037,0,1,1
43646,6,3,153042,153042,153045,0,3,5
43647,1,2,153043,153045,153047,2,4,0
43648,3,3,153046,153047,153050,1,4,0
43649,6,1,153052,153052,153053,0,1,2
43650,3,3,153055,153055,153058,0,3,2
43651,6,3,153061,153061,153064,0,3,3
43652,5,3,153066,153066,153069,0,3,2
43653,5,3,153071,153071,153074,0,3,2
43654,5,2,153076,153076,153078,0,2,2
43655,4,3,153080,153080,153083,0,3,2
43656,3,2,153083,153083,153085,0,2,0
43657,6,3,153089,153089,153092,0,3,4
43658,1,3,153090,153092,153095,2,5,0
43659,1,3,153091,153095,153098,4,7,0
43660,1,1,153092,153098,153099,6,7,0
43661,3,2,153095,153099,153101,4,6,0
43662,6,1,153101,153101,153102,0,1,0
43663,1,3,153102,153102,153105,0,3,0
43664,2,3,153104,153105,153108,1,4,0
43665,6,2,153110,153110,153112,0,2,2
43666,4,2,153114,153114,153116,0,2,2
43667,6,1,153120,153120,153121,0,1,4
43668,1,3,153121,153121,153124,0,3,0
43669,6,2,153127,153127,153129,0,2,3
43670,6,3,153133,153133,153136,0,3,4
43671,2,2,153135,153136,153138,1,3,0
43672,2,1,153137,153138,153139,1,2,0
43673,5,3,153142,153142,153145,0,3,3
43674,1,1,153143,153145,153146,2,3,0
43675,1,3,153144,153146,153149,2,5,0
43676,4,1,153148,153149,153150,1,2,0
43677,4,2,153152,153152,153154,0,2,2
43678,2,2,153154,153154,153156,0,2,0
43679,2,2,153156,153156,153158,0,2,0
43680,2,2,153158,153158,153160,0,2,0
43681,2,3,153160,153160,153163,0,3,0
43682,5,3,153165,153165,153168,0,3,2
43683,6,2,153171,153171,153173,0,2,3
43684,1,1,153172,153173,153174,1,2,0
43685,6,1,153178,153178,153179,0,1,4
43686,4,2,153182,153182,153184,0,2,3
43687,1,3,153183,153184,153187,1,4,0
43688,3,2,153186,153187,153189,1,3,0
43689,1,3,153187,153189,153192,2,5,0
43690,2,1,153189,153192,153193,3,4,0
43691,6,3,153195,153195,153198,0,3,2
43692,2,2,153197,153198,153200,1,3,0
43693,3,1,153200,153200,153201,0,1,0
43694,1,1,153201,153201,153202,0,1,0
43695,5,2,153206,153206,153208,0,2,4
43696,2,2,153208,153208,153210,0,2,0
43697,4,2,153212,153212,153214,0,2,2
43698,4,3,153216,153216,153219,0,3,2
43699,6,3,153222,153222,153225,0,3,3
43700,2,2,153224,153225,153227,1,3,0
43701,1,1,153225,153227,153228,2,3,0
43702,1,1,153226,153228,153229,2,3,0
43703,2,3,153228,153229,153232,1,4,0
43704,6,2,153234,153234,153236,0,2,2
43705,5,2,153239,153239,153241,0,2,3
43706,4,2,153243,153243,153245,0,2,2
43707,1,3,153244,153245,153248,1,4,0
43708,6,3,153250,153250,153253,0,3,2
43709,2,3,153252,153253,153256,1,4,0
43710,1,2,153253,153256,153258,3,5,0
43711,4,1,153257,153258,153259,1,2,0
43712,3,3,153260,153260,153263,0,3,1
43713,5,1,153265,153265,153266,0,1,2
43714,5,1,153270,153270,153271,0,1,4
43715,3,3,153273,153273,153276,0,3,2
43716,4,1,153277,153277,153278,0,1,1
43717,6,1,153283,153283,153284,0,1,5
43718,4,2,153287,153287,153289,0,2,3
43719,6,2,153293,153293,153295,0,2,4
43720,4,2,153297,153297,153299,0,2,2
43721,6,3,153303,153303,153306,0,3,4
43722,6,3,153309,153309,153312,0,3,3
43723,1,2,153310,153312,153314,2,4,0
43724,6,3,153316,153316,153319,0,3,2
43725,4,2,153320,153320,153322,0,2,1
43726,6,2,153326,153326,153328,0,2,4
43727,1,2,153327,153328,153330,1,3,0
43728,2,3,153329,153330,153333,1,4,0
43729,4,1,153333,153333,153334,0,1,0
43730,4,3,153337,153337,153340,0,3,3
43731,1,1,153338,153340,153341,2,3,0
43732,1,3,153339,153341,153344,2,5,0
43733,3,1,153342,153344,153345,2,3,0
43734,4,1,153346,153346,153347,0,1,1
43735,2,3,153348,153348,153351,0,3,1
43736,4,1,153352,153352,153353,0,1,1
43737,4,2,153356,153356,153358,0,2,3
43738,4,2,153360,153360,153362,0,2,2
43739,6,3,153366,153366,153369,0,3,4
43740,4,3,153370,153370,153373,0,3,1
43741,5,2,153375,153375,153377,0,2,2
43742,1,3,153376,153377,153380,1,4,0
43743,4,2,153380,153380,153382,0,2,0
43744,1,3,153381,153382,153385,1,4,0
43745,1,3,153382,153385,153388,3,6,0
43746,1,2,153383,153388,153390,5,7,0
43747,5,1,153388,153390,153391,2,3,0
43748,5,3,153393,153393,153396,0,3,2
43749,1,3,153394,153396,153399,2,5,0
43750,2,1,153396,153399,153400,3,4,0
43751,3,2,153399,153400,153402,1,3,0
43752,1,2,153400,153402,153404,2,4,0
43753,2,2,153402,153404,153406,2,4,0
43754,3,1,153405,153406,153407,1,2,0
43755,2,2,153407,153407,153409,0,2,0
43756,1,1,153408,153409,153410,1,2,0
43757,5,2,153413,153413,153415,0,2,3
43758,1,2,153414,153415,153417,1,3,0
43759,6,1,153420,153420,153421,0,1,3
43760,6,1,153426,153426,153427,0,1,5
43761,4,2,153430,153430,153432,0,2,3
43762,6,1,153436,153436,153437,0,1,4
43763,3,1,153439,153439,153440,0,1,2
43764,5,1,153444,153444,153445,0,1,4
43765,5,3,153449,153449,153452,0,3,4
43766,4,1,153453,153453,153454,0,1,1
43767,3,2,153456,153456,153458,0,2,2
43768,1,1,153457,153458,153459,1,2,0
43769,4,2,153461,153461,153463,0,2,2
43770,6,3,153467,153467,153470,0,3,4
43771,5,2,153472,153472,153474,0,2,2
43772,1,3,153473,153474,153477,1,4,0
43773,1,3,153474,153477,153480,3,6,0
43774,3,1,153477,153480,153481,3,4,0
43775,4,3,153481,153481,153484,0,3,0
43776,4,3,153485,153485,153488,0,3,1
43777,1,3,153486,153488,153491,2,5,0
43778,3,2,153489,153491,153493,2,4,0
43779,5,3,153494,153494,153497,0,3,1
43780,3,2,153497,153497,153499,0,2,0
43781,2,2,153499,153499,153501,0,2,0
43782,6,2,153505,153505,153507,0,2,4
43783,2,2,153507,153507,153509,0,2,0
43784,2,1,153509,153509,153510,0,1,0
43785,5,3,153514,153514,153517,0,3,4
43786,5,3,153519,153519,153522,0,3,2
43787,1,3,153520,153522,153525,2,5,0
43788,2,1,153522,153525,153526,3,4,0
43789,4,3,153526,153526,153529,0,3,0
43790,5,2,153531,153531,153533,0,2,2
43791,4,2,153535,153535,153537,0,2,2
43792,3,2,153538,153538,153540,0,2,1
43793,1,3,153539,153540,153543,1,4,0
43794,6,2,153545,153545,153547,0,2,2
43795,4,2,153549,153549,153551,0,2,2
43796,2,1,153551,153551,153552,0,1,0
43797,6,2,153557,153557,153559,0,2,5
43798,2,1,153559,153559,153560,0,1,0
43799,2,3,153561,153561,153564,0,3,1
43800,2,1,153563,153564,153565,1,2,0
43801,2,2,153565,153565,153567,0,2,0
43802,4,1,153569,153569,153570,0,1,2
43803,5,1,153574,153574,153575,0,1,4
43804,5,2,153579,153579,153581,0,2,4
43805,1,3,153580,153581,153584,1,4,0
43806,5,1,153585,153585,153586,0,1,1
43807,1,3,153586,153586,153589,0,3,0
43808,1,2,153587,153589,153591,2,4,0
43809,6,1,153593,153593,153594,0,1,2
43810,5,2,153598,153598,153600,0,2,4
43811,2,2,153600,153600,153602,0,2,0
43812,5,3,153605,153605,153608,0,3,3
43813,4,2,153609,153609,153611,0,2,1
43814,1,2,153610,153611,153613,1,3,0
43815,1,2,153611,153613,153615,2,4,0
43816,6,2,153617,153617,153619,0,2,2
43817,3,1,153620,153620,153621,0,1,1
43818,5,3,153625,153625,153628,0,3,4
43819,5,2,153630,153630,153632,0,2,2
43820,5,2,153635,153635,153637,0,2,3
43821,5,1,153640,153640,153641,0,1,3
43822,3,1,153643,153643,153644,0,1,2
43823,3,1,153646,153646,153647,0,1,2
43824,3,3,153649,153649,153652,0,3,2
43825,2,1,153651,153652,153653,1,2,0
43826,4,3,153655,153655,153658,0,3,2
43827,4,2,153659,153659,153661,0,2,1
43828,5,1,153664,153664,153665,0,1,3
43829,3,3,153667,153667,153670,0,3,2
43830,5,3,153672,153672,153675,0,3,2
43831,3,1,153675,153675,153676,0,1,0
43832,3,1,153678,153678,153679,0,1,2
43833,6,1,153684,153684,153685,0,1,5
43834,2,2,153686,153686,153688,0,2,1
43835,5,2,153691,153691,153693,0,2,3
43836,4,2,153695,153695,153697,0,2,2
43837,3,1,153698,153698,153699,0,1,1
43838,4,2,153702,153702,153704,0,2,3
43839,2,1,153704,153704,153705,0,1,0
43840,3,2,153707,153707,153709,0,2,2
43841,4,2,153711,153711,153713,0,2,2
43842,2,3,153713,153713,153716,0,3,0
43843,4,1,153717,153717,153718,0,1,1
43844,5,3,153722,153722,153725,0,3,4
43845,6,3,153728,153728,153731,0,3,3
43846,4,3,153732,153732,153735,0,3,1
43847,1,1,153733,153735,153736,2,3,0
43848,4,1,153737,153737,153738,0,1,1
43849,6,1,153743,153743,153744,0,1,5
43850,4,2,153747,153747,153749,0,2,3
43851,4,3,153751,153751,153754,0,3,2
43852,2,2,153753,153754,153756,1,3,0
43853,2,3,153755,153756,153759,1,4,0
43854,4,1,153759,153759,153760,0,1,0
43855,5,2,153764,153764,153766,0,2,4
43856,4,2,153768,153768,153770,0,2,2
43857,5,2,153773,153773,153775,0,2,3
43858,3,3,153776,153776,153779,0,3,1
43859,5,2,153781,153781,153783,0,2,2
43860,3,1,153784,153784,153785,0,1,1
43861,6,1,153790,153790,153791,0,1,5
43862,5,2,153795,153795,153797,0,2,4
43863,5,1,153800,153800,153801,0,1,3
43864,3,3,153803,153803,153806,0,3,2
43865,1,1,153804,153806,153807,2,3,0
43866,4,2,153808,153808,153810,0,2,1
43867,2,2,153810,153810,153812,0,2,0
43868,3,3,153813,153813,153816,0,3,1
43869,6,1,153819,153819,153820,0,1,3
43870,2,3,153821,153821,153824,0,3,1
43871,6,3,153827,153827,153830,0,3,3
43872,3,1,153830,153830,153831,0,1,0
43873,6,1,153836,153836,153837,0,1,5
43874,4,2,153840,153840,153842,0,2,3
43875,1,3,153841,153842,153845,1,4,0
43876,4,3,153845,153845,153848,0,3,0
43877,4,1,153849,153849,153850,0,1,1
43878,6,1,153855,153855,153856,0,1,5
43879,2,2,153857,153857,153859,0,2,1
43880,2,3,153859,153859,153862,0,3,0
43881,4,3,153863,153863,153866,0,3,1
43882,2,3,153865,153866,153869,1,4,0
43883,2,2,153867,153869,153871,2,4,0
43884,3,3,153870,153871,153874,1,4,0
43885,6,2,153876,153876,153878,0,2,2
43886,1,1,153877,153878,153879,1,2,0
43887,2,2,153879,153879,153881,0,2,0
43888,3,1,153882,153882,153883,0,1,1
43889,6,3,153888,153888,153891,0,3,5
43890,5,2,153893,153893,153895,0,2,2
43891,3,3,153896,153896,153899,0,3,1
43892,5,3,153901,153901,153904,0,3,2
43893,6,3,153907,153907,153910,0,3,3
43894,5,1,153912,153912,153913,0,1,2
43895,6,3,153918,153918,153921,0,3,5
43896,5,1,153923,153923,153924,0,1,2
43897,2,3,153925,153925,153928,0,3,1
43898,6,2,153931,153931,153933,0,2,3
43899,4,1,153935,153935,153936,0,1,2
43900,4,2,153939,153939,153941,0,2,3
43901,2,3,153941,153941,153944,0,3,0
43902,2,3,153943,153944,153947,1,4,0
43903,3,1,153946,153947,153948,1,2,0
43904,4,2,153950,153950,153952,0,2,2
43905,1,1,153951,153952,153953,1,2,0
43906,2,3,153953,153953,153956,0,3,0
43907,5,1,153958,153958,153959,0,1,2
43908,3,1,153961,153961,153962,0,1,2
43909,5,2,153966,153966,153968,0,2,4
43910,1,3,153967,153968,153971,1,4,0
43911,2,3,153969,153971,153974,2,5,0
43912,3,2,153972,153974,153976,2,4,0
43913,1,1,153973,153976,153977,3,4,0
43914,2,2,153975,153977,153979,2,4,0
43915,3,1,153978,153979,153980,1,2,0
43916,6,1,153984,153984,153985,0,1,4
43917,3,2,153987,153987,153989,0,2,2
43918,6,1,153993,153993,153994,0,1,4
43919,4,3,153997,153997,154000,0,3,3
43920,3,3,154000,154000,154003,0,3,0
43921,5,2,154005,154005,154007,0,2,2
43922,2,2,154007,154007,154009,0,2,0
43923,3,2,154010,154010,154012,0,2,1
43924,3,3,154013,154013,154016,0,3,1
43925,1,3,154014,154016,154019,2,5,0
43926,2,1,154016,154019,154020,3,4,0
43927,4,2,154020,154020,154022,0,2,0
43928,2,1,154022,154022,154023,0,1,0
43929,6,1,154028,154028,154029,0,1,5
43930,1,1,154029,154029,154030,0,1,0
43931,2,1,154031,154031,154032,0,1,1
43932,2,3,154033,154033,154036,0,3,1
43933,2,2,154035,154036,154038,1,3,0
43934,6,2,154041,154041,154043,0,2,3
43935,3,2,154044,154044,154046,0,2,1
43936,1,1,154045,154046,154047,1,2,0
43937,3,2,154048,154048,154050,0,2,1
43938,6,3,154054,154054,154057,0,3,4
43939,1,3,154055,154057,154060,2,5,0
43940,6,3,154061,154061,154064,0,3,1
43941,6,3,154067,154067,154070,0,3,3
43942,1,3,154068,154070,154073,2,5,0
43943,4,2,154072,154073,154075,1,3,0
43944,4,3,154076,154076,154079,0,3,1
43945,3,1,154079,154079,154080,0,1,0
43946,1,3,154080,154080,154083,0,3,0
43947,3,3,154083,154083,154086,0,3,0
43948,3,1,154086,154086,154087,0,1,0
43949,6,3,154092,154092,154095,0,3,5
43950,4,2,154096,154096,154098,0,2,1
43951,1,3,154097,154098,154101,1,4,0
43952,6,3,154103,154103,154106,0,3,2
43953,5,2,154108,154108,154110,0,2,2
43954,4,3,154112,154112,154115,0,3,2
43955,6,3,154118,154118,154121,0,3,3
43956,4,3,154122,154122,154125,0,3,1
43957,6,1,154128,154128,154129,0,1,3
43958,3,1,154131,154131,154132,0,1,2
43959,2,3,154133,154133,154136,0,3,1
43960,3,1,154136,154136,154137,0,1,0
43961,3,3,154139,154139,154142,0,3,2
43962,3,2,154142,154142,154144,0,2,0
43963,6,1,154148,154148,154149,0,1,4
43964,2,1,154150,154150,154151,0,1,1
43965,3,1,154153,154153,154154,0,1,2
43966,1,2,154154,154154,154156,0,2,0
43967,5,1,154159,154159,154160,0,1,3
43968,5,3,154164,154164,154167,0,3,4
43969,4,1,154168,154168,154169,0,1,1
43970,4,2,154172,154172,154174,0,2,3
43971,2,3,154174,154174,154177,0,3,0
43972,1,2,154175,154177,154179,2,4,0
43973,5,3,154180,154180,154183,0,3,1
43974,1,2,154181,154183,154185,2,4,0
43975,5,1,154186,154186,154187,0,1,1
43976,4,1,154190,154190,154191,0,1,3
43977,4,1,154194,154194,154195,0,1,3
43978,4,3,154198,154198,154201,0,3,3
43979,4,3,154202,154202,154205,0,3,1
43980,6,1,154208,154208,154209,0,1,3
43981,4,1,154212,154212,154213,0,1,3
43982,4,2,154216,154216,154218,0,2,3
43983,1,2,154217,154218,154220,1,3,0
43984,6,2,154223,154223,154225,0,2,3
43985,3,2,154226,154226,154228,0,2,1
43986,1,1,154227,154228,154229,1,2,0
43987,1,2,154228,154229,154231,1,3,0
43988,5,1,154233,154233,154234,0,1,2
43989,4,1,154237,154237,154238,0,1,3
43990,1,1,154238,154238,154239,0,1,0
43991,2,1,154240,154240,154241,0,1,1
43992,2,2,154242,154242,154244,0,2,1
43993,3,2,154245,154245,154247,0,2,1
43994,5,2,154250,154250,154252,0,2,3
43995,5,1,154255,154255,154256,0,1,3
43996,4,2,154259,154259,154261,0,2,3
43997,5,1,154264,154264,154265,0,1,3
43998,3,2,154267,154267,154269,0,2,2
43999,2,2,154269,154269,154271,0,2,0
44000,3,2,154272,154272,154274,0,2,1
44001,2,3,154274,154274,154277,0,3,0
44002,2,2,154276,154277,154279,1,3,0
44003,4,3,154280,154280,154283,0,3,1
44004,5,1,154285,154285,154286,0,1,2
44005,1,2,154286,154286,154288,0,2,0
44006,2,3,154288,154288,154291,0,3,0
44007,5,2,154293,154293,154295,0,2,2
44008,1,1,154294,154295,154296,1,2,0
44009,4,3,154298,154298,154301,0,3,2
44010,4,3,154302,154302,154305,0,3,1
44011,3,3,154305,154305,154308,0,3,0
44012,2,3,154307,154308,154311,1,4,0
44013,5,1,154312,154312,154313,0,1,1
44014,4,1,154316,154316,154317,0,1,3
44015,2,3,154318,154318,154321,0,3,1
44016,4,1,154322,154322,154323,0,1,1
44017,5,1,154327,154327,154328,0,1,4
44018,1,3,154328,154328,154331,0,3,0
44019,6,1,154334,154334,154335,0,1,3
44020,1,3,154335,154335,154338,0,3,0
44021,4,2,154339,154339,154341,0,2,1
44022,2,1,154341,154341,154342,0,1,0
44023,5,3,154346,154346,154349,0,3,4
44024,1,1,154347,154349,154350,2,3,0
44025,5,3,154352,154352,154355,0,3,2
44026,2,3,154354,154355,154358,1,4,0
44027,1,2,154355,154358,154360,3,5,0
44028,3,1,154358,154360,154361,2,3,0
44029,1,2,154359,154361,154363,2,4,0
44030,2,1,154361,154363,154364,2,3,0
44031,2,3,154363,154364,154367,1,4,0
44032,1,2,154364,154367,154369,3,5,0
44033,4,3,154368,154369,154372,1,4,0
44034,1,1,154369,154372,154373,3,4,0
44035,6,1,154375,154375,154376,0,1,2
44036,4,3,154379,154379,154382,0,3,3
44037,6,1,154385,154385,154386,0,1,3
44038,6,1,154391,154391,154392,0,1,5
44039,6,3,154397,154397,154400,0,3,5
44040,3,1,154400,154400,154401,0,1,0
44041,6,1,154406,154406,154407,0,1,5
44042,5,3,154411,154411,154414,0,3,4
44043,6,2,154417,154417,154419,0,2,3
44044,5,1,154422,154422,154423,0,1,3
44045,2,1,154424,154424,154425,0,1,1
44046,5,3,154429,154429,154432,0,3,4
44047,1,3,154430,154432,154435,2,5,0
44048,4,3,154434,154435,154438,1,4,0
44049,3,3,154437,154438,154441,1,4,0
44050,3,2,154440,154441,154443,1,3,0
44051,2,2,154442,154443,154445,1,3,0
44052,2,1,154444,154445,154446,1,2,0
44053,3,3,154447,154447,154450,0,3,1
44054,4,3,154451,154451,154454,0,3,1
44055,4,2,154455,154455,154457,0,2,1
44056,5,3,154460,154460,154463,0,3,3
44057,1,2,154461,154463,154465,2,4,0
44058,3,3,154464,154465,154468,1,4,0
44059,5,3,154469,154469,154472,0,3,1
44060,5,1,154474,154474,154475,0,1,2
44061,1,3,154475,154475,154478,0,3,0
44062,1,3,154476,154478,154481,2,5,0
44063,5,1,154481,154481,154482,0,1,0
44064,4,3,154485,154485,154488,0,3,3
44065,2,2,154487,154488,154490,1,3,0
44066,1,3,154488,154490,154493,2,5,0
44067,4,1,154492,154493,154494,1,2,0
44068,4,1,154496,154496,154497,0,1,2
44069,1,3,154497,154497,154500,0,3,0
44070,5,2,154502,154502,154504,0,2,2
44071,4,3,154506,154506,154509,0,3,2
44072,4,3,154510,154510,154513,0,3,1
44073,6,3,154516,154516,154519,0,3,3
44074,3,1,154519,154519,154520,0,1,0
44075,3,2,154522,154522,154524,0,2,2
44076,1,2,154523,154524,154526,1,3,0
44077,2,2,154525,154526,154528,1,3,0
44078,2,1,154527,154528,154529,1,2,0
44079,6,1,154533,154533,154534,0,1,4
44080,2,1,154535,154535,154536,0,1,1
44081,1,3,154536,154536,154539,0,3,0
44082,1,3,154537,154539,154542,2,5,0
44083,5,3,154542,154542,154545,0,3,0
44084,1,2,154543,154545,154547,2,4,0
44085,6,2,154549,154549,154551,0,2,2
44086,5,2,154554,154554,154556,0,2,3
44087,5,3,154559,154559,154562,0,3,3
44088,2,2,154561,154562,154564,1,3,0
44089,3,3,154564,154564,154567,0,3,0
44090,5,1,154569,154569,154570,0,1,2
44091,2,3,154571,154571,154574,0,3,1
44092,5,1,154576,154576,154577,0,1,2
44093,2,2,154578,154578,154580,0,2,1
44094,3,3,154581,154581,154584,0,3,1
44095,5,3,154586,154586,154589,0,3,2
44096,2,3,154588,154589,154592,1,4,0
44097,5,3,154593,154593,154596,0,3,1
44098,1,1,154594,154596,154597,2,3,0
44099,1,3,154595,154597,154600,2,5,0
44100,1,2,154596,154600,154602,4,6,0
44101,5,1,154601,154602,154603,1,2,0
44102,2,3,154603,154603,154606,0,3,0
44103,3,3,154606,154606,154609,0,3,0
44104,5,1,154611,154611,154612,0,1,2
44105,6,2,154617,154617,154619,0,2,5
44106,4,3,154621,154621,154624,0,3,2
44107,1,3,154622,154624,154627,2,5,0
44108,4,1,154626,154627,154628,1,2,0
44109,3,1,154629,154629,154630,0,1,1
44110,6,2,154635,154635,154637,0,2,5
44111,3,2,154638,154638,154640,0,2,1
44112,2,3,154640,154640,154643,0,3,0
44113,3,2,154643,154643,154645,0,2,0
44114,5,2,154648,154648,154650,0,2,3
44115,4,1,154652,154652,154653,0,1,2
44116,6,1,154658,154658,154659,0,1,5
44117,6,2,154664,154664,154666,0,2,5
44118,2,2,154666,154666,154668,0,2,0
44119,2,2,154668,154668,154670,0,2,0
44120,5,2,154673,154673,154675,0,2,3
44121,2,1,154675,154675,154676,0,1,0
44122,1,1,154676,154676,154677,0,1,0
44123,4,2,154680,154680,154682,0,2,3
44124,5,1,154685,154685,154686,0,1,3
44125,2,3,154687,154687,154690,0,3,1
44126,4,1,154691,154691,154692,0,1,1
44127,6,1,154697,154697,154698,0,1,5
44128,6,1,154703,154703,154704,0,1,5
44129,2,1,154705,154705,154706,0,1,1
44130,2,2,154707,154707,154709,0,2,1
44131,1,1,154708,154709,154710,1,2,0
44132,2,1,154710,154710,154711,0,1,0
44133,4,2,154714,154714,154716,0,2,3
44134,1,3,154715,154716,154719,1,4,0
44135,2,2,154717,154719,154721,2,4,0
44136,1,2,154718,154721,154723,3,5,0
44137,1,2,154719,154723,154725,4,6,0
44138,1,1,154720,154725,154726,5,6,0
44139,5,2,154725,154726,154728,1,3,0
44140,4,3,154729,154729,154732,0,3,1
44141,4,1,154733,154733,154734,0,1,1
44142,2,3,154735,154735,154738,0,3,1
44143,1,3,154736,154738,154741,2,5,0
44144,4,3,154740,154741,154744,1,4,0
44145,5,3,154745,154745,154748,0,3,1
44146,4,3,154749,154749,154752,0,3,1
44147,2,2,154751,154752,154754,1,3,0
44148,1,3,154752,154754,154757,2,5,0
44149,6,2,154758,154758,154760,0,2,1
44150,5,1,154763,154763,154764,0,1,3
44151,4,2,154767,154767,154769,0,2,3
44152,4,3,154771,154771,154774,0,3,2
44153,3,1,154774,154774,154775,0,1,0
44154,1,3,154775,154775,154778,0,3,0
44155,1,2,154776,154778,154780,2,4,0
44156,4,3,154780,154780,154783,0,3,0
44157,2,2,154782,154783,154785,1,3,0
44158,5,3,154787,154787,154790,0,3,2
44159,3,3,154790,154790,154793,0,3,0
44160,5,3,154795,154795,154798,0,3,2
44161,2,1,154797,154798,154799,1,2,0
44162,6,2,154803,154803,154805,0,2,4
44163,5,2,154808,154808,154810,0,2,3
44164,2,1,154810,154810,154811,0,1,0
44165,2,1,154812,154812,154813,0,1,1
44166,6,3,154818,154818,154821,0,3,5
44167,6,1,154824,154824,154825,0,1,3
44168,3,3,154827,154827,154830,0,3,2
44169,3,1,154830,154830,154831,0,1,0
44170,6,3,154836,154836,154839,0,3,5
44171,3,1,154839,154839,154840,0,1,0
44172,6,1,154845,154845,154846,0,1,5
44173,6,3,154851,154851,154854,0,3,5
44174,5,1,154856,154856,154857,0,1,2
44175,5,2,154861,154861,154863,0,2,4
44176,6,3,154867,154867,154870,0,3,4
44177,3,3,154870,154870,154873,0,3,0
44178,1,1,154871,154873,154874,2,3,0
44179,6,2,154877,154877,154879,0,2,3
44180,6,3,154883,154883,154886,0,3,4
44181,1,2,154884,154886,154888,2,4,0
44182,1,2,154885,154888,154890,3,5,0
44183,6,3,154891,154891,154894,0,3,1
44184,3,1,154894,154894,154895,0,1,0
44185,4,1,154898,154898,154899,0,1,3
44186,3,3,154901,154901,154904,0,3,2
44187,1,3,154902,154904,154907,2,5,0
44188,6,1,154908,154908,154909,0,1,1
44189,1,2,154909,154909,154911,0,2,0
44190,6,3,154915,154915,154918,0,3,4
44191,1,1,154916,154918,154919,2,3,0
44192,5,1,154921,154921,154922,0,1,2
44193,4,2,154925,154925,154927,0,2,3
44194,1,1,154926,154927,154928,1,2,0
44195,3,1,154929,154929,154930,0,1,1
44196,4,3,154933,154933,154936,0,3,3
44197,6,3,154939,154939,154942,0,3,3
44198,6,3,154945,154945,154948,0,3,3
44199,1,3,154946,154948,154951,2,5,0
44200,3,2,154949,154951,154953,2,4,0
44201,2,2,154951,154953,154955,2,4,0
44202,4,1,154955,154955,154956,0,1,0
44203,2,2,154957,154957,154959,0,2,1
44204,1,2,154958,154959,154961,1,3,0
44205,5,1,154963,154963,154964,0,1,2
44206,2,1,154965,154965,154966,0,1,1
44207,3,3,154968,154968,154971,0,3,2
44208,6,2,154974,154974,154976,0,2,3
44209,5,3,154979,154979,154982,0,3,3
44210,4,2,154983,154983,154985,0,2,1
44211,3,1,154986,154986,154987,0,1,1
44212,2,3,154988,154988,154991,0,3,1
44213,2,2,154990,154991,154993,1,3,0
44214,4,1,154994,154994,154995,0,1,1
44215,4,3,154998,154998,155001,0,3,3
44216,1,3,154999,155001,155004,2,5,0
44217,1,2,155000,155004,155006,4,6,0
44218,1,1,155001,155006,155007,5,6,0
44219,4,2,155005,155007,155009,2,4,0
44220,1,3,155006,155009,155012,3,6,0
44221,6,1,155012,155012,155013,0,1,0
44222,6,1,155018,155018,155019,0,1,5
44223,5,2,155023,155023,155025,0,2,4
44224,5,3,155028,155028,155031,0,3,3
44225,5,1,155033,155033,155034,0,1,2
44226,4,1,155037,155037,155038,0,1,3
44227,1,3,155038,155038,155041,0,3,0
44228,4,2,155042,155042,155044,0,2,1
44229,3,1,155045,155045,155046,0,1,1
44230,4,1,155049,155049,155050,0,1,3
44231,2,1,155051,155051,155052,0,1,1
44232,4,1,155055,155055,155056,0,1,3
44233,1,1,155056,155056,155057,0,1,0
44234,6,1,155062,155062,155063,0,1,5
44235,6,1,155068,155068,155069,0,1,5
44236,2,1,155070,155070,155071,0,1,1
44237,3,3,155073,155073,155076,0,3,2
44238,4,2,155077,155077,155079,0,2,1
44239,4,3,155081,155081,155084,0,3,2
44240,5,3,155086,155086,155089,0,3,2
44241,6,2,155092,155092,155094,0,2,3
44242,5,1,155097,155097,155098,0,1,3
44243,5,1,155102,155102,155103,0,1,4
44244,3,2,155105,155105,155107,0,2,2
44245,3,1,155108,155108,155109,0,1,1
44246,4,2,155112,155112,155114,0,2,3
44247,5,2,155117,155117,155119,0,2,3
44248,5,2,155122,155122,155124,0,2,3
44249,6,3,155128,155128,155131,0,3,4
44250,3,1,155131,155131,155132,0,1,0
44251,3,3,155134,155134,155137,0,3,2
44252,1,2,155135,155137,155139,2,4,0
44253,3,1,155138,155139,155140,1,2,0
44254,4,3,155142,155142,155145,0,3,2
44255,2,3,155144,155145,155148,1,4,0
44256,3,3,155147,155148,155151,1,4,0
44257,3,1,155150,155151,155152,1,2,0
44258,6,1,155156,155156,155157,0,1,4
44259,5,3,155161,155161,155164,0,3,4
44260,3,1,155164,155164,155165,0,1,0
44261,1,3,155165,155165,155168,0,3,0
44262,2,2,155167,155168,155170,1,3,0
44263,4,1,155171,155171,155172,0,1,1
44264,6,3,155177,155177,155180,0,3,5
44265,2,3,155179,155180,155183,1,4,0
44266,2,3,155181,155183,155186,2,5,0
44267,6,1,155187,155187,155188,0,1,1
44268,1,1,155188,155188,155189,0,1,0
44269,1,3,155189,155189,155192,0,3,0
44270,5,3,155194,155194,155197,0,3,2
44271,3,3,155197,155197,155200,0,3,0
44272,4,3,155201,155201,155204,0,3,1
44273,3,3,155204,155204,155207,0,3,0
44274,4,1,155208,155208,155209,0,1,1
44275,6,1,155214,155214,155215,0,1,5
44276,4,2,155218,155218,155220,0,2,3
44277,5,3,155223,155223,155226,0,3,3
44278,3,1,155226,155226,155227,0,1,0
44279,2,1,155228,155228,155229,0,1,1
44280,2,2,155230,155230,155232,0,2,1
44281,4,1,155234,155234,155235,0,1,2
44282,1,2,155235,155235,155237,0,2,0
44283,5,2,155240,155240,155242,0,2,3
44284,1,1,155241,155242,155243,1,2,0
44285,2,3,155243,155243,155246,0,3,0
44286,4,2,155247,155247,155249,0,2,1
44287,2,3,155249,155249,155252,0,3,0
44288,4,3,155253,155253,155256,0,3,1
44289,5,2,155258,155258,155260,0,2,2
44290,1,3,155259,155260,155263,1,4,0
44291,2,2,155261,155263,155265,2,4,0
44292,4,3,155265,155265,155268,0,3,0
44293,5,1,155270,155270,155271,0,1,2
44294,6,3,155276,155276,155279,0,3,5
44295,3,3,155279,155279,155282,0,3,0
44296,3,2,155282,155282,155284,0,2,0
44297,2,2,155284,155284,155286,0,2,0
44298,1,3,155285,155286,155289,1,4,0
44299,4,3,155289,155289,155292,0,3,0
44300,5,3,155294,155294,155297,0,3,2
44301,4,3,155298,155298,155301,0,3,1
44302,5,2,155303,155303,155305,0,2,2
44303,2,3,155305,155305,155308,0,3,0
44304,3,3,155308,155308,155311,0,3,0
44305,1,2,155309,155311,155313,2,4,0
44306,4,1,155313,155313,155314,0,1,0
44307,5,2,155318,155318,155320,0,2,4
44308,6,2,155324,155324,155326,0,2,4
44309,1,3,155325,155326,155329,1,4,0
44310,4,2,155329,155329,155331,0,2,0
44311,6,2,155335,155335,155337,0,2,4
44312,5,3,155340,155340,155343,0,3,3
44313,6,1,155346,155346,155347,0,1,3
44314,3,1,155349,155349,155350,0,1,2
44315,6,3,155355,155355,155358,0,3,5
44316,5,3,155360,155360,155363,0,3,2
44317,1,1,155361,155363,155364,2,3,0
44318,2,3,155363,155364,155367,1,4,0
44319,2,1,155365,155367,155368,2,3,0
44320,5,1,155370,155370,155371,0,1,2
44321,3,1,155373,155373,155374,0,1,2
44322,1,1,155374,155374,155375,0,1,0
44323,1,1,155375,155375,155376,0,1,0
44324,2,3,155377,155377,155380,0,3,1
44325,2,3,155379,155380,155383,1,4,0
44326,3,1,155382,155383,155384,1,2,0
44327,6,1,155388,155388,155389,0,1,4
44328,4,3,155392,155392,155395,0,3,3
44329,3,3,155395,155395,155398,0,3,0
44330,4,1,155399,155399,155400,0,1,1
44331,2,3,155401,155401,155404,0,3,1
44332,4,3,155405,155405,155408,0,3,1
44333,5,3,155410,155410,155413,0,3,2
44334,2,2,155412,155413,155415,1,3,0
44335,2,1,155414,155415,155416,1,2,0
44336,1,2,155415,155416,155418,1,3,0
44337,4,3,155419,155419,155422,0,3,1
44338,5,1,155424,155424,155425,0,1,2
44339,6,2,155430,155430,155432,0,2,5
44340,4,2,155434,155434,155436,0,2,2
44341,1,2,155435,155436,155438,1,3,0
44342,1,3,155436,155438,155441,2,5,0
44343,4,3,155440,155441,155444,1,4,0
44344,1,1,155441,155444,155445,3,4,0
44345,3,3,155444,155445,155448,1,4,0
44346,1,2,155445,155448,155450,3,5,0
44347,4,2,155449,155450,155452,1,3,0
44348,1,2,155450,155452,155454,2,4,0
44349,1,2,155451,155454,155456,3,5,0
44350,1,1,155452,155456,155457,4,5,0
44351,5,3,155457,155457,155460,0,3,0
44352,5,3,155462,155462,155465,0,3,2
44353,6,2,155468,155468,155470,0,2,3
44354,5,3,155473,155473,155476,0,3,3
44355,1,1,155474,155476,155477,2,3,0
44356,3,3,155477,155477,155480,0,3,0
44357,1,1,155478,155480,155481,2,3,0
44358,3,1,155481,155481,155482,0,1,0
44359,6,2,155487,155487,155489,0,2,5
44360,5,3,155492,155492,155495,0,3,3
44361,1,3,155493,155495,155498,2,5,0
44362,5,2,155498,155498,155500,0,2,0
44363,1,1,155499,155500,155501,1,2,0
44364,2,1,155501,155501,155502,0,1,0
44365,5,1,155506,155506,155507,0,1,4
44366,6,2,155512,155512,155514,0,2,5
44367,3,2,155515,155515,155517,0,2,1
44368,3,3,155518,155518,155521,0,3,1
44369,3,1,155521,155521,155522,0,1,0
44370,6,3,155527,155527,155530,0,3,5
44371,1,2,155528,155530,155532,2,4,0
44372,1,3,155529,155532,155535,3,6,0
44373,5,3,155534,155535,155538,1,4,0
44374,2,2,155536,155538,155540,2,4,0
44375,4,3,155540,155540,155543,0,3,0
44376,2,1,155542,155543,155544,1,2,0
44377,6,2,155548,155548,155550,0,2,4
44378,2,2,155550,155550,155552,0,2,0
44379,3,3,155553,155553,155556,0,3,1
44380,1,1,155554,155556,155557,2,3,0
44381,4,3,155558,155558,155561,0,3,1
44382,2,2,155560,155561,155563,1,3,0
44383,3,1,155563,155563,155564,0,1,0
44384,2,1,155565,155565,155566,0,1,1
44385,1,3,155566,155566,155569,0,3,0
44386,4,3,155570,155570,155573,0,3,1
44387,4,3,155574,155574,155577,0,3,1
44388,6,2,155580,155580,155582,0,2,3
44389,3,3,155583,155583,155586,0,3,1
44390,3,2,155586,155586,155588,0,2,0
44391,6,1,155592,155592,155593,0,1,4
44392,1,1,155593,155593,155594,0,1,0
44393,2,1,155595,155595,155596,0,1,1
44394,5,1,155600,155600,155601,0,1,4
44395,2,1,155602,155602,155603,0,1,1
44396,3,3,155605,155605,155608,0,3,2
44397,1,3,155606,155608,155611,2,5,0
44398,1,1,155607,155611,155612,4,5,0
44399,6,3,155613,155613,155616,0,3,1
44400,4,2,155617,155617,155619,0,2,1
44401,2,1,155619,155619,155620,0,1,0
44402,2,2,155621,155621,155623,0,2,1
44403,1,1,155622,155623,155624,1,2,0
44404,3,3,155625,155625,155628,0,3,1
44405,6,3,155631,155631,155634,0,3,3
44406,4,1,155635,155635,155636,0,1,1
44407,4,3,155639,155639,155642,0,3,3
44408,2,1,155641,155642,155643,1,2,0
44409,3,3,155644,155644,155647,0,3,1
44410,1,1,155645,155647,155648,2,3,0
44411,1,1,155646,155648,155649,2,3,0
44412,2,1,155648,155649,155650,1,2,0
44413,6,3,155654,155654,155657,0,3,4
44414,1,3,155655,155657,155660,2,5,0
44415,4,3,155659,155660,155663,1,4,0
44416,1,1,155660,155663,155664,3,4,0
44417,5,3,155665,155665,155668,0,3,1
44418,4,1,155669,155669,155670,0,1,1
44419,4,2,155673,155673,155675,0,2,3
44420,1,1,155674,155675,155676,1,2,0
44421,3,1,155677,155677,155678,0,1,1
44422,4,3,155681,155681,155684,0,3,3
44423,5,3,155686,155686,155689,0,3,2
44424,4,3,155690,155690,155693,0,3,1
44425,6,2,155696,155696,155698,0,2,3
44426,4,1,155700,155700,155701,0,1,2
44427,4,2,155704,155704,155706,0,2,3
44428,6,1,155710,155710,155711,0,1,4
44429,6,1,155716,155716,155717,0,1,5
44430,5,3,155721,155721,155724,0,3,4
44431,3,3,155724,155724,155727,0,3,0
44432,5,1,155729,155729,155730,0,1,2
44433,1,2,155730,155730,155732,0,2,0
44434,1,2,155731,155732,155734,1,3,0
44435,5,3,155736,155736,155739,0,3,2
44436,5,2,155741,155741,155743,0,2,2
44437,6,1,155747,155747,155748,0,1,4
44438,2,2,155749,155749,155751,0,2,1
44439,5,3,155754,155754,155757,0,3,3
44440,2,1,155756,155757,155758,1,2,0
44441,3,3,155759,155759,155762,0,3,1
44442,1,3,155760,155762,155765,2,5,0
44443,4,1,155764,155765,155766,1,2,0
44444,4,2,155768,155768,155770,0,2,2
44445,5,1,155773,155773,155774,0,1,3
44446,4,2,155777,155777,155779,0,2,3
44447,2,2,155779,155779,155781,0,2,0
44448,3,3,155782,155782,155785,0,3,1
44449,4,3,155786,155786,155789,0,3,1
44450,4,1,155790,155790,155791,0,1,1
44451,1,2,155791,155791,155793,0,2,0
44452,6,2,155797,155797,155799,0,2,4
44453,1,3,155798,155799,155802,1,4,0
44454,6,1,155804,155804,155805,0,1,2
44455,3,1,155807,155807,155808,0,1,2
44456,5,2,155812,155812,155814,0,2,4
44457,3,3,155815,155815,155818,0,3,1
44458,6,3,155821,155821,155824,0,3,3
44459,5,2,155826,155826,155828,0,2,2
44460,4,3,155830,155830,155833,0,3,2
44461,5,3,155835,155835,155838,0,3,2
44462,5,1,155840,155840,155841,0,1,2
44463,5,1,155845,155845,155846,0,1,4
44464,3,1,155848,155848,155849,0,1,2
44465,2,2,155850,155850,155852,0,2,1
44466,6,1,155856,155856,155857,0,1,4
44467,2,1,155858,155858,155859,0,1,1
44468,6,1,155864,155864,155865,0,1,5
44469,4,1,155868,155868,155869,0,1,3
44470,1,3,155869,155869,155872,0,3,0
44471,1,2,155870,155872,155874,2,4,0
44472,5,2,155875,155875,155877,0,2,1
44473,1,2,155876,155877,155879,1,3,0
44474,5,2,155881,155881,155883,0,2,2
44475,5,1,155886,155886,155887,0,1,3
44476,5,1,155891,155891,155892,0,1,4
44477,2,2,155893,155893,155895,0,2,1
44478,3,2,155896,155896,155898,0,2,1
44479,4,3,155900,155900,155903,0,3,2
44480,2,1,155902,155903,155904,1,2,0
44481,4,3,155906,155906,155909,0,3,2
44482,1,3,155907,155909,155912,2,5,0
44483,4,1,155911,155912,155913,1,2,0
44484,5,1,155916,155916,155917,0,1,3
44485,4,2,155920,155920,155922,0,2,3
44486,3,2,155923,155923,155925,0,2,1
44487,3,2,155926,155926,155928,0,2,1
44488,3,3,155929,155929,155932,0,3,1
44489,5,1,155934,155934,155935,0,1,2
44490,5,1,155939,155939,155940,0,1,4
44491,5,3,155944,155944,155947,0,3,4
44492,6,3,155950,155950,155953,0,3,3
44493,5,2,155955,155955,155957,0,2,2
44494,4,2,155959,155959,155961,0,2,2
44495,1,1,155960,155961,155962,1,2,0
44496,2,1,155962,155962,155963,0,1,0
44497,1,1,155963,155963,155964,0,1,0
44498,4,1,155967,155967,155968,0,1,3
44499,5,2,155972,155972,155974,0,2,4
44500,6,1,155978,155978,155979,0,1,4
44501,6,1,155984,155984,155985,0,1,5
44502,4,3,155988,155988,155991,0,3,3
44503,4,2,155992,155992,155994,0,2,1
44504,6,2,155998,155998,156000,0,2,4
44505,1,3,155999,156000,156003,1,4,0
44506,1,1,156000,156003,156004,3,4,0
44507,4,3,156004,156004,156007,0,3,0
44508,4,1,156008,156008,156009,0,1,1
44509,5,1,156013,156013,156014,0,1,4
44510,6,2,156019,156019,156021,0,2,5
44511,4,2,156023,156023,156025,0,2,2
44512,2,2,156025,156025,156027,0,2,0
44513,1,2,156026,156027,156029,1,3,0
44514,5,2,156031,156031,156033,0,2,2
44515,2,1,156033,156033,156034,0,1,0
44516,6,1,156039,156039,156040,0,1,5
44517,1,3,156040,156040,156043,0,3,0
44518,4,2,156044,156044,156046,0,2,1
44519,3,2,156047,156047,156049,0,2,1
44520,3,2,156050,156050,156052,0,2,1
44521,3,3,156053,156053,156056,0,3,1
44522,1,2,156054,156056,156058,2,4,0
44523,6,1,156060,156060,156061,0,1,2
44524,2,2,156062,156062,156064,0,2,1
44525,2,1,156064,156064,156065,0,1,0
44526,5,3,156069,156069,156072,0,3,4
44527,4,3,156073,156073,156076,0,3,1
44528,3,3,156076,156076,156079,0,3,0
44529,5,3,156081,156081,156084,0,3,2
44530,4,1,156085,156085,156086,0,1,1
44531,5,2,156090,156090,156092,0,2,4
44532,1,2,156091,156092,156094,1,3,0
44533,3,1,156094,156094,156095,0,1,0
44534,5,1,156099,156099,156100,0,1,4
44535,6,3,156105,156105,156108,0,3,5
44536,6,3,156111,156111,156114,0,3,3
44537,2,2,156113,156114,156116,1,3,0
44538,4,2,156117,156117,156119,0,2,1
44539,1,3,156118,156119,156122,1,4,0
44540,1,1,156119,156122,156123,3,4,0
44541,1,3,156120,156123,156126,3,6,0
44542,4,3,156124,156126,156129,2,5,0
44543,3,1,156127,156129,156130,2,3,0
44544,6,3,156133,156133,156136,0,3,3
44545,5,2,156138,156138,156140,0,2,2
44546,1,3,156139,156140,156143,1,4,0
44547,3,1,156142,156143,156144,1,2,0
44548,1,3,156143,156144,156147,1,4,0
44549,3,1,156146,156147,156148,1,2,0
44550,3,1,156149,156149,156150,0,1,1
44551,1,3,156150,156150,156153,0,3,0
44552,6,3,156156,156156,156159,0,3,3
44553,6,1,156162,156162,156163,0,1,3
44554,3,3,156165,156165,156168,0,3,2
44555,5,1,156170,156170,156171,0,1,2
44556,5,1,156175,156175,156176,0,1,4
44557,1,2,156176,156176,156178,0,2,0
44558,3,3,156179,156179,156182,0,3,1
44559,6,3,156185,156185,156188,0,3,3
44560,1,2,156186,156188,156190,2,4,0
44561,1,3,156187,156190,156193,3,6,0
44562,5,2,156192,156193,156195,1,3,0
44563,2,2,156194,156195,156197,1,3,0
44564,5,1,156199,156199,156200,0,1,2
44565,5,2,156204,156204,156206,0,2,4
44566,5,2,156209,156209,156211,0,2,3
44567,1,1,156210,156211,156212,1,2,0
44568,2,3,156212,156212,156215,0,3,0
44569,1,3,156213,156215,156218,2,5,0
44570,3,3,156216,156218,156221,2,5,0
44571,3,3,156219,156221,156224,2,5,0
44572,2,3,156221,156224,156227,3,6,0
44573,3,2,156224,156227,156229,3,5,0
44574,5,2,156229,156229,156231,0,2,0
44575,6,1,156235,156235,156236,0,1,4
44576,6,3,156241,156241,156244,0,3,5
44577,3,2,156244,156244,156246,0,2,0
44578,6,2,156250,156250,156252,0,2,4
44579,4,2,156254,156254,156256,0,2,2
44580,2,2,156256,156256,156258,0,2,0
44581,2,3,156258,156258,156261,0,3,0
44582,5,1,156263,156263,156264,0,1,2
44583,3,3,156266,156266,156269,0,3,2
44584,1,1,156267,156269,156270,2,3,0
44585,2,1,156269,156270,156271,1,2,0
44586,1,2,156270,156271,156273,1,3,0
44587,1,3,156271,156273,156276,2,5,0
44588,1,1,156272,156276,156277,4,5,0
44589,6,3,156278,156278,156281,0,3,1
44590,5,2,156283,156283,156285,0,2,2
44591,4,1,156287,156287,156288,0,1,2
44592,4,3,156291,156291,156294,0,3,3
44593,2,3,156293,156294,156297,1,4,0
44594,3,3,156296,156297,156300,1,4,0
44595,2,3,156298,156300,156303,2,5,0
44596,2,1,156300,156303,156304,3,4,0
44597,3,2,156303,156304,156306,1,3,0
44598,6,3,156309,156309,156312,0,3,3
44599,6,3,156315,156315,156318,0,3,3
44600,5,1,156320,156320,156321,0,1,2
44601,3,2,156323,156323,156325,0,2,2
44602,5,2,156328,156328,156330,0,2,3
44603,2,1,156330,156330,156331,0,1,0
44604,1,3,156331,156331,156334,0,3,0
44605,2,2,156333,156334,156336,1,3,0
44606,5,1,156338,156338,156339,0,1,2
44607,2,2,156340,156340,156342,0,2,1
44608,5,3,156345,156345,156348,0,3,3
44609,5,3,156350,156350,156353,0,3,2
44610,6,2,156356,156356,156358,0,2,3
44611,2,3,156358,156358,156361,0,3,0
44612,3,3,156361,156361,156364,0,3,0
44613,1,3,156362,156364,156367,2,5,0
44614,5,2,156367,156367,156369,0,2,0
44615,5,1,156372,156372,156373,0,1,3
44616,1,2,156373,156373,156375,0,2,0
44617,3,2,156376,156376,156378,0,2,1
44618,1,2,156377,156378,156380,1,3,0
44619,3,3,156380,156380,156383,0,3,0
44620,2,2,156382,156383,156385,1,3,0
44621,3,3,156385,156385,156388,0,3,0
44622,3,1,156388,156388,156389,0,1,0
44623,5,2,156393,156393,156395,0,2,4
44624,4,1,156397,156397,156398,0,1,2
44625,1,1,156398,156398,156399,0,1,0
44626,6,2,156404,156404,156406,0,2,5
44627,3,1,156407,156407,156408,0,1,1
44628,5,1,156412,156412,156413,0,1,4
44629,6,2,156418,156418,156420,0,2,5
44630,6,3,156424,156424,156427,0,3,4
44631,2,2,156426,156427,156429,1,3,0
44632,5,2,156431,156431,156433,0,2,2
44633,4,3,156435,156435,156438,0,3,2
44634,2,3,156437,156438,156441,1,4,0
44635,5,1,156442,156442,156443,0,1,1
44636,2,1,156444,156444,156445,0,1,1
44637,4,2,156448,156448,156450,0,2,3
44638,2,2,156450,156450,156452,0,2,0
44639,6,3,156456,156456,156459,0,3,4
44640,1,1,156457,156459,156460,2,3,0
44641,4,2,156461,156461,156463,0,2,1
44642,1,2,156462,156463,156465,1,3,0
44643,3,3,156465,156465,156468,0,3,0
44644,1,1,156466,156468,156469,2,3,0
44645,5,1,156471,156471,156472,0,1,2
44646,6,1,156477,156477,156478,0,1,5
44647,2,1,156479,156479,156480,0,1,1
44648,3,3,156482,156482,156485,0,3,2
44649,5,2,156487,156487,156489,0,2,2
44650,4,2,156491,156491,156493,0,2,2
44651,6,2,156497,156497,156499,0,2,4
44652,1,1,156498,156499,156500,1,2,0
44653,6,2,156504,156504,156506,0,2,4
44654,3,3,156507,156507,156510,0,3,1
44655,5,2,156512,156512,156514,0,2,2
44656,4,1,156516,156516,156517,0,1,2
44657,3,1,156519,156519,156520,0,1,2
44658,2,3,156521,156521,156524,0,3,1
44659,4,1,156525,156525,156526,0,1,1
44660,2,3,156527,156527,156530,0,3,1
44661,3,1,156530,156530,156531,0,1,0
44662,2,1,156532,156532,156533,0,1,1
44663,1,3,156533,156533,156536,0,3,0
44664,5,2,156538,156538,156540,0,2,2
44665,2,2,156540,156540,156542,0,2,0
44666,4,2,156544,156544,156546,0,2,2
44667,6,2,156550,156550,156552,0,2,4
44668,6,2,156556,156556,156558,0,2,4
44669,2,2,156558,156558,156560,0,2,0
44670,5,3,156563,156563,156566,0,3,3
44671,5,3,156568,156568,156571,0,3,2
44672,2,3,156570,156571,156574,1,4,0
44673,2,1,156572,156574,156575,2,3,0
44674,5,3,156577,156577,156580,0,3,2
44675,1,2,156578,156580,156582,2,4,0
44676,2,2,156580,156582,156584,2,4,0
44677,6,2,156586,156586,156588,0,2,2
44678,2,1,156588,156588,156589,0,1,0
44679,1,3,156589,156589,156592,0,3,0
44680,1,1,156590,156592,156593,2,3,0
44681,1,3,156591,156593,156596,2,5,0
44682,6,3,156597,156597,156600,0,3,1
44683,4,1,156601,156601,156602,0,1,1
44684,3,3,156604,156604,156607,0,3,2
44685,2,2,156606,156607,156609,1,3,0
44686,3,1,156609,156609,156610,0,1,0
44687,2,1,156611,156611,156612,0,1,1
44688,1,1,156612,156612,156613,0,1,0
44689,2,3,156614,156614,156617,0,3,1
44690,3,1,156617,156617,156618,0,1,0
44691,6,3,156623,156623,156626,0,3,5
44692,1,3,156624,156626,156629,2,5,0
44693,1,1,156625,156629,156630,4,5,0
44694,3,3,156628,156630,156633,2,5,0
44695,6,3,156634,156634,156637,0,3,1
44696,6,3,156640,156640,156643,0,3,3
44697,3,3,156643,156643,156646,0,3,0
44698,6,3,156649,156649,156652,0,3,3
44699,6,1,156655,156655,156656,0,1,3
44700,4,1,156659,156659,156660,0,1,3
44701,3,1,156662,156662,156663,0,1,2
44702,5,1,156667,156667,156668,0,1,4
44703,4,3,156671,156671,156674,0,3,3
44704,5,1,156676,156676,156677,0,1,2
44705,4,3,156680,156680,156683,0,3,3
44706,2,1,156682,156683,156684,1,2,0
44707,5,1,156687,156687,156688,0,1,3
44708,1,1,156688,156688,156689,0,1,0
44709,2,3,156690,156690,156693,0,3,1
44710,2,2,156692,156693,156695,1,3,0
44711,3,1,156695,156695,156696,0,1,0
44712,2,3,156697,156697,156700,0,3,1
44713,1,1,156698,156700,156701,2,3,0
44714,6,1,156704,156704,156705,0,1,3
44715,2,2,156706,156706,156708,0,2,1
44716,1,2,156707,156708,156710,1,3,0
44717,2,1,156709,156710,156711,1,2,0
44718,1,3,156710,156711,156714,1,4,0
44719,4,1,156714,156714,156715,0,1,0
44720,3,2,156717,156717,156719,0,2,2
44721,6,1,156723,156723,156724,0,1,4
44722,3,3,156726,156726,156729,0,3,2
44723,6,1,156732,156732,156733,0,1,3
44724,3,3,156735,156735,156738,0,3,2
44725,2,3,156737,156738,156741,1,4,0
44726,6,3,156743,156743,156746,0,3,2
44727,5,1,156748,156748,156749,0,1,2
44728,2,1,156750,156750,156751,0,1,1
44729,1,2,156751,156751,156753,0,2,0
44730,4,2,156755,156755,156757,0,2,2
44731,5,2,156760,156760,156762,0,2,3
44732,6,3,156766,156766,156769,0,3,4
44733,2,2,156768,156769,156771,1,3,0
44734,3,3,156771,156771,156774,0,3,0
44735,3,3,156774,156774,156777,0,3,0
44736,2,1,156776,156777,156778,1,2,0
44737,6,1,156782,156782,156783,0,1,4
44738,4,1,156786,156786,156787,0,1,3
44739,5,1,156791,156791,156792,0,1,4
44740,5,1,156796,156796,156797,0,1,4
44741,1,1,156797,156797,156798,0,1,0
44742,2,3,156799,156799,156802,0,3,1
44743,2,1,156801,156802,156803,1,2,0
44744,2,3,156803,156803,156806,0,3,0
44745,6,1,156809,156809,156810,0,1,3
44746,5,2,156814,156814,156816,0,2,4
44747,1,3,156815,156816,156819,1,4,0
44748,2,2,156817,156819,156821,2,4,0
44749,4,3,156821,156821,156824,0,3,0
44750,5,3,156826,156826,156829,0,3,2
44751,6,3,156832,156832,156835,0,3,3
44752,6,1,156838,156838,156839,0,1,3
44753,1,3,156839,156839,156842,0,3,0
44754,5,2,156844,156844,156846,0,2,2
44755,5,3,156849,156849,156852,0,3,3
44756,5,3,156854,156854,156857,0,3,2
44757,5,2,156859,156859,156861,0,2,2
44758,5,2,156864,156864,156866,0,2,3
44759,2,3,156866,156866,156869,0,3,0
44760,6,2,156872,156872,156874,0,2,3
44761,4,3,156876,156876,156879,0,3,2
44762,2,2,156878,156879,156881,1,3,0
44763,3,1,156881,156881,156882,0,1,0
44764,3,2,156884,156884,156886,0,2,2
44765,2,1,156886,156886,156887,0,1,0
44766,1,1,156887,156887,156888,0,1,0
44767,3,1,156890,156890,156891,0,1,2
44768,4,1,156894,156894,156895,0,1,3
44769,6,1,156900,156900,156901,0,1,5
44770,5,3,156905,156905,156908,0,3,4
44771,4,2,156909,156909,156911,0,2,1
44772,4,1,156913,156913,156914,0,1,2
44773,2,1,156915,156915,156916,0,1,1
44774,2,1,156917,156917,156918,0,1,1
44775,3,2,156920,156920,156922,0,2,2
44776,4,2,156924,156924,156926,0,2,2
44777,2,3,156926,156926,156929,0,3,0
44778,2,3,156928,156929,156932,1,4,0
44779,3,3,156931,156932,156935,1,4,0
44780,5,2,156936,156936,156938,0,2,1
44781,6,1,156942,156942,156943,0,1,4
44782,4,2,156946,156946,156948,0,2,3
44783,2,3,156948,156948,156951,0,3,0
44784,6,1,156954,156954,156955,0,1,3
44785,4,3,156958,156958,156961,0,3,3
44786,2,3,156960,156961,156964,1,4,0
44787,3,1,156963,156964,156965,1,2,0
44788,1,2,156964,156965,156967,1,3,0
44789,5,3,156969,156969,156972,0,3,2
44790,6,2,156975,156975,156977,0,2,3
44791,5,1,156980,156980,156981,0,1,3
44792,6,1,156986,156986,156987,0,1,5
44793,2,1,156988,156988,156989,0,1,1
44794,1,3,156989,156989,156992,0,3,0
44795,6,1,156995,156995,156996,0,1,3
44796,4,1,156999,156999,157000,0,1,3
44797,2,1,157001,157001,157002,0,1,1
44798,3,1,157004,157004,157005,0,1,2
44799,4,1,157008,157008,157009,0,1,3
44800,5,1,157013,157013,157014,0,1,4
44801,2,3,157015,157015,157018,0,3,1
44802,1,3,157016,157018,157021,2,5,0
44803,4,1,157020,157021,157022,1,2,0
44804,6,1,157026,157026,157027,0,1,4
44805,4,3,157030,157030,157033,0,3,3
44806,2,2,157032,157033,157035,1,3,0
44807,3,3,157035,157035,157038,0,3,0
44808,2,1,157037,157038,157039,1,2,0
44809,4,2,157041,157041,157043,0,2,2
44810,5,3,157046,157046,157049,0,3,3
44811,4,1,157050,157050,157051,0,1,1
44812,1,3,157051,157051,157054,0,3,0
44813,5,2,157056,157056,157058,0,2,2
44814,5,1,157061,157061,157062,0,1,3
44815,5,1,157066,157066,157067,0,1,4
44816,5,1,157071,157071,157072,0,1,4
44817,4,1,157075,157075,157076,0,1,3
44818,1,2,157076,157076,157078,0,2,0
44819,4,1,157080,157080,157081,0,1,2
44820,6,1,157086,157086,157087,0,1,5
44821,3,2,157089,157089,157091,0,2,2
44822,4,3,157093,157093,157096,0,3,2
44823,2,2,157095,157096,157098,1,3,0
44824,2,2,157097,157098,157100,1,3,0
44825,5,1,157102,157102,157103,0,1,2
44826,6,3,157108,157108,157111,0,3,5
44827,2,2,157110,157111,157113,1,3,0
44828,3,2,157113,157113,157115,0,2,0
44829,2,1,157115,157115,157116,0,1,0
44830,4,3,157119,157119,157122,0,3,3
44831,6,2,157125,157125,157127,0,2,3
44832,4,2,157129,157129,157131,0,2,2
44833,6,3,157135,157135,157138,0,3,4
44834,5,1,157140,157140,157141,0,1,2
44835,4,3,157144,157144,157147,0,3,3
44836,6,3,157150,157150,157153,0,3,3
44837,2,2,157152,157153,157155,1,3,0
44838,1,3,157153,157155,157158,2,5,0
44839,5,3,157158,157158,157161,0,3,0
44840,2,1,157160,157161,157162,1,2,0
44841,3,2,157163,157163,157165,0,2,1
44842,2,3,157165,157165,157168,0,3,0
44843,1,2,157166,157168,157170,2,4,0
44844,6,2,157172,157172,157174,0,2,2
44845,6,3,157178,157178,157181,0,3,4
44846,5,1,157183,157183,157184,0,1,2
44847,2,3,157185,157185,157188,0,3,1
44848,1,3,157186,157188,157191,2,5,0
44849,3,1,157189,157191,157192,2,3,0
44850,1,2,157190,157192,157194,2,4,0
44851,5,3,157195,157195,157198,0,3,1
44852,5,2,157200,157200,157202,0,2,2
44853,4,3,157204,157204,157207,0,3,2
44854,4,3,157208,157208,157211,0,3,1
44855,5,1,157213,157213,157214,0,1,2
44856,3,2,157216,157216,157218,0,2,2
44857,5,3,157221,157221,157224,0,3,3
44858,2,1,157223,157224,157225,1,2,0
44859,6,3,157229,157229,157232,0,3,4
44860,6,3,157235,157235,157238,0,3,3
44861,3,1,157238,157238,157239,0,1,0
44862,2,3,157240,157240,157243,0,3,1
44863,1,1,157241,157243,157244,2,3,0
44864,5,3,157246,157246,157249,0,3,2
44865,4,3,157250,157250,157253,0,3,1
44866,1,1,157251,157253,157254,2,3,0
44867,1,3,157252,157254,157257,2,5,0
44868,5,2,157257,157257,157259,0,2,0
44869,3,3,157260,157260,157263,0,3,1
44870,5,3,157265,157265,157268,0,3,2
44871,2,3,157267,157268,157271,1,4,0
44872,4,3,157271,157271,157274,0,3,0
44873,3,3,157274,157274,157277,0,3,0
44874,6,3,157280,157280,157283,0,3,3
44875,6,1,157286,157286,157287,0,1,3
44876,3,1,157289,157289,157290,0,1,2
44877,5,3,157294,157294,157297,0,3,4
44878,4,1,157298,157298,157299,0,1,1
44879,1,1,157299,157299,157300,0,1,0
44880,1,3,157300,157300,157303,0,3,0
44881,3,3,157303,157303,157306,0,3,0
44882,1,1,157304,157306,157307,2,3,0
44883,6,3,157310,157310,157313,0,3,3
44884,3,1,157313,157313,157314,0,1,0
44885,4,1,157317,157317,157318,0,1,3
44886,2,3,157319,157319,157322,0,3,1
44887,6,1,157325,157325,157326,0,1,3
44888,3,3,157328,157328,157331,0,3,2
44889,5,3,157333,157333,157336,0,3,2
44890,2,1,157335,157336,157337,1,2,0
44891,5,3,157340,157340,157343,0,3,3
44892,2,2,157342,157343,157345,1,3,0
44893,4,3,157346,157346,157349,0,3,1
44894,5,2,157351,157351,157353,0,2,2
44895,3,1,157354,157354,157355,0,1,1
44896,6,1,157360,157360,157361,0,1,5
44897,3,1,157363,157363,157364,0,1,2
44898,5,2,157368,157368,157370,0,2,4
44899,5,1,157373,157373,157374,0,1,3
44900,2,3,157375,157375,157378,0,3,1
44901,6,2,157381,157381,157383,0,2,3
44902,5,1,157386,157386,157387,0,1,3
44903,2,1,157388,157388,157389,0,1,1
44904,2,2,157390,157390,157392,0,2,1
44905,6,2,157396,157396,157398,0,2,4
44906,4,3,157400,157400,157403,0,3,2
44907,3,2,157403,157403,157405,0,2,0
44908,3,3,157406,157406,157409,0,3,1
44909,2,2,157408,157409,157411,1,3,0
44910,2,1,157410,157411,157412,1,2,0
44911,4,2,157414,157414,157416,0,2,2
44912,6,1,157420,157420,157421,0,1,4
44913,2,3,157422,157422,157425,0,3,1
44914,2,2,157424,157425,157427,1,3,0
44915,5,1,157429,157429,157430,0,1,2
44916,4,1,157433,157433,157434,0,1,3
44917,2,3,157435,157435,157438,0,3,1
44918,4,3,157439,157439,157442,0,3,1
44919,6,3,157445,157445,157448,0,3,3
44920,6,2,157451,157451,157453,0,2,3
44921,4,3,157455,157455,157458,0,3,2
44922,2,2,157457,157458,157460,1,3,0
44923,6,2,157463,157463,157465,0,2,3
44924,5,2,157468,157468,157470,0,2,3
44925,3,1,157471,157471,157472,0,1,1
44926,6,2,157477,157477,157479,0,2,5
44927,1,3,157478,157479,157482,1,4,0
44928,2,2,157480,157482,157484,2,4,0
44929,6,1,157486,157486,157487,0,1,2
44930,4,2,157490,157490,157492,0,2,3
44931,3,2,157493,157493,157495,0,2,1
44932,1,3,157494,157495,157498,1,4,0
44933,6,1,157500,157500,157501,0,1,2
44934,1,2,157501,157501,157503,0,2,0
44935,1,2,157502,157503,157505,1,3,0
44936,6,3,157508,157508,157511,0,3,3
44937,2,1,157510,157511,157512,1,2,0
44938,4,2,157514,157514,157516,0,2,2
44939,5,1,157519,157519,157520,0,1,3
44940,2,3,157521,157521,157524,0,3,1
44941,5,1,157526,157526,157527,0,1,2
44942,5,2,157531,157531,157533,0,2,4
44943,6,1,157537,157537,157538,0,1,4
44944,6,3,157543,157543,157546,0,3,5
44945,5,1,157548,157548,157549,0,1,2
44946,5,2,157553,157553,157555,0,2,4
44947,4,3,157557,157557,157560,0,3,2
44948,5,1,157562,157562,157563,0,1,2
44949,2,1,157564,157564,157565,0,1,1
44950,1,2,157565,157565,157567,0,2,0
44951,4,2,157569,157569,157571,0,2,2
44952,6,2,157575,157575,157577,0,2,4
44953,1,3,157576,157577,157580,1,4,0
44954,1,2,157577,157580,157582,3,5,0
44955,3,2,157580,157582,157584,2,4,0
44956,6,1,157586,157586,157587,0,1,2
44957,2,1,157588,157588,157589,0,1,1
44958,5,1,157593,157593,157594,0,1,4
44959,5,3,157598,157598,157601,0,3,4
44960,1,1,157599,157601,157602,2,3,0
44961,6,2,157605,157605,157607,0,2,3
44962,3,1,157608,157608,157609,0,1,1
44963,6,1,157614,157614,157615,0,1,5
44964,5,1,157619,157619,157620,0,1,4
44965,4,3,157623,157623,157626,0,3,3
44966,2,1,157625,157626,157627,1,2,0
44967,3,3,157628,157628,157631,0,3,1
44968,5,3,157633,157633,157636,0,3,2
44969,6,1,157639,157639,157640,0,1,3
44970,1,2,157640,157640,157642,0,2,0
44971,1,3,157641,157642,157645,1,4,0
44972,3,1,157644,157645,157646,1,2,0
44973,3,2,157647,157647,157649,0,2,1
44974,1,2,157648,157649,157651,1,3,0
44975,3,3,157651,157651,157654,0,3,0
44976,1,3,157652,157654,157657,2,5,0
44977,3,2,157655,157657,157659,2,4,0
44978,2,3,157657,157659,157662,2,5,0
44979,3,1,157660,157662,157663,2,3,0
44980,3,1,157663,157663,157664,0,1,0
44981,1,2,157664,157664,157666,0,2,0
44982,2,3,157666,157666,157669,0,3,0
44983,4,3,157670,157670,157673,0,3,1
44984,5,1,157675,157675,157676,0,1,2
44985,1,1,157676,157676,157677,0,1,0
44986,4,1,157680,157680,157681,0,1,3
44987,5,2,157685,157685,157687,0,2,4
44988,2,1,157687,157687,157688,0,1,0
44989,1,1,157688,157688,157689,0,1,0
44990,3,2,157691,157691,157693,0,2,2
44991,4,1,157695,157695,157696,0,1,2
44992,4,2,157699,157699,157701,0,2,3
44993,6,2,157705,157705,157707,0,2,4
44994,3,2,157708,157708,157710,0,2,1
44995,3,2,157711,157711,157713,0,2,1
44996,6,1,157717,157717,157718,0,1,4
44997,4,1,157721,157721,157722,0,1,3
44998,5,3,157726,157726,157729,0,3,4
44999,4,2,157730,157730,157732,0,2,1
45000,4,1,157734,157734,157735,0,1,2
45001,1,3,157735,157735,157738,0,3,0
45002,3,1,157738,157738,157739,0,1,0
45003,6,1,157744,157744,157745,0,1,5
45004,6,2,157750,157750,157752,0,2,5
45005,5,3,157755,157755,157758,0,3,3
45006,3,1,157758,157758,157759,0,1,0
45007,2,2,157760,157760,157762,0,2,1
45008,3,1,157763,157763,157764,0,1,1
45009,5,2,157768,157768,157770,0,2,4
45010,2,3,157770,157770,157773,0,3,0
45011,6,2,157776,157776,157778,0,2,3
45012,1,1,157777,157778,157779,1,2,0
45013,5,3,157782,157782,157785,0,3,3
45014,4,3,157786,157786,157789,0,3,1
45015,6,3,157792,157792,157795,0,3,3
45016,4,2,157796,157796,157798,0,2,1
45017,4,1,157800,157800,157801,0,1,2
45018,6,1,157806,157806,157807,0,1,5
45019,2,1,157808,157808,157809,0,1,1
45020,5,2,157813,157813,157815,0,2,4
45021,5,1,157818,157818,157819,0,1,3
45022,3,1,157821,157821,157822,0,1,2
45023,6,3,157827,157827,157830,0,3,5
45024,2,3,157829,157830,157833,1,4,0
45025,3,3,157832,157833,157836,1,4,0
45026,1,2,157833,157836,157838,3,5,0
45027,5,3,157838,157838,157841,0,3,0
45028,1,1,157839,157841,157842,2,3,0
45029,5,1,157844,157844,157845,0,1,2
45030,4,1,157848,157848,157849,0,1,3
45031,2,1,157850,157850,157851,0,1,1
45032,2,3,157852,157852,157855,0,3,1
45033,1,1,157853,157855,157856,2,3,0
45034,1,2,157854,157856,157858,2,4,0
45035,4,3,157858,157858,157861,0,3,0
45036,1,2,157859,157861,157863,2,4,0
45037,3,3,157862,157863,157866,1,4,0
45038,3,3,157865,157866,157869,1,4,0
45039,2,3,157867,157869,157872,2,5,0
45040,1,3,157868,157872,157875,4,7,0
45041,1,2,157869,157875,157877,6,8,0
45042,1,3,157870,157877,157880,7,10,0
45043,5,1,157875,157880,157881,5,6,0
45044,3,1,157878,157881,157882,3,4,0
45045,2,2,157880,157882,157884,2,4,0
45046,4,1,157884,157884,157885,0,1,0
45047,2,3,157886,157886,157889,0,3,1
45048,1,1,157887,157889,157890,2,3,0
45049,3,2,157890,157890,157892,0,2,0
45050,3,3,157893,157893,157896,0,3,1
45051,6,3,157899,157899,157902,0,3,3
45052,6,3,157905,157905,157908,0,3,3
45053,5,1,157910,157910,157911,0,1,2
45054,3,2,157913,157913,157915,0,2,2
45055,1,1,157914,157915,157916,1,2,0
45056,1,3,157915,157916,157919,1,4,0
45057,5,1,157920,157920,157921,0,1,1
45058,3,1,157923,157923,157924,0,1,2
45059,4,3,157927,157927,157930,0,3,3
45060,1,2,157928,157930,157932,2,4,0
45061,6,1,157934,157934,157935,0,1,2
45062,1,3,157935,157935,157938,0,3,0
45063,1,2,157936,157938,157940,2,4,0
45064,1,2,157937,157940,157942,3,5,0
45065,2,2,157939,157942,157944,3,5,0
45066,5,1,157944,157944,157945,0,1,0
45067,3,1,157947,157947,157948,0,1,2
45068,3,2,157950,157950,157952,0,2,2
45069,6,1,157956,157956,157957,0,1,4
45070,2,2,157958,157958,157960,0,2,1
45071,1,2,157959,157960,157962,1,3,0
45072,6,3,157965,157965,157968,0,3,3
45073,6,1,157971,157971,157972,0,1,3
45074,6,1,157977,157977,157978,0,1,5
45075,1,1,157978,157978,157979,0,1,0
45076,6,2,157984,157984,157986,0,2,5
45077,4,3,157988,157988,157991,0,3,2
45078,6,2,157994,157994,157996,0,2,3
45079,3,3,157997,157997,158000,0,3,1
45080,3,2,158000,158000,158002,0,2,0
45081,5,2,158005,158005,158007,0,2,3
45082,2,3,158007,158007,158010,0,3,0
45083,6,1,158013,158013,158014,0,1,3
45084,4,3,158017,158017,158020,0,3,3
45085,3,1,158020,158020,158021,0,1,0
45086,3,2,158023,158023,158025,0,2,2
45087,5,3,158028,158028,158031,0,3,3
45088,4,3,158032,158032,158035,0,3,1
45089,2,3,158034,158035,158038,1,4,0
45090,2,1,158036,158038,158039,2,3,0
45091,1,2,158037,158039,158041,2,4,0
45092,2,2,158039,158041,158043,2,4,0
45093,2,1,158041,158043,158044,2,3,0
45094,1,2,158042,158044,158046,2,4,0
45095,2,2,158044,158046,158048,2,4,0
45096,3,1,158047,158048,158049,1,2,0
45097,3,1,158050,158050,158051,0,1,1
45098,1,1,158051,158051,158052,0,1,0
45099,6,3,158057,158057,158060,0,3,5
45100,1,3,158058,158060,158063,2,5,0
45101,1,3,158059,158063,158066,4,7,0
45102,1,1,158060,158066,158067,6,7,0
45103,4,2,158064,158067,158069,3,5,0
45104,6,1,158070,158070,158071,0,1,1
45105,3,3,158073,158073,158076,0,3,2
45106,6,3,158079,158079,158082,0,3,3
45107,5,2,158084,158084,158086,0,2,2
45108,4,2,158088,158088,158090,0,2,2
45109,2,3,158090,158090,158093,0,3,0
45110,5,1,158095,158095,158096,0,1,2
45111,5,3,158100,158100,158103,0,3,4
45112,1,3,158101,158103,158106,2,5,0
45113,6,3,158107,158107,158110,0,3,1
45114,4,2,158111,158111,158113,0,2,1
45115,3,3,158114,158114,158117,0,3,1
45116,5,1,158119,158119,158120,0,1,2
45117,5,1,158124,158124,158125,0,1,4
45118,3,3,158127,158127,158130,0,3,2
45119,5,1,158132,158132,158133,0,1,2
45120,1,2,158133,158133,158135,0,2,0
45121,1,3,158134,158135,158138,1,4,0
45122,6,3,158140,158140,158143,0,3,2
45123,6,1,158146,158146,158147,0,1,3
45124,1,1,158147,158147,158148,0,1,0
45125,1,1,158148,158148,158149,0,1,0
45126,3,3,158151,158151,158154,0,3,2
45127,6,3,158157,158157,158160,0,3,3
45128,2,3,158159,158160,158163,1,4,0
45129,5,3,158164,158164,158167,0,3,1
45130,3,1,158167,158167,158168,0,1,0
45131,3,3,158170,158170,158173,0,3,2
45132,3,3,158173,158173,158176,0,3,0
45133,1,1,158174,158176,158177,2,3,0
45134,3,1,158177,158177,158178,0,1,0
45135,5,2,158182,158182,158184,0,2,4
45136,1,3,158183,158184,158187,1,4,0
45137,5,1,158188,158188,158189,0,1,1
45138,3,1,158191,158191,158192,0,1,2
45139,5,2,158196,158196,158198,0,2,4
45140,4,1,158200,158200,158201,0,1,2
45141,5,3,158205,158205,158208,0,3,4
45142,2,3,158207,158208,158211,1,4,0
45143,4,2,158211,158211,158213,0,2,0
45144,2,2,158213,158213,158215,0,2,0
45145,1,2,158214,158215,158217,1,3,0
45146,5,2,158219,158219,158221,0,2,2
45147,5,1,158224,158224,158225,0,1,3
45148,1,3,158225,158225,158228,0,3,0
45149,4,3,158229,158229,158232,0,3,1
45150,5,2,158234,158234,158236,0,2,2
45151,4,1,158238,158238,158239,0,1,2
45152,4,3,158242,158242,158245,0,3,3
45153,4,2,158246,158246,158248,0,2,1
45154,5,1,158251,158251,158252,0,1,3
45155,1,2,158252,158252,158254,0,2,0
45156,3,3,158255,158255,158258,0,3,1
45157,3,1,158258,158258,158259,0,1,0
45158,5,3,158263,158263,158266,0,3,4
45159,3,2,158266,158266,158268,0,2,0
45160,1,1,158267,158268,158269,1,2,0
45161,1,3,158268,158269,158272,1,4,0
45162,5,2,158273,158273,158275,0,2,1
45163,3,3,158276,158276,158279,0,3,1
45164,6,2,158282,158282,158284,0,2,3
45165,4,2,158286,158286,158288,0,2,2
45166,2,3,158288,158288,158291,0,3,0
45167,3,3,158291,158291,158294,0,3,0
45168,3,2,158294,158294,158296,0,2,0
45169,5,1,158299,158299,158300,0,1,3
45170,5,1,158304,158304,158305,0,1,4
45171,3,2,158307,158307,158309,0,2,2
45172,1,1,158308,158309,158310,1,2,0
45173,5,3,158313,158313,158316,0,3,3
45174,6,3,158319,158319,158322,0,3,3
45175,2,1,158321,158322,158323,1,2,0
45176,5,3,158326,158326,158329,0,3,3
45177,2,3,158328,158329,158332,1,4,0
45178,1,3,158329,158332,158335,3,6,0
45179,5,1,158334,158335,158336,1,2,0
45180,3,2,158337,158337,158339,0,2,1
45181,1,2,158338,158339,158341,1,3,0
45182,4,2,158342,158342,158344,0,2,1
45183,6,3,158348,158348,158351,0,3,4
45184,4,2,158352,158352,158354,0,2,1
45185,6,3,158358,158358,158361,0,3,4
45186,3,1,158361,158361,158362,0,1,0
45187,3,3,158364,158364,158367,0,3,2
45188,3,2,158367,158367,158369,0,2,0
45189,3,1,158370,158370,158371,0,1,1
45190,5,1,158375,158375,158376,0,1,4
45191,2,3,158377,158377,158380,0,3,1
45192,4,3,158381,158381,158384,0,3,1
45193,1,1,158382,158384,158385,2,3,0
45194,3,1,158385,158385,158386,0,1,0
45195,3,2,158388,158388,158390,0,2,2
45196,5,2,158393,158393,158395,0,2,3
45197,6,3,158399,158399,158402,0,3,4
45198,1,3,158400,158402,158405,2,5,0
45199,3,1,158403,158405,158406,2,3,0
45200,2,3,158405,158406,158409,1,4,0
45201,1,3,158406,158409,158412,3,6,0
45202,6,3,158412,158412,158415,0,3,0
45203,4,1,158416,158416,158417,0,1,1
45204,6,2,158422,158422,158424,0,2,5
45205,5,3,158427,158427,158430,0,3,3
45206,5,3,158432,158432,158435,0,3,2
45207,5,2,158437,158437,158439,0,2,2
45208,6,2,158443,158443,158445,0,2,4
45209,5,2,158448,158448,158450,0,2,3
45210,6,2,158454,158454,158456,0,2,4
45211,2,3,158456,158456,158459,0,3,0
45212,2,3,158458,158459,158462,1,4,0
45213,4,2,158462,158462,158464,0,2,0
45214,3,1,158465,158465,158466,0,1,1
45215,4,2,158469,158469,158471,0,2,3
45216,4,2,158473,158473,158475,0,2,2
45217,2,2,158475,158475,158477,0,2,0
45218,3,1,158478,158478,158479,0,1,1
45219,5,2,158483,158483,158485,0,2,4
45220,1,1,158484,158485,158486,1,2,0
45221,6,1,158490,158490,158491,0,1,4
45222,6,1,158496,158496,158497,0,1,5
45223,2,2,158498,158498,158500,0,2,1
45224,6,3,158504,158504,158507,0,3,4
45225,2,2,158506,158507,158509,1,3,0
45226,4,1,158510,158510,158511,0,1,1
45227,2,2,158512,158512,158514,0,2,1
45228,4,1,158516,158516,158517,0,1,2
45229,6,2,158522,158522,158524,0,2,5
45230,4,3,158526,158526,158529,0,3,2
45231,4,1,158530,158530,158531,0,1,1
45232,3,3,158533,158533,158536,0,3,2
45233,4,1,158537,158537,158538,0,1,1
45234,3,1,158540,158540,158541,0,1,2
45235,5,1,158545,158545,158546,0,1,4
45236,4,2,158549,158549,158551,0,2,3
45237,4,3,158553,158553,158556,0,3,2
45238,4,3,158557,158557,158560,0,3,1
45239,5,1,158562,158562,158563,0,1,2
45240,2,3,158564,158564,158567,0,3,1
45241,4,3,158568,158568,158571,0,3,1
45242,5,2,158573,158573,158575,0,2,2
45243,4,2,158577,158577,158579,0,2,2
45244,3,1,158580,158580,158581,0,1,1
45245,4,3,158584,158584,158587,0,3,3
45246,1,3,158585,158587,158590,2,5,0
45247,6,1,158591,158591,158592,0,1,1
45248,4,2,158595,158595,158597,0,2,3
45249,6,2,158601,158601,158603,0,2,4
45250,4,2,158605,158605,158607,0,2,2
45251,1,3,158606,158607,158610,1,4,0
45252,1,3,158607,158610,158613,3,6,0
45253,3,3,158610,158613,158616,3,6,0
45254,1,1,158611,158616,158617,5,6,0
45255,5,1,158616,158617,158618,1,2,0
45256,2,3,158618,158618,158621,0,3,0
45257,6,2,158624,158624,158626,0,2,3
45258,2,3,158626,158626,158629,0,3,0
45259,2,1,158628,158629,158630,1,2,0
45260,3,2,158631,158631,158633,0,2,1
45261,4,2,158635,158635,158637,0,2,2
45262,4,2,158639,158639,158641,0,2,2
45263,5,2,158644,158644,158646,0,2,3
45264,1,1,158645,158646,158647,1,2,0
45265,6,2,158651,158651,158653,0,2,4
45266,2,2,158653,158653,158655,0,2,0
45267,5,1,158658,158658,158659,0,1,3
45268,2,1,158660,158660,158661,0,1,1
45269,6,3,158666,158666,158669,0,3,5
45270,3,2,158669,158669,158671,0,2,0
45271,3,3,158672,158672,158675,0,3,1
45272,5,2,158677,158677,158679,0,2,2
45273,2,3,158679,158679,158682,0,3,0
45274,5,2,158684,158684,158686,0,2,2
45275,3,2,158687,158687,158689,0,2,1
45276,1,2,158688,158689,158691,1,3,0
45277,5,1,158693,158693,158694,0,1,2
45278,2,1,158695,158695,158696,0,1,1
45279,3,1,158698,158698,158699,0,1,2
45280,4,2,158702,158702,158704,0,2,3
45281,1,2,158703,158704,158706,1,3,0
45282,6,2,158709,158709,158711,0,2,3
45283,1,2,158710,158711,158713,1,3,0
45284,4,3,158714,158714,158717,0,3,1
45285,4,3,158718,158718,158721,0,3,1
45286,4,3,158722,158722,158725,0,3,1
45287,6,1,158728,158728,158729,0,1,3
45288,6,2,158734,158734,158736,0,2,5
45289,2,1,158736,158736,158737,0,1,0
45290,6,1,158742,158742,158743,0,1,5
45291,2,1,158744,158744,158745,0,1,1
45292,3,1,158747,158747,158748,0,1,2
45293,3,1,158750,158750,158751,0,1,2
45294,6,3,158756,158756,158759,0,3,5
45295,2,3,158758,158759,158762,1,4,0
45296,1,2,158759,158762,158764,3,5,0
45297,6,3,158765,158765,158768,0,3,1
45298,4,3,158769,158769,158772,0,3,1
45299,3,1,158772,158772,158773,0,1,0
45300,2,3,158774,158774,158777,0,3,1
45301,4,2,158778,158778,158780,0,2,1
45302,4,2,158782,158782,158784,0,2,2
45303,6,2,158788,158788,158790,0,2,4
45304,2,2,158790,158790,158792,0,2,0
45305,2,3,158792,158792,158795,0,3,0
45306,1,2,158793,158795,158797,2,4,0
45307,2,2,158795,158797,158799,2,4,0
45308,5,1,158800,158800,158801,0,1,1
45309,4,2,158804,158804,158806,0,2,3
45310,1,1,158805,158806,158807,1,2,0
45311,2,1,158807,158807,158808,0,1,0
45312,2,2,158809,158809,158811,0,2,1
45313,4,3,158813,158813,158816,0,3,2
45314,2,1,158815,158816,158817,1,2,0
45315,5,3,158820,158820,158823,0,3,3
45316,6,1,158826,158826,158827,0,1,3
45317,3,3,158829,158829,158832,0,3,2
45318,4,1,158833,158833,158834,0,1,1
45319,5,2,158838,158838,158840,0,2,4
45320,1,3,158839,158840,158843,1,4,0
45321,3,1,158842,158843,158844,1,2,0
45322,1,3,158843,158844,158847,1,4,0
45323,1,3,158844,158847,158850,3,6,0
45324,1,3,158845,158850,158853,5,8,0
45325,6,3,158851,158853,158856,2,5,0
45326,5,3,158856,158856,158859,0,3,0
45327,5,2,158861,158861,158863,0,2,2
45328,4,2,158865,158865,158867,0,2,2
45329,3,2,158868,158868,158870,0,2,1
45330,2,1,158870,158870,158871,0,1,0
45331,2,1,158872,158872,158873,0,1,1
45332,6,2,158878,158878,158880,0,2,5
45333,1,3,158879,158880,158883,1,4,0
45334,3,1,158882,158883,158884,1,2,0
45335,1,1,158883,158884,158885,1,2,0
45336,3,2,158886,158886,158888,0,2,1
45337,4,3,158890,158890,158893,0,3,2
45338,2,2,158892,158893,158895,1,3,0
45339,3,1,158895,158895,158896,0,1,0
45340,6,1,158901,158901,158902,0,1,5
45341,4,3,158905,158905,158908,0,3,3
45342,1,2,158906,158908,158910,2,4,0
45343,4,3,158910,158910,158913,0,3,0
45344,6,2,158916,158916,158918,0,2,3
45345,2,2,158918,158918,158920,0,2,0
45346,4,3,158922,158922,158925,0,3,2
45347,3,3,158925,158925,158928,0,3,0
45348,5,3,158930,158930,158933,0,3,2
45349,1,2,158931,158933,158935,2,4,0
45350,3,1,158934,158935,158936,1,2,0
45351,6,3,158940,158940,158943,0,3,4
45352,5,1,158945,158945,158946,0,1,2
45353,2,3,158947,158947,158950,0,3,1
45354,3,3,158950,158950,158953,0,3,0
45355,6,3,158956,158956,158959,0,3,3
45356,2,1,158958,158959,158960,1,2,0
45357,6,2,158964,158964,158966,0,2,4
45358,3,2,158967,158967,158969,0,2,1
45359,1,1,158968,158969,158970,1,2,0
45360,3,3,158971,158971,158974,0,3,1
45361,6,2,158977,158977,158979,0,2,3
45362,2,2,158979,158979,158981,0,2,0
45363,3,2,158982,158982,158984,0,2,1
45364,6,1,158988,158988,158989,0,1,4
45365,3,3,158991,158991,158994,0,3,2
45366,4,2,158995,158995,158997,0,2,1
45367,5,2,159000,159000,159002,0,2,3
45368,4,1,159004,159004,159005,0,1,2
45369,1,3,159005,159005,159008,0,3,0
45370,2,1,159007,159008,159009,1,2,0
45371,4,1,159011,159011,159012,0,1,2
45372,5,3,159016,159016,159019,0,3,4
45373,6,1,159022,159022,159023,0,1,3
45374,1,1,159023,159023,159024,0,1,0
45375,2,2,159025,159025,159027,0,2,1
45376,2,2,159027,159027,159029,0,2,0
45377,6,3,159033,159033,159036,0,3,4
45378,4,2,159037,159037,159039,0,2,1
45379,4,2,159041,159041,159043,0,2,2
45380,2,2,159043,159043,159045,0,2,0
45381,3,3,159046,159046,159049,0,3,1
45382,2,3,159048,159049,159052,1,4,0
45383,4,3,159052,159052,159055,0,3,0
45384,6,3,159058,159058,159061,0,3,3
45385,4,1,159062,159062,159063,0,1,1
45386,5,2,159067,159067,159069,0,2,4
45387,1,2,159068,159069,159071,1,3,0
45388,3,3,159071,159071,159074,0,3,0
45389,6,1,159077,159077,159078,0,1,3
45390,6,1,159083,159083,159084,0,1,5
45391,2,3,159085,159085,159088,0,3,1
45392,4,2,159089,159089,159091,0,2,1
45393,1,3,159090,159091,159094,1,4,0
45394,3,1,159093,159094,159095,1,2,0
45395,5,3,159098,159098,159101,0,3,3
45396,5,2,159103,159103,159105,0,2,2
45397,5,1,159108,159108,159109,0,1,3
45398,1,1,159109,159109,159110,0,1,0
45399,6,1,159115,159115,159116,0,1,5
45400,3,1,159118,159118,159119,0,1,2
45401,6,1,159124,159124,159125,0,1,5
45402,5,1,159129,159129,159130,0,1,4
45403,2,2,159131,159131,159133,0,2,1
45404,2,2,159133,159133,159135,0,2,0
45405,4,3,159137,159137,159140,0,3,2
45406,2,3,159139,159140,159143,1,4,0
45407,3,3,159142,159143,159146,1,4,0
45408,6,1,159148,159148,159149,0,1,2
45409,3,3,159151,159151,159154,0,3,2
45410,3,3,159154,159154,159157,0,3,0
45411,5,1,159159,159159,159160,0,1,2
45412,4,1,159163,159163,159164,0,1,3
45413,5,1,159168,159168,159169,0,1,4
45414,3,2,159171,159171,159173,0,2,2
45415,1,3,159172,159173,159176,1,4,0
45416,6,1,159178,159178,159179,0,1,2
45417,4,3,159182,159182,159185,0,3,3
45418,6,1,159188,159188,159189,0,1,3
45419,6,3,159194,159194,159197,0,3,5
45420,3,2,159197,159197,159199,0,2,0
45421,4,3,159201,159201,159204,0,3,2
45422,3,1,159204,159204,159205,0,1,0
45423,2,1,159206,159206,159207,0,1,1
45424,4,3,159210,159210,159213,0,3,3
45425,4,1,159214,159214,159215,0,1,1
45426,6,2,159220,159220,159222,0,2,5
45427,5,2,159225,159225,159227,0,2,3
45428,6,1,159231,159231,159232,0,1,4
45429,2,1,159233,159233,159234,0,1,1
45430,1,3,159234,159234,159237,0,3,0
45431,3,3,159237,159237,159240,0,3,0
45432,2,2,159239,159240,159242,1,3,0
45433,3,3,159242,159242,159245,0,3,0
45434,1,3,159243,159245,159248,2,5,0
45435,3,1,159246,159248,159249,2,3,0
45436,4,3,159250,159250,159253,0,3,1
45437,2,2,159252,159253,159255,1,3,0
45438,1,3,159253,159255,159258,2,5,0
45439,3,2,159256,159258,159260,2,4,0
45440,2,3,159258,159260,159263,2,5,0
45441,3,1,159261,159263,159264,2,3,0
45442,5,1,159266,159266,159267,0,1,2
45443,4,2,159270,159270,159272,0,2,3
45444,5,3,159275,159275,159278,0,3,3
45445,1,3,159276,159278,159281,2,5,0
45446,2,2,159278,159281,159283,3,5,0
45447,6,3,159284,159284,159287,0,3,1
45448,1,3,159285,159287,159290,2,5,0
45449,6,1,159291,159291,159292,0,1,1
45450,2,2,159293,159293,159295,0,2,1
45451,3,3,159296,159296,159299,0,3,1
45452,5,1,159301,159301,159302,0,1,2
45453,1,3,159302,159302,159305,0,3,0
45454,1,3,159303,159305,159308,2,5,0
45455,1,1,159304,159308,159309,4,5,0
45456,5,2,159309,159309,159311,0,2,0
45457,3,1,159312,159312,159313,0,1,1
45458,2,3,159314,159314,159317,0,3,1
45459,3,1,159317,159317,159318,0,1,0
45460,1,1,159318,159318,159319,0,1,0
45461,4,1,159322,159322,159323,0,1,3
45462,6,2,159328,159328,159330,0,2,5
45463,1,1,159329,159330,159331,1,2,0
45464,3,3,159332,159332,159335,0,3,1
45465,6,1,159338,159338,159339,0,1,3
45466,4,2,159342,159342,159344,0,2,3
45467,3,1,159345,159345,159346,0,1,1
45468,1,2,159346,159346,159348,0,2,0
45469,2,3,159348,159348,159351,0,3,0
45470,3,1,159351,159351,159352,0,1,0
45471,4,1,159355,159355,159356,0,1,3
45472,4,1,159359,159359,159360,0,1,3
45473,5,1,159364,159364,159365,0,1,4
45474,5,1,159369,159369,159370,0,1,4
45475,1,2,159370,159370,159372,0,2,0
45476,2,1,159372,159372,159373,0,1,0
45477,4,2,159376,159376,159378,0,2,3
45478,1,1,159377,159378,159379,1,2,0
45479,3,3,159380,159380,159383,0,3,1
45480,5,1,159385,159385,159386,0,1,2
45481,3,1,159388,159388,159389,0,1,2
45482,3,3,159391,159391,159394,0,3,2
45483,3,2,159394,159394,159396,0,2,0
45484,6,1,159400,159400,159401,0,1,4
45485,2,1,159402,159402,159403,0,1,1
45486,6,2,159408,159408,159410,0,2,5
45487,1,2,159409,159410,159412,1,3,0
45488,2,1,159411,159412,159413,1,2,0
45489,6,2,159417,159417,159419,0,2,4
45490,2,3,159419,159419,159422,0,3,0
45491,4,2,159423,159423,159425,0,2,1
45492,6,3,159429,159429,159432,0,3,4
45493,3,1,159432,159432,159433,0,1,0
45494,2,1,159434,159434,159435,0,1,1
45495,3,2,159437,159437,159439,0,2,2
45496,5,3,159442,159442,159445,0,3,3
45497,3,1,159445,159445,159446,0,1,0
45498,3,2,159448,159448,159450,0,2,2
45499,2,3,159450,159450,159453,0,3,0
45500,4,3,159454,159454,159457,0,3,1
45501,6,2,159460,159460,159462,0,2,3
45502,6,2,159466,159466,159468,0,2,4
45503,2,2,159468,159468,159470,0,2,0
45504,3,3,159471,159471,159474,0,3,1
45505,4,1,159475,159475,159476,0,1,1
45506,6,2,159481,159481,159483,0,2,5
45507,6,2,159487,159487,159489,0,2,4
45508,6,2,159493,159493,159495,0,2,4
45509,5,2,159498,159498,159500,0,2,3
45510,5,2,159503,159503,159505,0,2,3
45511,3,3,159506,159506,159509,0,3,1
45512,3,1,159509,159509,159510,0,1,0
45513,1,2,159510,159510,159512,0,2,0
45514,3,1,159513,159513,159514,0,1,1
45515,2,3,159515,159515,159518,0,3,1
45516,1,1,159516,159518,159519,2,3,0
45517,2,2,159518,159519,159521,1,3,0
45518,4,3,159522,159522,159525,0,3,1
45519,5,3,159527,159527,159530,0,3,2
45520,4,3,159531,159531,159534,0,3,1
45521,6,2,159537,159537,159539,0,2,3
45522,4,2,159541,159541,159543,0,2,2
45523,5,3,159546,159546,159549,0,3,3
45524,4,3,159550,159550,159553,0,3,1
45525,5,1,159555,159555,159556,0,1,2
45526,2,2,159557,159557,159559,0,2,1
45527,6,2,159563,159563,159565,0,2,4
45528,4,2,159567,159567,159569,0,2,2
45529,3,1,159570,159570,159571,0,1,1
45530,6,3,159576,159576,159579,0,3,5
45531,2,1,159578,159579,159580,1,2,0
45532,2,3,159580,159580,159583,0,3,0
45533,5,2,159585,159585,159587,0,2,2
45534,5,3,159590,159590,159593,0,3,3
45535,5,3,159595,159595,159598,0,3,2
45536,1,2,159596,159598,159600,2,4,0
45537,1,1,159597,159600,159601,3,4,0
45538,3,3,159600,159601,159604,1,4,0
45539,3,1,159603,159604,159605,1,2,0
45540,6,3,159609,159609,159612,0,3,4
45541,5,2,159614,159614,159616,0,2,2
45542,4,3,159618,159618,159621,0,3,2
45543,2,1,159620,159621,159622,1,2,0
45544,5,1,159625,159625,159626,0,1,3
45545,2,3,159627,159627,159630,0,3,1
45546,5,2,159632,159632,159634,0,2,2
45547,4,3,159636,159636,159639,0,3,2
45548,2,3,159638,159639,159642,1,4,0
45549,2,2,159640,159642,159644,2,4,0
45550,3,2,159643,159644,159646,1,3,0
45551,6,1,159649,159649,159650,0,1,3
45552,1,2,159650,159650,159652,0,2,0
45553,3,2,159653,159653,159655,0,2,1
45554,6,3,159659,159659,159662,0,3,4
45555,2,1,159661,159662,159663,1,2,0
45556,1,1,159662,159663,159664,1,2,0
45557,5,3,159667,159667,159670,0,3,3
45558,2,1,159669,159670,159671,1,2,0
45559,3,2,159672,159672,159674,0,2,1
45560,4,1,159676,159676,159677,0,1,2
45561,6,2,159682,159682,159684,0,2,5
45562,1,3,159683,159684,159687,1,4,0
45563,6,1,159689,159689,159690,0,1,2
45564,4,1,159693,159693,159694,0,1,3
45565,2,1,159695,159695,159696,0,1,1
45566,1,2,159696,159696,159698,0,2,0
45567,1,2,159697,159698,159700,1,3,0
45568,2,3,159699,159700,159703,1,4,0
45569,3,1,159702,159703,159704,1,2,0
45570,6,1,159708,159708,159709,0,1,4
45571,5,3,159713,159713,159716,0,3,4
45572,5,3,159718,159718,159721,0,3,2
45573,2,3,159720,159721,159724,1,4,0
45574,1,3,159721,159724,159727,3,6,0
45575,3,1,159724,159727,159728,3,4,0
45576,4,3,159728,159728,159731,0,3,0
45577,4,2,159732,159732,159734,0,2,1
45578,4,2,159736,159736,159738,0,2,2
45579,3,3,159739,159739,159742,0,3,1
45580,4,1,159743,159743,159744,0,1,1
45581,4,3,159747,159747,159750,0,3,3
45582,3,1,159750,159750,159751,0,1,0
45583,4,1,159754,159754,159755,0,1,3
45584,2,2,159756,159756,159758,0,2,1
45585,3,1,159759,159759,159760,0,1,1
45586,6,3,159765,159765,159768,0,3,5
45587,1,3,159766,159768,159771,2,5,0
45588,3,2,159769,159771,159773,2,4,0
45589,6,1,159775,159775,159776,0,1,2
45590,5,2,159780,159780,159782,0,2,4
45591,1,2,159781,159782,159784,1,3,0
45592,4,1,159785,159785,159786,0,1,1
45593,6,1,159791,159791,159792,0,1,5
45594,2,3,159793,159793,159796,0,3,1
45595,6,3,159799,159799,159802,0,3,3
45596,2,2,159801,159802,159804,1,3,0
45597,1,1,159802,159804,159805,2,3,0
45598,6,1,159808,159808,159809,0,1,3
45599,1,1,159809,159809,159810,0,1,0
45600,3,3,159812,159812,159815,0,3,2
45601,3,1,159815,159815,159816,0,1,0
45602,4,2,159819,159819,159821,0,2,3
45603,6,1,159825,159825,159826,0,1,4
45604,2,3,159827,159827,159830,0,3,1
45605,3,2,159830,159830,159832,0,2,0
45606,2,3,159832,159832,159835,0,3,0
45607,3,2,159835,159835,159837,0,2,0
45608,1,2,159836,159837,159839,1,3,0
45609,6,2,159842,159842,159844,0,2,3
45610,3,2,159845,159845,159847,0,2,1
45611,5,2,159850,159850,159852,0,2,3
45612,4,3,159854,159854,159857,0,3,2
45613,3,2,159857,159857,159859,0,2,0
45614,4,2,159861,159861,159863,0,2,2
45615,4,3,159865,159865,159868,0,3,2
45616,1,1,159866,159868,159869,2,3,0
45617,3,3,159869,159869,159872,0,3,0
45618,2,3,159871,159872,159875,1,4,0
45619,6,2,159877,159877,159879,0,2,2
45620,5,2,159882,159882,159884,0,2,3
45621,5,1,159887,159887,159888,0,1,3
45622,5,2,159892,159892,159894,0,2,4
45623,6,1,159898,159898,159899,0,1,4
45624,3,2,159901,159901,159903,0,2,2
45625,2,1,159903,159903,159904,0,1,0
45626,5,1,159908,159908,159909,0,1,4
45627,4,1,159912,159912,159913,0,1,3
45628,2,3,159914,159914,159917,0,3,1
45629,2,2,159916,159917,159919,1,3,0
45630,1,2,159917,159919,159921,2,4,0
45631,4,3,159921,159921,159924,0,3,0
45632,6,3,159927,159927,159930,0,3,3
45633,5,3,159932,159932,159935,0,3,2
45634,2,3,159934,159935,159938,1,4,0
45635,3,1,159937,159938,159939,1,2,0
45636,3,1,159940,159940,159941,0,1,1
45637,3,2,159943,159943,159945,0,2,2
45638,4,1,159947,159947,159948,0,1,2
45639,5,1,159952,159952,159953,0,1,4
45640,3,1,159955,159955,159956,0,1,2
45641,5,3,159960,159960,159963,0,3,4
45642,6,1,159966,159966,159967,0,1,3
45643,1,2,159967,159967,159969,0,2,0
45644,1,1,159968,159969,159970,1,2,0
45645,2,1,159970,159970,159971,0,1,0
45646,2,3,159972,159972,159975,0,3,1
45647,4,1,159976,159976,159977,0,1,1
45648,5,3,159981,159981,159984,0,3,4
45649,6,2,159987,159987,159989,0,2,3
45650,2,2,159989,159989,159991,0,2,0
45651,2,3,159991,159991,159994,0,3,0
45652,4,3,159995,159995,159998,0,3,1
45653,4,2,159999,159999,160001,0,2,1
45654,6,2,160005,160005,160007,0,2,4
45655,3,3,160008,160008,160011,0,3,1
45656,3,3,160011,160011,160014,0,3,0
45657,1,2,160012,160014,160016,2,4,0
45658,2,1,160014,160016,160017,2,3,0
45659,3,1,160017,160017,160018,0,1,0
45660,3,2,160020,160020,160022,0,2,2
45661,5,3,160025,160025,160028,0,3,3
45662,5,2,160030,160030,160032,0,2,2
45663,5,1,160035,160035,160036,0,1,3
45664,1,1,160036,160036,160037,0,1,0
45665,3,1,160039,160039,160040,0,1,2
45666,4,2,160043,160043,160045,0,2,3
45667,1,1,160044,160045,160046,1,2,0
45668,5,1,160049,160049,160050,0,1,3
45669,2,1,160051,160051,160052,0,1,1
45670,3,1,160054,160054,160055,0,1,2
45671,5,1,160059,160059,160060,0,1,4
45672,6,1,160065,160065,160066,0,1,5
45673,1,1,160066,160066,160067,0,1,0
45674,3,3,160069,160069,160072,0,3,2
45675,5,1,160074,160074,160075,0,1,2
45676,5,3,160079,160079,160082,0,3,4
45677,2,2,160081,160082,160084,1,3,0
45678,3,1,160084,160084,160085,0,1,0
45679,6,3,160090,160090,160093,0,3,5
45680,2,1,160092,160093,160094,1,2,0
45681,4,2,160096,160096,160098,0,2,2
45682,4,2,160100,160100,160102,0,2,2
45683,5,1,160105,160105,160106,0,1,3
45684,2,3,160107,160107,160110,0,3,1
45685,6,2,160113,160113,160115,0,2,3
45686,5,3,160118,160118,160121,0,3,3
45687,1,2,160119,160121,160123,2,4,0
45688,5,1,160124,160124,160125,0,1,1
45689,4,1,160128,160128,160129,0,1,3
45690,6,2,160134,160134,160136,0,2,5
45691,4,2,160138,160138,160140,0,2,2
45692,4,2,160142,160142,160144,0,2,2
45693,6,3,160148,160148,160151,0,3,4
45694,4,1,160152,160152,160153,0,1,1
45695,5,3,160157,160157,160160,0,3,4
45696,1,1,160158,160160,160161,2,3,0
45697,3,2,160161,160161,160163,0,2,0
45698,3,3,160164,160164,160167,0,3,1
45699,6,3,160170,160170,160173,0,3,3
45700,6,2,160176,160176,160178,0,2,3
45701,4,2,160180,160180,160182,0,2,2
45702,4,3,160184,160184,160187,0,3,2
45703,1,3,160185,160187,160190,2,5,0
45704,5,1,160190,160190,160191,0,1,0
45705,6,1,160196,160196,160197,0,1,5
45706,1,1,160197,160197,160198,0,1,0
45707,3,2,160200,160200,160202,0,2,2
45708,2,3,160202,160202,160205,0,3,0
45709,1,3,160203,160205,160208,2,5,0
45710,2,2,160205,160208,160210,3,5,0
45711,1,2,160206,160210,160212,4,6,0
45712,2,2,160208,160212,160214,4,6,0
45713,4,1,160212,160214,160215,2,3,0
45714,3,1,160215,160215,160216,0,1,0
45715,4,2,160219,160219,160221,0,2,3
45716,1,2,160220,160221,160223,1,3,0
45717,6,2,160226,160226,160228,0,2,3
45718,6,1,160232,160232,160233,0,1,4
45719,6,1,160238,160238,160239,0,1,5
45720,1,3,160239,160239,160242,0,3,0
45721,5,1,160244,160244,160245,0,1,2
45722,5,3,160249,160249,160252,0,3,4
45723,2,1,160251,160252,160253,1,2,0
45724,2,1,160253,160253,160254,0,1,0
45725,6,1,160259,160259,160260,0,1,5
45726,1,3,160260,160260,160263,0,3,0
45727,1,3,160261,160263,160266,2,5,0
45728,6,2,160267,160267,160269,0,2,1
45729,5,2,160272,160272,160274,0,2,3
45730,2,3,160274,160274,160277,0,3,0
45731,5,2,160279,160279,160281,0,2,2
45732,6,2,160285,160285,160287,0,2,4
45733,6,2,160291,160291,160293,0,2,4
45734,6,3,160297,160297,160300,0,3,4
45735,4,3,160301,160301,160304,0,3,1
45736,6,2,160307,160307,160309,0,2,3
45737,2,3,160309,160309,160312,0,3,0
45738,1,2,160310,160312,160314,2,4,0
45739,5,3,160315,160315,160318,0,3,1
45740,2,2,160317,160318,160320,1,3,0
45741,3,1,160320,160320,160321,0,1,0
45742,6,1,160326,160326,160327,0,1,5
45743,2,2,160328,160328,160330,0,2,1
45744,3,3,160331,160331,160334,0,3,1
45745,1,2,160332,160334,160336,2,4,0
45746,2,2,160334,160336,160338,2,4,0
45747,6,1,160340,160340,160341,0,1,2
45748,6,2,160346,160346,160348,0,2,5
45749,5,2,160351,160351,160353,0,2,3
45750,6,1,160357,160357,160358,0,1,4
45751,1,3,160358,160358,160361,0,3,0
45752,4,1,160362,160362,160363,0,1,1
45753,2,3,160364,160364,160367,0,3,1
45754,2,1,160366,160367,160368,1,2,0
45755,5,1,160371,160371,160372,0,1,3
45756,1,1,160372,160372,160373,0,1,0
45757,6,1,160378,160378,160379,0,1,5
45758,1,1,160379,160379,160380,0,1,0
45759,1,3,160380,160380,160383,0,3,0
45760,3,1,160383,160383,160384,0,1,0
45761,3,3,160386,160386,160389,0,3,2
45762,3,3,160389,160389,160392,0,3,0
45763,5,2,160394,160394,160396,0,2,2
45764,2,3,160396,160396,160399,0,3,0
45765,4,2,160400,160400,160402,0,2,1
45766,2,3,160402,160402,160405,0,3,0
45767,5,2,160407,160407,160409,0,2,2
45768,4,1,160411,160411,160412,0,1,2
45769,3,1,160414,160414,160415,0,1,2
45770,5,2,160419,160419,160421,0,2,4
45771,2,2,160421,160421,160423,0,2,0
45772,5,3,160426,160426,160429,0,3,3
45773,2,1,160428,160429,160430,1,2,0
45774,3,1,160431,160431,160432,0,1,1
45775,6,1,160437,160437,160438,0,1,5
45776,1,3,160438,160438,160441,0,3,0
45777,3,2,160441,160441,160443,0,2,0
45778,4,3,160445,160445,160448,0,3,2
45779,6,3,160451,160451,160454,0,3,3
45780,1,2,160452,160454,160456,2,4,0
45781,1,1,160453,160456,160457,3,4,0
45782,6,3,160459,160459,160462,0,3,2
45783,3,1,160462,160462,160463,0,1,0
45784,6,3,160468,160468,160471,0,3,5
45785,2,1,160470,160471,160472,1,2,0
45786,5,2,160475,160475,160477,0,2,3
45787,6,2,160481,160481,160483,0,2,4
45788,6,1,160487,160487,160488,0,1,4
45789,6,1,160493,160493,160494,0,1,5
45790,2,2,160495,160495,160497,0,2,1
45791,4,3,160499,160499,160502,0,3,2
45792,3,2,160502,160502,160504,0,2,0
45793,6,3,160508,160508,160511,0,3,4
45794,6,3,160514,160514,160517,0,3,3
45795,2,3,160516,160517,160520,1,4,0
45796,5,3,160521,160521,160524,0,3,1
45797,4,2,160525,160525,160527,0,2,1
45798,6,3,160531,160531,160534,0,3,4
45799,5,2,160536,160536,160538,0,2,2
45800,6,1,160542,160542,160543,0,1,4
45801,1,1,160543,160543,160544,0,1,0
45802,1,3,160544,160544,160547,0,3,0
45803,5,2,160549,160549,160551,0,2,2
45804,1,2,160550,160551,160553,1,3,0
45805,2,3,160552,160553,160556,1,4,0
45806,1,3,160553,160556,160559,3,6,0
45807,1,1,160554,160559,160560,5,6,0
45808,2,3,160556,160560,160563,4,7,0
45809,6,1,160562,160563,160564,1,2,0
45810,4,3,160566,160566,160569,0,3,2
45811,2,1,160568,160569,160570,1,2,0
45812,4,1,160572,160572,160573,0,1,2
45813,3,1,160575,160575,160576,0,1,2
45814,2,1,160577,160577,160578,0,1,1
45815,3,3,160580,160580,160583,0,3,2
45816,1,2,160581,160583,160585,2,4,0
45817,3,3,160584,160585,160588,1,4,0
45818,1,3,160585,160588,160591,3,6,0
45819,2,1,160587,160591,160592,4,5,0
45820,2,1,160589,160592,160593,3,4,0
45821,6,1,160595,160595,160596,0,1,2
45822,3,2,160598,160598,160600,0,2,2
45823,1,2,160599,160600,160602,1,3,0
45824,6,2,160605,160605,160607,0,2,3
45825,1,3,160606,160607,160610,1,4,0
45826,6,1,160612,160612,160613,0,1,2
45827,6,2,160618,160618,160620,0,2,5
45828,5,1,160623,160623,160624,0,1,3
45829,1,1,160624,160624,160625,0,1,0
45830,2,2,160626,160626,160628,0,2,1
45831,2,2,160628,160628,160630,0,2,0
45832,6,2,160634,160634,160636,0,2,4
45833,4,3,160638,160638,160641,0,3,2
45834,4,1,160642,160642,160643,0,1,1
45835,6,2,160648,160648,160650,0,2,5
45836,4,1,160652,160652,160653,0,1,2
45837,2,2,160654,160654,160656,0,2,1
45838,1,2,160655,160656,160658,1,3,0
45839,5,2,160660,160660,160662,0,2,2
45840,2,3,160662,160662,160665,0,3,0
45841,4,2,160666,160666,160668,0,2,1
45842,3,2,160669,160669,160671,0,2,1
45843,3,3,160672,160672,160675,0,3,1
45844,5,1,160677,160677,160678,0,1,2
45845,1,2,160678,160678,160680,0,2,0
45846,3,1,160681,160681,160682,0,1,1
45847,1,1,160682,160682,160683,0,1,0
45848,5,2,160687,160687,160689,0,2,4
45849,3,3,160690,160690,160693,0,3,1
45850,3,2,160693,160693,160695,0,2,0
45851,1,1,160694,160695,160696,1,2,0
45852,6,2,160700,160700,160702,0,2,4
45853,1,1,160701,160702,160703,1,2,0
45854,3,2,160704,160704,160706,0,2,1
45855,4,3,160708,160708,160711,0,3,2
45856,4,1,160712,160712,160713,0,1,1
45857,4,3,160716,160716,160719,0,3,3
45858,6,3,160722,160722,160725,0,3,3
45859,3,1,160725,160725,160726,0,1,0
45860,3,3,160728,160728,160731,0,3,2
45861,3,1,160731,160731,160732,0,1,0
45862,2,2,160733,160733,160735,0,2,1
45863,5,1,160738,160738,160739,0,1,3
45864,2,1,160740,160740,160741,0,1,1
45865,3,2,160743,160743,160745,0,2,2
45866,4,2,160747,160747,160749,0,2,2
45867,1,1,160748,160749,160750,1,2,0
45868,6,3,160754,160754,160757,0,3,4
45869,5,3,160759,160759,160762,0,3,2
45870,1,3,160760,160762,160765,2,5,0
45871,6,1,160766,160766,160767,0,1,1
45872,1,3,160767,160767,160770,0,3,0
45873,5,1,160772,160772,160773,0,1,2
45874,3,2,160775,160775,160777,0,2,2
45875,2,3,160777,160777,160780,0,3,0
45876,6,1,160783,160783,160784,0,1,3
45877,1,2,160784,160784,160786,0,2,0
45878,6,3,160790,160790,160793,0,3,4
45879,5,2,160795,160795,160797,0,2,2
45880,4,2,160799,160799,160801,0,2,2
45881,2,2,160801,160801,160803,0,2,0
45882,2,1,160803,160803,160804,0,1,0
45883,3,2,160806,160806,160808,0,2,2
45884,4,2,160810,160810,160812,0,2,2
45885,3,3,160813,160813,160816,0,3,1
45886,2,2,160815,160816,160818,1,3,0
45887,1,3,160816,160818,160821,2,5,0
45888,6,2,160822,160822,160824,0,2,1
45889,5,2,160827,160827,160829,0,2,3
45890,3,3,160830,160830,160833,0,3,1
45891,3,1,160833,160833,160834,0,1,0
45892,4,2,160837,160837,160839,0,2,3
45893,3,2,160840,160840,160842,0,2,1
45894,6,1,160846,160846,160847,0,1,4
45895,5,1,160851,160851,160852,0,1,4
45896,3,3,160854,160854,160857,0,3,2
45897,3,2,160857,160857,160859,0,2,0
45898,3,3,160860,160860,160863,0,3,1
45899,5,1,160865,160865,160866,0,1,2
45900,6,3,160871,160871,160874,0,3,5
45901,6,1,160877,160877,160878,0,1,3
45902,3,2,160880,160880,160882,0,2,2
45903,4,3,160884,160884,160887,0,3,2
45904,6,1,160890,160890,160891,0,1,3
45905,4,3,160894,160894,160897,0,3,3
45906,4,1,160898,160898,160899,0,1,1
45907,2,1,160900,160900,160901,0,1,1
45908,5,1,160905,160905,160906,0,1,4
45909,2,2,160907,160907,160909,0,2,1
45910,1,1,160908,160909,160910,1,2,0
45911,1,3,160909,160910,160913,1,4,0
45912,6,2,160915,160915,160917,0,2,2
45913,1,3,160916,160917,160920,1,4,0
45914,6,2,160922,160922,160924,0,2,2
45915,5,2,160927,160927,160929,0,2,3
45916,6,2,160933,160933,160935,0,2,4
45917,4,1,160937,160937,160938,0,1,2
45918,2,3,160939,160939,160942,0,3,1
45919,5,1,160944,160944,160945,0,1,2
45920,4,3,160948,160948,160951,0,3,3
45921,5,3,160953,160953,160956,0,3,2
45922,6,2,160959,160959,160961,0,2,3
45923,5,2,160964,160964,160966,0,2,3
45924,1,3,160965,160966,160969,1,4,0
45925,4,2,160969,160969,160971,0,2,0
45926,3,3,160972,160972,160975,0,3,1
45927,2,1,160974,160975,160976,1,2,0
45928,2,3,160976,160976,160979,0,3,0
45929,2,3,160978,160979,160982,1,4,0
45930,5,3,160983,160983,160986,0,3,1
45931,2,2,160985,160986,160988,1,3,0
45932,3,2,160988,160988,160990,0,2,0
45933,5,3,160993,160993,160996,0,3,3
45934,4,3,160997,160997,161000,0,3,1
45935,6,3,161003,161003,161006,0,3,3
45936,4,1,161007,161007,161008,0,1,1
45937,5,3,161012,161012,161015,0,3,4
45938,4,2,161016,161016,161018,0,2,1
45939,3,3,161019,161019,161022,0,3,1
45940,5,2,161024,161024,161026,0,2,2
45941,1,1,161025,161026,161027,1,2,0
45942,5,1,161030,161030,161031,0,1,3
45943,6,1,161036,161036,161037,0,1,5
45944,2,2,161038,161038,161040,0,2,1
45945,5,1,161043,161043,161044,0,1,3
45946,6,3,161049,161049,161052,0,3,5
45947,4,3,161053,161053,161056,0,3,1
45948,2,2,161055,161056,161058,1,3,0
45949,2,3,161057,161058,161061,1,4,0
45950,4,1,161061,161061,161062,0,1,0
45951,4,2,161065,161065,161067,0,2,3
45952,3,1,161068,161068,161069,0,1,1
45953,3,1,161071,161071,161072,0,1,2
45954,5,1,161076,161076,161077,0,1,4
45955,2,2,161078,161078,161080,0,2,1
45956,5,2,161083,161083,161085,0,2,3
45957,2,3,161085,161085,161088,0,3,0
45958,4,1,161089,161089,161090,0,1,1
45959,1,2,161090,161090,161092,0,2,0
45960,1,2,161091,161092,161094,1,3,0
45961,6,3,161097,161097,161100,0,3,3
45962,6,1,161103,161103,161104,0,1,3
45963,2,1,161105,161105,161106,0,1,1
45964,3,1,161108,161108,161109,0,1,2
45965,4,2,161112,161112,161114,0,2,3
45966,2,2,161114,161114,161116,0,2,0
45967,6,2,161120,161120,161122,0,2,4
45968,3,1,161123,161123,161124,0,1,1
45969,6,1,161129,161129,161130,0,1,5
45970,1,3,161130,161130,161133,0,3,0
45971,6,2,161136,161136,161138,0,2,3
45972,1,1,161137,161138,161139,1,2,0
45973,5,2,161142,161142,161144,0,2,3
45974,3,3,161145,161145,161148,0,3,1
45975,4,3,161149,161149,161152,0,3,1
45976,5,2,161154,161154,161156,0,2,2
45977,6,2,161160,161160,161162,0,2,4
45978,6,3,161166,161166,161169,0,3,4
45979,3,2,161169,161169,161171,0,2,0
45980,4,3,161173,161173,161176,0,3,2
45981,1,3,161174,161176,161179,2,5,0
45982,6,1,161180,161180,161181,0,1,1
45983,4,3,161184,161184,161187,0,3,3
45984,1,2,161185,161187,161189,2,4,0
45985,4,2,161189,161189,161191,0,2,0
45986,1,2,161190,161191,161193,1,3,0
45987,2,3,161192,161193,161196,1,4,0
45988,4,3,161196,161196,161199,0,3,0
45989,1,1,161197,161199,161200,2,3,0
45990,4,2,161201,161201,161203,0,2,1
45991,2,2,161203,161203,161205,0,2,0
45992,2,3,161205,161205,161208,0,3,0
45993,4,1,161209,161209,161210,0,1,1
45994,1,3,161210,161210,161213,0,3,0
45995,3,3,161213,161213,161216,0,3,0
45996,3,3,161216,161216,161219,0,3,0
45997,4,2,161220,161220,161222,0,2,1
45998,6,1,161226,161226,161227,0,1,4
45999,2,3,161228,161228,161231,0,3,1
46000,6,3,161234,161234,161237,0,3,3
46001,6,3,161240,161240,161243,0,3,3
46002,6,2,161246,161246,161248,0,2,3
46003,3,2,161249,161249,161251,0,2,1
46004,4,1,161253,161253,161254,0,1,2
46005,5,1,161258,161258,161259,0,1,4
46006,3,1,161261,161261,161262,0,1,2
46007,6,3,161267,161267,161270,0,3,5
46008,5,3,161272,161272,161275,0,3,2
46009,2,2,161274,161275,161277,1,3,0
46010,2,1,161276,161277,161278,1,2,0
46011,2,3,161278,161278,161281,0,3,0
46012,3,2,161281,161281,161283,0,2,0
46013,2,2,161283,161283,161285,0,2,0
46014,2,1,161285,161285,161286,0,1,0
46015,1,3,161286,161286,161289,0,3,0
46016,3,2,161289,161289,161291,0,2,0
46017,6,3,161295,161295,161298,0,3,4
46018,1,1,161296,161298,161299,2,3,0
46019,6,2,161302,161302,161304,0,2,3
46020,6,2,161308,161308,161310,0,2,4
46021,1,2,161309,161310,161312,1,3,0
46022,3,3,161312,161312,161315,0,3,0
46023,6,2,161318,161318,161320,0,2,3
46024,4,3,161322,161322,161325,0,3,2
46025,5,1,161327,161327,161328,0,1,2
46026,6,1,161333,161333,161334,0,1,5
46027,3,3,161336,161336,161339,0,3,2
46028,4,2,161340,161340,161342,0,2,1
46029,6,3,161346,161346,161349,0,3,4
46030,1,2,161347,161349,161351,2,4,0
46031,3,1,161350,161351,161352,1,2,0
46032,4,2,161354,161354,161356,0,2,2
46033,4,3,161358,161358,161361,0,3,2
46034,1,1,161359,161361,161362,2,3,0
46035,6,1,161365,161365,161366,0,1,3
46036,4,1,161369,161369,161370,0,1,3
46037,4,2,161373,161373,161375,0,2,3
46038,4,2,161377,161377,161379,0,2,2
46039,4,2,161381,161381,161383,0,2,2
46040,5,1,161386,161386,161387,0,1,3
46041,4,1,161390,161390,161391,0,1,3
46042,2,1,161392,161392,161393,0,1,1
46043,4,3,161396,161396,161399,0,3,3
46044,3,2,161399,161399,161401,0,2,0
46045,5,2,161404,161404,161406,0,2,3
46046,5,2,161409,161409,161411,0,2,3
46047,5,2,161414,161414,161416,0,2,3
46048,4,2,161418,161418,161420,0,2,2
46049,3,1,161421,161421,161422,0,1,1
46050,6,2,161427,161427,161429,0,2,5
46051,3,2,161430,161430,161432,0,2,1
46052,6,1,161436,161436,161437,0,1,4
46053,5,1,161441,161441,161442,0,1,4
46054,4,2,161445,161445,161447,0,2,3
46055,1,3,161446,161447,161450,1,4,0
46056,5,2,161451,161451,161453,0,2,1
46057,3,2,161454,161454,161456,0,2,1
46058,6,2,161460,161460,161462,0,2,4
46059,6,1,161466,161466,161467,0,1,4
46060,3,3,161469,161469,161472,0,3,2
46061,1,1,161470,161472,161473,2,3,0
46062,6,1,161476,161476,161477,0,1,3
46063,5,3,161481,161481,161484,0,3,4
46064,6,2,161487,161487,161489,0,2,3
46065,6,3,161493,161493,161496,0,3,4
46066,1,2,161494,161496,161498,2,4,0
46067,3,1,161497,161498,161499,1,2,0
46068,6,3,161503,161503,161506,0,3,4
46069,5,2,161508,161508,161510,0,2,2
46070,3,1,161511,161511,161512,0,1,1
46071,6,3,161517,161517,161520,0,3,5
46072,1,2,161518,161520,161522,2,4,0
46073,3,1,161521,161522,161523,1,2,0
46074,5,3,161526,161526,161529,0,3,3
46075,3,1,161529,161529,161530,0,1,0
46076,4,2,161533,161533,161535,0,2,3
46077,5,3,161538,161538,161541,0,3,3
46078,6,2,161544,161544,161546,0,2,3
46079,6,1,161550,161550,161551,0,1,4
46080,5,2,161555,161555,161557,0,2,4
46081,3,2,161558,161558,161560,0,2,1
46082,3,2,161561,161561,161563,0,2,1
46083,5,2,161566,161566,161568,0,2,3
46084,2,1,161568,161568,161569,0,1,0
46085,1,3,161569,161569,161572,0,3,0
46086,1,3,161570,161572,161575,2,5,0
46087,4,1,161574,161575,161576,1,2,0
46088,3,2,161577,161577,161579,0,2,1
46089,4,1,161581,161581,161582,0,1,2
46090,5,2,161586,161586,161588,0,2,4
46091,1,1,161587,161588,161589,1,2,0
46092,2,1,161589,161589,161590,0,1,0
46093,2,3,161591,161591,161594,0,3,1
46094,1,3,161592,161594,161597,2,5,0
46095,4,3,161596,161597,161600,1,4,0
46096,5,3,161601,161601,161604,0,3,1
46097,4,1,161605,161605,161606,0,1,1
46098,6,3,161611,161611,161614,0,3,5
46099,4,3,161615,161615,161618,0,3,1
46100,3,2,161618,161618,161620,0,2,0
46101,6,2,161624,161624,161626,0,2,4
46102,2,3,161626,161626,161629,0,3,0
46103,5,2,161631,161631,161633,0,2,2
46104,1,2,161632,161633,161635,1,3,0
46105,6,2,161638,161638,161640,0,2,3
46106,6,1,161644,161644,161645,0,1,4
46107,4,1,161648,161648,161649,0,1,3
46108,3,2,161651,161651,161653,0,2,2
46109,4,1,161655,161655,161656,0,1,2
46110,5,2,161660,161660,161662,0,2,4
46111,6,2,161666,161666,161668,0,2,4
46112,4,2,161670,161670,161672,0,2,2
46113,6,2,161676,161676,161678,0,2,4
46114,3,2,161679,161679,161681,0,2,1
46115,4,1,161683,161683,161684,0,1,2
46116,5,3,161688,161688,161691,0,3,4
46117,1,3,161689,161691,161694,2,5,0
46118,2,1,161691,161694,161695,3,4,0
46119,5,2,161696,161696,161698,0,2,1
46120,6,3,161702,161702,161705,0,3,4
46121,2,1,161704,161705,161706,1,2,0
46122,5,3,161709,161709,161712,0,3,3
46123,3,2,161712,161712,161714,0,2,0
46124,2,2,161714,161714,161716,0,2,0
46125,5,2,161719,161719,161721,0,2,3
46126,6,1,161725,161725,161726,0,1,4
46127,3,1,161728,161728,161729,0,1,2
46128,3,1,161731,161731,161732,0,1,2
46129,5,3,161736,161736,161739,0,3,4
46130,5,1,161741,161741,161742,0,1,2
46131,1,1,161742,161742,161743,0,1,0
46132,4,3,161746,161746,161749,0,3,3
46133,3,3,161749,161749,161752,0,3,0
46134,6,3,161755,161755,161758,0,3,3
46135,2,1,161757,161758,161759,1,2,0
46136,5,3,161762,161762,161765,0,3,3
46137,4,1,161766,161766,161767,0,1,1
46138,3,1,161769,161769,161770,0,1,2
46139,1,3,161770,161770,161773,0,3,0
46140,1,2,161771,161773,161775,2,4,0
46141,5,3,161776,161776,161779,0,3,1
46142,3,1,161779,161779,161780,0,1,0
46143,1,3,161780,161780,161783,0,3,0
46144,1,1,161781,161783,161784,2,3,0
46145,3,2,161784,161784,161786,0,2,0
46146,3,3,161787,161787,161790,0,3,1
46147,1,2,161788,161790,161792,2,4,0
46148,6,3,161794,161794,161797,0,3,2
46149,5,3,161799,161799,161802,0,3,2
46150,1,3,161800,161802,161805,2,5,0
46151,3,1,161803,161805,161806,2,3,0
46152,1,2,161804,161806,161808,2,4,0
46153,1,3,161805,161808,161811,3,6,0
46154,3,1,161808,161811,161812,3,4,0
46155,1,3,161809,161812,161815,3,6,0
46156,1,3,161810,161815,161818,5,8,0
46157,1,2,161811,161818,161820,7,9,0
46158,1,1,161812,161820,161821,8,9,0
46159,1,3,161813,161821,161824,8,11,0
46160,4,3,161817,161824,161827,7,10,0
46161,2,2,161819,161827,161829,8,10,0
46162,3,2,161822,161829,161831,7,9,0
46163,6,1,161828,161831,161832,3,4,0
46164,1,1,161829,161832,161833,3,4,0
46165,1,2,161830,161833,161835,3,5,0
46166,2,2,161832,161835,161837,3,5,0
46167,2,3,161834,161837,161840,3,6,0
46168,4,2,161838,161840,161842,2,4,0
46169,2,2,161840,161842,161844,2,4,0
46170,4,3,161844,161844,161847,0,3,0
46171,3,1,161847,161847,161848,0,1,0
46172,6,1,161853,161853,161854,0,1,5
46173,4,3,161857,161857,161860,0,3,3
46174,4,2,161861,161861,161863,0,2,1
46175,2,3,161863,161863,161866,0,3,0
46176,3,3,161866,161866,161869,0,3,0
46177,5,3,161871,161871,161874,0,3,2
46178,2,1,161873,161874,161875,1,2,0
46179,4,1,161877,161877,161878,0,1,2
46180,4,2,161881,161881,161883,0,2,3
46181,2,1,161883,161883,161884,0,1,0
46182,3,2,161886,161886,161888,0,2,2
46183,6,1,161892,161892,161893,0,1,4
46184,4,2,161896,161896,161898,0,2,3
46185,3,2,161899,161899,161901,0,2,1
46186,5,3,161904,161904,161907,0,3,3
46187,2,3,161906,161907,161910,1,4,0
46188,4,2,161910,161910,161912,0,2,0
46189,5,3,161915,161915,161918,0,3,3
46190,5,3,161920,161920,161923,0,3,2
46191,4,1,161924,161924,161925,0,1,1
46192,2,2,161926,161926,161928,0,2,1
46193,3,3,161929,161929,161932,0,3,1
46194,1,2,161930,161932,161934,2,4,0
46195,6,3,161936,161936,161939,0,3,2
46196,1,3,161937,161939,161942,2,5,0
46197,1,3,161938,161942,161945,4,7,0
46198,4,1,161942,161945,161946,3,4,0
46199,1,3,161943,161946,161949,3,6,0
46200,1,3,161944,161949,161952,5,8,0
46201,2,3,161946,161952,161955,6,9,0
46202,5,3,161951,161955,161958,4,7,0
46203,5,3,161956,161958,161961,2,5,0
46204,2,3,161958,161961,161964,3,6,0
46205,1,3,161959,161964,161967,5,8,0
46206,1,3,161960,161967,161970,7,10,0
46207,3,2,161963,161970,161972,7,9,0
46208,6,1,161969,161972,161973,3,4,0
46209,4,2,161973,161973,161975,0,2,0
46210,4,2,161977,161977,161979,0,2,2
46211,3,3,161980,161980,161983,0,3,1
46212,2,3,161982,161983,161986,1,4,0
46213,1,3,161983,161986,161989,3,6,0
46214,2,1,161985,161989,161990,4,5,0
46215,3,3,161988,161990,161993,2,5,0
46216,2,3,161990,161993,161996,3,6,0
46217,3,2,161993,161996,161998,3,5,0
46218,4,2,161997,161998,162000,1,3,0
46219,2,3,161999,162000,162003,1,4,0
46220,6,1,162005,162005,162006,0,1,2
46221,5,3,162010,162010,162013,0,3,4
46222,6,2,162016,162016,162018,0,2,3
46223,6,1,162022,162022,162023,0,1,4
46224,4,3,162026,162026,162029,0,3,3
46225,4,2,162030,162030,162032,0,2,1
46226,3,3,162033,162033,162036,0,3,1
46227,3,1,162036,162036,162037,0,1,0
46228,2,3,162038,162038,162041,0,3,1
46229,3,1,162041,162041,162042,0,1,0
46230,6,1,162047,162047,162048,0,1,5
46231,6,1,162053,162053,162054,0,1,5
46232,3,1,162056,162056,162057,0,1,2
46233,6,1,162062,162062,162063,0,1,5
46234,3,3,162065,162065,162068,0,3,2
46235,4,3,162069,162069,162072,0,3,1
46236,5,3,162074,162074,162077,0,3,2
46237,2,2,162076,162077,162079,1,3,0
46238,3,1,162079,162079,162080,0,1,0
46239,2,2,162081,162081,162083,0,2,1
46240,5,3,162086,162086,162089,0,3,3
46241,1,3,162087,162089,162092,2,5,0
46242,3,2,162090,162092,162094,2,4,0
46243,2,3,162092,162094,162097,2,5,0
46244,2,2,162094,162097,162099,3,5,0
46245,3,3,162097,162099,162102,2,5,0
46246,1,2,162098,162102,162104,4,6,0
46247,5,2,162103,162104,162106,1,3,0
46248,4,1,162107,162107,162108,0,1,1
46249,2,2,162109,162109,162111,0,2,1
46250,1,3,162110,162111,162114,1,4,0
46251,6,3,162116,162116,162119,0,3,2
46252,6,3,162122,162122,162125,0,3,3
46253,5,3,162127,162127,162130,0,3,2
46254,1,3,162128,162130,162133,2,5,0
46255,5,1,162133,162133,162134,0,1,0
46256,1,2,162134,162134,162136,0,2,0
46257,2,3,162136,162136,162139,0,3,0
46258,2,1,162138,162139,162140,1,2,0
46259,2,1,162140,162140,162141,0,1,0
46260,3,3,162143,162143,162146,0,3,2
46261,6,1,162149,162149,162150,0,1,3
46262,4,3,162153,162153,162156,0,3,3
46263,6,2,162159,162159,162161,0,2,3
46264,3,1,162162,162162,162163,0,1,1
46265,3,3,162165,162165,162168,0,3,2
46266,5,1,162170,162170,162171,0,1,2
46267,4,2,162174,162174,162176,0,2,3
46268,6,2,162180,162180,162182,0,2,4
46269,4,2,162184,162184,162186,0,2,2
46270,2,2,162186,162186,162188,0,2,0
46271,6,1,162192,162192,162193,0,1,4
46272,4,1,162196,162196,162197,0,1,3
46273,5,1,162201,162201,162202,0,1,4
46274,2,2,162203,162203,162205,0,2,1
46275,2,1,162205,162205,162206,0,1,0
46276,3,2,162208,162208,162210,0,2,2
46277,4,2,162212,162212,162214,0,2,2
46278,5,3,162217,162217,162220,0,3,3
46279,4,1,162221,162221,162222,0,1,1
46280,4,3,162225,162225,162228,0,3,3
46281,2,1,162227,162228,162229,1,2,0
46282,6,2,162233,162233,162235,0,2,4
46283,6,2,162239,162239,162241,0,2,4
46284,3,1,162242,162242,162243,0,1,1
46285,3,3,162245,162245,162248,0,3,2
46286,5,2,162250,162250,162252,0,2,2
46287,5,2,162255,162255,162257,0,2,3
46288,3,3,162258,162258,162261,0,3,1
46289,2,1,162260,162261,162262,1,2,0
46290,3,1,162263,162263,162264,0,1,1
46291,4,3,162267,162267,162270,0,3,3
46292,5,3,162272,162272,162275,0,3,2
46293,1,1,162273,162275,162276,2,3,0
46294,1,1,162274,162276,162277,2,3,0
46295,5,2,162279,162279,162281,0,2,2
46296,3,3,162282,162282,162285,0,3,1
46297,4,2,162286,162286,162288,0,2,1
46298,2,1,162288,162288,162289,0,1,0
46299,5,1,162293,162293,162294,0,1,4
46300,4,1,162297,162297,162298,0,1,3
46301,4,3,162301,162301,162304,0,3,3
46302,5,2,162306,162306,162308,0,2,2
46303,2,2,162308,162308,162310,0,2,0
46304,4,2,162312,162312,162314,0,2,2
46305,4,2,162316,162316,162318,0,2,2
46306,5,1,162321,162321,162322,0,1,3
46307,6,2,162327,162327,162329,0,2,5
46308,4,1,162331,162331,162332,0,1,2
46309,4,1,162335,162335,162336,0,1,3
46310,1,1,162336,162336,162337,0,1,0
46311,2,3,162338,162338,162341,0,3,1
46312,5,1,162343,162343,162344,0,1,2
46313,6,1,162349,162349,162350,0,1,5
46314,1,2,162350,162350,162352,0,2,0
46315,5,1,162355,162355,162356,0,1,3
46316,6,1,162361,162361,162362,0,1,5
46317,2,2,162363,162363,162365,0,2,1
46318,3,3,162366,162366,162369,0,3,1
46319,1,1,162367,162369,162370,2,3,0
46320,2,2,162369,162370,162372,1,3,0
46321,5,3,162374,162374,162377,0,3,2
46322,5,2,162379,162379,162381,0,2,2
46323,6,3,162385,162385,162388,0,3,4
46324,6,1,162391,162391,162392,0,1,3
46325,2,2,162393,162393,162395,0,2,1
46326,6,2,162399,162399,162401,0,2,4
46327,6,3,162405,162405,162408,0,3,4
46328,5,1,162410,162410,162411,0,1,2
46329,5,1,162415,162415,162416,0,1,4
46330,5,3,162420,162420,162423,0,3,4
46331,4,1,162424,162424,162425,0,1,1
46332,3,2,162427,162427,162429,0,2,2
46333,1,3,162428,162429,162432,1,4,0
46334,5,2,162433,162433,162435,0,2,1
46335,4,1,162437,162437,162438,0,1,2
46336,3,1,162440,162440,162441,0,1,2
46337,4,2,162444,162444,162446,0,2,3
46338,5,2,162449,162449,162451,0,2,3
46339,5,3,162454,162454,162457,0,3,3
46340,3,1,162457,162457,162458,0,1,0
46341,2,1,162459,162459,162460,0,1,1
46342,6,1,162465,162465,162466,0,1,5
46343,6,3,162471,162471,162474,0,3,5
46344,3,2,162474,162474,162476,0,2,0
46345,6,1,162480,162480,162481,0,1,4
46346,3,1,162483,162483,162484,0,1,2
46347,1,3,162484,162484,162487,0,3,0
46348,2,1,162486,162487,162488,1,2,0
46349,6,3,162492,162492,162495,0,3,4
46350,2,1,162494,162495,162496,1,2,0
46351,6,2,162500,162500,162502,0,2,4
46352,4,3,162504,162504,162507,0,3,2
46353,4,3,162508,162508,162511,0,3,1
46354,2,3,162510,162511,162514,1,4,0
46355,6,1,162516,162516,162517,0,1,2
46356,6,2,162522,162522,162524,0,2,5
46357,6,1,162528,162528,162529,0,1,4
46358,4,1,162532,162532,162533,0,1,3
46359,6,3,162538,162538,162541,0,3,5
46360,3,2,162541,162541,162543,0,2,0
46361,5,3,162546,162546,162549,0,3,3
46362,1,3,162547,162549,162552,2,5,0
46363,4,2,162551,162552,162554,1,3,0
46364,2,3,162553,162554,162557,1,4,0
46365,2,3,162555,162557,162560,2,5,0
46366,3,2,162558,162560,162562,2,4,0
46367,5,2,162563,162563,162565,0,2,1
46368,6,3,162569,162569,162572,0,3,4
46369,5,2,162574,162574,162576,0,2,2
46370,6,3,162580,162580,162583,0,3,4
46371,5,1,162585,162585,162586,0,1,2
46372,2,3,162587,162587,162590,0,3,1
46373,2,2,162589,162590,162592,1,3,0
46374,1,1,162590,162592,162593,2,3,0
46375,2,2,162592,162593,162595,1,3,0
46376,6,2,162598,162598,162600,0,2,3
46377,6,2,162604,162604,162606,0,2,4
46378,5,1,162609,162609,162610,0,1,3
46379,1,2,162610,162610,162612,0,2,0
46380,4,1,162614,162614,162615,0,1,2
46381,3,3,162617,162617,162620,0,3,2
46382,4,1,162621,162621,162622,0,1,1
46383,5,2,162626,162626,162628,0,2,4
46384,5,2,162631,162631,162633,0,2,3
46385,2,2,162633,162633,162635,0,2,0
46386,3,1,162636,162636,162637,0,1,1
46387,1,3,162637,162637,162640,0,3,0
46388,5,1,162642,162642,162643,0,1,2
46389,3,1,162645,162645,162646,0,1,2
46390,4,3,162649,162649,162652,0,3,3
46391,5,1,162654,162654,162655,0,1,2
46392,6,3,162660,162660,162663,0,3,5
46393,1,1,162661,162663,162664,2,3,0
46394,2,1,162663,162664,162665,1,2,0
46395,5,2,162668,162668,162670,0,2,3
46396,1,2,162669,162670,162672,1,3,0
46397,4,1,162673,162673,162674,0,1,1
46398,1,1,162674,162674,162675,0,1,0
46399,2,2,162676,162676,162678,0,2,1
46400,6,2,162682,162682,162684,0,2,4
46401,3,3,162685,162685,162688,0,3,1
46402,1,3,162686,162688,162691,2,5,0
46403,6,3,162692,162692,162695,0,3,1
46404,5,1,162697,162697,162698,0,1,2
46405,1,2,162698,162698,162700,0,2,0
46406,3,1,162701,162701,162702,0,1,1
46407,4,3,162705,162705,162708,0,3,3
46408,6,1,162711,162711,162712,0,1,3
46409,4,3,162715,162715,162718,0,3,3
46410,3,2,162718,162718,162720,0,2,0
46411,1,1,162719,162720,162721,1,2,0
46412,3,2,162722,162722,162724,0,2,1
46413,1,1,162723,162724,162725,1,2,0
46414,4,3,162727,162727,162730,0,3,2
46415,5,2,162732,162732,162734,0,2,2
46416,6,2,162738,162738,162740,0,2,4
46417,3,2,162741,162741,162743,0,2,1
46418,2,1,162743,162743,162744,0,1,0
46419,2,1,162745,162745,162746,0,1,1
46420,3,3,162748,162748,162751,0,3,2
46421,1,3,162749,162751,162754,2,5,0
46422,4,1,162753,162754,162755,1,2,0
46423,3,1,162756,162756,162757,0,1,1
46424,2,1,162758,162758,162759,0,1,1
46425,4,1,162762,162762,162763,0,1,3
46426,5,3,162767,162767,162770,0,3,4
46427,1,2,162768,162770,162772,2,4,0
46428,4,2,162772,162772,162774,0,2,0
46429,4,1,162776,162776,162777,0,1,2
46430,2,1,162778,162778,162779,0,1,1
46431,4,3,162782,162782,162785,0,3,3
46432,3,2,162785,162785,162787,0,2,0
46433,2,2,162787,162787,162789,0,2,0
46434,5,3,162792,162792,162795,0,3,3
46435,5,2,162797,162797,162799,0,2,2
46436,3,1,162800,162800,162801,0,1,1
46437,4,3,162804,162804,162807,0,3,3
46438,4,3,162808,162808,162811,0,3,1
46439,2,1,162810,162811,162812,1,2,0
46440,3,2,162813,162813,162815,0,2,1
46441,6,1,162819,162819,162820,0,1,4
46442,1,2,162820,162820,162822,0,2,0
46443,1,3,162821,162822,162825,1,4,0
46444,2,2,162823,162825,162827,2,4,0
46445,3,1,162826,162827,162828,1,2,0
46446,4,3,162830,162830,162833,0,3,2
46447,1,3,162831,162833,162836,2,5,0
46448,4,3,162835,162836,162839,1,4,0
46449,4,2,162839,162839,162841,0,2,0
46450,2,3,162841,162841,162844,0,3,0
46451,1,3,162842,162844,162847,2,5,0
46452,5,3,162847,162847,162850,0,3,0
46453,6,3,162853,162853,162856,0,3,3
46454,6,2,162859,162859,162861,0,2,3
46455,2,1,162861,162861,162862,0,1,0
46456,6,2,162867,162867,162869,0,2,5
46457,3,1,162870,162870,162871,0,1,1
46458,6,3,162876,162876,162879,0,3,5
46459,4,3,162880,162880,162883,0,3,1
46460,3,2,162883,162883,162885,0,2,0
46461,1,3,162884,162885,162888,1,4,0
46462,6,3,162890,162890,162893,0,3,2
46463,3,3,162893,162893,162896,0,3,0
46464,6,3,162899,162899,162902,0,3,3
46465,3,1,162902,162902,162903,0,1,0
46466,1,1,162903,162903,162904,0,1,0
46467,6,3,162909,162909,162912,0,3,5
46468,1,2,162910,162912,162914,2,4,0
46469,6,1,162916,162916,162917,0,1,2
46470,3,1,162919,162919,162920,0,1,2
46471,6,3,162925,162925,162928,0,3,5
46472,6,1,162931,162931,162932,0,1,3
46473,5,3,162936,162936,162939,0,3,4
46474,4,3,162940,162940,162943,0,3,1
46475,1,2,162941,162943,162945,2,4,0
46476,6,2,162947,162947,162949,0,2,2
46477,5,3,162952,162952,162955,0,3,3
46478,1,3,162953,162955,162958,2,5,0
46479,1,3,162954,162958,162961,4,7,0
46480,3,1,162957,162961,162962,4,5,0
46481,3,1,162960,162962,162963,2,3,0
46482,3,1,162963,162963,162964,0,1,0
46483,1,2,162964,162964,162966,0,2,0
46484,6,3,162970,162970,162973,0,3,4
46485,5,1,162975,162975,162976,0,1,2
46486,1,1,162976,162976,162977,0,1,0
46487,5,1,162981,162981,162982,0,1,4
46488,6,2,162987,162987,162989,0,2,5
46489,6,3,162993,162993,162996,0,3,4
46490,4,1,162997,162997,162998,0,1,1
46491,1,1,162998,162998,162999,0,1,0
46492,6,3,163004,163004,163007,0,3,5
46493,2,2,163006,163007,163009,1,3,0
46494,4,1,163010,163010,163011,0,1,1
46495,6,3,163016,163016,163019,0,3,5
46496,4,2,163020,163020,163022,0,2,1
46497,1,3,163021,163022,163025,1,4,0
46498,5,1,163026,163026,163027,0,1,1
46499,3,1,163029,163029,163030,0,1,2
46500,1,3,163030,163030,163033,0,3,0
46501,5,2,163035,163035,163037,0,2,2
46502,3,1,163038,163038,163039,0,1,1
46503,5,2,163043,163043,163045,0,2,4
46504,6,2,163049,163049,163051,0,2,4
46505,1,1,163050,163051,163052,1,2,0
46506,6,3,163056,163056,163059,0,3,4
46507,5,3,163061,163061,163064,0,3,2
46508,4,2,163065,163065,163067,0,2,1
46509,4,1,163069,163069,163070,0,1,2
46510,5,1,163074,163074,163075,0,1,4
46511,3,3,163077,163077,163080,0,3,2
46512,5,1,163082,163082,163083,0,1,2
46513,6,2,163088,163088,163090,0,2,5
46514,2,1,163090,163090,163091,0,1,0
46515,2,2,163092,163092,163094,0,2,1
46516,3,3,163095,163095,163098,0,3,1
46517,5,2,163100,163100,163102,0,2,2
46518,6,2,163106,163106,163108,0,2,4
46519,1,1,163107,163108,163109,1,2,0
46520,2,3,163109,163109,163112,0,3,0
46521,3,3,163112,163112,163115,0,3,0
46522,1,3,163113,163115,163118,2,5,0
46523,5,3,163118,163118,163121,0,3,0
46524,4,3,163122,163122,163125,0,3,1
46525,1,1,163123,163125,163126,2,3,0
46526,5,1,163128,163128,163129,0,1,2
46527,3,3,163131,163131,163134,0,3,2
46528,3,1,163134,163134,163135,0,1,0
46529,5,2,163139,163139,163141,0,2,4
46530,1,1,163140,163141,163142,1,2,0
46531,4,3,163144,163144,163147,0,3,2
46532,4,1,163148,163148,163149,0,1,1
46533,1,3,163149,163149,163152,0,3,0
46534,4,1,163153,163153,163154,0,1,1
46535,3,3,163156,163156,163159,0,3,2
46536,6,1,163162,163162,163163,0,1,3
46537,4,1,163166,163166,163167,0,1,3
46538,2,1,163168,163168,163169,0,1,1
46539,1,2,163169,163169,163171,0,2,0
46540,4,1,163173,163173,163174,0,1,2
46541,6,3,163179,163179,163182,0,3,5
46542,5,2,163184,163184,163186,0,2,2
46543,6,1,163190,163190,163191,0,1,4
46544,1,3,163191,163191,163194,0,3,0
46545,6,1,163197,163197,163198,0,1,3
46546,1,1,163198,163198,163199,0,1,0
46547,5,1,163203,163203,163204,0,1,4
46548,4,2,163207,163207,163209,0,2,3
46549,1,3,163208,163209,163212,1,4,0
46550,4,3,163212,163212,163215,0,3,0
46551,3,2,163215,163215,163217,0,2,0
46552,1,3,163216,163217,163220,1,4,0
46553,6,1,163222,163222,163223,0,1,2
46554,2,2,163224,163224,163226,0,2,1
46555,3,2,163227,163227,163229,0,2,1
46556,4,1,163231,163231,163232,0,1,2
46557,1,1,163232,163232,163233,0,1,0
46558,2,1,163234,163234,163235,0,1,1
46559,3,1,163237,163237,163238,0,1,2
46560,1,1,163238,163238,163239,0,1,0
46561,1,1,163239,163239,163240,0,1,0
46562,4,3,163243,163243,163246,0,3,3
46563,5,1,163248,163248,163249,0,1,2
46564,4,2,163252,163252,163254,0,2,3
46565,3,3,163255,163255,163258,0,3,1
46566,6,3,163261,163261,163264,0,3,3
46567,3,2,163264,163264,163266,0,2,0
46568,5,1,163269,163269,163270,0,1,3
46569,1,1,163270,163270,163271,0,1,0
46570,3,2,163273,163273,163275,0,2,2
46571,4,1,163277,163277,163278,0,1,2
46572,4,1,163281,163281,163282,0,1,3
46573,6,3,163287,163287,163290,0,3,5
46574,2,1,163289,163290,163291,1,2,0
46575,4,3,163293,163293,163296,0,3,2
46576,2,1,163295,163296,163297,1,2,0
46577,6,3,163301,163301,163304,0,3,4
46578,3,1,163304,163304,163305,0,1,0
46579,5,2,163309,163309,163311,0,2,4
46580,2,2,163311,163311,163313,0,2,0
46581,1,2,163312,163313,163315,1,3,0
46582,5,1,163317,163317,163318,0,1,2
46583,5,2,163322,163322,163324,0,2,4
46584,5,2,163327,163327,163329,0,2,3
46585,6,1,163333,163333,163334,0,1,4
46586,4,3,163337,163337,163340,0,3,3
46587,1,3,163338,163340,163343,2,5,0
46588,3,1,163341,163343,163344,2,3,0
46589,1,2,163342,163344,163346,2,4,0
46590,5,2,163347,163347,163349,0,2,1
46591,5,2,163352,163352,163354,0,2,3
46592,1,2,163353,163354,163356,1,3,0
46593,2,3,163355,163356,163359,1,4,0
46594,4,1,163359,163359,163360,0,1,0
46595,4,1,163363,163363,163364,0,1,3
46596,3,1,163366,163366,163367,0,1,2
46597,1,2,163367,163367,163369,0,2,0
46598,4,1,163371,163371,163372,0,1,2
46599,2,2,163373,163373,163375,0,2,1
46600,4,3,163377,163377,163380,0,3,2
46601,4,3,163381,163381,163384,0,3,1
46602,6,3,163387,163387,163390,0,3,3
46603,1,2,163388,163390,163392,2,4,0
46604,3,3,163391,163392,163395,1,4,0
46605,3,2,163394,163395,163397,1,3,0
46606,1,2,163395,163397,163399,2,4,0
46607,3,3,163398,163399,163402,1,4,0
46608,4,3,163402,163402,163405,0,3,0
46609,1,3,163403,163405,163408,2,5,0
46610,6,1,163409,163409,163410,0,1,1
46611,6,3,163415,163415,163418,0,3,5
46612,1,3,163416,163418,163421,2,5,0
46613,1,1,163417,163421,163422,4,5,0
46614,4,2,163421,163422,163424,1,3,0
46615,3,2,163424,163424,163426,0,2,0
46616,6,1,163430,163430,163431,0,1,4
46617,5,2,163435,163435,163437,0,2,4
46618,1,2,163436,163437,163439,1,3,0
46619,2,3,163438,163439,163442,1,4,0
46620,4,3,163442,163442,163445,0,3,0
46621,4,3,163446,163446,163449,0,3,1
46622,4,2,163450,163450,163452,0,2,1
46623,1,3,163451,163452,163455,1,4,0
46624,1,3,163452,163455,163458,3,6,0
46625,1,3,163453,163458,163461,5,8,0
46626,3,2,163456,163461,163463,5,7,0
46627,2,2,163458,163463,163465,5,7,0
46628,5,3,163463,163465,163468,2,5,0
46629,1,2,163464,163468,163470,4,6,0
46630,4,1,163468,163470,163471,2,3,0
46631,1,3,163469,163471,163474,2,5,0
46632,3,1,163472,163474,163475,2,3,0
46633,5,1,163477,163477,163478,0,1,2
46634,2,2,163479,163479,163481,0,2,1
46635,6,1,163485,163485,163486,0,1,4
46636,5,1,163490,163490,163491,0,1,4
46637,3,1,163493,163493,163494,0,1,2
46638,3,2,163496,163496,163498,0,2,2
46639,5,3,163501,163501,163504,0,3,3
46640,2,1,163503,163504,163505,1,2,0
46641,5,3,163508,163508,163511,0,3,3
46642,3,1,163511,163511,163512,0,1,0
46643,4,2,163515,163515,163517,0,2,3
46644,1,1,163516,163517,163518,1,2,0
46645,6,3,163522,163522,163525,0,3,4
46646,5,1,163527,163527,163528,0,1,2
46647,1,3,163528,163528,163531,0,3,0
46648,6,2,163534,163534,163536,0,2,3
46649,6,3,163540,163540,163543,0,3,4
46650,5,3,163545,163545,163548,0,3,2
46651,4,3,163549,163549,163552,0,3,1
46652,4,1,163553,163553,163554,0,1,1
46653,4,3,163557,163557,163560,0,3,3
46654,5,2,163562,163562,163564,0,2,2
46655,1,1,163563,163564,163565,1,2,0
46656,4,3,163567,163567,163570,0,3,2
46657,5,3,163572,163572,163575,0,3,2
46658,3,2,163575,163575,163577,0,2,0
46659,3,2,163578,163578,163580,0,2,1
46660,4,1,163582,163582,163583,0,1,2
46661,1,3,163583,163583,163586,0,3,0
46662,6,2,163589,163589,163591,0,2,3
46663,4,1,163593,163593,163594,0,1,2
46664,4,1,163597,163597,163598,0,1,3
46665,5,1,163602,163602,163603,0,1,4
46666,1,2,163603,163603,163605,0,2,0
46667,1,3,163604,163605,163608,1,4,0
46668,2,1,163606,163608,163609,2,3,0
46669,2,3,163608,163609,163612,1,4,0
46670,1,3,163609,163612,163615,3,6,0
46671,2,1,163611,163615,163616,4,5,0
46672,3,3,163614,163616,163619,2,5,0
46673,1,3,163615,163619,163622,4,7,0
46674,6,2,163621,163622,163624,1,3,0
46675,3,2,163624,163624,163626,0,2,0
46676,2,1,163626,163626,163627,0,1,0
46677,3,2,163629,163629,163631,0,2,2
46678,6,1,163635,163635,163636,0,1,4
46679,5,1,163640,163640,163641,0,1,4
46680,3,3,163643,163643,163646,0,3,2
46681,5,3,163648,163648,163651,0,3,2
46682,6,2,163654,163654,163656,0,2,3
46683,3,3,163657,163657,163660,0,3,1
46684,4,3,163661,163661,163664,0,3,1
46685,4,3,163665,163665,163668,0,3,1
46686,3,3,163668,163668,163671,0,3,0
46687,4,2,163672,163672,163674,0,2,1
46688,2,3,163674,163674,163677,0,3,0
46689,1,3,163675,163677,163680,2,5,0
46690,2,1,163677,163680,163681,3,4,0
46691,6,2,163683,163683,163685,0,2,2
46692,6,2,163689,163689,163691,0,2,4
46693,6,3,163695,163695,163698,0,3,4
46694,6,2,163701,163701,163703,0,2,3
46695,3,1,163704,163704,163705,0,1,1
46696,2,3,163706,163706,163709,0,3,1
46697,1,3,163707,163709,163712,2,5,0
46698,3,3,163710,163712,163715,2,5,0
46699,5,1,163715,163715,163716,0,1,0
46700,2,2,163717,163717,163719,0,2,1
46701,3,1,163720,163720,163721,0,1,1
46702,1,1,163721,163721,163722,0,1,0
46703,4,2,163725,163725,163727,0,2,3
46704,5,1,163730,163730,163731,0,1,3
46705,5,3,163735,163735,163738,0,3,4
46706,2,3,163737,163738,163741,1,4,0
46707,6,2,163743,163743,163745,0,2,2
46708,6,2,163749,163749,163751,0,2,4
46709,1,1,163750,163751,163752,1,2,0
46710,6,3,163756,163756,163759,0,3,4
46711,2,1,163758,163759,163760,1,2,0
46712,5,3,163763,163763,163766,0,3,3
46713,2,2,163765,163766,163768,1,3,0
46714,6,3,163771,163771,163774,0,3,3
46715,2,3,163773,163774,163777,1,4,0
46716,1,3,163774,163777,163780,3,6,0
46717,3,3,163777,163780,163783,3,6,0
46718,3,3,163780,163783,163786,3,6,0
46719,1,2,163781,163786,163788,5,7,0
46720,3,3,163784,163788,163791,4,7,0
46721,2,1,163786,163791,163792,5,6,0
46722,6,1,163792,163792,163793,0,1,0
46723,5,1,163797,163797,163798,0,1,4
46724,6,2,163803,163803,163805,0,2,5
46725,4,2,163807,163807,163809,0,2,2
46726,3,3,163810,163810,163813,0,3,1
46727,5,1,163815,163815,163816,0,1,2
46728,1,2,163816,163816,163818,0,2,0
46729,3,1,163819,163819,163820,0,1,1
46730,5,2,163824,163824,163826,0,2,4
46731,5,1,163829,163829,163830,0,1,3
46732,6,2,163835,163835,163837,0,2,5
46733,1,1,163836,163837,163838,1,2,0
46734,4,1,163840,163840,163841,0,1,2
46735,4,1,163844,163844,163845,0,1,3
46736,4,2,163848,163848,163850,0,2,3
46737,4,3,163852,163852,163855,0,3,2
46738,4,1,163856,163856,163857,0,1,1
46739,5,1,163861,163861,163862,0,1,4
46740,2,3,163863,163863,163866,0,3,1
46741,5,1,163868,163868,163869,0,1,2
46742,3,1,163871,163871,163872,0,1,2
46743,6,2,163877,163877,163879,0,2,5
46744,5,1,163882,163882,163883,0,1,3
46745,5,3,163887,163887,163890,0,3,4
46746,6,1,163893,163893,163894,0,1,3
46747,2,2,163895,163895,163897,0,2,1
46748,2,3,163897,163897,163900,0,3,0
46749,3,3,163900,163900,163903,0,3,0
46750,6,1,163906,163906,163907,0,1,3
46751,3,1,163909,163909,163910,0,1,2
46752,1,1,163910,163910,163911,0,1,0
46753,6,1,163916,163916,163917,0,1,5
46754,5,1,163921,163921,163922,0,1,4
46755,6,2,163927,163927,163929,0,2,5
46756,4,1,163931,163931,163932,0,1,2
46757,1,2,163932,163932,163934,0,2,0
46758,4,3,163936,163936,163939,0,3,2
46759,4,1,163940,163940,163941,0,1,1
46760,3,1,163943,163943,163944,0,1,2
46761,2,3,163945,163945,163948,0,3,1
46762,6,3,163951,163951,163954,0,3,3
46763,6,1,163957,163957,163958,0,1,3
46764,1,2,163958,163958,163960,0,2,0
46765,6,3,163964,163964,163967,0,3,4
46766,6,1,163970,163970,163971,0,1,3
46767,4,1,163974,163974,163975,0,1,3
46768,5,1,163979,163979,163980,0,1,4
46769,3,1,163982,163982,163983,0,1,2
46770,3,1,163985,163985,163986,0,1,2
46771,1,2,163986,163986,163988,0,2,0
46772,5,2,163991,163991,163993,0,2,3
46773,2,3,163993,163993,163996,0,3,0
46774,4,3,163997,163997,164000,0,3,1
46775,2,3,163999,164000,164003,1,4,0
46776,1,1,164000,164003,164004,3,4,0
46777,1,1,164001,164004,164005,3,4,0
46778,3,2,164004,164005,164007,1,3,0
46779,6,2,164010,164010,164012,0,2,3
46780,4,1,164014,164014,164015,0,1,2
46781,4,3,164018,164018,164021,0,3,3
46782,2,2,164020,164021,164023,1,3,0
46783,2,2,164022,164023,164025,1,3,0
46784,6,3,164028,164028,164031,0,3,3
46785,2,3,164030,164031,164034,1,4,0
46786,1,2,164031,164034,164036,3,5,0
46787,2,2,164033,164036,164038,3,5,0
46788,2,1,164035,164038,164039,3,4,0
46789,2,2,164037,164039,164041,2,4,0
46790,3,2,164040,164041,164043,1,3,0
46791,2,2,164042,164043,164045,1,3,0
46792,3,1,164045,164045,164046,0,1,0
46793,5,3,164050,164050,164053,0,3,4
46794,5,2,164055,164055,164057,0,2,2
46795,6,3,164061,164061,164064,0,3,4
46796,2,2,164063,164064,164066,1,3,0
46797,3,3,164066,164066,164069,0,3,0
46798,1,3,164067,164069,164072,2,5,0
46799,5,1,164072,164072,164073,0,1,0
46800,2,2,164074,164074,164076,0,2,1
46801,3,3,164077,164077,164080,0,3,1
46802,5,1,164082,164082,164083,0,1,2
46803,4,2,164086,164086,164088,0,2,3
46804,1,3,164087,164088,164091,1,4,0
46805,4,2,164091,164091,164093,0,2,0
46806,3,3,164094,164094,164097,0,3,1
46807,1,3,164095,164097,164100,2,5,0
46808,4,1,164099,164100,164101,1,2,0
46809,2,1,164101,164101,164102,0,1,0
46810,3,3,164104,164104,164107,0,3,2
46811,6,1,164110,164110,164111,0,1,3
46812,5,2,164115,164115,164117,0,2,4
46813,2,2,164117,164117,164119,0,2,0
46814,3,3,164120,164120,164123,0,3,1
46815,4,2,164124,164124,164126,0,2,1
46816,1,3,164125,164126,164129,1,4,0
46817,6,2,164131,164131,164133,0,2,2
46818,1,2,164132,164133,164135,1,3,0
46819,6,3,164138,164138,164141,0,3,3
46820,4,3,164142,164142,164145,0,3,1
46821,5,2,164147,164147,164149,0,2,2
46822,6,2,164153,164153,164155,0,2,4
46823,3,1,164156,164156,164157,0,1,1
46824,2,2,164158,164158,164160,0,2,1
46825,6,2,164164,164164,164166,0,2,4
46826,6,3,164170,164170,164173,0,3,4
46827,6,1,164176,164176,164177,0,1,3
46828,5,2,164181,164181,164183,0,2,4
46829,3,2,164184,164184,164186,0,2,1
46830,3,1,164187,164187,164188,0,1,1
46831,2,3,164189,164189,164192,0,3,1
46832,3,2,164192,164192,164194,0,2,0
46833,5,1,164197,164197,164198,0,1,3
46834,4,2,164201,164201,164203,0,2,3
46835,5,3,164206,164206,164209,0,3,3
46836,3,3,164209,164209,164212,0,3,0
46837,2,1,164211,164212,164213,1,2,0
46838,1,2,164212,164213,164215,1,3,0
46839,4,1,164216,164216,164217,0,1,1
46840,3,3,164219,164219,164222,0,3,2
46841,4,1,164223,164223,164224,0,1,1
46842,4,2,164227,164227,164229,0,2,3
46843,4,1,164231,164231,164232,0,1,2
46844,1,1,164232,164232,164233,0,1,0
46845,1,2,164233,164233,164235,0,2,0
46846,3,1,164236,164236,164237,0,1,1
46847,6,1,164242,164242,164243,0,1,5
46848,3,2,164245,164245,164247,0,2,2
46849,4,3,164249,164249,164252,0,3,2
46850,5,2,164254,164254,164256,0,2,2
46851,4,2,164258,164258,164260,0,2,2
46852,1,2,164259,164260,164262,1,3,0
46853,3,2,164262,164262,164264,0,2,0
46854,1,2,164263,164264,164266,1,3,0
46855,2,2,164265,164266,164268,1,3,0
46856,6,2,164271,164271,164273,0,2,3
46857,1,2,164272,164273,164275,1,3,0
46858,4,2,164276,164276,164278,0,2,1
46859,4,1,164280,164280,164281,0,1,2
46860,6,1,164286,164286,164287,0,1,5
46861,1,3,164287,164287,164290,0,3,0
46862,3,3,164290,164290,164293,0,3,0
46863,1,3,164291,164293,164296,2,5,0
46864,5,1,164296,164296,164297,0,1,0
46865,2,1,164298,164298,164299,0,1,1
46866,5,2,164303,164303,164305,0,2,4
46867,3,1,164306,164306,164307,0,1,1
46868,6,1,164312,164312,164313,0,1,5
46869,6,3,164318,164318,164321,0,3,5
46870,1,1,164319,164321,164322,2,3,0
46871,1,3,164320,164322,164325,2,5,0
46872,2,1,164322,164325,164326,3,4,0
46873,4,3,164326,164326,164329,0,3,0
46874,4,1,164330,164330,164331,0,1,1
46875,2,1,164332,164332,164333,0,1,1
46876,2,2,164334,164334,164336,0,2,1
46877,5,2,164339,164339,164341,0,2,3
46878,5,2,164344,164344,164346,0,2,3
46879,2,2,164346,164346,164348,0,2,0
46880,1,3,164347,164348,164351,1,4,0
46881,5,1,164352,164352,164353,0,1,1
46882,6,3,164358,164358,164361,0,3,5
46883,1,2,164359,164361,164363,2,4,0
46884,4,2,164363,164363,164365,0,2,0
46885,5,1,164368,164368,164369,0,1,3
46886,5,2,164373,164373,164375,0,2,4
46887,4,3,164377,164377,164380,0,3,2
46888,6,1,164383,164383,164384,0,1,3
46889,1,3,164384,164384,164387,0,3,0
46890,6,1,164390,164390,164391,0,1,3
46891,3,3,164393,164393,164396,0,3,2
46892,5,1,164398,164398,164399,0,1,2
46893,4,2,164402,164402,164404,0,2,3
46894,6,1,164408,164408,164409,0,1,4
46895,5,3,164413,164413,164416,0,3,4
46896,2,3,164415,164416,164419,1,4,0
46897,5,3,164420,164420,164423,0,3,1
46898,5,2,164425,164425,164427,0,2,2
46899,6,3,164431,164431,164434,0,3,4
46900,6,1,164437,164437,164438,0,1,3
46901,2,3,164439,164439,164442,0,3,1
46902,6,2,164445,164445,164447,0,2,3
46903,1,3,164446,164447,164450,1,4,0
46904,1,1,164447,164450,164451,3,4,0
46905,6,1,164453,164453,164454,0,1,2
46906,3,3,164456,164456,164459,0,3,2
46907,3,3,164459,164459,164462,0,3,0
46908,3,3,164462,164462,164465,0,3,0
46909,2,1,164464,164465,164466,1,2,0
46910,3,1,164467,164467,164468,0,1,1
46911,3,3,164470,164470,164473,0,3,2
46912,1,1,164471,164473,164474,2,3,0
46913,1,3,164472,164474,164477,2,5,0
46914,4,1,164476,164477,164478,1,2,0
46915,2,1,164478,164478,164479,0,1,0
46916,2,2,164480,164480,164482,0,2,1
46917,5,3,164485,164485,164488,0,3,3
46918,2,1,164487,164488,164489,1,2,0
46919,2,3,164489,164489,164492,0,3,0
46920,6,2,164495,164495,164497,0,2,3
46921,4,3,164499,164499,164502,0,3,2
46922,1,3,164500,164502,164505,2,5,0
46923,1,2,164501,164505,164507,4,6,0
46924,1,1,164502,164507,164508,5,6,0
46925,3,2,164505,164508,164510,3,5,0
46926,3,2,164508,164510,164512,2,4,0
46927,4,2,164512,164512,164514,0,2,0
46928,2,1,164514,164514,164515,0,1,0
46929,4,1,164518,164518,164519,0,1,3
46930,3,1,164521,164521,164522,0,1,2
46931,6,3,164527,164527,164530,0,3,5
46932,3,2,164530,164530,164532,0,2,0
46933,6,3,164536,164536,164539,0,3,4
46934,4,1,164540,164540,164541,0,1,1
46935,5,3,164545,164545,164548,0,3,4
46936,5,3,164550,164550,164553,0,3,2
46937,2,3,164552,164553,164556,1,4,0
46938,3,3,164555,164556,164559,1,4,0
46939,5,2,164560,164560,164562,0,2,1
46940,2,2,164562,164562,164564,0,2,0
46941,3,1,164565,164565,164566,0,1,1
46942,3,2,164568,164568,164570,0,2,2
46943,2,2,164570,164570,164572,0,2,0
46944,4,3,164574,164574,164577,0,3,2
46945,1,2,164575,164577,164579,2,4,0
46946,1,2,164576,164579,164581,3,5,0
46947,1,2,164577,164581,164583,4,6,0
46948,5,2,164582,164583,164585,1,3,0
46949,5,3,164587,164587,164590,0,3,2
46950,3,3,164590,164590,164593,0,3,0
46951,6,1,164596,164596,164597,0,1,3
46952,2,1,164598,164598,164599,0,1,1
46953,4,3,164602,164602,164605,0,3,3
46954,3,1,164605,164605,164606,0,1,0
46955,5,2,164610,164610,164612,0,2,4
46956,3,1,164613,164613,164614,0,1,1
46957,6,1,164619,164619,164620,0,1,5
46958,2,1,164621,164621,164622,0,1,1
46959,2,3,164623,164623,164626,0,3,1
46960,4,2,164627,164627,164629,0,2,1
46961,3,1,164630,164630,164631,0,1,1
46962,3,1,164633,164633,164634,0,1,2
46963,6,3,164639,164639,164642,0,3,5
46964,6,2,164645,164645,164647,0,2,3
46965,6,3,164651,164651,164654,0,3,4
46966,6,2,164657,164657,164659,0,2,3
46967,1,1,164658,164659,164660,1,2,0
46968,3,3,164661,164661,164664,0,3,1
46969,4,1,164665,164665,164666,0,1,1
46970,3,1,164668,164668,164669,0,1,2
46971,4,3,164672,164672,164675,0,3,3
46972,3,2,164675,164675,164677,0,2,0
46973,4,1,164679,164679,164680,0,1,2
46974,3,1,164682,164682,164683,0,1,2
46975,4,2,164686,164686,164688,0,2,3
46976,5,3,164691,164691,164694,0,3,3
46977,3,1,164694,164694,164695,0,1,0
46978,2,2,164696,164696,164698,0,2,1
46979,2,1,164698,164698,164699,0,1,0
46980,1,3,164699,164699,164702,0,3,0
46981,5,2,164704,164704,164706,0,2,2
46982,5,1,164709,164709,164710,0,1,3
46983,6,2,164715,164715,164717,0,2,5
46984,6,3,164721,164721,164724,0,3,4
46985,4,3,164725,164725,164728,0,3,1
46986,5,2,164730,164730,164732,0,2,2
46987,6,1,164736,164736,164737,0,1,4
46988,4,3,164740,164740,164743,0,3,3
46989,2,1,164742,164743,164744,1,2,0
46990,6,2,164748,164748,164750,0,2,4
46991,4,2,164752,164752,164754,0,2,2
46992,2,1,164754,164754,164755,0,1,0
46993,5,2,164759,164759,164761,0,2,4
46994,2,2,164761,164761,164763,0,2,0
46995,6,3,164767,164767,164770,0,3,4
46996,3,2,164770,164770,164772,0,2,0
46997,1,2,164771,164772,164774,1,3,0
46998,6,2,164777,164777,164779,0,2,3
46999,4,1,164781,164781,164782,0,1,2
47000,6,2,164787,164787,164789,0,2,5
47001,1,1,164788,164789,164790,1,2,0
47002,2,3,164790,164790,164793,0,3,0
47003,6,1,164796,164796,164797,0,1,3
47004,1,2,164797,164797,164799,0,2,0
47005,2,2,164799,164799,164801,0,2,0
47006,2,1,164801,164801,164802,0,1,0
47007,2,2,164803,164803,164805,0,2,1
47008,2,2,164805,164805,164807,0,2,0
47009,1,3,164806,164807,164810,1,4,0
47010,2,1,164808,164810,164811,2,3,0
47011,1,2,164809,164811,164813,2,4,0
47012,2,1,164811,164813,164814,2,3,0
47013,5,2,164816,164816,164818,0,2,2
47014,6,1,164822,164822,164823,0,1,4
47015,4,1,164826,164826,164827,0,1,3
47016,3,2,164829,164829,164831,0,2,2
47017,6,2,164835,164835,164837,0,2,4
47018,3,3,164838,164838,164841,0,3,1
47019,3,2,164841,164841,164843,0,2,0
47020,5,2,164846,164846,164848,0,2,3
47021,1,3,164847,164848,164851,1,4,0
47022,3,2,164850,164851,164853,1,3,0
47023,1,3,164851,164853,164856,2,5,0
47024,3,2,164854,164856,164858,2,4,0
47025,6,2,164860,164860,164862,0,2,2
47026,1,1,164861,164862,164863,1,2,0
47027,2,3,164863,164863,164866,0,3,0
47028,2,3,164865,164866,164869,1,4,0
47029,5,2,164870,164870,164872,0,2,1
47030,3,1,164873,164873,164874,0,1,1
47031,6,1,164879,164879,164880,0,1,5
47032,3,2,164882,164882,164884,0,2,2
47033,2,2,164884,164884,164886,0,2,0
47034,4,3,164888,164888,164891,0,3,2
47035,6,2,164894,164894,164896,0,2,3
47036,2,3,164896,164896,164899,0,3,0
47037,1,1,164897,164899,164900,2,3,0
47038,2,3,164899,164900,164903,1,4,0
47039,4,3,164903,164903,164906,0,3,0
47040,6,3,164909,164909,164912,0,3,3
47041,2,2,164911,164912,164914,1,3,0
47042,3,1,164914,164914,164915,0,1,0
47043,6,3,164920,164920,164923,0,3,5
47044,3,3,164923,164923,164926,0,3,0
47045,2,2,164925,164926,164928,1,3,0
47046,5,2,164930,164930,164932,0,2,2
47047,5,1,164935,164935,164936,0,1,3
47048,5,2,164940,164940,164942,0,2,4
47049,2,2,164942,164942,164944,0,2,0
47050,5,2,164947,164947,164949,0,2,3
47051,6,3,164953,164953,164956,0,3,4
47052,2,1,164955,164956,164957,1,2,0
47053,6,3,164961,164961,164964,0,3,4
47054,4,2,164965,164965,164967,0,2,1
47055,5,2,164970,164970,164972,0,2,3
47056,6,2,164976,164976,164978,0,2,4
47057,5,1,164981,164981,164982,0,1,3
47058,1,2,164982,164982,164984,0,2,0
47059,4,3,164986,164986,164989,0,3,2
47060,2,3,164988,164989,164992,1,4,0
47061,6,3,164994,164994,164997,0,3,2
47062,2,3,164996,164997,165000,1,4,0
47063,5,3,165001,165001,165004,0,3,1
47064,4,2,165005,165005,165007,0,2,1
47065,4,1,165009,165009,165010,0,1,2
47066,4,1,165013,165013,165014,0,1,3
47067,6,3,165019,165019,165022,0,3,5
47068,4,1,165023,165023,165024,0,1,1
47069,4,2,165027,165027,165029,0,2,3
47070,5,1,165032,165032,165033,0,1,3
47071,2,3,165034,165034,165037,0,3,1
47072,1,2,165035,165037,165039,2,4,0
47073,3,3,165038,165039,165042,1,4,0
47074,1,2,165039,165042,165044,3,5,0
47075,5,3,165044,165044,165047,0,3,0
47076,1,1,165045,165047,165048,2,3,0
47077,6,2,165051,165051,165053,0,2,3
47078,2,2,165053,165053,165055,0,2,0
47079,5,1,165058,165058,165059,0,1,3
47080,2,2,165060,165060,165062,0,2,1
47081,4,3,165064,165064,165067,0,3,2
47082,1,2,165065,165067,165069,2,4,0
47083,5,1,165070,165070,165071,0,1,1
47084,2,3,165072,165072,165075,0,3,1
47085,3,1,165075,165075,165076,0,1,0
47086,4,2,165079,165079,165081,0,2,3
47087,6,1,165085,165085,165086,0,1,4
47088,3,2,165088,165088,165090,0,2,2
47089,6,3,165094,165094,165097,0,3,4
47090,3,3,165097,165097,165100,0,3,0
47091,6,3,165103,165103,165106,0,3,3
47092,1,1,165104,165106,165107,2,3,0
47093,6,3,165110,165110,165113,0,3,3
47094,6,2,165116,165116,165118,0,2,3
47095,2,3,165118,165118,165121,0,3,0
47096,1,2,165119,165121,165123,2,4,0
47097,2,3,165121,165123,165126,2,5,0
47098,5,1,165126,165126,165127,0,1,0
47099,4,1,165130,165130,165131,0,1,3
47100,1,3,165131,165131,165134,0,3,0
47101,3,3,165134,165134,165137,0,3,0
47102,5,1,165139,165139,165140,0,1,2
47103,2,2,165141,165141,165143,0,2,1
47104,1,1,165142,165143,165144,1,2,0
47105,2,1,165144,165144,165145,0,1,0
47106,5,1,165149,165149,165150,0,1,4
47107,2,3,165151,165151,165154,0,3,1
47108,1,3,165152,165154,165157,2,5,0
47109,3,2,165155,165157,165159,2,4,0
47110,5,2,165160,165160,165162,0,2,1
47111,5,1,165165,165165,165166,0,1,3
47112,4,1,165169,165169,165170,0,1,3
47113,6,3,165175,165175,165178,0,3,5
47114,5,1,165180,165180,165181,0,1,2
47115,2,1,165182,165182,165183,0,1,1
47116,3,1,165185,165185,165186,0,1,2
47117,1,3,165186,165186,165189,0,3,0
47118,6,3,165192,165192,165195,0,3,3
47119,6,3,165198,165198,165201,0,3,3
47120,1,1,165199,165201,165202,2,3,0
47121,3,1,165202,165202,165203,0,1,0
47122,5,2,165207,165207,165209,0,2,4
47123,5,3,165212,165212,165215,0,3,3
47124,3,3,165215,165215,165218,0,3,0
47125,6,1,165221,165221,165222,0,1,3
47126,6,2,165227,165227,165229,0,2,5
47127,3,2,165230,165230,165232,0,2,1
47128,3,1,165233,165233,165234,0,1,1
47129,2,3,165235,165235,165238,0,3,1
47130,1,2,165236,165238,165240,2,4,0
47131,3,2,165239,165240,165242,1,3,0
47132,5,2,165244,165244,165246,0,2,2
47133,2,1,165246,165246,165247,0,1,0
47134,3,3,165249,165249,165252,0,3,2
47135,5,2,165254,165254,165256,0,2,2
47136,6,3,165260,165260,165263,0,3,4
47137,6,2,165266,165266,165268,0,2,3
47138,2,1,165268,165268,165269,0,1,0
47139,5,1,165273,165273,165274,0,1,4
47140,1,2,165274,165274,165276,0,2,0
47141,6,3,165280,165280,165283,0,3,4
47142,1,3,165281,165283,165286,2,5,0
47143,4,3,165285,165286,165289,1,4,0
47144,4,2,165289,165289,165291,0,2,0
47145,4,1,165293,165293,165294,0,1,2
47146,2,2,165295,165295,165297,0,2,1
47147,1,1,165296,165297,165298,1,2,0
47148,4,2,165300,165300,165302,0,2,2
47149,4,3,165304,165304,165307,0,3,2
47150,5,1,165309,165309,165310,0,1,2
47151,4,3,165313,165313,165316,0,3,3
47152,3,2,165316,165316,165318,0,2,0
47153,5,3,165321,165321,165324,0,3,3
47154,6,3,165327,165327,165330,0,3,3
47155,6,2,165333,165333,165335,0,2,3
47156,2,1,165335,165335,165336,0,1,0
47157,6,3,165341,165341,165344,0,3,5
47158,6,3,165347,165347,165350,0,3,3
47159,5,1,165352,165352,165353,0,1,2
47160,4,1,165356,165356,165357,0,1,3
47161,3,1,165359,165359,165360,0,1,2
47162,5,1,165364,165364,165365,0,1,4
47163,2,3,165366,165366,165369,0,3,1
47164,4,1,165370,165370,165371,0,1,1
47165,6,3,165376,165376,165379,0,3,5
47166,6,2,165382,165382,165384,0,2,3
47167,6,3,165388,165388,165391,0,3,4
47168,2,3,165390,165391,165394,1,4,0
47169,1,2,165391,165394,165396,3,5,0
47170,2,1,165393,165396,165397,3,4,0
47171,3,3,165396,165397,165400,1,4,0
47172,3,2,165399,165400,165402,1,3,0
47173,3,1,165402,165402,165403,0,1,0
47174,4,1,165406,165406,165407,0,1,3
47175,2,3,165408,165408,165411,0,3,1
47176,5,1,165413,165413,165414,0,1,2
47177,5,3,165418,165418,165421,0,3,4
47178,1,3,165419,165421,165424,2,5,0
47179,3,3,165422,165424,165427,2,5,0
47180,6,2,165428,165428,165430,0,2,1
47181,1,2,165429,165430,165432,1,3,0
47182,5,1,165434,165434,165435,0,1,2
47183,5,1,165439,165439,165440,0,1,4
47184,1,3,165440,165440,165443,0,3,0
47185,2,1,165442,165443,165444,1,2,0
47186,2,1,165444,165444,165445,0,1,0
47187,6,1,165450,165450,165451,0,1,5
47188,6,2,165456,165456,165458,0,2,5
47189,6,3,165462,165462,165465,0,3,4
47190,1,1,165463,165465,165466,2,3,0
47191,4,2,165467,165467,165469,0,2,1
47192,6,2,165473,165473,165475,0,2,4
47193,5,1,165478,165478,165479,0,1,3
47194,6,1,165484,165484,165485,0,1,5
47195,5,1,165489,165489,165490,0,1,4
47196,4,3,165493,165493,165496,0,3,3
47197,3,3,165496,165496,165499,0,3,0
47198,2,3,165498,165499,165502,1,4,0
47199,6,3,165504,165504,165507,0,3,2
47200,4,3,165508,165508,165511,0,3,1
47201,6,2,165514,165514,165516,0,2,3
47202,2,1,165516,165516,165517,0,1,0
47203,4,3,165520,165520,165523,0,3,3
47204,1,3,165521,165523,165526,2,5,0
47205,3,2,165524,165526,165528,2,4,0
47206,3,1,165527,165528,165529,1,2,0
47207,4,3,165531,165531,165534,0,3,2
47208,5,3,165536,165536,165539,0,3,2
47209,5,1,165541,165541,165542,0,1,2
47210,5,2,165546,165546,165548,0,2,4
47211,6,3,165552,165552,165555,0,3,4
47212,5,1,165557,165557,165558,0,1,2
47213,3,3,165560,165560,165563,0,3,2
47214,1,3,165561,165563,165566,2,5,0
47215,4,3,165565,165566,165569,1,4,0
47216,2,3,165567,165569,165572,2,5,0
47217,1,2,165568,165572,165574,4,6,0
47218,2,3,165570,165574,165577,4,7,0
47219,4,2,165574,165577,165579,3,5,0
47220,2,2,165576,165579,165581,3,5,0
47221,4,2,165580,165581,165583,1,3,0
47222,4,1,165584,165584,165585,0,1,1
47223,2,1,165586,165586,165587,0,1,1
47224,1,1,165587,165587,165588,0,1,0
47225,6,1,165593,165593,165594,0,1,5
47226,6,3,165599,165599,165602,0,3,5
47227,1,3,165600,165602,165605,2,5,0
47228,1,2,165601,165605,165607,4,6,0
47229,4,2,165605,165607,165609,2,4,0
47230,2,2,165607,165609,165611,2,4,0
47231,6,2,165613,165613,165615,0,2,2
47232,5,3,165618,165618,165621,0,3,3
47233,2,1,165620,165621,165622,1,2,0
47234,1,3,165621,165622,165625,1,4,0
47235,3,3,165624,165625,165628,1,4,0
47236,5,3,165629,165629,165632,0,3,1
47237,1,1,165630,165632,165633,2,3,0
47238,2,1,165632,165633,165634,1,2,0
47239,2,2,165634,165634,165636,0,2,0
47240,2,1,165636,165636,165637,0,1,0
47241,5,2,165641,165641,165643,0,2,4
47242,2,1,165643,165643,165644,0,1,0
47243,4,3,165647,165647,165650,0,3,3
47244,3,2,165650,165650,165652,0,2,0
47245,6,3,165656,165656,165659,0,3,4
47246,3,3,165659,165659,165662,0,3,0
47247,5,2,165664,165664,165666,0,2,2
47248,2,2,165666,165666,165668,0,2,0
47249,1,1,165667,165668,165669,1,2,0
47250,1,3,165668,165669,165672,1,4,0
47251,2,3,165670,165672,165675,2,5,0
47252,3,2,165673,165675,165677,2,4,0
47253,4,2,165677,165677,165679,0,2,0
47254,5,2,165682,165682,165684,0,2,3
47255,4,1,165686,165686,165687,0,1,2
47256,6,2,165692,165692,165694,0,2,5
47257,1,3,165693,165694,165697,1,4,0
47258,4,2,165697,165697,165699,0,2,0
47259,2,1,165699,165699,165700,0,1,0
47260,1,1,165700,165700,165701,0,1,0
47261,1,2,165701,165701,165703,0,2,0
47262,4,2,165705,165705,165707,0,2,2
47263,2,3,165707,165707,165710,0,3,0
47264,2,3,165709,165710,165713,1,4,0
47265,1,1,165710,165713,165714,3,4,0
47266,5,1,165715,165715,165716,0,1,1
47267,3,3,165718,165718,165721,0,3,2
47268,1,1,165719,165721,165722,2,3,0
47269,2,2,165721,165722,165724,1,3,0
47270,5,3,165726,165726,165729,0,3,2
47271,2,3,165728,165729,165732,1,4,0
47272,2,3,165730,165732,165735,2,5,0
47273,4,1,165734,165735,165736,1,2,0
47274,2,3,165736,165736,165739,0,3,0
47275,2,2,165738,165739,165741,1,3,0
47276,1,1,165739,165741,165742,2,3,0
47277,5,1,165744,165744,165745,0,1,2
47278,5,1,165749,165749,165750,0,1,4
47279,6,2,165755,165755,165757,0,2,5
47280,6,1,165761,165761,165762,0,1,4
47281,5,2,165766,165766,165768,0,2,4
47282,4,1,165770,165770,165771,0,1,2
47283,5,2,165775,165775,165777,0,2,4
47284,1,2,165776,165777,165779,1,3,0
47285,6,2,165782,165782,165784,0,2,3
47286,4,2,165786,165786,165788,0,2,2
47287,5,3,165791,165791,165794,0,3,3
47288,6,2,165797,165797,165799,0,2,3
47289,1,1,165798,165799,165800,1,2,0
47290,5,2,165803,165803,165805,0,2,3
47291,5,1,165808,165808,165809,0,1,3
47292,1,1,165809,165809,165810,0,1,0
47293,3,3,165812,165812,165815,0,3,2
47294,3,1,165815,165815,165816,0,1,0
47295,2,1,165817,165817,165818,0,1,1
47296,1,1,165818,165818,165819,0,1,0
47297,3,3,165821,165821,165824,0,3,2
47298,6,1,165827,165827,165828,0,1,3
47299,6,1,165833,165833,165834,0,1,5
47300,3,3,165836,165836,165839,0,3,2
47301,4,3,165840,165840,165843,0,3,1
47302,6,3,165846,165846,165849,0,3,3
47303,4,2,165850,165850,165852,0,2,1
47304,5,1,165855,165855,165856,0,1,3
47305,1,3,165856,165856,165859,0,3,0
47306,3,2,165859,165859,165861,0,2,0
47307,4,3,165863,165863,165866,0,3,2
47308,1,2,165864,165866,165868,2,4,0
47309,6,3,165870,165870,165873,0,3,2
47310,6,3,165876,165876,165879,0,3,3
47311,1,1,165877,165879,165880,2,3,0
47312,6,1,165883,165883,165884,0,1,3
47313,5,3,165888,165888,165891,0,3,4
47314,1,3,165889,165891,165894,2,5,0
47315,3,2,165892,165894,165896,2,4,0
47316,2,1,165894,165896,165897,2,3,0
47317,2,3,165896,165897,165900,1,4,0
47318,4,3,165900,165900,165903,0,3,0
47319,5,3,165905,165905,165908,0,3,2
47320,5,2,165910,165910,165912,0,2,2
47321,2,3,165912,165912,165915,0,3,0
47322,6,3,165918,165918,165921,0,3,3
47323,5,2,165923,165923,165925,0,2,2
47324,3,1,165926,165926,165927,0,1,1
47325,1,3,165927,165927,165930,0,3,0
47326,3,1,165930,165930,165931,0,1,0
47327,1,2,165931,165931,165933,0,2,0
47328,5,1,165936,165936,165937,0,1,3
47329,4,2,165940,165940,165942,0,2,3
47330,4,2,165944,165944,165946,0,2,2
47331,6,1,165950,165950,165951,0,1,4
47332,1,2,165951,165951,165953,0,2,0
47333,1,2,165952,165953,165955,1,3,0
47334,4,1,165956,165956,165957,0,1,1
47335,4,3,165960,165960,165963,0,3,3
47336,3,3,165963,165963,165966,0,3,0
47337,3,1,165966,165966,165967,0,1,0
47338,3,1,165969,165969,165970,0,1,2
47339,1,1,165970,165970,165971,0,1,0
47340,1,2,165971,165971,165973,0,2,0
47341,2,1,165973,165973,165974,0,1,0
47342,2,3,165975,165975,165978,0,3,1
47343,4,3,165979,165979,165982,0,3,1
47344,5,3,165984,165984,165987,0,3,2
47345,2,3,165986,165987,165990,1,4,0
47346,2,2,165988,165990,165992,2,4,0
47347,4,1,165992,165992,165993,0,1,0
47348,4,3,165996,165996,165999,0,3,3
47349,4,1,166000,166000,166001,0,1,1
47350,3,1,166003,166003,166004,0,1,2
47351,6,3,166009,166009,166012,0,3,5
47352,5,1,166014,166014,166015,0,1,2
47353,3,2,166017,166017,166019,0,2,2
47354,2,2,166019,166019,166021,0,2,0
47355,3,3,166022,166022,166025,0,3,1
47356,1,3,166023,166025,166028,2,5,0
47357,6,2,166029,166029,166031,0,2,1
47358,6,3,166035,166035,166038,0,3,4
47359,1,2,166036,166038,166040,2,4,0
47360,1,3,166037,166040,166043,3,6,0
47361,1,3,166038,166043,166046,5,8,0
47362,2,3,166040,166046,166049,6,9,0
47363,3,3,166043,166049,166052,6,9,0
47364,6,1,166049,166052,166053,3,4,0
47365,2,3,166051,166053,166056,2,5,0
47366,4,3,166055,166056,166059,1,4,0
47367,2,1,166057,166059,166060,2,3,0
47368,4,1,166061,166061,166062,0,1,1
47369,5,3,166066,166066,166069,0,3,4
47370,5,1,166071,166071,166072,0,1,2
47371,5,2,166076,166076,166078,0,2,4
47372,3,1,166079,166079,166080,0,1,1
47373,1,3,166080,166080,166083,0,3,0
47374,3,3,166083,166083,166086,0,3,0
47375,1,1,166084,166086,166087,2,3,0
47376,4,2,166088,166088,166090,0,2,1
47377,2,1,166090,166090,166091,0,1,0
47378,6,1,166096,166096,166097,0,1,5
47379,2,1,166098,166098,166099,0,1,1
47380,3,1,166101,166101,166102,0,1,2
47381,2,3,166103,166103,166106,0,3,1
47382,6,2,166109,166109,166111,0,2,3
47383,5,3,166114,166114,166117,0,3,3
47384,2,1,166116,166117,166118,1,2,0
47385,2,1,166118,166118,166119,0,1,0
47386,1,2,166119,166119,166121,0,2,0
47387,6,1,166125,166125,166126,0,1,4
47388,3,1,166128,166128,166129,0,1,2
47389,5,3,166133,166133,166136,0,3,4
47390,2,2,166135,166136,166138,1,3,0
47391,4,2,166139,166139,166141,0,2,1
47392,4,3,166143,166143,166146,0,3,2
47393,2,2,166145,166146,166148,1,3,0
47394,4,2,166149,166149,166151,0,2,1
47395,5,1,166154,166154,166155,0,1,3
47396,6,1,166160,166160,166161,0,1,5
47397,2,2,166162,166162,166164,0,2,1
47398,6,3,166168,166168,166171,0,3,4
47399,2,2,166170,166171,166173,1,3,0
47400,4,3,166174,166174,166177,0,3,1
47401,4,3,166178,166178,166181,0,3,1
47402,1,3,166179,166181,166184,2,5,0
47403,3,1,166182,166184,166185,2,3,0
47404,1,2,166183,166185,166187,2,4,0
47405,2,3,166185,166187,166190,2,5,0
47406,2,1,166187,166190,166191,3,4,0
47407,3,1,166190,166191,166192,1,2,0
47408,3,2,166193,166193,166195,0,2,1
47409,1,3,166194,166195,166198,1,4,0
47410,5,3,166199,166199,166202,0,3,1
47411,4,1,166203,166203,166204,0,1,1
47412,1,3,166204,166204,166207,0,3,0
47413,1,2,166205,166207,166209,2,4,0
47414,3,1,166208,166209,166210,1,2,0
47415,5,1,166213,166213,166214,0,1,3
47416,1,1,166214,166214,166215,0,1,0
47417,4,3,166218,166218,166221,0,3,3
47418,2,1,166220,166221,166222,1,2,0
47419,6,1,166226,166226,166227,0,1,4
47420,6,2,166232,166232,166234,0,2,5
47421,3,1,166235,166235,166236,0,1,1
47422,5,1,166240,166240,166241,0,1,4
47423,2,1,166242,166242,166243,0,1,1
47424,5,3,166247,166247,166250,0,3,4
47425,1,1,166248,166250,166251,2,3,0
47426,6,1,166254,166254,166255,0,1,3
47427,1,1,166255,166255,166256,0,1,0
47428,5,1,166260,166260,166261,0,1,4
47429,4,3,166264,166264,166267,0,3,3
47430,6,1,166270,166270,166271,0,1,3
47431,3,2,166273,166273,166275,0,2,2
47432,6,3,166279,166279,166282,0,3,4
47433,2,3,166281,166282,166285,1,4,0
47434,5,1,166286,166286,166287,0,1,1
47435,1,2,166287,166287,166289,0,2,0
47436,6,1,166293,166293,166294,0,1,4
47437,4,3,166297,166297,166300,0,3,3
47438,3,3,166300,166300,166303,0,3,0
47439,2,1,166302,166303,166304,1,2,0
47440,1,2,166303,166304,166306,1,3,0
47441,2,3,166305,166306,166309,1,4,0
47442,2,1,166307,166309,166310,2,3,0
47443,1,3,166308,166310,166313,2,5,0
47444,3,1,166311,166313,166314,2,3,0
47445,4,3,166315,166315,166318,0,3,1
47446,1,2,166316,166318,166320,2,4,0
47447,5,2,166321,166321,166323,0,2,1
47448,1,1,166322,166323,166324,1,2,0
47449,3,3,166325,166325,166328,0,3,1
47450,1,3,166326,166328,166331,2,5,0
47451,5,2,166331,166331,166333,0,2,0
47452,2,2,166333,166333,166335,0,2,0
47453,3,2,166336,166336,166338,0,2,1
47454,2,3,166338,166338,166341,0,3,0
47455,6,1,166344,166344,166345,0,1,3
47456,1,1,166345,166345,166346,0,1,0
47457,6,3,166351,166351,166354,0,3,5
47458,6,1,166357,166357,166358,0,1,3
47459,2,1,166359,166359,166360,0,1,1
47460,4,3,166363,166363,166366,0,3,3
47461,1,1,166364,166366,166367,2,3,0
47462,5,2,166369,166369,166371,0,2,2
47463,1,1,166370,166371,166372,1,2,0
47464,5,1,166375,166375,166376,0,1,3
47465,5,1,166380,166380,166381,0,1,4
47466,6,1,166386,166386,166387,0,1,5
47467,5,2,166391,166391,166393,0,2,4
47468,5,3,166396,166396,166399,0,3,3
47469,1,1,166397,166399,166400,2,3,0
47470,3,1,166400,166400,166401,0,1,0
47471,1,3,166401,166401,166404,0,3,0
47472,5,2,166406,166406,166408,0,2,2
47473,3,2,166409,166409,166411,0,2,1
47474,5,1,166414,166414,166415,0,1,3
47475,2,2,166416,166416,166418,0,2,1
47476,6,3,166422,166422,166425,0,3,4
47477,5,1,166427,166427,166428,0,1,2
47478,3,1,166430,166430,166431,0,1,2
47479,1,2,166431,166431,166433,0,2,0
47480,6,2,166437,166437,166439,0,2,4
47481,3,1,166440,166440,166441,0,1,1
47482,2,1,166442,166442,166443,0,1,1
47483,2,1,166444,166444,166445,0,1,1
47484,4,2,166448,166448,166450,0,2,3
47485,4,2,166452,166452,166454,0,2,2
47486,3,3,166455,166455,166458,0,3,1
47487,1,1,166456,166458,166459,2,3,0
47488,5,2,166461,166461,166463,0,2,2
47489,5,2,166466,166466,166468,0,2,3
47490,4,2,166470,166470,166472,0,2,2
47491,2,3,166472,166472,166475,0,3,0
47492,6,3,166478,166478,166481,0,3,3
47493,3,3,166481,166481,166484,0,3,0
47494,1,2,166482,166484,166486,2,4,0
47495,4,1,166486,166486,166487,0,1,0
47496,5,2,166491,166491,166493,0,2,4
47497,3,1,166494,166494,166495,0,1,1
47498,6,3,166500,166500,166503,0,3,5
47499,6,1,166506,166506,166507,0,1,3
47500,4,3,166510,166510,166513,0,3,3
47501,4,1,166514,166514,166515,0,1,1
47502,4,2,166518,166518,166520,0,2,3
47503,6,2,166524,166524,166526,0,2,4
47504,5,2,166529,166529,166531,0,2,3
47505,1,2,166530,166531,166533,1,3,0
47506,3,2,166533,166533,166535,0,2,0
47507,1,3,166534,166535,166538,1,4,0
47508,3,3,166537,166538,166541,1,4,0
47509,5,1,166542,166542,166543,0,1,1
47510,4,3,166546,166546,166549,0,3,3
47511,1,1,166547,166549,166550,2,3,0
47512,3,1,166550,166550,166551,0,1,0
47513,6,2,166556,166556,166558,0,2,5
47514,2,1,166558,166558,166559,0,1,0
47515,4,3,166562,166562,166565,0,3,3
47516,3,3,166565,166565,166568,0,3,0
47517,3,3,166568,166568,166571,0,3,0
47518,1,2,166569,166571,166573,2,4,0
47519,5,2,166574,166574,166576,0,2,1
47520,1,3,166575,166576,166579,1,4,0
47521,6,2,166581,166581,166583,0,2,2
47522,6,1,166587,166587,166588,0,1,4
47523,3,3,166590,166590,166593,0,3,2
47524,5,1,166595,166595,166596,0,1,2
47525,1,1,166596,166596,166597,0,1,0
47526,4,1,166600,166600,166601,0,1,3
47527,2,2,166602,166602,166604,0,2,1
47528,1,2,166603,166604,166606,1,3,0
47529,6,1,166609,166609,166610,0,1,3
47530,6,1,166615,166615,166616,0,1,5
47531,1,2,166616,166616,166618,0,2,0
47532,6,3,166622,166622,166625,0,3,4
47533,3,1,166625,166625,166626,0,1,0
47534,2,2,166627,166627,166629,0,2,1
47535,1,1,166628,166629,166630,1,2,0
47536,3,3,166631,166631,166634,0,3,1
47537,6,3,166637,166637,166640,0,3,3
47538,4,1,166641,166641,166642,0,1,1
47539,1,2,166642,166642,166644,0,2,0
47540,6,2,166648,166648,166650,0,2,4
47541,2,3,166650,166650,166653,0,3,0
47542,2,1,166652,166653,166654,1,2,0
47543,6,2,166658,166658,166660,0,2,4
47544,5,1,166663,166663,166664,0,1,3
47545,3,1,166666,166666,166667,0,1,2
47546,4,2,166670,166670,166672,0,2,3
47547,5,3,166675,166675,166678,0,3,3
47548,4,1,166679,166679,166680,0,1,1
47549,6,3,166685,166685,166688,0,3,5
47550,4,3,166689,166689,166692,0,3,1
47551,3,2,166692,166692,166694,0,2,0
47552,1,2,166693,166694,166696,1,3,0
47553,3,3,166696,166696,166699,0,3,0
47554,3,1,166699,166699,166700,0,1,0
47555,6,2,166705,166705,166707,0,2,5
47556,3,3,166708,166708,166711,0,3,1
47557,6,1,166714,166714,166715,0,1,3
47558,3,1,166717,166717,166718,0,1,2
47559,4,2,166721,166721,166723,0,2,3
47560,1,3,166722,166723,166726,1,4,0
47561,5,1,166727,166727,166728,0,1,1
47562,2,2,166729,166729,166731,0,2,1
47563,4,2,166733,166733,166735,0,2,2
47564,1,2,166734,166735,166737,1,3,0
47565,4,2,166738,166738,166740,0,2,1
47566,5,3,166743,166743,166746,0,3,3
47567,3,3,166746,166746,166749,0,3,0
47568,3,1,166749,166749,166750,0,1,0
47569,6,2,166755,166755,166757,0,2,5
47570,1,3,166756,166757,166760,1,4,0
47571,5,1,166761,166761,166762,0,1,1
47572,5,1,166766,166766,166767,0,1,4
47573,6,2,166772,166772,166774,0,2,5
47574,2,1,166774,166774,166775,0,1,0
47575,5,3,166779,166779,166782,0,3,4
47576,5,1,166784,166784,166785,0,1,2
47577,3,3,166787,166787,166790,0,3,2
47578,5,3,166792,166792,166795,0,3,2
47579,1,2,166793,166795,166797,2,4,0
47580,5,1,166798,166798,166799,0,1,1
47581,6,1,166804,166804,166805,0,1,5
47582,4,3,166808,166808,166811,0,3,3
47583,6,1,166814,166814,166815,0,1,3
47584,2,3,166816,166816,166819,0,3,1
47585,4,1,166820,166820,166821,0,1,1
47586,6,1,166826,166826,166827,0,1,5
47587,1,3,166827,166827,166830,0,3,0
47588,5,1,166832,166832,166833,0,1,2
47589,1,2,166833,166833,166835,0,2,0
47590,1,3,166834,166835,166838,1,4,0
47591,5,1,166839,166839,166840,0,1,1
47592,2,2,166841,166841,166843,0,2,1
47593,4,1,166845,166845,166846,0,1,2
47594,4,2,166849,166849,166851,0,2,3
47595,5,1,166854,166854,166855,0,1,3
47596,1,2,166855,166855,166857,0,2,0
47597,2,2,166857,166857,166859,0,2,0
47598,5,2,166862,166862,166864,0,2,3
47599,1,2,166863,166864,166866,1,3,0
47600,5,2,166868,166868,166870,0,2,2
47601,4,3,166872,166872,166875,0,3,2
47602,1,1,166873,166875,166876,2,3,0
47603,2,3,166875,166876,166879,1,4,0
47604,5,3,166880,166880,166883,0,3,1
47605,2,3,166882,166883,166886,1,4,0
47606,6,1,166888,166888,166889,0,1,2
47607,6,2,166894,166894,166896,0,2,5
47608,1,2,166895,166896,166898,1,3,0
47609,6,3,166901,166901,166904,0,3,3
47610,4,3,166905,166905,166908,0,3,1
47611,2,3,166907,166908,166911,1,4,0
47612,4,1,166911,166911,166912,0,1,0
47613,2,3,166913,166913,166916,0,3,1
47614,4,3,166917,166917,166920,0,3,1
47615,2,3,166919,166920,166923,1,4,0
47616,5,3,166924,166924,166927,0,3,1
47617,5,2,166929,166929,166931,0,2,2
47618,4,3,166933,166933,166936,0,3,2
47619,3,3,166936,166936,166939,0,3,0
47620,6,1,166942,166942,166943,0,1,3
47621,4,3,166946,166946,166949,0,3,3
47622,6,2,166952,166952,166954,0,2,3
47623,3,3,166955,166955,166958,0,3,1
47624,6,2,166961,166961,166963,0,2,3
47625,4,3,166965,166965,166968,0,3,2
47626,1,1,166966,166968,166969,2,3,0
47627,1,1,166967,166969,166970,2,3,0
47628,5,3,166972,166972,166975,0,3,2
47629,5,2,166977,166977,166979,0,2,2
47630,1,2,166978,166979,166981,1,3,0
47631,5,1,166983,166983,166984,0,1,2
47632,5,1,166988,166988,166989,0,1,4
47633,1,1,166989,166989,166990,0,1,0
47634,2,1,166991,166991,166992,0,1,1
47635,2,3,166993,166993,166996,0,3,1
47636,1,2,166994,166996,166998,2,4,0
47637,2,1,166996,166998,166999,2,3,0
47638,1,2,166997,166999,167001,2,4,0
47639,2,1,166999,167001,167002,2,3,0
47640,2,1,167001,167002,167003,1,2,0
47641,1,1,167002,167003,167004,1,2,0
47642,5,3,167007,167007,167010,0,3,3
47643,6,2,167013,167013,167015,0,2,3
47644,3,1,167016,167016,167017,0,1,1
47645,5,2,167021,167021,167023,0,2,4
47646,6,3,167027,167027,167030,0,3,4
47647,1,2,167028,167030,167032,2,4,0
47648,3,3,167031,167032,167035,1,4,0
47649,1,1,167032,167035,167036,3,4,0
47650,4,2,167036,167036,167038,0,2,0
47651,5,3,167041,167041,167044,0,3,3
47652,2,2,167043,167044,167046,1,3,0
47653,1,2,167044,167046,167048,2,4,0
47654,3,2,167047,167048,167050,1,3,0
47655,2,2,167049,167050,167052,1,3,0
47656,6,3,167055,167055,167058,0,3,3
47657,4,1,167059,167059,167060,0,1,1
47658,3,1,167062,167062,167063,0,1,2
47659,5,1,167067,167067,167068,0,1,4
47660,1,2,167068,167068,167070,0,2,0
47661,2,3,167070,167070,167073,0,3,0
47662,5,3,167075,167075,167078,0,3,2
47663,4,2,167079,167079,167081,0,2,1
47664,1,1,167080,167081,167082,1,2,0
47665,3,1,167083,167083,167084,0,1,1
47666,5,1,167088,167088,167089,0,1,4
47667,6,3,167094,167094,167097,0,3,5
47668,5,3,167099,167099,167102,0,3,2
47669,1,2,167100,167102,167104,2,4,0
47670,1,1,167101,167104,167105,3,4,0
47671,1,2,167102,167105,167107,3,5,0
47672,4,1,167106,167107,167108,1,2,0
47673,1,2,167107,167108,167110,1,3,0
47674,6,2,167113,167113,167115,0,2,3
47675,2,3,167115,167115,167118,0,3,0
47676,4,3,167119,167119,167122,0,3,1
47677,2,2,167121,167122,167124,1,3,0
47678,4,3,167125,167125,167128,0,3,1
47679,6,3,167131,167131,167134,0,3,3
47680,2,3,167133,167134,167137,1,4,0
47681,6,2,167139,167139,167141,0,2,2
47682,4,3,167143,167143,167146,0,3,2
47683,3,3,167146,167146,167149,0,3,0
47684,1,3,167147,167149,167152,2,5,0
47685,2,3,167149,167152,167155,3,6,0
47686,3,3,167152,167155,167158,3,6,0
47687,3,2,167155,167158,167160,3,5,0
47688,6,2,167161,167161,167163,0,2,1
47689,6,3,167167,167167,167170,0,3,4
47690,1,1,167168,167170,167171,2,3,0
47691,3,3,167171,167171,167174,0,3,0
47692,2,2,167173,167174,167176,1,3,0
47693,3,2,167176,167176,167178,0,2,0
47694,5,1,167181,167181,167182,0,1,3
47695,5,2,167186,167186,167188,0,2,4
47696,1,1,167187,167188,167189,1,2,0
47697,4,3,167191,167191,167194,0,3,2
47698,4,2,167195,167195,167197,0,2,1
47699,6,3,167201,167201,167204,0,3,4
47700,5,1,167206,167206,167207,0,1,2
47701,3,3,167209,167209,167212,0,3,2
47702,3,3,167212,167212,167215,0,3,0
47703,2,3,167214,167215,167218,1,4,0
47704,6,1,167220,167220,167221,0,1,2
47705,4,2,167224,167224,167226,0,2,3
47706,5,2,167229,167229,167231,0,2,3
47707,3,1,167232,167232,167233,0,1,1
47708,3,2,167235,167235,167237,0,2,2
47709,4,3,167239,167239,167242,0,3,2
47710,2,3,167241,167242,167245,1,4,0
47711,2,1,167243,167245,167246,2,3,0
47712,6,2,167249,167249,167251,0,2,3
47713,4,3,167253,167253,167256,0,3,2
47714,5,3,167258,167258,167261,0,3,2
47715,4,2,167262,167262,167264,0,2,1
47716,1,2,167263,167264,167266,1,3,0
47717,3,2,167266,167266,167268,0,2,0
47718,4,1,167270,167270,167271,0,1,2
47719,3,1,167273,167273,167274,0,1,2
47720,1,1,167274,167274,167275,0,1,0
47721,3,2,167277,167277,167279,0,2,2
47722,4,2,167281,167281,167283,0,2,2
47723,2,3,167283,167283,167286,0,3,0
47724,1,2,167284,167286,167288,2,4,0
47725,3,1,167287,167288,167289,1,2,0
47726,4,2,167291,167291,167293,0,2,2
47727,1,1,167292,167293,167294,1,2,0
47728,6,2,167298,167298,167300,0,2,4
47729,6,2,167304,167304,167306,0,2,4
47730,5,1,167309,167309,167310,0,1,3
47731,5,2,167314,167314,167316,0,2,4
47732,3,2,167317,167317,167319,0,2,1
47733,4,3,167321,167321,167324,0,3,2
47734,2,1,167323,167324,167325,1,2,0
47735,2,2,167325,167325,167327,0,2,0
47736,6,2,167331,167331,167333,0,2,4
47737,3,1,167334,167334,167335,0,1,1
47738,6,2,167340,167340,167342,0,2,5
47739,1,3,167341,167342,167345,1,4,0
47740,4,3,167345,167345,167348,0,3,0
47741,1,2,167346,167348,167350,2,4,0
47742,6,3,167352,167352,167355,0,3,2
47743,3,3,167355,167355,167358,0,3,0
47744,4,1,167359,167359,167360,0,1,1
47745,1,1,167360,167360,167361,0,1,0
47746,6,2,167366,167366,167368,0,2,5
47747,6,1,167372,167372,167373,0,1,4
47748,4,2,167376,167376,167378,0,2,3
47749,2,3,167378,167378,167381,0,3,0
47750,3,1,167381,167381,167382,0,1,0
47751,4,1,167385,167385,167386,0,1,3
47752,2,3,167387,167387,167390,0,3,1
47753,2,1,167389,167390,167391,1,2,0
47754,2,2,167391,167391,167393,0,2,0
47755,2,2,167393,167393,167395,0,2,0
47756,1,3,167394,167395,167398,1,4,0
47757,1,1,167395,167398,167399,3,4,0
47758,4,3,167399,167399,167402,0,3,0
47759,4,3,167403,167403,167406,0,3,1
47760,1,1,167404,167406,167407,2,3,0
47761,1,1,167405,167407,167408,2,3,0
47762,4,2,167409,167409,167411,0,2,1
47763,5,1,167414,167414,167415,0,1,3
47764,2,2,167416,167416,167418,0,2,1
47765,1,2,167417,167418,167420,1,3,0
47766,4,1,167421,167421,167422,0,1,1
47767,6,1,167427,167427,167428,0,1,5
47768,1,1,167428,167428,167429,0,1,0
47769,6,2,167434,167434,167436,0,2,5
47770,1,1,167435,167436,167437,1,2,0
47771,3,1,167438,167438,167439,0,1,1
47772,2,2,167440,167440,167442,0,2,1
47773,1,2,167441,167442,167444,1,3,0
47774,2,1,167443,167444,167445,1,2,0
47775,6,1,167449,167449,167450,0,1,4
47776,1,1,167450,167450,167451,0,1,0
47777,6,2,167456,167456,167458,0,2,5
47778,2,3,167458,167458,167461,0,3,0
47779,3,2,167461,167461,167463,0,2,0
47780,4,1,167465,167465,167466,0,1,2
47781,1,1,167466,167466,167467,0,1,0
47782,6,3,167472,167472,167475,0,3,5
47783,1,1,167473,167475,167476,2,3,0
47784,5,1,167478,167478,167479,0,1,2
47785,5,3,167483,167483,167486,0,3,4
47786,6,1,167489,167489,167490,0,1,3
47787,2,2,167491,167491,167493,0,2,1
47788,4,3,167495,167495,167498,0,3,2
47789,5,1,167500,167500,167501,0,1,2
47790,3,3,167503,167503,167506,0,3,2
47791,5,2,167508,167508,167510,0,2,2
47792,2,1,167510,167510,167511,0,1,0
47793,3,1,167513,167513,167514,0,1,2
47794,3,2,167516,167516,167518,0,2,2
47795,3,3,167519,167519,167522,0,3,1
47796,1,2,167520,167522,167524,2,4,0
47797,1,2,167521,167524,167526,3,5,0
47798,1,2,167522,167526,167528,4,6,0
47799,5,3,167527,167528,167531,1,4,0
47800,3,2,167530,167531,167533,1,3,0
47801,2,1,167532,167533,167534,1,2,0
47802,5,1,167537,167537,167538,0,1,3
47803,4,1,167541,167541,167542,0,1,3
47804,1,3,167542,167542,167545,0,3,0
47805,6,1,167548,167548,167549,0,1,3
47806,2,3,167550,167550,167553,0,3,1
47807,3,1,167553,167553,167554,0,1,0
47808,1,3,167554,167554,167557,0,3,0
47809,3,2,167557,167557,167559,0,2,0
47810,1,3,167558,167559,167562,1,4,0
47811,4,1,167562,167562,167563,0,1,0
47812,1,3,167563,167563,167566,0,3,0
47813,1,2,167564,167566,167568,2,4,0
47814,1,3,167565,167568,167571,3,6,0
47815,6,2,167571,167571,167573,0,2,0
47816,5,2,167576,167576,167578,0,2,3
47817,6,2,167582,167582,167584,0,2,4
47818,2,3,167584,167584,167587,0,3,0
47819,6,1,167590,167590,167591,0,1,3
47820,2,2,167592,167592,167594,0,2,1
47821,2,1,167594,167594,167595,0,1,0
47822,6,3,167600,167600,167603,0,3,5
47823,1,3,167601,167603,167606,2,5,0
47824,2,1,167603,167606,167607,3,4,0
47825,4,2,167607,167607,167609,0,2,0
47826,2,3,167609,167609,167612,0,3,0
47827,5,1,167614,167614,167615,0,1,2
47828,1,3,167615,167615,167618,0,3,0
47829,6,3,167621,167621,167624,0,3,3
47830,1,2,167622,167624,167626,2,4,0
47831,4,3,167626,167626,167629,0,3,0
47832,6,2,167632,167632,167634,0,2,3
47833,2,2,167634,167634,167636,0,2,0
47834,2,1,167636,167636,167637,0,1,0
47835,3,1,167639,167639,167640,0,1,2
47836,6,3,167645,167645,167648,0,3,5
47837,1,2,167646,167648,167650,2,4,0
47838,6,2,167652,167652,167654,0,2,2
47839,5,1,167657,167657,167658,0,1,3
47840,1,3,167658,167658,167661,0,3,0
47841,1,3,167659,167661,167664,2,5,0
47842,5,1,167664,167664,167665,0,1,0
47843,4,1,167668,167668,167669,0,1,3
47844,1,3,167669,167669,167672,0,3,0
47845,6,1,167675,167675,167676,0,1,3
47846,6,3,167681,167681,167684,0,3,5
47847,6,3,167687,167687,167690,0,3,3
47848,2,2,167689,167690,167692,1,3,0
47849,3,3,167692,167692,167695,0,3,0
47850,4,2,167696,167696,167698,0,2,1
47851,3,1,167699,167699,167700,0,1,1
47852,4,2,167703,167703,167705,0,2,3
47853,2,1,167705,167705,167706,0,1,0
47854,6,3,167711,167711,167714,0,3,5
47855,6,2,167717,167717,167719,0,2,3
47856,4,1,167721,167721,167722,0,1,2
47857,3,1,167724,167724,167725,0,1,2
47858,5,2,167729,167729,167731,0,2,4
47859,2,1,167731,167731,167732,0,1,0
47860,4,2,167735,167735,167737,0,2,3
47861,3,2,167738,167738,167740,0,2,1
47862,4,2,167742,167742,167744,0,2,2
47863,1,1,167743,167744,167745,1,2,0
47864,5,1,167748,167748,167749,0,1,3
47865,3,3,167751,167751,167754,0,3,2
47866,5,1,167756,167756,167757,0,1,2
47867,3,1,167759,167759,167760,0,1,2
47868,2,2,167761,167761,167763,0,2,1
47869,2,2,167763,167763,167765,0,2,0
47870,2,2,167765,167765,167767,0,2,0
47871,5,3,167770,167770,167773,0,3,3
47872,5,2,167775,167775,167777,0,2,2
47873,5,1,167780,167780,167781,0,1,3
47874,5,1,167785,167785,167786,0,1,4
47875,4,1,167789,167789,167790,0,1,3
47876,4,2,167793,167793,167795,0,2,3
47877,4,1,167797,167797,167798,0,1,2
47878,3,1,167800,167800,167801,0,1,2
47879,1,1,167801,167801,167802,0,1,0
47880,5,2,167806,167806,167808,0,2,4
47881,6,3,167812,167812,167815,0,3,4
47882,5,1,167817,167817,167818,0,1,2
47883,5,3,167822,167822,167825,0,3,4
47884,1,1,167823,167825,167826,2,3,0
47885,3,2,167826,167826,167828,0,2,0
47886,1,3,167827,167828,167831,1,4,0
47887,6,2,167833,167833,167835,0,2,2
47888,4,1,167837,167837,167838,0,1,2
47889,4,3,167841,167841,167844,0,3,3
47890,1,2,167842,167844,167846,2,4,0
47891,6,1,167848,167848,167849,0,1,2
47892,3,1,167851,167851,167852,0,1,2
47893,2,3,167853,167853,167856,0,3,1
47894,3,1,167856,167856,167857,0,1,0
47895,3,2,167859,167859,167861,0,2,2
47896,2,1,167861,167861,167862,0,1,0
47897,3,3,167864,167864,167867,0,3,2
47898,1,1,167865,167867,167868,2,3,0
47899,5,2,167870,167870,167872,0,2,2
47900,2,2,167872,167872,167874,0,2,0
47901,5,1,167877,167877,167878,0,1,3
47902,6,2,167883,167883,167885,0,2,5
47903,4,3,167887,167887,167890,0,3,2
47904,2,2,167889,167890,167892,1,3,0
47905,5,2,167894,167894,167896,0,2,2
47906,6,2,167900,167900,167902,0,2,4
47907,6,3,167906,167906,167909,0,3,4
47908,2,3,167908,167909,167912,1,4,0
47909,6,3,167914,167914,167917,0,3,2
47910,4,3,167918,167918,167921,0,3,1
47911,1,3,167919,167921,167924,2,5,0
47912,2,1,167921,167924,167925,3,4,0
47913,3,1,167924,167925,167926,1,2,0
47914,6,1,167930,167930,167931,0,1,4
47915,3,3,167933,167933,167936,0,3,2
47916,1,2,167934,167936,167938,2,4,0
47917,6,1,167940,167940,167941,0,1,2
47918,5,3,167945,167945,167948,0,3,4
47919,4,3,167949,167949,167952,0,3,1
47920,1,1,167950,167952,167953,2,3,0
47921,6,3,167956,167956,167959,0,3,3
47922,4,1,167960,167960,167961,0,1,1
47923,2,3,167962,167962,167965,0,3,1
47924,3,1,167965,167965,167966,0,1,0
47925,2,3,167967,167967,167970,0,3,1
47926,3,1,167970,167970,167971,0,1,0
47927,3,1,167973,167973,167974,0,1,2
47928,4,2,167977,167977,167979,0,2,3
47929,4,2,167981,167981,167983,0,2,2
47930,4,3,167985,167985,167988,0,3,2
47931,5,3,167990,167990,167993,0,3,2
47932,3,3,167993,167993,167996,0,3,0
47933,1,3,167994,167996,167999,2,5,0
47934,4,3,167998,167999,168002,1,4,0
47935,4,1,168002,168002,168003,0,1,0
47936,5,2,168007,168007,168009,0,2,4
47937,6,3,168013,168013,168016,0,3,4
47938,6,3,168019,168019,168022,0,3,3
47939,6,2,168025,168025,168027,0,2,3
47940,5,2,168030,168030,168032,0,2,3
47941,6,1,168036,168036,168037,0,1,4
47942,4,3,168040,168040,168043,0,3,3
47943,6,3,168046,168046,168049,0,3,3
47944,4,2,168050,168050,168052,0,2,1
47945,2,3,168052,168052,168055,0,3,0
47946,2,3,168054,168055,168058,1,4,0
47947,3,1,168057,168058,168059,1,2,0
47948,5,3,168062,168062,168065,0,3,3
47949,5,2,168067,168067,168069,0,2,2
47950,3,3,168070,168070,168073,0,3,1
47951,3,2,168073,168073,168075,0,2,0
47952,4,3,168077,168077,168080,0,3,2
47953,3,2,168080,168080,168082,0,2,0
47954,2,2,168082,168082,168084,0,2,0
47955,2,3,168084,168084,168087,0,3,0
47956,1,2,168085,168087,168089,2,4,0
47957,3,3,168088,168089,168092,1,4,0
47958,4,2,168092,168092,168094,0,2,0
47959,6,1,168098,168098,168099,0,1,4
47960,6,2,168104,168104,168106,0,2,5
47961,5,3,168109,168109,168112,0,3,3
47962,5,1,168114,168114,168115,0,1,2
47963,2,3,168116,168116,168119,0,3,1
47964,4,1,168120,168120,168121,0,1,1
47965,5,1,168125,168125,168126,0,1,4
47966,3,2,168128,168128,168130,0,2,2
47967,2,3,168130,168130,168133,0,3,0
47968,1,3,168131,168133,168136,2,5,0
47969,6,2,168137,168137,168139,0,2,1
47970,2,3,168139,168139,168142,0,3,0
47971,6,2,168145,168145,168147,0,2,3
47972,6,3,168151,168151,168154,0,3,4
47973,2,1,168153,168154,168155,1,2,0
47974,1,2,168154,168155,168157,1,3,0
47975,3,3,168157,168157,168160,0,3,0
47976,1,3,168158,168160,168163,2,5,0
47977,4,2,168162,168163,168165,1,3,0
47978,2,2,168164,168165,168167,1,3,0
47979,4,3,168168,168168,168171,0,3,1
47980,6,3,168174,168174,168177,0,3,3
47981,6,2,168180,168180,168182,0,2,3
47982,6,1,168186,168186,168187,0,1,4
47983,6,3,168192,168192,168195,0,3,5
47984,6,1,168198,168198,168199,0,1,3
47985,5,3,168203,168203,168206,0,3,4
47986,1,3,168204,168206,168209,2,5,0
47987,3,2,168207,168209,168211,2,4,0
47988,1,2,168208,168211,168213,3,5,0
47989,2,2,168210,168213,168215,3,5,0
47990,1,1,168211,168215,168216,4,5,0
47991,2,2,168213,168216,168218,3,5,0
47992,6,2,168219,168219,168221,0,2,1
47993,2,2,168221,168221,168223,0,2,0
47994,6,3,168227,168227,168230,0,3,4
47995,2,3,168229,168230,168233,1,4,0
47996,3,2,168232,168233,168235,1,3,0
47997,5,3,168237,168237,168240,0,3,2
47998,2,2,168239,168240,168242,1,3,0
47999,5,3,168244,168244,168247,0,3,2
48000,2,3,168246,168247,168250,1,4,0
48001,1,1,168247,168250,168251,3,4,0
48002,5,2,168252,168252,168254,0,2,1
48003,4,2,168256,168256,168258,0,2,2
48004,1,1,168257,168258,168259,1,2,0
48005,1,2,168258,168259,168261,1,3,0
48006,2,2,168260,168261,168263,1,3,0
48007,2,2,168262,168263,168265,1,3,0
48008,2,2,168264,168265,168267,1,3,0
48009,1,1,168265,168267,168268,2,3,0
48010,1,3,168266,168268,168271,2,5,0
48011,3,3,168269,168271,168274,2,5,0
48012,4,3,168273,168274,168277,1,4,0
48013,1,1,168274,168277,168278,3,4,0
48014,6,3,168280,168280,168283,0,3,2
48015,2,2,168282,168283,168285,1,3,0
48016,5,3,168287,168287,168290,0,3,2
48017,5,1,168292,168292,168293,0,1,2
48018,1,2,168293,168293,168295,0,2,0
48019,6,2,168299,168299,168301,0,2,4
48020,5,1,168304,168304,168305,0,1,3
48021,2,3,168306,168306,168309,0,3,1
48022,5,3,168311,168311,168314,0,3,2
48023,1,1,168312,168314,168315,2,3,0
48024,1,1,168313,168315,168316,2,3,0
48025,1,2,168314,168316,168318,2,4,0
48026,1,1,168315,168318,168319,3,4,0
48027,5,3,168320,168320,168323,0,3,1
48028,5,2,168325,168325,168327,0,2,2
48029,5,3,168330,168330,168333,0,3,3
48030,6,3,168336,168336,168339,0,3,3
48031,2,1,168338,168339,168340,1,2,0
48032,5,3,168343,168343,168346,0,3,3
48033,6,1,168349,168349,168350,0,1,3
48034,1,3,168350,168350,168353,0,3,0
48035,3,3,168353,168353,168356,0,3,0
48036,3,3,168356,168356,168359,0,3,0
48037,5,1,168361,168361,168362,0,1,2
48038,6,1,168367,168367,168368,0,1,5
48039,5,1,168372,168372,168373,0,1,4
48040,3,2,168375,168375,168377,0,2,2
48041,5,3,168380,168380,168383,0,3,3
48042,5,3,168385,168385,168388,0,3,2
48043,2,3,168387,168388,168391,1,4,0
48044,3,3,168390,168391,168394,1,4,0
48045,1,1,168391,168394,168395,3,4,0
48046,6,3,168397,168397,168400,0,3,2
48047,3,2,168400,168400,168402,0,2,0
48048,5,2,168405,168405,168407,0,2,3
48049,4,3,168409,168409,168412,0,3,2
48050,5,2,168414,168414,168416,0,2,2
48051,4,2,168418,168418,168420,0,2,2
48052,1,1,168419,168420,168421,1,2,0
48053,6,1,168425,168425,168426,0,1,4
48054,2,2,168427,168427,168429,0,2,1
48055,3,2,168430,168430,168432,0,2,1
48056,5,3,168435,168435,168438,0,3,3
48057,6,1,168441,168441,168442,0,1,3
48058,3,3,168444,168444,168447,0,3,2
48059,5,1,168449,168449,168450,0,1,2
48060,4,1,168453,168453,168454,0,1,3
48061,3,3,168456,168456,168459,0,3,2
48062,3,1,168459,168459,168460,0,1,0
48063,4,2,168463,168463,168465,0,2,3
48064,1,3,168464,168465,168468,1,4,0
48065,5,2,168469,168469,168471,0,2,1
48066,3,2,168472,168472,168474,0,2,1
48067,2,2,168474,168474,168476,0,2,0
48068,5,2,168479,168479,168481,0,2,3
48069,6,3,168485,168485,168488,0,3,4
48070,5,1,168490,168490,168491,0,1,2
48071,3,3,168493,168493,168496,0,3,2
48072,6,1,168499,168499,168500,0,1,3
48073,1,3,168500,168500,168503,0,3,0
48074,1,3,168501,168503,168506,2,5,0
48075,5,2,168506,168506,168508,0,2,0
48076,2,3,168508,168508,168511,0,3,0
48077,4,2,168512,168512,168514,0,2,1
48078,5,2,168517,168517,168519,0,2,3
48079,2,3,168519,168519,168522,0,3,0
48080,6,3,168525,168525,168528,0,3,3
48081,6,3,168531,168531,168534,0,3,3
48082,6,2,168537,168537,168539,0,2,3
48083,2,3,168539,168539,168542,0,3,0
48084,2,2,168541,168542,168544,1,3,0
48085,4,3,168545,168545,168548,0,3,1
48086,3,1,168548,168548,168549,0,1,0
48087,1,3,168549,168549,168552,0,3,0
48088,5,1,168554,168554,168555,0,1,2
48089,6,1,168560,168560,168561,0,1,5
48090,3,1,168563,168563,168564,0,1,2
48091,4,3,168567,168567,168570,0,3,3
48092,2,3,168569,168570,168573,1,4,0
48093,2,2,168571,168573,168575,2,4,0
48094,1,2,168572,168575,168577,3,5,0
48095,2,3,168574,168577,168580,3,6,0
48096,1,1,168575,168580,168581,5,6,0
48097,4,1,168579,168581,168582,2,3,0
48098,4,3,168583,168583,168586,0,3,1
48099,5,2,168588,168588,168590,0,2,2
48100,1,2,168589,168590,168592,1,3,0
48101,6,1,168595,168595,168596,0,1,3
48102,5,1,168600,168600,168601,0,1,4
48103,6,1,168606,168606,168607,0,1,5
48104,2,1,168608,168608,168609,0,1,1
48105,2,1,168610,168610,168611,0,1,1
48106,5,3,168615,168615,168618,0,3,4
48107,1,2,168616,168618,168620,2,4,0
48108,6,3,168622,168622,168625,0,3,2
48109,1,2,168623,168625,168627,2,4,0
48110,2,1,168625,168627,168628,2,3,0
48111,2,1,168627,168628,168629,1,2,0
48112,5,1,168632,168632,168633,0,1,3
48113,1,1,168633,168633,168634,0,1,0
48114,2,1,168635,168635,168636,0,1,1
48115,5,2,168640,168640,168642,0,2,4
48116,1,2,168641,168642,168644,1,3,0
48117,5,2,168646,168646,168648,0,2,2
48118,3,2,168649,168649,168651,0,2,1
48119,2,3,168651,168651,168654,0,3,0
48120,4,1,168655,168655,168656,0,1,1
48121,6,3,168661,168661,168664,0,3,5
48122,3,2,168664,168664,168666,0,2,0
48123,2,3,168666,168666,168669,0,3,0
48124,2,3,168668,168669,168672,1,4,0
48125,3,2,168671,168672,168674,1,3,0
48126,5,3,168676,168676,168679,0,3,2
48127,4,3,168680,168680,168683,0,3,1
48128,6,3,168686,168686,168689,0,3,3
48129,3,3,168689,168689,168692,0,3,0
48130,1,2,168690,168692,168694,2,4,0
48131,2,2,168692,168694,168696,2,4,0
48132,5,1,168697,168697,168698,0,1,1
48133,4,2,168701,168701,168703,0,2,3
48134,1,3,168702,168703,168706,1,4,0
48135,3,1,168705,168706,168707,1,2,0
48136,2,1,168707,168707,168708,0,1,0
48137,2,1,168709,168709,168710,0,1,1
48138,5,1,168714,168714,168715,0,1,4
48139,3,3,168717,168717,168720,0,3,2
48140,1,2,168718,168720,168722,2,4,0
48141,4,3,168722,168722,168725,0,3,0
48142,4,1,168726,168726,168727,0,1,1
48143,6,2,168732,168732,168734,0,2,5
48144,5,2,168737,168737,168739,0,2,3
48145,6,2,168743,168743,168745,0,2,4
48146,3,2,168746,168746,168748,0,2,1
48147,3,3,168749,168749,168752,0,3,1
48148,1,1,168750,168752,168753,2,3,0
48149,5,2,168755,168755,168757,0,2,2
48150,1,2,168756,168757,168759,1,3,0
48151,1,1,168757,168759,168760,2,3,0
48152,1,2,168758,168760,168762,2,4,0
48153,4,3,168762,168762,168765,0,3,0
48154,6,2,168768,168768,168770,0,2,3
48155,1,1,168769,168770,168771,1,2,0
48156,4,3,168773,168773,168776,0,3,2
48157,1,2,168774,168776,168778,2,4,0
48158,4,1,168778,168778,168779,0,1,0
48159,1,3,168779,168779,168782,0,3,0
48160,1,2,168780,168782,168784,2,4,0
48161,4,2,168784,168784,168786,0,2,0
48162,5,3,168789,168789,168792,0,3,3
48163,3,1,168792,168792,168793,0,1,0
48164,6,3,168798,168798,168801,0,3,5
48165,6,1,168804,168804,168805,0,1,3
48166,3,1,168807,168807,168808,0,1,2
48167,4,1,168811,168811,168812,0,1,3
48168,3,3,168814,168814,168817,0,3,2
48169,5,3,168819,168819,168822,0,3,2
48170,1,3,168820,168822,168825,2,5,0
48171,6,3,168826,168826,168829,0,3,1
48172,3,3,168829,168829,168832,0,3,0
48173,4,2,168833,168833,168835,0,2,1
48174,3,1,168836,168836,168837,0,1,1
48175,6,1,168842,168842,168843,0,1,5
48176,5,1,168847,168847,168848,0,1,4
48177,1,3,168848,168848,168851,0,3,0
48178,3,2,168851,168851,168853,0,2,0
48179,2,1,168853,168853,168854,0,1,0
48180,2,2,168855,168855,168857,0,2,1
48181,1,2,168856,168857,168859,1,3,0
48182,1,3,168857,168859,168862,2,5,0
48183,4,2,168861,168862,168864,1,3,0
48184,2,3,168863,168864,168867,1,4,0
48185,6,1,168869,168869,168870,0,1,2
48186,2,3,168871,168871,168874,0,3,1
48187,2,1,168873,168874,168875,1,2,0
48188,4,2,168877,168877,168879,0,2,2
48189,4,2,168881,168881,168883,0,2,2
48190,6,2,168887,168887,168889,0,2,4
48191,6,3,168893,168893,168896,0,3,4
48192,4,3,168897,168897,168900,0,3,1
48193,4,2,168901,168901,168903,0,2,1
48194,4,2,168905,168905,168907,0,2,2
48195,5,3,168910,168910,168913,0,3,3
48196,2,3,168912,168913,168916,1,4,0
48197,1,3,168913,168916,168919,3,6,0
48198,1,1,168914,168919,168920,5,6,0
48199,2,1,168916,168920,168921,4,5,0
48200,4,2,168920,168921,168923,1,3,0
48201,4,1,168924,168924,168925,0,1,1
48202,1,1,168925,168925,168926,0,1,0
48203,6,1,168931,168931,168932,0,1,5
48204,4,2,168935,168935,168937,0,2,3
48205,5,2,168940,168940,168942,0,2,3
48206,5,3,168945,168945,168948,0,3,3
48207,1,2,168946,168948,168950,2,4,0
48208,5,2,168951,168951,168953,0,2,1
48209,6,3,168957,168957,168960,0,3,4
48210,6,2,168963,168963,168965,0,2,3
48211,5,2,168968,168968,168970,0,2,3
48212,3,3,168971,168971,168974,0,3,1
48213,6,2,168977,168977,168979,0,2,3
48214,3,3,168980,168980,168983,0,3,1
48215,6,3,168986,168986,168989,0,3,3
48216,5,2,168991,168991,168993,0,2,2
48217,3,3,168994,168994,168997,0,3,1
48218,6,2,169000,169000,169002,0,2,3
48219,3,1,169003,169003,169004,0,1,1
48220,6,1,169009,169009,169010,0,1,5
48221,3,1,169012,169012,169013,0,1,2
48222,5,2,169017,169017,169019,0,2,4
48223,3,3,169020,169020,169023,0,3,1
48224,2,2,169022,169023,169025,1,3,0
48225,6,2,169028,169028,169030,0,2,3
48226,1,1,169029,169030,169031,1,2,0
48227,2,3,169031,169031,169034,0,3,0
48228,4,2,169035,169035,169037,0,2,1
48229,4,1,169039,169039,169040,0,1,2
48230,2,1,169041,169041,169042,0,1,1
48231,6,3,169047,169047,169050,0,3,5
48232,5,1,169052,169052,169053,0,1,2
48233,5,3,169057,169057,169060,0,3,4
48234,4,1,169061,169061,169062,0,1,1
48235,6,3,169067,169067,169070,0,3,5
48236,4,2,169071,169071,169073,0,2,1
48237,5,2,169076,169076,169078,0,2,3
48238,4,3,169080,169080,169083,0,3,2
48239,6,3,169086,169086,169089,0,3,3
48240,6,2,169092,169092,169094,0,2,3
48241,2,3,169094,169094,169097,0,3,0
48242,1,3,169095,169097,169100,2,5,0
48243,1,3,169096,169100,169103,4,7,0
48244,2,1,169098,169103,169104,5,6,0
48245,1,3,169099,169104,169107,5,8,0
48246,3,2,169102,169107,169109,5,7,0
48247,2,3,169104,169109,169112,5,8,0
48248,1,2,169105,169112,169114,7,9,0
48249,5,2,169110,169114,169116,4,6,0
48250,4,1,169114,169116,169117,2,3,0
48251,3,3,169117,169117,169120,0,3,0
48252,2,1,169119,169120,169121,1,2,0
48253,5,3,169124,169124,169127,0,3,3
48254,5,1,169129,169129,169130,0,1,2
48255,3,3,169132,169132,169135,0,3,2
48256,2,2,169134,169135,169137,1,3,0
48257,2,3,169136,169137,169140,1,4,0
48258,1,2,169137,169140,169142,3,5,0
48259,4,2,169141,169142,169144,1,3,0
48260,6,1,169147,169147,169148,0,1,3
48261,2,3,169149,169149,169152,0,3,1
48262,3,1,169152,169152,169153,0,1,0
48263,1,3,169153,169153,169156,0,3,0
48264,5,3,169158,169158,169161,0,3,2
48265,1,2,169159,169161,169163,2,4,0
48266,1,1,169160,169163,169164,3,4,0
48267,2,2,169162,169164,169166,2,4,0
48268,6,3,169168,169168,169171,0,3,2
48269,5,3,169173,169173,169176,0,3,2
48270,3,2,169176,169176,169178,0,2,0
48271,4,3,169180,169180,169183,0,3,2
48272,6,2,169186,169186,169188,0,2,3
48273,3,3,169189,169189,169192,0,3,1
48274,6,2,169195,169195,169197,0,2,3
48275,2,1,169197,169197,169198,0,1,0
48276,2,2,169199,169199,169201,0,2,1
48277,4,3,169203,169203,169206,0,3,2
48278,3,1,169206,169206,169207,0,1,0
48279,4,3,169210,169210,169213,0,3,3
48280,2,2,169212,169213,169215,1,3,0
48281,5,3,169217,169217,169220,0,3,2
48282,4,2,169221,169221,169223,0,2,1
48283,3,1,169224,169224,169225,0,1,1
48284,2,2,169226,169226,169228,0,2,1
48285,5,1,169231,169231,169232,0,1,3
48286,5,1,169236,169236,169237,0,1,4
48287,3,2,169239,169239,169241,0,2,2
48288,3,3,169242,169242,169245,0,3,1
48289,3,2,169245,169245,169247,0,2,0
48290,1,3,169246,169247,169250,1,4,0
48291,1,1,169247,169250,169251,3,4,0
48292,4,1,169251,169251,169252,0,1,0
48293,6,3,169257,169257,169260,0,3,5
48294,2,2,169259,169260,169262,1,3,0
48295,5,3,169264,169264,169267,0,3,2
48296,5,1,169269,169269,169270,0,1,2
48297,1,1,169270,169270,169271,0,1,0
48298,5,2,169275,169275,169277,0,2,4
48299,2,1,169277,169277,169278,0,1,0
48300,4,2,169281,169281,169283,0,2,3
48301,5,3,169286,169286,169289,0,3,3
48302,6,1,169292,169292,169293,0,1,3
48303,5,3,169297,169297,169300,0,3,4
48304,6,1,169303,169303,169304,0,1,3
48305,2,1,169305,169305,169306,0,1,1
48306,5,2,169310,169310,169312,0,2,4
48307,1,3,169311,169312,169315,1,4,0
48308,5,3,169316,169316,169319,0,3,1
48309,1,3,169317,169319,169322,2,5,0
48310,2,1,169319,169322,169323,3,4,0
48311,1,3,169320,169323,169326,3,6,0
48312,2,2,169322,169326,169328,4,6,0
48313,6,3,169328,169328,169331,0,3,0
48314,4,1,169332,169332,169333,0,1,1
48315,2,1,169334,169334,169335,0,1,1
48316,6,1,169340,169340,169341,0,1,5
48317,5,2,169345,169345,169347,0,2,4
48318,5,2,169350,169350,169352,0,2,3
48319,2,1,169352,169352,169353,0,1,0
48320,5,1,169357,169357,169358,0,1,4
48321,6,3,169363,169363,169366,0,3,5
48322,6,1,169369,169369,169370,0,1,3
48323,2,2,169371,169371,169373,0,2,1
48324,3,3,169374,169374,169377,0,3,1
48325,5,1,169379,169379,169380,0,1,2
48326,2,3,169381,169381,169384,0,3,1
48327,2,3,169383,169384,169387,1,4,0
48328,3,3,169386,169387,169390,1,4,0
48329,1,2,169387,169390,169392,3,5,0
48330,4,2,169391,169392,169394,1,3,0
48331,6,1,169397,169397,169398,0,1,3
48332,2,3,169399,169399,169402,0,3,1
48333,4,1,169403,169403,169404,0,1,1
48334,3,2,169406,169406,169408,0,2,2
48335,1,3,169407,169408,169411,1,4,0
48336,5,2,169412,169412,169414,0,2,1
48337,3,1,169415,169415,169416,0,1,1
48338,1,3,169416,169416,169419,0,3,0
48339,1,2,169417,169419,169421,2,4,0
48340,4,3,169421,169421,169424,0,3,0
48341,6,2,169427,169427,169429,0,2,3
48342,6,2,169433,169433,169435,0,2,4
48343,3,2,169436,169436,169438,0,2,1
48344,6,2,169442,169442,169444,0,2,4
48345,3,3,169445,169445,169448,0,3,1
48346,4,2,169449,169449,169451,0,2,1
48347,4,3,169453,169453,169456,0,3,2
48348,6,3,169459,169459,169462,0,3,3
48349,3,1,169462,169462,169463,0,1,0
48350,2,1,169464,169464,169465,0,1,1
48351,6,1,169470,169470,169471,0,1,5
48352,3,3,169473,169473,169476,0,3,2
48353,4,3,169477,169477,169480,0,3,1
48354,2,3,169479,169480,169483,1,4,0
48355,3,2,169482,169483,169485,1,3,0
48356,6,3,169488,169488,169491,0,3,3
48357,3,2,169491,169491,169493,0,2,0
48358,2,1,169493,169493,169494,0,1,0
48359,6,2,169499,169499,169501,0,2,5
48360,1,3,169500,169501,169504,1,4,0
48361,5,2,169505,169505,169507,0,2,1
48362,6,3,169511,169511,169514,0,3,4
48363,6,2,169517,169517,169519,0,2,3
48364,4,3,169521,169521,169524,0,3,2
48365,3,2,169524,169524,169526,0,2,0
48366,5,3,169529,169529,169532,0,3,3
48367,3,1,169532,169532,169533,0,1,0
48368,1,1,169533,169533,169534,0,1,0
48369,2,1,169535,169535,169536,0,1,1
48370,6,3,169541,169541,169544,0,3,5
48371,4,2,169545,169545,169547,0,2,1
48372,2,1,169547,169547,169548,0,1,0
48373,2,2,169549,169549,169551,0,2,1
48374,6,1,169555,169555,169556,0,1,4
48375,2,2,169557,169557,169559,0,2,1
48376,4,1,169561,169561,169562,0,1,2
48377,1,3,169562,169562,169565,0,3,0
48378,1,3,169563,169565,169568,2,5,0
48379,4,2,169567,169568,169570,1,3,0
48380,4,3,169571,169571,169574,0,3,1
48381,3,1,169574,169574,169575,0,1,0
48382,2,1,169576,169576,169577,0,1,1
48383,2,3,169578,169578,169581,0,3,1
48384,4,1,169582,169582,169583,0,1,1
48385,6,2,169588,169588,169590,0,2,5
48386,1,3,169589,169590,169593,1,4,0
48387,1,1,169590,169593,169594,3,4,0
48388,1,2,169591,169594,169596,3,5,0
48389,4,3,169595,169596,169599,1,4,0
48390,3,2,169598,169599,169601,1,3,0
48391,1,1,169599,169601,169602,2,3,0
48392,3,2,169602,169602,169604,0,2,0
48393,5,3,169607,169607,169610,0,3,3
48394,1,2,169608,169610,169612,2,4,0
48395,3,2,169611,169612,169614,1,3,0
48396,2,1,169613,169614,169615,1,2,0
48397,4,2,169617,169617,169619,0,2,2
48398,4,1,169621,169621,169622,0,1,2
48399,1,1,169622,169622,169623,0,1,0
48400,1,3,169623,169623,169626,0,3,0
48401,6,3,169629,169629,169632,0,3,3
48402,3,2,169632,169632,169634,0,2,0
48403,5,2,169637,169637,169639,0,2,3
48404,5,1,169642,169642,169643,0,1,3
48405,4,2,169646,169646,169648,0,2,3
48406,1,3,169647,169648,169651,1,4,0
48407,5,3,169652,169652,169655,0,3,1
48408,5,1,169657,169657,169658,0,1,2
48409,6,1,169663,169663,169664,0,1,5
48410,5,2,169668,169668,169670,0,2,4
48411,1,2,169669,169670,169672,1,3,0
48412,3,2,169672,169672,169674,0,2,0
48413,3,1,169675,169675,169676,0,1,1
48414,5,3,169680,169680,169683,0,3,4
48415,1,2,169681,169683,169685,2,4,0
48416,3,2,169684,169685,169687,1,3,0
48417,6,2,169690,169690,169692,0,2,3
48418,1,2,169691,169692,169694,1,3,0
48419,1,2,169692,169694,169696,2,4,0
48420,6,3,169698,169698,169701,0,3,2
48421,4,3,169702,169702,169705,0,3,1
48422,1,2,169703,169705,169707,2,4,0
48423,4,2,169707,169707,169709,0,2,0
48424,5,3,169712,169712,169715,0,3,3
48425,1,3,169713,169715,169718,2,5,0
48426,5,2,169718,169718,169720,0,2,0
48427,6,2,169724,169724,169726,0,2,4
48428,1,3,169725,169726,169729,1,4,0
48429,4,3,169729,169729,169732,0,3,0
48430,4,1,169733,169733,169734,0,1,1
48431,3,2,169736,169736,169738,0,2,2
48432,2,1,169738,169738,169739,0,1,0
48433,3,1,169741,169741,169742,0,1,2
48434,2,1,169743,169743,169744,0,1,1
48435,5,2,169748,169748,169750,0,2,4
48436,4,3,169752,169752,169755,0,3,2
48437,5,2,169757,169757,169759,0,2,2
48438,1,1,169758,169759,169760,1,2,0
48439,4,1,169762,169762,169763,0,1,2
48440,1,2,169763,169763,169765,0,2,0
48441,2,1,169765,169765,169766,0,1,0
48442,1,2,169766,169766,169768,0,2,0
48443,6,3,169772,169772,169775,0,3,4
48444,1,2,169773,169775,169777,2,4,0
48445,2,3,169775,169777,169780,2,5,0
48446,3,2,169778,169780,169782,2,4,0
48447,4,1,169782,169782,169783,0,1,0
48448,3,1,169785,169785,169786,0,1,2
48449,5,3,169790,169790,169793,0,3,4
48450,6,1,169796,169796,169797,0,1,3
48451,4,2,169800,169800,169802,0,2,3
48452,1,2,169801,169802,169804,1,3,0
48453,5,2,169806,169806,169808,0,2,2
48454,6,2,169812,169812,169814,0,2,4
48455,6,2,169818,169818,169820,0,2,4
48456,4,1,169822,169822,169823,0,1,2
48457,4,2,169826,169826,169828,0,2,3
48458,4,1,169830,169830,169831,0,1,2
48459,6,2,169836,169836,169838,0,2,5
48460,4,1,169840,169840,169841,0,1,2
48461,5,3,169845,169845,169848,0,3,4
48462,1,3,169846,169848,169851,2,5,0
48463,3,1,169849,169851,169852,2,3,0
48464,2,1,169851,169852,169853,1,2,0
48465,6,1,169857,169857,169858,0,1,4
48466,1,3,169858,169858,169861,0,3,0
48467,3,2,169861,169861,169863,0,2,0
48468,4,1,169865,169865,169866,0,1,2
48469,5,1,169870,169870,169871,0,1,4
48470,3,1,169873,169873,169874,0,1,2
48471,3,2,169876,169876,169878,0,2,2
48472,3,2,169879,169879,169881,0,2,1
48473,4,3,169883,169883,169886,0,3,2
48474,5,3,169888,169888,169891,0,3,2
48475,5,3,169893,169893,169896,0,3,2
48476,3,2,169896,169896,169898,0,2,0
48477,4,1,169900,169900,169901,0,1,2
48478,6,2,169906,169906,169908,0,2,5
48479,2,3,169908,169908,169911,0,3,0
48480,3,1,169911,169911,169912,0,1,0
48481,5,3,169916,169916,169919,0,3,4
48482,5,3,169921,169921,169924,0,3,2
48483,4,1,169925,169925,169926,0,1,1
48484,2,2,169927,169927,169929,0,2,1
48485,5,1,169932,169932,169933,0,1,3
48486,5,3,169937,169937,169940,0,3,4
48487,1,3,169938,169940,169943,2,5,0
48488,1,2,169939,169943,169945,4,6,0
48489,3,2,169942,169945,169947,3,5,0
48490,3,1,169945,169947,169948,2,3,0
48491,3,1,169948,169948,169949,0,1,0
48492,6,2,169954,169954,169956,0,2,5
48493,5,1,169959,169959,169960,0,1,3
48494,6,1,169965,169965,169966,0,1,5
48495,5,1,169970,169970,169971,0,1,4
48496,6,2,169976,169976,169978,0,2,5
48497,3,1,169979,169979,169980,0,1,1
48498,3,2,169982,169982,169984,0,2,2
48499,1,2,169983,169984,169986,1,3,0
48500,1,2,169984,169986,169988,2,4,0
48501,2,1,169986,169988,169989,2,3,0
48502,6,2,169992,169992,169994,0,2,3
48503,2,2,169994,169994,169996,0,2,0
48504,4,3,169998,169998,170001,0,3,2
48505,4,2,170002,170002,170004,0,2,1
48506,5,2,170007,170007,170009,0,2,3
48507,6,3,170013,170013,170016,0,3,4
48508,6,3,170019,170019,170022,0,3,3
48509,6,3,170025,170025,170028,0,3,3
48510,5,3,170030,170030,170033,0,3,2
48511,3,1,170033,170033,170034,0,1,0
48512,6,2,170039,170039,170041,0,2,5
48513,2,1,170041,170041,170042,0,1,0
48514,3,1,170044,170044,170045,0,1,2
48515,6,3,170050,170050,170053,0,3,5
48516,5,1,170055,170055,170056,0,1,2
48517,5,1,170060,170060,170061,0,1,4
48518,6,3,170066,170066,170069,0,3,5
48519,4,1,170070,170070,170071,0,1,1
48520,3,2,170073,170073,170075,0,2,2
48521,1,1,170074,170075,170076,1,2,0
48522,4,1,170078,170078,170079,0,1,2
48523,3,2,170081,170081,170083,0,2,2
48524,4,1,170085,170085,170086,0,1,2
48525,4,3,170089,170089,170092,0,3,3
48526,1,1,170090,170092,170093,2,3,0
48527,6,1,170096,170096,170097,0,1,3
48528,4,1,170100,170100,170101,0,1,3
48529,6,3,170106,170106,170109,0,3,5
48530,6,3,170112,170112,170115,0,3,3
48531,4,1,170116,170116,170117,0,1,1
48532,5,2,170121,170121,170123,0,2,4
48533,6,1,170127,170127,170128,0,1,4
48534,5,3,170132,170132,170135,0,3,4
48535,5,3,170137,170137,170140,0,3,2
48536,4,2,170141,170141,170143,0,2,1
48537,6,1,170147,170147,170148,0,1,4
48538,1,2,170148,170148,170150,0,2,0
48539,1,2,170149,170150,170152,1,3,0
48540,2,2,170151,170152,170154,1,3,0
48541,4,1,170155,170155,170156,0,1,1
48542,4,1,170159,170159,170160,0,1,3
48543,4,1,170163,170163,170164,0,1,3
48544,1,1,170164,170164,170165,0,1,0
48545,2,1,170166,170166,170167,0,1,1
48546,3,2,170169,170169,170171,0,2,2
48547,2,1,170171,170171,170172,0,1,0
48548,3,1,170174,170174,170175,0,1,2
48549,2,1,170176,170176,170177,0,1,1
48550,1,1,170177,170177,170178,0,1,0
48551,4,3,170181,170181,170184,0,3,3
48552,6,1,170187,170187,170188,0,1,3
48553,2,1,170189,170189,170190,0,1,1
48554,5,2,170194,170194,170196,0,2,4
48555,3,3,170197,170197,170200,0,3,1
48556,2,1,170199,170200,170201,1,2,0
48557,2,2,170201,170201,170203,0,2,0
48558,3,3,170204,170204,170207,0,3,1
48559,3,1,170207,170207,170208,0,1,0
48560,2,1,170209,170209,170210,0,1,1
48561,5,2,170214,170214,170216,0,2,4
48562,4,2,170218,170218,170220,0,2,2
48563,4,3,170222,170222,170225,0,3,2
48564,3,2,170225,170225,170227,0,2,0
48565,3,1,170228,170228,170229,0,1,1
48566,3,1,170231,170231,170232,0,1,2
48567,1,1,170232,170232,170233,0,1,0
48568,3,3,170235,170235,170238,0,3,2
48569,2,2,170237,170238,170240,1,3,0
48570,6,1,170243,170243,170244,0,1,3
48571,5,3,170248,170248,170251,0,3,4
48572,4,3,170252,170252,170255,0,3,1
48573,1,2,170253,170255,170257,2,4,0
48574,5,1,170258,170258,170259,0,1,1
48575,2,2,170260,170260,170262,0,2,1
48576,1,1,170261,170262,170263,1,2,0
48577,6,2,170267,170267,170269,0,2,4
48578,4,2,170271,170271,170273,0,2,2
48579,5,2,170276,170276,170278,0,2,3
48580,2,2,170278,170278,170280,0,2,0
48581,3,1,170281,170281,170282,0,1,1
48582,3,3,170284,170284,170287,0,3,2
48583,5,1,170289,170289,170290,0,1,2
48584,2,2,170291,170291,170293,0,2,1
48585,3,3,170294,170294,170297,0,3,1
48586,5,2,170299,170299,170301,0,2,2
48587,3,1,170302,170302,170303,0,1,1
48588,1,3,170303,170303,170306,0,3,0
48589,4,3,170307,170307,170310,0,3,1
48590,4,2,170311,170311,170313,0,2,1
48591,3,3,170314,170314,170317,0,3,1
48592,2,2,170316,170317,170319,1,3,0
48593,1,2,170317,170319,170321,2,4,0
48594,1,3,170318,170321,170324,3,6,0
48595,2,1,170320,170324,170325,4,5,0
48596,4,1,170324,170325,170326,1,2,0
48597,3,2,170327,170327,170329,0,2,1
48598,5,1,170332,170332,170333,0,1,3
48599,1,1,170333,170333,170334,0,1,0
48600,4,1,170337,170337,170338,0,1,3
48601,6,3,170343,170343,170346,0,3,5
48602,5,2,170348,170348,170350,0,2,2
48603,4,1,170352,170352,170353,0,1,2
48604,6,3,170358,170358,170361,0,3,5
48605,6,3,170364,170364,170367,0,3,3
48606,1,3,170365,170367,170370,2,5,0
48607,6,3,170371,170371,170374,0,3,1
48608,6,1,170377,170377,170378,0,1,3
48609,5,2,170382,170382,170384,0,2,4
48610,4,2,170386,170386,170388,0,2,2
48611,4,2,170390,170390,170392,0,2,2
48612,6,3,170396,170396,170399,0,3,4
48613,1,3,170397,170399,170402,2,5,0
48614,3,3,170400,170402,170405,2,5,0
48615,4,3,170404,170405,170408,1,4,0
48616,4,1,170408,170408,170409,0,1,0
48617,2,2,170410,170410,170412,0,2,1
48618,2,3,170412,170412,170415,0,3,0
48619,4,2,170416,170416,170418,0,2,1
48620,6,2,170422,170422,170424,0,2,4
48621,1,2,170423,170424,170426,1,3,0
48622,4,2,170427,170427,170429,0,2,1
48623,1,2,170428,170429,170431,1,3,0
48624,1,2,170429,170431,170433,2,4,0
48625,2,1,170431,170433,170434,2,3,0
48626,5,3,170436,170436,170439,0,3,2
48627,2,1,170438,170439,170440,1,2,0
48628,2,2,170440,170440,170442,0,2,0
48629,1,1,170441,170442,170443,1,2,0
48630,3,3,170444,170444,170447,0,3,1
48631,4,1,170448,170448,170449,0,1,1
48632,1,2,170449,170449,170451,0,2,0
48633,3,3,170452,170452,170455,0,3,1
48634,4,3,170456,170456,170459,0,3,1
48635,5,1,170461,170461,170462,0,1,2
48636,5,2,170466,170466,170468,0,2,4
48637,1,3,170467,170468,170471,1,4,0
48638,3,2,170470,170471,170473,1,3,0
48639,6,2,170476,170476,170478,0,2,3
48640,1,2,170477,170478,170480,1,3,0
48641,4,3,170481,170481,170484,0,3,1
48642,3,3,170484,170484,170487,0,3,0
48643,2,3,170486,170487,170490,1,4,0
48644,1,2,170487,170490,170492,3,5,0
48645,6,2,170493,170493,170495,0,2,1
48646,4,2,170497,170497,170499,0,2,2
48647,1,1,170498,170499,170500,1,2,0
48648,5,3,170503,170503,170506,0,3,3
48649,2,2,170505,170506,170508,1,3,0
48650,3,1,170508,170508,170509,0,1,0
48651,6,2,170514,170514,170516,0,2,5
48652,1,1,170515,170516,170517,1,2,0
48653,4,3,170519,170519,170522,0,3,2
48654,6,2,170525,170525,170527,0,2,3
48655,2,1,170527,170527,170528,0,1,0
48656,3,1,170530,170530,170531,0,1,2
48657,2,3,170532,170532,170535,0,3,1
48658,5,3,170537,170537,170540,0,3,2
48659,1,3,170538,170540,170543,2,5,0
48660,5,1,170543,170543,170544,0,1,0
48661,1,2,170544,170544,170546,0,2,0
48662,6,3,170550,170550,170553,0,3,4
48663,1,1,170551,170553,170554,2,3,0
48664,6,1,170557,170557,170558,0,1,3
48665,4,2,170561,170561,170563,0,2,3
48666,3,2,170564,170564,170566,0,2,1
48667,5,3,170569,170569,170572,0,3,3
48668,2,2,170571,170572,170574,1,3,0
48669,6,3,170577,170577,170580,0,3,3
48670,1,1,170578,170580,170581,2,3,0
48671,6,3,170584,170584,170587,0,3,3
48672,3,3,170587,170587,170590,0,3,0
48673,1,3,170588,170590,170593,2,5,0
48674,1,1,170589,170593,170594,4,5,0
48675,2,3,170591,170594,170597,3,6,0
48676,2,2,170593,170597,170599,4,6,0
48677,5,3,170598,170599,170602,1,4,0
48678,3,2,170601,170602,170604,1,3,0
48679,3,1,170604,170604,170605,0,1,0
48680,5,3,170609,170609,170612,0,3,4
48681,1,2,170610,170612,170614,2,4,0
48682,1,2,170611,170614,170616,3,5,0
48683,6,1,170617,170617,170618,0,1,1
48684,6,2,170623,170623,170625,0,2,5
48685,2,2,170625,170625,170627,0,2,0
48686,2,1,170627,170627,170628,0,1,0
48687,2,1,170629,170629,170630,0,1,1
48688,3,2,170632,170632,170634,0,2,2
48689,2,2,170634,170634,170636,0,2,0
48690,3,2,170637,170637,170639,0,2,1
48691,6,3,170643,170643,170646,0,3,4
48692,4,1,170647,170647,170648,0,1,1
48693,3,3,170650,170650,170653,0,3,2
48694,4,1,170654,170654,170655,0,1,1
48695,6,3,170660,170660,170663,0,3,5
48696,4,2,170664,170664,170666,0,2,1
48697,2,1,170666,170666,170667,0,1,0
48698,1,3,170667,170667,170670,0,3,0
48699,2,3,170669,170670,170673,1,4,0
48700,2,1,170671,170673,170674,2,3,0
48701,1,3,170672,170674,170677,2,5,0
48702,2,1,170674,170677,170678,3,4,0
48703,4,3,170678,170678,170681,0,3,0
48704,6,3,170684,170684,170687,0,3,3
48705,4,1,170688,170688,170689,0,1,1
48706,3,1,170691,170691,170692,0,1,2
48707,5,2,170696,170696,170698,0,2,4
48708,4,2,170700,170700,170702,0,2,2
48709,6,3,170706,170706,170709,0,3,4
48710,4,3,170710,170710,170713,0,3,1
48711,6,3,170716,170716,170719,0,3,3
48712,4,3,170720,170720,170723,0,3,1
48713,4,3,170724,170724,170727,0,3,1
48714,2,3,170726,170727,170730,1,4,0
48715,1,1,170727,170730,170731,3,4,0
48716,1,1,170728,170731,170732,3,4,0
48717,6,3,170734,170734,170737,0,3,2
48718,6,2,170740,170740,170742,0,2,3
48719,5,2,170745,170745,170747,0,2,3
48720,5,3,170750,170750,170753,0,3,3
48721,3,3,170753,170753,170756,0,3,0
48722,4,1,170757,170757,170758,0,1,1
48723,2,2,170759,170759,170761,0,2,1
48724,6,1,170765,170765,170766,0,1,4
48725,5,1,170770,170770,170771,0,1,4
48726,1,2,170771,170771,170773,0,2,0
48727,5,2,170776,170776,170778,0,2,3
48728,4,1,170780,170780,170781,0,1,2
48729,2,3,170782,170782,170785,0,3,1
48730,2,3,170784,170785,170788,1,4,0
48731,2,3,170786,170788,170791,2,5,0
48732,1,2,170787,170791,170793,4,6,0
48733,1,3,170788,170793,170796,5,8,0
48734,6,1,170794,170796,170797,2,3,0
48735,5,1,170799,170799,170800,0,1,2
48736,4,1,170803,170803,170804,0,1,3
48737,3,3,170806,170806,170809,0,3,2
48738,3,1,170809,170809,170810,0,1,0
48739,2,2,170811,170811,170813,0,2,1
48740,4,2,170815,170815,170817,0,2,2
48741,2,1,170817,170817,170818,0,1,0
48742,2,2,170819,170819,170821,0,2,1
48743,5,2,170824,170824,170826,0,2,3
48744,4,2,170828,170828,170830,0,2,2
48745,4,1,170832,170832,170833,0,1,2
48746,2,2,170834,170834,170836,0,2,1
48747,5,2,170839,170839,170841,0,2,3
48748,5,3,170844,170844,170847,0,3,3
48749,6,3,170850,170850,170853,0,3,3
48750,1,3,170851,170853,170856,2,5,0
48751,6,1,170857,170857,170858,0,1,1
48752,5,3,170862,170862,170865,0,3,4
48753,4,1,170866,170866,170867,0,1,1
48754,3,3,170869,170869,170872,0,3,2
48755,3,3,170872,170872,170875,0,3,0
48756,2,1,170874,170875,170876,1,2,0
48757,6,2,170880,170880,170882,0,2,4
48758,1,2,170881,170882,170884,1,3,0
48759,4,2,170885,170885,170887,0,2,1
48760,1,1,170886,170887,170888,1,2,0
48761,2,1,170888,170888,170889,0,1,0
48762,4,3,170892,170892,170895,0,3,3
48763,6,2,170898,170898,170900,0,2,3
48764,2,2,170900,170900,170902,0,2,0
48765,5,1,170905,170905,170906,0,1,3
48766,1,2,170906,170906,170908,0,2,0
48767,2,1,170908,170908,170909,0,1,0
48768,5,3,170913,170913,170916,0,3,4
48769,3,1,170916,170916,170917,0,1,0
48770,5,3,170921,170921,170924,0,3,4
48771,5,1,170926,170926,170927,0,1,2
48772,6,1,170932,170932,170933,0,1,5
48773,2,2,170934,170934,170936,0,2,1
48774,4,2,170938,170938,170940,0,2,2
48775,1,2,170939,170940,170942,1,3,0
48776,6,2,170945,170945,170947,0,2,3
48777,6,1,170951,170951,170952,0,1,4
48778,3,3,170954,170954,170957,0,3,2
48779,4,3,170958,170958,170961,0,3,1
48780,4,2,170962,170962,170964,0,2,1
48781,5,1,170967,170967,170968,0,1,3
48782,4,2,170971,170971,170973,0,2,3
48783,4,3,170975,170975,170978,0,3,2
48784,5,2,170980,170980,170982,0,2,2
48785,3,1,170983,170983,170984,0,1,1
48786,1,2,170984,170984,170986,0,2,0
48787,1,2,170985,170986,170988,1,3,0
48788,3,2,170988,170988,170990,0,2,0
48789,3,2,170991,170991,170993,0,2,1
48790,4,2,170995,170995,170997,0,2,2
48791,3,1,170998,170998,170999,0,1,1
48792,6,1,171004,171004,171005,0,1,5
48793,4,3,171008,171008,171011,0,3,3
48794,2,1,171010,171011,171012,1,2,0
48795,1,2,171011,171012,171014,1,3,0
48796,5,2,171016,171016,171018,0,2,2
48797,4,3,171020,171020,171023,0,3,2
48798,3,1,171023,171023,171024,0,1,0
48799,3,3,171026,171026,171029,0,3,2
48800,3,3,171029,171029,171032,0,3,0
48801,2,2,171031,171032,171034,1,3,0
48802,4,3,171035,171035,171038,0,3,1
48803,3,3,171038,171038,171041,0,3,0
48804,6,1,171044,171044,171045,0,1,3
48805,6,3,171050,171050,171053,0,3,5
48806,2,2,171052,171053,171055,1,3,0
48807,6,3,171058,171058,171061,0,3,3
48808,2,3,171060,171061,171064,1,4,0
48809,1,2,171061,171064,171066,3,5,0
48810,1,2,171062,171066,171068,4,6,0
48811,2,3,171064,171068,171071,4,7,0
48812,2,1,171066,171071,171072,5,6,0
48813,2,3,171068,171072,171075,4,7,0
48814,2,1,171070,171075,171076,5,6,0
48815,3,2,171073,171076,171078,3,5,0
48816,2,3,171075,171078,171081,3,6,0
48817,5,3,171080,171081,171084,1,4,0
48818,4,3,171084,171084,171087,0,3,0
48819,4,1,171088,171088,171089,0,1,1
48820,5,1,171093,171093,171094,0,1,4
48821,5,3,171098,171098,171101,0,3,4
48822,5,3,171103,171103,171106,0,3,2
48823,5,1,171108,171108,171109,0,1,2
48824,1,2,171109,171109,171111,0,2,0
48825,3,2,171112,171112,171114,0,2,1
48826,5,3,171117,171117,171120,0,3,3
48827,2,2,171119,171120,171122,1,3,0
48828,5,1,171124,171124,171125,0,1,2
48829,1,3,171125,171125,171128,0,3,0
48830,4,2,171129,171129,171131,0,2,1
48831,4,1,171133,171133,171134,0,1,2
48832,3,1,171136,171136,171137,0,1,2
48833,4,1,171140,171140,171141,0,1,3
48834,2,3,171142,171142,171145,0,3,1
48835,4,3,171146,171146,171149,0,3,1
48836,6,2,171152,171152,171154,0,2,3
48837,6,3,171158,171158,171161,0,3,4
48838,3,2,171161,171161,171163,0,2,0
48839,3,3,171164,171164,171167,0,3,1
48840,2,1,171166,171167,171168,1,2,0
48841,3,2,171169,171169,171171,0,2,1
48842,3,2,171172,171172,171174,0,2,1
48843,5,1,171177,171177,171178,0,1,3
48844,2,2,171179,171179,171181,0,2,1
48845,2,1,171181,171181,171182,0,1,0
48846,3,1,171184,171184,171185,0,1,2
48847,6,1,171190,171190,171191,0,1,5
48848,3,3,171193,171193,171196,0,3,2
48849,6,1,171199,171199,171200,0,1,3
48850,2,3,171201,171201,171204,0,3,1
48851,2,3,171203,171204,171207,1,4,0
48852,1,1,171204,171207,171208,3,4,0
48853,5,3,171209,171209,171212,0,3,1
48854,6,2,171215,171215,171217,0,2,3
48855,1,1,171216,171217,171218,1,2,0
48856,6,1,171222,171222,171223,0,1,4
48857,4,1,171226,171226,171227,0,1,3
48858,5,1,171231,171231,171232,0,1,4
48859,1,2,171232,171232,171234,0,2,0
48860,4,3,171236,171236,171239,0,3,2
48861,4,1,171240,171240,171241,0,1,1
48862,6,1,171246,171246,171247,0,1,5
48863,3,2,171249,171249,171251,0,2,2
48864,4,1,171253,171253,171254,0,1,2
48865,2,1,171255,171255,171256,0,1,1
48866,4,1,171259,171259,171260,0,1,3
48867,2,2,171261,171261,171263,0,2,1
48868,4,1,171265,171265,171266,0,1,2
48869,5,3,171270,171270,171273,0,3,4
48870,4,1,171274,171274,171275,0,1,1
48871,4,1,171278,171278,171279,0,1,3
48872,6,1,171284,171284,171285,0,1,5
48873,5,3,171289,171289,171292,0,3,4
48874,6,3,171295,171295,171298,0,3,3
48875,3,3,171298,171298,171301,0,3,0
48876,3,2,171301,171301,171303,0,2,0
48877,5,3,171306,171306,171309,0,3,3
48878,5,1,171311,171311,171312,0,1,2
48879,5,1,171316,171316,171317,0,1,4
48880,2,2,171318,171318,171320,0,2,1
48881,3,1,171321,171321,171322,0,1,1
48882,1,2,171322,171322,171324,0,2,0
48883,3,2,171325,171325,171327,0,2,1
48884,2,3,171327,171327,171330,0,3,0
48885,2,3,171329,171330,171333,1,4,0
48886,1,1,171330,171333,171334,3,4,0
48887,1,1,171331,171334,171335,3,4,0
48888,3,1,171334,171335,171336,1,2,0
48889,1,1,171335,171336,171337,1,2,0
48890,2,3,171337,171337,171340,0,3,0
48891,1,2,171338,171340,171342,2,4,0
48892,2,1,171340,171342,171343,2,3,0
48893,2,3,171342,171343,171346,1,4,0
48894,2,1,171344,171346,171347,2,3,0
48895,5,3,171349,171349,171352,0,3,2
48896,2,1,171351,171352,171353,1,2,0
48897,3,1,171354,171354,171355,0,1,1
48898,2,3,171356,171356,171359,0,3,1
48899,6,2,171362,171362,171364,0,2,3
48900,2,2,171364,171364,171366,0,2,0
48901,2,3,171366,171366,171369,0,3,0
48902,6,3,171372,171372,171375,0,3,3
48903,3,3,171375,171375,171378,0,3,0
48904,2,2,171377,171378,171380,1,3,0
48905,5,1,171382,171382,171383,0,1,2
48906,1,2,171383,171383,171385,0,2,0
48907,2,1,171385,171385,171386,0,1,0
48908,1,2,171386,171386,171388,0,2,0
48909,4,3,171390,171390,171393,0,3,2
48910,5,2,171395,171395,171397,0,2,2
48911,3,3,171398,171398,171401,0,3,1
48912,5,2,171403,171403,171405,0,2,2
48913,1,1,171404,171405,171406,1,2,0
48914,5,3,171409,171409,171412,0,3,3
48915,3,1,171412,171412,171413,0,1,0
48916,6,2,171418,171418,171420,0,2,5
48917,2,2,171420,171420,171422,0,2,0
48918,2,2,171422,171422,171424,0,2,0
48919,2,1,171424,171424,171425,0,1,0
48920,6,2,171430,171430,171432,0,2,5
48921,5,2,171435,171435,171437,0,2,3
48922,1,1,171436,171437,171438,1,2,0
48923,6,1,171442,171442,171443,0,1,4
48924,1,1,171443,171443,171444,0,1,0
48925,6,2,171449,171449,171451,0,2,5
48926,6,1,171455,171455,171456,0,1,4
48927,3,1,171458,171458,171459,0,1,2
48928,4,2,171462,171462,171464,0,2,3
48929,2,3,171464,171464,171467,0,3,0
48930,3,2,171467,171467,171469,0,2,0
48931,4,2,171471,171471,171473,0,2,2
48932,3,3,171474,171474,171477,0,3,1
48933,4,3,171478,171478,171481,0,3,1
48934,3,1,171481,171481,171482,0,1,0
48935,3,1,171484,171484,171485,0,1,2
48936,3,3,171487,171487,171490,0,3,2
48937,5,2,171492,171492,171494,0,2,2
48938,4,3,171496,171496,171499,0,3,2
48939,3,1,171499,171499,171500,0,1,0
48940,5,2,171504,171504,171506,0,2,4
48941,5,3,171509,171509,171512,0,3,3
48942,3,3,171512,171512,171515,0,3,0
48943,6,1,171518,171518,171519,0,1,3
48944,6,3,171524,171524,171527,0,3,5
48945,3,2,171527,171527,171529,0,2,0
48946,3,2,171530,171530,171532,0,2,1
48947,3,1,171533,171533,171534,0,1,1
48948,1,3,171534,171534,171537,0,3,0
48949,1,3,171535,171537,171540,2,5,0
48950,6,2,171541,171541,171543,0,2,1
48951,5,3,171546,171546,171549,0,3,3
48952,1,1,171547,171549,171550,2,3,0
48953,5,3,171552,171552,171555,0,3,2
48954,2,2,171554,171555,171557,1,3,0
48955,2,1,171556,171557,171558,1,2,0
48956,2,1,171558,171558,171559,0,1,0
48957,3,3,171561,171561,171564,0,3,2
48958,1,3,171562,171564,171567,2,5,0
48959,1,3,171563,171567,171570,4,7,0
48960,3,1,171566,171570,171571,4,5,0
48961,1,3,171567,171571,171574,4,7,0
48962,1,1,171568,171574,171575,6,7,0
48963,1,2,171569,171575,171577,6,8,0
48964,2,2,171571,171577,171579,6,8,0
48965,1,2,171572,171579,171581,7,9,0
48966,6,1,171578,171581,171582,3,4,0
48967,2,3,171580,171582,171585,2,5,0
48968,4,3,171584,171585,171588,1,4,0
48969,2,2,171586,171588,171590,2,4,0
48970,3,3,171589,171590,171593,1,4,0
48971,4,1,171593,171593,171594,0,1,0
48972,5,2,171598,171598,171600,0,2,4
48973,1,3,171599,171600,171603,1,4,0
48974,6,3,171605,171605,171608,0,3,2
48975,3,3,171608,171608,171611,0,3,0
48976,1,2,171609,171611,171613,2,4,0
48977,6,2,171615,171615,171617,0,2,2
48978,1,3,171616,171617,171620,1,4,0
48979,2,2,171618,171620,171622,2,4,0
48980,2,2,171620,171622,171624,2,4,0
48981,3,1,171623,171624,171625,1,2,0
48982,6,2,171629,171629,171631,0,2,4
48983,3,3,171632,171632,171635,0,3,1
48984,4,2,171636,171636,171638,0,2,1
48985,3,1,171639,171639,171640,0,1,1
48986,5,1,171644,171644,171645,0,1,4
48987,3,3,171647,171647,171650,0,3,2
48988,1,3,171648,171650,171653,2,5,0
48989,3,1,171651,171653,171654,2,3,0
48990,2,2,171653,171654,171656,1,3,0
48991,6,1,171659,171659,171660,0,1,3
48992,6,1,171665,171665,171666,0,1,5
48993,5,3,171670,171670,171673,0,3,4
48994,3,3,171673,171673,171676,0,3,0
48995,1,1,171674,171676,171677,2,3,0
48996,6,1,171680,171680,171681,0,1,3
48997,3,1,171683,171683,171684,0,1,2
48998,6,1,171689,171689,171690,0,1,5
48999,4,1,171693,171693,171694,0,1,3
49000,3,3,171696,171696,171699,0,3,2
49001,1,1,171697,171699,171700,2,3,0
49002,5,2,171702,171702,171704,0,2,2
49003,6,3,171708,171708,171711,0,3,4
49004,6,3,171714,171714,171717,0,3,3
49005,5,3,171719,171719,171722,0,3,2
49006,4,2,171723,171723,171725,0,2,1
49007,5,3,171728,171728,171731,0,3,3
49008,4,3,171732,171732,171735,0,3,1
49009,4,3,171736,171736,171739,0,3,1
49010,3,2,171739,171739,171741,0,2,0
49011,2,1,171741,171741,171742,0,1,0
49012,6,2,171747,171747,171749,0,2,5
49013,4,1,171751,171751,171752,0,1,2
49014,6,1,171757,171757,171758,0,1,5
49015,4,1,171761,171761,171762,0,1,3
49016,6,3,171767,171767,171770,0,3,5
49017,5,2,171772,171772,171774,0,2,2
49018,4,1,171776,171776,171777,0,1,2
49019,4,2,171780,171780,171782,0,2,3
49020,2,2,171782,171782,171784,0,2,0
49021,4,2,171786,171786,171788,0,2,2
49022,4,3,171790,171790,171793,0,3,2
49023,2,2,171792,171793,171795,1,3,0
49024,6,1,171798,171798,171799,0,1,3
49025,4,2,171802,171802,171804,0,2,3
49026,2,1,171804,171804,171805,0,1,0
49027,1,1,171805,171805,171806,0,1,0
49028,6,1,171811,171811,171812,0,1,5
49029,2,2,171813,171813,171815,0,2,1
49030,2,3,171815,171815,171818,0,3,0
49031,2,3,171817,171818,171821,1,4,0
49032,4,2,171821,171821,171823,0,2,0
49033,5,3,171826,171826,171829,0,3,3
49034,5,3,171831,171831,171834,0,3,2
49035,5,2,171836,171836,171838,0,2,2
49036,3,1,171839,171839,171840,0,1,1
49037,1,3,171840,171840,171843,0,3,0
49038,3,1,171843,171843,171844,0,1,0
49039,6,3,171849,171849,171852,0,3,5
49040,1,3,171850,171852,171855,2,5,0
49041,2,2,171852,171855,171857,3,5,0
49042,1,1,171853,171857,171858,4,5,0
49043,6,1,171859,171859,171860,0,1,1
49044,3,2,171862,171862,171864,0,2,2
49045,5,2,171867,171867,171869,0,2,3
49046,1,3,171868,171869,171872,1,4,0
49047,1,3,171869,171872,171875,3,6,0
49048,6,2,171875,171875,171877,0,2,0
49049,2,1,171877,171877,171878,0,1,0
49050,4,1,171881,171881,171882,0,1,3
49051,2,1,171883,171883,171884,0,1,1
49052,1,2,171884,171884,171886,0,2,0
49053,1,3,171885,171886,171889,1,4,0
49054,1,1,171886,171889,171890,3,4,0
49055,5,3,171891,171891,171894,0,3,1
49056,6,1,171897,171897,171898,0,1,3
49057,3,1,171900,171900,171901,0,1,2
49058,1,1,171901,171901,171902,0,1,0
49059,3,1,171904,171904,171905,0,1,2
49060,1,1,171905,171905,171906,0,1,0
49061,3,1,171908,171908,171909,0,1,2
49062,2,3,171910,171910,171913,0,3,1
49063,6,1,171916,171916,171917,0,1,3
49064,2,1,171918,171918,171919,0,1,1
49065,5,1,171923,171923,171924,0,1,4
49066,1,2,171924,171924,171926,0,2,0
49067,5,2,171929,171929,171931,0,2,3
49068,5,3,171934,171934,171937,0,3,3
49069,5,2,171939,171939,171941,0,2,2
49070,6,1,171945,171945,171946,0,1,4
49071,6,2,171951,171951,171953,0,2,5
49072,6,1,171957,171957,171958,0,1,4
49073,2,2,171959,171959,171961,0,2,1
49074,5,1,171964,171964,171965,0,1,3
49075,3,1,171967,171967,171968,0,1,2
49076,6,1,171973,171973,171974,0,1,5
49077,1,1,171974,171974,171975,0,1,0
49078,2,2,171976,171976,171978,0,2,1
49079,4,1,171980,171980,171981,0,1,2
49080,5,3,171985,171985,171988,0,3,4
49081,5,2,171990,171990,171992,0,2,2
49082,1,2,171991,171992,171994,1,3,0
49083,5,1,171996,171996,171997,0,1,2
49084,1,3,171997,171997,172000,0,3,0
49085,6,2,172003,172003,172005,0,2,3
49086,5,3,172008,172008,172011,0,3,3
49087,5,1,172013,172013,172014,0,1,2
49088,4,3,172017,172017,172020,0,3,3
49089,2,3,172019,172020,172023,1,4,0
49090,4,3,172023,172023,172026,0,3,0
49091,6,3,172029,172029,172032,0,3,3
49092,4,3,172033,172033,172036,0,3,1
49093,1,2,172034,172036,172038,2,4,0
49094,4,1,172038,172038,172039,0,1,0
49095,5,1,172043,172043,172044,0,1,4
49096,2,1,172045,172045,172046,0,1,1
49097,4,2,172049,172049,172051,0,2,3
49098,5,1,172054,172054,172055,0,1,3
49099,1,3,172055,172055,172058,0,3,0
49100,3,3,172058,172058,172061,0,3,0
49101,5,3,172063,172063,172066,0,3,2
49102,1,2,172064,172066,172068,2,4,0
49103,5,3,172069,172069,172072,0,3,1
49104,1,3,172070,172072,172075,2,5,0
49105,3,2,172073,172075,172077,2,4,0
49106,2,1,172075,172077,172078,2,3,0
49107,1,1,172076,172078,172079,2,3,0
49108,5,2,172081,172081,172083,0,2,2
49109,3,2,172084,172084,172086,0,2,1
49110,2,2,172086,172086,172088,0,2,0
49111,1,3,172087,172088,172091,1,4,0
49112,3,3,172090,172091,172094,1,4,0
49113,6,1,172096,172096,172097,0,1,2
49114,4,1,172100,172100,172101,0,1,3
49115,3,2,172103,172103,172105,0,2,2
49116,6,3,172109,172109,172112,0,3,4
49117,1,3,172110,172112,172115,2,5,0
49118,4,1,172114,172115,172116,1,2,0
49119,3,1,172117,172117,172118,0,1,1
49120,2,2,172119,172119,172121,0,2,1
49121,6,2,172125,172125,172127,0,2,4
49122,6,1,172131,172131,172132,0,1,4
49123,2,2,172133,172133,172135,0,2,1
49124,1,2,172134,172135,172137,1,3,0
49125,4,3,172138,172138,172141,0,3,1
49126,3,3,172141,172141,172144,0,3,0
49127,4,1,172145,172145,172146,0,1,1
49128,6,2,172151,172151,172153,0,2,5
49129,3,2,172154,172154,172156,0,2,1
49130,2,1,172156,172156,172157,0,1,0
49131,2,3,172158,172158,172161,0,3,1
49132,1,2,172159,172161,172163,2,4,0
49133,1,3,172160,172163,172166,3,6,0
49134,2,2,172162,172166,172168,4,6,0
49135,2,2,172164,172168,172170,4,6,0
49136,2,1,172166,172170,172171,4,5,0
49137,6,1,172172,172172,172173,0,1,1
49138,4,3,172176,172176,172179,0,3,3
49139,4,2,172180,172180,172182,0,2,1
49140,6,2,172186,172186,172188,0,2,4
49141,6,1,172192,172192,172193,0,1,4
49142,6,1,172198,172198,172199,0,1,5
49143,6,3,172204,172204,172207,0,3,5
49144,3,1,172207,172207,172208,0,1,0
49145,3,2,172210,172210,172212,0,2,2
49146,6,3,172216,172216,172219,0,3,4
49147,2,1,172218,172219,172220,1,2,0
49148,3,3,172221,172221,172224,0,3,1
49149,4,1,172225,172225,172226,0,1,1
49150,4,3,172229,172229,172232,0,3,3
49151,6,2,172235,172235,172237,0,2,3
49152,1,3,172236,172237,172240,1,4,0
49153,6,2,172242,172242,172244,0,2,2
49154,5,3,172247,172247,172250,0,3,3
49155,4,1,172251,172251,172252,0,1,1
49156,1,2,172252,172252,172254,0,2,0
49157,3,3,172255,172255,172258,0,3,1
49158,4,2,172259,172259,172261,0,2,1
49159,1,1,172260,172261,172262,1,2,0
49160,6,2,172266,172266,172268,0,2,4
49161,2,2,172268,172268,172270,0,2,0
49162,1,1,172269,172270,172271,1,2,0
49163,5,3,172274,172274,172277,0,3,3
49164,3,1,172277,172277,172278,0,1,0
49165,2,3,172279,172279,172282,0,3,1
49166,3,1,172282,172282,172283,0,1,0
49167,4,1,172286,172286,172287,0,1,3
49168,1,1,172287,172287,172288,0,1,0
49169,4,1,172291,172291,172292,0,1,3
49170,6,2,172297,172297,172299,0,2,5
49171,6,2,172303,172303,172305,0,2,4
49172,4,2,172307,172307,172309,0,2,2
49173,5,3,172312,172312,172315,0,3,3
49174,3,3,172315,172315,172318,0,3,0
49175,4,2,172319,172319,172321,0,2,1
49176,1,3,172320,172321,172324,1,4,0
49177,1,3,172321,172324,172327,3,6,0
49178,4,3,172325,172327,172330,2,5,0
49179,1,2,172326,172330,172332,4,6,0
49180,1,3,172327,172332,172335,5,8,0
49181,3,1,172330,172335,172336,5,6,0
49182,4,3,172334,172336,172339,2,5,0
49183,6,2,172340,172340,172342,0,2,1
49184,2,3,172342,172342,172345,0,3,0
49185,2,2,172344,172345,172347,1,3,0
49186,4,3,172348,172348,172351,0,3,1
49187,2,2,172350,172351,172353,1,3,0
49188,1,1,172351,172353,172354,2,3,0
49189,1,3,172352,172354,172357,2,5,0
49190,2,1,172354,172357,172358,3,4,0
49191,2,1,172356,172358,172359,2,3,0
49192,5,3,172361,172361,172364,0,3,2
49193,1,3,172362,172364,172367,2,5,0
49194,1,1,172363,172367,172368,4,5,0
49195,5,3,172368,172368,172371,0,3,0
49196,5,2,172373,172373,172375,0,2,2
49197,2,2,172375,172375,172377,0,2,0
49198,5,2,172380,172380,172382,0,2,3
49199,4,2,172384,172384,172386,0,2,2
49200,6,2,172390,172390,172392,0,2,4
49201,1,2,172391,172392,172394,1,3,0
49202,3,2,172394,172394,172396,0,2,0
49203,3,1,172397,172397,172398,0,1,1
49204,4,2,172401,172401,172403,0,2,3
49205,1,3,172402,172403,172406,1,4,0
49206,5,2,172407,172407,172409,0,2,1
49207,5,1,172412,172412,172413,0,1,3
49208,5,1,172417,172417,172418,0,1,4
49209,1,2,172418,172418,172420,0,2,0
49210,4,2,172422,172422,172424,0,2,2
49211,6,1,172428,172428,172429,0,1,4
49212,6,1,172434,172434,172435,0,1,5
49213,6,3,172440,172440,172443,0,3,5
49214,2,3,172442,172443,172446,1,4,0
49215,4,2,172446,172446,172448,0,2,0
49216,2,1,172448,172448,172449,0,1,0
49217,4,2,172452,172452,172454,0,2,3
49218,4,1,172456,172456,172457,0,1,2
49219,5,3,172461,172461,172464,0,3,4
49220,4,2,172465,172465,172467,0,2,1
49221,5,2,172470,172470,172472,0,2,3
49222,4,1,172474,172474,172475,0,1,2
49223,1,3,172475,172475,172478,0,3,0
49224,3,3,172478,172478,172481,0,3,0
49225,4,3,172482,172482,172485,0,3,1
49226,6,2,172488,172488,172490,0,2,3
49227,2,3,172490,172490,172493,0,3,0
49228,1,1,172491,172493,172494,2,3,0
49229,5,1,172496,172496,172497,0,1,2
49230,5,1,172501,172501,172502,0,1,4
49231,3,3,172504,172504,172507,0,3,2
49232,2,1,172506,172507,172508,1,2,0
49233,1,3,172507,172508,172511,1,4,0
49234,5,1,172512,172512,172513,0,1,1
49235,5,3,172517,172517,172520,0,3,4
49236,3,2,172520,172520,172522,0,2,0
49237,5,1,172525,172525,172526,0,1,3
49238,4,2,172529,172529,172531,0,2,3
49239,4,1,172533,172533,172534,0,1,2
49240,2,2,172535,172535,172537,0,2,1
49241,6,2,172541,172541,172543,0,2,4
49242,1,3,172542,172543,172546,1,4,0
49243,1,3,172543,172546,172549,3,6,0
49244,5,3,172548,172549,172552,1,4,0
49245,2,3,172550,172552,172555,2,5,0
49246,2,2,172552,172555,172557,3,5,0
49247,2,3,172554,172557,172560,3,6,0
49248,4,2,172558,172560,172562,2,4,0
49249,5,1,172563,172563,172564,0,1,1
49250,3,1,172566,172566,172567,0,1,2
49251,5,2,172571,172571,172573,0,2,4
49252,3,1,172574,172574,172575,0,1,1
49253,4,3,172578,172578,172581,0,3,3
49254,1,1,172579,172581,172582,2,3,0
49255,6,1,172585,172585,172586,0,1,3
49256,2,3,172587,172587,172590,0,3,1
49257,6,3,172593,172593,172596,0,3,3
49258,4,1,172597,172597,172598,0,1,1
49259,5,2,172602,172602,172604,0,2,4
49260,1,3,172603,172604,172607,1,4,0
49261,6,1,172609,172609,172610,0,1,2
49262,6,2,172615,172615,172617,0,2,5
49263,5,3,172620,172620,172623,0,3,3
49264,3,3,172623,172623,172626,0,3,0
49265,6,3,172629,172629,172632,0,3,3
49266,5,1,172634,172634,172635,0,1,2
49267,3,1,172637,172637,172638,0,1,2
49268,1,1,172638,172638,172639,0,1,0
49269,2,1,172640,172640,172641,0,1,1
49270,4,3,172644,172644,172647,0,3,3
49271,3,2,172647,172647,172649,0,2,0
49272,6,1,172653,172653,172654,0,1,4
49273,4,1,172657,172657,172658,0,1,3
49274,6,2,172663,172663,172665,0,2,5
49275,5,2,172668,172668,172670,0,2,3
49276,4,1,172672,172672,172673,0,1,2
49277,2,3,172674,172674,172677,0,3,1
49278,5,2,172679,172679,172681,0,2,2
49279,6,1,172685,172685,172686,0,1,4
49280,4,1,172689,172689,172690,0,1,3
49281,2,3,172691,172691,172694,0,3,1
49282,3,1,172694,172694,172695,0,1,0
49283,5,3,172699,172699,172702,0,3,4
49284,3,3,172702,172702,172705,0,3,0
49285,3,3,172705,172705,172708,0,3,0
49286,5,3,172710,172710,172713,0,3,2
49287,6,2,172716,172716,172718,0,2,3
49288,4,3,172720,172720,172723,0,3,2
49289,2,2,172722,172723,172725,1,3,0
49290,4,1,172726,172726,172727,0,1,1
49291,4,2,172730,172730,172732,0,2,3
49292,5,2,172735,172735,172737,0,2,3
49293,2,3,172737,172737,172740,0,3,0
49294,5,1,172742,172742,172743,0,1,2
49295,4,3,172746,172746,172749,0,3,3
49296,4,3,172750,172750,172753,0,3,1
49297,5,1,172755,172755,172756,0,1,2
49298,6,2,172761,172761,172763,0,2,5
49299,1,3,172762,172763,172766,1,4,0
49300,6,1,172768,172768,172769,0,1,2
49301,2,2,172770,172770,172772,0,2,1
49302,5,3,172775,172775,172778,0,3,3
49303,3,2,172778,172778,172780,0,2,0
49304,5,2,172783,172783,172785,0,2,3
49305,5,1,172788,172788,172789,0,1,3
49306,1,2,172789,172789,172791,0,2,0
49307,6,2,172795,172795,172797,0,2,4
49308,5,3,172800,172800,172803,0,3,3
49309,2,1,172802,172803,172804,1,2,0
49310,1,1,172803,172804,172805,1,2,0
49311,2,1,172805,172805,172806,0,1,0
49312,5,1,172810,172810,172811,0,1,4
49313,3,1,172813,172813,172814,0,1,2
49314,5,1,172818,172818,172819,0,1,4
49315,2,3,172820,172820,172823,0,3,1
49316,4,1,172824,172824,172825,0,1,1
49317,2,1,172826,172826,172827,0,1,1
49318,6,2,172832,172832,172834,0,2,5
49319,5,2,172837,172837,172839,0,2,3
49320,4,1,172841,172841,172842,0,1,2
49321,1,1,172842,172842,172843,0,1,0
49322,1,2,172843,172843,172845,0,2,0
49323,4,1,172847,172847,172848,0,1,2
49324,6,2,172853,172853,172855,0,2,5
49325,6,3,172859,172859,172862,0,3,4
49326,1,2,172860,172862,172864,2,4,0
49327,6,1,172866,172866,172867,0,1,2
49328,3,2,172869,172869,172871,0,2,2
49329,3,3,172872,172872,172875,0,3,1
49330,1,3,172873,172875,172878,2,5,0
49331,2,1,172875,172878,172879,3,4,0
49332,5,1,172880,172880,172881,0,1,1
49333,1,1,172881,172881,172882,0,1,0
49334,4,2,172885,172885,172887,0,2,3
49335,5,2,172890,172890,172892,0,2,3
49336,6,2,172896,172896,172898,0,2,4
49337,6,3,172902,172902,172905,0,3,4
49338,1,1,172903,172905,172906,2,3,0
49339,2,2,172905,172906,172908,1,3,0
49340,4,1,172909,172909,172910,0,1,1
49341,3,1,172912,172912,172913,0,1,2
49342,6,2,172918,172918,172920,0,2,5
49343,1,3,172919,172920,172923,1,4,0
49344,4,2,172923,172923,172925,0,2,0
49345,2,1,172925,172925,172926,0,1,0
49346,3,3,172928,172928,172931,0,3,2
49347,2,3,172930,172931,172934,1,4,0
49348,6,3,172936,172936,172939,0,3,2
49349,6,2,172942,172942,172944,0,2,3
49350,3,1,172945,172945,172946,0,1,1
49351,3,2,172948,172948,172950,0,2,2
49352,6,1,172954,172954,172955,0,1,4
49353,6,2,172960,172960,172962,0,2,5
49354,3,1,172963,172963,172964,0,1,1
49355,5,2,172968,172968,172970,0,2,4
49356,4,1,172972,172972,172973,0,1,2
49357,5,1,172977,172977,172978,0,1,4
49358,1,2,172978,172978,172980,0,2,0
49359,2,3,172980,172980,172983,0,3,0
49360,4,1,172984,172984,172985,0,1,1
49361,3,3,172987,172987,172990,0,3,2
49362,1,1,172988,172990,172991,2,3,0
49363,6,3,172994,172994,172997,0,3,3
49364,5,2,172999,172999,173001,0,2,2
49365,6,3,173005,173005,173008,0,3,4
49366,1,3,173006,173008,173011,2,5,0
49367,4,2,173010,173011,173013,1,3,0
49368,4,2,173014,173014,173016,0,2,1
49369,2,3,173016,173016,173019,0,3,0
49370,5,2,173021,173021,173023,0,2,2
49371,4,1,173025,173025,173026,0,1,2
49372,6,3,173031,173031,173034,0,3,5
49373,3,3,173034,173034,173037,0,3,0
49374,4,2,173038,173038,173040,0,2,1
49375,2,1,173040,173040,173041,0,1,0
49376,4,1,173044,173044,173045,0,1,3
49377,3,1,173047,173047,173048,0,1,2
49378,5,3,173052,173052,173055,0,3,4
49379,6,2,173058,173058,173060,0,2,3
49380,6,1,173064,173064,173065,0,1,4
49381,1,3,173065,173065,173068,0,3,0
49382,2,1,173067,173068,173069,1,2,0
49383,1,1,173068,173069,173070,1,2,0
49384,5,2,173073,173073,173075,0,2,3
49385,1,3,173074,173075,173078,1,4,0
49386,1,2,173075,173078,173080,3,5,0
49387,5,2,173080,173080,173082,0,2,0
49388,4,2,173084,173084,173086,0,2,2
49389,1,2,173085,173086,173088,1,3,0
49390,1,1,173086,173088,173089,2,3,0
49391,4,2,173090,173090,173092,0,2,1
49392,1,1,173091,173092,173093,1,2,0
49393,1,3,173092,173093,173096,1,4,0
49394,6,3,173098,173098,173101,0,3,2
49395,5,1,173103,173103,173104,0,1,2
49396,6,2,173109,173109,173111,0,2,5
49397,4,1,173113,173113,173114,0,1,2
49398,3,3,173116,173116,173119,0,3,2
49399,3,3,173119,173119,173122,0,3,0
49400,3,3,173122,173122,173125,0,3,0
49401,5,2,173127,173127,173129,0,2,2
49402,6,2,173133,173133,173135,0,2,4
49403,2,3,173135,173135,173138,0,3,0
49404,2,3,173137,173138,173141,1,4,0
49405,1,2,173138,173141,173143,3,5,0
49406,1,3,173139,173143,173146,4,7,0
49407,5,1,173144,173146,173147,2,3,0
49408,2,1,173146,173147,173148,1,2,0
49409,3,1,173149,173149,173150,0,1,1
49410,4,1,173153,173153,173154,0,1,3
49411,6,2,173159,173159,173161,0,2,5
49412,2,1,173161,173161,173162,0,1,0
49413,6,1,173167,173167,173168,0,1,5
49414,6,2,173173,173173,173175,0,2,5
49415,4,1,173177,173177,173178,0,1,2
49416,2,1,173179,173179,173180,0,1,1
49417,3,2,173182,173182,173184,0,2,2
49418,2,1,173184,173184,173185,0,1,0
49419,6,3,173190,173190,173193,0,3,5
49420,1,3,173191,173193,173196,2,5,0
49421,2,2,173193,173196,173198,3,5,0
49422,1,2,173194,173198,173200,4,6,0
49423,3,1,173197,173200,173201,3,4,0
49424,5,1,173202,173202,173203,0,1,1
49425,4,2,173206,173206,173208,0,2,3
49426,4,2,173210,173210,173212,0,2,2
49427,5,1,173215,173215,173216,0,1,3
49428,4,2,173219,173219,173221,0,2,3
49429,4,1,173223,173223,173224,0,1,2
49430,1,1,173224,173224,173225,0,1,0
49431,1,2,173225,173225,173227,0,2,0
49432,3,1,173228,173228,173229,0,1,1
49433,2,3,173230,173230,173233,0,3,1
49434,3,2,173233,173233,173235,0,2,0
49435,3,3,173236,173236,173239,0,3,1
49436,1,2,173237,173239,173241,2,4,0
49437,5,2,173242,173242,173244,0,2,1
49438,1,1,173243,173244,173245,1,2,0
49439,1,2,173244,173245,173247,1,3,0
49440,6,3,173250,173250,173253,0,3,3
49441,1,2,173251,173253,173255,2,4,0
49442,5,3,173256,173256,173259,0,3,1
49443,1,3,173257,173259,173262,2,5,0
49444,6,1,173263,173263,173264,0,1,1
49445,5,1,173268,173268,173269,0,1,4
49446,6,3,173274,173274,173277,0,3,5
49447,4,3,173278,173278,173281,0,3,1
49448,4,3,173282,173282,173285,0,3,1
49449,6,3,173288,173288,173291,0,3,3
49450,3,1,173291,173291,173292,0,1,0
49451,4,2,173295,173295,173297,0,2,3
49452,4,2,173299,173299,173301,0,2,2
49453,4,3,173303,173303,173306,0,3,2
49454,4,2,173307,173307,173309,0,2,1
49455,3,1,173310,173310,173311,0,1,1
49456,2,3,173312,173312,173315,0,3,1
49457,6,2,173318,173318,173320,0,2,3
49458,4,3,173322,173322,173325,0,3,2
49459,4,2,173326,173326,173328,0,2,1
49460,2,2,173328,173328,173330,0,2,0
49461,3,2,173331,173331,173333,0,2,1
49462,1,3,173332,173333,173336,1,4,0
49463,2,2,173334,173336,173338,2,4,0
49464,4,2,173338,173338,173340,0,2,0
49465,1,2,173339,173340,173342,1,3,0
49466,5,3,173344,173344,173347,0,3,2
49467,3,3,173347,173347,173350,0,3,0
49468,5,2,173352,173352,173354,0,2,2
49469,2,1,173354,173354,173355,0,1,0
49470,3,3,173357,173357,173360,0,3,2
49471,3,1,173360,173360,173361,0,1,0
49472,1,3,173361,173361,173364,0,3,0
49473,1,1,173362,173364,173365,2,3,0
49474,5,2,173367,173367,173369,0,2,2
49475,6,1,173373,173373,173374,0,1,4
49476,6,1,173379,173379,173380,0,1,5
49477,1,3,173380,173380,173383,0,3,0
49478,6,3,173386,173386,173389,0,3,3
49479,5,1,173391,173391,173392,0,1,2
49480,1,3,173392,173392,173395,0,3,0
49481,6,1,173398,173398,173399,0,1,3
49482,3,2,173401,173401,173403,0,2,2
49483,2,3,173403,173403,173406,0,3,0
49484,2,2,173405,173406,173408,1,3,0
49485,4,2,173409,173409,173411,0,2,1
49486,6,1,173415,173415,173416,0,1,4
49487,6,2,173421,173421,173423,0,2,5
49488,5,3,173426,173426,173429,0,3,3
49489,5,1,173431,173431,173432,0,1,2
49490,1,2,173432,173432,173434,0,2,0
49491,6,3,173438,173438,173441,0,3,4
49492,6,1,173444,173444,173445,0,1,3
49493,5,1,173449,173449,173450,0,1,4
49494,6,1,173455,173455,173456,0,1,5
49495,1,1,173456,173456,173457,0,1,0
49496,4,3,173460,173460,173463,0,3,3
49497,6,3,173466,173466,173469,0,3,3
49498,3,2,173469,173469,173471,0,2,0
49499,2,1,173471,173471,173472,0,1,0
49500,1,1,173472,173472,173473,0,1,0
49501,5,2,173477,173477,173479,0,2,4
49502,4,2,173481,173481,173483,0,2,2
49503,4,1,173485,173485,173486,0,1,2
49504,5,3,173490,173490,173493,0,3,4
49505,6,3,173496,173496,173499,0,3,3
49506,2,3,173498,173499,173502,1,4,0
49507,1,2,173499,173502,173504,3,5,0
49508,1,3,173500,173504,173507,4,7,0
49509,6,2,173506,173507,173509,1,3,0
49510,6,1,173512,173512,173513,0,1,3
49511,5,3,173517,173517,173520,0,3,4
49512,3,1,173520,173520,173521,0,1,0
49513,3,2,173523,173523,173525,0,2,2
49514,4,1,173527,173527,173528,0,1,2
49515,6,2,173533,173533,173535,0,2,5
49516,2,2,173535,173535,173537,0,2,0
49517,4,3,173539,173539,173542,0,3,2
49518,6,1,173545,173545,173546,0,1,3
49519,1,1,173546,173546,173547,0,1,0
49520,1,1,173547,173547,173548,0,1,0
49521,3,2,173550,173550,173552,0,2,2
49522,3,1,173553,173553,173554,0,1,1
49523,5,3,173558,173558,173561,0,3,4
49524,2,1,173560,173561,173562,1,2,0
49525,5,1,173565,173565,173566,0,1,3
49526,1,2,173566,173566,173568,0,2,0
49527,4,3,173570,173570,173573,0,3,2
49528,4,1,173574,173574,173575,0,1,1
49529,5,1,173579,173579,173580,0,1,4
49530,1,2,173580,173580,173582,0,2,0
49531,1,1,173581,173582,173583,1,2,0
49532,6,1,173587,173587,173588,0,1,4
49533,1,1,173588,173588,173589,0,1,0
49534,4,1,173592,173592,173593,0,1,3
49535,2,3,173594,173594,173597,0,3,1
49536,3,2,173597,173597,173599,0,2,0
49537,1,3,173598,173599,173602,1,4,0
49538,4,2,173602,173602,173604,0,2,0
49539,3,2,173605,173605,173607,0,2,1
49540,2,2,173607,173607,173609,0,2,0
49541,5,3,173612,173612,173615,0,3,3
49542,6,3,173618,173618,173621,0,3,3
49543,2,3,173620,173621,173624,1,4,0
49544,2,1,173622,173624,173625,2,3,0
49545,1,2,173623,173625,173627,2,4,0
49546,6,1,173629,173629,173630,0,1,2
49547,1,3,173630,173630,173633,0,3,0
49548,4,3,173634,173634,173637,0,3,1
49549,1,1,173635,173637,173638,2,3,0
49550,2,3,173637,173638,173641,1,4,0
49551,6,1,173643,173643,173644,0,1,2
49552,2,3,173645,173645,173648,0,3,1
49553,6,3,173651,173651,173654,0,3,3
49554,3,2,173654,173654,173656,0,2,0
49555,2,1,173656,173656,173657,0,1,0
49556,6,3,173662,173662,173665,0,3,5
49557,6,1,173668,173668,173669,0,1,3
49558,2,1,173670,173670,173671,0,1,1
49559,3,1,173673,173673,173674,0,1,2
49560,1,2,173674,173674,173676,0,2,0
49561,2,1,173676,173676,173677,0,1,0
49562,3,1,173679,173679,173680,0,1,2
49563,1,1,173680,173680,173681,0,1,0
49564,3,1,173683,173683,173684,0,1,2
49565,1,2,173684,173684,173686,0,2,0
49566,2,3,173686,173686,173689,0,3,0
49567,2,2,173688,173689,173691,1,3,0
49568,2,1,173690,173691,173692,1,2,0
49569,3,1,173693,173693,173694,0,1,1
49570,2,2,173695,173695,173697,0,2,1
49571,1,3,173696,173697,173700,1,4,0
49572,2,2,173698,173700,173702,2,4,0
49573,2,3,173700,173702,173705,2,5,0
49574,6,2,173706,173706,173708,0,2,1
49575,4,3,173710,173710,173713,0,3,2
49576,5,2,173715,173715,173717,0,2,2
49577,6,3,173721,173721,173724,0,3,4
49578,6,1,173727,173727,173728,0,1,3
49579,2,3,173729,173729,173732,0,3,1
49580,6,2,173735,173735,173737,0,2,3
49581,3,2,173738,173738,173740,0,2,1
49582,5,1,173743,173743,173744,0,1,3
49583,4,3,173747,173747,173750,0,3,3
49584,2,3,173749,173750,173753,1,4,0
49585,1,2,173750,173753,173755,3,5,0
49586,3,1,173753,173755,173756,2,3,0
49587,2,2,173755,173756,173758,1,3,0
49588,2,2,173757,173758,173760,1,3,0
49589,1,2,173758,173760,173762,2,4,0
49590,5,3,173763,173763,173766,0,3,1
49591,2,1,173765,173766,173767,1,2,0
49592,4,2,173769,173769,173771,0,2,2
49593,3,1,173772,173772,173773,0,1,1
49594,5,1,173777,173777,173778,0,1,4
49595,6,2,173783,173783,173785,0,2,5
49596,1,2,173784,173785,173787,1,3,0
49597,2,2,173786,173787,173789,1,3,0
49598,2,1,173788,173789,173790,1,2,0
49599,1,1,173789,173790,173791,1,2,0
49600,2,1,173791,173791,173792,0,1,0
49601,6,1,173797,173797,173798,0,1,5
49602,6,3,173803,173803,173806,0,3,5
49603,2,1,173805,173806,173807,1,2,0
49604,5,2,173810,173810,173812,0,2,3
49605,1,2,173811,173812,173814,1,3,0
49606,6,3,173817,173817,173820,0,3,3
49607,1,3,173818,173820,173823,2,5,0
49608,2,1,173820,173823,173824,3,4,0
49609,2,1,173822,173824,173825,2,3,0
49610,6,1,173828,173828,173829,0,1,3
49611,3,1,173831,173831,173832,0,1,2
49612,5,3,173836,173836,173839,0,3,4
49613,6,2,173842,173842,173844,0,2,3
49614,4,1,173846,173846,173847,0,1,2
49615,2,2,173848,173848,173850,0,2,1
49616,5,1,173853,173853,173854,0,1,3
49617,5,3,173858,173858,173861,0,3,4
49618,5,3,173863,173863,173866,0,3,2
49619,6,3,173869,173869,173872,0,3,3
49620,3,1,173872,173872,173873,0,1,0
49621,6,3,173878,173878,173881,0,3,5
49622,2,3,173880,173881,173884,1,4,0
49623,6,1,173886,173886,173887,0,1,2
49624,1,3,173887,173887,173890,0,3,0
49625,4,3,173891,173891,173894,0,3,1
49626,3,3,173894,173894,173897,0,3,0
49627,5,1,173899,173899,173900,0,1,2
49628,6,2,173905,173905,173907,0,2,5
49629,6,2,173911,173911,173913,0,2,4
49630,4,1,173915,173915,173916,0,1,2
49631,3,1,173918,173918,173919,0,1,2
49632,3,3,173921,173921,173924,0,3,2
49633,6,1,173927,173927,173928,0,1,3
49634,5,2,173932,173932,173934,0,2,4
49635,3,1,173935,173935,173936,0,1,1
49636,5,3,173940,173940,173943,0,3,4
49637,3,3,173943,173943,173946,0,3,0
49638,4,3,173947,173947,173950,0,3,1
49639,1,2,173948,173950,173952,2,4,0
49640,3,2,173951,173952,173954,1,3,0
49641,2,1,173953,173954,173955,1,2,0
49642,1,1,173954,173955,173956,1,2,0
49643,1,2,173955,173956,173958,1,3,0
49644,6,3,173961,173961,173964,0,3,3
49645,6,3,173967,173967,173970,0,3,3
49646,1,2,173968,173970,173972,2,4,0
49647,2,3,173970,173972,173975,2,5,0
49648,6,2,173976,173976,173978,0,2,1
49649,3,3,173979,173979,173982,0,3,1
49650,6,2,173985,173985,173987,0,2,3
49651,5,1,173990,173990,173991,0,1,3
49652,2,2,173992,173992,173994,0,2,1
49653,4,1,173996,173996,173997,0,1,2
49654,6,3,174002,174002,174005,0,3,5
49655,3,2,174005,174005,174007,0,2,0
49656,1,1,174006,174007,174008,1,2,0
49657,2,2,174008,174008,174010,0,2,0
49658,6,1,174014,174014,174015,0,1,4
49659,2,1,174016,174016,174017,0,1,1
49660,4,2,174020,174020,174022,0,2,3
49661,3,2,174023,174023,174025,0,2,1
49662,4,1,174027,174027,174028,0,1,2
49663,1,2,174028,174028,174030,0,2,0
49664,1,2,174029,174030,174032,1,3,0
49665,4,3,174033,174033,174036,0,3,1
49666,1,2,174034,174036,174038,2,4,0
49667,5,3,174039,174039,174042,0,3,1
49668,4,3,174043,174043,174046,0,3,1
49669,4,3,174047,174047,174050,0,3,1
49670,6,1,174053,174053,174054,0,1,3
49671,3,2,174056,174056,174058,0,2,2
49672,1,3,174057,174058,174061,1,4,0
49673,4,3,174061,174061,174064,0,3,0
49674,5,1,174066,174066,174067,0,1,2
49675,4,3,174070,174070,174073,0,3,3
49676,3,1,174073,174073,174074,0,1,0
49677,4,1,174077,174077,174078,0,1,3
49678,6,1,174083,174083,174084,0,1,5
49679,1,2,174084,174084,174086,0,2,0
49680,6,2,174090,174090,174092,0,2,4
49681,5,1,174095,174095,174096,0,1,3
49682,2,2,174097,174097,174099,0,2,1
49683,3,1,174100,174100,174101,0,1,1
49684,2,3,174102,174102,174105,0,3,1
49685,5,1,174107,174107,174108,0,1,2
49686,1,1,174108,174108,174109,0,1,0
49687,1,1,174109,174109,174110,0,1,0
49688,4,2,174113,174113,174115,0,2,3
49689,1,1,174114,174115,174116,1,2,0
49690,1,1,174115,174116,174117,1,2,0
49691,5,2,174120,174120,174122,0,2,3
49692,4,2,174124,174124,174126,0,2,2
49693,6,1,174130,174130,174131,0,1,4
49694,6,3,174136,174136,174139,0,3,5
49695,1,1,174137,174139,174140,2,3,0
49696,3,3,174140,174140,174143,0,3,0
49697,2,1,174142,174143,174144,1,2,0
49698,2,1,174144,174144,174145,0,1,0
49699,3,1,174147,174147,174148,0,1,2
49700,5,3,174152,174152,174155,0,3,4
49701,2,2,174154,174155,174157,1,3,0
49702,6,3,174160,174160,174163,0,3,3
49703,5,3,174165,174165,174168,0,3,2
49704,2,2,174167,174168,174170,1,3,0
49705,5,3,174172,174172,174175,0,3,2
49706,4,3,174176,174176,174179,0,3,1
49707,4,2,174180,174180,174182,0,2,1
49708,3,1,174183,174183,174184,0,1,1
49709,4,1,174187,174187,174188,0,1,3
49710,2,1,174189,174189,174190,0,1,1
49711,1,2,174190,174190,174192,0,2,0
49712,2,2,174192,174192,174194,0,2,0
49713,4,3,174196,174196,174199,0,3,2
49714,1,2,174197,174199,174201,2,4,0
49715,3,2,174200,174201,174203,1,3,0
49716,6,1,174206,174206,174207,0,1,3
49717,1,2,174207,174207,174209,0,2,0
49718,3,2,174210,174210,174212,0,2,1
49719,3,1,174213,174213,174214,0,1,1
49720,4,3,174217,174217,174220,0,3,3
49721,2,3,174219,174220,174223,1,4,0
49722,4,1,174223,174223,174224,0,1,0
49723,5,2,174228,174228,174230,0,2,4
49724,3,1,174231,174231,174232,0,1,1
49725,4,1,174235,174235,174236,0,1,3
49726,1,3,174236,174236,174239,0,3,0
49727,5,1,174241,174241,174242,0,1,2
49728,4,1,174245,174245,174246,0,1,3
49729,6,1,174251,174251,174252,0,1,5
49730,5,1,174256,174256,174257,0,1,4
49731,3,3,174259,174259,174262,0,3,2
49732,6,2,174265,174265,174267,0,2,3
49733,6,3,174271,174271,174274,0,3,4
49734,1,1,174272,174274,174275,2,3,0
49735,3,2,174275,174275,174277,0,2,0
49736,4,1,174279,174279,174280,0,1,2
49737,5,1,174284,174284,174285,0,1,4
49738,5,3,174289,174289,174292,0,3,4
49739,3,2,174292,174292,174294,0,2,0
49740,5,3,174297,174297,174300,0,3,3
49741,4,3,174301,174301,174304,0,3,1
49742,6,2,174307,174307,174309,0,2,3
49743,5,2,174312,174312,174314,0,2,3
49744,6,2,174318,174318,174320,0,2,4
49745,4,3,174322,174322,174325,0,3,2
49746,1,1,174323,174325,174326,2,3,0
49747,6,1,174329,174329,174330,0,1,3
49748,2,2,174331,174331,174333,0,2,1
49749,2,2,174333,174333,174335,0,2,0
49750,5,3,174338,174338,174341,0,3,3
49751,4,1,174342,174342,174343,0,1,1
49752,2,1,174344,174344,174345,0,1,1
49753,2,2,174346,174346,174348,0,2,1
49754,2,2,174348,174348,174350,0,2,0
49755,1,1,174349,174350,174351,1,2,0
49756,1,2,174350,174351,174353,1,3,0
49757,4,3,174354,174354,174357,0,3,1
49758,3,2,174357,174357,174359,0,2,0
49759,4,3,174361,174361,174364,0,3,2
49760,6,3,174367,174367,174370,0,3,3
49761,4,1,174371,174371,174372,0,1,1
49762,1,2,174372,174372,174374,0,2,0
49763,4,1,174376,174376,174377,0,1,2
49764,4,1,174380,174380,174381,0,1,3
49765,1,1,174381,174381,174382,0,1,0
49766,6,3,174387,174387,174390,0,3,5
49767,2,2,174389,174390,174392,1,3,0
49768,4,2,174393,174393,174395,0,2,1
49769,5,2,174398,174398,174400,0,2,3
49770,4,2,174402,174402,174404,0,2,2
49771,4,1,174406,174406,174407,0,1,2
49772,1,1,174407,174407,174408,0,1,0
49773,4,1,174411,174411,174412,0,1,3
49774,6,1,174417,174417,174418,0,1,5
49775,6,2,174423,174423,174425,0,2,5
49776,4,2,174427,174427,174429,0,2,2
49777,5,1,174432,174432,174433,0,1,3
49778,1,2,174433,174433,174435,0,2,0
49779,5,2,174438,174438,174440,0,2,3
49780,2,3,174440,174440,174443,0,3,0
49781,5,2,174445,174445,174447,0,2,2
49782,1,1,174446,174447,174448,1,2,0
49783,4,1,174450,174450,174451,0,1,2
49784,3,1,174453,174453,174454,0,1,2
49785,2,1,174455,174455,174456,0,1,1
49786,6,2,174461,174461,174463,0,2,5
49787,2,1,174463,174463,174464,0,1,0
49788,6,2,174469,174469,174471,0,2,5
49789,4,3,174473,174473,174476,0,3,2
49790,6,3,174479,174479,174482,0,3,3
49791,4,2,174483,174483,174485,0,2,1
49792,3,3,174486,174486,174489,0,3,1
49793,6,3,174492,174492,174495,0,3,3
49794,4,3,174496,174496,174499,0,3,1
49795,5,3,174501,174501,174504,0,3,2
49796,2,1,174503,174504,174505,1,2,0
49797,4,2,174507,174507,174509,0,2,2
49798,1,1,174508,174509,174510,1,2,0
49799,3,3,174511,174511,174514,0,3,1
49800,6,2,174517,174517,174519,0,2,3
49801,1,3,174518,174519,174522,1,4,0
49802,3,2,174521,174522,174524,1,3,0
49803,3,2,174524,174524,174526,0,2,0
49804,6,3,174530,174530,174533,0,3,4
49805,2,2,174532,174533,174535,1,3,0
49806,3,2,174535,174535,174537,0,2,0
49807,3,3,174538,174538,174541,0,3,1
49808,3,3,174541,174541,174544,0,3,0
49809,5,2,174546,174546,174548,0,2,2
49810,2,2,174548,174548,174550,0,2,0
49811,1,3,174549,174550,174553,1,4,0
49812,1,3,174550,174553,174556,3,6,0
49813,3,2,174553,174556,174558,3,5,0
49814,3,2,174556,174558,174560,2,4,0
49815,4,2,174560,174560,174562,0,2,0
49816,6,3,174566,174566,174569,0,3,4
49817,3,2,174569,174569,174571,0,2,0
49818,6,1,174575,174575,174576,0,1,4
49819,5,3,174580,174580,174583,0,3,4
49820,3,2,174583,174583,174585,0,2,0
49821,3,1,174586,174586,174587,0,1,1
49822,4,2,174590,174590,174592,0,2,3
49823,6,2,174596,174596,174598,0,2,4
49824,1,1,174597,174598,174599,1,2,0
49825,1,2,174598,174599,174601,1,3,0
49826,3,1,174601,174601,174602,0,1,0
49827,1,3,174602,174602,174605,0,3,0
49828,6,3,174608,174608,174611,0,3,3
49829,6,1,174614,174614,174615,0,1,3
49830,1,3,174615,174615,174618,0,3,0
49831,2,3,174617,174618,174621,1,4,0
49832,1,1,174618,174621,174622,3,4,0
49833,2,2,174620,174622,174624,2,4,0
49834,3,2,174623,174624,174626,1,3,0
49835,1,3,174624,174626,174629,2,5,0
49836,4,2,174628,174629,174631,1,3,0
49837,5,2,174633,174633,174635,0,2,2
49838,3,1,174636,174636,174637,0,1,1
49839,6,3,174642,174642,174645,0,3,5
49840,5,3,174647,174647,174650,0,3,2
49841,1,1,174648,174650,174651,2,3,0
49842,1,3,174649,174651,174654,2,5,0
49843,1,3,174650,174654,174657,4,7,0
49844,5,3,174655,174657,174660,2,5,0
49845,2,1,174657,174660,174661,3,4,0
49846,4,1,174661,174661,174662,0,1,0
49847,2,2,174663,174663,174665,0,2,1
49848,4,2,174667,174667,174669,0,2,2
49849,2,3,174669,174669,174672,0,3,0
49850,4,3,174673,174673,174676,0,3,1
49851,5,3,174678,174678,174681,0,3,2
49852,1,1,174679,174681,174682,2,3,0
49853,6,2,174685,174685,174687,0,2,3
49854,6,3,174691,174691,174694,0,3,4
49855,5,3,174696,174696,174699,0,3,2
49856,5,2,174701,174701,174703,0,2,2
49857,2,3,174703,174703,174706,0,3,0
49858,4,1,174707,174707,174708,0,1,1
49859,2,1,174709,174709,174710,0,1,1
49860,5,1,174714,174714,174715,0,1,4
49861,1,2,174715,174715,174717,0,2,0
49862,2,3,174717,174717,174720,0,3,0
49863,2,2,174719,174720,174722,1,3,0
49864,2,2,174721,174722,174724,1,3,0
49865,1,1,174722,174724,174725,2,3,0
49866,3,2,174725,174725,174727,0,2,0
49867,6,3,174731,174731,174734,0,3,4
49868,5,3,174736,174736,174739,0,3,2
49869,5,2,174741,174741,174743,0,2,2
49870,6,1,174747,174747,174748,0,1,4
49871,5,3,174752,174752,174755,0,3,4
49872,5,3,174757,174757,174760,0,3,2
49873,4,2,174761,174761,174763,0,2,1
49874,1,3,174762,174763,174766,1,4,0
49875,3,2,174765,174766,174768,1,3,0
49876,5,3,174770,174770,174773,0,3,2
49877,1,3,174771,174773,174776,2,5,0
49878,1,1,174772,174776,174777,4,5,0
49879,5,3,174777,174777,174780,0,3,0
49880,5,3,174782,174782,174785,0,3,2
49881,4,1,174786,174786,174787,0,1,1
49882,6,2,174792,174792,174794,0,2,5
49883,4,3,174796,174796,174799,0,3,2
49884,5,3,174801,174801,174804,0,3,2
49885,3,1,174804,174804,174805,0,1,0
49886,5,2,174809,174809,174811,0,2,4
49887,6,3,174815,174815,174818,0,3,4
49888,2,3,174817,174818,174821,1,4,0
49889,4,1,174821,174821,174822,0,1,0
49890,4,1,174825,174825,174826,0,1,3
49891,5,1,174830,174830,174831,0,1,4
49892,1,1,174831,174831,174832,0,1,0
49893,6,2,174837,174837,174839,0,2,5
49894,6,2,174843,174843,174845,0,2,4
49895,5,1,174848,174848,174849,0,1,3
49896,2,3,174850,174850,174853,0,3,1
49897,6,1,174856,174856,174857,0,1,3
49898,3,2,174859,174859,174861,0,2,2
49899,5,2,174864,174864,174866,0,2,3
49900,6,1,174870,174870,174871,0,1,4
49901,6,1,174876,174876,174877,0,1,5
49902,4,2,174880,174880,174882,0,2,3
49903,2,2,174882,174882,174884,0,2,0
49904,6,3,174888,174888,174891,0,3,4
49905,5,2,174893,174893,174895,0,2,2
49906,4,2,174897,174897,174899,0,2,2
49907,2,1,174899,174899,174900,0,1,0
49908,2,3,174901,174901,174904,0,3,1
49909,3,3,174904,174904,174907,0,3,0
49910,3,1,174907,174907,174908,0,1,0
49911,2,2,174909,174909,174911,0,2,1
49912,5,1,174914,174914,174915,0,1,3
49913,4,1,174918,174918,174919,0,1,3
49914,1,1,174919,174919,174920,0,1,0
49915,5,2,174924,174924,174926,0,2,4
49916,6,1,174930,174930,174931,0,1,4
49917,5,2,174935,174935,174937,0,2,4
49918,4,2,174939,174939,174941,0,2,2
49919,4,2,174943,174943,174945,0,2,2
49920,3,1,174946,174946,174947,0,1,1
49921,4,2,174950,174950,174952,0,2,3
49922,6,1,174956,174956,174957,0,1,4
49923,6,1,174962,174962,174963,0,1,5
49924,5,1,174967,174967,174968,0,1,4
49925,1,1,174968,174968,174969,0,1,0
49926,1,3,174969,174969,174972,0,3,0
49927,5,3,174974,174974,174977,0,3,2
49928,5,1,174979,174979,174980,0,1,2
49929,3,1,174982,174982,174983,0,1,2
49930,5,1,174987,174987,174988,0,1,4
49931,1,2,174988,174988,174990,0,2,0
49932,5,1,174993,174993,174994,0,1,3
49933,3,2,174996,174996,174998,0,2,2
49934,5,1,175001,175001,175002,0,1,3
49935,2,2,175003,175003,175005,0,2,1
49936,3,3,175006,175006,175009,0,3,1
49937,5,3,175011,175011,175014,0,3,2
49938,6,2,175017,175017,175019,0,2,3
49939,4,2,175021,175021,175023,0,2,2
49940,4,3,175025,175025,175028,0,3,2
49941,1,2,175026,175028,175030,2,4,0
49942,4,3,175030,175030,175033,0,3,0
49943,3,3,175033,175033,175036,0,3,0
49944,6,3,175039,175039,175042,0,3,3
49945,2,1,175041,175042,175043,1,2,0
49946,3,1,175044,175044,175045,0,1,1
49947,6,2,175050,175050,175052,0,2,5
49948,4,1,175054,175054,175055,0,1,2
49949,6,1,175060,175060,175061,0,1,5
49950,3,2,175063,175063,175065,0,2,2
49951,4,2,175067,175067,175069,0,2,2
49952,3,2,175070,175070,175072,0,2,1
49953,6,2,175076,175076,175078,0,2,4
49954,1,3,175077,175078,175081,1,4,0
49955,1,3,175078,175081,175084,3,6,0
49956,6,3,175084,175084,175087,0,3,0
49957,2,2,175086,175087,175089,1,3,0
49958,5,3,175091,175091,175094,0,3,2
49959,3,3,175094,175094,175097,0,3,0
49960,4,3,175098,175098,175101,0,3,1
49961,6,2,175104,175104,175106,0,2,3
49962,4,3,175108,175108,175111,0,3,2
49963,2,1,175110,175111,175112,1,2,0
49964,5,1,175115,175115,175116,0,1,3
49965,2,2,175117,175117,175119,0,2,1
49966,6,2,175123,175123,175125,0,2,4
49967,3,2,175126,175126,175128,0,2,1
49968,6,2,175132,175132,175134,0,2,4
49969,3,2,175135,175135,175137,0,2,1
49970,2,3,175137,175137,175140,0,3,0
49971,4,3,175141,175141,175144,0,3,1
49972,4,2,175145,175145,175147,0,2,1
49973,1,3,175146,175147,175150,1,4,0
49974,1,3,175147,175150,175153,3,6,0
49975,3,1,175150,175153,175154,3,4,0
49976,4,3,175154,175154,175157,0,3,0
49977,3,2,175157,175157,175159,0,2,0
49978,2,3,175159,175159,175162,0,3,0
49979,6,2,175165,175165,175167,0,2,3
49980,5,1,175170,175170,175171,0,1,3
49981,2,2,175172,175172,175174,0,2,1
49982,6,3,175178,175178,175181,0,3,4
49983,3,3,175181,175181,175184,0,3,0
49984,6,3,175187,175187,175190,0,3,3
49985,5,3,175192,175192,175195,0,3,2
49986,2,2,175194,175195,175197,1,3,0
49987,3,3,175197,175197,175200,0,3,0
49988,3,3,175200,175200,175203,0,3,0
49989,4,3,175204,175204,175207,0,3,1
49990,3,3,175207,175207,175210,0,3,0
49991,6,3,175213,175213,175216,0,3,3
49992,6,3,175219,175219,175222,0,3,3
49993,3,3,175222,175222,175225,0,3,0
49994,3,1,175225,175225,175226,0,1,0
49995,3,3,175228,175228,175231,0,3,2
49996,5,1,175233,175233,175234,0,1,2
49997,5,1,175238,175238,175239,0,1,4
49998,4,3,175242,175242,175245,0,3,3
49999,3,2,175245,175245,175247,0,2,0
50000,5,2,175250,175250,175252,0,2,3
50001,4,3,175254,175254,175257,0,3,2
50002,3,2,175257,175257,175259,0,2,0
50003,2,3,175259,175259,175262,0,3,0
50004,5,1,175264,175264,175265,0,1,2
50005,5,1,175269,175269,175270,0,1,4
50006,1,1,175270,175270,175271,0,1,0
50007,4,2,175274,175274,175276,0,2,3
50008,1,3,175275,175276,175279,1,4,0
50009,1,2,175276,175279,175281,3,5,0
50010,4,1,175280,175281,175282,1,2,0
50011,6,2,175286,175286,175288,0,2,4
50012,6,2,175292,175292,175294,0,2,4
50013,6,2,175298,175298,175300,0,2,4
50014,2,1,175300,175300,175301,0,1,0
50015,2,3,175302,175302,175305,0,3,1
50016,4,3,175306,175306,175309,0,3,1
50017,6,3,175312,175312,175315,0,3,3
50018,2,3,175314,175315,175318,1,4,0
50019,4,2,175318,175318,175320,0,2,0
50020,5,2,175323,175323,175325,0,2,3
50021,3,2,175326,175326,175328,0,2,1
50022,5,3,175331,175331,175334,0,3,3
50023,1,1,175332,175334,175335,2,3,0
50024,4,2,175336,175336,175338,0,2,1
50025,3,2,175339,175339,175341,0,2,1
50026,1,1,175340,175341,175342,1,2,0
50027,5,1,175345,175345,175346,0,1,3
50028,3,1,175348,175348,175349,0,1,2
50029,5,3,175353,175353,175356,0,3,4
50030,4,3,175357,175357,175360,0,3,1
50031,1,1,175358,175360,175361,2,3,0
50032,3,2,175361,175361,175363,0,2,0
50033,6,3,175367,175367,175370,0,3,4
50034,2,2,175369,175370,175372,1,3,0
50035,4,2,175373,175373,175375,0,2,1
50036,2,2,175375,175375,175377,0,2,0
50037,3,2,175378,175378,175380,0,2,1
50038,6,3,175384,175384,175387,0,3,4
50039,4,2,175388,175388,175390,0,2,1
50040,5,2,175393,175393,175395,0,2,3
50041,3,3,175396,175396,175399,0,3,1
50042,4,3,175400,175400,175403,0,3,1
50043,4,3,175404,175404,175407,0,3,1
50044,6,2,175410,175410,175412,0,2,3
50045,3,1,175413,175413,175414,0,1,1
50046,1,3,175414,175414,175417,0,3,0
50047,1,3,175415,175417,175420,2,5,0
50048,6,2,175421,175421,175423,0,2,1
50049,6,3,175427,175427,175430,0,3,4
50050,3,2,175430,175430,175432,0,2,0
50051,4,1,175434,175434,175435,0,1,2
50052,3,1,175437,175437,175438,0,1,2
50053,5,2,175442,175442,175444,0,2,4
50054,2,1,175444,175444,175445,0,1,0
50055,3,3,175447,175447,175450,0,3,2
50056,2,2,175449,175450,175452,1,3,0
50057,6,1,175455,175455,175456,0,1,3
50058,4,3,175459,175459,175462,0,3,3
50059,5,2,175464,175464,175466,0,2,2
50060,5,3,175469,175469,175472,0,3,3
50061,5,1,175474,175474,175475,0,1,2
50062,2,1,175476,175476,175477,0,1,1
50063,3,3,175479,175479,175482,0,3,2
50064,2,2,175481,175482,175484,1,3,0
50065,3,3,175484,175484,175487,0,3,0
50066,3,3,175487,175487,175490,0,3,0
50067,1,3,175488,175490,175493,2,5,0
50068,3,3,175491,175493,175496,2,5,0
50069,5,1,175496,175496,175497,0,1,0
50070,3,3,175499,175499,175502,0,3,2
50071,1,2,175500,175502,175504,2,4,0
50072,3,1,175503,175504,175505,1,2,0
50073,3,2,175506,175506,175508,0,2,1
50074,1,3,175507,175508,175511,1,4,0
50075,2,1,175509,175511,175512,2,3,0
50076,6,1,175515,175515,175516,0,1,3
50077,6,2,175521,175521,175523,0,2,5
50078,2,3,175523,175523,175526,0,3,0
50079,2,3,175525,175526,175529,1,4,0
50080,5,3,175530,175530,175533,0,3,1
50081,4,2,175534,175534,175536,0,2,1
50082,6,1,175540,175540,175541,0,1,4
50083,4,1,175544,175544,175545,0,1,3
50084,5,3,175549,175549,175552,0,3,4
50085,4,1,175553,175553,175554,0,1,1
50086,3,2,175556,175556,175558,0,2,2
50087,3,1,175559,175559,175560,0,1,1
50088,6,3,175565,175565,175568,0,3,5
50089,1,3,175566,175568,175571,2,5,0
50090,3,2,175569,175571,175573,2,4,0
50091,2,2,175571,175573,175575,2,4,0
50092,1,3,175572,175575,175578,3,6,0
50093,1,3,175573,175578,175581,5,8,0
50094,5,2,175578,175581,175583,3,5,0
50095,4,3,175582,175583,175586,1,4,0
50096,3,3,175585,175586,175589,1,4,0
50097,2,3,175587,175589,175592,2,5,0
50098,1,2,175588,175592,175594,4,6,0
50099,5,1,175593,175594,175595,1,2,0
50100,6,1,175599,175599,175600,0,1,4
50101,6,3,175605,175605,175608,0,3,5
50102,1,2,175606,175608,175610,2,4,0
50103,2,3,175608,175610,175613,2,5,0
50104,5,3,175613,175613,175616,0,3,0
50105,4,2,175617,175617,175619,0,2,1
50106,3,3,175620,175620,175623,0,3,1
50107,4,1,175624,175624,175625,0,1,1
50108,5,1,175629,175629,175630,0,1,4
50109,2,1,175631,175631,175632,0,1,1
50110,4,1,175635,175635,175636,0,1,3
50111,1,3,175636,175636,175639,0,3,0
50112,1,3,175637,175639,175642,2,5,0
50113,3,2,175640,175642,175644,2,4,0
50114,4,1,175644,175644,175645,0,1,0
50115,5,1,175649,175649,175650,0,1,4
50116,5,3,175654,175654,175657,0,3,4
50117,1,3,175655,175657,175660,2,5,0
50118,3,3,175658,175660,175663,2,5,0
50119,3,1,175661,175663,175664,2,3,0
50120,2,1,175663,175664,175665,1,2,0
50121,2,3,175665,175665,175668,0,3,0
50122,2,1,175667,175668,175669,1,2,0
50123,4,3,175671,175671,175674,0,3,2
50124,4,1,175675,175675,175676,0,1,1
50125,1,2,175676,175676,175678,0,2,0
50126,5,3,175681,175681,175684,0,3,3
50127,5,1,175686,175686,175687,0,1,2
50128,4,1,175690,175690,175691,0,1,3
50129,1,2,175691,175691,175693,0,2,0
50130,4,1,175695,175695,175696,0,1,2
50131,1,3,175696,175696,175699,0,3,0
50132,1,1,175697,175699,175700,2,3,0
50133,6,1,175703,175703,175704,0,1,3
50134,5,2,175708,175708,175710,0,2,4
50135,3,3,175711,175711,175714,0,3,1
50136,4,3,175715,175715,175718,0,3,1
50137,4,3,175719,175719,175722,0,3,1
50138,4,1,175723,175723,175724,0,1,1
50139,3,3,175726,175726,175729,0,3,2
50140,2,2,175728,175729,175731,1,3,0
50141,2,1,175730,175731,175732,1,2,0
50142,6,1,175736,175736,175737,0,1,4
50143,6,2,175742,175742,175744,0,2,5
50144,3,3,175745,175745,175748,0,3,1
50145,1,2,175746,175748,175750,2,4,0
50146,5,3,175751,175751,175754,0,3,1
50147,2,2,175753,175754,175756,1,3,0
50148,3,1,175756,175756,175757,0,1,0
50149,5,3,175761,175761,175764,0,3,4
50150,5,3,175766,175766,175769,0,3,2
50151,6,3,175772,175772,175775,0,3,3
50152,4,3,175776,175776,175779,0,3,1
50153,3,3,175779,175779,175782,0,3,0
50154,3,2,175782,175782,175784,0,2,0
50155,4,2,175786,175786,175788,0,2,2
50156,5,1,175791,175791,175792,0,1,3
50157,4,3,175795,175795,175798,0,3,3
50158,6,3,175801,175801,175804,0,3,3
50159,2,1,175803,175804,175805,1,2,0
50160,4,3,175807,175807,175810,0,3,2
50161,1,3,175808,175810,175813,2,5,0
50162,4,1,175812,175813,175814,1,2,0
50163,5,3,175817,175817,175820,0,3,3
50164,3,2,175820,175820,175822,0,2,0
50165,5,3,175825,175825,175828,0,3,3
50166,5,1,175830,175830,175831,0,1,2
50167,1,3,175831,175831,175834,0,3,0
50168,3,2,175834,175834,175836,0,2,0
50169,2,3,175836,175836,175839,0,3,0
50170,6,1,175842,175842,175843,0,1,3
50171,5,1,175847,175847,175848,0,1,4
50172,6,3,175853,175853,175856,0,3,5
50173,6,2,175859,175859,175861,0,2,3
50174,6,1,175865,175865,175866,0,1,4
50175,4,3,175869,175869,175872,0,3,3
50176,1,2,175870,175872,175874,2,4,0
50177,5,3,175875,175875,175878,0,3,1
50178,1,2,175876,175878,175880,2,4,0
50179,4,3,175880,175880,175883,0,3,0
50180,4,1,175884,175884,175885,0,1,1
50181,5,3,175889,175889,175892,0,3,4
50182,4,1,175893,175893,175894,0,1,1
50183,6,2,175899,175899,175901,0,2,5
50184,6,3,175905,175905,175908,0,3,4
50185,4,1,175909,175909,175910,0,1,1
50186,4,2,175913,175913,175915,0,2,3
50187,1,1,175914,175915,175916,1,2,0
50188,4,1,175918,175918,175919,0,1,2
50189,4,1,175922,175922,175923,0,1,3
50190,2,2,175924,175924,175926,0,2,1
50191,1,3,175925,175926,175929,1,4,0
50192,3,1,175928,175929,175930,1,2,0
50193,1,3,175929,175930,175933,1,4,0
50194,1,2,175930,175933,175935,3,5,0
50195,5,3,175935,175935,175938,0,3,0
50196,6,2,175941,175941,175943,0,2,3
50197,6,3,175947,175947,175950,0,3,4
50198,6,2,175953,175953,175955,0,2,3
50199,2,1,175955,175955,175956,0,1,0
50200,1,3,175956,175956,175959,0,3,0
50201,3,3,175959,175959,175962,0,3,0
50202,6,2,175965,175965,175967,0,2,3
50203,6,3,175971,175971,175974,0,3,4
50204,3,1,175974,175974,175975,0,1,0
50205,1,3,175975,175975,175978,0,3,0
50206,2,2,175977,175978,175980,1,3,0
50207,4,1,175981,175981,175982,0,1,1
50208,3,2,175984,175984,175986,0,2,2
50209,1,2,175985,175986,175988,1,3,0
50210,6,1,175991,175991,175992,0,1,3
50211,3,3,175994,175994,175997,0,3,2
50212,1,1,175995,175997,175998,2,3,0
50213,2,1,175997,175998,175999,1,2,0
50214,6,2,176003,176003,176005,0,2,4
50215,2,3,176005,176005,176008,0,3,0
50216,4,3,176009,176009,176012,0,3,1
50217,3,3,176012,176012,176015,0,3,0
50218,2,1,176014,176015,176016,1,2,0
50219,5,1,176019,176019,176020,0,1,3
50220,1,1,176020,176020,176021,0,1,0
50221,3,2,176023,176023,176025,0,2,2
50222,2,1,176025,176025,176026,0,1,0
50223,4,3,176029,176029,176032,0,3,3
50224,1,2,176030,176032,176034,2,4,0
50225,4,1,176034,176034,176035,0,1,0
50226,5,3,176039,176039,176042,0,3,4
50227,4,1,176043,176043,176044,0,1,1
50228,5,3,176048,176048,176051,0,3,4
50229,5,3,176053,176053,176056,0,3,2
50230,1,2,176054,176056,176058,2,4,0
50231,4,2,176058,176058,176060,0,2,0
50232,1,2,176059,176060,176062,1,3,0
50233,1,2,176060,176062,176064,2,4,0
50234,3,1,176063,176064,176065,1,2,0
50235,3,2,176066,176066,176068,0,2,1
50236,4,3,176070,176070,176073,0,3,2
50237,3,3,176073,176073,176076,0,3,0
50238,3,1,176076,176076,176077,0,1,0
50239,3,3,176079,176079,176082,0,3,2
50240,2,1,176081,176082,176083,1,2,0
50241,2,3,176083,176083,176086,0,3,0
50242,1,3,176084,176086,176089,2,5,0
50243,4,2,176088,176089,176091,1,3,0
50244,3,1,176091,176091,176092,0,1,0
50245,1,1,176092,176092,176093,0,1,0
50246,5,3,176097,176097,176100,0,3,4
50247,2,3,176099,176100,176103,1,4,0
50248,5,3,176104,176104,176107,0,3,1
50249,1,2,176105,176107,176109,2,4,0
50250,6,3,176111,176111,176114,0,3,2
50251,6,3,176117,176117,176120,0,3,3
50252,4,3,176121,176121,176124,0,3,1
50253,3,2,176124,176124,176126,0,2,0
50254,6,2,176130,176130,176132,0,2,4
50255,2,3,176132,176132,176135,0,3,0
50256,2,1,176134,176135,176136,1,2,0
50257,2,3,176136,176136,176139,0,3,0
50258,1,1,176137,176139,176140,2,3,0
50259,5,3,176142,176142,176145,0,3,2
50260,2,2,176144,176145,176147,1,3,0
50261,1,3,176145,176147,176150,2,5,0
50262,2,2,176147,176150,176152,3,5,0
50263,4,2,176151,176152,176154,1,3,0
50264,1,3,176152,176154,176157,2,5,0
50265,2,3,176154,176157,176160,3,6,0
50266,3,2,176157,176160,176162,3,5,0
50267,4,1,176161,176162,176163,1,2,0
50268,5,3,176166,176166,176169,0,3,3
50269,2,2,176168,176169,176171,1,3,0
50270,3,1,176171,176171,176172,0,1,0
50271,6,3,176177,176177,176180,0,3,5
50272,6,1,176183,176183,176184,0,1,3
50273,4,1,176187,176187,176188,0,1,3
50274,3,3,176190,176190,176193,0,3,2
50275,2,3,176192,176193,176196,1,4,0
50276,5,2,176197,176197,176199,0,2,1
50277,5,3,176202,176202,176205,0,3,3
50278,3,1,176205,176205,176206,0,1,0
50279,6,2,176211,176211,176213,0,2,5
50280,2,1,176213,176213,176214,0,1,0
50281,3,3,176216,176216,176219,0,3,2
50282,1,1,176217,176219,176220,2,3,0
50283,4,3,176221,176221,176224,0,3,1
50284,1,1,176222,176224,176225,2,3,0
50285,4,3,176226,176226,176229,0,3,1
50286,1,3,176227,176229,176232,2,5,0
50287,4,2,176231,176232,176234,1,3,0
50288,6,3,176237,176237,176240,0,3,3
50289,1,1,176238,176240,176241,2,3,0
50290,2,1,176240,176241,176242,1,2,0
50291,5,3,176245,176245,176248,0,3,3
50292,5,3,176250,176250,176253,0,3,2
50293,4,2,176254,176254,176256,0,2,1
50294,5,3,176259,176259,176262,0,3,3
50295,5,3,176264,176264,176267,0,3,2
50296,4,2,176268,176268,176270,0,2,1
50297,4,1,176272,176272,176273,0,1,2
50298,3,3,176275,176275,176278,0,3,2
50299,1,1,176276,176278,176279,2,3,0
50300,1,3,176277,176279,176282,2,5,0
50301,3,2,176280,176282,176284,2,4,0
50302,4,2,176284,176284,176286,0,2,0
50303,2,2,176286,176286,176288,0,2,0
50304,6,3,176292,176292,176295,0,3,4
50305,4,2,176296,176296,176298,0,2,1
50306,2,3,176298,176298,176301,0,3,0
50307,6,2,176304,176304,176306,0,2,3
50308,1,3,176305,176306,176309,1,4,0
50309,5,1,176310,176310,176311,0,1,1
50310,4,1,176314,176314,176315,0,1,3
50311,1,3,176315,176315,176318,0,3,0
50312,1,3,176316,176318,176321,2,5,0
50313,3,1,176319,176321,176322,2,3,0
50314,5,3,176324,176324,176327,0,3,2
50315,5,1,176329,176329,176330,0,1,2
50316,4,3,176333,176333,176336,0,3,3
50317,2,1,176335,176336,176337,1,2,0
50318,3,2,176338,176338,176340,0,2,1
50319,4,3,176342,176342,176345,0,3,2
50320,2,3,176344,176345,176348,1,4,0
50321,6,2,176350,176350,176352,0,2,2
50322,1,1,176351,176352,176353,1,2,0
50323,2,2,176353,176353,176355,0,2,0
50324,2,3,176355,176355,176358,0,3,0
50325,3,3,176358,176358,176361,0,3,0
50326,4,2,176362,176362,176364,0,2,1
50327,4,3,176366,176366,176369,0,3,2
50328,4,1,176370,176370,176371,0,1,1
50329,2,3,176372,176372,176375,0,3,1
50330,5,3,176377,176377,176380,0,3,2
50331,5,3,176382,176382,176385,0,3,2
50332,2,2,176384,176385,176387,1,3,0
50333,5,2,176389,176389,176391,0,2,2
50334,4,2,176393,176393,176395,0,2,2
50335,6,2,176399,176399,176401,0,2,4
50336,2,2,176401,176401,176403,0,2,0
50337,1,2,176402,176403,176405,1,3,0
50338,1,1,176403,176405,176406,2,3,0
50339,3,2,176406,176406,176408,0,2,0
50340,4,1,176410,176410,176411,0,1,2
50341,2,3,176412,176412,176415,0,3,1
50342,3,1,176415,176415,176416,0,1,0
50343,1,3,176416,176416,176419,0,3,0
50344,4,2,176420,176420,176422,0,2,1
50345,3,3,176423,176423,176426,0,3,1
50346,2,2,176425,176426,176428,1,3,0
50347,4,3,176429,176429,176432,0,3,1
50348,3,3,176432,176432,176435,0,3,0
50349,2,2,176434,176435,176437,1,3,0
50350,5,3,176439,176439,176442,0,3,2
50351,1,2,176440,176442,176444,2,4,0
50352,6,2,176446,176446,176448,0,2,2
50353,4,2,176450,176450,176452,0,2,2
50354,3,2,176453,176453,176455,0,2,1
50355,2,2,176455,176455,176457,0,2,0
50356,3,1,176458,176458,176459,0,1,1
50357,5,3,176463,176463,176466,0,3,4
50358,6,2,176469,176469,176471,0,2,3
50359,4,1,176473,176473,176474,0,1,2
50360,4,1,176477,176477,176478,0,1,3
50361,3,1,176480,176480,176481,0,1,2
50362,5,1,176485,176485,176486,0,1,4
50363,3,1,176488,176488,176489,0,1,2
50364,3,3,176491,176491,176494,0,3,2
50365,2,1,176493,176494,176495,1,2,0
50366,4,3,176497,176497,176500,0,3,2
50367,6,3,176503,176503,176506,0,3,3
50368,3,2,176506,176506,176508,0,2,0
50369,2,3,176508,176508,176511,0,3,0
50370,5,2,176513,176513,176515,0,2,2
50371,4,1,176517,176517,176518,0,1,2
50372,5,2,176522,176522,176524,0,2,4
50373,4,3,176526,176526,176529,0,3,2
50374,6,2,176532,176532,176534,0,2,3
50375,4,3,176536,176536,176539,0,3,2
50376,2,2,176538,176539,176541,1,3,0
50377,5,2,176543,176543,176545,0,2,2
50378,1,1,176544,176545,176546,1,2,0
50379,6,3,176550,176550,176553,0,3,4
50380,5,1,176555,176555,176556,0,1,2
50381,5,2,176560,176560,176562,0,2,4
50382,6,3,176566,176566,176569,0,3,4
50383,1,2,176567,176569,176571,2,4,0
50384,2,3,176569,176571,176574,2,5,0
50385,6,3,176575,176575,176578,0,3,1
50386,4,3,176579,176579,176582,0,3,1
50387,3,2,176582,176582,176584,0,2,0
50388,3,1,176585,176585,176586,0,1,1
50389,4,2,176589,176589,176591,0,2,3
50390,1,1,176590,176591,176592,1,2,0
50391,4,2,176594,176594,176596,0,2,2
50392,3,1,176597,176597,176598,0,1,1
50393,1,1,176598,176598,176599,0,1,0
50394,2,1,176600,176600,176601,0,1,1
50395,1,1,176601,176601,176602,0,1,0
50396,4,1,176605,176605,176606,0,1,3
50397,6,2,176611,176611,176613,0,2,5
50398,1,3,176612,176613,176616,1,4,0
50399,4,2,176616,176616,176618,0,2,0
50400,4,1,176620,176620,176621,0,1,2
50401,2,3,176622,176622,176625,0,3,1
50402,5,2,176627,176627,176629,0,2,2
50403,1,3,176628,176629,176632,1,4,0
50404,1,3,176629,176632,176635,3,6,0
50405,2,3,176631,176635,176638,4,7,0
50406,1,2,176632,176638,176640,6,8,0
50407,5,2,176637,176640,176642,3,5,0
50408,3,1,176640,176642,176643,2,3,0
50409,3,1,176643,176643,176644,0,1,0
50410,4,3,176647,176647,176650,0,3,3
50411,1,2,176648,176650,176652,2,4,0
50412,2,1,176650,176652,176653,2,3,0
50413,4,3,176654,176654,176657,0,3,1
50414,5,3,176659,176659,176662,0,3,2
50415,1,1,176660,176662,176663,2,3,0
50416,3,2,176663,176663,176665,0,2,0
50417,4,1,176667,176667,176668,0,1,2
50418,6,2,176673,176673,176675,0,2,5
50419,2,1,176675,176675,176676,0,1,0
50420,2,3,176677,176677,176680,0,3,1
50421,2,2,176679,176680,176682,1,3,0
50422,6,2,176685,176685,176687,0,2,3
50423,3,2,176688,176688,176690,0,2,1
50424,6,1,176694,176694,176695,0,1,4
50425,6,1,176700,176700,176701,0,1,5
50426,4,3,176704,176704,176707,0,3,3
50427,1,2,176705,176707,176709,2,4,0
50428,4,1,176709,176709,176710,0,1,0
50429,6,2,176715,176715,176717,0,2,5
50430,2,1,176717,176717,176718,0,1,0
50431,6,3,176723,176723,176726,0,3,5
50432,2,1,176725,176726,176727,1,2,0
50433,2,3,176727,176727,176730,0,3,0
50434,4,1,176731,176731,176732,0,1,1
50435,6,2,176737,176737,176739,0,2,5
50436,5,2,176742,176742,176744,0,2,3
50437,1,3,176743,176744,176747,1,4,0
50438,1,2,176744,176747,176749,3,5,0
50439,4,1,176748,176749,176750,1,2,0
50440,5,1,176753,176753,176754,0,1,3
50441,1,3,176754,176754,176757,0,3,0
50442,2,2,176756,176757,176759,1,3,0
50443,1,3,176757,176759,176762,2,5,0
50444,1,2,176758,176762,176764,4,6,0
50445,3,3,176761,176764,176767,3,6,0
50446,4,2,176765,176767,176769,2,4,0
50447,4,3,176769,176769,176772,0,3,0
50448,4,1,176773,176773,176774,0,1,1
50449,1,1,176774,176774,176775,0,1,0
50450,6,1,176780,176780,176781,0,1,5
50451,2,1,176782,176782,176783,0,1,1
50452,2,3,176784,176784,176787,0,3,1
50453,4,2,176788,176788,176790,0,2,1
50454,3,1,176791,176791,176792,0,1,1
50455,3,2,176794,176794,176796,0,2,2
50456,3,2,176797,176797,176799,0,2,1
50457,3,1,176800,176800,176801,0,1,1
50458,4,2,176804,176804,176806,0,2,3
50459,5,1,176809,176809,176810,0,1,3
50460,6,1,176815,176815,176816,0,1,5
50461,6,1,176821,176821,176822,0,1,5
50462,6,1,176827,176827,176828,0,1,5
50463,1,1,176828,176828,176829,0,1,0
50464,2,2,176830,176830,176832,0,2,1
50465,4,3,176834,176834,176837,0,3,2
50466,1,3,176835,176837,176840,2,5,0
50467,4,1,176839,176840,176841,1,2,0
50468,1,1,176840,176841,176842,1,2,0
50469,5,1,176845,176845,176846,0,1,3
50470,3,3,176848,176848,176851,0,3,2
50471,6,2,176854,176854,176856,0,2,3
50472,6,1,176860,176860,176861,0,1,4
50473,3,1,176863,176863,176864,0,1,2
50474,6,1,176869,176869,176870,0,1,5
50475,2,3,176871,176871,176874,0,3,1
50476,3,2,176874,176874,176876,0,2,0
50477,1,2,176875,176876,176878,1,3,0
50478,2,2,176877,176878,176880,1,3,0
50479,4,2,176881,176881,176883,0,2,1
50480,4,3,176885,176885,176888,0,3,2
50481,6,2,176891,176891,176893,0,2,3
50482,2,3,176893,176893,176896,0,3,0
50483,2,2,176895,176896,176898,1,3,0
50484,6,1,176901,176901,176902,0,1,3
50485,6,2,176907,176907,176909,0,2,5
50486,5,3,176912,176912,176915,0,3,3
50487,1,2,176913,176915,176917,2,4,0
50488,3,3,176916,176917,176920,1,4,0
50489,4,3,176920,176920,176923,0,3,0
50490,3,1,176923,176923,176924,0,1,0
50491,3,2,176926,176926,176928,0,2,2
50492,6,2,176932,176932,176934,0,2,4
50493,4,2,176936,176936,176938,0,2,2
50494,5,3,176941,176941,176944,0,3,3
50495,4,3,176945,176945,176948,0,3,1
50496,2,1,176947,176948,176949,1,2,0
50497,4,1,176951,176951,176952,0,1,2
50498,2,2,176953,176953,176955,0,2,1
50499,4,1,176957,176957,176958,0,1,2
50500,1,3,176958,176958,176961,0,3,0
50501,6,3,176964,176964,176967,0,3,3
50502,2,1,176966,176967,176968,1,2,0
50503,1,2,176967,176968,176970,1,3,0
50504,4,3,176971,176971,176974,0,3,1
50505,2,1,176973,176974,176975,1,2,0
50506,5,2,176978,176978,176980,0,2,3
50507,2,2,176980,176980,176982,0,2,0
50508,6,2,176986,176986,176988,0,2,4
50509,1,3,176987,176988,176991,1,4,0
50510,6,1,176993,176993,176994,0,1,2
50511,5,2,176998,176998,177000,0,2,4
50512,4,3,177002,177002,177005,0,3,2
50513,6,1,177008,177008,177009,0,1,3
50514,6,1,177014,177014,177015,0,1,5
50515,2,3,177016,177016,177019,0,3,1
50516,5,1,177021,177021,177022,0,1,2
50517,6,1,177027,177027,177028,0,1,5
50518,4,3,177031,177031,177034,0,3,3
50519,4,3,177035,177035,177038,0,3,1
50520,5,2,177040,177040,177042,0,2,2
50521,2,3,177042,177042,177045,0,3,0
50522,2,1,177044,177045,177046,1,2,0
50523,1,1,177045,177046,177047,1,2,0
50524,2,3,177047,177047,177050,0,3,0
50525,1,3,177048,177050,177053,2,5,0
50526,1,2,177049,177053,177055,4,6,0
50527,3,2,177052,177055,177057,3,5,0
50528,1,3,177053,177057,177060,4,7,0
50529,1,2,177054,177060,177062,6,8,0
50530,4,1,177058,177062,177063,4,5,0
50531,6,1,177064,177064,177065,0,1,1
50532,6,3,177070,177070,177073,0,3,5
50533,6,3,177076,177076,177079,0,3,3
50534,3,1,177079,177079,177080,0,1,0
50535,4,3,177083,177083,177086,0,3,3
50536,6,1,177089,177089,177090,0,1,3
50537,5,3,177094,177094,177097,0,3,4
50538,1,3,177095,177097,177100,2,5,0
50539,6,1,177101,177101,177102,0,1,1
50540,5,1,177106,177106,177107,0,1,4
50541,1,2,177107,177107,177109,0,2,0
50542,6,1,177113,177113,177114,0,1,4
50543,3,1,177116,177116,177117,0,1,2
50544,6,3,177122,177122,177125,0,3,5
50545,4,3,177126,177126,177129,0,3,1
50546,6,1,177132,177132,177133,0,1,3
50547,6,1,177138,177138,177139,0,1,5
50548,4,2,177142,177142,177144,0,2,3
50549,6,3,177148,177148,177151,0,3,4
50550,5,3,177153,177153,177156,0,3,2
50551,4,2,177157,177157,177159,0,2,1
50552,2,3,177159,177159,177162,0,3,0
50553,2,2,177161,177162,177164,1,3,0
50554,3,2,177164,177164,177166,0,2,0
50555,1,1,177165,177166,177167,1,2,0
50556,3,3,177168,177168,177171,0,3,1
50557,5,2,177173,177173,177175,0,2,2
50558,2,1,177175,177175,177176,0,1,0
50559,5,3,177180,177180,177183,0,3,4
50560,5,1,177185,177185,177186,0,1,2
50561,3,1,177188,177188,177189,0,1,2
50562,4,1,177192,177192,177193,0,1,3
50563,3,1,177195,177195,177196,0,1,2
50564,5,2,177200,177200,177202,0,2,4
50565,2,1,177202,177202,177203,0,1,0
50566,6,1,177208,177208,177209,0,1,5
50567,1,1,177209,177209,177210,0,1,0
50568,2,3,177211,177211,177214,0,3,1
50569,2,1,177213,177214,177215,1,2,0
50570,2,1,177215,177215,177216,0,1,0
50571,6,1,177221,177221,177222,0,1,5
50572,4,2,177225,177225,177227,0,2,3
50573,6,1,177231,177231,177232,0,1,4
50574,3,1,177234,177234,177235,0,1,2
50575,4,2,177238,177238,177240,0,2,3
50576,1,2,177239,177240,177242,1,3,0
50577,3,2,177242,177242,177244,0,2,0
50578,1,1,177243,177244,177245,1,2,0
50579,2,3,177245,177245,177248,0,3,0
50580,1,3,177246,177248,177251,2,5,0
50581,3,1,177249,177251,177252,2,3,0
50582,3,3,177252,177252,177255,0,3,0
50583,2,2,177254,177255,177257,1,3,0
50584,4,2,177258,177258,177260,0,2,1
50585,6,2,177264,177264,177266,0,2,4
50586,3,2,177267,177267,177269,0,2,1
50587,3,2,177270,177270,177272,0,2,1
50588,6,2,177276,177276,177278,0,2,4
50589,1,3,177277,177278,177281,1,4,0
50590,1,2,177278,177281,177283,3,5,0
50591,2,3,177280,177283,177286,3,6,0
50592,2,3,177282,177286,177289,4,7,0
50593,1,1,177283,177289,177290,6,7,0
50594,5,2,177288,177290,177292,2,4,0
50595,3,1,177291,177292,177293,1,2,0
50596,1,1,177292,177293,177294,1,2,0
50597,5,3,177297,177297,177300,0,3,3
50598,6,1,177303,177303,177304,0,1,3
50599,3,1,177306,177306,177307,0,1,2
50600,5,2,177311,177311,177313,0,2,4
50601,1,1,177312,177313,177314,1,2,0
50602,4,3,177316,177316,177319,0,3,2
50603,6,2,177322,177322,177324,0,2,3
50604,2,3,177324,177324,177327,0,3,0
50605,4,1,177328,177328,177329,0,1,1
50606,5,2,177333,177333,177335,0,2,4
50607,6,2,177339,177339,177341,0,2,4
50608,6,3,177345,177345,177348,0,3,4
50609,4,3,177349,177349,177352,0,3,1
50610,4,3,177353,177353,177356,0,3,1
50611,4,1,177357,177357,177358,0,1,1
50612,3,1,177360,177360,177361,0,1,2
50613,3,3,177363,177363,177366,0,3,2
50614,6,3,177369,177369,177372,0,3,3
50615,5,3,177374,177374,177377,0,3,2
50616,3,3,177377,177377,177380,0,3,0
50617,5,1,177382,177382,177383,0,1,2
50618,6,1,177388,177388,177389,0,1,5
50619,6,1,177394,177394,177395,0,1,5
50620,2,2,177396,177396,177398,0,2,1
50621,1,1,177397,177398,177399,1,2,0
50622,2,2,177399,177399,177401,0,2,0
50623,6,3,177405,177405,177408,0,3,4
50624,2,2,177407,177408,177410,1,3,0
50625,3,1,177410,177410,177411,0,1,0
50626,5,1,177415,177415,177416,0,1,4
50627,4,1,177419,177419,177420,0,1,3
50628,4,1,177423,177423,177424,0,1,3
50629,5,1,177428,177428,177429,0,1,4
50630,5,3,177433,177433,177436,0,3,4
50631,1,3,177434,177436,177439,2,5,0
50632,1,3,177435,177439,177442,4,7,0
50633,1,2,177436,177442,177444,6,8,0
50634,3,2,177439,177444,177446,5,7,0
50635,6,1,177445,177446,177447,1,2,0
50636,6,2,177451,177451,177453,0,2,4
50637,6,1,177457,177457,177458,0,1,4
50638,4,3,177461,177461,177464,0,3,3
50639,4,1,177465,177465,177466,0,1,1
50640,5,2,177470,177470,177472,0,2,4
50641,4,1,177474,177474,177475,0,1,2
50642,2,1,177476,177476,177477,0,1,1
50643,6,2,177482,177482,177484,0,2,5
50644,3,2,177485,177485,177487,0,2,1
50645,3,1,177488,177488,177489,0,1,1
50646,5,2,177493,177493,177495,0,2,4
50647,2,1,177495,177495,177496,0,1,0
50648,1,2,177496,177496,177498,0,2,0
50649,5,3,177501,177501,177504,0,3,3
50650,6,3,177507,177507,177510,0,3,3
50651,2,2,177509,177510,177512,1,3,0
50652,2,3,177511,177512,177515,1,4,0
50653,2,3,177513,177515,177518,2,5,0
50654,4,2,177517,177518,177520,1,3,0
50655,6,2,177523,177523,177525,0,2,3
50656,6,2,177529,177529,177531,0,2,4
50657,6,1,177535,177535,177536,0,1,4
50658,4,2,177539,177539,177541,0,2,3
50659,4,1,177543,177543,177544,0,1,2
50660,5,3,177548,177548,177551,0,3,4
50661,5,1,177553,177553,177554,0,1,2
50662,1,3,177554,177554,177557,0,3,0
50663,6,2,177560,177560,177562,0,2,3
50664,5,1,177565,177565,177566,0,1,3
50665,6,2,177571,177571,177573,0,2,5
50666,4,3,177575,177575,177578,0,3,2
50667,2,3,177577,177578,177581,1,4,0
50668,3,1,177580,177581,177582,1,2,0
50669,6,3,177586,177586,177589,0,3,4
50670,3,1,177589,177589,177590,0,1,0
50671,2,1,177591,177591,177592,0,1,1
50672,2,2,177593,177593,177595,0,2,1
50673,2,2,177595,177595,177597,0,2,0
50674,2,3,177597,177597,177600,0,3,0
50675,4,2,177601,177601,177603,0,2,1
50676,2,1,177603,177603,177604,0,1,0
50677,5,3,177608,177608,177611,0,3,4
50678,2,1,177610,177611,177612,1,2,0
50679,5,3,177615,177615,177618,0,3,3
50680,4,3,177619,177619,177622,0,3,1
50681,2,1,177621,177622,177623,1,2,0
50682,2,1,177623,177623,177624,0,1,0
50683,5,3,177628,177628,177631,0,3,4
50684,4,1,177632,177632,177633,0,1,1
50685,1,2,177633,177633,177635,0,2,0
50686,1,3,177634,177635,177638,1,4,0
50687,4,3,177638,177638,177641,0,3,0
50688,2,3,177640,177641,177644,1,4,0
50689,2,1,177642,177644,177645,2,3,0
50690,3,1,177645,177645,177646,0,1,0
50691,2,1,177647,177647,177648,0,1,1
50692,6,3,177653,177653,177656,0,3,5
50693,6,2,177659,177659,177661,0,2,3
50694,4,1,177663,177663,177664,0,1,2
50695,5,3,177668,177668,177671,0,3,4
50696,5,3,177673,177673,177676,0,3,2
50697,2,1,177675,177676,177677,1,2,0
50698,4,1,177679,177679,177680,0,1,2
50699,2,3,177681,177681,177684,0,3,1
50700,3,3,177684,177684,177687,0,3,0
50701,2,3,177686,177687,177690,1,4,0
50702,1,3,177687,177690,177693,3,6,0
50703,4,3,177691,177693,177696,2,5,0
50704,1,1,177692,177696,177697,4,5,0
50705,4,1,177696,177697,177698,1,2,0
50706,6,1,177702,177702,177703,0,1,4
50707,6,2,177708,177708,177710,0,2,5
50708,5,2,177713,177713,177715,0,2,3
50709,6,2,177719,177719,177721,0,2,4
50710,2,3,177721,177721,177724,0,3,0
50711,1,1,177722,177724,177725,2,3,0
50712,4,3,177726,177726,177729,0,3,1
50713,5,1,177731,177731,177732,0,1,2
50714,5,1,177736,177736,177737,0,1,4
50715,1,3,177737,177737,177740,0,3,0
50716,1,1,177738,177740,177741,2,3,0
50717,3,1,177741,177741,177742,0,1,0
50718,3,1,177744,177744,177745,0,1,2
50719,3,2,177747,177747,177749,0,2,2
50720,6,3,177753,177753,177756,0,3,4
50721,5,2,177758,177758,177760,0,2,2
50722,2,2,177760,177760,177762,0,2,0
50723,4,2,177764,177764,177766,0,2,2
50724,2,1,177766,177766,177767,0,1,0
50725,6,1,177772,177772,177773,0,1,5
50726,4,1,177776,177776,177777,0,1,3
50727,6,1,177782,177782,177783,0,1,5
50728,3,1,177785,177785,177786,0,1,2
50729,2,2,177787,177787,177789,0,2,1
50730,2,3,177789,177789,177792,0,3,0
50731,5,1,177794,177794,177795,0,1,2
50732,1,3,177795,177795,177798,0,3,0
50733,5,1,177800,177800,177801,0,1,2
50734,3,3,177803,177803,177806,0,3,2
50735,6,2,177809,177809,177811,0,2,3
50736,5,3,177814,177814,177817,0,3,3
50737,4,1,177818,177818,177819,0,1,1
50738,4,1,177822,177822,177823,0,1,3
50739,2,1,177824,177824,177825,0,1,1
50740,1,3,177825,177825,177828,0,3,0
50741,2,3,177827,177828,177831,1,4,0
50742,5,2,177832,177832,177834,0,2,1
50743,6,1,177838,177838,177839,0,1,4
50744,6,2,177844,177844,177846,0,2,5
50745,1,1,177845,177846,177847,1,2,0
50746,5,3,177850,177850,177853,0,3,3
50747,3,2,177853,177853,177855,0,2,0
50748,2,1,177855,177855,177856,0,1,0
50749,3,2,177858,177858,177860,0,2,2
50750,2,1,177860,177860,177861,0,1,0
50751,4,3,177864,177864,177867,0,3,3
50752,6,2,177870,177870,177872,0,2,3
50753,6,2,177876,177876,177878,0,2,4
50754,4,3,177880,177880,177883,0,3,2
50755,2,3,177882,177883,177886,1,4,0
50756,4,2,177886,177886,177888,0,2,0
50757,6,1,177892,177892,177893,0,1,4
50758,6,1,177898,177898,177899,0,1,5
50759,6,2,177904,177904,177906,0,2,5
50760,2,3,177906,177906,177909,0,3,0
50761,2,3,177908,177909,177912,1,4,0
50762,1,2,177909,177912,177914,3,5,0
50763,5,3,177914,177914,177917,0,3,0
50764,5,1,177919,177919,177920,0,1,2
50765,1,2,177920,177920,177922,0,2,0
50766,3,3,177923,177923,177926,0,3,1
50767,6,2,177929,177929,177931,0,2,3
50768,3,1,177932,177932,177933,0,1,1
50769,2,1,177934,177934,177935,0,1,1
50770,4,2,177938,177938,177940,0,2,3
50771,3,2,177941,177941,177943,0,2,1
50772,6,2,177947,177947,177949,0,2,4
50773,3,1,177950,177950,177951,0,1,1
50774,1,1,177951,177951,177952,0,1,0
50775,6,2,177957,177957,177959,0,2,5
50776,1,2,177958,177959,177961,1,3,0
50777,1,1,177959,177961,177962,2,3,0
50778,1,2,177960,177962,177964,2,4,0
50779,4,1,177964,177964,177965,0,1,0
50780,6,3,177970,177970,177973,0,3,5
50781,3,2,177973,177973,177975,0,2,0
50782,4,1,177977,177977,177978,0,1,2
50783,1,1,177978,177978,177979,0,1,0
50784,6,3,177984,177984,177987,0,3,5
50785,4,1,177988,177988,177989,0,1,1
50786,4,3,177992,177992,177995,0,3,3
50787,1,2,177993,177995,177997,2,4,0
50788,3,2,177996,177997,177999,1,3,0
50789,5,2,178001,178001,178003,0,2,2
50790,3,2,178004,178004,178006,0,2,1
50791,1,2,178005,178006,178008,1,3,0
50792,3,3,178008,178008,178011,0,3,0
50793,3,3,178011,178011,178014,0,3,0
50794,4,3,178015,178015,178018,0,3,1
50795,6,1,178021,178021,178022,0,1,3
50796,3,2,178024,178024,178026,0,2,2
50797,2,1,178026,178026,178027,0,1,0
50798,2,1,178028,178028,178029,0,1,1
50799,3,1,178031,178031,178032,0,1,2
50800,4,3,178035,178035,178038,0,3,3
50801,1,2,178036,178038,178040,2,4,0
50802,4,3,178040,178040,178043,0,3,0
50803,6,3,178046,178046,178049,0,3,3
50804,5,3,178051,178051,178054,0,3,2
50805,5,2,178056,178056,178058,0,2,2
50806,3,1,178059,178059,178060,0,1,1
50807,6,2,178065,178065,178067,0,2,5
50808,2,2,178067,178067,178069,0,2,0
50809,1,3,178068,178069,178072,1,4,0
50810,5,1,178073,178073,178074,0,1,1
50811,1,3,178074,178074,178077,0,3,0
50812,4,1,178078,178078,178079,0,1,1
50813,2,2,178080,178080,178082,0,2,1
50814,5,3,178085,178085,178088,0,3,3
50815,4,2,178089,178089,178091,0,2,1
50816,2,1,178091,178091,178092,0,1,0
50817,6,3,178097,178097,178100,0,3,5
50818,2,3,178099,178100,178103,1,4,0
50819,6,3,178105,178105,178108,0,3,2
50820,3,2,178108,178108,178110,0,2,0
50821,2,1,178110,178110,178111,0,1,0
50822,5,2,178115,178115,178117,0,2,4
50823,2,1,178117,178117,178118,0,1,0
50824,5,3,178122,178122,178125,0,3,4
50825,4,2,178126,178126,178128,0,2,1
50826,1,2,178127,178128,178130,1,3,0
50827,1,1,178128,178130,178131,2,3,0
50828,4,2,178132,178132,178134,0,2,1
50829,2,3,178134,178134,178137,0,3,0
50830,5,2,178139,178139,178141,0,2,2
50831,2,2,178141,178141,178143,0,2,0
50832,4,1,178145,178145,178146,0,1,2
50833,5,1,178150,178150,178151,0,1,4
50834,2,3,178152,178152,178155,0,3,1
50835,6,2,178158,178158,178160,0,2,3
50836,2,3,178160,178160,178163,0,3,0
50837,1,1,178161,178163,178164,2,3,0
50838,4,2,178165,178165,178167,0,2,1
50839,2,1,178167,178167,178168,0,1,0
50840,5,3,178172,178172,178175,0,3,4
50841,3,1,178175,178175,178176,0,1,0
50842,4,3,178179,178179,178182,0,3,3
50843,5,3,178184,178184,178187,0,3,2
50844,5,3,178189,178189,178192,0,3,2
50845,3,1,178192,178192,178193,0,1,0
50846,6,2,178198,178198,178200,0,2,5
50847,2,2,178200,178200,178202,0,2,0
50848,2,1,178202,178202,178203,0,1,0
50849,6,2,178208,178208,178210,0,2,5
50850,4,2,178212,178212,178214,0,2,2
50851,1,1,178213,178214,178215,1,2,0
50852,2,1,178215,178215,178216,0,1,0
50853,6,1,178221,178221,178222,0,1,5
50854,5,1,178226,178226,178227,0,1,4
50855,6,2,178232,178232,178234,0,2,5
50856,4,2,178236,178236,178238,0,2,2
50857,1,1,178237,178238,178239,1,2,0
50858,1,3,178238,178239,178242,1,4,0
50859,5,2,178243,178243,178245,0,2,1
50860,3,3,178246,178246,178249,0,3,1
50861,1,1,178247,178249,178250,2,3,0
50862,1,2,178248,178250,178252,2,4,0
50863,2,1,178250,178252,178253,2,3,0
50864,4,2,178254,178254,178256,0,2,1
50865,4,3,178258,178258,178261,0,3,2
50866,4,3,178262,178262,178265,0,3,1
50867,4,3,178266,178266,178269,0,3,1
50868,5,2,178271,178271,178273,0,2,2
50869,4,2,178275,178275,178277,0,2,2
50870,1,2,178276,178277,178279,1,3,0
50871,5,3,178281,178281,178284,0,3,2
50872,1,1,178282,178284,178285,2,3,0
50873,4,2,178286,178286,178288,0,2,1
50874,1,1,178287,178288,178289,1,2,0
50875,2,1,178289,178289,178290,0,1,0
50876,4,2,178293,178293,178295,0,2,3
50877,4,3,178297,178297,178300,0,3,2
50878,6,3,178303,178303,178306,0,3,3
50879,2,1,178305,178306,178307,1,2,0
50880,5,3,178310,178310,178313,0,3,3
50881,1,2,178311,178313,178315,2,4,0
50882,6,3,178317,178317,178320,0,3,2
50883,5,1,178322,178322,178323,0,1,2
50884,3,2,178325,178325,178327,0,2,2
50885,4,1,178329,178329,178330,0,1,2
50886,3,1,178332,178332,178333,0,1,2
50887,1,1,178333,178333,178334,0,1,0
50888,2,3,178335,178335,178338,0,3,1
50889,1,3,178336,178338,178341,2,5,0
50890,2,1,178338,178341,178342,3,4,0
50891,2,1,178340,178342,178343,2,3,0
50892,3,3,178343,178343,178346,0,3,0
50893,6,1,178349,178349,178350,0,1,3
50894,2,1,178351,178351,178352,0,1,1
50895,4,2,178355,178355,178357,0,2,3
50896,3,1,178358,178358,178359,0,1,1
50897,2,1,178360,178360,178361,0,1,1
50898,6,1,178366,178366,178367,0,1,5
50899,6,2,178372,178372,178374,0,2,5
50900,4,2,178376,178376,178378,0,2,2
50901,2,2,178378,178378,178380,0,2,0
50902,2,1,178380,178380,178381,0,1,0
50903,1,1,178381,178381,178382,0,1,0
50904,3,1,178384,178384,178385,0,1,2
50905,5,3,178389,178389,178392,0,3,4
50906,3,3,178392,178392,178395,0,3,0
50907,5,3,178397,178397,178400,0,3,2
50908,1,2,178398,178400,178402,2,4,0
50909,1,2,178399,178402,178404,3,5,0
50910,2,2,178401,178404,178406,3,5,0
50911,3,1,178404,178406,178407,2,3,0
50912,5,1,178409,178409,178410,0,1,2
50913,6,3,178415,178415,178418,0,3,5
50914,5,3,178420,178420,178423,0,3,2
50915,4,2,178424,178424,178426,0,2,1
50916,4,3,178428,178428,178431,0,3,2
50917,5,2,178433,178433,178435,0,2,2
50918,1,2,178434,178435,178437,1,3,0
50919,4,1,178438,178438,178439,0,1,1
50920,3,2,178441,178441,178443,0,2,2
50921,3,2,178444,178444,178446,0,2,1
50922,5,1,178449,178449,178450,0,1,3
50923,1,1,178450,178450,178451,0,1,0
50924,5,3,178455,178455,178458,0,3,4
50925,6,1,178461,178461,178462,0,1,3
50926,5,1,178466,178466,178467,0,1,4
50927,5,3,178471,178471,178474,0,3,4
50928,2,1,178473,178474,178475,1,2,0
50929,2,1,178475,178475,178476,0,1,0
50930,2,1,178477,178477,178478,0,1,1
50931,3,2,178480,178480,178482,0,2,2
50932,1,1,178481,178482,178483,1,2,0
50933,3,1,178484,178484,178485,0,1,1
50934,1,1,178485,178485,178486,0,1,0
50935,3,2,178488,178488,178490,0,2,2
50936,5,2,178493,178493,178495,0,2,3
50937,6,3,178499,178499,178502,0,3,4
50938,1,2,178500,178502,178504,2,4,0
50939,6,1,178506,178506,178507,0,1,2
50940,3,2,178509,178509,178511,0,2,2
50941,4,2,178513,178513,178515,0,2,2
50942,1,1,178514,178515,178516,1,2,0
50943,6,1,178520,178520,178521,0,1,4
50944,4,2,178524,178524,178526,0,2,3
50945,3,1,178527,178527,178528,0,1,1
50946,2,3,178529,178529,178532,0,3,1
50947,4,3,178533,178533,178536,0,3,1
50948,1,3,178534,178536,178539,2,5,0
50949,3,3,178537,178539,178542,2,5,0
50950,6,1,178543,178543,178544,0,1,1
50951,5,1,178548,178548,178549,0,1,4
50952,3,1,178551,178551,178552,0,1,2
50953,3,3,178554,178554,178557,0,3,2
50954,6,2,178560,178560,178562,0,2,3
50955,3,1,178563,178563,178564,0,1,1
50956,3,2,178566,178566,178568,0,2,2
50957,3,1,178569,178569,178570,0,1,1
50958,1,3,178570,178570,178573,0,3,0
50959,2,2,178572,178573,178575,1,3,0
50960,2,2,178574,178575,178577,1,3,0
50961,4,2,178578,178578,178580,0,2,1
50962,4,2,178582,178582,178584,0,2,2
50963,2,1,178584,178584,178585,0,1,0
50964,2,3,178586,178586,178589,0,3,1
50965,4,3,178590,178590,178593,0,3,1
50966,4,3,178594,178594,178597,0,3,1
50967,3,1,178597,178597,178598,0,1,0
50968,6,2,178603,178603,178605,0,2,5
50969,6,2,178609,178609,178611,0,2,4
50970,6,1,178615,178615,178616,0,1,4
50971,4,2,178619,178619,178621,0,2,3
50972,3,3,178622,178622,178625,0,3,1
50973,1,2,178623,178625,178627,2,4,0
50974,5,1,178628,178628,178629,0,1,1
50975,6,2,178634,178634,178636,0,2,5
50976,5,1,178639,178639,178640,0,1,3
50977,2,1,178641,178641,178642,0,1,1
50978,1,2,178642,178642,178644,0,2,0
50979,4,1,178646,178646,178647,0,1,2
50980,4,2,178650,178650,178652,0,2,3
50981,2,1,178652,178652,178653,0,1,0
50982,4,3,178656,178656,178659,0,3,3
50983,3,3,178659,178659,178662,0,3,0
50984,2,2,178661,178662,178664,1,3,0
50985,5,3,178666,178666,178669,0,3,2
50986,6,3,178672,178672,178675,0,3,3
50987,4,2,178676,178676,178678,0,2,1
50988,2,2,178678,178678,178680,0,2,0
50989,4,1,178682,178682,178683,0,1,2
50990,4,2,178686,178686,178688,0,2,3
50991,2,1,178688,178688,178689,0,1,0
50992,2,1,178690,178690,178691,0,1,1
50993,2,1,178692,178692,178693,0,1,1
50994,6,1,178698,178698,178699,0,1,5
50995,4,3,178702,178702,178705,0,3,3
50996,6,3,178708,178708,178711,0,3,3
50997,3,3,178711,178711,178714,0,3,0
50998,2,1,178713,178714,178715,1,2,0
50999,4,3,178717,178717,178720,0,3,2
51000,3,1,178720,178720,178721,0,1,0
51001,3,3,178723,178723,178726,0,3,2
51002,5,3,178728,178728,178731,0,3,2
51003,6,2,178734,178734,178736,0,2,3
51004,1,2,178735,178736,178738,1,3,0
51005,6,2,178741,178741,178743,0,2,3
51006,5,1,178746,178746,178747,0,1,3
51007,6,1,178752,178752,178753,0,1,5
51008,6,1,178758,178758,178759,0,1,5
51009,4,3,178762,178762,178765,0,3,3
51010,3,1,178765,178765,178766,0,1,0
51011,1,3,178766,178766,178769,0,3,0
51012,3,2,178769,178769,178771,0,2,0
51013,2,3,178771,178771,178774,0,3,0
51014,4,1,178775,178775,178776,0,1,1
51015,1,3,178776,178776,178779,0,3,0
51016,2,1,178778,178779,178780,1,2,0
51017,1,3,178779,178780,178783,1,4,0
51018,2,1,178781,178783,178784,2,3,0
51019,6,1,178787,178787,178788,0,1,3
51020,4,2,178791,178791,178793,0,2,3
51021,5,1,178796,178796,178797,0,1,3
51022,4,2,178800,178800,178802,0,2,3
51023,3,1,178803,178803,178804,0,1,1
51024,5,2,178808,178808,178810,0,2,4
51025,1,3,178809,178810,178813,1,4,0
51026,6,2,178815,178815,178817,0,2,2
51027,2,3,178817,178817,178820,0,3,0
51028,2,2,178819,178820,178822,1,3,0
51029,4,1,178823,178823,178824,0,1,1
51030,1,3,178824,178824,178827,0,3,0
51031,6,2,178830,178830,178832,0,2,3
51032,2,1,178832,178832,178833,0,1,0
51033,4,1,178836,178836,178837,0,1,3
51034,2,2,178838,178838,178840,0,2,1
51035,3,2,178841,178841,178843,0,2,1
51036,1,2,178842,178843,178845,1,3,0
51037,6,3,178848,178848,178851,0,3,3
51038,6,3,178854,178854,178857,0,3,3
51039,3,3,178857,178857,178860,0,3,0
51040,6,2,178863,178863,178865,0,2,3
51041,3,2,178866,178866,178868,0,2,1
51042,6,1,178872,178872,178873,0,1,4
51043,2,3,178874,178874,178877,0,3,1
51044,1,3,178875,178877,178880,2,5,0
51045,5,2,178880,178880,178882,0,2,0
51046,4,1,178884,178884,178885,0,1,2
51047,6,3,178890,178890,178893,0,3,5
51048,5,2,178895,178895,178897,0,2,2
51049,6,1,178901,178901,178902,0,1,4
51050,4,2,178905,178905,178907,0,2,3
51051,5,1,178910,178910,178911,0,1,3
51052,5,1,178915,178915,178916,0,1,4
51053,2,3,178917,178917,178920,0,3,1
51054,5,3,178922,178922,178925,0,3,2
51055,5,3,178927,178927,178930,0,3,2
51056,5,2,178932,178932,178934,0,2,2
51057,2,2,178934,178934,178936,0,2,0
51058,4,1,178938,178938,178939,0,1,2
51059,4,3,178942,178942,178945,0,3,3
51060,2,3,178944,178945,178948,1,4,0
51061,3,2,178947,178948,178950,1,3,0
51062,3,1,178950,178950,178951,0,1,0
51063,4,2,178954,178954,178956,0,2,3
51064,2,3,178956,178956,178959,0,3,0
51065,6,1,178962,178962,178963,0,1,3
51066,2,3,178964,178964,178967,0,3,1
51067,4,3,178968,178968,178971,0,3,1
51068,3,1,178971,178971,178972,0,1,0
51069,3,3,178974,178974,178977,0,3,2
51070,6,2,178980,178980,178982,0,2,3
51071,4,3,178984,178984,178987,0,3,2
51072,4,2,178988,178988,178990,0,2,1
51073,3,2,178991,178991,178993,0,2,1
51074,1,1,178992,178993,178994,1,2,0
51075,5,3,178997,178997,179000,0,3,3
51076,1,2,178998,179000,179002,2,4,0
51077,3,1,179001,179002,179003,1,2,0
51078,6,1,179007,179007,179008,0,1,4
51079,6,2,179013,179013,179015,0,2,5
51080,5,3,179018,179018,179021,0,3,3
51081,1,1,179019,179021,179022,2,3,0
51082,4,2,179023,179023,179025,0,2,1
51083,6,1,179029,179029,179030,0,1,4
51084,6,1,179035,179035,179036,0,1,5
51085,1,3,179036,179036,179039,0,3,0
51086,1,2,179037,179039,179041,2,4,0
51087,4,2,179041,179041,179043,0,2,0
51088,4,3,179045,179045,179048,0,3,2
51089,1,2,179046,179048,179050,2,4,0
51090,4,2,179050,179050,179052,0,2,0
51091,4,1,179054,179054,179055,0,1,2
51092,5,3,179059,179059,179062,0,3,4
51093,4,3,179063,179063,179066,0,3,1
51094,2,1,179065,179066,179067,1,2,0
51095,5,3,179070,179070,179073,0,3,3
51096,2,3,179072,179073,179076,1,4,0
51097,6,3,179078,179078,179081,0,3,2
51098,1,3,179079,179081,179084,2,5,0
51099,6,1,179085,179085,179086,0,1,1
51100,5,1,179090,179090,179091,0,1,4
51101,3,1,179093,179093,179094,0,1,2
51102,2,1,179095,179095,179096,0,1,1
51103,6,1,179101,179101,179102,0,1,5
51104,6,3,179107,179107,179110,0,3,5
51105,1,2,179108,179110,179112,2,4,0
51106,5,2,179113,179113,179115,0,2,1
51107,4,3,179117,179117,179120,0,3,2
51108,6,2,179123,179123,179125,0,2,3
51109,2,1,179125,179125,179126,0,1,0
51110,6,3,179131,179131,179134,0,3,5
51111,6,3,179137,179137,179140,0,3,3
51112,3,1,179140,179140,179141,0,1,0
51113,1,3,179141,179141,179144,0,3,0
51114,6,1,179147,179147,179148,0,1,3
51115,5,3,179152,179152,179155,0,3,4
51116,4,3,179156,179156,179159,0,3,1
51117,3,1,179159,179159,179160,0,1,0
51118,2,3,179161,179161,179164,0,3,1
51119,5,1,179166,179166,179167,0,1,2
51120,4,3,179170,179170,179173,0,3,3
51121,6,2,179176,179176,179178,0,2,3
51122,3,3,179179,179179,179182,0,3,1
51123,4,2,179183,179183,179185,0,2,1
51124,2,2,179185,179185,179187,0,2,0
51125,1,2,179186,179187,179189,1,3,0
51126,3,1,179189,179189,179190,0,1,0
51127,6,2,179195,179195,179197,0,2,5
51128,2,1,179197,179197,179198,0,1,0
51129,4,1,179201,179201,179202,0,1,3
51130,4,1,179205,179205,179206,0,1,3
51131,4,2,179209,179209,179211,0,2,3
51132,5,3,179214,179214,179217,0,3,3
51133,4,1,179218,179218,179219,0,1,1
51134,6,3,179224,179224,179227,0,3,5
51135,2,2,179226,179227,179229,1,3,0
51136,5,3,179231,179231,179234,0,3,2
51137,2,3,179233,179234,179237,1,4,0
51138,4,1,179237,179237,179238,0,1,0
51139,2,3,179239,179239,179242,0,3,1
51140,5,3,179244,179244,179247,0,3,2
51141,6,2,179250,179250,179252,0,2,3
51142,6,1,179256,179256,179257,0,1,4
51143,5,2,179261,179261,179263,0,2,4
51144,1,2,179262,179263,179265,1,3,0
51145,5,1,179267,179267,179268,0,1,2
51146,5,1,179272,179272,179273,0,1,4
51147,3,1,179275,179275,179276,0,1,2
51148,1,3,179276,179276,179279,0,3,0
51149,5,3,179281,179281,179284,0,3,2
51150,4,3,179285,179285,179288,0,3,1
51151,6,1,179291,179291,179292,0,1,3
51152,3,1,179294,179294,179295,0,1,2
51153,1,2,179295,179295,179297,0,2,0
51154,2,1,179297,179297,179298,0,1,0
51155,4,3,179301,179301,179304,0,3,3
51156,1,2,179302,179304,179306,2,4,0
51157,4,2,179306,179306,179308,0,2,0
51158,5,1,179311,179311,179312,0,1,3
51159,4,1,179315,179315,179316,0,1,3
51160,5,2,179320,179320,179322,0,2,4
51161,1,3,179321,179322,179325,1,4,0
51162,1,1,179322,179325,179326,3,4,0
51163,1,1,179323,179326,179327,3,4,0
51164,6,3,179329,179329,179332,0,3,2
51165,4,3,179333,179333,179336,0,3,1
51166,4,1,179337,179337,179338,0,1,1
51167,3,3,179340,179340,179343,0,3,2
51168,3,3,179343,179343,179346,0,3,0
51169,4,3,179347,179347,179350,0,3,1
51170,4,1,179351,179351,179352,0,1,1
51171,2,1,179353,179353,179354,0,1,1
51172,6,3,179359,179359,179362,0,3,5
51173,3,2,179362,179362,179364,0,2,0
51174,6,3,179368,179368,179371,0,3,4
51175,4,2,179372,179372,179374,0,2,1
51176,6,1,179378,179378,179379,0,1,4
51177,3,2,179381,179381,179383,0,2,2
51178,4,1,179385,179385,179386,0,1,2
51179,6,3,179391,179391,179394,0,3,5
51180,2,2,179393,179394,179396,1,3,0
51181,6,1,179399,179399,179400,0,1,3
51182,4,1,179403,179403,179404,0,1,3
51183,3,2,179406,179406,179408,0,2,2
51184,4,2,179410,179410,179412,0,2,2
51185,2,3,179412,179412,179415,0,3,0
51186,6,3,179418,179418,179421,0,3,3
51187,4,3,179422,179422,179425,0,3,1
51188,3,1,179425,179425,179426,0,1,0
51189,1,2,179426,179426,179428,0,2,0
51190,2,2,179428,179428,179430,0,2,0
51191,2,1,179430,179430,179431,0,1,0
51192,6,1,179436,179436,179437,0,1,5
51193,2,2,179438,179438,179440,0,2,1
51194,4,1,179442,179442,179443,0,1,2
51195,1,1,179443,179443,179444,0,1,0
51196,1,3,179444,179444,179447,0,3,0
51197,1,1,179445,179447,179448,2,3,0
51198,5,1,179450,179450,179451,0,1,2
51199,3,1,179453,179453,179454,0,1,2
51200,2,1,179455,179455,179456,0,1,1
51201,2,2,179457,179457,179459,0,2,1
51202,6,2,179463,179463,179465,0,2,4
51203,2,2,179465,179465,179467,0,2,0
51204,1,2,179466,179467,179469,1,3,0
51205,3,2,179469,179469,179471,0,2,0
51206,6,2,179475,179475,179477,0,2,4
51207,5,1,179480,179480,179481,0,1,3
51208,4,3,179484,179484,179487,0,3,3
51209,1,3,179485,179487,179490,2,5,0
51210,2,3,179487,179490,179493,3,6,0
51211,1,1,179488,179493,179494,5,6,0
51212,5,1,179493,179494,179495,1,2,0
51213,4,1,179497,179497,179498,0,1,2
51214,3,2,179500,179500,179502,0,2,2
51215,3,3,179503,179503,179506,0,3,1
51216,2,3,179505,179506,179509,1,4,0
51217,5,3,179510,179510,179513,0,3,1
51218,1,3,179511,179513,179516,2,5,0
51219,5,1,179516,179516,179517,0,1,0
51220,6,3,179522,179522,179525,0,3,5
51221,1,3,179523,179525,179528,2,5,0
51222,5,2,179528,179528,179530,0,2,0
51223,4,1,179532,179532,179533,0,1,2
51224,5,2,179537,179537,179539,0,2,4
51225,1,3,179538,179539,179542,1,4,0
51226,6,3,179544,179544,179547,0,3,2
51227,4,3,179548,179548,179551,0,3,1
51228,2,1,179550,179551,179552,1,2,0
51229,3,1,179553,179553,179554,0,1,1
51230,5,3,179558,179558,179561,0,3,4
51231,1,3,179559,179561,179564,2,5,0
51232,3,1,179562,179564,179565,2,3,0
51233,3,3,179565,179565,179568,0,3,0
51234,5,1,179570,179570,179571,0,1,2
51235,1,3,179571,179571,179574,0,3,0
51236,1,2,179572,179574,179576,2,4,0
51237,2,3,179574,179576,179579,2,5,0
51238,3,1,179577,179579,179580,2,3,0
51239,2,1,179579,179580,179581,1,2,0
51240,3,1,179582,179582,179583,0,1,1
51241,1,1,179583,179583,179584,0,1,0
51242,3,1,179586,179586,179587,0,1,2
51243,1,3,179587,179587,179590,0,3,0
51244,1,3,179588,179590,179593,2,5,0
51245,5,3,179593,179593,179596,0,3,0
51246,5,3,179598,179598,179601,0,3,2
51247,6,1,179604,179604,179605,0,1,3
51248,6,1,179610,179610,179611,0,1,5
51249,1,1,179611,179611,179612,0,1,0
51250,1,1,179612,179612,179613,0,1,0
51251,4,2,179616,179616,179618,0,2,3
51252,1,2,179617,179618,179620,1,3,0
51253,5,1,179622,179622,179623,0,1,2
51254,4,2,179626,179626,179628,0,2,3
51255,4,3,179630,179630,179633,0,3,2
51256,2,2,179632,179633,179635,1,3,0
51257,5,3,179637,179637,179640,0,3,2
51258,3,2,179640,179640,179642,0,2,0
51259,4,3,179644,179644,179647,0,3,2
51260,3,2,179647,179647,179649,0,2,0
51261,3,2,179650,179650,179652,0,2,1
51262,5,1,179655,179655,179656,0,1,3
51263,4,2,179659,179659,179661,0,2,3
51264,6,1,179665,179665,179666,0,1,4
51265,2,3,179667,179667,179670,0,3,1
51266,2,2,179669,179670,179672,1,3,0
51267,2,1,179671,179672,179673,1,2,0
51268,1,1,179672,179673,179674,1,2,0
51269,2,1,179674,179674,179675,0,1,0
51270,4,1,179678,179678,179679,0,1,3
51271,2,1,179680,179680,179681,0,1,1
51272,2,2,179682,179682,179684,0,2,1
51273,3,2,179685,179685,179687,0,2,1
51274,2,3,179687,179687,179690,0,3,0
51275,1,2,179688,179690,179692,2,4,0
51276,1,3,179689,179692,179695,3,6,0
51277,6,1,179695,179695,179696,0,1,0
51278,4,1,179699,179699,179700,0,1,3
51279,2,3,179701,179701,179704,0,3,1
51280,4,3,179705,179705,179708,0,3,1
51281,3,1,179708,179708,179709,0,1,0
51282,2,2,179710,179710,179712,0,2,1
51283,6,3,179716,179716,179719,0,3,4
51284,4,2,179720,179720,179722,0,2,1
51285,5,1,179725,179725,179726,0,1,3
51286,6,2,179731,179731,179733,0,2,5
51287,2,1,179733,179733,179734,0,1,0
51288,5,3,179738,179738,179741,0,3,4
51289,2,1,179740,179741,179742,1,2,0
51290,6,1,179746,179746,179747,0,1,4
51291,3,1,179749,179749,179750,0,1,2
51292,5,1,179754,179754,179755,0,1,4
51293,3,3,179757,179757,179760,0,3,2
51294,5,2,179762,179762,179764,0,2,2
51295,5,2,179767,179767,179769,0,2,3
51296,2,3,179769,179769,179772,0,3,0
51297,4,2,179773,179773,179775,0,2,1
51298,4,3,179777,179777,179780,0,3,2
51299,4,3,179781,179781,179784,0,3,1
51300,6,3,179787,179787,179790,0,3,3
51301,6,1,179793,179793,179794,0,1,3
51302,6,3,179799,179799,179802,0,3,5
51303,6,3,179805,179805,179808,0,3,3
51304,1,1,179806,179808,179809,2,3,0
51305,2,2,179808,179809,179811,1,3,0
51306,2,1,179810,179811,179812,1,2,0
51307,5,1,179815,179815,179816,0,1,3
51308,1,1,179816,179816,179817,0,1,0
51309,6,1,179822,179822,179823,0,1,5
51310,5,1,179827,179827,179828,0,1,4
51311,5,2,179832,179832,179834,0,2,4
51312,1,3,179833,179834,179837,1,4,0
51313,6,1,179839,179839,179840,0,1,2
51314,3,2,179842,179842,179844,0,2,2
51315,4,3,179846,179846,179849,0,3,2
51316,3,2,179849,179849,179851,0,2,0
51317,3,2,179852,179852,179854,0,2,1
51318,5,1,179857,179857,179858,0,1,3
51319,4,1,179861,179861,179862,0,1,3
51320,2,2,179863,179863,179865,0,2,1
51321,5,1,179868,179868,179869,0,1,3
51322,3,2,179871,179871,179873,0,2,2
51323,2,3,179873,179873,179876,0,3,0
51324,2,2,179875,179876,179878,1,3,0
51325,1,2,179876,179878,179880,2,4,0
51326,3,3,179879,179880,179883,1,4,0
51327,5,2,179884,179884,179886,0,2,1
51328,6,3,179890,179890,179893,0,3,4
51329,2,2,179892,179893,179895,1,3,0
51330,1,3,179893,179895,179898,2,5,0
51331,3,3,179896,179898,179901,2,5,0
51332,4,3,179900,179901,179904,1,4,0
51333,6,1,179906,179906,179907,0,1,2
51334,2,2,179908,179908,179910,0,2,1
51335,6,3,179914,179914,179917,0,3,4
51336,5,2,179919,179919,179921,0,2,2
51337,6,3,179925,179925,179928,0,3,4
51338,6,3,179931,179931,179934,0,3,3
51339,5,1,179936,179936,179937,0,1,2
51340,4,1,179940,179940,179941,0,1,3
51341,4,3,179944,179944,179947,0,3,3
51342,5,1,179949,179949,179950,0,1,2
51343,2,1,179951,179951,179952,0,1,1
51344,4,1,179955,179955,179956,0,1,3
51345,1,3,179956,179956,179959,0,3,0
51346,2,2,179958,179959,179961,1,3,0
51347,6,1,179964,179964,179965,0,1,3
51348,2,2,179966,179966,179968,0,2,1
51349,5,3,179971,179971,179974,0,3,3
51350,6,2,179977,179977,179979,0,2,3
51351,4,1,179981,179981,179982,0,1,2
51352,3,2,179984,179984,179986,0,2,2
51353,4,3,179988,179988,179991,0,3,2
51354,2,3,179990,179991,179994,1,4,0
51355,2,2,179992,179994,179996,2,4,0
51356,2,1,179994,179996,179997,2,3,0
51357,4,1,179998,179998,179999,0,1,1
51358,6,2,180004,180004,180006,0,2,5
51359,1,3,180005,180006,180009,1,4,0
51360,4,3,180009,180009,180012,0,3,0
51361,2,3,180011,180012,180015,1,4,0
51362,3,2,180014,180015,180017,1,3,0
51363,1,2,180015,180017,180019,2,4,0
51364,2,1,180017,180019,180020,2,3,0
51365,4,1,180021,180021,180022,0,1,1
51366,4,1,180025,180025,180026,0,1,3
51367,5,3,180030,180030,180033,0,3,4
51368,4,3,180034,180034,180037,0,3,1
51369,6,2,180040,180040,180042,0,2,3
51370,6,1,180046,180046,180047,0,1,4
51371,4,3,180050,180050,180053,0,3,3
51372,4,2,180054,180054,180056,0,2,1
51373,4,1,180058,180058,180059,0,1,2
51374,2,2,180060,180060,180062,0,2,1
51375,3,1,180063,180063,180064,0,1,1
51376,6,2,180069,180069,180071,0,2,5
51377,6,1,180075,180075,180076,0,1,4
51378,2,1,180077,180077,180078,0,1,1
51379,6,1,180083,180083,180084,0,1,5
51380,6,1,180089,180089,180090,0,1,5
51381,3,2,180092,180092,180094,0,2,2
51382,3,2,180095,180095,180097,0,2,1
51383,6,2,180101,180101,180103,0,2,4
51384,1,3,180102,180103,180106,1,4,0
51385,3,1,180105,180106,180107,1,2,0
51386,4,3,180109,180109,180112,0,3,2
51387,1,3,180110,180112,180115,2,5,0
51388,2,3,180112,180115,180118,3,6,0
51389,4,1,180116,180118,180119,2,3,0
51390,1,3,180117,180119,180122,2,5,0
51391,4,1,180121,180122,180123,1,2,0
51392,1,1,180122,180123,180124,1,2,0
51393,2,3,180124,180124,180127,0,3,0
51394,6,2,180130,180130,180132,0,2,3
51395,2,2,180132,180132,180134,0,2,0
51396,2,1,180134,180134,180135,0,1,0
51397,5,3,180139,180139,180142,0,3,4
51398,3,3,180142,180142,180145,0,3,0
51399,4,3,180146,180146,180149,0,3,1
51400,6,3,180152,180152,180155,0,3,3
51401,1,2,180153,180155,180157,2,4,0
51402,6,3,180159,180159,180162,0,3,2
51403,1,3,180160,180162,180165,2,5,0
51404,6,1,180166,180166,180167,0,1,1
51405,4,1,180170,180170,180171,0,1,3
51406,1,3,180171,180171,180174,0,3,0
51407,5,2,180176,180176,180178,0,2,2
51408,6,1,180182,180182,180183,0,1,4
51409,3,2,180185,180185,180187,0,2,2
51410,2,1,180187,180187,180188,0,1,0
51411,4,3,180191,180191,180194,0,3,3
51412,1,3,180192,180194,180197,2,5,0
51413,3,1,180195,180197,180198,2,3,0
51414,2,2,180197,180198,180200,1,3,0
51415,1,3,180198,180200,180203,2,5,0
51416,1,1,180199,180203,180204,4,5,0
51417,3,1,180202,180204,180205,2,3,0
51418,4,1,180206,180206,180207,0,1,1
51419,5,2,180211,180211,180213,0,2,4
51420,2,1,180213,180213,180214,0,1,0
51421,2,2,180215,180215,180217,0,2,1
51422,3,2,180218,180218,180220,0,2,1
51423,6,2,180224,180224,180226,0,2,4
51424,5,2,180229,180229,180231,0,2,3
51425,6,3,180235,180235,180238,0,3,4
51426,2,2,180237,180238,180240,1,3,0
51427,6,1,180243,180243,180244,0,1,3
51428,5,2,180248,180248,180250,0,2,4
51429,1,1,180249,180250,180251,1,2,0
51430,6,1,180255,180255,180256,0,1,4
51431,3,2,180258,180258,180260,0,2,2
51432,4,1,180262,180262,180263,0,1,2
51433,1,1,180263,180263,180264,0,1,0
51434,3,2,180266,180266,180268,0,2,2
51435,5,3,180271,180271,180274,0,3,3
51436,4,1,180275,180275,180276,0,1,1
51437,5,1,180280,180280,180281,0,1,4
51438,2,1,180282,180282,180283,0,1,1
51439,3,1,180285,180285,180286,0,1,2
51440,5,1,180290,180290,180291,0,1,4
51441,4,1,180294,180294,180295,0,1,3
51442,3,2,180297,180297,180299,0,2,2
51443,2,3,180299,180299,180302,0,3,0
51444,5,3,180304,180304,180307,0,3,2
51445,3,2,180307,180307,180309,0,2,0
51446,5,1,180312,180312,180313,0,1,3
51447,6,2,180318,180318,180320,0,2,5
51448,2,3,180320,180320,180323,0,3,0
51449,2,3,180322,180323,180326,1,4,0
51450,5,3,180327,180327,180330,0,3,1
51451,6,2,180333,180333,180335,0,2,3
51452,5,1,180338,180338,180339,0,1,3
51453,4,3,180342,180342,180345,0,3,3
51454,3,2,180345,180345,180347,0,2,0
51455,6,2,180351,180351,180353,0,2,4
51456,4,2,180355,180355,180357,0,2,2
51457,6,2,180361,180361,180363,0,2,4
51458,5,3,180366,180366,180369,0,3,3
51459,1,3,180367,180369,180372,2,5,0
51460,1,1,180368,180372,180373,4,5,0
51461,5,1,180373,180373,180374,0,1,0
51462,3,1,180376,180376,180377,0,1,2
51463,2,1,180378,180378,180379,0,1,1
51464,5,2,180383,180383,180385,0,2,4
51465,2,3,180385,180385,180388,0,3,0
51466,2,2,180387,180388,180390,1,3,0
51467,6,1,180393,180393,180394,0,1,3
51468,4,2,180397,180397,180399,0,2,3
51469,4,1,180401,180401,180402,0,1,2
51470,4,2,180405,180405,180407,0,2,3
51471,2,3,180407,180407,180410,0,3,0
51472,6,3,180413,180413,180416,0,3,3
51473,4,1,180417,180417,180418,0,1,1
51474,1,1,180418,180418,180419,0,1,0
51475,2,3,180420,180420,180423,0,3,1
51476,1,2,180421,180423,180425,2,4,0
51477,6,2,180427,180427,180429,0,2,2
51478,6,1,180433,180433,180434,0,1,4
51479,2,1,180435,180435,180436,0,1,1
51480,2,1,180437,180437,180438,0,1,1
51481,4,1,180441,180441,180442,0,1,3
51482,6,3,180447,180447,180450,0,3,5
51483,4,3,180451,180451,180454,0,3,1
51484,1,3,180452,180454,180457,2,5,0
51485,2,2,180454,180457,180459,3,5,0
51486,4,2,180458,180459,180461,1,3,0
51487,3,1,180461,180461,180462,0,1,0
51488,5,2,180466,180466,180468,0,2,4
51489,3,2,180469,180469,180471,0,2,1
51490,1,2,180470,180471,180473,1,3,0
51491,2,3,180472,180473,180476,1,4,0
51492,2,1,180474,180476,180477,2,3,0
51493,3,2,180477,180477,180479,0,2,0
51494,6,2,180483,180483,180485,0,2,4
51495,3,3,180486,180486,180489,0,3,1
51496,2,2,180488,180489,180491,1,3,0
51497,6,2,180494,180494,180496,0,2,3
51498,3,1,180497,180497,180498,0,1,1
51499,4,2,180501,180501,180503,0,2,3
51500,6,1,180507,180507,180508,0,1,4
51501,6,1,180513,180513,180514,0,1,5
51502,6,1,180519,180519,180520,0,1,5
51503,1,3,180520,180520,180523,0,3,0
51504,4,1,180524,180524,180525,0,1,1
51505,5,2,180529,180529,180531,0,2,4
51506,2,2,180531,180531,180533,0,2,0
51507,3,2,180534,180534,180536,0,2,1
51508,1,1,180535,180536,180537,1,2,0
51509,3,1,180538,180538,180539,0,1,1
51510,2,3,180540,180540,180543,0,3,1
51511,4,2,180544,180544,180546,0,2,1
51512,1,1,180545,180546,180547,1,2,0
51513,5,2,180550,180550,180552,0,2,3
51514,2,1,180552,180552,180553,0,1,0
51515,6,3,180558,180558,180561,0,3,5
51516,6,2,180564,180564,180566,0,2,3
51517,5,3,180569,180569,180572,0,3,3
51518,6,3,180575,180575,180578,0,3,3
51519,5,1,180580,180580,180581,0,1,2
51520,3,3,180583,180583,180586,0,3,2
51521,3,3,180586,180586,180589,0,3,0
51522,1,2,180587,180589,180591,2,4,0
51523,3,1,180590,180591,180592,1,2,0
51524,2,1,180592,180592,180593,0,1,0
51525,3,2,180595,180595,180597,0,2,2
51526,4,1,180599,180599,180600,0,1,2
51527,2,3,180601,180601,180604,0,3,1
51528,1,2,180602,180604,180606,2,4,0
51529,3,2,180605,180606,180608,1,3,0
51530,6,1,180611,180611,180612,0,1,3
51531,3,1,180614,180614,180615,0,1,2
51532,1,1,180615,180615,180616,0,1,0
51533,2,3,180617,180617,180620,0,3,1
51534,2,3,180619,180620,180623,1,4,0
51535,5,3,180624,180624,180627,0,3,1
51536,3,1,180627,180627,180628,0,1,0
51537,3,3,180630,180630,180633,0,3,2
51538,5,1,180635,180635,180636,0,1,2
51539,6,3,180641,180641,180644,0,3,5
51540,6,2,180647,180647,180649,0,2,3
51541,4,1,180651,180651,180652,0,1,2
51542,6,2,180657,180657,180659,0,2,5
51543,5,2,180662,180662,180664,0,2,3
51544,5,2,180667,180667,180669,0,2,3
51545,3,3,180670,180670,180673,0,3,1
51546,1,2,180671,180673,180675,2,4,0
51547,3,1,180674,180675,180676,1,2,0
51548,2,3,180676,180676,180679,0,3,0
51549,2,2,180678,180679,180681,1,3,0
51550,3,2,180681,180681,180683,0,2,0
51551,4,1,180685,180685,180686,0,1,2
51552,4,1,180689,180689,180690,0,1,3
51553,1,1,180690,180690,180691,0,1,0
51554,4,1,180694,180694,180695,0,1,3
51555,2,1,180696,180696,180697,0,1,1
51556,5,2,180701,180701,180703,0,2,4
51557,5,2,180706,180706,180708,0,2,3
51558,5,2,180711,180711,180713,0,2,3
51559,1,1,180712,180713,180714,1,2,0
51560,5,2,180717,180717,180719,0,2,3
51561,4,3,180721,180721,180724,0,3,2
51562,6,1,180727,180727,180728,0,1,3
51563,6,2,180733,180733,180735,0,2,5
51564,3,1,180736,180736,180737,0,1,1
51565,6,1,180742,180742,180743,0,1,5
51566,2,2,180744,180744,180746,0,2,1
51567,6,3,180750,180750,180753,0,3,4
51568,2,1,180752,180753,180754,1,2,0
51569,6,2,180758,180758,180760,0,2,4
51570,3,2,180761,180761,180763,0,2,1
51571,2,3,180763,180763,180766,0,3,0
51572,1,3,180764,180766,180769,2,5,0
51573,4,3,180768,180769,180772,1,4,0
51574,5,1,180773,180773,180774,0,1,1
51575,5,2,180778,180778,180780,0,2,4
51576,2,1,180780,180780,180781,0,1,0
51577,5,3,180785,180785,180788,0,3,4
51578,1,1,180786,180788,180789,2,3,0
51579,5,3,180791,180791,180794,0,3,2
51580,3,1,180794,180794,180795,0,1,0
51581,6,3,180800,180800,180803,0,3,5
51582,5,2,180805,180805,180807,0,2,2
51583,2,3,180807,180807,180810,0,3,0
51584,4,2,180811,180811,180813,0,2,1
51585,3,3,180814,180814,180817,0,3,1
51586,1,2,180815,180817,180819,2,4,0
51587,4,1,180819,180819,180820,0,1,0
51588,1,3,180820,180820,180823,0,3,0
51589,2,2,180822,180823,180825,1,3,0
51590,4,3,180826,180826,180829,0,3,1
51591,4,3,180830,180830,180833,0,3,1
51592,4,3,180834,180834,180837,0,3,1
51593,5,2,180839,180839,180841,0,2,2
51594,1,3,180840,180841,180844,1,4,0
51595,5,3,180845,180845,180848,0,3,1
51596,3,1,180848,180848,180849,0,1,0
51597,1,1,180849,180849,180850,0,1,0
51598,1,3,180850,180850,180853,0,3,0
51599,5,3,180855,180855,180858,0,3,2
51600,3,3,180858,180858,180861,0,3,0
51601,2,1,180860,180861,180862,1,2,0
51602,2,3,180862,180862,180865,0,3,0
51603,2,2,180864,180865,180867,1,3,0
51604,5,2,180869,180869,180871,0,2,2
51605,5,3,180874,180874,180877,0,3,3
51606,3,2,180877,180877,180879,0,2,0
51607,1,3,180878,180879,180882,1,4,0
51608,3,2,180881,180882,180884,1,3,0
51609,5,1,180886,180886,180887,0,1,2
51610,2,3,180888,180888,180891,0,3,1
51611,2,1,180890,180891,180892,1,2,0
51612,3,2,180893,180893,180895,0,2,1
51613,3,3,180896,180896,180899,0,3,1
51614,1,3,180897,180899,180902,2,5,0
51615,3,3,180900,180902,180905,2,5,0
51616,1,3,180901,180905,180908,4,7,0
51617,3,1,180904,180908,180909,4,5,0
51618,3,2,180907,180909,180911,2,4,0
51619,6,2,180913,180913,180915,0,2,2
51620,6,2,180919,180919,180921,0,2,4
51621,5,1,180924,180924,180925,0,1,3
51622,2,1,180926,180926,180927,0,1,1
51623,3,2,180929,180929,180931,0,2,2
51624,5,3,180934,180934,180937,0,3,3
51625,4,1,180938,180938,180939,0,1,1
51626,2,3,180940,180940,180943,0,3,1
51627,2,1,180942,180943,180944,1,2,0
51628,3,3,180945,180945,180948,0,3,1
51629,5,2,180950,180950,180952,0,2,2
51630,1,3,180951,180952,180955,1,4,0
51631,1,1,180952,180955,180956,3,4,0
51632,2,2,180954,180956,180958,2,4,0
51633,3,2,180957,180958,180960,1,3,0
51634,1,1,180958,180960,180961,2,3,0
51635,4,3,180962,180962,180965,0,3,1
51636,4,3,180966,180966,180969,0,3,1
51637,2,3,180968,180969,180972,1,4,0
51638,6,3,180974,180974,180977,0,3,2
51639,6,2,180980,180980,180982,0,2,3
51640,5,1,180985,180985,180986,0,1,3
51641,1,2,180986,180986,180988,0,2,0
51642,5,1,180991,180991,180992,0,1,3
51643,4,3,180995,180995,180998,0,3,3
51644,1,2,180996,180998,181000,2,4,0
51645,5,3,181001,181001,181004,0,3,1
51646,6,2,181007,181007,181009,0,2,3
51647,1,3,181008,181009,181012,1,4,0
51648,4,1,181012,181012,181013,0,1,0
51649,2,1,181014,181014,181015,0,1,1
51650,4,1,181018,181018,181019,0,1,3
51651,2,3,181020,181020,181023,0,3,1
51652,2,2,181022,181023,181025,1,3,0
51653,3,3,181025,181025,181028,0,3,0
51654,2,1,181027,181028,181029,1,2,0
51655,4,3,181031,181031,181034,0,3,2
51656,6,1,181037,181037,181038,0,1,3
51657,4,2,181041,181041,181043,0,2,3
51658,4,1,181045,181045,181046,0,1,2
51659,4,1,181049,181049,181050,0,1,3
51660,1,1,181050,181050,181051,0,1,0
51661,6,2,181056,181056,181058,0,2,5
51662,2,3,181058,181058,181061,0,3,0
51663,1,2,181059,181061,181063,2,4,0
51664,5,1,181064,181064,181065,0,1,1
51665,1,1,181065,181065,181066,0,1,0
51666,5,1,181070,181070,181071,0,1,4
51667,4,1,181074,181074,181075,0,1,3
51668,1,2,181075,181075,181077,0,2,0
51669,1,2,181076,181077,181079,1,3,0
51670,2,1,181078,181079,181080,1,2,0
51671,5,3,181083,181083,181086,0,3,3
51672,5,1,181088,181088,181089,0,1,2
51673,5,2,181093,181093,181095,0,2,4
51674,5,1,181098,181098,181099,0,1,3
51675,6,3,181104,181104,181107,0,3,5
51676,2,1,181106,181107,181108,1,2,0
51677,5,1,181111,181111,181112,0,1,3
51678,3,2,181114,181114,181116,0,2,2
51679,2,2,181116,181116,181118,0,2,0
51680,1,1,181117,181118,181119,1,2,0
51681,6,2,181123,181123,181125,0,2,4
51682,6,3,181129,181129,181132,0,3,4
51683,5,2,181134,181134,181136,0,2,2
51684,6,3,181140,181140,181143,0,3,4
51685,2,2,181142,181143,181145,1,3,0
51686,1,2,181143,181145,181147,2,4,0
51687,2,3,181145,181147,181150,2,5,0
51688,4,1,181149,181150,181151,1,2,0
51689,6,2,181155,181155,181157,0,2,4
51690,5,1,181160,181160,181161,0,1,3
51691,6,3,181166,181166,181169,0,3,5
51692,1,2,181167,181169,181171,2,4,0
51693,5,2,181172,181172,181174,0,2,1
51694,2,3,181174,181174,181177,0,3,0
51695,4,1,181178,181178,181179,0,1,1
51696,4,1,181182,181182,181183,0,1,3
51697,4,2,181186,181186,181188,0,2,3
51698,4,3,181190,181190,181193,0,3,2
51699,5,3,181195,181195,181198,0,3,2
51700,6,1,181201,181201,181202,0,1,3
51701,3,2,181204,181204,181206,0,2,2
51702,5,3,181209,181209,181212,0,3,3
51703,5,2,181214,181214,181216,0,2,2
51704,3,1,181217,181217,181218,0,1,1
51705,3,1,181220,181220,181221,0,1,2
51706,5,1,181225,181225,181226,0,1,4
51707,6,2,181231,181231,181233,0,2,5
51708,1,1,181232,181233,181234,1,2,0
51709,3,3,181235,181235,181238,0,3,1
51710,6,3,181241,181241,181244,0,3,3
51711,4,2,181245,181245,181247,0,2,1
51712,5,1,181250,181250,181251,0,1,3
51713,5,3,181255,181255,181258,0,3,4
51714,5,2,181260,181260,181262,0,2,2
51715,2,2,181262,181262,181264,0,2,0
51716,4,1,181266,181266,181267,0,1,2
51717,4,2,181270,181270,181272,0,2,3
51718,4,3,181274,181274,181277,0,3,2
51719,6,3,181280,181280,181283,0,3,3
51720,2,1,181282,181283,181284,1,2,0
51721,2,2,181284,181284,181286,0,2,0
51722,6,2,181290,181290,181292,0,2,4
51723,4,1,181294,181294,181295,0,1,2
51724,3,2,181297,181297,181299,0,2,2
51725,1,2,181298,181299,181301,1,3,0
51726,2,3,181300,181301,181304,1,4,0
51727,5,2,181305,181305,181307,0,2,1
51728,4,1,181309,181309,181310,0,1,2
51729,5,3,181314,181314,181317,0,3,4
51730,2,1,181316,181317,181318,1,2,0
51731,1,3,181317,181318,181321,1,4,0
51732,4,3,181321,181321,181324,0,3,0
51733,3,2,181324,181324,181326,0,2,0
51734,5,1,181329,181329,181330,0,1,3
51735,6,2,181335,181335,181337,0,2,5
51736,1,2,181336,181337,181339,1,3,0
51737,2,3,181338,181339,181342,1,4,0
51738,4,2,181342,181342,181344,0,2,0
51739,1,1,181343,181344,181345,1,2,0
51740,2,1,181345,181345,181346,0,1,0
51741,6,1,181351,181351,181352,0,1,5
51742,1,2,181352,181352,181354,0,2,0
51743,1,1,181353,181354,181355,1,2,0
51744,1,3,181354,181355,181358,1,4,0
51745,6,1,181360,181360,181361,0,1,2
51746,5,3,181365,181365,181368,0,3,4
51747,6,3,181371,181371,181374,0,3,3
51748,4,2,181375,181375,181377,0,2,1
51749,5,1,181380,181380,181381,0,1,3
51750,6,2,181386,181386,181388,0,2,5
51751,6,3,181392,181392,181395,0,3,4
51752,2,3,181394,181395,181398,1,4,0
51753,6,1,181400,181400,181401,0,1,2
51754,3,1,181403,181403,181404,0,1,2
51755,2,1,181405,181405,181406,0,1,1
51756,5,3,181410,181410,181413,0,3,4
51757,3,1,181413,181413,181414,0,1,0
51758,2,3,181415,181415,181418,0,3,1
51759,5,1,181420,181420,181421,0,1,2
51760,1,1,181421,181421,181422,0,1,0
51761,1,1,181422,181422,181423,0,1,0
51762,6,3,181428,181428,181431,0,3,5
51763,5,2,181433,181433,181435,0,2,2
51764,3,1,181436,181436,181437,0,1,1
51765,1,1,181437,181437,181438,0,1,0
51766,4,3,181441,181441,181444,0,3,3
51767,2,2,181443,181444,181446,1,3,0
51768,3,3,181446,181446,181449,0,3,0
51769,1,2,181447,181449,181451,2,4,0
51770,6,1,181453,181453,181454,0,1,2
51771,6,2,181459,181459,181461,0,2,5
51772,1,2,181460,181461,181463,1,3,0
51773,3,1,181463,181463,181464,0,1,0
51774,1,3,181464,181464,181467,0,3,0
51775,6,2,181470,181470,181472,0,2,3
51776,5,2,181475,181475,181477,0,2,3
51777,2,1,181477,181477,181478,0,1,0
51778,1,1,181478,181478,181479,0,1,0
51779,4,2,181482,181482,181484,0,2,3
51780,3,1,181485,181485,181486,0,1,1
51781,2,1,181487,181487,181488,0,1,1
51782,5,3,181492,181492,181495,0,3,4
51783,4,2,181496,181496,181498,0,2,1
51784,6,3,181502,181502,181505,0,3,4
51785,3,1,181505,181505,181506,0,1,0
51786,2,3,181507,181507,181510,0,3,1
51787,2,2,181509,181510,181512,1,3,0
51788,3,2,181512,181512,181514,0,2,0
51789,1,3,181513,181514,181517,1,4,0
51790,6,1,181519,181519,181520,0,1,2
51791,6,2,181525,181525,181527,0,2,5
51792,3,1,181528,181528,181529,0,1,1
51793,1,2,181529,181529,181531,0,2,0
51794,4,2,181533,181533,181535,0,2,2
51795,4,1,181537,181537,181538,0,1,2
51796,1,2,181538,181538,181540,0,2,0
51797,5,2,181543,181543,181545,0,2,3
51798,2,1,181545,181545,181546,0,1,0
51799,4,3,181549,181549,181552,0,3,3
51800,3,2,181552,181552,181554,0,2,0
51801,5,1,181557,181557,181558,0,1,3
51802,4,1,181561,181561,181562,0,1,3
51803,5,2,181566,181566,181568,0,2,4
51804,4,1,181570,181570,181571,0,1,2
51805,4,2,181574,181574,181576,0,2,3
51806,2,3,181576,181576,181579,0,3,0
51807,2,3,181578,181579,181582,1,4,0
51808,2,2,181580,181582,181584,2,4,0
51809,3,3,181583,181584,181587,1,4,0
51810,4,1,181587,181587,181588,0,1,0
51811,5,3,181592,181592,181595,0,3,4
51812,2,1,181594,181595,181596,1,2,0
51813,4,3,181598,181598,181601,0,3,2
51814,3,2,181601,181601,181603,0,2,0
51815,1,1,181602,181603,181604,1,2,0
51816,4,3,181606,181606,181609,0,3,2
51817,6,1,181612,181612,181613,0,1,3
51818,4,2,181616,181616,181618,0,2,3
51819,5,2,181621,181621,181623,0,2,3
51820,1,2,181622,181623,181625,1,3,0
51821,3,2,181625,181625,181627,0,2,0
51822,1,1,181626,181627,181628,1,2,0
51823,1,2,181627,181628,181630,1,3,0
51824,1,1,181628,181630,181631,2,3,0
51825,1,3,181629,181631,181634,2,5,0
51826,1,1,181630,181634,181635,4,5,0
51827,3,1,181633,181635,181636,2,3,0
51828,3,3,181636,181636,181639,0,3,0
51829,1,1,181637,181639,181640,2,3,0
51830,1,3,181638,181640,181643,2,5,0
51831,6,1,181644,181644,181645,0,1,1
51832,4,1,181648,181648,181649,0,1,3
51833,6,2,181654,181654,181656,0,2,5
51834,6,1,181660,181660,181661,0,1,4
51835,3,2,181663,181663,181665,0,2,2
51836,1,3,181664,181665,181668,1,4,0
51837,1,1,181665,181668,181669,3,4,0
51838,4,2,181669,181669,181671,0,2,0
51839,6,2,181675,181675,181677,0,2,4
51840,4,3,181679,181679,181682,0,3,2
51841,6,3,181685,181685,181688,0,3,3
51842,4,1,181689,181689,181690,0,1,1
51843,4,2,181693,181693,181695,0,2,3
51844,2,2,181695,181695,181697,0,2,0
51845,2,2,181697,181697,181699,0,2,0
51846,4,1,181701,181701,181702,0,1,2
51847,2,1,181703,181703,181704,0,1,1
51848,6,1,181709,181709,181710,0,1,5
51849,6,3,181715,181715,181718,0,3,5
51850,2,3,181717,181718,181721,1,4,0
51851,1,2,181718,181721,181723,3,5,0
51852,1,3,181719,181723,181726,4,7,0
51853,6,1,181725,181726,181727,1,2,0
51854,6,2,181731,181731,181733,0,2,4
51855,2,1,181733,181733,181734,0,1,0
51856,4,3,181737,181737,181740,0,3,3
51857,4,2,181741,181741,181743,0,2,1
51858,5,2,181746,181746,181748,0,2,3
51859,6,3,181752,181752,181755,0,3,4
51860,5,3,181757,181757,181760,0,3,2
51861,2,1,181759,181760,181761,1,2,0
51862,2,2,181761,181761,181763,0,2,0
51863,3,3,181764,181764,181767,0,3,1
51864,1,3,181765,181767,181770,2,5,0
51865,4,3,181769,181770,181773,1,4,0
51866,5,1,181774,181774,181775,0,1,1
51867,4,2,181778,181778,181780,0,2,3
51868,5,2,181783,181783,181785,0,2,3
51869,5,1,181788,181788,181789,0,1,3
51870,1,2,181789,181789,181791,0,2,0
51871,1,2,181790,181791,181793,1,3,0
51872,5,1,181795,181795,181796,0,1,2
51873,5,2,181800,181800,181802,0,2,4
51874,5,1,181805,181805,181806,0,1,3
51875,3,2,181808,181808,181810,0,2,2
51876,1,1,181809,181810,181811,1,2,0
51877,1,1,181810,181811,181812,1,2,0
51878,3,1,181813,181813,181814,0,1,1
51879,1,1,181814,181814,181815,0,1,0
51880,6,3,181820,181820,181823,0,3,5
51881,4,2,181824,181824,181826,0,2,1
51882,1,1,181825,181826,181827,1,2,0
51883,2,3,181827,181827,181830,0,3,0
51884,5,1,181832,181832,181833,0,1,2
51885,2,2,181834,181834,181836,0,2,1
51886,5,2,181839,181839,181841,0,2,3
51887,1,1,181840,181841,181842,1,2,0
51888,1,2,181841,181842,181844,1,3,0
51889,4,1,181845,181845,181846,0,1,1
51890,3,3,181848,181848,181851,0,3,2
51891,2,3,181850,181851,181854,1,4,0
51892,3,1,181853,181854,181855,1,2,0
51893,3,3,181856,181856,181859,0,3,1
51894,4,1,181860,181860,181861,0,1,1
51895,6,3,181866,181866,181869,0,3,5
51896,5,3,181871,181871,181874,0,3,2
51897,5,2,181876,181876,181878,0,2,2
51898,1,3,181877,181878,181881,1,4,0
51899,2,1,181879,181881,181882,2,3,0
51900,2,1,181881,181882,181883,1,2,0
51901,3,1,181884,181884,181885,0,1,1
51902,3,2,181887,181887,181889,0,2,2
51903,3,3,181890,181890,181893,0,3,1
51904,2,1,181892,181893,181894,1,2,0
51905,2,2,181894,181894,181896,0,2,0
51906,2,3,181896,181896,181899,0,3,0
51907,4,1,181900,181900,181901,0,1,1
51908,2,1,181902,181902,181903,0,1,1
51909,3,2,181905,181905,181907,0,2,2
51910,5,2,181910,181910,181912,0,2,3
51911,6,1,181916,181916,181917,0,1,4
51912,2,3,181918,181918,181921,0,3,1
51913,4,3,181922,181922,181925,0,3,1
51914,3,2,181925,181925,181927,0,2,0
51915,5,1,181930,181930,181931,0,1,3
51916,2,1,181932,181932,181933,0,1,1
51917,3,1,181935,181935,181936,0,1,2
51918,1,2,181936,181936,181938,0,2,0
51919,4,2,181940,181940,181942,0,2,2
51920,5,3,181945,181945,181948,0,3,3
51921,2,3,181947,181948,181951,1,4,0
51922,2,1,181949,181951,181952,2,3,0
51923,4,2,181953,181953,181955,0,2,1
51924,2,3,181955,181955,181958,0,3,0
51925,4,1,181959,181959,181960,0,1,1
51926,2,1,181961,181961,181962,0,1,1
51927,4,1,181965,181965,181966,0,1,3
51928,2,1,181967,181967,181968,0,1,1
51929,1,3,181968,181968,181971,0,3,0
51930,3,2,181971,181971,181973,0,2,0
51931,2,3,181973,181973,181976,0,3,0
51932,4,1,181977,181977,181978,0,1,1
51933,1,1,181978,181978,181979,0,1,0
51934,1,1,181979,181979,181980,0,1,0
51935,2,3,181981,181981,181984,0,3,1
51936,3,1,181984,181984,181985,0,1,0
51937,5,1,181989,181989,181990,0,1,4
51938,1,2,181990,181990,181992,0,2,0
51939,4,1,181994,181994,181995,0,1,2
51940,4,3,181998,181998,182001,0,3,3
51941,3,3,182001,182001,182004,0,3,0
51942,6,1,182007,182007,182008,0,1,3
51943,5,1,182012,182012,182013,0,1,4
51944,5,3,182017,182017,182020,0,3,4
51945,1,3,182018,182020,182023,2,5,0
51946,4,3,182022,182023,182026,1,4,0
51947,2,2,182024,182026,182028,2,4,0
51948,6,3,182030,182030,182033,0,3,2
51949,2,2,182032,182033,182035,1,3,0
51950,5,2,182037,182037,182039,0,2,2
51951,6,3,182043,182043,182046,0,3,4
51952,1,3,182044,182046,182049,2,5,0
51953,5,3,182049,182049,182052,0,3,0
51954,2,2,182051,182052,182054,1,3,0
51955,1,2,182052,182054,182056,2,4,0
51956,6,1,182058,182058,182059,0,1,2
51957,2,3,182060,182060,182063,0,3,1
51958,2,2,182062,182063,182065,1,3,0
51959,4,3,182066,182066,182069,0,3,1
51960,3,3,182069,182069,182072,0,3,0
51961,6,1,182075,182075,182076,0,1,3
51962,3,1,182078,182078,182079,0,1,2
51963,2,1,182080,182080,182081,0,1,1
51964,1,2,182081,182081,182083,0,2,0
51965,5,2,182086,182086,182088,0,2,3
51966,2,1,182088,182088,182089,0,1,0
51967,5,1,182093,182093,182094,0,1,4
51968,2,3,182095,182095,182098,0,3,1
51969,3,3,182098,182098,182101,0,3,0
51970,1,3,182099,182101,182104,2,5,0
51971,1,2,182100,182104,182106,4,6,0
51972,4,3,182104,182106,182109,2,5,0
51973,3,1,182107,182109,182110,2,3,0
51974,4,3,182111,182111,182114,0,3,1
51975,4,2,182115,182115,182117,0,2,1
51976,3,2,182118,182118,182120,0,2,1
51977,1,1,182119,182120,182121,1,2,0
51978,4,2,182123,182123,182125,0,2,2
51979,2,1,182125,182125,182126,0,1,0
51980,5,1,182130,182130,182131,0,1,4
51981,2,1,182132,182132,182133,0,1,1
51982,5,1,182137,182137,182138,0,1,4
51983,4,2,182141,182141,182143,0,2,3
51984,5,1,182146,182146,182147,0,1,3
51985,1,3,182147,182147,182150,0,3,0
51986,1,3,182148,182150,182153,2,5,0
51987,6,1,182154,182154,182155,0,1,1
51988,1,2,182155,182155,182157,0,2,0
51989,3,2,182158,182158,182160,0,2,1
51990,4,2,182162,182162,182164,0,2,2
51991,5,3,182167,182167,182170,0,3,3
51992,6,3,182173,182173,182176,0,3,3
51993,5,2,182178,182178,182180,0,2,2
51994,6,1,182184,182184,182185,0,1,4
51995,3,1,182187,182187,182188,0,1,2
51996,4,2,182191,182191,182193,0,2,3
51997,6,2,182197,182197,182199,0,2,4
51998,6,2,182203,182203,182205,0,2,4
51999,4,1,182207,182207,182208,0,1,2
52000,2,2,182209,182209,182211,0,2,1
52001,2,3,182211,182211,182214,0,3,0
52002,3,1,182214,182214,182215,0,1,0
52003,6,1,182220,182220,182221,0,1,5
52004,5,3,182225,182225,182228,0,3,4
52005,2,2,182227,182228,182230,1,3,0
52006,1,3,182228,182230,182233,2,5,0
52007,2,3,182230,182233,182236,3,6,0
52008,5,2,182235,182236,182238,1,3,0
52009,2,2,182237,182238,182240,1,3,0
52010,6,2,182243,182243,182245,0,2,3
52011,5,1,182248,182248,182249,0,1,3
52012,1,3,182249,182249,182252,0,3,0
52013,4,2,182253,182253,182255,0,2,1
52014,6,3,182259,182259,182262,0,3,4
52015,4,1,182263,182263,182264,0,1,1
52016,1,3,182264,182264,182267,0,3,0
52017,3,1,182267,182267,182268,0,1,0
52018,2,2,182269,182269,182271,0,2,1
52019,5,2,182274,182274,182276,0,2,3
52020,4,2,182278,182278,182280,0,2,2
52021,3,3,182281,182281,182284,0,3,1
52022,1,3,182282,182284,182287,2,5,0
52023,4,1,182286,182287,182288,1,2,0
52024,2,1,182288,182288,182289,0,1,0
52025,6,3,182294,182294,182297,0,3,5
52026,3,3,182297,182297,182300,0,3,0
52027,5,3,182302,182302,182305,0,3,2
52028,3,3,182305,182305,182308,0,3,0
52029,2,2,182307,182308,182310,1,3,0
52030,2,2,182309,182310,182312,1,3,0
52031,2,1,182311,182312,182313,1,2,0
52032,5,1,182316,182316,182317,0,1,3
52033,2,1,182318,182318,182319,0,1,1
52034,2,1,182320,182320,182321,0,1,1
52035,5,1,182325,182325,182326,0,1,4
52036,2,3,182327,182327,182330,0,3,1
52037,1,1,182328,182330,182331,2,3,0
52038,5,2,182333,182333,182335,0,2,2
52039,3,1,182336,182336,182337,0,1,1
52040,2,3,182338,182338,182341,0,3,1
52041,4,2,182342,182342,182344,0,2,1
52042,4,2,182346,182346,182348,0,2,2
52043,4,2,182350,182350,182352,0,2,2
52044,3,3,182353,182353,182356,0,3,1
52045,1,1,182354,182356,182357,2,3,0
52046,6,1,182360,182360,182361,0,1,3
52047,4,3,182364,182364,182367,0,3,3
52048,2,2,182366,182367,182369,1,3,0
52049,4,2,182370,182370,182372,0,2,1
52050,5,2,182375,182375,182377,0,2,3
52051,2,1,182377,182377,182378,0,1,0
52052,3,3,182380,182380,182383,0,3,2
52053,1,2,182381,182383,182385,2,4,0
52054,6,2,182387,182387,182389,0,2,2
52055,4,3,182391,182391,182394,0,3,2
52056,5,2,182396,182396,182398,0,2,2
52057,3,2,182399,182399,182401,0,2,1
52058,1,3,182400,182401,182404,1,4,0
52059,2,2,182402,182404,182406,2,4,0
52060,3,1,182405,182406,182407,1,2,0
52061,4,1,182409,182409,182410,0,1,2
52062,3,1,182412,182412,182413,0,1,2
52063,1,1,182413,182413,182414,0,1,0
52064,5,2,182418,182418,182420,0,2,4
52065,5,1,182423,182423,182424,0,1,3
52066,1,3,182424,182424,182427,0,3,0
52067,5,3,182429,182429,182432,0,3,2
52068,4,2,182433,182433,182435,0,2,1
52069,4,3,182437,182437,182440,0,3,2
52070,4,1,182441,182441,182442,0,1,1
52071,1,3,182442,182442,182445,0,3,0
52072,6,1,182448,182448,182449,0,1,3
52073,5,1,182453,182453,182454,0,1,4
52074,1,2,182454,182454,182456,0,2,0
52075,3,3,182457,182457,182460,0,3,1
52076,2,2,182459,182460,182462,1,3,0
52077,2,3,182461,182462,182465,1,4,0
52078,4,2,182465,182465,182467,0,2,0
52079,1,2,182466,182467,182469,1,3,0
52080,6,3,182472,182472,182475,0,3,3
52081,2,2,182474,182475,182477,1,3,0
52082,4,1,182478,182478,182479,0,1,1
52083,5,1,182483,182483,182484,0,1,4
52084,3,2,182486,182486,182488,0,2,2
52085,5,3,182491,182491,182494,0,3,3
52086,5,2,182496,182496,182498,0,2,2
52087,6,1,182502,182502,182503,0,1,4
52088,5,1,182507,182507,182508,0,1,4
52089,2,3,182509,182509,182512,0,3,1
52090,2,1,182511,182512,182513,1,2,0
52091,4,2,182515,182515,182517,0,2,2
52092,5,1,182520,182520,182521,0,1,3
52093,2,1,182522,182522,182523,0,1,1
52094,3,3,182525,182525,182528,0,3,2
52095,6,3,182531,182531,182534,0,3,3
52096,4,3,182535,182535,182538,0,3,1
52097,2,2,182537,182538,182540,1,3,0
52098,3,1,182540,182540,182541,0,1,0
52099,1,2,182541,182541,182543,0,2,0
52100,3,3,182544,182544,182547,0,3,1
52101,5,3,182549,182549,182552,0,3,2
52102,4,3,182553,182553,182556,0,3,1
52103,6,1,182559,182559,182560,0,1,3
52104,5,2,182564,182564,182566,0,2,4
52105,5,3,182569,182569,182572,0,3,3
52106,6,2,182575,182575,182577,0,2,3
52107,1,1,182576,182577,182578,1,2,0
52108,3,1,182579,182579,182580,0,1,1
52109,2,2,182581,182581,182583,0,2,1
52110,6,2,182587,182587,182589,0,2,4
52111,2,1,182589,182589,182590,0,1,0
52112,4,1,182593,182593,182594,0,1,3
52113,4,3,182597,182597,182600,0,3,3
52114,1,3,182598,182600,182603,2,5,0
52115,6,3,182604,182604,182607,0,3,1
52116,1,3,182605,182607,182610,2,5,0
52117,4,1,182609,182610,182611,1,2,0
52118,4,2,182613,182613,182615,0,2,2
52119,5,1,182618,182618,182619,0,1,3
52120,2,2,182620,182620,182622,0,2,1
52121,1,1,182621,182622,182623,1,2,0
52122,4,3,182625,182625,182628,0,3,2
52123,2,1,182627,182628,182629,1,2,0
52124,5,3,182632,182632,182635,0,3,3
52125,4,1,182636,182636,182637,0,1,1
52126,2,1,182638,182638,182639,0,1,1
52127,2,2,182640,182640,182642,0,2,1
52128,3,2,182643,182643,182645,0,2,1
52129,6,2,182649,182649,182651,0,2,4
52130,3,2,182652,182652,182654,0,2,1
52131,2,2,182654,182654,182656,0,2,0
52132,6,1,182660,182660,182661,0,1,4
52133,2,2,182662,182662,182664,0,2,1
52134,1,3,182663,182664,182667,1,4,0
52135,6,3,182669,182669,182672,0,3,2
52136,1,2,182670,182672,182674,2,4,0
52137,6,1,182676,182676,182677,0,1,2
52138,5,1,182681,182681,182682,0,1,4
52139,2,3,182683,182683,182686,0,3,1
52140,4,1,182687,182687,182688,0,1,1
52141,2,2,182689,182689,182691,0,2,1
52142,4,1,182693,182693,182694,0,1,2
52143,3,2,182696,182696,182698,0,2,2
52144,1,3,182697,182698,182701,1,4,0
52145,5,1,182702,182702,182703,0,1,1
52146,3,2,182705,182705,182707,0,2,2
52147,2,2,182707,182707,182709,0,2,0
52148,2,2,182709,182709,182711,0,2,0
52149,4,2,182713,182713,182715,0,2,2
52150,5,2,182718,182718,182720,0,2,3
52151,3,1,182721,182721,182722,0,1,1
52152,4,1,182725,182725,182726,0,1,3
52153,6,1,182731,182731,182732,0,1,5
52154,4,2,182735,182735,182737,0,2,3
52155,6,2,182741,182741,182743,0,2,4
52156,3,2,182744,182744,182746,0,2,1
52157,5,2,182749,182749,182751,0,2,3
52158,1,1,182750,182751,182752,1,2,0
52159,3,2,182753,182753,182755,0,2,1
52160,5,2,182758,182758,182760,0,2,3
52161,2,1,182760,182760,182761,0,1,0
52162,3,3,182763,182763,182766,0,3,2
52163,2,1,182765,182766,182767,1,2,0
52164,5,3,182770,182770,182773,0,3,3
52165,3,2,182773,182773,182775,0,2,0
52166,1,1,182774,182775,182776,1,2,0
52167,5,1,182779,182779,182780,0,1,3
52168,1,3,182780,182780,182783,0,3,0
52169,2,2,182782,182783,182785,1,3,0
52170,3,3,182785,182785,182788,0,3,0
52171,4,1,182789,182789,182790,0,1,1
52172,4,3,182793,182793,182796,0,3,3
52173,1,2,182794,182796,182798,2,4,0
52174,5,2,182799,182799,182801,0,2,1
52175,2,2,182801,182801,182803,0,2,0
52176,2,1,182803,182803,182804,0,1,0
52177,3,3,182806,182806,182809,0,3,2
52178,1,3,182807,182809,182812,2,5,0
52179,4,2,182811,182812,182814,1,3,0
52180,2,3,182813,182814,182817,1,4,0
52181,4,1,182817,182817,182818,0,1,0
52182,6,3,182823,182823,182826,0,3,5
52183,4,2,182827,182827,182829,0,2,1
52184,6,2,182833,182833,182835,0,2,4
52185,4,2,182837,182837,182839,0,2,2
52186,3,2,182840,182840,182842,0,2,1
52187,5,2,182845,182845,182847,0,2,3
52188,1,2,182846,182847,182849,1,3,0
52189,2,1,182848,182849,182850,1,2,0
52190,1,1,182849,182850,182851,1,2,0
52191,2,2,182851,182851,182853,0,2,0
52192,6,3,182857,182857,182860,0,3,4
52193,4,3,182861,182861,182864,0,3,1
52194,3,3,182864,182864,182867,0,3,0
52195,2,2,182866,182867,182869,1,3,0
52196,1,2,182867,182869,182871,2,4,0
52197,6,1,182873,182873,182874,0,1,2
52198,5,2,182878,182878,182880,0,2,4
52199,3,1,182881,182881,182882,0,1,1
52200,5,2,182886,182886,182888,0,2,4
52201,6,2,182892,182892,182894,0,2,4
52202,6,3,182898,182898,182901,0,3,4
52203,2,1,182900,182901,182902,1,2,0
52204,6,1,182906,182906,182907,0,1,4
52205,2,2,182908,182908,182910,0,2,1
52206,1,3,182909,182910,182913,1,4,0
52207,5,2,182914,182914,182916,0,2,1
52208,3,1,182917,182917,182918,0,1,1
52209,4,2,182921,182921,182923,0,2,3
52210,3,3,182924,182924,182927,0,3,1
52211,1,3,182925,182927,182930,2,5,0
52212,5,1,182930,182930,182931,0,1,0
52213,3,1,182933,182933,182934,0,1,2
52214,3,3,182936,182936,182939,0,3,2
52215,4,3,182940,182940,182943,0,3,1
52216,3,2,182943,182943,182945,0,2,0
52217,1,3,182944,182945,182948,1,4,0
52218,2,1,182946,182948,182949,2,3,0
52219,3,2,182949,182949,182951,0,2,0
52220,5,2,182954,182954,182956,0,2,3
52221,3,1,182957,182957,182958,0,1,1
52222,3,3,182960,182960,182963,0,3,2
52223,6,1,182966,182966,182967,0,1,3
52224,3,3,182969,182969,182972,0,3,2
52225,2,2,182971,182972,182974,1,3,0
52226,5,1,182976,182976,182977,0,1,2
52227,4,2,182980,182980,182982,0,2,3
52228,6,3,182986,182986,182989,0,3,4
52229,2,2,182988,182989,182991,1,3,0
52230,6,3,182994,182994,182997,0,3,3
52231,4,1,182998,182998,182999,0,1,1
52232,1,3,182999,182999,183002,0,3,0
52233,2,2,183001,183002,183004,1,3,0
52234,3,3,183004,183004,183007,0,3,0
52235,6,2,183010,183010,183012,0,2,3
52236,2,3,183012,183012,183015,0,3,0
52237,1,1,183013,183015,183016,2,3,0
52238,3,3,183016,183016,183019,0,3,0
52239,4,2,183020,183020,183022,0,2,1
52240,1,1,183021,183022,183023,1,2,0
52241,6,1,183027,183027,183028,0,1,4
52242,5,2,183032,183032,183034,0,2,4
52243,4,2,183036,183036,183038,0,2,2
52244,4,3,183040,183040,183043,0,3,2
52245,4,2,183044,183044,183046,0,2,1
52246,2,1,183046,183046,183047,0,1,0
52247,2,2,183048,183048,183050,0,2,1
52248,5,1,183053,183053,183054,0,1,3
52249,6,1,183059,183059,183060,0,1,5
52250,3,1,183062,183062,183063,0,1,2
52251,4,1,183066,183066,183067,0,1,3
52252,2,1,183068,183068,183069,0,1,1
52253,3,1,183071,183071,183072,0,1,2
52254,2,2,183073,183073,183075,0,2,1
52255,5,3,183078,183078,183081,0,3,3
52256,2,2,183080,183081,183083,1,3,0
52257,6,3,183086,183086,183089,0,3,3
52258,4,3,183090,183090,183093,0,3,1
52259,1,1,183091,183093,183094,2,3,0
52260,1,2,183092,183094,183096,2,4,0
52261,3,1,183095,183096,183097,1,2,0
52262,6,2,183101,183101,183103,0,2,4
52263,4,1,183105,183105,183106,0,1,2
52264,3,3,183108,183108,183111,0,3,2
52265,5,1,183113,183113,183114,0,1,2
52266,5,3,183118,183118,183121,0,3,4
52267,6,1,183124,183124,183125,0,1,3
52268,2,2,183126,183126,183128,0,2,1
52269,4,3,183130,183130,183133,0,3,2
52270,2,1,183132,183133,183134,1,2,0
52271,6,1,183138,183138,183139,0,1,4
52272,2,2,183140,183140,183142,0,2,1
52273,3,1,183143,183143,183144,0,1,1
52274,4,1,183147,183147,183148,0,1,3
52275,3,1,183150,183150,183151,0,1,2
52276,1,3,183151,183151,183154,0,3,0
52277,2,2,183153,183154,183156,1,3,0
52278,2,3,183155,183156,183159,1,4,0
52279,1,2,183156,183159,183161,3,5,0
52280,2,1,183158,183161,183162,3,4,0
52281,2,1,183160,183162,183163,2,3,0
52282,3,1,183163,183163,183164,0,1,0
52283,4,3,183167,183167,183170,0,3,3
52284,4,2,183171,183171,183173,0,2,1
52285,2,2,183173,183173,183175,0,2,0
52286,4,1,183177,183177,183178,0,1,2
52287,4,2,183181,183181,183183,0,2,3
52288,3,1,183184,183184,183185,0,1,1
52289,1,3,183185,183185,183188,0,3,0
52290,3,2,183188,183188,183190,0,2,0
52291,3,3,183191,183191,183194,0,3,1
52292,5,3,183196,183196,183199,0,3,2
52293,1,1,183197,183199,183200,2,3,0
52294,5,2,183202,183202,183204,0,2,2
52295,6,3,183208,183208,183211,0,3,4
52296,5,1,183213,183213,183214,0,1,2
52297,4,2,183217,183217,183219,0,2,3
52298,1,1,183218,183219,183220,1,2,0
52299,1,2,183219,183220,183222,1,3,0
52300,3,3,183222,183222,183225,0,3,0
52301,5,2,183227,183227,183229,0,2,2
52302,1,3,183228,183229,183232,1,4,0
52303,3,1,183231,183232,183233,1,2,0
52304,1,2,183232,183233,183235,1,3,0
52305,3,1,183235,183235,183236,0,1,0
52306,5,1,183240,183240,183241,0,1,4
52307,4,1,183244,183244,183245,0,1,3
52308,1,1,183245,183245,183246,0,1,0
52309,2,3,183247,183247,183250,0,3,1
52310,5,1,183252,183252,183253,0,1,2
52311,6,2,183258,183258,183260,0,2,5
52312,6,2,183264,183264,183266,0,2,4
52313,1,3,183265,183266,183269,1,4,0
52314,6,2,183271,183271,183273,0,2,2
52315,5,2,183276,183276,183278,0,2,3
52316,5,1,183281,183281,183282,0,1,3
52317,1,3,183282,183282,183285,0,3,0
52318,6,1,183288,183288,183289,0,1,3
52319,4,2,183292,183292,183294,0,2,3
52320,4,3,183296,183296,183299,0,3,2
52321,1,3,183297,183299,183302,2,5,0
52322,5,1,183302,183302,183303,0,1,0
52323,1,3,183303,183303,183306,0,3,0
52324,2,3,183305,183306,183309,1,4,0
52325,4,3,183309,183309,183312,0,3,0
52326,6,2,183315,183315,183317,0,2,3
52327,1,1,183316,183317,183318,1,2,0
52328,3,3,183319,183319,183322,0,3,1
52329,3,3,183322,183322,183325,0,3,0
52330,4,2,183326,183326,183328,0,2,1
52331,6,3,183332,183332,183335,0,3,4
52332,5,1,183337,183337,183338,0,1,2
52333,6,2,183343,183343,183345,0,2,5
52334,2,2,183345,183345,183347,0,2,0
52335,4,1,183349,183349,183350,0,1,2
52336,4,1,183353,183353,183354,0,1,3
52337,2,3,183355,183355,183358,0,3,1
52338,3,2,183358,183358,183360,0,2,0
52339,5,1,183363,183363,183364,0,1,3
52340,1,3,183364,183364,183367,0,3,0
52341,3,3,183367,183367,183370,0,3,0
52342,3,2,183370,183370,183372,0,2,0
52343,2,3,183372,183372,183375,0,3,0
52344,6,2,183378,183378,183380,0,2,3
52345,6,3,183384,183384,183387,0,3,4
52346,6,3,183390,183390,183393,0,3,3
52347,4,3,183394,183394,183397,0,3,1
52348,2,2,183396,183397,183399,1,3,0
52349,2,1,183398,183399,183400,1,2,0
52350,6,2,183404,183404,183406,0,2,4
52351,5,3,183409,183409,183412,0,3,3
52352,1,1,183410,183412,183413,2,3,0
52353,2,1,183412,183413,183414,1,2,0
52354,6,1,183418,183418,183419,0,1,4
52355,3,2,183421,183421,183423,0,2,2
52356,5,2,183426,183426,183428,0,2,3
52357,4,1,183430,183430,183431,0,1,2
52358,3,2,183433,183433,183435,0,2,2
52359,6,3,183439,183439,183442,0,3,4
52360,3,3,183442,183442,183445,0,3,0
52361,3,3,183445,183445,183448,0,3,0
52362,6,1,183451,183451,183452,0,1,3
52363,1,1,183452,183452,183453,0,1,0
52364,5,1,183457,183457,183458,0,1,4
52365,6,2,183463,183463,183465,0,2,5
52366,3,2,183466,183466,183468,0,2,1
52367,2,3,183468,183468,183471,0,3,0
52368,2,1,183470,183471,183472,1,2,0
52369,6,3,183476,183476,183479,0,3,4
52370,4,3,183480,183480,183483,0,3,1
52371,5,1,183485,183485,183486,0,1,2
52372,2,1,183487,183487,183488,0,1,1
52373,3,2,183490,183490,183492,0,2,2
52374,5,1,183495,183495,183496,0,1,3
52375,3,2,183498,183498,183500,0,2,2
52376,2,1,183500,183500,183501,0,1,0
52377,6,2,183506,183506,183508,0,2,5
52378,1,3,183507,183508,183511,1,4,0
52379,2,3,183509,183511,183514,2,5,0
52380,4,1,183513,183514,183515,1,2,0
52381,2,3,183515,183515,183518,0,3,0
52382,5,3,183520,183520,183523,0,3,2
52383,6,3,183526,183526,183529,0,3,3
52384,4,2,183530,183530,183532,0,2,1
52385,2,3,183532,183532,183535,0,3,0
52386,5,1,183537,183537,183538,0,1,2
52387,5,3,183542,183542,183545,0,3,4
52388,4,1,183546,183546,183547,0,1,1
52389,4,3,183550,183550,183553,0,3,3
52390,5,2,183555,183555,183557,0,2,2
52391,2,3,183557,183557,183560,0,3,0
52392,5,3,183562,183562,183565,0,3,2
52393,6,3,183568,183568,183571,0,3,3
52394,5,3,183573,183573,183576,0,3,2
52395,3,1,183576,183576,183577,0,1,0
52396,4,1,183580,183580,183581,0,1,3
52397,1,1,183581,183581,183582,0,1,0
52398,5,3,183586,183586,183589,0,3,4
52399,5,2,183591,183591,183593,0,2,2
52400,4,2,183595,183595,183597,0,2,2
52401,2,2,183597,183597,183599,0,2,0
52402,3,1,183600,183600,183601,0,1,1
52403,2,1,183602,183602,183603,0,1,1
52404,3,3,183605,183605,183608,0,3,2
52405,3,2,183608,183608,183610,0,2,0
52406,4,2,183612,183612,183614,0,2,2
52407,3,2,183615,183615,183617,0,2,1
52408,2,2,183617,183617,183619,0,2,0
52409,6,1,183623,183623,183624,0,1,4
52410,4,2,183627,183627,183629,0,2,3
52411,4,2,183631,183631,183633,0,2,2
52412,6,2,183637,183637,183639,0,2,4
52413,4,2,183641,183641,183643,0,2,2
52414,6,1,183647,183647,183648,0,1,4
52415,1,2,183648,183648,183650,0,2,0
52416,4,2,183652,183652,183654,0,2,2
52417,3,3,183655,183655,183658,0,3,1
52418,3,3,183658,183658,183661,0,3,0
52419,1,3,183659,183661,183664,2,5,0
52420,4,2,183663,183664,183666,1,3,0
52421,6,1,183669,183669,183670,0,1,3
52422,6,2,183675,183675,183677,0,2,5
52423,3,1,183678,183678,183679,0,1,1
52424,5,3,183683,183683,183686,0,3,4
52425,1,3,183684,183686,183689,2,5,0
52426,1,3,183685,183689,183692,4,7,0
52427,4,3,183689,183692,183695,3,6,0
52428,2,2,183691,183695,183697,4,6,0
52429,6,3,183697,183697,183700,0,3,0
52430,2,2,183699,183700,183702,1,3,0
52431,4,3,183703,183703,183706,0,3,1
52432,5,1,183708,183708,183709,0,1,2
52433,5,3,183713,183713,183716,0,3,4
52434,5,1,183718,183718,183719,0,1,2
52435,1,2,183719,183719,183721,0,2,0
52436,4,1,183723,183723,183724,0,1,2
52437,4,2,183727,183727,183729,0,2,3
52438,4,3,183731,183731,183734,0,3,2
52439,5,3,183736,183736,183739,0,3,2
52440,2,2,183738,183739,183741,1,3,0
52441,2,3,183740,183741,183744,1,4,0
52442,3,2,183743,183744,183746,1,3,0
52443,5,2,183748,183748,183750,0,2,2
52444,1,2,183749,183750,183752,1,3,0
52445,4,3,183753,183753,183756,0,3,1
52446,6,3,183759,183759,183762,0,3,3
52447,1,2,183760,183762,183764,2,4,0
52448,4,1,183764,183764,183765,0,1,0
52449,3,1,183767,183767,183768,0,1,2
52450,6,3,183773,183773,183776,0,3,5
52451,4,3,183777,183777,183780,0,3,1
52452,2,1,183779,183780,183781,1,2,0
52453,2,2,183781,183781,183783,0,2,0
52454,1,2,183782,183783,183785,1,3,0
52455,5,1,183787,183787,183788,0,1,2
52456,3,1,183790,183790,183791,0,1,2
52457,5,3,183795,183795,183798,0,3,4
52458,6,3,183801,183801,183804,0,3,3
52459,2,2,183803,183804,183806,1,3,0
52460,1,2,183804,183806,183808,2,4,0
52461,2,3,183806,183808,183811,2,5,0
52462,3,3,183809,183811,183814,2,5,0
52463,3,2,183812,183814,183816,2,4,0
52464,3,3,183815,183816,183819,1,4,0
52465,1,3,183816,183819,183822,3,6,0
52466,4,2,183820,183822,183824,2,4,0
52467,6,3,183826,183826,183829,0,3,2
52468,6,1,183832,183832,183833,0,1,3
52469,3,1,183835,183835,183836,0,1,2
52470,4,2,183839,183839,183841,0,2,3
52471,1,1,183840,183841,183842,1,2,0
52472,4,1,183844,183844,183845,0,1,2
52473,5,1,183849,183849,183850,0,1,4
52474,4,2,183853,183853,183855,0,2,3
52475,4,1,183857,183857,183858,0,1,2
52476,3,3,183860,183860,183863,0,3,2
52477,1,1,183861,183863,183864,2,3,0
52478,6,2,183867,183867,183869,0,2,3
52479,1,3,183868,183869,183872,1,4,0
52480,2,3,183870,183872,183875,2,5,0
52481,6,1,183876,183876,183877,0,1,1
52482,4,1,183880,183880,183881,0,1,3
52483,6,3,183886,183886,183889,0,3,5
52484,2,2,183888,183889,183891,1,3,0
52485,3,1,183891,183891,183892,0,1,0
52486,2,1,183893,183893,183894,0,1,1
52487,3,1,183896,183896,183897,0,1,2
52488,6,3,183902,183902,183905,0,3,5
52489,5,2,183907,183907,183909,0,2,2
52490,2,1,183909,183909,183910,0,1,0
52491,5,2,183914,183914,183916,0,2,4
52492,5,2,183919,183919,183921,0,2,3
52493,2,3,183921,183921,183924,0,3,0
52494,2,2,183923,183924,183926,1,3,0
52495,4,1,183927,183927,183928,0,1,1
52496,2,3,183929,183929,183932,0,3,1
52497,2,2,183931,183932,183934,1,3,0
52498,6,2,183937,183937,183939,0,2,3
52499,1,3,183938,183939,183942,1,4,0
52500,6,2,183944,183944,183946,0,2,2
52501,5,1,183949,183949,183950,0,1,3
52502,3,3,183952,183952,183955,0,3,2
52503,6,3,183958,183958,183961,0,3,3
52504,6,3,183964,183964,183967,0,3,3
52505,2,1,183966,183967,183968,1,2,0
52506,3,1,183969,183969,183970,0,1,1
52507,5,1,183974,183974,183975,0,1,4
52508,5,1,183979,183979,183980,0,1,4
52509,1,2,183980,183980,183982,0,2,0
52510,1,1,183981,183982,183983,1,2,0
52511,3,2,183984,183984,183986,0,2,1
52512,4,1,183988,183988,183989,0,1,2
52513,2,3,183990,183990,183993,0,3,1
52514,4,2,183994,183994,183996,0,2,1
52515,2,3,183996,183996,183999,0,3,0
52516,5,3,184001,184001,184004,0,3,2
52517,1,2,184002,184004,184006,2,4,0
52518,4,1,184006,184006,184007,0,1,0
52519,3,3,184009,184009,184012,0,3,2
52520,4,3,184013,184013,184016,0,3,1
52521,1,2,184014,184016,184018,2,4,0
52522,5,1,184019,184019,184020,0,1,1
52523,6,1,184025,184025,184026,0,1,5
52524,2,1,184027,184027,184028,0,1,1
52525,6,3,184033,184033,184036,0,3,5
52526,4,3,184037,184037,184040,0,3,1
52527,3,2,184040,184040,184042,0,2,0
52528,5,2,184045,184045,184047,0,2,3
52529,1,1,184046,184047,184048,1,2,0
52530,6,3,184052,184052,184055,0,3,4
52531,2,1,184054,184055,184056,1,2,0
52532,5,2,184059,184059,184061,0,2,3
52533,6,1,184065,184065,184066,0,1,4
52534,6,1,184071,184071,184072,0,1,5
52535,3,3,184074,184074,184077,0,3,2
52536,5,2,184079,184079,184081,0,2,2
52537,4,3,184083,184083,184086,0,3,2
52538,5,3,184088,184088,184091,0,3,2
52539,6,3,184094,184094,184097,0,3,3
52540,3,1,184097,184097,184098,0,1,0
52541,6,3,184103,184103,184106,0,3,5
52542,3,3,184106,184106,184109,0,3,0
52543,6,1,184112,184112,184113,0,1,3
52544,3,3,184115,184115,184118,0,3,2
52545,5,3,184120,184120,184123,0,3,2
52546,2,2,184122,184123,184125,1,3,0
52547,1,3,184123,184125,184128,2,5,0
52548,1,1,184124,184128,184129,4,5,0
52549,2,2,184126,184129,184131,3,5,0
52550,3,1,184129,184131,184132,2,3,0
52551,5,3,184134,184134,184137,0,3,2
52552,3,3,184137,184137,184140,0,3,0
52553,6,1,184143,184143,184144,0,1,3
52554,4,3,184147,184147,184150,0,3,3
52555,4,3,184151,184151,184154,0,3,1
52556,1,1,184152,184154,184155,2,3,0
52557,4,3,184156,184156,184159,0,3,1
52558,2,2,184158,184159,184161,1,3,0
52559,5,3,184163,184163,184166,0,3,2
52560,4,1,184167,184167,184168,0,1,1
52561,3,1,184170,184170,184171,0,1,2
52562,5,3,184175,184175,184178,0,3,4
52563,3,1,184178,184178,184179,0,1,0
52564,3,3,184181,184181,184184,0,3,2
52565,5,3,184186,184186,184189,0,3,2
52566,1,3,184187,184189,184192,2,5,0
52567,5,3,184192,184192,184195,0,3,0
52568,5,3,184197,184197,184200,0,3,2
52569,3,1,184200,184200,184201,0,1,0
52570,5,1,184205,184205,184206,0,1,4
52571,4,1,184209,184209,184210,0,1,3
52572,4,1,184213,184213,184214,0,1,3
52573,5,1,184218,184218,184219,0,1,4
52574,2,2,184220,184220,184222,0,2,1
52575,6,3,184226,184226,184229,0,3,4
52576,5,3,184231,184231,184234,0,3,2
52577,2,3,184233,184234,184237,1,4,0
52578,1,3,184234,184237,184240,3,6,0
52579,1,2,184235,184240,184242,5,7,0
52580,5,2,184240,184242,184244,2,4,0
52581,5,1,184245,184245,184246,0,1,1
52582,3,2,184248,184248,184250,0,2,2
52583,6,2,184254,184254,184256,0,2,4
52584,4,3,184258,184258,184261,0,3,2
52585,1,1,184259,184261,184262,2,3,0
52586,4,1,184263,184263,184264,0,1,1
52587,1,3,184264,184264,184267,0,3,0
52588,1,1,184265,184267,184268,2,3,0
52589,5,2,184270,184270,184272,0,2,2
52590,1,2,184271,184272,184274,1,3,0
52591,6,3,184277,184277,184280,0,3,3
52592,4,3,184281,184281,184284,0,3,1
52593,6,3,184287,184287,184290,0,3,3
52594,4,3,184291,184291,184294,0,3,1
52595,2,1,184293,184294,184295,1,2,0
52596,5,3,184298,184298,184301,0,3,3
52597,1,1,184299,184301,184302,2,3,0
52598,6,3,184305,184305,184308,0,3,3
52599,1,1,184306,184308,184309,2,3,0
52600,6,3,184312,184312,184315,0,3,3
52601,4,2,184316,184316,184318,0,2,1
52602,5,2,184321,184321,184323,0,2,3
52603,3,1,184324,184324,184325,0,1,1
52604,2,3,184326,184326,184329,0,3,1
52605,1,2,184327,184329,184331,2,4,0
52606,1,1,184328,184331,184332,3,4,0
52607,2,2,184330,184332,184334,2,4,0
52608,3,1,184333,184334,184335,1,2,0
52609,3,1,184336,184336,184337,0,1,1
52610,5,3,184341,184341,184344,0,3,4
52611,1,3,184342,184344,184347,2,5,0
52612,6,2,184348,184348,184350,0,2,1
52613,3,3,184351,184351,184354,0,3,1
52614,2,3,184353,184354,184357,1,4,0
52615,3,3,184356,184357,184360,1,4,0
52616,6,1,184362,184362,184363,0,1,2
52617,2,1,184364,184364,184365,0,1,1
52618,3,2,184367,184367,184369,0,2,2
52619,4,1,184371,184371,184372,0,1,2
52620,5,3,184376,184376,184379,0,3,4
52621,6,1,184382,184382,184383,0,1,3
52622,4,1,184386,184386,184387,0,1,3
52623,2,1,184388,184388,184389,0,1,1
52624,2,1,184390,184390,184391,0,1,1
52625,3,3,184393,184393,184396,0,3,2
52626,2,1,184395,184396,184397,1,2,0
52627,4,3,184399,184399,184402,0,3,2
52628,6,3,184405,184405,184408,0,3,3
52629,1,3,184406,184408,184411,2,5,0
52630,4,3,184410,184411,184414,1,4,0
52631,6,3,184416,184416,184419,0,3,2
52632,6,2,184422,184422,184424,0,2,3
52633,6,2,184428,184428,184430,0,2,4
52634,6,3,184434,184434,184437,0,3,4
52635,2,1,184436,184437,184438,1,2,0
52636,1,3,184437,184438,184441,1,4,0
52637,6,3,184443,184443,184446,0,3,2
52638,1,3,184444,184446,184449,2,5,0
52639,3,2,184447,184449,184451,2,4,0
52640,1,3,184448,184451,184454,3,6,0
52641,4,1,184452,184454,184455,2,3,0
52642,6,1,184458,184458,184459,0,1,3
52643,4,3,184462,184462,184465,0,3,3
52644,6,1,184468,184468,184469,0,1,3
52645,2,2,184470,184470,184472,0,2,1
52646,1,3,184471,184472,184475,1,4,0
52647,6,3,184477,184477,184480,0,3,2
52648,3,1,184480,184480,184481,0,1,0
52649,5,2,184485,184485,184487,0,2,4
52650,5,3,184490,184490,184493,0,3,3
52651,3,3,184493,184493,184496,0,3,0
52652,3,2,184496,184496,184498,0,2,0
52653,6,2,184502,184502,184504,0,2,4
52654,5,2,184507,184507,184509,0,2,3
52655,4,3,184511,184511,184514,0,3,2
52656,4,3,184515,184515,184518,0,3,1
52657,4,3,184519,184519,184522,0,3,1
52658,3,2,184522,184522,184524,0,2,0
52659,5,3,184527,184527,184530,0,3,3
52660,1,2,184528,184530,184532,2,4,0
52661,3,3,184531,184532,184535,1,4,0
52662,5,2,184536,184536,184538,0,2,1
52663,6,2,184542,184542,184544,0,2,4
52664,5,1,184547,184547,184548,0,1,3
52665,2,2,184549,184549,184551,0,2,1
52666,1,3,184550,184551,184554,1,4,0
52667,6,3,184556,184556,184559,0,3,2
52668,6,3,184562,184562,184565,0,3,3
52669,3,1,184565,184565,184566,0,1,0
52670,2,3,184567,184567,184570,0,3,1
52671,4,3,184571,184571,184574,0,3,1
52672,2,3,184573,184574,184577,1,4,0
52673,1,2,184574,184577,184579,3,5,0
52674,1,1,184575,184579,184580,4,5,0
52675,5,1,184580,184580,184581,0,1,0
52676,4,3,184584,184584,184587,0,3,3
52677,3,3,184587,184587,184590,0,3,0
52678,4,3,184591,184591,184594,0,3,1
52679,6,1,184597,184597,184598,0,1,3
52680,6,2,184603,184603,184605,0,2,5
52681,3,1,184606,184606,184607,0,1,1
52682,3,2,184609,184609,184611,0,2,2
52683,3,2,184612,184612,184614,0,2,1
52684,3,3,184615,184615,184618,0,3,1
52685,4,1,184619,184619,184620,0,1,1
52686,3,1,184622,184622,184623,0,1,2
52687,1,2,184623,184623,184625,0,2,0
52688,3,2,184626,184626,184628,0,2,1
52689,4,3,184630,184630,184633,0,3,2
52690,1,2,184631,184633,184635,2,4,0
52691,6,1,184637,184637,184638,0,1,2
52692,2,3,184639,184639,184642,0,3,1
52693,5,3,184644,184644,184647,0,3,2
52694,4,3,184648,184648,184651,0,3,1
52695,3,1,184651,184651,184652,0,1,0
52696,1,2,184652,184652,184654,0,2,0
52697,5,1,184657,184657,184658,0,1,3
52698,2,1,184659,184659,184660,0,1,1
52699,5,3,184664,184664,184667,0,3,4
52700,2,1,184666,184667,184668,1,2,0
52701,6,1,184672,184672,184673,0,1,4
52702,2,3,184674,184674,184677,0,3,1
52703,3,2,184677,184677,184679,0,2,0
52704,1,1,184678,184679,184680,1,2,0
52705,5,3,184683,184683,184686,0,3,3
52706,5,1,184688,184688,184689,0,1,2
52707,5,2,184693,184693,184695,0,2,4
52708,2,2,184695,184695,184697,0,2,0
52709,5,2,184700,184700,184702,0,2,3
52710,2,3,184702,184702,184705,0,3,0
52711,6,2,184708,184708,184710,0,2,3
52712,1,2,184709,184710,184712,1,3,0
52713,1,1,184710,184712,184713,2,3,0
52714,6,2,184716,184716,184718,0,2,3
52715,1,1,184717,184718,184719,1,2,0
52716,5,2,184722,184722,184724,0,2,3
52717,4,2,184726,184726,184728,0,2,2
52718,1,2,184727,184728,184730,1,3,0
52719,1,1,184728,184730,184731,2,3,0
52720,2,3,184730,184731,184734,1,4,0
52721,5,1,184735,184735,184736,0,1,1
52722,2,3,184737,184737,184740,0,3,1
52723,4,2,184741,184741,184743,0,2,1
52724,3,3,184744,184744,184747,0,3,1
52725,2,1,184746,184747,184748,1,2,0
52726,1,1,184747,184748,184749,1,2,0
52727,3,3,184750,184750,184753,0,3,1
52728,1,1,184751,184753,184754,2,3,0
52729,3,2,184754,184754,184756,0,2,0
52730,5,1,184759,184759,184760,0,1,3
52731,2,2,184761,184761,184763,0,2,1
52732,6,2,184767,184767,184769,0,2,4
52733,1,3,184768,184769,184772,1,4,0
52734,1,2,184769,184772,184774,3,5,0
52735,5,2,184774,184774,184776,0,2,0
52736,2,3,184776,184776,184779,0,3,0
52737,5,3,184781,184781,184784,0,3,2
52738,1,2,184782,184784,184786,2,4,0
52739,2,1,184784,184786,184787,2,3,0
52740,2,3,184786,184787,184790,1,4,0
52741,4,3,184790,184790,184793,0,3,0
52742,6,1,184796,184796,184797,0,1,3
52743,3,3,184799,184799,184802,0,3,2
52744,4,2,184803,184803,184805,0,2,1
52745,3,2,184806,184806,184808,0,2,1
52746,6,2,184812,184812,184814,0,2,4
52747,3,2,184815,184815,184817,0,2,1
52748,1,2,184816,184817,184819,1,3,0
52749,4,3,184820,184820,184823,0,3,1
52750,3,1,184823,184823,184824,0,1,0
52751,3,1,184826,184826,184827,0,1,2
52752,2,3,184828,184828,184831,0,3,1
52753,3,3,184831,184831,184834,0,3,0
52754,5,2,184836,184836,184838,0,2,2
52755,6,1,184842,184842,184843,0,1,4
52756,1,2,184843,184843,184845,0,2,0
52757,2,1,184845,184845,184846,0,1,0
52758,4,1,184849,184849,184850,0,1,3
52759,6,3,184855,184855,184858,0,3,5
52760,1,1,184856,184858,184859,2,3,0
52761,6,1,184862,184862,184863,0,1,3
52762,3,3,184865,184865,184868,0,3,2
52763,1,1,184866,184868,184869,2,3,0
52764,3,2,184869,184869,184871,0,2,0
52765,1,3,184870,184871,184874,1,4,0
52766,5,3,184875,184875,184878,0,3,1
52767,6,2,184881,184881,184883,0,2,3
52768,1,1,184882,184883,184884,1,2,0
52769,5,3,184887,184887,184890,0,3,3
52770,2,3,184889,184890,184893,1,4,0
52771,6,3,184895,184895,184898,0,3,2
52772,2,2,184897,184898,184900,1,3,0
52773,4,3,184901,184901,184904,0,3,1
52774,3,1,184904,184904,184905,0,1,0
52775,2,2,184906,184906,184908,0,2,1
52776,4,3,184910,184910,184913,0,3,2
52777,5,3,184915,184915,184918,0,3,2
52778,4,2,184919,184919,184921,0,2,1
52779,2,1,184921,184921,184922,0,1,0
52780,2,3,184923,184923,184926,0,3,1
52781,1,1,184924,184926,184927,2,3,0
52782,3,3,184927,184927,184930,0,3,0
52783,2,2,184929,184930,184932,1,3,0
52784,5,3,184934,184934,184937,0,3,2
52785,4,1,184938,184938,184939,0,1,1
52786,6,1,184944,184944,184945,0,1,5
52787,6,1,184950,184950,184951,0,1,5
52788,3,3,184953,184953,184956,0,3,2
52789,6,1,184959,184959,184960,0,1,3
52790,3,3,184962,184962,184965,0,3,2
52791,4,1,184966,184966,184967,0,1,1
52792,5,3,184971,184971,184974,0,3,4
52793,3,1,184974,184974,184975,0,1,0
52794,3,2,184977,184977,184979,0,2,2
52795,6,1,184983,184983,184984,0,1,4
52796,6,3,184989,184989,184992,0,3,5
52797,3,2,184992,184992,184994,0,2,0
52798,5,1,184997,184997,184998,0,1,3
52799,5,3,185002,185002,185005,0,3,4
52800,2,2,185004,185005,185007,1,3,0
52801,1,1,185005,185007,185008,2,3,0
52802,4,1,185009,185009,185010,0,1,1
52803,3,3,185012,185012,185015,0,3,2
52804,6,1,185018,185018,185019,0,1,3
52805,6,3,185024,185024,185027,0,3,5
52806,5,2,185029,185029,185031,0,2,2
52807,2,1,185031,185031,185032,0,1,0
52808,5,1,185036,185036,185037,0,1,4
52809,2,2,185038,185038,185040,0,2,1
52810,1,2,185039,185040,185042,1,3,0
52811,5,2,185044,185044,185046,0,2,2
52812,2,3,185046,185046,185049,0,3,0
52813,1,1,185047,185049,185050,2,3,0
52814,6,3,185053,185053,185056,0,3,3
52815,5,3,185058,185058,185061,0,3,2
52816,6,3,185064,185064,185067,0,3,3
52817,1,1,185065,185067,185068,2,3,0
52818,5,2,185070,185070,185072,0,2,2
52819,6,2,185076,185076,185078,0,2,4
52820,1,3,185077,185078,185081,1,4,0
52821,1,3,185078,185081,185084,3,6,0
52822,2,2,185080,185084,185086,4,6,0
52823,6,2,185086,185086,185088,0,2,0
52824,6,3,185092,185092,185095,0,3,4
52825,6,3,185098,185098,185101,0,3,3
52826,1,3,185099,185101,185104,2,5,0
52827,6,3,185105,185105,185108,0,3,1
52828,2,2,185107,185108,185110,1,3,0
52829,3,2,185110,185110,185112,0,2,0
52830,2,3,185112,185112,185115,0,3,0
52831,1,1,185113,185115,185116,2,3,0
52832,2,3,185115,185116,185119,1,4,0
52833,3,3,185118,185119,185122,1,4,0
52834,1,2,185119,185122,185124,3,5,0
52835,1,3,185120,185124,185127,4,7,0
52836,2,3,185122,185127,185130,5,8,0
52837,6,3,185128,185130,185133,2,5,0
52838,1,3,185129,185133,185136,4,7,0
52839,1,3,185130,185136,185139,6,9,0
52840,3,3,185133,185139,185142,6,9,0
52841,4,2,185137,185142,185144,5,7,0
52842,1,1,185138,185144,185145,6,7,0
52843,2,2,185140,185145,185147,5,7,0
52844,4,2,185144,185147,185149,3,5,0
52845,1,1,185145,185149,185150,4,5,0
52846,2,2,185147,185150,185152,3,5,0
52847,6,2,185153,185153,185155,0,2,1
52848,6,3,185159,185159,185162,0,3,4
52849,5,3,185164,185164,185167,0,3,2
52850,5,2,185169,185169,185171,0,2,2
52851,3,1,185172,185172,185173,0,1,1
52852,5,2,185177,185177,185179,0,2,4
52853,4,2,185181,185181,185183,0,2,2
52854,6,3,185187,185187,185190,0,3,4
52855,6,2,185193,185193,185195,0,2,3
52856,5,1,185198,185198,185199,0,1,3
52857,5,1,185203,185203,185204,0,1,4
52858,2,1,185205,185205,185206,0,1,1
52859,1,2,185206,185206,185208,0,2,0
52860,2,1,185208,185208,185209,0,1,0
52861,1,2,185209,185209,185211,0,2,0
52862,6,2,185215,185215,185217,0,2,4
52863,5,3,185220,185220,185223,0,3,3
52864,3,2,185223,185223,185225,0,2,0
52865,3,1,185226,185226,185227,0,1,1
52866,1,1,185227,185227,185228,0,1,0
52867,2,3,185229,185229,185232,0,3,1
52868,5,3,185234,185234,185237,0,3,2
52869,4,1,185238,185238,185239,0,1,1
52870,5,3,185243,185243,185246,0,3,4
52871,6,3,185249,185249,185252,0,3,3
52872,2,1,185251,185252,185253,1,2,0
52873,5,1,185256,185256,185257,0,1,3
52874,2,1,185258,185258,185259,0,1,1
52875,5,1,185263,185263,185264,0,1,4
52876,2,2,185265,185265,185267,0,2,1
52877,5,3,185270,185270,185273,0,3,3
52878,3,2,185273,185273,185275,0,2,0
52879,1,3,185274,185275,185278,1,4,0
52880,6,1,185280,185280,185281,0,1,2
52881,4,3,185284,185284,185287,0,3,3
52882,6,3,185290,185290,185293,0,3,3
52883,1,3,185291,185293,185296,2,5,0
52884,4,1,185295,185296,185297,1,2,0
52885,6,3,185301,185301,185304,0,3,4
52886,4,1,185305,185305,185306,0,1,1
52887,5,1,185310,185310,185311,0,1,4
52888,1,3,185311,185311,185314,0,3,0
52889,2,3,185313,185314,185317,1,4,0
52890,2,1,185315,185317,185318,2,3,0
52891,6,1,185321,185321,185322,0,1,3
52892,4,2,185325,185325,185327,0,2,3
52893,1,2,185326,185327,185329,1,3,0
52894,5,3,185331,185331,185334,0,3,2
52895,6,1,185337,185337,185338,0,1,3
52896,3,1,185340,185340,185341,0,1,2
52897,1,2,185341,185341,185343,0,2,0
52898,4,3,185345,185345,185348,0,3,2
52899,5,1,185350,185350,185351,0,1,2
52900,1,1,185351,185351,185352,0,1,0
52901,6,2,185357,185357,185359,0,2,5
52902,2,1,185359,185359,185360,0,1,0
52903,5,2,185364,185364,185366,0,2,4
52904,6,2,185370,185370,185372,0,2,4
52905,2,2,185372,185372,185374,0,2,0
52906,2,3,185374,185374,185377,0,3,0
52907,6,3,185380,185380,185383,0,3,3
52908,1,2,185381,185383,185385,2,4,0
52909,1,3,185382,185385,185388,3,6,0
52910,6,1,185388,185388,185389,0,1,0
52911,5,1,185393,185393,185394,0,1,4
52912,2,1,185395,185395,185396,0,1,1
52913,2,1,185397,185397,185398,0,1,1
52914,1,1,185398,185398,185399,0,1,0
52915,4,1,185402,185402,185403,0,1,3
52916,1,1,185403,185403,185404,0,1,0
52917,2,1,185405,185405,185406,0,1,1
52918,6,1,185411,185411,185412,0,1,5
52919,6,2,185417,185417,185419,0,2,5
52920,3,1,185420,185420,185421,0,1,1
52921,2,3,185422,185422,185425,0,3,1
52922,1,3,185423,185425,185428,2,5,0
52923,2,3,185425,185428,185431,3,6,0
52924,3,1,185428,185431,185432,3,4,0
52925,6,2,185434,185434,185436,0,2,2
52926,1,1,185435,185436,185437,1,2,0
52927,6,3,185441,185441,185444,0,3,4
52928,1,2,185442,185444,185446,2,4,0
52929,3,3,185445,185446,185449,1,4,0
52930,2,3,185447,185449,185452,2,5,0
52931,3,2,185450,185452,185454,2,4,0
52932,2,2,185452,185454,185456,2,4,0
52933,4,1,185456,185456,185457,0,1,0
52934,4,1,185460,185460,185461,0,1,3
52935,5,2,185465,185465,185467,0,2,4
52936,6,2,185471,185471,185473,0,2,4
52937,3,3,185474,185474,185477,0,3,1
52938,2,1,185476,185477,185478,1,2,0
52939,3,2,185479,185479,185481,0,2,1
52940,4,1,185483,185483,185484,0,1,2
52941,4,2,185487,185487,185489,0,2,3
52942,3,1,185490,185490,185491,0,1,1
52943,2,2,185492,185492,185494,0,2,1
52944,5,1,185497,185497,185498,0,1,3
52945,5,3,185502,185502,185505,0,3,4
52946,6,1,185508,185508,185509,0,1,3
52947,1,1,185509,185509,185510,0,1,0
52948,4,2,185513,185513,185515,0,2,3
52949,5,2,185518,185518,185520,0,2,3
52950,2,1,185520,185520,185521,0,1,0
52951,5,2,185525,185525,185527,0,2,4
52952,3,3,185528,185528,185531,0,3,1
52953,5,2,185533,185533,185535,0,2,2
52954,3,2,185536,185536,185538,0,2,1
52955,5,3,185541,185541,185544,0,3,3
52956,5,2,185546,185546,185548,0,2,2
52957,2,3,185548,185548,185551,0,3,0
52958,5,1,185553,185553,185554,0,1,2
52959,5,3,185558,185558,185561,0,3,4
52960,4,2,185562,185562,185564,0,2,1
52961,6,2,185568,185568,185570,0,2,4
52962,5,1,185573,185573,185574,0,1,3
52963,3,3,185576,185576,185579,0,3,2
52964,1,2,185577,185579,185581,2,4,0
52965,1,2,185578,185581,185583,3,5,0
52966,2,1,185580,185583,185584,3,4,0
52967,2,2,185582,185584,185586,2,4,0
52968,5,1,185587,185587,185588,0,1,1
52969,5,2,185592,185592,185594,0,2,4
52970,1,3,185593,185594,185597,1,4,0
52971,6,1,185599,185599,185600,0,1,2
52972,1,2,185600,185600,185602,0,2,0
52973,5,3,185605,185605,185608,0,3,3
52974,5,3,185610,185610,185613,0,3,2
52975,6,2,185616,185616,185618,0,2,3
52976,2,2,185618,185618,185620,0,2,0
52977,3,1,185621,185621,185622,0,1,1
52978,5,3,185626,185626,185629,0,3,4
52979,3,3,185629,185629,185632,0,3,0
52980,1,3,185630,185632,185635,2,5,0
52981,3,1,185633,185635,185636,2,3,0
52982,4,2,185637,185637,185639,0,2,1
52983,1,3,185638,185639,185642,1,4,0
52984,5,3,185643,185643,185646,0,3,1
52985,2,1,185645,185646,185647,1,2,0
52986,2,1,185647,185647,185648,0,1,0
52987,6,2,185653,185653,185655,0,2,5
52988,2,1,185655,185655,185656,0,1,0
52989,2,3,185657,185657,185660,0,3,1
52990,6,3,185663,185663,185666,0,3,3
52991,6,3,185669,185669,185672,0,3,3
52992,4,2,185673,185673,185675,0,2,1
52993,6,3,185679,185679,185682,0,3,4
52994,1,2,185680,185682,185684,2,4,0
52995,6,2,185686,185686,185688,0,2,2
52996,2,1,185688,185688,185689,0,1,0
52997,1,2,185689,185689,185691,0,2,0
52998,1,1,185690,185691,185692,1,2,0
52999,1,2,185691,185692,185694,1,3,0
53000,1,2,185692,185694,185696,2,4,0
53001,5,1,185697,185697,185698,0,1,1
53002,2,1,185699,185699,185700,0,1,1
53003,5,1,185704,185704,185705,0,1,4
53004,4,1,185708,185708,185709,0,1,3
53005,5,1,185713,185713,185714,0,1,4
53006,2,2,185715,185715,185717,0,2,1
53007,2,2,185717,185717,185719,0,2,0
53008,6,2,185723,185723,185725,0,2,4
53009,4,2,185727,185727,185729,0,2,2
53010,1,2,185728,185729,185731,1,3,0
53011,5,2,185733,185733,185735,0,2,2
53012,5,3,185738,185738,185741,0,3,3
53013,3,2,185741,185741,185743,0,2,0
53014,1,3,185742,185743,185746,1,4,0
53015,3,1,185745,185746,185747,1,2,0
53016,1,3,185746,185747,185750,1,4,0
53017,5,2,185751,185751,185753,0,2,1
53018,4,3,185755,185755,185758,0,3,2
53019,4,2,185759,185759,185761,0,2,1
53020,3,1,185762,185762,185763,0,1,1
53021,3,3,185765,185765,185768,0,3,2
53022,5,1,185770,185770,185771,0,1,2
53023,5,3,185775,185775,185778,0,3,4
53024,4,2,185779,185779,185781,0,2,1
53025,2,1,185781,185781,185782,0,1,0
53026,1,3,185782,185782,185785,0,3,0
53027,4,2,185786,185786,185788,0,2,1
53028,5,1,185791,185791,185792,0,1,3
53029,1,3,185792,185792,185795,0,3,0
53030,4,2,185796,185796,185798,0,2,1
53031,6,3,185802,185802,185805,0,3,4
53032,6,1,185808,185808,185809,0,1,3
53033,4,3,185812,185812,185815,0,3,3
53034,2,2,185814,185815,185817,1,3,0
53035,2,1,185816,185817,185818,1,2,0
53036,3,1,185819,185819,185820,0,1,1
53037,2,3,185821,185821,185824,0,3,1
53038,1,1,185822,185824,185825,2,3,0
53039,1,2,185823,185825,185827,2,4,0
53040,2,2,185825,185827,185829,2,4,0
53041,3,2,185828,185829,185831,1,3,0
53042,2,1,185830,185831,185832,1,2,0
53043,2,2,185832,185832,185834,0,2,0
53044,4,1,185836,185836,185837,0,1,2
53045,3,3,185839,185839,185842,0,3,2
53046,1,3,185840,185842,185845,2,5,0
53047,4,3,185844,185845,185848,1,4,0
53048,3,1,185847,185848,185849,1,2,0
53049,1,2,185848,185849,185851,1,3,0
53050,4,1,185852,185852,185853,0,1,1
53051,1,2,185853,185853,185855,0,2,0
53052,4,3,185857,185857,185860,0,3,2
53053,6,3,185863,185863,185866,0,3,3
53054,2,3,185865,185866,185869,1,4,0
53055,2,3,185867,185869,185872,2,5,0
53056,3,3,185870,185872,185875,2,5,0
53057,5,2,185875,185875,185877,0,2,0
53058,1,3,185876,185877,185880,1,4,0
53059,2,1,185878,185880,185881,2,3,0
53060,5,2,185883,185883,185885,0,2,2
53061,4,2,185887,185887,185889,0,2,2
53062,1,3,185888,185889,185892,1,4,0
53063,1,2,185889,185892,185894,3,5,0
53064,2,1,185891,185894,185895,3,4,0
53065,6,1,185897,185897,185898,0,1,2
53066,1,1,185898,185898,185899,0,1,0
53067,2,2,185900,185900,185902,0,2,1
53068,6,2,185906,185906,185908,0,2,4
53069,6,1,185912,185912,185913,0,1,4
53070,6,2,185918,185918,185920,0,2,5
53071,3,2,185921,185921,185923,0,2,1
53072,5,3,185926,185926,185929,0,3,3
53073,2,1,185928,185929,185930,1,2,0
53074,2,1,185930,185930,185931,0,1,0
53075,6,3,185936,185936,185939,0,3,5
53076,6,3,185942,185942,185945,0,3,3
53077,4,2,185946,185946,185948,0,2,1
53078,3,1,185949,185949,185950,0,1,1
53079,1,1,185950,185950,185951,0,1,0
53080,1,1,185951,185951,185952,0,1,0
53081,1,1,185952,185952,185953,0,1,0
53082,6,3,185958,185958,185961,0,3,5
53083,3,1,185961,185961,185962,0,1,0
53084,1,3,185962,185962,185965,0,3,0
53085,1,3,185963,185965,185968,2,5,0
53086,2,2,185965,185968,185970,3,5,0
53087,2,2,185967,185970,185972,3,5,0
53088,2,3,185969,185972,185975,3,6,0
53089,4,3,185973,185975,185978,2,5,0
53090,6,3,185979,185979,185982,0,3,1
53091,6,1,185985,185985,185986,0,1,3
53092,1,3,185986,185986,185989,0,3,0
53093,1,3,185987,185989,185992,2,5,0
53094,1,2,185988,185992,185994,4,6,0
53095,6,1,185994,185994,185995,0,1,0
53096,6,2,186000,186000,186002,0,2,5
53097,1,3,186001,186002,186005,1,4,0
53098,5,2,186006,186006,186008,0,2,1
53099,4,3,186010,186010,186013,0,3,2
53100,2,2,186012,186013,186015,1,3,0
53101,5,2,186017,186017,186019,0,2,2
53102,3,1,186020,186020,186021,0,1,1
53103,5,3,186025,186025,186028,0,3,4
53104,4,2,186029,186029,186031,0,2,1
53105,5,1,186034,186034,186035,0,1,3
53106,4,2,186038,186038,186040,0,2,3
53107,5,1,186043,186043,186044,0,1,3
53108,2,1,186045,186045,186046,0,1,1
53109,4,2,186049,186049,186051,0,2,3
53110,4,1,186053,186053,186054,0,1,2
53111,3,1,186056,186056,186057,0,1,2
53112,2,3,186058,186058,186061,0,3,1
53113,5,2,186063,186063,186065,0,2,2
53114,5,2,186068,186068,186070,0,2,3
53115,6,1,186074,186074,186075,0,1,4
53116,2,3,186076,186076,186079,0,3,1
53117,3,1,186079,186079,186080,0,1,0
53118,1,1,186080,186080,186081,0,1,0
53119,4,1,186084,186084,186085,0,1,3
53120,6,1,186090,186090,186091,0,1,5
53121,5,2,186095,186095,186097,0,2,4
53122,1,2,186096,186097,186099,1,3,0
53123,4,3,186100,186100,186103,0,3,1
53124,2,3,186102,186103,186106,1,4,0
53125,5,3,186107,186107,186110,0,3,1
53126,5,3,186112,186112,186115,0,3,2
53127,5,1,186117,186117,186118,0,1,2
53128,4,3,186121,186121,186124,0,3,3
53129,2,1,186123,186124,186125,1,2,0
53130,6,3,186129,186129,186132,0,3,4
53131,3,3,186132,186132,186135,0,3,0
53132,5,1,186137,186137,186138,0,1,2
53133,3,1,186140,186140,186141,0,1,2
53134,2,1,186142,186142,186143,0,1,1
53135,3,2,186145,186145,186147,0,2,2
53136,2,2,186147,186147,186149,0,2,0
53137,4,2,186151,186151,186153,0,2,2
53138,6,3,186157,186157,186160,0,3,4
53139,1,1,186158,186160,186161,2,3,0
53140,5,3,186163,186163,186166,0,3,2
53141,5,2,186168,186168,186170,0,2,2
53142,3,2,186171,186171,186173,0,2,1
53143,2,1,186173,186173,186174,0,1,0
53144,4,2,186177,186177,186179,0,2,3
53145,1,3,186178,186179,186182,1,4,0
53146,1,1,186179,186182,186183,3,4,0
53147,6,2,186185,186185,186187,0,2,2
53148,1,3,186186,186187,186190,1,4,0
53149,5,2,186191,186191,186193,0,2,1
53150,1,2,186192,186193,186195,1,3,0
53151,2,3,186194,186195,186198,1,4,0
53152,6,1,186200,186200,186201,0,1,2
53153,5,2,186205,186205,186207,0,2,4
53154,2,1,186207,186207,186208,0,1,0
53155,2,3,186209,186209,186212,0,3,1
53156,5,2,186214,186214,186216,0,2,2
53157,1,1,186215,186216,186217,1,2,0
53158,2,1,186217,186217,186218,0,1,0
53159,1,2,186218,186218,186220,0,2,0
53160,2,3,186220,186220,186223,0,3,0
53161,1,3,186221,186223,186226,2,5,0
53162,5,3,186226,186226,186229,0,3,0
53163,5,3,186231,186231,186234,0,3,2
53164,3,2,186234,186234,186236,0,2,0
53165,5,2,186239,186239,186241,0,2,3
53166,1,1,186240,186241,186242,1,2,0
53167,1,2,186241,186242,186244,1,3,0
53168,5,1,186246,186246,186247,0,1,2
53169,6,1,186252,186252,186253,0,1,5
53170,5,2,186257,186257,186259,0,2,4
53171,1,2,186258,186259,186261,1,3,0
53172,2,2,186260,186261,186263,1,3,0
53173,1,2,186261,186263,186265,2,4,0
53174,3,2,186264,186265,186267,1,3,0
53175,4,3,186268,186268,186271,0,3,1
53176,1,1,186269,186271,186272,2,3,0
53177,2,1,186271,186272,186273,1,2,0
53178,2,3,186273,186273,186276,0,3,0
53179,2,1,186275,186276,186277,1,2,0
53180,5,1,186280,186280,186281,0,1,3
53181,1,3,186281,186281,186284,0,3,0
53182,2,2,186283,186284,186286,1,3,0
53183,3,1,186286,186286,186287,0,1,0
53184,1,2,186287,186287,186289,0,2,0
53185,6,3,186293,186293,186296,0,3,4
53186,1,1,186294,186296,186297,2,3,0
53187,3,2,186297,186297,186299,0,2,0
53188,6,3,186303,186303,186306,0,3,4
53189,2,3,186305,186306,186309,1,4,0
53190,5,2,186310,186310,186312,0,2,1
53191,6,3,186316,186316,186319,0,3,4
53192,4,2,186320,186320,186322,0,2,1
53193,1,1,186321,186322,186323,1,2,0
53194,1,3,186322,186323,186326,1,4,0
53195,6,1,186328,186328,186329,0,1,2
53196,5,3,186333,186333,186336,0,3,4
53197,6,3,186339,186339,186342,0,3,3
53198,3,1,186342,186342,186343,0,1,0
53199,2,1,186344,186344,186345,0,1,1
53200,6,3,186350,186350,186353,0,3,5
53201,4,1,186354,186354,186355,0,1,1
53202,1,3,186355,186355,186358,0,3,0
53203,6,1,186361,186361,186362,0,1,3
53204,2,1,186363,186363,186364,0,1,1
53205,6,2,186369,186369,186371,0,2,5
53206,6,3,186375,186375,186378,0,3,4
53207,3,1,186378,186378,186379,0,1,0
53208,5,1,186383,186383,186384,0,1,4
53209,1,1,186384,186384,186385,0,1,0
53210,1,1,186385,186385,186386,0,1,0
53211,5,3,186390,186390,186393,0,3,4
53212,2,2,186392,186393,186395,1,3,0
53213,2,2,186394,186395,186397,1,3,0
53214,1,1,186395,186397,186398,2,3,0
53215,3,1,186398,186398,186399,0,1,0
53216,2,3,186400,186400,186403,0,3,1
53217,3,3,186403,186403,186406,0,3,0
53218,2,2,186405,186406,186408,1,3,0
53219,2,3,186407,186408,186411,1,4,0
53220,4,3,186411,186411,186414,0,3,0
53221,1,1,186412,186414,186415,2,3,0
53222,4,3,186416,186416,186419,0,3,1
53223,4,3,186420,186420,186423,0,3,1
53224,1,1,186421,186423,186424,2,3,0
53225,1,1,186422,186424,186425,2,3,0
53226,4,2,186426,186426,186428,0,2,1
53227,3,3,186429,186429,186432,0,3,1
53228,6,1,186435,186435,186436,0,1,3
53229,3,1,186438,186438,186439,0,1,2
53230,4,3,186442,186442,186445,0,3,3
53231,4,1,186446,186446,186447,0,1,1
53232,5,2,186451,186451,186453,0,2,4
53233,6,1,186457,186457,186458,0,1,4
53234,6,2,186463,186463,186465,0,2,5
53235,3,2,186466,186466,186468,0,2,1
53236,3,3,186469,186469,186472,0,3,1
53237,3,3,186472,186472,186475,0,3,0
53238,2,2,186474,186475,186477,1,3,0
53239,5,2,186479,186479,186481,0,2,2
53240,3,1,186482,186482,186483,0,1,1
53241,2,1,186484,186484,186485,0,1,1
53242,3,1,186487,186487,186488,0,1,2
53243,1,2,186488,186488,186490,0,2,0
53244,2,1,186490,186490,186491,0,1,0
53245,2,1,186492,186492,186493,0,1,1
53246,6,3,186498,186498,186501,0,3,5
53247,6,1,186504,186504,186505,0,1,3
53248,3,1,186507,186507,186508,0,1,2
53249,5,2,186512,186512,186514,0,2,4
53250,2,2,186514,186514,186516,0,2,0
53251,4,2,186518,186518,186520,0,2,2
53252,1,3,186519,186520,186523,1,4,0
53253,1,2,186520,186523,186525,3,5,0
53254,3,3,186523,186525,186528,2,5,0
53255,1,1,186524,186528,186529,4,5,0
53256,2,3,186526,186529,186532,3,6,0
53257,4,2,186530,186532,186534,2,4,0
53258,2,3,186532,186534,186537,2,5,0
53259,4,1,186536,186537,186538,1,2,0
53260,5,1,186541,186541,186542,0,1,3
53261,4,2,186545,186545,186547,0,2,3
53262,1,1,186546,186547,186548,1,2,0
53263,6,2,186552,186552,186554,0,2,4
53264,4,3,186556,186556,186559,0,3,2
53265,1,2,186557,186559,186561,2,4,0
53266,6,2,186563,186563,186565,0,2,2
53267,4,1,186567,186567,186568,0,1,2
53268,6,1,186573,186573,186574,0,1,5
53269,2,1,186575,186575,186576,0,1,1
53270,1,2,186576,186576,186578,0,2,0
53271,2,1,186578,186578,186579,0,1,0
53272,5,1,186583,186583,186584,0,1,4
53273,3,1,186586,186586,186587,0,1,2
53274,1,1,186587,186587,186588,0,1,0
53275,5,1,186592,186592,186593,0,1,4
53276,4,2,186596,186596,186598,0,2,3
53277,6,1,186602,186602,186603,0,1,4
53278,4,1,186606,186606,186607,0,1,3
53279,1,1,186607,186607,186608,0,1,0
53280,4,1,186611,186611,186612,0,1,3
53281,6,3,186617,186617,186620,0,3,5
53282,3,3,186620,186620,186623,0,3,0
53283,2,1,186622,186623,186624,1,2,0
53284,3,1,186625,186625,186626,0,1,1
53285,1,2,186626,186626,186628,0,2,0
53286,2,3,186628,186628,186631,0,3,0
53287,3,3,186631,186631,186634,0,3,0
53288,4,2,186635,186635,186637,0,2,1
53289,3,1,186638,186638,186639,0,1,1
53290,4,3,186642,186642,186645,0,3,3
53291,3,2,186645,186645,186647,0,2,0
53292,1,1,186646,186647,186648,1,2,0
53293,5,3,186651,186651,186654,0,3,3
53294,3,2,186654,186654,186656,0,2,0
53295,2,2,186656,186656,186658,0,2,0
53296,4,1,186660,186660,186661,0,1,2
53297,6,3,186666,186666,186669,0,3,5
53298,2,1,186668,186669,186670,1,2,0
53299,1,2,186669,186670,186672,1,3,0
53300,5,1,186674,186674,186675,0,1,2
53301,4,3,186678,186678,186681,0,3,3
53302,5,3,186683,186683,186686,0,3,2
53303,6,2,186689,186689,186691,0,2,3
53304,3,1,186692,186692,186693,0,1,1
53305,4,1,186696,186696,186697,0,1,3
53306,5,2,186701,186701,186703,0,2,4
53307,5,3,186706,186706,186709,0,3,3
53308,4,2,186710,186710,186712,0,2,1
53309,3,2,186713,186713,186715,0,2,1
53310,3,2,186716,186716,186718,0,2,1
53311,3,1,186719,186719,186720,0,1,1
53312,2,2,186721,186721,186723,0,2,1
53313,6,3,186727,186727,186730,0,3,4
53314,6,3,186733,186733,186736,0,3,3
53315,5,3,186738,186738,186741,0,3,2
53316,2,3,186740,186741,186744,1,4,0
53317,2,1,186742,186744,186745,2,3,0
53318,1,2,186743,186745,186747,2,4,0
53319,4,2,186747,186747,186749,0,2,0
53320,6,3,186753,186753,186756,0,3,4
53321,1,1,186754,186756,186757,2,3,0
53322,6,3,186760,186760,186763,0,3,3
53323,5,1,186765,186765,186766,0,1,2
53324,4,2,186769,186769,186771,0,2,3
53325,6,2,186775,186775,186777,0,2,4
53326,3,1,186778,186778,186779,0,1,1
53327,5,3,186783,186783,186786,0,3,4
53328,4,3,186787,186787,186790,0,3,1
53329,3,2,186790,186790,186792,0,2,0
53330,1,3,186791,186792,186795,1,4,0
53331,1,2,186792,186795,186797,3,5,0
53332,3,3,186795,186797,186800,2,5,0
53333,3,1,186798,186800,186801,2,3,0
53334,5,1,186803,186803,186804,0,1,2
53335,4,2,186807,186807,186809,0,2,3
53336,6,3,186813,186813,186816,0,3,4
53337,2,2,186815,186816,186818,1,3,0
53338,4,2,186819,186819,186821,0,2,1
53339,6,2,186825,186825,186827,0,2,4
53340,4,1,186829,186829,186830,0,1,2
53341,6,2,186835,186835,186837,0,2,5
53342,1,1,186836,186837,186838,1,2,0
53343,5,1,186841,186841,186842,0,1,3
53344,5,2,186846,186846,186848,0,2,4
53345,5,3,186851,186851,186854,0,3,3
53346,1,2,186852,186854,186856,2,4,0
53347,4,2,186856,186856,186858,0,2,0
53348,5,1,186861,186861,186862,0,1,3
53349,3,1,186864,186864,186865,0,1,2
53350,6,3,186870,186870,186873,0,3,5
53351,3,3,186873,186873,186876,0,3,0
53352,1,3,186874,186876,186879,2,5,0
53353,6,2,186880,186880,186882,0,2,1
53354,3,2,186883,186883,186885,0,2,1
53355,2,2,186885,186885,186887,0,2,0
53356,5,1,186890,186890,186891,0,1,3
53357,1,3,186891,186891,186894,0,3,0
53358,3,3,186894,186894,186897,0,3,0
53359,3,1,186897,186897,186898,0,1,0
53360,5,2,186902,186902,186904,0,2,4
53361,6,3,186908,186908,186911,0,3,4
53362,4,3,186912,186912,186915,0,3,1
53363,1,2,186913,186915,186917,2,4,0
53364,2,3,186915,186917,186920,2,5,0
53365,2,1,186917,186920,186921,3,4,0
53366,5,3,186922,186922,186925,0,3,1
53367,4,1,186926,186926,186927,0,1,1
53368,1,3,186927,186927,186930,0,3,0
53369,3,2,186930,186930,186932,0,2,0
53370,6,2,186936,186936,186938,0,2,4
53371,4,3,186940,186940,186943,0,3,2
53372,5,1,186945,186945,186946,0,1,2
53373,2,2,186947,186947,186949,0,2,1
53374,2,3,186949,186949,186952,0,3,0
53375,4,1,186953,186953,186954,0,1,1
53376,1,1,186954,186954,186955,0,1,0
53377,3,1,186957,186957,186958,0,1,2
53378,3,2,186960,186960,186962,0,2,2
53379,2,1,186962,186962,186963,0,1,0
53380,5,2,186967,186967,186969,0,2,4
53381,5,3,186972,186972,186975,0,3,3
53382,1,1,186973,186975,186976,2,3,0
53383,1,2,186974,186976,186978,2,4,0
53384,3,2,186977,186978,186980,1,3,0
53385,5,3,186982,186982,186985,0,3,2
53386,3,3,186985,186985,186988,0,3,0
53387,3,1,186988,186988,186989,0,1,0
53388,3,3,186991,186991,186994,0,3,2
53389,4,3,186995,186995,186998,0,3,1
53390,5,2,187000,187000,187002,0,2,2
53391,6,3,187006,187006,187009,0,3,4
53392,6,1,187012,187012,187013,0,1,3
53393,1,2,187013,187013,187015,0,2,0
53394,4,2,187017,187017,187019,0,2,2
53395,4,3,187021,187021,187024,0,3,2
53396,5,2,187026,187026,187028,0,2,2
53397,3,3,187029,187029,187032,0,3,1
53398,3,2,187032,187032,187034,0,2,0
53399,5,2,187037,187037,187039,0,2,3
53400,2,2,187039,187039,187041,0,2,0
53401,5,3,187044,187044,187047,0,3,3
53402,3,3,187047,187047,187050,0,3,0
53403,2,3,187049,187050,187053,1,4,0
53404,1,2,187050,187053,187055,3,5,0
53405,6,1,187056,187056,187057,0,1,1
53406,3,2,187059,187059,187061,0,2,2
53407,3,2,187062,187062,187064,0,2,1
53408,3,1,187065,187065,187066,0,1,1
53409,3,2,187068,187068,187070,0,2,2
53410,3,1,187071,187071,187072,0,1,1
53411,2,2,187073,187073,187075,0,2,1
53412,1,3,187074,187075,187078,1,4,0
53413,2,2,187076,187078,187080,2,4,0
53414,3,3,187079,187080,187083,1,4,0
53415,2,3,187081,187083,187086,2,5,0
53416,6,3,187087,187087,187090,0,3,1
53417,5,2,187092,187092,187094,0,2,2
53418,2,3,187094,187094,187097,0,3,0
53419,4,2,187098,187098,187100,0,2,1
53420,3,3,187101,187101,187104,0,3,1
53421,1,2,187102,187104,187106,2,4,0
53422,6,2,187108,187108,187110,0,2,2
53423,3,1,187111,187111,187112,0,1,1
53424,5,1,187116,187116,187117,0,1,4
53425,1,2,187117,187117,187119,0,2,0
53426,1,3,187118,187119,187122,1,4,0
53427,5,3,187123,187123,187126,0,3,1
53428,4,2,187127,187127,187129,0,2,1
53429,3,2,187130,187130,187132,0,2,1
53430,1,3,187131,187132,187135,1,4,0
53431,2,3,187133,187135,187138,2,5,0
53432,5,2,187138,187138,187140,0,2,0
53433,1,2,187139,187140,187142,1,3,0
53434,5,2,187144,187144,187146,0,2,2
53435,2,1,187146,187146,187147,0,1,0
53436,6,3,187152,187152,187155,0,3,5
53437,5,1,187157,187157,187158,0,1,2
53438,2,3,187159,187159,187162,0,3,1
53439,1,2,187160,187162,187164,2,4,0
53440,4,1,187164,187164,187165,0,1,0
53441,4,3,187168,187168,187171,0,3,3
53442,6,1,187174,187174,187175,0,1,3
53443,6,2,187180,187180,187182,0,2,5
53444,6,3,187186,187186,187189,0,3,4
53445,5,1,187191,187191,187192,0,1,2
53446,2,3,187193,187193,187196,0,3,1
53447,2,3,187195,187196,187199,1,4,0
53448,2,2,187197,187199,187201,2,4,0
53449,3,3,187200,187201,187204,1,4,0
53450,5,3,187205,187205,187208,0,3,1
53451,6,3,187211,187211,187214,0,3,3
53452,6,2,187217,187217,187219,0,2,3
53453,3,1,187220,187220,187221,0,1,1
53454,3,1,187223,187223,187224,0,1,2
53455,6,1,187229,187229,187230,0,1,5
53456,6,1,187235,187235,187236,0,1,5
53457,4,3,187239,187239,187242,0,3,3
53458,4,3,187243,187243,187246,0,3,1
53459,1,3,187244,187246,187249,2,5,0
53460,1,1,187245,187249,187250,4,5,0
53461,6,1,187251,187251,187252,0,1,1
53462,6,3,187257,187257,187260,0,3,5
53463,3,1,187260,187260,187261,0,1,0
53464,4,3,187264,187264,187267,0,3,3
53465,3,3,187267,187267,187270,0,3,0
53466,6,2,187273,187273,187275,0,2,3
53467,2,2,187275,187275,187277,0,2,0
53468,5,2,187280,187280,187282,0,2,3
53469,6,3,187286,187286,187289,0,3,4
53470,1,3,187287,187289,187292,2,5,0
53471,4,1,187291,187292,187293,1,2,0
53472,5,1,187296,187296,187297,0,1,3
53473,3,2,187299,187299,187301,0,2,2
53474,4,2,187303,187303,187305,0,2,2
53475,5,1,187308,187308,187309,0,1,3
53476,6,3,187314,187314,187317,0,3,5
53477,2,3,187316,187317,187320,1,4,0
53478,1,1,187317,187320,187321,3,4,0
53479,1,1,187318,187321,187322,3,4,0
53480,5,1,187323,187323,187324,0,1,1
53481,6,2,187329,187329,187331,0,2,5
53482,5,3,187334,187334,187337,0,3,3
53483,5,3,187339,187339,187342,0,3,2
53484,3,3,187342,187342,187345,0,3,0
53485,5,1,187347,187347,187348,0,1,2
53486,2,1,187349,187349,187350,0,1,1
53487,5,2,187354,187354,187356,0,2,4
53488,2,3,187356,187356,187359,0,3,0
53489,5,2,187361,187361,187363,0,2,2
53490,3,2,187364,187364,187366,0,2,1
53491,3,1,187367,187367,187368,0,1,1
53492,1,2,187368,187368,187370,0,2,0
53493,5,1,187373,187373,187374,0,1,3
53494,6,1,187379,187379,187380,0,1,5
53495,1,1,187380,187380,187381,0,1,0
53496,6,1,187386,187386,187387,0,1,5
53497,3,2,187389,187389,187391,0,2,2
53498,4,1,187393,187393,187394,0,1,2
53499,1,3,187394,187394,187397,0,3,0
53500,1,3,187395,187397,187400,2,5,0
53501,2,2,187397,187400,187402,3,5,0
53502,4,1,187401,187402,187403,1,2,0
53503,6,1,187407,187407,187408,0,1,4
53504,4,1,187411,187411,187412,0,1,3
53505,5,3,187416,187416,187419,0,3,4
53506,3,2,187419,187419,187421,0,2,0
53507,1,3,187420,187421,187424,1,4,0
53508,4,2,187424,187424,187426,0,2,0
53509,5,2,187429,187429,187431,0,2,3
53510,5,3,187434,187434,187437,0,3,3
53511,5,2,187439,187439,187441,0,2,2
53512,4,3,187443,187443,187446,0,3,2
53513,6,2,187449,187449,187451,0,2,3
53514,6,3,187455,187455,187458,0,3,4
53515,1,2,187456,187458,187460,2,4,0
53516,1,1,187457,187460,187461,3,4,0
53517,6,3,187463,187463,187466,0,3,2
53518,3,1,187466,187466,187467,0,1,0
53519,6,1,187472,187472,187473,0,1,5
53520,4,3,187476,187476,187479,0,3,3
53521,6,1,187482,187482,187483,0,1,3
53522,4,2,187486,187486,187488,0,2,3
53523,5,1,187491,187491,187492,0,1,3
53524,1,1,187492,187492,187493,0,1,0
53525,4,2,187496,187496,187498,0,2,3
53526,1,3,187497,187498,187501,1,4,0
53527,5,1,187502,187502,187503,0,1,1
53528,1,2,187503,187503,187505,0,2,0
53529,6,3,187509,187509,187512,0,3,4
53530,2,2,187511,187512,187514,1,3,0
53531,6,1,187517,187517,187518,0,1,3
53532,6,1,187523,187523,187524,0,1,5
53533,6,3,187529,187529,187532,0,3,5
53534,2,2,187531,187532,187534,1,3,0
53535,4,3,187535,187535,187538,0,3,1
53536,3,1,187538,187538,187539,0,1,0
53537,5,1,187543,187543,187544,0,1,4
53538,2,3,187545,187545,187548,0,3,1
53539,1,1,187546,187548,187549,2,3,0
53540,5,2,187551,187551,187553,0,2,2
53541,4,2,187555,187555,187557,0,2,2
53542,3,1,187558,187558,187559,0,1,1
53543,3,1,187561,187561,187562,0,1,2
53544,5,1,187566,187566,187567,0,1,4
53545,1,2,187567,187567,187569,0,2,0
53546,1,1,187568,187569,187570,1,2,0
53547,2,2,187570,187570,187572,0,2,0
53548,5,3,187575,187575,187578,0,3,3
53549,4,2,187579,187579,187581,0,2,1
53550,5,2,187584,187584,187586,0,2,3
53551,1,2,187585,187586,187588,1,3,0
53552,5,2,187590,187590,187592,0,2,2
53553,5,1,187595,187595,187596,0,1,3
53554,5,1,187600,187600,187601,0,1,4
53555,5,1,187605,187605,187606,0,1,4
53556,6,1,187611,187611,187612,0,1,5
53557,5,2,187616,187616,187618,0,2,4
53558,2,2,187618,187618,187620,0,2,0
53559,6,2,187624,187624,187626,0,2,4
53560,1,1,187625,187626,187627,1,2,0
53561,1,1,187626,187627,187628,1,2,0
53562,6,3,187632,187632,187635,0,3,4
53563,1,2,187633,187635,187637,2,4,0
53564,2,1,187635,187637,187638,2,3,0
53565,5,2,187640,187640,187642,0,2,2
53566,3,1,187643,187643,187644,0,1,1
53567,3,3,187646,187646,187649,0,3,2
53568,6,1,187652,187652,187653,0,1,3
53569,3,2,187655,187655,187657,0,2,2
53570,1,3,187656,187657,187660,1,4,0
53571,4,2,187660,187660,187662,0,2,0
53572,6,3,187666,187666,187669,0,3,4
53573,3,3,187669,187669,187672,0,3,0
53574,3,2,187672,187672,187674,0,2,0
53575,1,2,187673,187674,187676,1,3,0
53576,5,2,187678,187678,187680,0,2,2
53577,6,1,187684,187684,187685,0,1,4
53578,2,3,187686,187686,187689,0,3,1
53579,4,3,187690,187690,187693,0,3,1
53580,4,3,187694,187694,187697,0,3,1
53581,2,1,187696,187697,187698,1,2,0
53582,2,2,187698,187698,187700,0,2,0
53583,5,2,187703,187703,187705,0,2,3
53584,5,2,187708,187708,187710,0,2,3
53585,1,2,187709,187710,187712,1,3,0
53586,1,2,187710,187712,187714,2,4,0
53587,4,3,187714,187714,187717,0,3,0
53588,5,1,187719,187719,187720,0,1,2
53589,4,2,187723,187723,187725,0,2,3
53590,6,2,187729,187729,187731,0,2,4
53591,1,2,187730,187731,187733,1,3,0
53592,2,2,187732,187733,187735,1,3,0
53593,6,2,187738,187738,187740,0,2,3
53594,4,3,187742,187742,187745,0,3,2
53595,3,1,187745,187745,187746,0,1,0
53596,4,3,187749,187749,187752,0,3,3
53597,3,3,187752,187752,187755,0,3,0
53598,2,2,187754,187755,187757,1,3,0
53599,6,3,187760,187760,187763,0,3,3
53600,5,2,187765,187765,187767,0,2,2
53601,5,2,187770,187770,187772,0,2,3
53602,1,1,187771,187772,187773,1,2,0
53603,6,1,187777,187777,187778,0,1,4
53604,6,2,187783,187783,187785,0,2,5
53605,5,3,187788,187788,187791,0,3,3
53606,3,3,187791,187791,187794,0,3,0
53607,4,3,187795,187795,187798,0,3,1
53608,6,2,187801,187801,187803,0,2,3
53609,6,3,187807,187807,187810,0,3,4
53610,4,1,187811,187811,187812,0,1,1
53611,3,3,187814,187814,187817,0,3,2
53612,3,3,187817,187817,187820,0,3,0
53613,3,2,187820,187820,187822,0,2,0
53614,6,2,187826,187826,187828,0,2,4
53615,5,2,187831,187831,187833,0,2,3
53616,4,3,187835,187835,187838,0,3,2
53617,2,1,187837,187838,187839,1,2,0
53618,4,3,187841,187841,187844,0,3,2
53619,1,1,187842,187844,187845,2,3,0
53620,6,3,187848,187848,187851,0,3,3
53621,3,2,187851,187851,187853,0,2,0
53622,1,2,187852,187853,187855,1,3,0
53623,4,1,187856,187856,187857,0,1,1
53624,5,2,187861,187861,187863,0,2,4
53625,6,1,187867,187867,187868,0,1,4
53626,5,2,187872,187872,187874,0,2,4
53627,4,2,187876,187876,187878,0,2,2
53628,1,1,187877,187878,187879,1,2,0
53629,3,3,187880,187880,187883,0,3,1
53630,3,3,187883,187883,187886,0,3,0
53631,2,1,187885,187886,187887,1,2,0
53632,4,3,187889,187889,187892,0,3,2
53633,4,3,187893,187893,187896,0,3,1
53634,4,2,187897,187897,187899,0,2,1
53635,4,3,187901,187901,187904,0,3,2
53636,3,3,187904,187904,187907,0,3,0
53637,1,3,187905,187907,187910,2,5,0
53638,4,3,187909,187910,187913,1,4,0
53639,6,1,187915,187915,187916,0,1,2
53640,6,3,187921,187921,187924,0,3,5
53641,5,2,187926,187926,187928,0,2,2
53642,6,2,187932,187932,187934,0,2,4
53643,3,3,187935,187935,187938,0,3,1
53644,6,1,187941,187941,187942,0,1,3
53645,1,3,187942,187942,187945,0,3,0
53646,2,3,187944,187945,187948,1,4,0
53647,5,2,187949,187949,187951,0,2,1
53648,1,3,187950,187951,187954,1,4,0
53649,6,3,187956,187956,187959,0,3,2
53650,3,2,187959,187959,187961,0,2,0
53651,3,3,187962,187962,187965,0,3,1
53652,2,2,187964,187965,187967,1,3,0
53653,3,3,187967,187967,187970,0,3,0
53654,2,2,187969,187970,187972,1,3,0
53655,2,1,187971,187972,187973,1,2,0
53656,4,3,187975,187975,187978,0,3,2
53657,1,2,187976,187978,187980,2,4,0
53658,2,3,187978,187980,187983,2,5,0
53659,3,3,187981,187983,187986,2,5,0
53660,2,1,187983,187986,187987,3,4,0
53661,5,2,187988,187988,187990,0,2,1
53662,4,3,187992,187992,187995,0,3,2
53663,1,1,187993,187995,187996,2,3,0
53664,5,2,187998,187998,188000,0,2,2
53665,6,3,188004,188004,188007,0,3,4
53666,4,2,188008,188008,188010,0,2,1
53667,3,3,188011,188011,188014,0,3,1
53668,2,1,188013,188014,188015,1,2,0
53669,6,2,188019,188019,188021,0,2,4
53670,3,1,188022,188022,188023,0,1,1
53671,2,2,188024,188024,188026,0,2,1
53672,3,1,188027,188027,188028,0,1,1
53673,6,1,188033,188033,188034,0,1,5
53674,6,2,188039,188039,188041,0,2,5
53675,2,2,188041,188041,188043,0,2,0
53676,4,3,188045,188045,188048,0,3,2
53677,6,3,188051,188051,188054,0,3,3
53678,5,2,188056,188056,188058,0,2,2
53679,5,2,188061,188061,188063,0,2,3
53680,4,3,188065,188065,188068,0,3,2
53681,1,3,188066,188068,188071,2,5,0
53682,4,2,188070,188071,188073,1,3,0
53683,3,2,188073,188073,188075,0,2,0
53684,4,2,188077,188077,188079,0,2,2
53685,6,3,188083,188083,188086,0,3,4
53686,6,2,188089,188089,188091,0,2,3
53687,6,1,188095,188095,188096,0,1,4
53688,6,2,188101,188101,188103,0,2,5
53689,3,2,188104,188104,188106,0,2,1
53690,2,3,188106,188106,188109,0,3,0
53691,2,2,188108,188109,188111,1,3,0
53692,5,3,188113,188113,188116,0,3,2
53693,1,3,188114,188116,188119,2,5,0
53694,3,1,188117,188119,188120,2,3,0
53695,5,3,188122,188122,188125,0,3,2
53696,3,2,188125,188125,188127,0,2,0
53697,3,1,188128,188128,188129,0,1,1
53698,3,2,188131,188131,188133,0,2,2
53699,6,1,188137,188137,188138,0,1,4
53700,1,3,188138,188138,188141,0,3,0
53701,5,1,188143,188143,188144,0,1,2
53702,5,2,188148,188148,188150,0,2,4
53703,2,3,188150,188150,188153,0,3,0
53704,2,3,188152,188153,188156,1,4,0
53705,4,2,188156,188156,188158,0,2,0
53706,6,1,188162,188162,188163,0,1,4
53707,5,1,188167,188167,188168,0,1,4
53708,1,3,188168,188168,188171,0,3,0
53709,1,1,188169,188171,188172,2,3,0
53710,3,3,188172,188172,188175,0,3,0
53711,1,1,188173,188175,188176,2,3,0
53712,5,2,188178,188178,188180,0,2,2
53713,1,2,188179,188180,188182,1,3,0
53714,5,3,188184,188184,188187,0,3,2
53715,1,2,188185,188187,188189,2,4,0
53716,3,3,188188,188189,188192,1,4,0
53717,2,2,188190,188192,188194,2,4,0
53718,1,3,188191,188194,188197,3,6,0
53719,3,1,188194,188197,188198,3,4,0
53720,6,1,188200,188200,188201,0,1,2
53721,1,2,188201,188201,188203,0,2,0
53722,3,2,188204,188204,188206,0,2,1
53723,1,2,188205,188206,188208,1,3,0
53724,1,2,188206,188208,188210,2,4,0
53725,1,1,188207,188210,188211,3,4,0
53726,3,2,188210,188211,188213,1,3,0
53727,3,2,188213,188213,188215,0,2,0
53728,2,3,188215,188215,188218,0,3,0
53729,3,2,188218,188218,188220,0,2,0
53730,4,3,188222,188222,188225,0,3,2
53731,5,1,188227,188227,188228,0,1,2
53732,4,3,188231,188231,188234,0,3,3
53733,4,1,188235,188235,188236,0,1,1
53734,5,1,188240,188240,188241,0,1,4
53735,1,3,188241,188241,188244,0,3,0
53736,6,1,188247,188247,188248,0,1,3
53737,1,3,188248,188248,188251,0,3,0
53738,1,1,188249,188251,188252,2,3,0
53739,5,2,188254,188254,188256,0,2,2
53740,2,3,188256,188256,188259,0,3,0
53741,5,1,188261,188261,188262,0,1,2
53742,1,2,188262,188262,188264,0,2,0
53743,6,3,188268,188268,188271,0,3,4
53744,4,3,188272,188272,188275,0,3,1
53745,6,3,188278,188278,188281,0,3,3
53746,5,3,188283,188283,188286,0,3,2
53747,4,1,188287,188287,188288,0,1,1
53748,5,1,188292,188292,188293,0,1,4
53749,2,3,188294,188294,188297,0,3,1
53750,5,2,188299,188299,188301,0,2,2
53751,1,1,188300,188301,188302,1,2,0
53752,5,3,188305,188305,188308,0,3,3
53753,2,1,188307,188308,188309,1,2,0
53754,5,1,188312,188312,188313,0,1,3
53755,6,3,188318,188318,188321,0,3,5
53756,2,2,188320,188321,188323,1,3,0
53757,1,1,188321,188323,188324,2,3,0
53758,4,3,188325,188325,188328,0,3,1
53759,4,2,188329,188329,188331,0,2,1
53760,5,1,188334,188334,188335,0,1,3
53761,3,3,188337,188337,188340,0,3,2
53762,3,3,188340,188340,188343,0,3,0
53763,5,3,188345,188345,188348,0,3,2
53764,1,1,188346,188348,188349,2,3,0
53765,2,1,188348,188349,188350,1,2,0
53766,3,2,188351,188351,188353,0,2,1
53767,1,2,188352,188353,188355,1,3,0
53768,3,3,188355,188355,188358,0,3,0
53769,4,2,188359,188359,188361,0,2,1
53770,5,1,188364,188364,188365,0,1,3
53771,4,3,188368,188368,188371,0,3,3
53772,5,3,188373,188373,188376,0,3,2
53773,5,2,188378,188378,188380,0,2,2
53774,4,1,188382,188382,188383,0,1,2
53775,6,2,188388,188388,188390,0,2,5
53776,5,2,188393,188393,188395,0,2,3
53777,4,2,188397,188397,188399,0,2,2
53778,4,1,188401,188401,188402,0,1,2
53779,3,1,188404,188404,188405,0,1,2
53780,4,2,188408,188408,188410,0,2,3
53781,1,2,188409,188410,188412,1,3,0
53782,3,1,188412,188412,188413,0,1,0
53783,4,3,188416,188416,188419,0,3,3
53784,5,3,188421,188421,188424,0,3,2
53785,3,3,188424,188424,188427,0,3,0
53786,5,1,188429,188429,188430,0,1,2
53787,2,2,188431,188431,188433,0,2,1
53788,6,3,188437,188437,188440,0,3,4
53789,5,1,188442,188442,188443,0,1,2
53790,3,2,188445,188445,188447,0,2,2
53791,3,2,188448,188448,188450,0,2,1
53792,6,3,188454,188454,188457,0,3,4
53793,1,2,188455,188457,188459,2,4,0
53794,4,3,188459,188459,188462,0,3,0
53795,4,2,188463,188463,188465,0,2,1
53796,2,1,188465,188465,188466,0,1,0
53797,1,2,188466,188466,188468,0,2,0
53798,5,1,188471,188471,188472,0,1,3
53799,3,2,188474,188474,188476,0,2,2
53800,3,3,188477,188477,188480,0,3,1
53801,2,3,188479,188480,188483,1,4,0
53802,6,3,188485,188485,188488,0,3,2
53803,2,1,188487,188488,188489,1,2,0
53804,5,1,188492,188492,188493,0,1,3
53805,5,3,188497,188497,188500,0,3,4
53806,6,3,188503,188503,188506,0,3,3
53807,6,2,188509,188509,188511,0,2,3
53808,2,3,188511,188511,188514,0,3,0
53809,2,1,188513,188514,188515,1,2,0
53810,6,1,188519,188519,188520,0,1,4
53811,5,2,188524,188524,188526,0,2,4
53812,2,3,188526,188526,188529,0,3,0
53813,4,1,188530,188530,188531,0,1,1
53814,3,1,188533,188533,188534,0,1,2
53815,2,2,188535,188535,188537,0,2,1
53816,2,2,188537,188537,188539,0,2,0
53817,1,3,188538,188539,188542,1,4,0
53818,6,2,188544,188544,188546,0,2,2
53819,2,2,188546,188546,188548,0,2,0
53820,4,3,188550,188550,188553,0,3,2
53821,5,2,188555,188555,188557,0,2,2
53822,1,1,188556,188557,188558,1,2,0
53823,3,1,188559,188559,188560,0,1,1
53824,5,1,188564,188564,188565,0,1,4
53825,3,2,188567,188567,188569,0,2,2
53826,6,3,188573,188573,188576,0,3,4
53827,2,2,188575,188576,188578,1,3,0
53828,1,2,188576,188578,188580,2,4,0
53829,3,1,188579,188580,188581,1,2,0
53830,1,1,188580,188581,188582,1,2,0
53831,5,1,188585,188585,188586,0,1,3
53832,1,3,188586,188586,188589,0,3,0
53833,3,1,188589,188589,188590,0,1,0
53834,6,3,188595,188595,188598,0,3,5
53835,4,1,188599,188599,188600,0,1,1
53836,3,2,188602,188602,188604,0,2,2
53837,1,2,188603,188604,188606,1,3,0
53838,5,2,188608,188608,188610,0,2,2
53839,4,1,188612,188612,188613,0,1,2
53840,6,1,188618,188618,188619,0,1,5
53841,1,2,188619,188619,188621,0,2,0
53842,6,3,188625,188625,188628,0,3,4
53843,1,3,188626,188628,188631,2,5,0
53844,6,1,188632,188632,188633,0,1,1
53845,4,3,188636,188636,188639,0,3,3
53846,1,2,188637,188639,188641,2,4,0
53847,3,2,188640,188641,188643,1,3,0
53848,2,1,188642,188643,188644,1,2,0
53849,2,3,188644,188644,188647,0,3,0
53850,6,2,188650,188650,188652,0,2,3
53851,6,3,188656,188656,188659,0,3,4
53852,4,1,188660,188660,188661,0,1,1
53853,3,1,188663,188663,188664,0,1,2
53854,6,3,188669,188669,188672,0,3,5
53855,4,3,188673,188673,188676,0,3,1
53856,6,3,188679,188679,188682,0,3,3
53857,3,2,188682,188682,188684,0,2,0
53858,4,2,188686,188686,188688,0,2,2
53859,1,1,188687,188688,188689,1,2,0
53860,6,3,188693,188693,188696,0,3,4
53861,2,3,188695,188696,188699,1,4,0
53862,5,2,188700,188700,188702,0,2,1
53863,6,2,188706,188706,188708,0,2,4
53864,4,3,188710,188710,188713,0,3,2
53865,3,1,188713,188713,188714,0,1,0
53866,1,1,188714,188714,188715,0,1,0
53867,2,3,188716,188716,188719,0,3,1
53868,6,2,188722,188722,188724,0,2,3
53869,5,2,188727,188727,188729,0,2,3
53870,1,1,188728,188729,188730,1,2,0
53871,2,2,188730,188730,188732,0,2,0
53872,5,2,188735,188735,188737,0,2,3
53873,3,2,188738,188738,188740,0,2,1
53874,3,1,188741,188741,188742,0,1,1
53875,6,3,188747,188747,188750,0,3,5
53876,5,2,188752,188752,188754,0,2,2
53877,3,1,188755,188755,188756,0,1,1
53878,6,1,188761,188761,188762,0,1,5
53879,5,2,188766,188766,188768,0,2,4
53880,3,2,188769,188769,188771,0,2,1
53881,3,2,188772,188772,188774,0,2,1
53882,4,1,188776,188776,188777,0,1,2
53883,5,3,188781,188781,188784,0,3,4
53884,6,1,188787,188787,188788,0,1,3
53885,6,2,188793,188793,188795,0,2,5
53886,2,2,188795,188795,188797,0,2,0
53887,5,2,188800,188800,188802,0,2,3
53888,2,3,188802,188802,188805,0,3,0
53889,6,3,188808,188808,188811,0,3,3
53890,6,2,188814,188814,188816,0,2,3
53891,1,2,188815,188816,188818,1,3,0
53892,4,2,188819,188819,188821,0,2,1
53893,5,1,188824,188824,188825,0,1,3
53894,6,2,188830,188830,188832,0,2,5
53895,2,3,188832,188832,188835,0,3,0
53896,3,2,188835,188835,188837,0,2,0
53897,3,3,188838,188838,188841,0,3,1
53898,5,3,188843,188843,188846,0,3,2
53899,1,3,188844,188846,188849,2,5,0
53900,2,1,188846,188849,188850,3,4,0
53901,4,2,188850,188850,188852,0,2,0
53902,2,3,188852,188852,188855,0,3,0
53903,6,3,188858,188858,188861,0,3,3
53904,6,1,188864,188864,188865,0,1,3
53905,6,2,188870,188870,188872,0,2,5
53906,3,2,188873,188873,188875,0,2,1
53907,5,2,188878,188878,188880,0,2,3
53908,5,2,188883,188883,188885,0,2,3
53909,1,1,188884,188885,188886,1,2,0
53910,1,2,188885,188886,188888,1,3,0
53911,2,3,188887,188888,188891,1,4,0
53912,5,3,188892,188892,188895,0,3,1
53913,2,3,188894,188895,188898,1,4,0
53914,6,2,188900,188900,188902,0,2,2
53915,4,2,188904,188904,188906,0,2,2
53916,6,3,188910,188910,188913,0,3,4
53917,5,1,188915,188915,188916,0,1,2
53918,1,2,188916,188916,188918,0,2,0
53919,6,3,188922,188922,188925,0,3,4
53920,3,3,188925,188925,188928,0,3,0
53921,4,2,188929,188929,188931,0,2,1
53922,4,1,188933,188933,188934,0,1,2
53923,2,1,188935,188935,188936,0,1,1
53924,2,3,188937,188937,188940,0,3,1
53925,1,3,188938,188940,188943,2,5,0
53926,3,1,188941,188943,188944,2,3,0
53927,5,3,188946,188946,188949,0,3,2
53928,2,3,188948,188949,188952,1,4,0
53929,3,1,188951,188952,188953,1,2,0
53930,2,1,188953,188953,188954,0,1,0
53931,5,1,188958,188958,188959,0,1,4
53932,2,2,188960,188960,188962,0,2,1
53933,2,2,188962,188962,188964,0,2,0
53934,1,2,188963,188964,188966,1,3,0
53935,1,2,188964,188966,188968,2,4,0
53936,1,3,188965,188968,188971,3,6,0
53937,2,1,188967,188971,188972,4,5,0
53938,1,1,188968,188972,188973,4,5,0
53939,5,1,188973,188973,188974,0,1,0
53940,4,3,188977,188977,188980,0,3,3
53941,6,1,188983,188983,188984,0,1,3
53942,2,3,188985,188985,188988,0,3,1
53943,5,2,188990,188990,188992,0,2,2
53944,3,2,188993,188993,188995,0,2,1
53945,1,1,188994,188995,188996,1,2,0
53946,3,2,188997,188997,188999,0,2,1
53947,5,1,189002,189002,189003,0,1,3
53948,5,1,189007,189007,189008,0,1,4
53949,6,1,189013,189013,189014,0,1,5
53950,1,2,189014,189014,189016,0,2,0
53951,4,3,189018,189018,189021,0,3,2
53952,3,2,189021,189021,189023,0,2,0
53953,5,3,189026,189026,189029,0,3,3
53954,6,2,189032,189032,189034,0,2,3
53955,6,3,189038,189038,189041,0,3,4
53956,2,2,189040,189041,189043,1,3,0
53957,4,2,189044,189044,189046,0,2,1
53958,6,1,189050,189050,189051,0,1,4
53959,6,3,189056,189056,189059,0,3,5
53960,6,3,189062,189062,189065,0,3,3
53961,2,2,189064,189065,189067,1,3,0
53962,5,2,189069,189069,189071,0,2,2
53963,5,1,189074,189074,189075,0,1,3
53964,2,2,189076,189076,189078,0,2,1
53965,5,3,189081,189081,189084,0,3,3
53966,1,1,189082,189084,189085,2,3,0
53967,4,3,189086,189086,189089,0,3,1
53968,5,3,189091,189091,189094,0,3,2
53969,4,3,189095,189095,189098,0,3,1
53970,1,1,189096,189098,189099,2,3,0
53971,4,1,189100,189100,189101,0,1,1
53972,4,2,189104,189104,189106,0,2,3
53973,2,3,189106,189106,189109,0,3,0
53974,1,1,189107,189109,189110,2,3,0
53975,6,2,189113,189113,189115,0,2,3
53976,3,2,189116,189116,189118,0,2,1
53977,1,1,189117,189118,189119,1,2,0
53978,4,3,189121,189121,189124,0,3,2
53979,1,3,189122,189124,189127,2,5,0
53980,4,2,189126,189127,189129,1,3,0
53981,1,1,189127,189129,189130,2,3,0
53982,5,1,189132,189132,189133,0,1,2
53983,6,2,189138,189138,189140,0,2,5
53984,2,3,189140,189140,189143,0,3,0
53985,5,1,189145,189145,189146,0,1,2
53986,4,2,189149,189149,189151,0,2,3
53987,6,2,189155,189155,189157,0,2,4
53988,1,2,189156,189157,189159,1,3,0
53989,6,2,189162,189162,189164,0,2,3
53990,1,1,189163,189164,189165,1,2,0
53991,6,1,189169,189169,189170,0,1,4
53992,6,3,189175,189175,189178,0,3,5
53993,1,3,189176,189178,189181,2,5,0
53994,6,1,189182,189182,189183,0,1,1
53995,2,3,189184,189184,189187,0,3,1
53996,2,2,189186,189187,189189,1,3,0
53997,1,3,189187,189189,189192,2,5,0
53998,3,2,189190,189192,189194,2,4,0
53999,6,1,189196,189196,189197,0,1,2
54000,5,1,189201,189201,189202,0,1,4
54001,3,3,189204,189204,189207,0,3,2
54002,4,3,189208,189208,189211,0,3,1
54003,3,2,189211,189211,189213,0,2,0
54004,4,2,189215,189215,189217,0,2,2
54005,4,1,189219,189219,189220,0,1,2
54006,3,2,189222,189222,189224,0,2,2
54007,2,1,189224,189224,189225,0,1,0
54008,1,2,189225,189225,189227,0,2,0
54009,5,1,189230,189230,189231,0,1,3
54010,3,3,189233,189233,189236,0,3,2
54011,6,2,189239,189239,189241,0,2,3
54012,3,2,189242,189242,189244,0,2,1
54013,6,2,189248,189248,189250,0,2,4
54014,3,2,189251,189251,189253,0,2,1
54015,2,2,189253,189253,189255,0,2,0
54016,5,3,189258,189258,189261,0,3,3
54017,5,1,189263,189263,189264,0,1,2
54018,1,1,189264,189264,189265,0,1,0
54019,3,1,189267,189267,189268,0,1,2
54020,3,3,189270,189270,189273,0,3,2
54021,5,1,189275,189275,189276,0,1,2
54022,4,3,189279,189279,189282,0,3,3
54023,1,1,189280,189282,189283,2,3,0
54024,3,2,189283,189283,189285,0,2,0
54025,6,3,189289,189289,189292,0,3,4
54026,4,3,189293,189293,189296,0,3,1
54027,5,2,189298,189298,189300,0,2,2
54028,1,3,189299,189300,189303,1,4,0
54029,4,3,189303,189303,189306,0,3,0
54030,4,1,189307,189307,189308,0,1,1
54031,3,2,189310,189310,189312,0,2,2
54032,2,1,189312,189312,189313,0,1,0
54033,2,2,189314,189314,189316,0,2,1
54034,6,3,189320,189320,189323,0,3,4
54035,6,3,189326,189326,189329,0,3,3
54036,4,3,189330,189330,189333,0,3,1
54037,3,3,189333,189333,189336,0,3,0
54038,6,2,189339,189339,189341,0,2,3
54039,5,3,189344,189344,189347,0,3,3
54040,2,1,189346,189347,189348,1,2,0
54041,3,2,189349,189349,189351,0,2,1
54042,4,2,189353,189353,189355,0,2,2
54043,3,1,189356,189356,189357,0,1,1
54044,5,1,189361,189361,189362,0,1,4
54045,5,3,189366,189366,189369,0,3,4
54046,2,1,189368,189369,189370,1,2,0
54047,3,1,189371,189371,189372,0,1,1
54048,2,1,189373,189373,189374,0,1,1
54049,5,3,189378,189378,189381,0,3,4
54050,6,1,189384,189384,189385,0,1,3
54051,5,1,189389,189389,189390,0,1,4
54052,5,1,189394,189394,189395,0,1,4
54053,4,3,189398,189398,189401,0,3,3
54054,2,3,189400,189401,189404,1,4,0
54055,2,3,189402,189404,189407,2,5,0
54056,1,1,189403,189407,189408,4,5,0
54057,1,3,189404,189408,189411,4,7,0
54058,6,3,189410,189411,189414,1,4,0
54059,4,3,189414,189414,189417,0,3,0
54060,2,2,189416,189417,189419,1,3,0
54061,1,1,189417,189419,189420,2,3,0
54062,1,3,189418,189420,189423,2,5,0
54063,1,3,189419,189423,189426,4,7,0
54064,6,2,189425,189426,189428,1,3,0
54065,2,3,189427,189428,189431,1,4,0
54066,3,3,189430,189431,189434,1,4,0
54067,2,1,189432,189434,189435,2,3,0
54068,3,1,189435,189435,189436,0,1,0
54069,4,1,189439,189439,189440,0,1,3
54070,4,3,189443,189443,189446,0,3,3
54071,6,3,189449,189449,189452,0,3,3
54072,5,2,189454,189454,189456,0,2,2
54073,2,2,189456,189456,189458,0,2,0
54074,2,1,189458,189458,189459,0,1,0
54075,5,2,189463,189463,189465,0,2,4
54076,2,2,189465,189465,189467,0,2,0
54077,6,1,189471,189471,189472,0,1,4
54078,4,3,189475,189475,189478,0,3,3
54079,3,2,189478,189478,189480,0,2,0
54080,5,3,189483,189483,189486,0,3,3
54081,3,3,189486,189486,189489,0,3,0
54082,6,3,189492,189492,189495,0,3,3
54083,4,3,189496,189496,189499,0,3,1
54084,5,2,189501,189501,189503,0,2,2
54085,3,3,189504,189504,189507,0,3,1
54086,2,2,189506,189507,189509,1,3,0
54087,6,1,189512,189512,189513,0,1,3
54088,4,3,189516,189516,189519,0,3,3
54089,1,3,189517,189519,189522,2,5,0
54090,6,2,189523,189523,189525,0,2,1
54091,5,1,189528,189528,189529,0,1,3
54092,5,2,189533,189533,189535,0,2,4
54093,5,1,189538,189538,189539,0,1,3
54094,4,1,189542,189542,189543,0,1,3
54095,2,2,189544,189544,189546,0,2,1
54096,1,3,189545,189546,189549,1,4,0
54097,2,1,189547,189549,189550,2,3,0
54098,2,3,189549,189550,189553,1,4,0
54099,1,1,189550,189553,189554,3,4,0
54100,1,1,189551,189554,189555,3,4,0
54101,3,3,189554,189555,189558,1,4,0
54102,6,2,189560,189560,189562,0,2,2
54103,4,2,189564,189564,189566,0,2,2
54104,2,1,189566,189566,189567,0,1,0
54105,2,3,189568,189568,189571,0,3,1
54106,6,3,189574,189574,189577,0,3,3
54107,6,1,189580,189580,189581,0,1,3
54108,1,1,189581,189581,189582,0,1,0
54109,3,2,189584,189584,189586,0,2,2
54110,4,3,189588,189588,189591,0,3,2
54111,3,1,189591,189591,189592,0,1,0
54112,5,3,189596,189596,189599,0,3,4
54113,4,3,189600,189600,189603,0,3,1
54114,2,2,189602,189603,189605,1,3,0
54115,4,2,189606,189606,189608,0,2,1
54116,2,3,189608,189608,189611,0,3,0
54117,2,3,189610,189611,189614,1,4,0
54118,1,2,189611,189614,189616,3,5,0
54119,6,3,189617,189617,189620,0,3,1
54120,4,2,189621,189621,189623,0,2,1
54121,2,1,189623,189623,189624,0,1,0
54122,5,3,189628,189628,189631,0,3,4
54123,3,2,189631,189631,189633,0,2,0
54124,1,3,189632,189633,189636,1,4,0
54125,6,1,189638,189638,189639,0,1,2
54126,6,3,189644,189644,189647,0,3,5
54127,1,2,189645,189647,189649,2,4,0
54128,1,3,189646,189649,189652,3,6,0
54129,2,2,189648,189652,189654,4,6,0
54130,6,1,189654,189654,189655,0,1,0
54131,3,1,189657,189657,189658,0,1,2
54132,4,1,189661,189661,189662,0,1,3
54133,3,1,189664,189664,189665,0,1,2
54134,4,1,189668,189668,189669,0,1,3
54135,2,3,189670,189670,189673,0,3,1
54136,2,2,189672,189673,189675,1,3,0
54137,2,1,189674,189675,189676,1,2,0
54138,2,2,189676,189676,189678,0,2,0
54139,2,2,189678,189678,189680,0,2,0
54140,3,2,189681,189681,189683,0,2,1
54141,4,1,189685,189685,189686,0,1,2
54142,6,2,189691,189691,189693,0,2,5
54143,5,1,189696,189696,189697,0,1,3
54144,3,3,189699,189699,189702,0,3,2
54145,1,1,189700,189702,189703,2,3,0
54146,2,3,189702,189703,189706,1,4,0
54147,6,3,189708,189708,189711,0,3,2
54148,5,1,189713,189713,189714,0,1,2
54149,6,1,189719,189719,189720,0,1,5
54150,1,3,189720,189720,189723,0,3,0
54151,1,1,189721,189723,189724,2,3,0
54152,5,1,189726,189726,189727,0,1,2
54153,2,2,189728,189728,189730,0,2,1
54154,5,1,189733,189733,189734,0,1,3
54155,6,3,189739,189739,189742,0,3,5
54156,5,1,189744,189744,189745,0,1,2
54157,6,1,189750,189750,189751,0,1,5
54158,6,2,189756,189756,189758,0,2,5
54159,6,2,189762,189762,189764,0,2,4
54160,1,1,189763,189764,189765,1,2,0
54161,6,2,189769,189769,189771,0,2,4
54162,6,3,189775,189775,189778,0,3,4
54163,3,2,189778,189778,189780,0,2,0
54164,4,2,189782,189782,189784,0,2,2
54165,1,1,189783,189784,189785,1,2,0
54166,1,2,189784,189785,189787,1,3,0
54167,5,3,189789,189789,189792,0,3,2
54168,2,3,189791,189792,189795,1,4,0
54169,3,2,189794,189795,189797,1,3,0
54170,1,1,189795,189797,189798,2,3,0
54171,5,1,189800,189800,189801,0,1,2
54172,1,1,189801,189801,189802,0,1,0
54173,3,3,189804,189804,189807,0,3,2
54174,3,1,189807,189807,189808,0,1,0
54175,6,2,189813,189813,189815,0,2,5
54176,6,2,189819,189819,189821,0,2,4
54177,3,3,189822,189822,189825,0,3,1
54178,3,1,189825,189825,189826,0,1,0
54179,2,2,189827,189827,189829,0,2,1
54180,5,1,189832,189832,189833,0,1,3
54181,6,3,189838,189838,189841,0,3,5
54182,1,3,189839,189841,189844,2,5,0
54183,4,3,189843,189844,189847,1,4,0
54184,2,2,189845,189847,189849,2,4,0
54185,5,1,189850,189850,189851,0,1,1
54186,1,3,189851,189851,189854,0,3,0
54187,6,3,189857,189857,189860,0,3,3
54188,2,3,189859,189860,189863,1,4,0
54189,2,3,189861,189863,189866,2,5,0
54190,4,1,189865,189866,189867,1,2,0
54191,5,2,189870,189870,189872,0,2,3
54192,4,3,189874,189874,189877,0,3,2
54193,2,3,189876,189877,189880,1,4,0
54194,2,1,189878,189880,189881,2,3,0
54195,1,2,189879,189881,189883,2,4,0
54196,4,2,189883,189883,189885,0,2,0
54197,1,2,189884,189885,189887,1,3,0
54198,5,3,189889,189889,189892,0,3,2
54199,4,2,189893,189893,189895,0,2,1
54200,3,2,189896,189896,189898,0,2,1
54201,6,1,189902,189902,189903,0,1,4
54202,6,1,189908,189908,189909,0,1,5
54203,6,3,189914,189914,189917,0,3,5
54204,2,1,189916,189917,189918,1,2,0
54205,2,3,189918,189918,189921,0,3,0
54206,3,1,189921,189921,189922,0,1,0
54207,3,3,189924,189924,189927,0,3,2
54208,2,1,189926,189927,189928,1,2,0
54209,2,3,189928,189928,189931,0,3,0
54210,6,1,189934,189934,189935,0,1,3
54211,5,1,189939,189939,189940,0,1,4
54212,4,2,189943,189943,189945,0,2,3
54213,4,2,189947,189947,189949,0,2,2
54214,1,1,189948,189949,189950,1,2,0
54215,1,3,189949,189950,189953,1,4,0
54216,2,3,189951,189953,189956,2,5,0
54217,2,2,189953,189956,189958,3,5,0
54218,1,3,189954,189958,189961,4,7,0
54219,6,2,189960,189961,189963,1,3,0
54220,3,3,189963,189963,189966,0,3,0
54221,4,1,189967,189967,189968,0,1,1
54222,3,1,189970,189970,189971,0,1,2
54223,5,3,189975,189975,189978,0,3,4
54224,5,3,189980,189980,189983,0,3,2
54225,2,2,189982,189983,189985,1,3,0
54226,2,3,189984,189985,189988,1,4,0
54227,3,3,189987,189988,189991,1,4,0
54228,4,3,189991,189991,189994,0,3,0
54229,2,1,189993,189994,189995,1,2,0
54230,5,2,189998,189998,190000,0,2,3
54231,6,1,190004,190004,190005,0,1,4
54232,5,3,190009,190009,190012,0,3,4
54233,5,2,190014,190014,190016,0,2,2
54234,5,2,190019,190019,190021,0,2,3
54235,4,1,190023,190023,190024,0,1,2
54236,1,3,190024,190024,190027,0,3,0
54237,6,1,190030,190030,190031,0,1,3
54238,1,2,190031,190031,190033,0,2,0
54239,1,3,190032,190033,190036,1,4,0
54240,4,3,190036,190036,190039,0,3,0
54241,5,3,190041,190041,190044,0,3,2
54242,3,3,190044,190044,190047,0,3,0
54243,5,2,190049,190049,190051,0,2,2
54244,4,3,190053,190053,190056,0,3,2
54245,1,2,190054,190056,190058,2,4,0
54246,1,1,190055,190058,190059,3,4,0
54247,6,1,190061,190061,190062,0,1,2
54248,6,3,190067,190067,190070,0,3,5
54249,5,1,190072,190072,190073,0,1,2
54250,2,1,190074,190074,190075,0,1,1
54251,1,2,190075,190075,190077,0,2,0
54252,3,3,190078,190078,190081,0,3,1
54253,3,3,190081,190081,190084,0,3,0
54254,2,2,190083,190084,190086,1,3,0
54255,5,2,190088,190088,190090,0,2,2
54256,6,1,190094,190094,190095,0,1,4
54257,5,1,190099,190099,190100,0,1,4
54258,4,1,190103,190103,190104,0,1,3
54259,6,2,190109,190109,190111,0,2,5
54260,1,2,190110,190111,190113,1,3,0
54261,3,2,190113,190113,190115,0,2,0
54262,1,2,190114,190115,190117,1,3,0
54263,2,2,190116,190117,190119,1,3,0
54264,3,1,190119,190119,190120,0,1,0
54265,4,2,190123,190123,190125,0,2,3
54266,5,2,190128,190128,190130,0,2,3
54267,2,1,190130,190130,190131,0,1,0
54268,1,2,190131,190131,190133,0,2,0
54269,4,2,190135,190135,190137,0,2,2
54270,3,3,190138,190138,190141,0,3,1
54271,3,2,190141,190141,190143,0,2,0
54272,2,2,190143,190143,190145,0,2,0
54273,4,1,190147,190147,190148,0,1,2
54274,6,1,190153,190153,190154,0,1,5
54275,2,3,190155,190155,190158,0,3,1
54276,4,3,190159,190159,190162,0,3,1
54277,6,2,190165,190165,190167,0,2,3
54278,1,3,190166,190167,190170,1,4,0
54279,5,2,190171,190171,190173,0,2,1
54280,1,1,190172,190173,190174,1,2,0
54281,5,3,190177,190177,190180,0,3,3
54282,5,1,190182,190182,190183,0,1,2
54283,5,2,190187,190187,190189,0,2,4
54284,2,1,190189,190189,190190,0,1,0
54285,2,1,190191,190191,190192,0,1,1
54286,2,2,190193,190193,190195,0,2,1
54287,4,2,190197,190197,190199,0,2,2
54288,6,3,190203,190203,190206,0,3,4
54289,4,3,190207,190207,190210,0,3,1
54290,4,2,190211,190211,190213,0,2,1
54291,5,1,190216,190216,190217,0,1,3
54292,4,2,190220,190220,190222,0,2,3
54293,1,2,190221,190222,190224,1,3,0
54294,4,2,190225,190225,190227,0,2,1
54295,1,1,190226,190227,190228,1,2,0
54296,6,1,190232,190232,190233,0,1,4
54297,6,3,190238,190238,190241,0,3,5
54298,5,1,190243,190243,190244,0,1,2
54299,2,1,190245,190245,190246,0,1,1
54300,5,1,190250,190250,190251,0,1,4
54301,6,3,190256,190256,190259,0,3,5
54302,3,2,190259,190259,190261,0,2,0
54303,1,2,190260,190261,190263,1,3,0
54304,2,1,190262,190263,190264,1,2,0
54305,4,2,190266,190266,190268,0,2,2
54306,1,2,190267,190268,190270,1,3,0
54307,3,3,190270,190270,190273,0,3,0
54308,5,2,190275,190275,190277,0,2,2
54309,6,3,190281,190281,190284,0,3,4
54310,1,1,190282,190284,190285,2,3,0
54311,6,1,190288,190288,190289,0,1,3
54312,3,2,190291,190291,190293,0,2,2
54313,1,3,190292,190293,190296,1,4,0
54314,1,2,190293,190296,190298,3,5,0
54315,4,3,190297,190298,190301,1,4,0
54316,2,1,190299,190301,190302,2,3,0
54317,4,1,190303,190303,190304,0,1,1
54318,3,2,190306,190306,190308,0,2,2
54319,5,2,190311,190311,190313,0,2,3
54320,5,1,190316,190316,190317,0,1,3
54321,5,3,190321,190321,190324,0,3,4
54322,6,3,190327,190327,190330,0,3,3
54323,4,3,190331,190331,190334,0,3,1
54324,6,1,190337,190337,190338,0,1,3
54325,5,1,190342,190342,190343,0,1,4
54326,6,1,190348,190348,190349,0,1,5
54327,1,1,190349,190349,190350,0,1,0
54328,6,1,190355,190355,190356,0,1,5
54329,3,2,190358,190358,190360,0,2,2
54330,1,3,190359,190360,190363,1,4,0
54331,3,2,190362,190363,190365,1,3,0
54332,1,1,190363,190365,190366,2,3,0
54333,6,1,190369,190369,190370,0,1,3
54334,3,1,190372,190372,190373,0,1,2
54335,2,3,190374,190374,190377,0,3,1
54336,5,1,190379,190379,190380,0,1,2
54337,4,2,190383,190383,190385,0,2,3
54338,5,1,190388,190388,190389,0,1,3
54339,3,2,190391,190391,190393,0,2,2
54340,4,1,190395,190395,190396,0,1,2
54341,4,3,190399,190399,190402,0,3,3
54342,2,1,190401,190402,190403,1,2,0
54343,2,2,190403,190403,190405,0,2,0
54344,4,1,190407,190407,190408,0,1,2
54345,4,3,190411,190411,190414,0,3,3
54346,3,1,190414,190414,190415,0,1,0
54347,4,1,190418,190418,190419,0,1,3
54348,6,3,190424,190424,190427,0,3,5
54349,4,2,190428,190428,190430,0,2,1
54350,4,3,190432,190432,190435,0,3,2
54351,2,3,190434,190435,190438,1,4,0
54352,5,2,190439,190439,190441,0,2,1
54353,5,3,190444,190444,190447,0,3,3
54354,1,3,190445,190447,190450,2,5,0
54355,1,1,190446,190450,190451,4,5,0
54356,1,3,190447,190451,190454,4,7,0
54357,1,2,190448,190454,190456,6,8,0
54358,4,2,190452,190456,190458,4,6,0
54359,2,2,190454,190458,190460,4,6,0
54360,3,3,190457,190460,190463,3,6,0
54361,3,2,190460,190463,190465,3,5,0
54362,3,2,190463,190465,190467,2,4,0
54363,1,2,190464,190467,190469,3,5,0
54364,5,3,190469,190469,190472,0,3,0
54365,6,3,190475,190475,190478,0,3,3
54366,6,1,190481,190481,190482,0,1,3
54367,3,3,190484,190484,190487,0,3,2
54368,6,3,190490,190490,190493,0,3,3
54369,6,1,190496,190496,190497,0,1,3
54370,4,3,190500,190500,190503,0,3,3
54371,3,3,190503,190503,190506,0,3,0
54372,5,2,190508,190508,190510,0,2,2
54373,4,3,190512,190512,190515,0,3,2
54374,4,2,190516,190516,190518,0,2,1
54375,6,2,190522,190522,190524,0,2,4
54376,3,2,190525,190525,190527,0,2,1
54377,1,3,190526,190527,190530,1,4,0
54378,2,2,190528,190530,190532,2,4,0
54379,2,3,190530,190532,190535,2,5,0
54380,3,1,190533,190535,190536,2,3,0
54381,6,3,190539,190539,190542,0,3,3
54382,6,1,190545,190545,190546,0,1,3
54383,2,2,190547,190547,190549,0,2,1
54384,3,2,190550,190550,190552,0,2,1
54385,5,1,190555,190555,190556,0,1,3
54386,5,2,190560,190560,190562,0,2,4
54387,6,1,190566,190566,190567,0,1,4
54388,3,2,190569,190569,190571,0,2,2
54389,5,3,190574,190574,190577,0,3,3
54390,6,1,190580,190580,190581,0,1,3
54391,1,3,190581,190581,190584,0,3,0
54392,1,3,190582,190584,190587,2,5,0
54393,3,1,190585,190587,190588,2,3,0
54394,4,2,190589,190589,190591,0,2,1
54395,6,1,190595,190595,190596,0,1,4
54396,2,2,190597,190597,190599,0,2,1
54397,1,3,190598,190599,190602,1,4,0
54398,2,1,190600,190602,190603,2,3,0
54399,1,1,190601,190603,190604,2,3,0
54400,2,3,190603,190604,190607,1,4,0
54401,5,3,190608,190608,190611,0,3,1
54402,6,2,190614,190614,190616,0,2,3
54403,1,2,190615,190616,190618,1,3,0
54404,4,3,190619,190619,190622,0,3,1
54405,5,3,190624,190624,190627,0,3,2
54406,3,2,190627,190627,190629,0,2,0
54407,2,3,190629,190629,190632,0,3,0
54408,3,3,190632,190632,190635,0,3,0
54409,2,2,190634,190635,190637,1,3,0
54410,4,2,190638,190638,190640,0,2,1
54411,3,3,190641,190641,190644,0,3,1
54412,4,2,190645,190645,190647,0,2,1
54413,1,1,190646,190647,190648,1,2,0
54414,4,1,190650,190650,190651,0,1,2
54415,2,1,190652,190652,190653,0,1,1
54416,3,3,190655,190655,190658,0,3,2
54417,1,2,190656,190658,190660,2,4,0
54418,4,3,190660,190660,190663,0,3,0
54419,3,3,190663,190663,190666,0,3,0
54420,6,1,190669,190669,190670,0,1,3
54421,4,3,190673,190673,190676,0,3,3
54422,2,1,190675,190676,190677,1,2,0
54423,5,2,190680,190680,190682,0,2,3
54424,6,2,190686,190686,190688,0,2,4
54425,6,1,190692,190692,190693,0,1,4
54426,6,1,190698,190698,190699,0,1,5
54427,3,2,190701,190701,190703,0,2,2
54428,1,3,190702,190703,190706,1,4,0
54429,4,3,190706,190706,190709,0,3,0
54430,1,3,190707,190709,190712,2,5,0
54431,6,3,190713,190713,190716,0,3,1
54432,6,1,190719,190719,190720,0,1,3
54433,2,1,190721,190721,190722,0,1,1
54434,6,2,190727,190727,190729,0,2,5
54435,5,3,190732,190732,190735,0,3,3
54436,4,2,190736,190736,190738,0,2,1
54437,6,2,190742,190742,190744,0,2,4
54438,4,3,190746,190746,190749,0,3,2
54439,2,3,190748,190749,190752,1,4,0
54440,2,3,190750,190752,190755,2,5,0
54441,5,3,190755,190755,190758,0,3,0
54442,2,2,190757,190758,190760,1,3,0
54443,1,1,190758,190760,190761,2,3,0
54444,6,1,190764,190764,190765,0,1,3
54445,1,3,190765,190765,190768,0,3,0
54446,1,2,190766,190768,190770,2,4,0
54447,6,1,190772,190772,190773,0,1,2
54448,5,1,190777,190777,190778,0,1,4
54449,3,2,190780,190780,190782,0,2,2
54450,6,1,190786,190786,190787,0,1,4
54451,3,2,190789,190789,190791,0,2,2
54452,2,2,190791,190791,190793,0,2,0
54453,2,2,190793,190793,190795,0,2,0
54454,1,1,190794,190795,190796,1,2,0
54455,3,3,190797,190797,190800,0,3,1
54456,2,3,190799,190800,190803,1,4,0
54457,4,1,190803,190803,190804,0,1,0
54458,4,3,190807,190807,190810,0,3,3
54459,6,2,190813,190813,190815,0,2,3
54460,2,1,190815,190815,190816,0,1,0
54461,2,1,190817,190817,190818,0,1,1
54462,3,3,190820,190820,190823,0,3,2
54463,1,3,190821,190823,190826,2,5,0
54464,2,3,190823,190826,190829,3,6,0
54465,3,1,190826,190829,190830,3,4,0
54466,2,2,190828,190830,190832,2,4,0
54467,4,2,190832,190832,190834,0,2,0
54468,4,1,190836,190836,190837,0,1,2
54469,6,1,190842,190842,190843,0,1,5
54470,1,2,190843,190843,190845,0,2,0
54471,1,1,190844,190845,190846,1,2,0
54472,5,3,190849,190849,190852,0,3,3
54473,3,3,190852,190852,190855,0,3,0
54474,6,3,190858,190858,190861,0,3,3
54475,2,1,190860,190861,190862,1,2,0
54476,2,3,190862,190862,190865,0,3,0
54477,3,2,190865,190865,190867,0,2,0
54478,6,1,190871,190871,190872,0,1,4
54479,3,3,190874,190874,190877,0,3,2
54480,4,3,190878,190878,190881,0,3,1
54481,3,1,190881,190881,190882,0,1,0
54482,3,1,190884,190884,190885,0,1,2
54483,6,3,190890,190890,190893,0,3,5
54484,5,3,190895,190895,190898,0,3,2
54485,6,2,190901,190901,190903,0,2,3
54486,4,3,190905,190905,190908,0,3,2
54487,2,2,190907,190908,190910,1,3,0
54488,2,2,190909,190910,190912,1,3,0
54489,6,3,190915,190915,190918,0,3,3
54490,4,1,190919,190919,190920,0,1,1
54491,6,2,190925,190925,190927,0,2,5
54492,4,2,190929,190929,190931,0,2,2
54493,3,2,190932,190932,190934,0,2,1
54494,2,2,190934,190934,190936,0,2,0
54495,6,3,190940,190940,190943,0,3,4
54496,3,2,190943,190943,190945,0,2,0
54497,5,2,190948,190948,190950,0,2,3
54498,6,2,190954,190954,190956,0,2,4
54499,5,3,190959,190959,190962,0,3,3
54500,3,3,190962,190962,190965,0,3,0
54501,4,3,190966,190966,190969,0,3,1
54502,4,1,190970,190970,190971,0,1,1
54503,1,2,190971,190971,190973,0,2,0
54504,3,3,190974,190974,190977,0,3,1
54505,3,2,190977,190977,190979,0,2,0
54506,4,3,190981,190981,190984,0,3,2
54507,3,1,190984,190984,190985,0,1,0
54508,2,2,190986,190986,190988,0,2,1
54509,3,3,190989,190989,190992,0,3,1
54510,1,1,190990,190992,190993,2,3,0
54511,3,3,190993,190993,190996,0,3,0
54512,6,2,190999,190999,191001,0,2,3
54513,1,1,191000,191001,191002,1,2,0
54514,1,3,191001,191002,191005,1,4,0
54515,6,2,191007,191007,191009,0,2,2
54516,6,2,191013,191013,191015,0,2,4
54517,6,2,191019,191019,191021,0,2,4
54518,4,2,191023,191023,191025,0,2,2
54519,6,3,191029,191029,191032,0,3,4
54520,2,1,191031,191032,191033,1,2,0
54521,6,2,191037,191037,191039,0,2,4
54522,3,1,191040,191040,191041,0,1,1
54523,2,1,191042,191042,191043,0,1,1
54524,1,1,191043,191043,191044,0,1,0
54525,6,3,191049,191049,191052,0,3,5
54526,3,3,191052,191052,191055,0,3,0
54527,1,2,191053,191055,191057,2,4,0
54528,2,3,191055,191057,191060,2,5,0
54529,4,1,191059,191060,191061,1,2,0
54530,4,3,191063,191063,191066,0,3,2
54531,4,1,191067,191067,191068,0,1,1
54532,6,2,191073,191073,191075,0,2,5
54533,2,3,191075,191075,191078,0,3,0
54534,2,3,191077,191078,191081,1,4,0
54535,6,1,191083,191083,191084,0,1,2
54536,6,3,191089,191089,191092,0,3,5
54537,2,1,191091,191092,191093,1,2,0
54538,1,3,191092,191093,191096,1,4,0
54539,2,3,191094,191096,191099,2,5,0
54540,6,1,191100,191100,191101,0,1,1
54541,3,3,191103,191103,191106,0,3,2
54542,4,2,191107,191107,191109,0,2,1
54543,4,3,191111,191111,191114,0,3,2
54544,4,1,191115,191115,191116,0,1,1
54545,4,3,191119,191119,191122,0,3,3
54546,3,1,191122,191122,191123,0,1,0
54547,5,3,191127,191127,191130,0,3,4
54548,1,2,191128,191130,191132,2,4,0
54549,1,2,191129,191132,191134,3,5,0
54550,5,1,191134,191134,191135,0,1,0
54551,4,2,191138,191138,191140,0,2,3
54552,4,2,191142,191142,191144,0,2,2
54553,3,1,191145,191145,191146,0,1,1
54554,3,1,191148,191148,191149,0,1,2
54555,2,3,191150,191150,191153,0,3,1
54556,5,3,191155,191155,191158,0,3,2
54557,2,3,191157,191158,191161,1,4,0
54558,6,3,191163,191163,191166,0,3,2
54559,2,2,191165,191166,191168,1,3,0
54560,2,2,191167,191168,191170,1,3,0
54561,1,2,191168,191170,191172,2,4,0
54562,3,1,191171,191172,191173,1,2,0
54563,1,2,191172,191173,191175,1,3,0
54564,1,2,191173,191175,191177,2,4,0
54565,5,1,191178,191178,191179,0,1,1
54566,5,1,191183,191183,191184,0,1,4
54567,4,3,191187,191187,191190,0,3,3
54568,3,2,191190,191190,191192,0,2,0
54569,6,2,191196,191196,191198,0,2,4
54570,6,3,191202,191202,191205,0,3,4
54571,4,2,191206,191206,191208,0,2,1
54572,3,1,191209,191209,191210,0,1,1
54573,3,2,191212,191212,191214,0,2,2
54574,2,1,191214,191214,191215,0,1,0
54575,5,2,191219,191219,191221,0,2,4
54576,3,2,191222,191222,191224,0,2,1
54577,2,1,191224,191224,191225,0,1,0
54578,2,2,191226,191226,191228,0,2,1
54579,3,3,191229,191229,191232,0,3,1
54580,4,1,191233,191233,191234,0,1,1
54581,4,1,191237,191237,191238,0,1,3
54582,5,1,191242,191242,191243,0,1,4
54583,6,1,191248,191248,191249,0,1,5
54584,6,3,191254,191254,191257,0,3,5
54585,1,1,191255,191257,191258,2,3,0
54586,5,2,191260,191260,191262,0,2,2
54587,3,2,191263,191263,191265,0,2,1
54588,2,2,191265,191265,191267,0,2,0
54589,5,3,191270,191270,191273,0,3,3
54590,6,3,191276,191276,191279,0,3,3
54591,2,1,191278,191279,191280,1,2,0
54592,5,1,191283,191283,191284,0,1,3
54593,2,3,191285,191285,191288,0,3,1
54594,5,2,191290,191290,191292,0,2,2
54595,1,3,191291,191292,191295,1,4,0
54596,1,1,191292,191295,191296,3,4,0
54597,4,2,191296,191296,191298,0,2,0
54598,5,3,191301,191301,191304,0,3,3
54599,3,3,191304,191304,191307,0,3,0
54600,4,2,191308,191308,191310,0,2,1
54601,5,2,191313,191313,191315,0,2,3
54602,6,2,191319,191319,191321,0,2,4
54603,3,2,191322,191322,191324,0,2,1
54604,6,2,191328,191328,191330,0,2,4
54605,3,3,191331,191331,191334,0,3,1
54606,5,3,191336,191336,191339,0,3,2
54607,1,2,191337,191339,191341,2,4,0
54608,2,2,191339,191341,191343,2,4,0
54609,5,3,191344,191344,191347,0,3,1
54610,5,3,191349,191349,191352,0,3,2
54611,5,2,191354,191354,191356,0,2,2
54612,1,1,191355,191356,191357,1,2,0
54613,2,1,191357,191357,191358,0,1,0
54614,3,1,191360,191360,191361,0,1,2
54615,6,2,191366,191366,191368,0,2,5
54616,4,1,191370,191370,191371,0,1,2
54617,2,3,191372,191372,191375,0,3,1
54618,3,3,191375,191375,191378,0,3,0
54619,6,1,191381,191381,191382,0,1,3
54620,4,2,191385,191385,191387,0,2,3
54621,2,2,191387,191387,191389,0,2,0
54622,1,3,191388,191389,191392,1,4,0
54623,1,2,191389,191392,191394,3,5,0
54624,5,1,191394,191394,191395,0,1,0
54625,6,2,191400,191400,191402,0,2,5
54626,3,3,191403,191403,191406,0,3,1
54627,4,2,191407,191407,191409,0,2,1
54628,1,3,191408,191409,191412,1,4,0
54629,6,3,191414,191414,191417,0,3,2
54630,3,1,191417,191417,191418,0,1,0
54631,1,3,191418,191418,191421,0,3,0
54632,3,2,191421,191421,191423,0,2,0
54633,6,3,191427,191427,191430,0,3,4
54634,5,3,191432,191432,191435,0,3,2
54635,3,1,191435,191435,191436,0,1,0
54636,2,2,191437,191437,191439,0,2,1
54637,6,2,191443,191443,191445,0,2,4
54638,3,1,191446,191446,191447,0,1,1
54639,2,3,191448,191448,191451,0,3,1
54640,5,2,191453,191453,191455,0,2,2
54641,4,3,191457,191457,191460,0,3,2
54642,1,2,191458,191460,191462,2,4,0
54643,6,1,191464,191464,191465,0,1,2
54644,3,1,191467,191467,191468,0,1,2
54645,3,2,191470,191470,191472,0,2,2
54646,1,3,191471,191472,191475,1,4,0
54647,1,2,191472,191475,191477,3,5,0
54648,5,3,191477,191477,191480,0,3,0
54649,4,1,191481,191481,191482,0,1,1
54650,2,1,191483,191483,191484,0,1,1
54651,1,3,191484,191484,191487,0,3,0
54652,5,2,191489,191489,191491,0,2,2
54653,6,3,191495,191495,191498,0,3,4
54654,1,3,191496,191498,191501,2,5,0
54655,4,1,191500,191501,191502,1,2,0
54656,2,3,191502,191502,191505,0,3,0
54657,4,3,191506,191506,191509,0,3,1
54658,5,1,191511,191511,191512,0,1,2
54659,6,3,191517,191517,191520,0,3,5
54660,2,3,191519,191520,191523,1,4,0
54661,4,3,191523,191523,191526,0,3,0
54662,2,2,191525,191526,191528,1,3,0
54663,5,2,191530,191530,191532,0,2,2
54664,6,1,191536,191536,191537,0,1,4
54665,4,1,191540,191540,191541,0,1,3
54666,1,3,191541,191541,191544,0,3,0
54667,1,1,191542,191544,191545,2,3,0
54668,1,2,191543,191545,191547,2,4,0
54669,2,3,191545,191547,191550,2,5,0
54670,2,1,191547,191550,191551,3,4,0
54671,5,3,191552,191552,191555,0,3,1
54672,2,2,191554,191555,191557,1,3,0
54673,3,3,191557,191557,191560,0,3,0
54674,6,3,191563,191563,191566,0,3,3
54675,2,1,191565,191566,191567,1,2,0
54676,5,1,191570,191570,191571,0,1,3
54677,6,3,191576,191576,191579,0,3,5
54678,5,1,191581,191581,191582,0,1,2
54679,6,1,191587,191587,191588,0,1,5
54680,5,3,191592,191592,191595,0,3,4
54681,6,2,191598,191598,191600,0,2,3
54682,3,2,191601,191601,191603,0,2,1
54683,3,2,191604,191604,191606,0,2,1
54684,2,1,191606,191606,191607,0,1,0
54685,6,3,191612,191612,191615,0,3,5
54686,5,2,191617,191617,191619,0,2,2
54687,6,3,191623,191623,191626,0,3,4
54688,1,2,191624,191626,191628,2,4,0
54689,2,3,191626,191628,191631,2,5,0
54690,4,3,191630,191631,191634,1,4,0
54691,1,3,191631,191634,191637,3,6,0
54692,5,2,191636,191637,191639,1,3,0
54693,2,3,191638,191639,191642,1,4,0
54694,4,3,191642,191642,191645,0,3,0
54695,1,2,191643,191645,191647,2,4,0
54696,4,2,191647,191647,191649,0,2,0
54697,2,2,191649,191649,191651,0,2,0
54698,6,1,191655,191655,191656,0,1,4
54699,6,1,191661,191661,191662,0,1,5
54700,1,1,191662,191662,191663,0,1,0
54701,6,2,191668,191668,191670,0,2,5
54702,4,3,191672,191672,191675,0,3,2
54703,5,2,191677,191677,191679,0,2,2
54704,2,3,191679,191679,191682,0,3,0
54705,2,3,191681,191682,191685,1,4,0
54706,6,2,191687,191687,191689,0,2,2
54707,3,2,191690,191690,191692,0,2,1
54708,3,1,191693,191693,191694,0,1,1
54709,3,3,191696,191696,191699,0,3,2
54710,3,1,191699,191699,191700,0,1,0
54711,3,1,191702,191702,191703,0,1,2
54712,5,3,191707,191707,191710,0,3,4
54713,5,2,191712,191712,191714,0,2,2
54714,3,2,191715,191715,191717,0,2,1
54715,3,1,191718,191718,191719,0,1,1
54716,2,1,191720,191720,191721,0,1,1
54717,4,2,191724,191724,191726,0,2,3
54718,6,1,191730,191730,191731,0,1,4
54719,3,1,191733,191733,191734,0,1,2
54720,6,1,191739,191739,191740,0,1,5
54721,5,3,191744,191744,191747,0,3,4
54722,6,1,191750,191750,191751,0,1,3
54723,5,3,191755,191755,191758,0,3,4
54724,6,3,191761,191761,191764,0,3,3
54725,5,3,191766,191766,191769,0,3,2
54726,4,3,191770,191770,191773,0,3,1
54727,3,2,191773,191773,191775,0,2,0
54728,6,2,191779,191779,191781,0,2,4
54729,5,2,191784,191784,191786,0,2,3
54730,3,1,191787,191787,191788,0,1,1
54731,5,1,191792,191792,191793,0,1,4
54732,6,3,191798,191798,191801,0,3,5
54733,5,2,191803,191803,191805,0,2,2
54734,1,1,191804,191805,191806,1,2,0
54735,4,2,191808,191808,191810,0,2,2
54736,5,3,191813,191813,191816,0,3,3
54737,2,2,191815,191816,191818,1,3,0
54738,4,3,191819,191819,191822,0,3,1
54739,4,2,191823,191823,191825,0,2,1
54740,2,1,191825,191825,191826,0,1,0
54741,3,1,191828,191828,191829,0,1,2
54742,1,3,191829,191829,191832,0,3,0
54743,4,3,191833,191833,191836,0,3,1
54744,3,1,191836,191836,191837,0,1,0
54745,2,1,191838,191838,191839,0,1,1
54746,3,1,191841,191841,191842,0,1,2
54747,4,3,191845,191845,191848,0,3,3
54748,6,1,191851,191851,191852,0,1,3
54749,2,2,191853,191853,191855,0,2,1
54750,1,3,191854,191855,191858,1,4,0
54751,5,3,191859,191859,191862,0,3,1
54752,3,3,191862,191862,191865,0,3,0
54753,1,2,191863,191865,191867,2,4,0
54754,1,3,191864,191867,191870,3,6,0
54755,3,2,191867,191870,191872,3,5,0
54756,5,3,191872,191872,191875,0,3,0
54757,1,1,191873,191875,191876,2,3,0
54758,6,3,191879,191879,191882,0,3,3
54759,2,1,191881,191882,191883,1,2,0
54760,2,3,191883,191883,191886,0,3,0
54761,5,1,191888,191888,191889,0,1,2
54762,5,3,191893,191893,191896,0,3,4
54763,1,1,191894,191896,191897,2,3,0
54764,5,1,191899,191899,191900,0,1,2
54765,1,3,191900,191900,191903,0,3,0
54766,6,3,191906,191906,191909,0,3,3
54767,3,3,191909,191909,191912,0,3,0
54768,2,1,191911,191912,191913,1,2,0
54769,4,3,191915,191915,191918,0,3,2
54770,1,1,191916,191918,191919,2,3,0
54771,2,1,191918,191919,191920,1,2,0
54772,5,1,191923,191923,191924,0,1,3
54773,5,3,191928,191928,191931,0,3,4
54774,4,2,191932,191932,191934,0,2,1
54775,3,2,191935,191935,191937,0,2,1
54776,5,3,191940,191940,191943,0,3,3
54777,5,2,191945,191945,191947,0,2,2
54778,1,3,191946,191947,191950,1,4,0
54779,3,2,191949,191950,191952,1,3,0
54780,1,2,191950,191952,191954,2,4,0
54781,2,1,191952,191954,191955,2,3,0
54782,4,1,191956,191956,191957,0,1,1
54783,6,3,191962,191962,191965,0,3,5
54784,1,1,191963,191965,191966,2,3,0
54785,1,2,191964,191966,191968,2,4,0
54786,5,3,191969,191969,191972,0,3,1
54787,4,3,191973,191973,191976,0,3,1
54788,6,1,191979,191979,191980,0,1,3
54789,4,2,191983,191983,191985,0,2,3
54790,5,3,191988,191988,191991,0,3,3
54791,6,3,191994,191994,191997,0,3,3
54792,6,1,192000,192000,192001,0,1,3
54793,5,2,192005,192005,192007,0,2,4
54794,5,3,192010,192010,192013,0,3,3
54795,1,2,192011,192013,192015,2,4,0
54796,1,1,192012,192015,192016,3,4,0
54797,4,2,192016,192016,192018,0,2,0
54798,1,1,192017,192018,192019,1,2,0
54799,1,1,192018,192019,192020,1,2,0
54800,4,2,192022,192022,192024,0,2,2
54801,5,3,192027,192027,192030,0,3,3
54802,2,3,192029,192030,192033,1,4,0
54803,1,3,192030,192033,192036,3,6,0
54804,5,3,192035,192036,192039,1,4,0
54805,3,1,192038,192039,192040,1,2,0
54806,6,3,192044,192044,192047,0,3,4
54807,2,1,192046,192047,192048,1,2,0
54808,2,3,192048,192048,192051,0,3,0
54809,4,1,192052,192052,192053,0,1,1
54810,2,2,192054,192054,192056,0,2,1
54811,6,1,192060,192060,192061,0,1,4
54812,1,1,192061,192061,192062,0,1,0
54813,4,3,192065,192065,192068,0,3,3
54814,1,2,192066,192068,192070,2,4,0
54815,3,2,192069,192070,192072,1,3,0
54816,4,2,192073,192073,192075,0,2,1
54817,5,2,192078,192078,192080,0,2,3
54818,1,1,192079,192080,192081,1,2,0
54819,5,1,192084,192084,192085,0,1,3
54820,6,3,192090,192090,192093,0,3,5
54821,5,1,192095,192095,192096,0,1,2
54822,1,1,192096,192096,192097,0,1,0
54823,1,3,192097,192097,192100,0,3,0
54824,6,2,192103,192103,192105,0,2,3
54825,1,2,192104,192105,192107,1,3,0
54826,3,1,192107,192107,192108,0,1,0
54827,1,1,192108,192108,192109,0,1,0
54828,1,2,192109,192109,192111,0,2,0
54829,6,1,192115,192115,192116,0,1,4
54830,1,2,192116,192116,192118,0,2,0
54831,1,3,192117,192118,192121,1,4,0
54832,1,2,192118,192121,192123,3,5,0
54833,4,1,192122,192123,192124,1,2,0
54834,4,2,192126,192126,192128,0,2,2
54835,4,1,192130,192130,192131,0,1,2
54836,5,2,192135,192135,192137,0,2,4
54837,1,2,192136,192137,192139,1,3,0
54838,5,2,192141,192141,192143,0,2,2
54839,1,2,192142,192143,192145,1,3,0
54840,5,3,192147,192147,192150,0,3,2
54841,2,3,192149,192150,192153,1,4,0
54842,4,3,192153,192153,192156,0,3,0
54843,2,1,192155,192156,192157,1,2,0
54844,1,1,192156,192157,192158,1,2,0
54845,4,2,192160,192160,192162,0,2,2
54846,3,3,192163,192163,192166,0,3,1
54847,6,1,192169,192169,192170,0,1,3
54848,3,1,192172,192172,192173,0,1,2
54849,3,1,192175,192175,192176,0,1,2
54850,3,2,192178,192178,192180,0,2,2
54851,6,2,192184,192184,192186,0,2,4
54852,2,1,192186,192186,192187,0,1,0
54853,5,1,192191,192191,192192,0,1,4
54854,1,2,192192,192192,192194,0,2,0
54855,6,3,192198,192198,192201,0,3,4
54856,3,3,192201,192201,192204,0,3,0
54857,2,2,192203,192204,192206,1,3,0
54858,5,3,192208,192208,192211,0,3,2
54859,3,3,192211,192211,192214,0,3,0
54860,4,3,192215,192215,192218,0,3,1
54861,6,1,192221,192221,192222,0,1,3
54862,2,2,192223,192223,192225,0,2,1
54863,5,1,192228,192228,192229,0,1,3
54864,3,2,192231,192231,192233,0,2,2
54865,4,3,192235,192235,192238,0,3,2
54866,3,1,192238,192238,192239,0,1,0
54867,1,2,192239,192239,192241,0,2,0
54868,5,2,192244,192244,192246,0,2,3
54869,5,1,192249,192249,192250,0,1,3
54870,3,2,192252,192252,192254,0,2,2
54871,5,1,192257,192257,192258,0,1,3
54872,1,1,192258,192258,192259,0,1,0
54873,3,3,192261,192261,192264,0,3,2
54874,4,2,192265,192265,192267,0,2,1
54875,4,2,192269,192269,192271,0,2,2
54876,3,3,192272,192272,192275,0,3,1
54877,1,2,192273,192275,192277,2,4,0
54878,6,1,192279,192279,192280,0,1,2
54879,3,1,192282,192282,192283,0,1,2
54880,6,2,192288,192288,192290,0,2,5
54881,3,3,192291,192291,192294,0,3,1
54882,1,3,192292,192294,192297,2,5,0
54883,4,1,192296,192297,192298,1,2,0
54884,3,3,192299,192299,192302,0,3,1
54885,6,3,192305,192305,192308,0,3,3
54886,2,3,192307,192308,192311,1,4,0
54887,5,1,192312,192312,192313,0,1,1
54888,5,3,192317,192317,192320,0,3,4
54889,3,3,192320,192320,192323,0,3,0
54890,5,1,192325,192325,192326,0,1,2
54891,5,3,192330,192330,192333,0,3,4
54892,2,1,192332,192333,192334,1,2,0
54893,1,1,192333,192334,192335,1,2,0
54894,4,2,192337,192337,192339,0,2,2
54895,2,1,192339,192339,192340,0,1,0
54896,2,2,192341,192341,192343,0,2,1
54897,1,2,192342,192343,192345,1,3,0
54898,2,1,192344,192345,192346,1,2,0
54899,5,2,192349,192349,192351,0,2,3
54900,1,2,192350,192351,192353,1,3,0
54901,6,3,192356,192356,192359,0,3,3
54902,4,3,192360,192360,192363,0,3,1
54903,6,3,192366,192366,192369,0,3,3
54904,5,2,192371,192371,192373,0,2,2
54905,5,2,192376,192376,192378,0,2,3
54906,5,1,192381,192381,192382,0,1,3
54907,5,1,192386,192386,192387,0,1,4
54908,5,2,192391,192391,192393,0,2,4
54909,6,1,192397,192397,192398,0,1,4
54910,4,3,192401,192401,192404,0,3,3
54911,6,2,192407,192407,192409,0,2,3
54912,3,3,192410,192410,192413,0,3,1
54913,5,3,192415,192415,192418,0,3,2
54914,5,3,192420,192420,192423,0,3,2
54915,2,2,192422,192423,192425,1,3,0
54916,2,3,192424,192425,192428,1,4,0
54917,5,2,192429,192429,192431,0,2,1
54918,1,3,192430,192431,192434,1,4,0
54919,6,2,192436,192436,192438,0,2,2
54920,4,1,192440,192440,192441,0,1,2
54921,3,1,192443,192443,192444,0,1,2
54922,6,3,192449,192449,192452,0,3,5
54923,2,1,192451,192452,192453,1,2,0
54924,6,2,192457,192457,192459,0,2,4
54925,5,3,192462,192462,192465,0,3,3
54926,5,2,192467,192467,192469,0,2,2
54927,6,2,192473,192473,192475,0,2,4
54928,4,3,192477,192477,192480,0,3,2
54929,6,1,192483,192483,192484,0,1,3
54930,1,2,192484,192484,192486,0,2,0
54931,2,3,192486,192486,192489,0,3,0
54932,3,2,192489,192489,192491,0,2,0
54933,6,1,192495,192495,192496,0,1,4
54934,1,1,192496,192496,192497,0,1,0
54935,1,2,192497,192497,192499,0,2,0
54936,2,1,192499,192499,192500,0,1,0
54937,2,2,192501,192501,192503,0,2,1
54938,2,1,192503,192503,192504,0,1,0
54939,2,3,192505,192505,192508,0,3,1
54940,2,1,192507,192508,192509,1,2,0
54941,4,1,192511,192511,192512,0,1,2
54942,3,2,192514,192514,192516,0,2,2
54943,2,2,192516,192516,192518,0,2,0
54944,3,3,192519,192519,192522,0,3,1
54945,1,2,192520,192522,192524,2,4,0
54946,5,3,192525,192525,192528,0,3,1
54947,3,3,192528,192528,192531,0,3,0
54948,2,3,192530,192531,192534,1,4,0
54949,1,2,192531,192534,192536,3,5,0
54950,2,1,192533,192536,192537,3,4,0
54951,3,3,192536,192537,192540,1,4,0
54952,2,2,192538,192540,192542,2,4,0
54953,5,3,192543,192543,192546,0,3,1
54954,2,3,192545,192546,192549,1,4,0
54955,1,3,192546,192549,192552,3,6,0
54956,2,2,192548,192552,192554,4,6,0
54957,4,1,192552,192554,192555,2,3,0
54958,3,1,192555,192555,192556,0,1,0
54959,2,1,192557,192557,192558,0,1,1
54960,5,1,192562,192562,192563,0,1,4
54961,4,2,192566,192566,192568,0,2,3
54962,6,3,192572,192572,192575,0,3,4
54963,2,2,192574,192575,192577,1,3,0
54964,1,2,192575,192577,192579,2,4,0
54965,6,1,192581,192581,192582,0,1,2
54966,6,3,192587,192587,192590,0,3,5
54967,5,3,192592,192592,192595,0,3,2
54968,1,1,192593,192595,192596,2,3,0
54969,5,1,192598,192598,192599,0,1,2
54970,2,1,192600,192600,192601,0,1,1
54971,1,3,192601,192601,192604,0,3,0
54972,2,2,192603,192604,192606,1,3,0
54973,2,1,192605,192606,192607,1,2,0
54974,2,3,192607,192607,192610,0,3,0
54975,4,3,192611,192611,192614,0,3,1
54976,6,3,192617,192617,192620,0,3,3
54977,1,3,192618,192620,192623,2,5,0
54978,3,2,192621,192623,192625,2,4,0
54979,2,1,192623,192625,192626,2,3,0
54980,3,3,192626,192626,192629,0,3,0
54981,5,2,192631,192631,192633,0,2,2
54982,1,3,192632,192633,192636,1,4,0
54983,4,3,192636,192636,192639,0,3,0
54984,6,2,192642,192642,192644,0,2,3
54985,2,3,192644,192644,192647,0,3,0
54986,1,3,192645,192647,192650,2,5,0
54987,1,3,192646,192650,192653,4,7,0
54988,3,1,192649,192653,192654,4,5,0
54989,2,2,192651,192654,192656,3,5,0
54990,4,3,192655,192656,192659,1,4,0
54991,3,2,192658,192659,192661,1,3,0
54992,2,1,192660,192661,192662,1,2,0
54993,5,2,192665,192665,192667,0,2,3
54994,3,1,192668,192668,192669,0,1,1
54995,1,3,192669,192669,192672,0,3,0
54996,6,1,192675,192675,192676,0,1,3
54997,1,3,192676,192676,192679,0,3,0
54998,1,1,192677,192679,192680,2,3,0
54999,1,2,192678,192680,192682,2,4,0
55000,1,2,192679,192682,192684,3,5,0
55001,5,1,192684,192684,192685,0,1,0
55002,2,2,192686,192686,192688,0,2,1
55003,3,3,192689,192689,192692,0,3,1
55004,2,2,192691,192692,192694,1,3,0
55005,3,2,192694,192694,192696,0,2,0
55006,6,2,192700,192700,192702,0,2,4
55007,4,2,192704,192704,192706,0,2,2
55008,5,1,192709,192709,192710,0,1,3
55009,6,3,192715,192715,192718,0,3,5
55010,3,3,192718,192718,192721,0,3,0
55011,4,3,192722,192722,192725,0,3,1
55012,5,2,192727,192727,192729,0,2,2
55013,6,3,192733,192733,192736,0,3,4
55014,3,2,192736,192736,192738,0,2,0
55015,2,2,192738,192738,192740,0,2,0
55016,3,3,192741,192741,192744,0,3,1
55017,1,1,192742,192744,192745,2,3,0
55018,2,1,192744,192745,192746,1,2,0
55019,1,2,192745,192746,192748,1,3,0
55020,4,2,192749,192749,192751,0,2,1
55021,4,3,192753,192753,192756,0,3,2
55022,3,2,192756,192756,192758,0,2,0
55023,1,1,192757,192758,192759,1,2,0
55024,1,2,192758,192759,192761,1,3,0
55025,5,1,192763,192763,192764,0,1,2
55026,2,2,192765,192765,192767,0,2,1
55027,4,3,192769,192769,192772,0,3,2
55028,1,2,192770,192772,192774,2,4,0
55029,1,3,192771,192774,192777,3,6,0
55030,1,2,192772,192777,192779,5,7,0
55031,1,2,192773,192779,192781,6,8,0
55032,6,2,192779,192781,192783,2,4,0
55033,3,1,192782,192783,192784,1,2,0
55034,5,3,192787,192787,192790,0,3,3
55035,1,3,192788,192790,192793,2,5,0
55036,2,2,192790,192793,192795,3,5,0
55037,5,2,192795,192795,192797,0,2,0
55038,4,3,192799,192799,192802,0,3,2
55039,3,1,192802,192802,192803,0,1,0
55040,3,3,192805,192805,192808,0,3,2
55041,3,3,192808,192808,192811,0,3,0
55042,4,2,192812,192812,192814,0,2,1
55043,2,3,192814,192814,192817,0,3,0
55044,3,1,192817,192817,192818,0,1,0
55045,3,2,192820,192820,192822,0,2,2
55046,6,1,192826,192826,192827,0,1,4
55047,6,3,192832,192832,192835,0,3,5
55048,1,3,192833,192835,192838,2,5,0
55049,6,3,192839,192839,192842,0,3,1
55050,4,3,192843,192843,192846,0,3,1
55051,6,2,192849,192849,192851,0,2,3
55052,5,1,192854,192854,192855,0,1,3
55053,3,3,192857,192857,192860,0,3,2
55054,2,1,192859,192860,192861,1,2,0
55055,6,1,192865,192865,192866,0,1,4
55056,5,2,192870,192870,192872,0,2,4
55057,4,2,192874,192874,192876,0,2,2
55058,6,2,192880,192880,192882,0,2,4
55059,3,3,192883,192883,192886,0,3,1
55060,3,2,192886,192886,192888,0,2,0
55061,3,3,192889,192889,192892,0,3,1
55062,4,1,192893,192893,192894,0,1,1
55063,5,3,192898,192898,192901,0,3,4
55064,5,3,192903,192903,192906,0,3,2
55065,6,1,192909,192909,192910,0,1,3
55066,5,2,192914,192914,192916,0,2,4
55067,5,2,192919,192919,192921,0,2,3
55068,3,1,192922,192922,192923,0,1,1
55069,3,3,192925,192925,192928,0,3,2
55070,6,3,192931,192931,192934,0,3,3
55071,2,1,192933,192934,192935,1,2,0
55072,2,3,192935,192935,192938,0,3,0
55073,2,1,192937,192938,192939,1,2,0
55074,6,3,192943,192943,192946,0,3,4
55075,4,1,192947,192947,192948,0,1,1
55076,4,3,192951,192951,192954,0,3,3
55077,6,3,192957,192957,192960,0,3,3
55078,6,1,192963,192963,192964,0,1,3
55079,3,1,192966,192966,192967,0,1,2
55080,3,3,192969,192969,192972,0,3,2
55081,1,3,192970,192972,192975,2,5,0
55082,6,1,192976,192976,192977,0,1,1
55083,4,2,192980,192980,192982,0,2,3
55084,3,3,192983,192983,192986,0,3,1
55085,6,1,192989,192989,192990,0,1,3
55086,6,1,192995,192995,192996,0,1,5
55087,6,1,193001,193001,193002,0,1,5
55088,1,2,193002,193002,193004,0,2,0
55089,3,2,193005,193005,193007,0,2,1
55090,3,2,193008,193008,193010,0,2,1
55091,5,1,193013,193013,193014,0,1,3
55092,1,2,193014,193014,193016,0,2,0
55093,6,2,193020,193020,193022,0,2,4
55094,4,1,193024,193024,193025,0,1,2
55095,2,2,193026,193026,193028,0,2,1
55096,1,1,193027,193028,193029,1,2,0
55097,1,1,193028,193029,193030,1,2,0
55098,2,2,193030,193030,193032,0,2,0
55099,2,1,193032,193032,193033,0,1,0
55100,1,1,193033,193033,193034,0,1,0
55101,5,2,193038,193038,193040,0,2,4
55102,2,1,193040,193040,193041,0,1,0
55103,4,3,193044,193044,193047,0,3,3
55104,4,3,193048,193048,193051,0,3,1
55105,3,2,193051,193051,193053,0,2,0
55106,6,3,193057,193057,193060,0,3,4
55107,5,1,193062,193062,193063,0,1,2
55108,5,2,193067,193067,193069,0,2,4
55109,6,1,193073,193073,193074,0,1,4
55110,1,3,193074,193074,193077,0,3,0
55111,1,2,193075,193077,193079,2,4,0
55112,4,3,193079,193079,193082,0,3,0
55113,2,2,193081,193082,193084,1,3,0
55114,3,3,193084,193084,193087,0,3,0
55115,5,3,193089,193089,193092,0,3,2
55116,1,1,193090,193092,193093,2,3,0
55117,1,3,193091,193093,193096,2,5,0
55118,4,3,193095,193096,193099,1,4,0
55119,2,1,193097,193099,193100,2,3,0
55120,3,3,193100,193100,193103,0,3,0
55121,5,1,193105,193105,193106,0,1,2
55122,2,1,193107,193107,193108,0,1,1
55123,5,3,193112,193112,193115,0,3,4
55124,4,2,193116,193116,193118,0,2,1
55125,4,3,193120,193120,193123,0,3,2
55126,6,3,193126,193126,193129,0,3,3
55127,4,3,193130,193130,193133,0,3,1
55128,1,1,193131,193133,193134,2,3,0
55129,1,2,193132,193134,193136,2,4,0
55130,4,2,193136,193136,193138,0,2,0
55131,1,1,193137,193138,193139,1,2,0
55132,1,2,193138,193139,193141,1,3,0
55133,4,1,193142,193142,193143,0,1,1
55134,3,2,193145,193145,193147,0,2,2
55135,6,3,193151,193151,193154,0,3,4
55136,4,2,193155,193155,193157,0,2,1
55137,2,3,193157,193157,193160,0,3,0
55138,6,1,193163,193163,193164,0,1,3
55139,6,1,193169,193169,193170,0,1,5
55140,1,1,193170,193170,193171,0,1,0
55141,6,2,193176,193176,193178,0,2,5
55142,5,1,193181,193181,193182,0,1,3
55143,2,3,193183,193183,193186,0,3,1
55144,5,2,193188,193188,193190,0,2,2
55145,1,1,193189,193190,193191,1,2,0
55146,2,3,193191,193191,193194,0,3,0
55147,3,3,193194,193194,193197,0,3,0
55148,3,1,193197,193197,193198,0,1,0
55149,4,3,193201,193201,193204,0,3,3
55150,4,2,193205,193205,193207,0,2,1
55151,3,3,193208,193208,193211,0,3,1
55152,5,2,193213,193213,193215,0,2,2
55153,4,1,193217,193217,193218,0,1,2
55154,4,3,193221,193221,193224,0,3,3
55155,3,1,193224,193224,193225,0,1,0
55156,6,1,193230,193230,193231,0,1,5
55157,3,3,193233,193233,193236,0,3,2
55158,5,3,193238,193238,193241,0,3,2
55159,2,3,193240,193241,193244,1,4,0
55160,6,3,193246,193246,193249,0,3,2
55161,4,3,193250,193250,193253,0,3,1
55162,3,2,193253,193253,193255,0,2,0
55163,4,3,193257,193257,193260,0,3,2
55164,4,1,193261,193261,193262,0,1,1
55165,6,1,193267,193267,193268,0,1,5
55166,5,3,193272,193272,193275,0,3,4
55167,4,2,193276,193276,193278,0,2,1
55168,6,1,193282,193282,193283,0,1,4
55169,5,1,193287,193287,193288,0,1,4
55170,1,1,193288,193288,193289,0,1,0
55171,6,1,193294,193294,193295,0,1,5
55172,2,3,193296,193296,193299,0,3,1
55173,5,2,193301,193301,193303,0,2,2
55174,4,3,193305,193305,193308,0,3,2
55175,1,2,193306,193308,193310,2,4,0
55176,3,1,193309,193310,193311,1,2,0
55177,1,2,193310,193311,193313,1,3,0
55178,5,1,193315,193315,193316,0,1,2
55179,1,1,193316,193316,193317,0,1,0
55180,3,2,193319,193319,193321,0,2,2
55181,1,1,193320,193321,193322,1,2,0
55182,3,2,193323,193323,193325,0,2,1
55183,5,2,193328,193328,193330,0,2,3
55184,1,3,193329,193330,193333,1,4,0
55185,6,2,193335,193335,193337,0,2,2
55186,1,3,193336,193337,193340,1,4,0
55187,6,2,193342,193342,193344,0,2,2
55188,1,1,193343,193344,193345,1,2,0
55189,6,3,193349,193349,193352,0,3,4
55190,5,1,193354,193354,193355,0,1,2
55191,5,3,193359,193359,193362,0,3,4
55192,4,2,193363,193363,193365,0,2,1
55193,1,3,193364,193365,193368,1,4,0
55194,3,3,193367,193368,193371,1,4,0
55195,1,1,193368,193371,193372,3,4,0
55196,4,2,193372,193372,193374,0,2,0
55197,5,3,193377,193377,193380,0,3,3
55198,4,1,193381,193381,193382,0,1,1
55199,3,3,193384,193384,193387,0,3,2
55200,3,1,193387,193387,193388,0,1,0
55201,6,1,193393,193393,193394,0,1,5
55202,4,1,193397,193397,193398,0,1,3
55203,5,1,193402,193402,193403,0,1,4
55204,4,2,193406,193406,193408,0,2,3
55205,2,2,193408,193408,193410,0,2,0
55206,5,3,193413,193413,193416,0,3,3
55207,2,3,193415,193416,193419,1,4,0
55208,5,3,193420,193420,193423,0,3,1
55209,4,1,193424,193424,193425,0,1,1
55210,3,3,193427,193427,193430,0,3,2
55211,6,2,193433,193433,193435,0,2,3
55212,4,1,193437,193437,193438,0,1,2
55213,4,3,193441,193441,193444,0,3,3
55214,1,1,193442,193444,193445,2,3,0
55215,1,3,193443,193445,193448,2,5,0
55216,4,3,193447,193448,193451,1,4,0
55217,3,1,193450,193451,193452,1,2,0
55218,5,3,193455,193455,193458,0,3,3
55219,5,3,193460,193460,193463,0,3,2
55220,4,2,193464,193464,193466,0,2,1
55221,2,3,193466,193466,193469,0,3,0
55222,6,3,193472,193472,193475,0,3,3
55223,5,2,193477,193477,193479,0,2,2
55224,1,3,193478,193479,193482,1,4,0
55225,2,2,193480,193482,193484,2,4,0
55226,3,2,193483,193484,193486,1,3,0
55227,3,2,193486,193486,193488,0,2,0
55228,6,3,193492,193492,193495,0,3,4
55229,3,1,193495,193495,193496,0,1,0
55230,4,1,193499,193499,193500,0,1,3
55231,1,1,193500,193500,193501,0,1,0
55232,5,1,193505,193505,193506,0,1,4
55233,4,1,193509,193509,193510,0,1,3
55234,5,3,193514,193514,193517,0,3,4
55235,1,3,193515,193517,193520,2,5,0
55236,3,3,193518,193520,193523,2,5,0
55237,2,2,193520,193523,193525,3,5,0
55238,5,1,193525,193525,193526,0,1,0
55239,4,3,193529,193529,193532,0,3,3
55240,6,1,193535,193535,193536,0,1,3
55241,6,3,193541,193541,193544,0,3,5
55242,2,2,193543,193544,193546,1,3,0
55243,4,3,193547,193547,193550,0,3,1
55244,6,2,193553,193553,193555,0,2,3
55245,5,3,193558,193558,193561,0,3,3
55246,3,2,193561,193561,193563,0,2,0
55247,4,3,193565,193565,193568,0,3,2
55248,1,1,193566,193568,193569,2,3,0
55249,1,2,193567,193569,193571,2,4,0
55250,2,1,193569,193571,193572,2,3,0
55251,1,3,193570,193572,193575,2,5,0
55252,5,1,193575,193575,193576,0,1,0
55253,1,3,193576,193576,193579,0,3,0
55254,1,1,193577,193579,193580,2,3,0
55255,2,2,193579,193580,193582,1,3,0
55256,1,3,193580,193582,193585,2,5,0
55257,3,3,193583,193585,193588,2,5,0
55258,1,3,193584,193588,193591,4,7,0
55259,2,3,193586,193591,193594,5,8,0
55260,6,1,193592,193594,193595,2,3,0
55261,1,2,193593,193595,193597,2,4,0
55262,4,1,193597,193597,193598,0,1,0
55263,1,3,193598,193598,193601,0,3,0
55264,4,2,193602,193602,193604,0,2,1
55265,6,3,193608,193608,193611,0,3,4
55266,6,3,193614,193614,193617,0,3,3
55267,6,2,193620,193620,193622,0,2,3
55268,1,2,193621,193622,193624,1,3,0
55269,3,2,193624,193624,193626,0,2,0
55270,1,2,193625,193626,193628,1,3,0
55271,4,1,193629,193629,193630,0,1,1
55272,2,2,193631,193631,193633,0,2,1
55273,2,2,193633,193633,193635,0,2,0
55274,1,1,193634,193635,193636,1,2,0
55275,3,3,193637,193637,193640,0,3,1
55276,1,3,193638,193640,193643,2,5,0
55277,4,2,193642,193643,193645,1,3,0
55278,2,1,193644,193645,193646,1,2,0
55279,5,3,193649,193649,193652,0,3,3
55280,2,2,193651,193652,193654,1,3,0
55281,5,2,193656,193656,193658,0,2,2
55282,4,2,193660,193660,193662,0,2,2
55283,2,2,193662,193662,193664,0,2,0
55284,1,3,193663,193664,193667,1,4,0
55285,1,2,193664,193667,193669,3,5,0
55286,4,3,193668,193669,193672,1,4,0
55287,5,3,193673,193673,193676,0,3,1
55288,1,2,193674,193676,193678,2,4,0
55289,4,3,193678,193678,193681,0,3,0
55290,3,2,193681,193681,193683,0,2,0
55291,5,2,193686,193686,193688,0,2,3
55292,1,1,193687,193688,193689,1,2,0
55293,2,3,193689,193689,193692,0,3,0
55294,4,1,193693,193693,193694,0,1,1
55295,2,2,193695,193695,193697,0,2,1
55296,6,1,193701,193701,193702,0,1,4
55297,2,1,193703,193703,193704,0,1,1
55298,4,2,193707,193707,193709,0,2,3
55299,6,3,193713,193713,193716,0,3,4
55300,2,3,193715,193716,193719,1,4,0
55301,6,2,193721,193721,193723,0,2,2
55302,6,2,193727,193727,193729,0,2,4
55303,4,1,193731,193731,193732,0,1,2
55304,6,1,193737,193737,193738,0,1,5
55305,2,3,193739,193739,193742,0,3,1
55306,5,3,193744,193744,193747,0,3,2
55307,5,2,193749,193749,193751,0,2,2
55308,5,2,193754,193754,193756,0,2,3
55309,6,1,193760,193760,193761,0,1,4
55310,1,1,193761,193761,193762,0,1,0
55311,6,2,193767,193767,193769,0,2,5
55312,4,2,193771,193771,193773,0,2,2
55313,1,1,193772,193773,193774,1,2,0
55314,6,2,193778,193778,193780,0,2,4
55315,6,2,193784,193784,193786,0,2,4
55316,1,3,193785,193786,193789,1,4,0
55317,6,3,193791,193791,193794,0,3,2
55318,1,2,193792,193794,193796,2,4,0
55319,2,1,193794,193796,193797,2,3,0
55320,3,3,193797,193797,193800,0,3,0
55321,1,1,193798,193800,193801,2,3,0
55322,2,1,193800,193801,193802,1,2,0
55323,4,2,193804,193804,193806,0,2,2
55324,5,2,193809,193809,193811,0,2,3
55325,1,2,193810,193811,193813,1,3,0
55326,5,1,193815,193815,193816,0,1,2
55327,1,1,193816,193816,193817,0,1,0
55328,1,3,193817,193817,193820,0,3,0
55329,5,1,193822,193822,193823,0,1,2
55330,4,2,193826,193826,193828,0,2,3
55331,6,1,193832,193832,193833,0,1,4
55332,4,2,193836,193836,193838,0,2,3
55333,6,2,193842,193842,193844,0,2,4
55334,6,2,193848,193848,193850,0,2,4
55335,3,3,193851,193851,193854,0,3,1
55336,2,3,193853,193854,193857,1,4,0
55337,4,1,193857,193857,193858,0,1,0
55338,2,2,193859,193859,193861,0,2,1
55339,5,2,193864,193864,193866,0,2,3
55340,1,2,193865,193866,193868,1,3,0
55341,5,2,193870,193870,193872,0,2,2
55342,3,1,193873,193873,193874,0,1,1
55343,1,1,193874,193874,193875,0,1,0
55344,5,1,193879,193879,193880,0,1,4
55345,6,3,193885,193885,193888,0,3,5
55346,6,3,193891,193891,193894,0,3,3
55347,2,2,193893,193894,193896,1,3,0
55348,1,1,193894,193896,193897,2,3,0
55349,4,1,193898,193898,193899,0,1,1
55350,1,3,193899,193899,193902,0,3,0
55351,4,2,193903,193903,193905,0,2,1
55352,3,3,193906,193906,193909,0,3,1
55353,6,1,193912,193912,193913,0,1,3
55354,3,1,193915,193915,193916,0,1,2
55355,6,1,193921,193921,193922,0,1,5
55356,4,2,193925,193925,193927,0,2,3
55357,4,2,193929,193929,193931,0,2,2
55358,1,3,193930,193931,193934,1,4,0
55359,2,1,193932,193934,193935,2,3,0
55360,3,1,193935,193935,193936,0,1,0
55361,1,1,193936,193936,193937,0,1,0
55362,1,2,193937,193937,193939,0,2,0
55363,2,3,193939,193939,193942,0,3,0
55364,3,1,193942,193942,193943,0,1,0
55365,4,1,193946,193946,193947,0,1,3
55366,2,2,193948,193948,193950,0,2,1
55367,2,1,193950,193950,193951,0,1,0
55368,4,3,193954,193954,193957,0,3,3
55369,4,2,193958,193958,193960,0,2,1
55370,1,1,193959,193960,193961,1,2,0
55371,1,1,193960,193961,193962,1,2,0
55372,1,3,193961,193962,193965,1,4,0
55373,4,3,193965,193965,193968,0,3,0
55374,2,1,193967,193968,193969,1,2,0
55375,5,2,193972,193972,193974,0,2,3
55376,3,2,193975,193975,193977,0,2,1
55377,6,3,193981,193981,193984,0,3,4
55378,3,2,193984,193984,193986,0,2,0
55379,5,1,193989,193989,193990,0,1,3
55380,3,2,193992,193992,193994,0,2,2
55381,4,3,193996,193996,193999,0,3,2
55382,2,3,193998,193999,194002,1,4,0
55383,5,2,194003,194003,194005,0,2,1
55384,4,3,194007,194007,194010,0,3,2
55385,1,1,194008,194010,194011,2,3,0
55386,5,2,194013,194013,194015,0,2,2
55387,1,1,194014,194015,194016,1,2,0
55388,4,1,194018,194018,194019,0,1,2
55389,6,2,194024,194024,194026,0,2,5
55390,6,1,194030,194030,194031,0,1,4
55391,3,3,194033,194033,194036,0,3,2
55392,6,3,194039,194039,194042,0,3,3
55393,6,3,194045,194045,194048,0,3,3
55394,6,1,194051,194051,194052,0,1,3
55395,3,3,194054,194054,194057,0,3,2
55396,1,2,194055,194057,194059,2,4,0
55397,1,1,194056,194059,194060,3,4,0
55398,6,2,194062,194062,194064,0,2,2
55399,4,2,194066,194066,194068,0,2,2
55400,6,1,194072,194072,194073,0,1,4
55401,3,3,194075,194075,194078,0,3,2
55402,4,2,194079,194079,194081,0,2,1
55403,5,3,194084,194084,194087,0,3,3
55404,5,2,194089,194089,194091,0,2,2
55405,6,3,194095,194095,194098,0,3,4
55406,3,3,194098,194098,194101,0,3,0
55407,3,3,194101,194101,194104,0,3,0
55408,4,3,194105,194105,194108,0,3,1
55409,4,3,194109,194109,194112,0,3,1
55410,6,2,194115,194115,194117,0,2,3
55411,6,1,194121,194121,194122,0,1,4
55412,1,2,194122,194122,194124,0,2,0
55413,3,3,194125,194125,194128,0,3,1
55414,2,1,194127,194128,194129,1,2,0
55415,4,3,194131,194131,194134,0,3,2
55416,2,3,194133,194134,194137,1,4,0
55417,1,1,194134,194137,194138,3,4,0
55418,2,3,194136,194138,194141,2,5,0
55419,1,1,194137,194141,194142,4,5,0
55420,6,3,194143,194143,194146,0,3,1
55421,6,3,194149,194149,194152,0,3,3
55422,4,3,194153,194153,194156,0,3,1
55423,6,3,194159,194159,194162,0,3,3
55424,4,2,194163,194163,194165,0,2,1
55425,4,1,194167,194167,194168,0,1,2
55426,4,2,194171,194171,194173,0,2,3
55427,6,2,194177,194177,194179,0,2,4
55428,3,1,194180,194180,194181,0,1,1
55429,4,2,194184,194184,194186,0,2,3
55430,6,2,194190,194190,194192,0,2,4
55431,4,1,194194,194194,194195,0,1,2
55432,3,1,194197,194197,194198,0,1,2
55433,3,3,194200,194200,194203,0,3,2
55434,2,2,194202,194203,194205,1,3,0
55435,1,2,194203,194205,194207,2,4,0
55436,6,3,194209,194209,194212,0,3,2
55437,2,1,194211,194212,194213,1,2,0
55438,5,1,194216,194216,194217,0,1,3
55439,2,1,194218,194218,194219,0,1,1
55440,5,3,194223,194223,194226,0,3,4
55441,5,2,194228,194228,194230,0,2,2
55442,6,3,194234,194234,194237,0,3,4
55443,5,2,194239,194239,194241,0,2,2
55444,6,3,194245,194245,194248,0,3,4
55445,4,2,194249,194249,194251,0,2,1
55446,6,1,194255,194255,194256,0,1,4
55447,4,2,194259,194259,194261,0,2,3
55448,3,2,194262,194262,194264,0,2,1
55449,5,1,194267,194267,194268,0,1,3
55450,5,1,194272,194272,194273,0,1,4
55451,2,3,194274,194274,194277,0,3,1
55452,1,2,194275,194277,194279,2,4,0
55453,4,1,194279,194279,194280,0,1,0
55454,4,2,194283,194283,194285,0,2,3
55455,6,1,194289,194289,194290,0,1,4
55456,2,1,194291,194291,194292,0,1,1
55457,5,3,194296,194296,194299,0,3,4
55458,1,2,194297,194299,194301,2,4,0
55459,2,1,194299,194301,194302,2,3,0
55460,2,3,194301,194302,194305,1,4,0
55461,1,1,194302,194305,194306,3,4,0
55462,6,2,194308,194308,194310,0,2,2
55463,5,3,194313,194313,194316,0,3,3
55464,4,3,194317,194317,194320,0,3,1
55465,3,2,194320,194320,194322,0,2,0
55466,6,2,194326,194326,194328,0,2,4
55467,5,1,194331,194331,194332,0,1,3
55468,1,2,194332,194332,194334,0,2,0
55469,5,3,194337,194337,194340,0,3,3
55470,5,2,194342,194342,194344,0,2,2
55471,2,3,194344,194344,194347,0,3,0
55472,1,2,194345,194347,194349,2,4,0
55473,5,2,194350,194350,194352,0,2,1
55474,2,2,194352,194352,194354,0,2,0
55475,6,2,194358,194358,194360,0,2,4
55476,1,1,194359,194360,194361,1,2,0
55477,4,3,194363,194363,194366,0,3,2
55478,5,3,194368,194368,194371,0,3,2
55479,3,2,194371,194371,194373,0,2,0
55480,1,3,194372,194373,194376,1,4,0
55481,6,1,194378,194378,194379,0,1,2
55482,4,2,194382,194382,194384,0,2,3
55483,3,2,194385,194385,194387,0,2,1
55484,6,1,194391,194391,194392,0,1,4
55485,1,1,194392,194392,194393,0,1,0
55486,4,1,194396,194396,194397,0,1,3
55487,6,1,194402,194402,194403,0,1,5
55488,6,2,194408,194408,194410,0,2,5
55489,1,3,194409,194410,194413,1,4,0
55490,6,2,194415,194415,194417,0,2,2
55491,1,2,194416,194417,194419,1,3,0
55492,2,2,194418,194419,194421,1,3,0
55493,3,2,194421,194421,194423,0,2,0
55494,1,1,194422,194423,194424,1,2,0
55495,5,1,194427,194427,194428,0,1,3
55496,3,1,194430,194430,194431,0,1,2
55497,6,3,194436,194436,194439,0,3,5
55498,3,1,194439,194439,194440,0,1,0
55499,4,1,194443,194443,194444,0,1,3
55500,4,1,194447,194447,194448,0,1,3
55501,1,1,194448,194448,194449,0,1,0
55502,6,2,194454,194454,194456,0,2,5
55503,1,3,194455,194456,194459,1,4,0
55504,3,1,194458,194459,194460,1,2,0
55505,4,3,194462,194462,194465,0,3,2
55506,5,2,194467,194467,194469,0,2,2
55507,3,1,194470,194470,194471,0,1,1
55508,6,3,194476,194476,194479,0,3,5
55509,3,2,194479,194479,194481,0,2,0
55510,6,2,194485,194485,194487,0,2,4
55511,6,2,194491,194491,194493,0,2,4
55512,2,2,194493,194493,194495,0,2,0
55513,1,1,194494,194495,194496,1,2,0
55514,5,2,194499,194499,194501,0,2,3
55515,4,1,194503,194503,194504,0,1,2
55516,4,3,194507,194507,194510,0,3,3
55517,3,1,194510,194510,194511,0,1,0
55518,6,2,194516,194516,194518,0,2,5
55519,3,3,194519,194519,194522,0,3,1
55520,2,3,194521,194522,194525,1,4,0
55521,5,3,194526,194526,194529,0,3,1
55522,4,1,194530,194530,194531,0,1,1
55523,4,1,194534,194534,194535,0,1,3
55524,6,2,194540,194540,194542,0,2,5
55525,3,2,194543,194543,194545,0,2,1
55526,1,1,194544,194545,194546,1,2,0
55527,3,2,194547,194547,194549,0,2,1
55528,6,3,194553,194553,194556,0,3,4
55529,1,1,194554,194556,194557,2,3,0
55530,3,1,194557,194557,194558,0,1,0
55531,5,3,194562,194562,194565,0,3,4
55532,4,1,194566,194566,194567,0,1,1
55533,1,2,194567,194567,194569,0,2,0
55534,2,2,194569,194569,194571,0,2,0
55535,1,1,194570,194571,194572,1,2,0
55536,4,1,194574,194574,194575,0,1,2
55537,5,1,194579,194579,194580,0,1,4
55538,1,3,194580,194580,194583,0,3,0
55539,4,2,194584,194584,194586,0,2,1
55540,4,1,194588,194588,194589,0,1,2
55541,2,3,194590,194590,194593,0,3,1
55542,3,3,194593,194593,194596,0,3,0
55543,2,3,194595,194596,194599,1,4,0
55544,3,1,194598,194599,194600,1,2,0
55545,6,2,194604,194604,194606,0,2,4
55546,3,2,194607,194607,194609,0,2,1
55547,3,2,194610,194610,194612,0,2,1
55548,5,2,194615,194615,194617,0,2,3
55549,2,2,194617,194617,194619,0,2,0
55550,6,3,194623,194623,194626,0,3,4
55551,3,2,194626,194626,194628,0,2,0
55552,5,3,194631,194631,194634,0,3,3
55553,3,2,194634,194634,194636,0,2,0
55554,2,3,194636,194636,194639,0,3,0
55555,1,1,194637,194639,194640,2,3,0
55556,4,3,194641,194641,194644,0,3,1
55557,4,2,194645,194645,194647,0,2,1
55558,5,1,194650,194650,194651,0,1,3
55559,6,2,194656,194656,194658,0,2,5
55560,2,1,194658,194658,194659,0,1,0
55561,1,3,194659,194659,194662,0,3,0
55562,5,1,194664,194664,194665,0,1,2
55563,4,1,194668,194668,194669,0,1,3
55564,5,3,194673,194673,194676,0,3,4
55565,2,3,194675,194676,194679,1,4,0
55566,4,1,194679,194679,194680,0,1,0
55567,2,3,194681,194681,194684,0,3,1
55568,1,3,194682,194684,194687,2,5,0
55569,2,2,194684,194687,194689,3,5,0
55570,5,2,194689,194689,194691,0,2,0
55571,3,2,194692,194692,194694,0,2,1
55572,5,3,194697,194697,194700,0,3,3
55573,6,3,194703,194703,194706,0,3,3
55574,6,1,194709,194709,194710,0,1,3
55575,2,3,194711,194711,194714,0,3,1
55576,6,2,194717,194717,194719,0,2,3
55577,4,1,194721,194721,194722,0,1,2
55578,1,2,194722,194722,194724,0,2,0
55579,2,1,194724,194724,194725,0,1,0
55580,4,1,194728,194728,194729,0,1,3
55581,1,2,194729,194729,194731,0,2,0
55582,2,2,194731,194731,194733,0,2,0
55583,2,1,194733,194733,194734,0,1,0
55584,6,1,194739,194739,194740,0,1,5
55585,5,2,194744,194744,194746,0,2,4
55586,1,2,194745,194746,194748,1,3,0
55587,5,2,194750,194750,194752,0,2,2
55588,3,3,194753,194753,194756,0,3,1
55589,6,1,194759,194759,194760,0,1,3
55590,2,1,194761,194761,194762,0,1,1
55591,3,3,194764,194764,194767,0,3,2
55592,2,2,194766,194767,194769,1,3,0
55593,6,1,194772,194772,194773,0,1,3
55594,1,2,194773,194773,194775,0,2,0
55595,4,1,194777,194777,194778,0,1,2
55596,1,1,194778,194778,194779,0,1,0
55597,1,2,194779,194779,194781,0,2,0
55598,1,3,194780,194781,194784,1,4,0
55599,3,3,194783,194784,194787,1,4,0
55600,5,1,194788,194788,194789,0,1,1
55601,3,2,194791,194791,194793,0,2,2
55602,1,1,194792,194793,194794,1,2,0
55603,4,2,194796,194796,194798,0,2,2
55604,5,3,194801,194801,194804,0,3,3
55605,1,2,194802,194804,194806,2,4,0
55606,3,3,194805,194806,194809,1,4,0
55607,5,3,194810,194810,194813,0,3,1
55608,5,1,194815,194815,194816,0,1,2
55609,5,3,194820,194820,194823,0,3,4
55610,3,1,194823,194823,194824,0,1,0
55611,4,2,194827,194827,194829,0,2,3
55612,1,1,194828,194829,194830,1,2,0
55613,5,1,194833,194833,194834,0,1,3
55614,3,2,194836,194836,194838,0,2,2
55615,2,1,194838,194838,194839,0,1,0
55616,5,1,194843,194843,194844,0,1,4
55617,6,3,194849,194849,194852,0,3,5
55618,4,2,194853,194853,194855,0,2,1
55619,2,1,194855,194855,194856,0,1,0
55620,5,3,194860,194860,194863,0,3,4
55621,1,3,194861,194863,194866,2,5,0
55622,5,3,194866,194866,194869,0,3,0
55623,3,2,194869,194869,194871,0,2,0
55624,5,3,194874,194874,194877,0,3,3
55625,2,1,194876,194877,194878,1,2,0
55626,4,2,194880,194880,194882,0,2,2
55627,6,2,194886,194886,194888,0,2,4
55628,2,3,194888,194888,194891,0,3,0
55629,1,1,194889,194891,194892,2,3,0
55630,2,1,194891,194892,194893,1,2,0
55631,5,3,194896,194896,194899,0,3,3
55632,2,1,194898,194899,194900,1,2,0
55633,6,3,194904,194904,194907,0,3,4
55634,2,2,194906,194907,194909,1,3,0
55635,3,1,194909,194909,194910,0,1,0
55636,5,1,194914,194914,194915,0,1,4
55637,4,2,194918,194918,194920,0,2,3
55638,4,3,194922,194922,194925,0,3,2
55639,5,3,194927,194927,194930,0,3,2
55640,1,1,194928,194930,194931,2,3,0
55641,4,1,194932,194932,194933,0,1,1
55642,3,2,194935,194935,194937,0,2,2
55643,3,3,194938,194938,194941,0,3,1
55644,1,3,194939,194941,194944,2,5,0
55645,5,1,194944,194944,194945,0,1,0
55646,4,1,194948,194948,194949,0,1,3
55647,1,2,194949,194949,194951,0,2,0
55648,1,3,194950,194951,194954,1,4,0
55649,1,1,194951,194954,194955,3,4,0
55650,5,1,194956,194956,194957,0,1,1
55651,6,3,194962,194962,194965,0,3,5
55652,5,3,194967,194967,194970,0,3,2
55653,4,2,194971,194971,194973,0,2,1
55654,3,1,194974,194974,194975,0,1,1
55655,5,1,194979,194979,194980,0,1,4
55656,3,2,194982,194982,194984,0,2,2
55657,5,3,194987,194987,194990,0,3,3
55658,1,1,194988,194990,194991,2,3,0
55659,1,3,194989,194991,194994,2,5,0
55660,5,1,194994,194994,194995,0,1,0
55661,6,2,195000,195000,195002,0,2,5
55662,2,1,195002,195002,195003,0,1,0
55663,3,3,195005,195005,195008,0,3,2
55664,5,1,195010,195010,195011,0,1,2
55665,3,1,195013,195013,195014,0,1,2
55666,6,1,195019,195019,195020,0,1,5
55667,6,1,195025,195025,195026,0,1,5
55668,4,3,195029,195029,195032,0,3,3
55669,5,3,195034,195034,195037,0,3,2
55670,6,3,195040,195040,195043,0,3,3
55671,3,2,195043,195043,195045,0,2,0
55672,4,2,195047,195047,195049,0,2,2
55673,2,3,195049,195049,195052,0,3,0
55674,2,3,195051,195052,195055,1,4,0
55675,3,3,195054,195055,195058,1,4,0
55676,3,3,195057,195058,195061,1,4,0
55677,4,1,195061,195061,195062,0,1,0
55678,1,1,195062,195062,195063,0,1,0
55679,5,1,195067,195067,195068,0,1,4
55680,2,1,195069,195069,195070,0,1,1
55681,3,1,195072,195072,195073,0,1,2
55682,2,2,195074,195074,195076,0,2,1
55683,3,3,195077,195077,195080,0,3,1
55684,5,2,195082,195082,195084,0,2,2
55685,3,1,195085,195085,195086,0,1,1
55686,2,3,195087,195087,195090,0,3,1
55687,3,1,195090,195090,195091,0,1,0
55688,6,2,195096,195096,195098,0,2,5
55689,5,2,195101,195101,195103,0,2,3
55690,5,1,195106,195106,195107,0,1,3
55691,5,2,195111,195111,195113,0,2,4
55692,5,3,195116,195116,195119,0,3,3
55693,1,2,195117,195119,195121,2,4,0
55694,4,3,195121,195121,195124,0,3,0
55695,1,1,195122,195124,195125,2,3,0
55696,3,3,195125,195125,195128,0,3,0
55697,1,2,195126,195128,195130,2,4,0
55698,2,3,195128,195130,195133,2,5,0
55699,5,1,195133,195133,195134,0,1,0
55700,6,2,195139,195139,195141,0,2,5
55701,6,1,195145,195145,195146,0,1,4
55702,5,2,195150,195150,195152,0,2,4
55703,1,1,195151,195152,195153,1,2,0
55704,2,1,195153,195153,195154,0,1,0
55705,6,2,195159,195159,195161,0,2,5
55706,1,2,195160,195161,195163,1,3,0
55707,3,3,195163,195163,195166,0,3,0
55708,3,2,195166,195166,195168,0,2,0
55709,1,2,195167,195168,195170,1,3,0
55710,6,1,195173,195173,195174,0,1,3
55711,6,3,195179,195179,195182,0,3,5
55712,5,2,195184,195184,195186,0,2,2
55713,2,1,195186,195186,195187,0,1,0
55714,2,1,195188,195188,195189,0,1,1
55715,6,2,195194,195194,195196,0,2,5
55716,6,1,195200,195200,195201,0,1,4
55717,1,2,195201,195201,195203,0,2,0
55718,3,1,195204,195204,195205,0,1,1
55719,6,3,195210,195210,195213,0,3,5
55720,4,2,195214,195214,195216,0,2,1
55721,2,2,195216,195216,195218,0,2,0
55722,2,2,195218,195218,195220,0,2,0
55723,6,2,195224,195224,195226,0,2,4
55724,3,2,195227,195227,195229,0,2,1
55725,5,1,195232,195232,195233,0,1,3
55726,4,1,195236,195236,195237,0,1,3
55727,2,1,195238,195238,195239,0,1,1
55728,2,2,195240,195240,195242,0,2,1
55729,2,2,195242,195242,195244,0,2,0
55730,3,1,195245,195245,195246,0,1,1
55731,2,3,195247,195247,195250,0,3,1
55732,3,1,195250,195250,195251,0,1,0
55733,5,1,195255,195255,195256,0,1,4
55734,6,3,195261,195261,195264,0,3,5
55735,5,1,195266,195266,195267,0,1,2
55736,3,1,195269,195269,195270,0,1,2
55737,5,3,195274,195274,195277,0,3,4
55738,5,3,195279,195279,195282,0,3,2
55739,1,2,195280,195282,195284,2,4,0
55740,5,2,195285,195285,195287,0,2,1
55741,5,1,195290,195290,195291,0,1,3
55742,3,3,195293,195293,195296,0,3,2
55743,4,3,195297,195297,195300,0,3,1
55744,6,3,195303,195303,195306,0,3,3
55745,6,3,195309,195309,195312,0,3,3
55746,3,3,195312,195312,195315,0,3,0
55747,5,3,195317,195317,195320,0,3,2
55748,6,3,195323,195323,195326,0,3,3
55749,4,3,195327,195327,195330,0,3,1
55750,4,1,195331,195331,195332,0,1,1
55751,1,3,195332,195332,195335,0,3,0
55752,3,2,195335,195335,195337,0,2,0
55753,2,3,195337,195337,195340,0,3,0
55754,3,1,195340,195340,195341,0,1,0
55755,2,3,195342,195342,195345,0,3,1
55756,4,1,195346,195346,195347,0,1,1
55757,5,1,195351,195351,195352,0,1,4
55758,2,2,195353,195353,195355,0,2,1
55759,2,3,195355,195355,195358,0,3,0
55760,4,1,195359,195359,195360,0,1,1
55761,4,1,195363,195363,195364,0,1,3
55762,1,1,195364,195364,195365,0,1,0
55763,3,1,195367,195367,195368,0,1,2
55764,4,3,195371,195371,195374,0,3,3
55765,6,1,195377,195377,195378,0,1,3
55766,6,2,195383,195383,195385,0,2,5
55767,6,1,195389,195389,195390,0,1,4
55768,4,2,195393,195393,195395,0,2,3
55769,1,3,195394,195395,195398,1,4,0
55770,5,3,195399,195399,195402,0,3,1
55771,5,1,195404,195404,195405,0,1,2
55772,5,3,195409,195409,195412,0,3,4
55773,5,2,195414,195414,195416,0,2,2
55774,6,1,195420,195420,195421,0,1,4
55775,4,3,195424,195424,195427,0,3,3
55776,2,2,195426,195427,195429,1,3,0
55777,1,2,195427,195429,195431,2,4,0
55778,1,3,195428,195431,195434,3,6,0
55779,3,1,195431,195434,195435,3,4,0
55780,6,3,195437,195437,195440,0,3,2
55781,6,2,195443,195443,195445,0,2,3
55782,5,2,195448,195448,195450,0,2,3
55783,2,1,195450,195450,195451,0,1,0
55784,1,1,195451,195451,195452,0,1,0
55785,1,3,195452,195452,195455,0,3,0
55786,6,2,195458,195458,195460,0,2,3
55787,2,1,195460,195460,195461,0,1,0
55788,4,1,195464,195464,195465,0,1,3
55789,2,1,195466,195466,195467,0,1,1
55790,5,3,195471,195471,195474,0,3,4
55791,3,1,195474,195474,195475,0,1,0
55792,3,3,195477,195477,195480,0,3,2
55793,1,2,195478,195480,195482,2,4,0
55794,2,1,195480,195482,195483,2,3,0
55795,6,3,195486,195486,195489,0,3,3
55796,3,3,195489,195489,195492,0,3,0
55797,1,2,195490,195492,195494,2,4,0
55798,6,3,195496,195496,195499,0,3,2
55799,1,2,195497,195499,195501,2,4,0
55800,3,1,195500,195501,195502,1,2,0
55801,1,3,195501,195502,195505,1,4,0
55802,2,1,195503,195505,195506,2,3,0
55803,3,2,195506,195506,195508,0,2,0
55804,4,1,195510,195510,195511,0,1,2
55805,6,3,195516,195516,195519,0,3,5
55806,6,2,195522,195522,195524,0,2,3
55807,6,1,195528,195528,195529,0,1,4
55808,3,2,195531,195531,195533,0,2,2
55809,3,3,195534,195534,195537,0,3,1
55810,4,2,195538,195538,195540,0,2,1
55811,3,3,195541,195541,195544,0,3,1
55812,4,3,195545,195545,195548,0,3,1
55813,5,1,195550,195550,195551,0,1,2
55814,1,3,195551,195551,195554,0,3,0
55815,2,1,195553,195554,195555,1,2,0
55816,1,2,195554,195555,195557,1,3,0
55817,3,3,195557,195557,195560,0,3,0
55818,2,1,195559,195560,195561,1,2,0
55819,1,2,195560,195561,195563,1,3,0
55820,3,1,195563,195563,195564,0,1,0
55821,1,1,195564,195564,195565,0,1,0
55822,2,2,195566,195566,195568,0,2,1
55823,1,1,195567,195568,195569,1,2,0
55824,6,2,195573,195573,195575,0,2,4
55825,5,2,195578,195578,195580,0,2,3
55826,1,1,195579,195580,195581,1,2,0
55827,6,3,195585,195585,195588,0,3,4
55828,5,2,195590,195590,195592,0,2,2
55829,5,2,195595,195595,195597,0,2,3
55830,6,2,195601,195601,195603,0,2,4
55831,1,2,195602,195603,195605,1,3,0
55832,6,2,195608,195608,195610,0,2,3
55833,6,3,195614,195614,195617,0,3,4
55834,3,2,195617,195617,195619,0,2,0
55835,6,2,195623,195623,195625,0,2,4
55836,4,1,195627,195627,195628,0,1,2
55837,4,2,195631,195631,195633,0,2,3
55838,5,3,195636,195636,195639,0,3,3
55839,2,3,195638,195639,195642,1,4,0
55840,5,1,195643,195643,195644,0,1,1
55841,3,3,195646,195646,195649,0,3,2
55842,1,3,195647,195649,195652,2,5,0
55843,6,2,195653,195653,195655,0,2,1
55844,1,2,195654,195655,195657,1,3,0
55845,2,1,195656,195657,195658,1,2,0
55846,4,2,195660,195660,195662,0,2,2
55847,1,2,195661,195662,195664,1,3,0
55848,4,3,195665,195665,195668,0,3,1
55849,5,1,195670,195670,195671,0,1,2
55850,6,3,195676,195676,195679,0,3,5
55851,3,2,195679,195679,195681,0,2,0
55852,4,3,195683,195683,195686,0,3,2
55853,5,1,195688,195688,195689,0,1,2
55854,1,3,195689,195689,195692,0,3,0
55855,3,2,195692,195692,195694,0,2,0
55856,5,3,195697,195697,195700,0,3,3
55857,6,1,195703,195703,195704,0,1,3
55858,5,3,195708,195708,195711,0,3,4
55859,4,1,195712,195712,195713,0,1,1
55860,4,2,195716,195716,195718,0,2,3
55861,3,2,195719,195719,195721,0,2,1
55862,5,1,195724,195724,195725,0,1,3
55863,4,2,195728,195728,195730,0,2,3
55864,4,2,195732,195732,195734,0,2,2
55865,5,3,195737,195737,195740,0,3,3
55866,6,2,195743,195743,195745,0,2,3
55867,5,1,195748,195748,195749,0,1,3
55868,4,2,195752,195752,195754,0,2,3
55869,1,3,195753,195754,195757,1,4,0
55870,6,3,195759,195759,195762,0,3,2
55871,4,2,195763,195763,195765,0,2,1
55872,4,3,195767,195767,195770,0,3,2
55873,2,2,195769,195770,195772,1,3,0
55874,1,2,195770,195772,195774,2,4,0
55875,2,2,195772,195774,195776,2,4,0
55876,3,1,195775,195776,195777,1,2,0
55877,3,1,195778,195778,195779,0,1,1
55878,2,2,195780,195780,195782,0,2,1
55879,2,3,195782,195782,195785,0,3,0
55880,6,1,195788,195788,195789,0,1,3
55881,5,2,195793,195793,195795,0,2,4
55882,4,3,195797,195797,195800,0,3,2
55883,5,3,195802,195802,195805,0,3,2
55884,2,1,195804,195805,195806,1,2,0
55885,1,2,195805,195806,195808,1,3,0
55886,1,2,195806,195808,195810,2,4,0
55887,3,3,195809,195810,195813,1,4,0
55888,5,2,195814,195814,195816,0,2,1
55889,1,2,195815,195816,195818,1,3,0
55890,5,2,195820,195820,195822,0,2,2
55891,4,1,195824,195824,195825,0,1,2
55892,5,1,195829,195829,195830,0,1,4
55893,5,1,195834,195834,195835,0,1,4
55894,1,3,195835,195835,195838,0,3,0
55895,6,3,195841,195841,195844,0,3,3
55896,2,3,195843,195844,195847,1,4,0
55897,4,3,195847,195847,195850,0,3,0
55898,3,1,195850,195850,195851,0,1,0
55899,3,1,195853,195853,195854,0,1,2
55900,6,1,195859,195859,195860,0,1,5
55901,5,2,195864,195864,195866,0,2,4
55902,6,1,195870,195870,195871,0,1,4
55903,5,3,195875,195875,195878,0,3,4
55904,3,3,195878,195878,195881,0,3,0
55905,1,2,195879,195881,195883,2,4,0
55906,4,1,195883,195883,195884,0,1,0
55907,3,1,195886,195886,195887,0,1,2
55908,4,3,195890,195890,195893,0,3,3
55909,2,1,195892,195893,195894,1,2,0
55910,3,2,195895,195895,195897,0,2,1
55911,2,1,195897,195897,195898,0,1,0
55912,4,2,195901,195901,195903,0,2,3
55913,6,1,195907,195907,195908,0,1,4
55914,5,2,195912,195912,195914,0,2,4
55915,4,3,195916,195916,195919,0,3,2
55916,3,1,195919,195919,195920,0,1,0
55917,1,2,195920,195920,195922,0,2,0
55918,3,1,195923,195923,195924,0,1,1
55919,4,3,195927,195927,195930,0,3,3
55920,1,3,195928,195930,195933,2,5,0
55921,5,2,195933,195933,195935,0,2,0
55922,6,2,195939,195939,195941,0,2,4
55923,4,3,195943,195943,195946,0,3,2
55924,3,3,195946,195946,195949,0,3,0
55925,3,3,195949,195949,195952,0,3,0
55926,6,3,195955,195955,195958,0,3,3
55927,2,1,195957,195958,195959,1,2,0
55928,5,2,195962,195962,195964,0,2,3
55929,5,2,195967,195967,195969,0,2,3
55930,4,3,195971,195971,195974,0,3,2
55931,3,2,195974,195974,195976,0,2,0
55932,3,1,195977,195977,195978,0,1,1
55933,2,2,195979,195979,195981,0,2,1
55934,6,2,195985,195985,195987,0,2,4
55935,1,1,195986,195987,195988,1,2,0
55936,1,2,195987,195988,195990,1,3,0
55937,2,3,195989,195990,195993,1,4,0
55938,1,3,195990,195993,195996,3,6,0
55939,2,3,195992,195996,195999,4,7,0
55940,1,2,195993,195999,196001,6,8,0
55941,2,2,195995,196001,196003,6,8,0
55942,4,2,195999,196003,196005,4,6,0
55943,3,2,196002,196005,196007,3,5,0
55944,5,1,196007,196007,196008,0,1,0
55945,1,2,196008,196008,196010,0,2,0
55946,2,3,196010,196010,196013,0,3,0
55947,1,3,196011,196013,196016,2,5,0
55948,2,3,196013,196016,196019,3,6,0
55949,5,1,196018,196019,196020,1,2,0
55950,2,3,196020,196020,196023,0,3,0
55951,1,3,196021,196023,196026,2,5,0
55952,4,3,196025,196026,196029,1,4,0
55953,5,3,196030,196030,196033,0,3,1
55954,4,2,196034,196034,196036,0,2,1
55955,6,2,196040,196040,196042,0,2,4
55956,3,2,196043,196043,196045,0,2,1
55957,3,2,196046,196046,196048,0,2,1
55958,2,2,196048,196048,196050,0,2,0
55959,3,2,196051,196051,196053,0,2,1
55960,5,2,196056,196056,196058,0,2,3
55961,6,1,196062,196062,196063,0,1,4
55962,2,2,196064,196064,196066,0,2,1
55963,1,1,196065,196066,196067,1,2,0
55964,5,3,196070,196070,196073,0,3,3
55965,6,2,196076,196076,196078,0,2,3
55966,6,2,196082,196082,196084,0,2,4
55967,2,3,196084,196084,196087,0,3,0
55968,6,3,196090,196090,196093,0,3,3
55969,1,2,196091,196093,196095,2,4,0
55970,3,2,196094,196095,196097,1,3,0
55971,5,2,196099,196099,196101,0,2,2
55972,2,1,196101,196101,196102,0,1,0
55973,1,1,196102,196102,196103,0,1,0
55974,5,3,196107,196107,196110,0,3,4
55975,6,1,196113,196113,196114,0,1,3
55976,2,3,196115,196115,196118,0,3,1
55977,1,2,196116,196118,196120,2,4,0
55978,3,1,196119,196120,196121,1,2,0
55979,2,3,196121,196121,196124,0,3,0
55980,1,3,196122,196124,196127,2,5,0
55981,1,2,196123,196127,196129,4,6,0
55982,4,2,196127,196129,196131,2,4,0
55983,4,2,196131,196131,196133,0,2,0
55984,4,3,196135,196135,196138,0,3,2
55985,6,1,196141,196141,196142,0,1,3
55986,4,2,196145,196145,196147,0,2,3
55987,4,2,196149,196149,196151,0,2,2
55988,5,1,196154,196154,196155,0,1,3
55989,5,1,196159,196159,196160,0,1,4
55990,4,3,196163,196163,196166,0,3,3
55991,4,2,196167,196167,196169,0,2,1
55992,3,3,196170,196170,196173,0,3,1
55993,1,3,196171,196173,196176,2,5,0
55994,1,3,196172,196176,196179,4,7,0
55995,6,1,196178,196179,196180,1,2,0
55996,6,2,196184,196184,196186,0,2,4
55997,3,2,196187,196187,196189,0,2,1
55998,6,2,196193,196193,196195,0,2,4
55999,2,1,196195,196195,196196,0,1,0
56000,6,1,196201,196201,196202,0,1,5
56001,5,3,196206,196206,196209,0,3,4
56002,4,2,196210,196210,196212,0,2,1
56003,2,1,196212,196212,196213,0,1,0
56004,4,1,196216,196216,196217,0,1,3
56005,3,1,196219,196219,196220,0,1,2
56006,6,1,196225,196225,196226,0,1,5
56007,1,2,196226,196226,196228,0,2,0
56008,2,2,196228,196228,196230,0,2,0
56009,4,1,196232,196232,196233,0,1,2
56010,1,3,196233,196233,196236,0,3,0
56011,6,3,196239,196239,196242,0,3,3
56012,3,2,196242,196242,196244,0,2,0
56013,1,2,196243,196244,196246,1,3,0
56014,4,2,196247,196247,196249,0,2,1
56015,5,1,196252,196252,196253,0,1,3
56016,2,2,196254,196254,196256,0,2,1
56017,4,3,196258,196258,196261,0,3,2
56018,3,1,196261,196261,196262,0,1,0
56019,1,1,196262,196262,196263,0,1,0
56020,2,2,196264,196264,196266,0,2,1
56021,3,3,196267,196267,196270,0,3,1
56022,4,1,196271,196271,196272,0,1,1
56023,6,3,196277,196277,196280,0,3,5
56024,2,2,196279,196280,196282,1,3,0
56025,2,3,196281,196282,196285,1,4,0
56026,5,3,196286,196286,196289,0,3,1
56027,3,3,196289,196289,196292,0,3,0
56028,6,2,196295,196295,196297,0,2,3
56029,4,2,196299,196299,196301,0,2,2
56030,3,1,196302,196302,196303,0,1,1
56031,5,1,196307,196307,196308,0,1,4
56032,1,2,196308,196308,196310,0,2,0
56033,6,2,196314,196314,196316,0,2,4
56034,5,1,196319,196319,196320,0,1,3
56035,3,3,196322,196322,196325,0,3,2
56036,2,1,196324,196325,196326,1,2,0
56037,3,2,196327,196327,196329,0,2,1
56038,6,1,196333,196333,196334,0,1,4
56039,2,1,196335,196335,196336,0,1,1
56040,4,3,196339,196339,196342,0,3,3
56041,2,2,196341,196342,196344,1,3,0
56042,4,2,196345,196345,196347,0,2,1
56043,5,2,196350,196350,196352,0,2,3
56044,3,2,196353,196353,196355,0,2,1
56045,5,3,196358,196358,196361,0,3,3
56046,4,2,196362,196362,196364,0,2,1
56047,4,3,196366,196366,196369,0,3,2
56048,5,3,196371,196371,196374,0,3,2
56049,5,1,196376,196376,196377,0,1,2
56050,2,3,196378,196378,196381,0,3,1
56051,2,1,196380,196381,196382,1,2,0
56052,6,3,196386,196386,196389,0,3,4
56053,6,3,196392,196392,196395,0,3,3
56054,6,3,196398,196398,196401,0,3,3
56055,4,2,196402,196402,196404,0,2,1
56056,1,2,196403,196404,196406,1,3,0
56057,1,1,196404,196406,196407,2,3,0
56058,4,3,196408,196408,196411,0,3,1
56059,1,1,196409,196411,196412,2,3,0
56060,1,2,196410,196412,196414,2,4,0
56061,5,1,196415,196415,196416,0,1,1
56062,1,1,196416,196416,196417,0,1,0
56063,3,3,196419,196419,196422,0,3,2
56064,4,3,196423,196423,196426,0,3,1
56065,6,2,196429,196429,196431,0,2,3
56066,5,2,196434,196434,196436,0,2,3
56067,3,2,196437,196437,196439,0,2,1
56068,2,2,196439,196439,196441,0,2,0
56069,4,1,196443,196443,196444,0,1,2
56070,2,1,196445,196445,196446,0,1,1
56071,1,1,196446,196446,196447,0,1,0
56072,5,1,196451,196451,196452,0,1,4
56073,4,2,196455,196455,196457,0,2,3
56074,2,2,196457,196457,196459,0,2,0
56075,2,2,196459,196459,196461,0,2,0
56076,3,3,196462,196462,196465,0,3,1
56077,2,3,196464,196465,196468,1,4,0
56078,2,1,196466,196468,196469,2,3,0
56079,4,3,196470,196470,196473,0,3,1
56080,5,1,196475,196475,196476,0,1,2
56081,5,3,196480,196480,196483,0,3,4
56082,6,2,196486,196486,196488,0,2,3
56083,1,3,196487,196488,196491,1,4,0
56084,5,3,196492,196492,196495,0,3,1
56085,2,2,196494,196495,196497,1,3,0
56086,4,1,196498,196498,196499,0,1,1
56087,4,3,196502,196502,196505,0,3,3
56088,3,3,196505,196505,196508,0,3,0
56089,5,2,196510,196510,196512,0,2,2
56090,4,3,196514,196514,196517,0,3,2
56091,2,3,196516,196517,196520,1,4,0
56092,1,1,196517,196520,196521,3,4,0
56093,6,3,196523,196523,196526,0,3,2
56094,4,3,196527,196527,196530,0,3,1
56095,5,3,196532,196532,196535,0,3,2
56096,6,1,196538,196538,196539,0,1,3
56097,4,2,196542,196542,196544,0,2,3
56098,1,3,196543,196544,196547,1,4,0
56099,3,3,196546,196547,196550,1,4,0
56100,6,2,196552,196552,196554,0,2,2
56101,1,1,196553,196554,196555,1,2,0
56102,5,3,196558,196558,196561,0,3,3
56103,1,3,196559,196561,196564,2,5,0
56104,1,3,196560,196564,196567,4,7,0
56105,4,3,196564,196567,196570,3,6,0
56106,4,3,196568,196570,196573,2,5,0
56107,3,3,196571,196573,196576,2,5,0
56108,5,1,196576,196576,196577,0,1,0
56109,5,3,196581,196581,196584,0,3,4
56110,1,2,196582,196584,196586,2,4,0
56111,2,1,196584,196586,196587,2,3,0
56112,3,1,196587,196587,196588,0,1,0
56113,2,3,196589,196589,196592,0,3,1
56114,3,3,196592,196592,196595,0,3,0
56115,3,1,196595,196595,196596,0,1,0
56116,5,1,196600,196600,196601,0,1,4
56117,6,1,196606,196606,196607,0,1,5
56118,6,2,196612,196612,196614,0,2,5
56119,4,3,196616,196616,196619,0,3,2
56120,4,2,196620,196620,196622,0,2,1
56121,2,3,196622,196622,196625,0,3,0
56122,4,2,196626,196626,196628,0,2,1
56123,3,1,196629,196629,196630,0,1,1
56124,5,3,196634,196634,196637,0,3,4
56125,3,1,196637,196637,196638,0,1,0
56126,4,3,196641,196641,196644,0,3,3
56127,6,3,196647,196647,196650,0,3,3
56128,1,3,196648,196650,196653,2,5,0
56129,4,1,196652,196653,196654,1,2,0
56130,2,2,196654,196654,196656,0,2,0
56131,6,2,196660,196660,196662,0,2,4
56132,2,2,196662,196662,196664,0,2,0
56133,3,2,196665,196665,196667,0,2,1
56134,5,2,196670,196670,196672,0,2,3
56135,2,3,196672,196672,196675,0,3,0
56136,1,1,196673,196675,196676,2,3,0
56137,5,1,196678,196678,196679,0,1,2
56138,2,2,196680,196680,196682,0,2,1
56139,3,1,196683,196683,196684,0,1,1
56140,5,3,196688,196688,196691,0,3,4
56141,5,2,196693,196693,196695,0,2,2
56142,2,2,196695,196695,196697,0,2,0
56143,1,2,196696,196697,196699,1,3,0
56144,1,2,196697,196699,196701,2,4,0
56145,2,3,196699,196701,196704,2,5,0
56146,5,3,196704,196704,196707,0,3,0
56147,3,1,196707,196707,196708,0,1,0
56148,3,2,196710,196710,196712,0,2,2
56149,2,2,196712,196712,196714,0,2,0
56150,6,2,196718,196718,196720,0,2,4
56151,1,1,196719,196720,196721,1,2,0
56152,5,3,196724,196724,196727,0,3,3
56153,3,1,196727,196727,196728,0,1,0
56154,6,2,196733,196733,196735,0,2,5
56155,1,2,196734,196735,196737,1,3,0
56156,5,2,196739,196739,196741,0,2,2
56157,6,2,196745,196745,196747,0,2,4
56158,2,1,196747,196747,196748,0,1,0
56159,2,1,196749,196749,196750,0,1,1
56160,3,3,196752,196752,196755,0,3,2
56161,4,3,196756,196756,196759,0,3,1
56162,6,3,196762,196762,196765,0,3,3
56163,6,2,196768,196768,196770,0,2,3
56164,1,1,196769,196770,196771,1,2,0
56165,3,1,196772,196772,196773,0,1,1
56166,1,1,196773,196773,196774,0,1,0
56167,3,1,196776,196776,196777,0,1,2
56168,4,1,196780,196780,196781,0,1,3
56169,2,2,196782,196782,196784,0,2,1
56170,2,2,196784,196784,196786,0,2,0
56171,4,1,196788,196788,196789,0,1,2
56172,1,1,196789,196789,196790,0,1,0
56173,3,2,196792,196792,196794,0,2,2
56174,2,1,196794,196794,196795,0,1,0
56175,4,2,196798,196798,196800,0,2,3
56176,2,3,196800,196800,196803,0,3,0
56177,1,2,196801,196803,196805,2,4,0
56178,4,2,196805,196805,196807,0,2,0
56179,4,2,196809,196809,196811,0,2,2
56180,3,2,196812,196812,196814,0,2,1
56181,4,2,196816,196816,196818,0,2,2
56182,5,1,196821,196821,196822,0,1,3
56183,4,1,196825,196825,196826,0,1,3
56184,3,2,196828,196828,196830,0,2,2
56185,6,1,196834,196834,196835,0,1,4
56186,6,2,196840,196840,196842,0,2,5
56187,3,2,196843,196843,196845,0,2,1
56188,5,3,196848,196848,196851,0,3,3
56189,3,3,196851,196851,196854,0,3,0
56190,3,1,196854,196854,196855,0,1,0
56191,3,1,196857,196857,196858,0,1,2
56192,5,1,196862,196862,196863,0,1,4
56193,4,3,196866,196866,196869,0,3,3
56194,6,1,196872,196872,196873,0,1,3
56195,6,3,196878,196878,196881,0,3,5
56196,5,2,196883,196883,196885,0,2,2
56197,2,2,196885,196885,196887,0,2,0
56198,6,2,196891,196891,196893,0,2,4
56199,3,1,196894,196894,196895,0,1,1
56200,5,2,196899,196899,196901,0,2,4
56201,6,3,196905,196905,196908,0,3,4
56202,4,1,196909,196909,196910,0,1,1
56203,4,3,196913,196913,196916,0,3,3
56204,2,2,196915,196916,196918,1,3,0
56205,2,2,196917,196918,196920,1,3,0
56206,5,2,196922,196922,196924,0,2,2
56207,3,1,196925,196925,196926,0,1,1
56208,5,2,196930,196930,196932,0,2,4
56209,6,3,196936,196936,196939,0,3,4
56210,1,1,196937,196939,196940,2,3,0
56211,3,3,196940,196940,196943,0,3,0
56212,5,3,196945,196945,196948,0,3,2
56213,2,3,196947,196948,196951,1,4,0
56214,1,3,196948,196951,196954,3,6,0
56215,2,1,196950,196954,196955,4,5,0
56216,3,2,196953,196955,196957,2,4,0
56217,5,1,196958,196958,196959,0,1,1
56218,3,2,196961,196961,196963,0,2,2
56219,6,2,196967,196967,196969,0,2,4
56220,3,3,196970,196970,196973,0,3,1
56221,1,3,196971,196973,196976,2,5,0
56222,2,3,196973,196976,196979,3,6,0
56223,1,2,196974,196979,196981,5,7,0
56224,1,1,196975,196981,196982,6,7,0
56225,3,2,196978,196982,196984,4,6,0
56226,5,3,196983,196984,196987,1,4,0
56227,4,1,196987,196987,196988,0,1,0
56228,1,2,196988,196988,196990,0,2,0
56229,3,1,196991,196991,196992,0,1,1
56230,4,2,196995,196995,196997,0,2,3
56231,4,1,196999,196999,197000,0,1,2
56232,4,1,197003,197003,197004,0,1,3
56233,6,1,197009,197009,197010,0,1,5
56234,2,3,197011,197011,197014,0,3,1
56235,1,2,197012,197014,197016,2,4,0
56236,4,3,197016,197016,197019,0,3,0
56237,3,1,197019,197019,197020,0,1,0
56238,2,2,197021,197021,197023,0,2,1
56239,2,3,197023,197023,197026,0,3,0
56240,2,1,197025,197026,197027,1,2,0
56241,2,3,197027,197027,197030,0,3,0
56242,2,3,197029,197030,197033,1,4,0
56243,1,2,197030,197033,197035,3,5,0
56244,2,1,197032,197035,197036,3,4,0
56245,3,1,197035,197036,197037,1,2,0
56246,4,3,197039,197039,197042,0,3,2
56247,3,2,197042,197042,197044,0,2,0
56248,2,1,197044,197044,197045,0,1,0
56249,4,3,197048,197048,197051,0,3,3
56250,2,3,197050,197051,197054,1,4,0
56251,1,3,197051,197054,197057,3,6,0
56252,4,2,197055,197057,197059,2,4,0
56253,5,3,197060,197060,197063,0,3,1
56254,2,1,197062,197063,197064,1,2,0
56255,2,3,197064,197064,197067,0,3,0
56256,5,3,197069,197069,197072,0,3,2
56257,3,3,197072,197072,197075,0,3,0
56258,5,1,197077,197077,197078,0,1,2
56259,2,1,197079,197079,197080,0,1,1
56260,5,1,197084,197084,197085,0,1,4
56261,3,1,197087,197087,197088,0,1,2
56262,2,3,197089,197089,197092,0,3,1
56263,2,3,197091,197092,197095,1,4,0
56264,5,1,197096,197096,197097,0,1,1
56265,2,2,197098,197098,197100,0,2,1
56266,4,2,197102,197102,197104,0,2,2
56267,4,1,197106,197106,197107,0,1,2
56268,1,3,197107,197107,197110,0,3,0
56269,2,3,197109,197110,197113,1,4,0
56270,1,3,197110,197113,197116,3,6,0
56271,4,3,197114,197116,197119,2,5,0
56272,3,3,197117,197119,197122,2,5,0
56273,1,3,197118,197122,197125,4,7,0
56274,3,2,197121,197125,197127,4,6,0
56275,5,2,197126,197127,197129,1,3,0
56276,5,2,197131,197131,197133,0,2,2
56277,1,1,197132,197133,197134,1,2,0
56278,5,1,197137,197137,197138,0,1,3
56279,1,1,197138,197138,197139,0,1,0
56280,2,2,197140,197140,197142,0,2,1
56281,4,1,197144,197144,197145,0,1,2
56282,1,3,197145,197145,197148,0,3,0
56283,4,2,197149,197149,197151,0,2,1
56284,1,2,197150,197151,197153,1,3,0
56285,3,1,197153,197153,197154,0,1,0
56286,3,2,197156,197156,197158,0,2,2
56287,1,2,197157,197158,197160,1,3,0
56288,1,2,197158,197160,197162,2,4,0
56289,3,3,197161,197162,197165,1,4,0
56290,6,1,197167,197167,197168,0,1,2
56291,6,2,197173,197173,197175,0,2,5
56292,2,3,197175,197175,197178,0,3,0
56293,6,3,197181,197181,197184,0,3,3
56294,2,2,197183,197184,197186,1,3,0
56295,2,3,197185,197186,197189,1,4,0
56296,3,2,197188,197189,197191,1,3,0
56297,5,1,197193,197193,197194,0,1,2
56298,5,1,197198,197198,197199,0,1,4
56299,3,2,197201,197201,197203,0,2,2
56300,1,3,197202,197203,197206,1,4,0
56301,1,2,197203,197206,197208,3,5,0
56302,3,2,197206,197208,197210,2,4,0
56303,6,1,197212,197212,197213,0,1,2
56304,1,1,197213,197213,197214,0,1,0
56305,6,1,197219,197219,197220,0,1,5
56306,6,2,197225,197225,197227,0,2,5
56307,6,2,197231,197231,197233,0,2,4
56308,1,1,197232,197233,197234,1,2,0
56309,5,1,197237,197237,197238,0,1,3
56310,4,2,197241,197241,197243,0,2,3
56311,2,1,197243,197243,197244,0,1,0
56312,5,2,197248,197248,197250,0,2,4
56313,3,2,197251,197251,197253,0,2,1
56314,3,3,197254,197254,197257,0,3,1
56315,5,1,197259,197259,197260,0,1,2
56316,1,1,197260,197260,197261,0,1,0
56317,4,1,197264,197264,197265,0,1,3
56318,6,2,197270,197270,197272,0,2,5
56319,6,3,197276,197276,197279,0,3,4
56320,6,2,197282,197282,197284,0,2,3
56321,2,3,197284,197284,197287,0,3,0
56322,4,2,197288,197288,197290,0,2,1
56323,5,1,197293,197293,197294,0,1,3
56324,3,3,197296,197296,197299,0,3,2
56325,4,2,197300,197300,197302,0,2,1
56326,5,3,197305,197305,197308,0,3,3
56327,4,2,197309,197309,197311,0,2,1
56328,1,3,197310,197311,197314,1,4,0
56329,2,2,197312,197314,197316,2,4,0
56330,1,2,197313,197316,197318,3,5,0
56331,5,2,197318,197318,197320,0,2,0
56332,2,2,197320,197320,197322,0,2,0
56333,2,3,197322,197322,197325,0,3,0
56334,5,1,197327,197327,197328,0,1,2
56335,6,3,197333,197333,197336,0,3,5
56336,1,2,197334,197336,197338,2,4,0
56337,6,3,197340,197340,197343,0,3,2
56338,2,3,197342,197343,197346,1,4,0
56339,4,1,197346,197346,197347,0,1,0
56340,1,1,197347,197347,197348,0,1,0
56341,4,3,197351,197351,197354,0,3,3
56342,4,1,197355,197355,197356,0,1,1
56343,4,3,197359,197359,197362,0,3,3
56344,4,1,197363,197363,197364,0,1,1
56345,1,1,197364,197364,197365,0,1,0
56346,5,3,197369,197369,197372,0,3,4
56347,4,2,197373,197373,197375,0,2,1
56348,3,2,197376,197376,197378,0,2,1
56349,1,1,197377,197378,197379,1,2,0
56350,3,1,197380,197380,197381,0,1,1
56351,4,3,197384,197384,197387,0,3,3
56352,6,2,197390,197390,197392,0,2,3
56353,6,1,197396,197396,197397,0,1,4
56354,3,2,197399,197399,197401,0,2,2
56355,3,2,197402,197402,197404,0,2,1
56356,3,2,197405,197405,197407,0,2,1
56357,5,2,197410,197410,197412,0,2,3
56358,1,2,197411,197412,197414,1,3,0
56359,3,3,197414,197414,197417,0,3,0
56360,5,3,197419,197419,197422,0,3,2
56361,2,1,197421,197422,197423,1,2,0
56362,3,3,197424,197424,197427,0,3,1
56363,6,2,197430,197430,197432,0,2,3
56364,1,3,197431,197432,197435,1,4,0
56365,2,1,197433,197435,197436,2,3,0
56366,3,2,197436,197436,197438,0,2,0
56367,2,3,197438,197438,197441,0,3,0
56368,2,1,197440,197441,197442,1,2,0
56369,2,1,197442,197442,197443,0,1,0
56370,3,1,197445,197445,197446,0,1,2
56371,6,3,197451,197451,197454,0,3,5
56372,4,2,197455,197455,197457,0,2,1
56373,1,3,197456,197457,197460,1,4,0
56374,4,2,197460,197460,197462,0,2,0
56375,4,2,197464,197464,197466,0,2,2
56376,2,1,197466,197466,197467,0,1,0
56377,5,3,197471,197471,197474,0,3,4
56378,2,1,197473,197474,197475,1,2,0
56379,2,1,197475,197475,197476,0,1,0
56380,2,2,197477,197477,197479,0,2,1
56381,1,1,197478,197479,197480,1,2,0
56382,3,3,197481,197481,197484,0,3,1
56383,4,3,197485,197485,197488,0,3,1
56384,4,2,197489,197489,197491,0,2,1
56385,2,3,197491,197491,197494,0,3,0
56386,4,1,197495,197495,197496,0,1,1
56387,3,1,197498,197498,197499,0,1,2
56388,6,2,197504,197504,197506,0,2,5
56389,2,1,197506,197506,197507,0,1,0
56390,1,3,197507,197507,197510,0,3,0
56391,5,2,197512,197512,197514,0,2,2
56392,1,3,197513,197514,197517,1,4,0
56393,4,3,197517,197517,197520,0,3,0
56394,2,1,197519,197520,197521,1,2,0
56395,2,3,197521,197521,197524,0,3,0
56396,5,1,197526,197526,197527,0,1,2
56397,3,2,197529,197529,197531,0,2,2
56398,1,2,197530,197531,197533,1,3,0
56399,2,3,197532,197533,197536,1,4,0
56400,5,3,197537,197537,197540,0,3,1
56401,5,3,197542,197542,197545,0,3,2
56402,1,2,197543,197545,197547,2,4,0
56403,4,2,197547,197547,197549,0,2,0
56404,5,2,197552,197552,197554,0,2,3
56405,5,3,197557,197557,197560,0,3,3
56406,5,1,197562,197562,197563,0,1,2
56407,3,1,197565,197565,197566,0,1,2
56408,6,3,197571,197571,197574,0,3,5
56409,1,1,197572,197574,197575,2,3,0
56410,2,1,197574,197575,197576,1,2,0
56411,1,2,197575,197576,197578,1,3,0
56412,2,2,197577,197578,197580,1,3,0
56413,5,2,197582,197582,197584,0,2,2
56414,4,1,197586,197586,197587,0,1,2
56415,2,3,197588,197588,197591,0,3,1
56416,1,1,197589,197591,197592,2,3,0
56417,4,1,197593,197593,197594,0,1,1
56418,3,3,197596,197596,197599,0,3,2
56419,5,1,197601,197601,197602,0,1,2
56420,2,1,197603,197603,197604,0,1,1
56421,3,3,197606,197606,197609,0,3,2
56422,5,1,197611,197611,197612,0,1,2
56423,6,1,197617,197617,197618,0,1,5
56424,1,3,197618,197618,197621,0,3,0
56425,1,1,197619,197621,197622,2,3,0
56426,5,1,197624,197624,197625,0,1,2
56427,3,3,197627,197627,197630,0,3,2
56428,3,3,197630,197630,197633,0,3,0
56429,3,1,197633,197633,197634,0,1,0
56430,3,3,197636,197636,197639,0,3,2
56431,2,1,197638,197639,197640,1,2,0
56432,5,1,197643,197643,197644,0,1,3
56433,6,2,197649,197649,197651,0,2,5
56434,5,2,197654,197654,197656,0,2,3
56435,2,1,197656,197656,197657,0,1,0
56436,3,2,197659,197659,197661,0,2,2
56437,5,3,197664,197664,197667,0,3,3
56438,5,2,197669,197669,197671,0,2,2
56439,5,1,197674,197674,197675,0,1,3
56440,6,2,197680,197680,197682,0,2,5
56441,3,2,197683,197683,197685,0,2,1
56442,1,1,197684,197685,197686,1,2,0
56443,1,2,197685,197686,197688,1,3,0
56444,5,2,197690,197690,197692,0,2,2
56445,3,1,197693,197693,197694,0,1,1
56446,6,2,197699,197699,197701,0,2,5
56447,6,1,197705,197705,197706,0,1,4
56448,2,1,197707,197707,197708,0,1,1
56449,6,1,197713,197713,197714,0,1,5
56450,2,3,197715,197715,197718,0,3,1
56451,3,1,197718,197718,197719,0,1,0
56452,4,2,197722,197722,197724,0,2,3
56453,4,3,197726,197726,197729,0,3,2
56454,3,2,197729,197729,197731,0,2,0
56455,3,2,197732,197732,197734,0,2,1
56456,6,1,197738,197738,197739,0,1,4
56457,6,3,197744,197744,197747,0,3,5
56458,4,3,197748,197748,197751,0,3,1
56459,3,3,197751,197751,197754,0,3,0
56460,5,1,197756,197756,197757,0,1,2
56461,2,2,197758,197758,197760,0,2,1
56462,2,1,197760,197760,197761,0,1,0
56463,2,1,197762,197762,197763,0,1,1
56464,4,1,197766,197766,197767,0,1,3
56465,3,2,197769,197769,197771,0,2,2
56466,5,2,197774,197774,197776,0,2,3
56467,1,1,197775,197776,197777,1,2,0
56468,5,2,197780,197780,197782,0,2,3
56469,4,3,197784,197784,197787,0,3,2
56470,3,2,197787,197787,197789,0,2,0
56471,1,3,197788,197789,197792,1,4,0
56472,3,2,197791,197792,197794,1,3,0
56473,6,3,197797,197797,197800,0,3,3
56474,4,2,197801,197801,197803,0,2,1
56475,6,3,197807,197807,197810,0,3,4
56476,1,1,197808,197810,197811,2,3,0
56477,3,1,197811,197811,197812,0,1,0
56478,4,2,197815,197815,197817,0,2,3
56479,6,2,197821,197821,197823,0,2,4
56480,1,1,197822,197823,197824,1,2,0
56481,4,3,197826,197826,197829,0,3,2
56482,3,3,197829,197829,197832,0,3,0
56483,4,2,197833,197833,197835,0,2,1
56484,4,1,197837,197837,197838,0,1,2
56485,3,1,197840,197840,197841,0,1,2
56486,6,2,197846,197846,197848,0,2,5
56487,6,3,197852,197852,197855,0,3,4
56488,6,1,197858,197858,197859,0,1,3
56489,4,2,197862,197862,197864,0,2,3
56490,2,1,197864,197864,197865,0,1,0
56491,4,3,197868,197868,197871,0,3,3
56492,4,3,197872,197872,197875,0,3,1
56493,1,3,197873,197875,197878,2,5,0
56494,3,3,197876,197878,197881,2,5,0
56495,3,3,197879,197881,197884,2,5,0
56496,6,1,197885,197885,197886,0,1,1
56497,3,2,197888,197888,197890,0,2,2
56498,1,2,197889,197890,197892,1,3,0
56499,1,2,197890,197892,197894,2,4,0
56500,3,2,197893,197894,197896,1,3,0
56501,4,2,197897,197897,197899,0,2,1
56502,6,2,197903,197903,197905,0,2,4
56503,2,2,197905,197905,197907,0,2,0
56504,1,2,197906,197907,197909,1,3,0
56505,5,1,197911,197911,197912,0,1,2
56506,5,2,197916,197916,197918,0,2,4
56507,4,1,197920,197920,197921,0,1,2
56508,4,3,197924,197924,197927,0,3,3
56509,1,3,197925,197927,197930,2,5,0
56510,5,1,197930,197930,197931,0,1,0
56511,3,2,197933,197933,197935,0,2,2
56512,5,2,197938,197938,197940,0,2,3
56513,5,2,197943,197943,197945,0,2,3
56514,4,3,197947,197947,197950,0,3,2
56515,2,2,197949,197950,197952,1,3,0
56516,2,2,197951,197952,197954,1,3,0
56517,5,3,197956,197956,197959,0,3,2
56518,4,3,197960,197960,197963,0,3,1
56519,6,3,197966,197966,197969,0,3,3
56520,1,1,197967,197969,197970,2,3,0
56521,4,2,197971,197971,197973,0,2,1
56522,6,1,197977,197977,197978,0,1,4
56523,5,2,197982,197982,197984,0,2,4
56524,4,1,197986,197986,197987,0,1,2
56525,2,1,197988,197988,197989,0,1,1
56526,5,1,197993,197993,197994,0,1,4
56527,1,2,197994,197994,197996,0,2,0
56528,4,1,197998,197998,197999,0,1,2
56529,6,2,198004,198004,198006,0,2,5
56530,3,3,198007,198007,198010,0,3,1
56531,1,1,198008,198010,198011,2,3,0
56532,3,3,198011,198011,198014,0,3,0
56533,4,1,198015,198015,198016,0,1,1
56534,2,3,198017,198017,198020,0,3,1
56535,6,3,198023,198023,198026,0,3,3
56536,3,2,198026,198026,198028,0,2,0
56537,5,1,198031,198031,198032,0,1,3
56538,1,2,198032,198032,198034,0,2,0
56539,1,1,198033,198034,198035,1,2,0
56540,1,3,198034,198035,198038,1,4,0
56541,3,2,198037,198038,198040,1,3,0
56542,6,3,198043,198043,198046,0,3,3
56543,4,2,198047,198047,198049,0,2,1
56544,2,1,198049,198049,198050,0,1,0
56545,3,1,198052,198052,198053,0,1,2
56546,2,3,198054,198054,198057,0,3,1
56547,2,3,198056,198057,198060,1,4,0
56548,1,3,198057,198060,198063,3,6,0
56549,3,3,198060,198063,198066,3,6,0
56550,5,3,198065,198066,198069,1,4,0
56551,2,2,198067,198069,198071,2,4,0
56552,4,1,198071,198071,198072,0,1,0
56553,3,3,198074,198074,198077,0,3,2
56554,2,2,198076,198077,198079,1,3,0
56555,1,1,198077,198079,198080,2,3,0
56556,4,1,198081,198081,198082,0,1,1
56557,2,3,198083,198083,198086,0,3,1
56558,1,2,198084,198086,198088,2,4,0
56559,2,3,198086,198088,198091,2,5,0
56560,3,2,198089,198091,198093,2,4,0
56561,5,1,198094,198094,198095,0,1,1
56562,2,2,198096,198096,198098,0,2,1
56563,3,2,198099,198099,198101,0,2,1
56564,5,3,198104,198104,198107,0,3,3
56565,4,1,198108,198108,198109,0,1,1
56566,5,3,198113,198113,198116,0,3,4
56567,1,1,198114,198116,198117,2,3,0
56568,3,1,198117,198117,198118,0,1,0
56569,4,2,198121,198121,198123,0,2,3
56570,1,2,198122,198123,198125,1,3,0
56571,5,1,198127,198127,198128,0,1,2
56572,4,2,198131,198131,198133,0,2,3
56573,4,2,198135,198135,198137,0,2,2
56574,2,1,198137,198137,198138,0,1,0
56575,6,1,198143,198143,198144,0,1,5
56576,4,3,198147,198147,198150,0,3,3
56577,2,2,198149,198150,198152,1,3,0
56578,5,1,198154,198154,198155,0,1,2
56579,6,3,198160,198160,198163,0,3,5
56580,4,3,198164,198164,198167,0,3,1
56581,5,3,198169,198169,198172,0,3,2
56582,6,2,198175,198175,198177,0,2,3
56583,4,2,198179,198179,198181,0,2,2
56584,3,1,198182,198182,198183,0,1,1
56585,2,2,198184,198184,198186,0,2,1
56586,5,2,198189,198189,198191,0,2,3
56587,1,3,198190,198191,198194,1,4,0
56588,6,3,198196,198196,198199,0,3,2
56589,5,2,198201,198201,198203,0,2,2
56590,4,3,198205,198205,198208,0,3,2
56591,1,1,198206,198208,198209,2,3,0
56592,4,3,198210,198210,198213,0,3,1
56593,6,2,198216,198216,198218,0,2,3
56594,1,1,198217,198218,198219,1,2,0
56595,2,3,198219,198219,198222,0,3,0
56596,3,1,198222,198222,198223,0,1,0
56597,2,2,198224,198224,198226,0,2,1
56598,6,1,198230,198230,198231,0,1,4
56599,2,2,198232,198232,198234,0,2,1
56600,1,3,198233,198234,198237,1,4,0
56601,3,2,198236,198237,198239,1,3,0
56602,2,1,198238,198239,198240,1,2,0
56603,6,1,198244,198244,198245,0,1,4
56604,1,2,198245,198245,198247,0,2,0
56605,4,3,198249,198249,198252,0,3,2
56606,2,1,198251,198252,198253,1,2,0
56607,2,3,198253,198253,198256,0,3,0
56608,5,2,198258,198258,198260,0,2,2
56609,5,3,198263,198263,198266,0,3,3
56610,2,2,198265,198266,198268,1,3,0
56611,2,3,198267,198268,198271,1,4,0
56612,3,1,198270,198271,198272,1,2,0
56613,4,1,198274,198274,198275,0,1,2
56614,4,2,198278,198278,198280,0,2,3
56615,2,1,198280,198280,198281,0,1,0
56616,5,2,198285,198285,198287,0,2,4
56617,3,2,198288,198288,198290,0,2,1
56618,4,3,198292,198292,198295,0,3,2
56619,1,3,198293,198295,198298,2,5,0
56620,1,2,198294,198298,198300,4,6,0
56621,5,2,198299,198300,198302,1,3,0
56622,6,1,198305,198305,198306,0,1,3
56623,5,2,198310,198310,198312,0,2,4
56624,2,2,198312,198312,198314,0,2,0
56625,4,3,198316,198316,198319,0,3,2
56626,1,1,198317,198319,198320,2,3,0
56627,6,3,198323,198323,198326,0,3,3
56628,6,1,198329,198329,198330,0,1,3
56629,1,1,198330,198330,198331,0,1,0
56630,1,3,198331,198331,198334,0,3,0
56631,3,3,198334,198334,198337,0,3,0
56632,4,1,198338,198338,198339,0,1,1
56633,3,2,198341,198341,198343,0,2,2
56634,3,3,198344,198344,198347,0,3,1
56635,4,1,198348,198348,198349,0,1,1
56636,2,2,198350,198350,198352,0,2,1
56637,1,2,198351,198352,198354,1,3,0
56638,6,1,198357,198357,198358,0,1,3
56639,4,3,198361,198361,198364,0,3,3
56640,6,2,198367,198367,198369,0,2,3
56641,6,3,198373,198373,198376,0,3,4
56642,1,1,198374,198376,198377,2,3,0
56643,1,3,198375,198377,198380,2,5,0
56644,4,1,198379,198380,198381,1,2,0
56645,6,1,198385,198385,198386,0,1,4
56646,6,3,198391,198391,198394,0,3,5
56647,2,1,198393,198394,198395,1,2,0
56648,6,2,198399,198399,198401,0,2,4
56649,4,2,198403,198403,198405,0,2,2
56650,6,3,198409,198409,198412,0,3,4
56651,3,2,198412,198412,198414,0,2,0
56652,4,2,198416,198416,198418,0,2,2
56653,6,3,198422,198422,198425,0,3,4
56654,2,2,198424,198425,198427,1,3,0
56655,2,3,198426,198427,198430,1,4,0
56656,4,3,198430,198430,198433,0,3,0
56657,1,3,198431,198433,198436,2,5,0
56658,6,3,198437,198437,198440,0,3,1
56659,3,3,198440,198440,198443,0,3,0
56660,3,1,198443,198443,198444,0,1,0
56661,2,3,198445,198445,198448,0,3,1
56662,6,3,198451,198451,198454,0,3,3
56663,1,1,198452,198454,198455,2,3,0
56664,4,1,198456,198456,198457,0,1,1
56665,4,1,198460,198460,198461,0,1,3
56666,1,1,198461,198461,198462,0,1,0
56667,1,2,198462,198462,198464,0,2,0
56668,2,1,198464,198464,198465,0,1,0
56669,4,3,198468,198468,198471,0,3,3
56670,2,2,198470,198471,198473,1,3,0
56671,4,3,198474,198474,198477,0,3,1
56672,1,3,198475,198477,198480,2,5,0
56673,4,1,198479,198480,198481,1,2,0
56674,1,1,198480,198481,198482,1,2,0
56675,1,1,198481,198482,198483,1,2,0
56676,6,1,198487,198487,198488,0,1,4
56677,6,3,198493,198493,198496,0,3,5
56678,6,3,198499,198499,198502,0,3,3
56679,6,2,198505,198505,198507,0,2,3
56680,4,2,198509,198509,198511,0,2,2
56681,4,1,198513,198513,198514,0,1,2
56682,2,3,198515,198515,198518,0,3,1
56683,3,1,198518,198518,198519,0,1,0
56684,2,1,198520,198520,198521,0,1,1
56685,5,1,198525,198525,198526,0,1,4
56686,1,1,198526,198526,198527,0,1,0
56687,5,1,198531,198531,198532,0,1,4
56688,4,3,198535,198535,198538,0,3,3
56689,2,3,198537,198538,198541,1,4,0
56690,2,1,198539,198541,198542,2,3,0
56691,2,1,198541,198542,198543,1,2,0
56692,2,2,198543,198543,198545,0,2,0
56693,3,2,198546,198546,198548,0,2,1
56694,5,3,198551,198551,198554,0,3,3
56695,2,2,198553,198554,198556,1,3,0
56696,1,1,198554,198556,198557,2,3,0
56697,3,1,198557,198557,198558,0,1,0
56698,2,2,198559,198559,198561,0,2,1
56699,1,3,198560,198561,198564,1,4,0
56700,5,3,198565,198565,198568,0,3,1
56701,1,2,198566,198568,198570,2,4,0
56702,3,1,198569,198570,198571,1,2,0
56703,5,2,198574,198574,198576,0,2,3
56704,5,1,198579,198579,198580,0,1,3
56705,6,2,198585,198585,198587,0,2,5
56706,4,1,198589,198589,198590,0,1,2
56707,6,1,198595,198595,198596,0,1,5
56708,5,1,198600,198600,198601,0,1,4
56709,3,2,198603,198603,198605,0,2,2
56710,2,1,198605,198605,198606,0,1,0
56711,4,2,198609,198609,198611,0,2,3
56712,6,3,198615,198615,198618,0,3,4
56713,4,3,198619,198619,198622,0,3,1
56714,5,1,198624,198624,198625,0,1,2
56715,2,3,198626,198626,198629,0,3,1
56716,3,3,198629,198629,198632,0,3,0
56717,3,1,198632,198632,198633,0,1,0
56718,4,3,198636,198636,198639,0,3,3
56719,5,1,198641,198641,198642,0,1,2
56720,1,1,198642,198642,198643,0,1,0
56721,1,1,198643,198643,198644,0,1,0
56722,2,3,198645,198645,198648,0,3,1
56723,6,1,198651,198651,198652,0,1,3
56724,3,2,198654,198654,198656,0,2,2
56725,6,3,198660,198660,198663,0,3,4
56726,5,3,198665,198665,198668,0,3,2
56727,6,2,198671,198671,198673,0,2,3
56728,4,3,198675,198675,198678,0,3,2
56729,6,3,198681,198681,198684,0,3,3
56730,2,2,198683,198684,198686,1,3,0
56731,4,3,198687,198687,198690,0,3,1
56732,4,2,198691,198691,198693,0,2,1
56733,6,1,198697,198697,198698,0,1,4
56734,5,3,198702,198702,198705,0,3,4
56735,4,3,198706,198706,198709,0,3,1
56736,2,2,198708,198709,198711,1,3,0
56737,4,3,198712,198712,198715,0,3,1
56738,6,1,198718,198718,198719,0,1,3
56739,2,2,198720,198720,198722,0,2,1
56740,3,2,198723,198723,198725,0,2,1
56741,4,2,198727,198727,198729,0,2,2
56742,1,2,198728,198729,198731,1,3,0
56743,6,1,198734,198734,198735,0,1,3
56744,6,3,198740,198740,198743,0,3,5
56745,5,3,198745,198745,198748,0,3,2
56746,6,3,198751,198751,198754,0,3,3
56747,3,1,198754,198754,198755,0,1,0
56748,2,1,198756,198756,198757,0,1,1
56749,4,2,198760,198760,198762,0,2,3
56750,1,1,198761,198762,198763,1,2,0
56751,6,3,198767,198767,198770,0,3,4
56752,5,2,198772,198772,198774,0,2,2
56753,6,2,198778,198778,198780,0,2,4
56754,6,3,198784,198784,198787,0,3,4
56755,4,2,198788,198788,198790,0,2,1
56756,5,1,198793,198793,198794,0,1,3
56757,6,3,198799,198799,198802,0,3,5
56758,5,3,198804,198804,198807,0,3,2
56759,6,1,198810,198810,198811,0,1,3
56760,2,2,198812,198812,198814,0,2,1
56761,4,3,198816,198816,198819,0,3,2
56762,1,1,198817,198819,198820,2,3,0
56763,4,1,198821,198821,198822,0,1,1
56764,3,2,198824,198824,198826,0,2,2
56765,4,3,198828,198828,198831,0,3,2
56766,4,1,198832,198832,198833,0,1,1
56767,3,1,198835,198835,198836,0,1,2
56768,4,1,198839,198839,198840,0,1,3
56769,2,1,198841,198841,198842,0,1,1
56770,2,2,198843,198843,198845,0,2,1
56771,4,3,198847,198847,198850,0,3,2
56772,5,1,198852,198852,198853,0,1,2
56773,5,1,198857,198857,198858,0,1,4
56774,4,1,198861,198861,198862,0,1,3
56775,6,3,198867,198867,198870,0,3,5
56776,3,3,198870,198870,198873,0,3,0
56777,5,2,198875,198875,198877,0,2,2
56778,2,2,198877,198877,198879,0,2,0
56779,5,2,198882,198882,198884,0,2,3
56780,4,1,198886,198886,198887,0,1,2
56781,5,3,198891,198891,198894,0,3,4
56782,1,3,198892,198894,198897,2,5,0
56783,4,2,198896,198897,198899,1,3,0
56784,3,2,198899,198899,198901,0,2,0
56785,1,2,198900,198901,198903,1,3,0
56786,6,1,198906,198906,198907,0,1,3
56787,3,3,198909,198909,198912,0,3,2
56788,2,3,198911,198912,198915,1,4,0
56789,4,3,198915,198915,198918,0,3,0
56790,3,2,198918,198918,198920,0,2,0
56791,5,2,198923,198923,198925,0,2,3
56792,2,2,198925,198925,198927,0,2,0
56793,1,3,198926,198927,198930,1,4,0
56794,4,1,198930,198930,198931,0,1,0
56795,3,2,198933,198933,198935,0,2,2
56796,2,3,198935,198935,198938,0,3,0
56797,5,3,198940,198940,198943,0,3,2
56798,5,2,198945,198945,198947,0,2,2
56799,6,3,198951,198951,198954,0,3,4
56800,4,1,198955,198955,198956,0,1,1
56801,2,3,198957,198957,198960,0,3,1
56802,3,3,198960,198960,198963,0,3,0
56803,5,3,198965,198965,198968,0,3,2
56804,1,1,198966,198968,198969,2,3,0
56805,3,2,198969,198969,198971,0,2,0
56806,6,2,198975,198975,198977,0,2,4
56807,4,1,198979,198979,198980,0,1,2
56808,4,2,198983,198983,198985,0,2,3
56809,3,1,198986,198986,198987,0,1,1
56810,5,3,198991,198991,198994,0,3,4
56811,1,3,198992,198994,198997,2,5,0
56812,5,1,198997,198997,198998,0,1,0
56813,3,3,199000,199000,199003,0,3,2
56814,2,2,199002,199003,199005,1,3,0
56815,5,3,199007,199007,199010,0,3,2
56816,4,3,199011,199011,199014,0,3,1
56817,4,2,199015,199015,199017,0,2,1
56818,5,2,199020,199020,199022,0,2,3
56819,3,2,199023,199023,199025,0,2,1
56820,5,3,199028,199028,199031,0,3,3
56821,4,2,199032,199032,199034,0,2,1
56822,2,3,199034,199034,199037,0,3,0
56823,1,2,199035,199037,199039,2,4,0
56824,4,1,199039,199039,199040,0,1,0
56825,6,3,199045,199045,199048,0,3,5
56826,6,1,199051,199051,199052,0,1,3
56827,6,1,199057,199057,199058,0,1,5
56828,4,1,199061,199061,199062,0,1,3
56829,6,2,199067,199067,199069,0,2,5
56830,3,2,199070,199070,199072,0,2,1
56831,4,1,199074,199074,199075,0,1,2
56832,3,1,199077,199077,199078,0,1,2
56833,5,2,199082,199082,199084,0,2,4
56834,2,1,199084,199084,199085,0,1,0
56835,6,2,199090,199090,199092,0,2,5
56836,6,1,199096,199096,199097,0,1,4
56837,5,2,199101,199101,199103,0,2,4
56838,6,2,199107,199107,199109,0,2,4
56839,4,1,199111,199111,199112,0,1,2
56840,6,3,199117,199117,199120,0,3,5
56841,6,3,199123,199123,199126,0,3,3
56842,2,2,199125,199126,199128,1,3,0
56843,5,2,199130,199130,199132,0,2,2
56844,2,2,199132,199132,199134,0,2,0
56845,3,3,199135,199135,199138,0,3,1
56846,2,1,199137,199138,199139,1,2,0
56847,4,2,199141,199141,199143,0,2,2
56848,2,3,199143,199143,199146,0,3,0
56849,4,3,199147,199147,199150,0,3,1
56850,3,1,199150,199150,199151,0,1,0
56851,2,1,199152,199152,199153,0,1,1
56852,4,2,199156,199156,199158,0,2,3
56853,2,1,199158,199158,199159,0,1,0
56854,6,3,199164,199164,199167,0,3,5
56855,3,1,199167,199167,199168,0,1,0
56856,1,1,199168,199168,199169,0,1,0
56857,4,2,199172,199172,199174,0,2,3
56858,5,2,199177,199177,199179,0,2,3
56859,6,2,199183,199183,199185,0,2,4
56860,3,3,199186,199186,199189,0,3,1
56861,4,1,199190,199190,199191,0,1,1
56862,3,3,199193,199193,199196,0,3,2
56863,1,2,199194,199196,199198,2,4,0
56864,2,1,199196,199198,199199,2,3,0
56865,1,1,199197,199199,199200,2,3,0
56866,3,1,199200,199200,199201,0,1,0
56867,4,2,199204,199204,199206,0,2,3
56868,5,2,199209,199209,199211,0,2,3
56869,4,1,199213,199213,199214,0,1,2
56870,1,3,199214,199214,199217,0,3,0
56871,6,2,199220,199220,199222,0,2,3
56872,4,2,199224,199224,199226,0,2,2
56873,2,2,199226,199226,199228,0,2,0
56874,4,2,199230,199230,199232,0,2,2
56875,5,1,199235,199235,199236,0,1,3
56876,5,2,199240,199240,199242,0,2,4
56877,2,1,199242,199242,199243,0,1,0
56878,2,3,199244,199244,199247,0,3,1
56879,5,3,199249,199249,199252,0,3,2
56880,4,3,199253,199253,199256,0,3,1
56881,3,2,199256,199256,199258,0,2,0
56882,2,2,199258,199258,199260,0,2,0
56883,6,1,199264,199264,199265,0,1,4
56884,1,1,199265,199265,199266,0,1,0
56885,1,2,199266,199266,199268,0,2,0
56886,5,3,199271,199271,199274,0,3,3
56887,1,2,199272,199274,199276,2,4,0
56888,1,2,199273,199276,199278,3,5,0
56889,6,1,199279,199279,199280,0,1,1
56890,3,2,199282,199282,199284,0,2,2
56891,6,3,199288,199288,199291,0,3,4
56892,3,1,199291,199291,199292,0,1,0
56893,6,3,199297,199297,199300,0,3,5
56894,5,1,199302,199302,199303,0,1,2
56895,5,1,199307,199307,199308,0,1,4
56896,3,3,199310,199310,199313,0,3,2
56897,6,1,199316,199316,199317,0,1,3
56898,1,1,199317,199317,199318,0,1,0
56899,4,3,199321,199321,199324,0,3,3
56900,5,3,199326,199326,199329,0,3,2
56901,5,2,199331,199331,199333,0,2,2
56902,2,3,199333,199333,199336,0,3,0
56903,1,2,199334,199336,199338,2,4,0
56904,6,2,199340,199340,199342,0,2,2
56905,6,3,199346,199346,199349,0,3,4
56906,5,3,199351,199351,199354,0,3,2
56907,4,3,199355,199355,199358,0,3,1
56908,1,2,199356,199358,199360,2,4,0
56909,5,2,199361,199361,199363,0,2,1
56910,4,3,199365,199365,199368,0,3,2
56911,5,2,199370,199370,199372,0,2,2
56912,6,3,199376,199376,199379,0,3,4
56913,6,1,199382,199382,199383,0,1,3
56914,6,3,199388,199388,199391,0,3,5
56915,2,2,199390,199391,199393,1,3,0
56916,1,3,199391,199393,199396,2,5,0
56917,5,3,199396,199396,199399,0,3,0
56918,2,3,199398,199399,199402,1,4,0
56919,5,1,199403,199403,199404,0,1,1
56920,1,2,199404,199404,199406,0,2,0
56921,4,1,199408,199408,199409,0,1,2
56922,3,1,199411,199411,199412,0,1,2
56923,3,3,199414,199414,199417,0,3,2
56924,4,2,199418,199418,199420,0,2,1
56925,6,2,199424,199424,199426,0,2,4
56926,2,1,199426,199426,199427,0,1,0
56927,2,1,199428,199428,199429,0,1,1
56928,4,2,199432,199432,199434,0,2,3
56929,4,1,199436,199436,199437,0,1,2
56930,6,2,199442,199442,199444,0,2,5
56931,3,2,199445,199445,199447,0,2,1
56932,3,2,199448,199448,199450,0,2,1
56933,4,1,199452,199452,199453,0,1,2
56934,2,2,199454,199454,199456,0,2,1
56935,1,3,199455,199456,199459,1,4,0
56936,5,2,199460,199460,199462,0,2,1
56937,3,2,199463,199463,199465,0,2,1
56938,1,1,199464,199465,199466,1,2,0
56939,4,2,199468,199468,199470,0,2,2
56940,4,1,199472,199472,199473,0,1,2
56941,2,1,199474,199474,199475,0,1,1
56942,3,1,199477,199477,199478,0,1,2
56943,4,1,199481,199481,199482,0,1,3
56944,4,3,199485,199485,199488,0,3,3
56945,5,2,199490,199490,199492,0,2,2
56946,1,2,199491,199492,199494,1,3,0
56947,3,2,199494,199494,199496,0,2,0
56948,6,2,199500,199500,199502,0,2,4
56949,6,1,199506,199506,199507,0,1,4
56950,1,2,199507,199507,199509,0,2,0
56951,4,1,199511,199511,199512,0,1,2
56952,6,1,199517,199517,199518,0,1,5
56953,1,2,199518,199518,199520,0,2,0
56954,3,2,199521,199521,199523,0,2,1
56955,2,1,199523,199523,199524,0,1,0
56956,5,3,199528,199528,199531,0,3,4
56957,3,1,199531,199531,199532,0,1,0
56958,1,3,199532,199532,199535,0,3,0
56959,4,2,199536,199536,199538,0,2,1
56960,5,3,199541,199541,199544,0,3,3
56961,6,3,199547,199547,199550,0,3,3
56962,6,3,199553,199553,199556,0,3,3
56963,5,2,199558,199558,199560,0,2,2
56964,3,1,199561,199561,199562,0,1,1
56965,4,3,199565,199565,199568,0,3,3
56966,4,2,199569,199569,199571,0,2,1
56967,3,2,199572,199572,199574,0,2,1
56968,1,1,199573,199574,199575,1,2,0
56969,2,1,199575,199575,199576,0,1,0
56970,1,1,199576,199576,199577,0,1,0
56971,6,3,199582,199582,199585,0,3,5
56972,5,1,199587,199587,199588,0,1,2
56973,4,1,199591,199591,199592,0,1,3
56974,4,1,199595,199595,199596,0,1,3
56975,6,1,199601,199601,199602,0,1,5
56976,2,3,199603,199603,199606,0,3,1
56977,4,2,199607,199607,199609,0,2,1
56978,1,1,199608,199609,199610,1,2,0
56979,6,2,199614,199614,199616,0,2,4
56980,4,3,199618,199618,199621,0,3,2
56981,3,2,199621,199621,199623,0,2,0
56982,6,2,199627,199627,199629,0,2,4
56983,5,1,199632,199632,199633,0,1,3
56984,4,2,199636,199636,199638,0,2,3
56985,4,3,199640,199640,199643,0,3,2
56986,4,3,199644,199644,199647,0,3,1
56987,1,3,199645,199647,199650,2,5,0
56988,3,1,199648,199650,199651,2,3,0
56989,5,2,199653,199653,199655,0,2,2
56990,1,1,199654,199655,199656,1,2,0
56991,2,1,199656,199656,199657,0,1,0
56992,5,3,199661,199661,199664,0,3,4
56993,4,2,199665,199665,199667,0,2,1
56994,6,3,199671,199671,199674,0,3,4
56995,3,1,199674,199674,199675,0,1,0
56996,6,1,199680,199680,199681,0,1,5
56997,5,1,199685,199685,199686,0,1,4
56998,3,3,199688,199688,199691,0,3,2
56999,3,2,199691,199691,199693,0,2,0
57000,5,1,199696,199696,199697,0,1,3
57001,4,2,199700,199700,199702,0,2,3
57002,3,3,199703,199703,199706,0,3,1
57003,3,1,199706,199706,199707,0,1,0
57004,2,2,199708,199708,199710,0,2,1
57005,2,3,199710,199710,199713,0,3,0
57006,4,3,199714,199714,199717,0,3,1
57007,4,1,199718,199718,199719,0,1,1
57008,2,3,199720,199720,199723,0,3,1
57009,1,1,199721,199723,199724,2,3,0
57010,6,1,199727,199727,199728,0,1,3
57011,1,3,199728,199728,199731,0,3,0
57012,4,1,199732,199732,199733,0,1,1
57013,2,2,199734,199734,199736,0,2,1
57014,5,3,199739,199739,199742,0,3,3
57015,1,3,199740,199742,199745,2,5,0
57016,6,2,199746,199746,199748,0,2,1
57017,6,2,199752,199752,199754,0,2,4
57018,4,3,199756,199756,199759,0,3,2
57019,2,1,199758,199759,199760,1,2,0
57020,6,1,199764,199764,199765,0,1,4
57021,6,1,199770,199770,199771,0,1,5
57022,3,3,199773,199773,199776,0,3,2
57023,3,2,199776,199776,199778,0,2,0
57024,5,3,199781,199781,199784,0,3,3
57025,5,2,199786,199786,199788,0,2,2
57026,1,3,199787,199788,199791,1,4,0
57027,3,3,199790,199791,199794,1,4,0
57028,3,2,199793,199794,199796,1,3,0
57029,5,3,199798,199798,199801,0,3,2
57030,2,1,199800,199801,199802,1,2,0
57031,5,1,199805,199805,199806,0,1,3
57032,5,2,199810,199810,199812,0,2,4
57033,3,2,199813,199813,199815,0,2,1
57034,3,2,199816,199816,199818,0,2,1
57035,6,1,199822,199822,199823,0,1,4
57036,5,2,199827,199827,199829,0,2,4
57037,1,3,199828,199829,199832,1,4,0
57038,1,3,199829,199832,199835,3,6,0
57039,3,2,199832,199835,199837,3,5,0
57040,3,2,199835,199837,199839,2,4,0
57041,2,2,199837,199839,199841,2,4,0
57042,4,2,199841,199841,199843,0,2,0
57043,4,3,199845,199845,199848,0,3,2
57044,6,1,199851,199851,199852,0,1,3
57045,2,2,199853,199853,199855,0,2,1
57046,3,2,199856,199856,199858,0,2,1
57047,5,2,199861,199861,199863,0,2,3
57048,4,1,199865,199865,199866,0,1,2
57049,6,1,199871,199871,199872,0,1,5
57050,4,2,199875,199875,199877,0,2,3
57051,3,2,199878,199878,199880,0,2,1
57052,3,3,199881,199881,199884,0,3,1
57053,3,1,199884,199884,199885,0,1,0
57054,2,3,199886,199886,199889,0,3,1
57055,1,2,199887,199889,199891,2,4,0
57056,2,3,199889,199891,199894,2,5,0
57057,4,1,199893,199894,199895,1,2,0
57058,2,2,199895,199895,199897,0,2,0
57059,3,1,199898,199898,199899,0,1,1
57060,2,3,199900,199900,199903,0,3,1
57061,3,3,199903,199903,199906,0,3,0
57062,5,1,199908,199908,199909,0,1,2
57063,3,3,199911,199911,199914,0,3,2
57064,2,3,199913,199914,199917,1,4,0
57065,6,1,199919,199919,199920,0,1,2
57066,4,3,199923,199923,199926,0,3,3
57067,5,2,199928,199928,199930,0,2,2
57068,6,3,199934,199934,199937,0,3,4
57069,1,2,199935,199937,199939,2,4,0
57070,1,3,199936,199939,199942,3,6,0
57071,3,2,199939,199942,199944,3,5,0
57072,4,2,199943,199944,199946,1,3,0
57073,1,1,199944,199946,199947,2,3,0
57074,5,1,199949,199949,199950,0,1,2
57075,3,2,199952,199952,199954,0,2,2
57076,4,2,199956,199956,199958,0,2,2
57077,4,3,199960,199960,199963,0,3,2
57078,4,3,199964,199964,199967,0,3,1
57079,4,1,199968,199968,199969,0,1,1
57080,6,3,199974,199974,199977,0,3,5
57081,1,2,199975,199977,199979,2,4,0
57082,6,1,199981,199981,199982,0,1,2
57083,3,2,199984,199984,199986,0,2,2
57084,6,1,199990,199990,199991,0,1,4
57085,3,3,199993,199993,199996,0,3,2
57086,5,1,199998,199998,199999,0,1,2
57087,2,3,200000,200000,200003,0,3,1
57088,3,2,200003,200003,200005,0,2,0
57089,4,3,200007,200007,200010,0,3,2
57090,5,2,200012,200012,200014,0,2,2
57091,6,3,200018,200018,200021,0,3,4
57092,4,3,200022,200022,200025,0,3,1
57093,3,3,200025,200025,200028,0,3,0
57094,6,2,200031,200031,200033,0,2,3
57095,6,1,200037,200037,200038,0,1,4
57096,2,3,200039,200039,200042,0,3,1
57097,1,2,200040,200042,200044,2,4,0
57098,1,2,200041,200044,200046,3,5,0
57099,2,1,200043,200046,200047,3,4,0
57100,6,1,200049,200049,200050,0,1,2
57101,6,2,200055,200055,200057,0,2,5
57102,1,3,200056,200057,200060,1,4,0
57103,6,3,200062,200062,200065,0,3,2
57104,4,3,200066,200066,200069,0,3,1
57105,6,2,200072,200072,200074,0,2,3
57106,3,3,200075,200075,200078,0,3,1
57107,5,2,200080,200080,200082,0,2,2
57108,6,3,200086,200086,200089,0,3,4
57109,2,2,200088,200089,200091,1,3,0
57110,4,3,200092,200092,200095,0,3,1
57111,6,2,200098,200098,200100,0,2,3
57112,1,2,200099,200100,200102,1,3,0
57113,4,3,200103,200103,200106,0,3,1
57114,4,3,200107,200107,200110,0,3,1
57115,3,1,200110,200110,200111,0,1,0
57116,2,1,200112,200112,200113,0,1,1
57117,2,3,200114,200114,200117,0,3,1
57118,4,1,200118,200118,200119,0,1,1
57119,3,1,200121,200121,200122,0,1,2
57120,2,2,200123,200123,200125,0,2,1
57121,6,1,200129,200129,200130,0,1,4
57122,2,2,200131,200131,200133,0,2,1
57123,4,2,200135,200135,200137,0,2,2
57124,6,2,200141,200141,200143,0,2,4
57125,6,3,200147,200147,200150,0,3,4
57126,6,1,200153,200153,200154,0,1,3
57127,5,1,200158,200158,200159,0,1,4
57128,3,3,200161,200161,200164,0,3,2
57129,2,3,200163,200164,200167,1,4,0
57130,5,1,200168,200168,200169,0,1,1
57131,4,2,200172,200172,200174,0,2,3
57132,5,3,200177,200177,200180,0,3,3
57133,4,3,200181,200181,200184,0,3,1
57134,6,3,200187,200187,200190,0,3,3
57135,6,1,200193,200193,200194,0,1,3
57136,3,2,200196,200196,200198,0,2,2
57137,4,3,200200,200200,200203,0,3,2
57138,2,3,200202,200203,200206,1,4,0
57139,4,3,200206,200206,200209,0,3,0
57140,2,1,200208,200209,200210,1,2,0
57141,1,1,200209,200210,200211,1,2,0
57142,4,1,200213,200213,200214,0,1,2
57143,2,1,200215,200215,200216,0,1,1
57144,5,2,200220,200220,200222,0,2,4
57145,2,1,200222,200222,200223,0,1,0
57146,1,3,200223,200223,200226,0,3,0
57147,5,1,200228,200228,200229,0,1,2
57148,3,2,200231,200231,200233,0,2,2
57149,1,2,200232,200233,200235,1,3,0
57150,4,1,200236,200236,200237,0,1,1
57151,4,3,200240,200240,200243,0,3,3
57152,4,3,200244,200244,200247,0,3,1
57153,2,1,200246,200247,200248,1,2,0
57154,3,1,200249,200249,200250,0,1,1
57155,2,2,200251,200251,200253,0,2,1
57156,6,1,200257,200257,200258,0,1,4
57157,5,2,200262,200262,200264,0,2,4
57158,2,3,200264,200264,200267,0,3,0
57159,1,2,200265,200267,200269,2,4,0
57160,4,1,200269,200269,200270,0,1,0
57161,1,2,200270,200270,200272,0,2,0
57162,4,1,200274,200274,200275,0,1,2
57163,6,2,200280,200280,200282,0,2,5
57164,6,2,200286,200286,200288,0,2,4
57165,1,2,200287,200288,200290,1,3,0
57166,1,1,200288,200290,200291,2,3,0
57167,3,1,200291,200291,200292,0,1,0
57168,6,3,200297,200297,200300,0,3,5
57169,1,2,200298,200300,200302,2,4,0
57170,5,3,200303,200303,200306,0,3,1
57171,2,2,200305,200306,200308,1,3,0
57172,1,3,200306,200308,200311,2,5,0
57173,2,1,200308,200311,200312,3,4,0
57174,3,3,200311,200312,200315,1,4,0
57175,4,1,200315,200315,200316,0,1,0
57176,3,2,200318,200318,200320,0,2,2
57177,1,2,200319,200320,200322,1,3,0
57178,4,2,200323,200323,200325,0,2,1
57179,4,2,200327,200327,200329,0,2,2
57180,2,1,200329,200329,200330,0,1,0
57181,5,1,200334,200334,200335,0,1,4
57182,4,1,200338,200338,200339,0,1,3
57183,4,1,200342,200342,200343,0,1,3
57184,5,3,200347,200347,200350,0,3,4
57185,1,3,200348,200350,200353,2,5,0
57186,5,3,200353,200353,200356,0,3,0
57187,5,3,200358,200358,200361,0,3,2
57188,6,3,200364,200364,200367,0,3,3
57189,5,2,200369,200369,200371,0,2,2
57190,4,3,200373,200373,200376,0,3,2
57191,6,2,200379,200379,200381,0,2,3
57192,4,3,200383,200383,200386,0,3,2
57193,5,3,200388,200388,200391,0,3,2
57194,3,1,200391,200391,200392,0,1,0
57195,1,2,200392,200392,200394,0,2,0
57196,2,1,200394,200394,200395,0,1,0
57197,2,2,200396,200396,200398,0,2,1
57198,4,1,200400,200400,200401,0,1,2
57199,2,2,200402,200402,200404,0,2,1
57200,6,3,200408,200408,200411,0,3,4
57201,5,2,200413,200413,200415,0,2,2
57202,1,2,200414,200415,200417,1,3,0
57203,2,2,200416,200417,200419,1,3,0
57204,5,3,200421,200421,200424,0,3,2
57205,3,2,200424,200424,200426,0,2,0
57206,3,3,200427,200427,200430,0,3,1
57207,1,2,200428,200430,200432,2,4,0
57208,1,2,200429,200432,200434,3,5,0
57209,4,2,200433,200434,200436,1,3,0
57210,3,2,200436,200436,200438,0,2,0
57211,3,2,200439,200439,200441,0,2,1
57212,5,1,200444,200444,200445,0,1,3
57213,6,2,200450,200450,200452,0,2,5
57214,2,2,200452,200452,200454,0,2,0
57215,1,1,200453,200454,200455,1,2,0
57216,6,3,200459,200459,200462,0,3,4
57217,2,1,200461,200462,200463,1,2,0
57218,2,1,200463,200463,200464,0,1,0
57219,5,3,200468,200468,200471,0,3,4
57220,6,1,200474,200474,200475,0,1,3
57221,5,3,200479,200479,200482,0,3,4
57222,3,1,200482,200482,200483,0,1,0
57223,5,3,200487,200487,200490,0,3,4
57224,3,2,200490,200490,200492,0,2,0
57225,3,1,200493,200493,200494,0,1,1
57226,2,3,200495,200495,200498,0,3,1
57227,2,2,200497,200498,200500,1,3,0
57228,3,2,200500,200500,200502,0,2,0
57229,4,3,200504,200504,200507,0,3,2
57230,5,1,200509,200509,200510,0,1,2
57231,4,1,200513,200513,200514,0,1,3
57232,1,3,200514,200514,200517,0,3,0
57233,5,3,200519,200519,200522,0,3,2
57234,2,3,200521,200522,200525,1,4,0
57235,4,3,200525,200525,200528,0,3,0
57236,1,1,200526,200528,200529,2,3,0
57237,1,2,200527,200529,200531,2,4,0
57238,4,1,200531,200531,200532,0,1,0
57239,6,3,200537,200537,200540,0,3,5
57240,2,3,200539,200540,200543,1,4,0
57241,2,3,200541,200543,200546,2,5,0
57242,1,2,200542,200546,200548,4,6,0
57243,1,3,200543,200548,200551,5,8,0
57244,1,3,200544,200551,200554,7,10,0
57245,6,1,200550,200554,200555,4,5,0
57246,2,2,200552,200555,200557,3,5,0
57247,1,1,200553,200557,200558,4,5,0
57248,5,3,200558,200558,200561,0,3,0
57249,1,2,200559,200561,200563,2,4,0
57250,1,1,200560,200563,200564,3,4,0
57251,2,1,200562,200564,200565,2,3,0
57252,2,2,200564,200565,200567,1,3,0
57253,3,1,200567,200567,200568,0,1,0
57254,6,1,200573,200573,200574,0,1,5
57255,5,1,200578,200578,200579,0,1,4
57256,2,2,200580,200580,200582,0,2,1
57257,2,3,200582,200582,200585,0,3,0
57258,5,2,200587,200587,200589,0,2,2
57259,3,1,200590,200590,200591,0,1,1
57260,2,3,200592,200592,200595,0,3,1
57261,4,3,200596,200596,200599,0,3,1
57262,4,1,200600,200600,200601,0,1,1
57263,5,1,200605,200605,200606,0,1,4
57264,2,2,200607,200607,200609,0,2,1
57265,3,2,200610,200610,200612,0,2,1
57266,1,1,200611,200612,200613,1,2,0
57267,4,1,200615,200615,200616,0,1,2
57268,3,1,200618,200618,200619,0,1,2
57269,3,3,200621,200621,200624,0,3,2
57270,1,3,200622,200624,200627,2,5,0
57271,4,2,200626,200627,200629,1,3,0
57272,3,3,200629,200629,200632,0,3,0
57273,2,1,200631,200632,200633,1,2,0
57274,2,2,200633,200633,200635,0,2,0
57275,4,2,200637,200637,200639,0,2,2
57276,2,3,200639,200639,200642,0,3,0
57277,5,2,200644,200644,200646,0,2,2
57278,3,1,200647,200647,200648,0,1,1
57279,4,1,200651,200651,200652,0,1,3
57280,1,1,200652,200652,200653,0,1,0
57281,4,3,200656,200656,200659,0,3,3
57282,6,2,200662,200662,200664,0,2,3
57283,4,3,200666,200666,200669,0,3,2
57284,3,1,200669,200669,200670,0,1,0
57285,1,3,200670,200670,200673,0,3,0
57286,5,1,200675,200675,200676,0,1,2
57287,1,3,200676,200676,200679,0,3,0
57288,5,3,200681,200681,200684,0,3,2
57289,4,2,200685,200685,200687,0,2,1
57290,4,2,200689,200689,200691,0,2,2
57291,3,3,200692,200692,200695,0,3,1
57292,3,1,200695,200695,200696,0,1,0
57293,6,2,200701,200701,200703,0,2,5
57294,6,3,200707,200707,200710,0,3,4
57295,6,3,200713,200713,200716,0,3,3
57296,2,3,200715,200716,200719,1,4,0
57297,1,2,200716,200719,200721,3,5,0
57298,1,1,200717,200721,200722,4,5,0
57299,3,3,200720,200722,200725,2,5,0
57300,6,1,200726,200726,200727,0,1,1
57301,2,1,200728,200728,200729,0,1,1
57302,5,3,200733,200733,200736,0,3,4
57303,1,2,200734,200736,200738,2,4,0
57304,1,1,200735,200738,200739,3,4,0
57305,3,3,200738,200739,200742,1,4,0
57306,2,1,200740,200742,200743,2,3,0
57307,5,3,200745,200745,200748,0,3,2
57308,3,3,200748,200748,200751,0,3,0
57309,6,3,200754,200754,200757,0,3,3
57310,6,1,200760,200760,200761,0,1,3
57311,3,1,200763,200763,200764,0,1,2
57312,3,1,200766,200766,200767,0,1,2
57313,4,3,200770,200770,200773,0,3,3
57314,5,2,200775,200775,200777,0,2,2
57315,1,3,200776,200777,200780,1,4,0
57316,4,1,200780,200780,200781,0,1,0
57317,6,1,200786,200786,200787,0,1,5
57318,2,1,200788,200788,200789,0,1,1
57319,4,1,200792,200792,200793,0,1,3
57320,2,1,200794,200794,200795,0,1,1
57321,6,3,200800,200800,200803,0,3,5
57322,3,3,200803,200803,200806,0,3,0
57323,2,1,200805,200806,200807,1,2,0
57324,2,3,200807,200807,200810,0,3,0
57325,1,2,200808,200810,200812,2,4,0
57326,5,3,200813,200813,200816,0,3,1
57327,3,2,200816,200816,200818,0,2,0
57328,3,2,200819,200819,200821,0,2,1
57329,1,1,200820,200821,200822,1,2,0
57330,3,1,200823,200823,200824,0,1,1
57331,5,1,200828,200828,200829,0,1,4
57332,1,3,200829,200829,200832,0,3,0
57333,2,3,200831,200832,200835,1,4,0
57334,6,2,200837,200837,200839,0,2,2
57335,6,3,200843,200843,200846,0,3,4
57336,5,1,200848,200848,200849,0,1,2
57337,6,1,200854,200854,200855,0,1,5
57338,3,3,200857,200857,200860,0,3,2
57339,2,3,200859,200860,200863,1,4,0
57340,2,1,200861,200863,200864,2,3,0
57341,1,3,200862,200864,200867,2,5,0
57342,5,3,200867,200867,200870,0,3,0
57343,5,3,200872,200872,200875,0,3,2
57344,4,2,200876,200876,200878,0,2,1
57345,3,2,200879,200879,200881,0,2,1
57346,5,3,200884,200884,200887,0,3,3
57347,6,2,200890,200890,200892,0,2,3
57348,6,2,200896,200896,200898,0,2,4
57349,6,1,200902,200902,200903,0,1,4
57350,2,1,200904,200904,200905,0,1,1
57351,1,3,200905,200905,200908,0,3,0
57352,6,1,200911,200911,200912,0,1,3
57353,6,2,200917,200917,200919,0,2,5
57354,1,3,200918,200919,200922,1,4,0
57355,5,1,200923,200923,200924,0,1,1
57356,6,3,200929,200929,200932,0,3,5
57357,6,2,200935,200935,200937,0,2,3
57358,2,1,200937,200937,200938,0,1,0
57359,4,3,200941,200941,200944,0,3,3
57360,6,3,200947,200947,200950,0,3,3
57361,5,2,200952,200952,200954,0,2,2
57362,4,3,200956,200956,200959,0,3,2
57363,6,2,200962,200962,200964,0,2,3
57364,6,1,200968,200968,200969,0,1,4
57365,5,2,200973,200973,200975,0,2,4
57366,4,3,200977,200977,200980,0,3,2
57367,2,3,200979,200980,200983,1,4,0
57368,2,3,200981,200983,200986,2,5,0
57369,3,2,200984,200986,200988,2,4,0
57370,6,2,200990,200990,200992,0,2,2
57371,4,1,200994,200994,200995,0,1,2
57372,2,1,200996,200996,200997,0,1,1
57373,2,3,200998,200998,201001,0,3,1
57374,1,1,200999,201001,201002,2,3,0
57375,4,2,201003,201003,201005,0,2,1
57376,4,1,201007,201007,201008,0,1,2
57377,4,2,201011,201011,201013,0,2,3
57378,6,3,201017,201017,201020,0,3,4
57379,1,3,201018,201020,201023,2,5,0
57380,4,1,201022,201023,201024,1,2,0
57381,3,3,201025,201025,201028,0,3,1
57382,6,2,201031,201031,201033,0,2,3
57383,1,3,201032,201033,201036,1,4,0
57384,4,1,201036,201036,201037,0,1,0
57385,5,3,201041,201041,201044,0,3,4
57386,5,3,201046,201046,201049,0,3,2
57387,4,3,201050,201050,201053,0,3,1
57388,1,2,201051,201053,201055,2,4,0
57389,2,2,201053,201055,201057,2,4,0
57390,1,2,201054,201057,201059,3,5,0
57391,6,1,201060,201060,201061,0,1,1
57392,6,3,201066,201066,201069,0,3,5
57393,6,1,201072,201072,201073,0,1,3
57394,1,2,201073,201073,201075,0,2,0
57395,5,2,201078,201078,201080,0,2,3
57396,6,3,201084,201084,201087,0,3,4
57397,3,3,201087,201087,201090,0,3,0
57398,4,3,201091,201091,201094,0,3,1
57399,1,2,201092,201094,201096,2,4,0
57400,6,3,201098,201098,201101,0,3,2
57401,3,1,201101,201101,201102,0,1,0
57402,6,1,201107,201107,201108,0,1,5
57403,6,1,201113,201113,201114,0,1,5
57404,3,3,201116,201116,201119,0,3,2
57405,6,2,201122,201122,201124,0,2,3
57406,4,1,201126,201126,201127,0,1,2
57407,1,1,201127,201127,201128,0,1,0
57408,4,1,201131,201131,201132,0,1,3
57409,2,3,201133,201133,201136,0,3,1
57410,6,1,201139,201139,201140,0,1,3
57411,2,2,201141,201141,201143,0,2,1
57412,5,1,201146,201146,201147,0,1,3
57413,4,3,201150,201150,201153,0,3,3
57414,2,3,201152,201153,201156,1,4,0
57415,4,3,201156,201156,201159,0,3,0
57416,5,3,201161,201161,201164,0,3,2
57417,1,1,201162,201164,201165,2,3,0
57418,6,3,201168,201168,201171,0,3,3
57419,5,2,201173,201173,201175,0,2,2
57420,5,2,201178,201178,201180,0,2,3
57421,5,3,201183,201183,201186,0,3,3
57422,4,1,201187,201187,201188,0,1,1
57423,2,2,201189,201189,201191,0,2,1
57424,3,2,201192,201192,201194,0,2,1
57425,2,3,201194,201194,201197,0,3,0
57426,3,3,201197,201197,201200,0,3,0
57427,4,1,201201,201201,201202,0,1,1
57428,4,1,201205,201205,201206,0,1,3
57429,3,3,201208,201208,201211,0,3,2
57430,5,2,201213,201213,201215,0,2,2
57431,3,3,201216,201216,201219,0,3,1
57432,1,1,201217,201219,201220,2,3,0
57433,4,2,201221,201221,201223,0,2,1
57434,2,1,201223,201223,201224,0,1,0
57435,6,3,201229,201229,201232,0,3,5
57436,6,3,201235,201235,201238,0,3,3
57437,3,2,201238,201238,201240,0,2,0
57438,5,3,201243,201243,201246,0,3,3
57439,1,3,201244,201246,201249,2,5,0
57440,1,2,201245,201249,201251,4,6,0
57441,6,3,201251,201251,201254,0,3,0
57442,2,3,201253,201254,201257,1,4,0
57443,6,3,201259,201259,201262,0,3,2
57444,1,2,201260,201262,201264,2,4,0
57445,4,1,201264,201264,201265,0,1,0
57446,5,2,201269,201269,201271,0,2,4
57447,2,1,201271,201271,201272,0,1,0
57448,4,1,201275,201275,201276,0,1,3
57449,1,3,201276,201276,201279,0,3,0
57450,2,1,201278,201279,201280,1,2,0
57451,3,1,201281,201281,201282,0,1,1
57452,4,3,201285,201285,201288,0,3,3
57453,5,3,201290,201290,201293,0,3,2
57454,1,2,201291,201293,201295,2,4,0
57455,2,3,201293,201295,201298,2,5,0
57456,6,2,201299,201299,201301,0,2,1
57457,2,3,201301,201301,201304,0,3,0
57458,1,3,201302,201304,201307,2,5,0
57459,6,3,201308,201308,201311,0,3,1
57460,1,3,201309,201311,201314,2,5,0
57461,6,2,201315,201315,201317,0,2,1
57462,4,1,201319,201319,201320,0,1,2
57463,6,2,201325,201325,201327,0,2,5
57464,3,2,201328,201328,201330,0,2,1
57465,5,1,201333,201333,201334,0,1,3
57466,2,3,201335,201335,201338,0,3,1
57467,6,3,201341,201341,201344,0,3,3
57468,1,3,201342,201344,201347,2,5,0
57469,4,3,201346,201347,201350,1,4,0
57470,2,1,201348,201350,201351,2,3,0
57471,6,3,201354,201354,201357,0,3,3
57472,3,2,201357,201357,201359,0,2,0
57473,1,3,201358,201359,201362,1,4,0
57474,6,1,201364,201364,201365,0,1,2
57475,6,3,201370,201370,201373,0,3,5
57476,3,3,201373,201373,201376,0,3,0
57477,6,1,201379,201379,201380,0,1,3
57478,2,2,201381,201381,201383,0,2,1
57479,3,1,201384,201384,201385,0,1,1
57480,5,1,201389,201389,201390,0,1,4
57481,5,2,201394,201394,201396,0,2,4
57482,4,2,201398,201398,201400,0,2,2
57483,5,3,201403,201403,201406,0,3,3
57484,4,2,201407,201407,201409,0,2,1
57485,5,3,201412,201412,201415,0,3,3
57486,5,1,201417,201417,201418,0,1,2
57487,5,1,201422,201422,201423,0,1,4
57488,6,3,201428,201428,201431,0,3,5
57489,4,3,201432,201432,201435,0,3,1
57490,1,2,201433,201435,201437,2,4,0
57491,1,3,201434,201437,201440,3,6,0
57492,1,3,201435,201440,201443,5,8,0
57493,2,1,201437,201443,201444,6,7,0
57494,2,1,201439,201444,201445,5,6,0
57495,3,2,201442,201445,201447,3,5,0
57496,5,3,201447,201447,201450,0,3,0
57497,5,3,201452,201452,201455,0,3,2
57498,2,3,201454,201455,201458,1,4,0
57499,3,2,201457,201458,201460,1,3,0
57500,3,1,201460,201460,201461,0,1,0
57501,6,3,201466,201466,201469,0,3,5
57502,3,3,201469,201469,201472,0,3,0
57503,1,2,201470,201472,201474,2,4,0
57504,3,2,201473,201474,201476,1,3,0
57505,4,2,201477,201477,201479,0,2,1
57506,6,2,201483,201483,201485,0,2,4
57507,5,3,201488,201488,201491,0,3,3
57508,3,3,201491,201491,201494,0,3,0
57509,2,2,201493,201494,201496,1,3,0
57510,5,1,201498,201498,201499,0,1,2
57511,4,1,201502,201502,201503,0,1,3
57512,2,2,201504,201504,201506,0,2,1
57513,1,1,201505,201506,201507,1,2,0
57514,6,3,201511,201511,201514,0,3,4
57515,4,1,201515,201515,201516,0,1,1
57516,5,3,201520,201520,201523,0,3,4
57517,4,1,201524,201524,201525,0,1,1
57518,1,1,201525,201525,201526,0,1,0
57519,5,2,201530,201530,201532,0,2,4
57520,4,2,201534,201534,201536,0,2,2
57521,3,1,201537,201537,201538,0,1,1
57522,4,2,201541,201541,201543,0,2,3
57523,4,2,201545,201545,201547,0,2,2
57524,2,2,201547,201547,201549,0,2,0
57525,2,1,201549,201549,201550,0,1,0
57526,5,2,201554,201554,201556,0,2,4
57527,4,1,201558,201558,201559,0,1,2
57528,4,1,201562,201562,201563,0,1,3
57529,4,1,201566,201566,201567,0,1,3
57530,1,3,201567,201567,201570,0,3,0
57531,6,1,201573,201573,201574,0,1,3
57532,1,3,201574,201574,201577,0,3,0
57533,1,2,201575,201577,201579,2,4,0
57534,4,2,201579,201579,201581,0,2,0
57535,6,3,201585,201585,201588,0,3,4
57536,1,3,201586,201588,201591,2,5,0
57537,2,2,201588,201591,201593,3,5,0
57538,3,3,201591,201593,201596,2,5,0
57539,5,3,201596,201596,201599,0,3,0
57540,2,2,201598,201599,201601,1,3,0
57541,4,3,201602,201602,201605,0,3,1
57542,6,3,201608,201608,201611,0,3,3
57543,4,1,201612,201612,201613,0,1,1
57544,1,3,201613,201613,201616,0,3,0
57545,5,1,201618,201618,201619,0,1,2
57546,2,3,201620,201620,201623,0,3,1
57547,4,2,201624,201624,201626,0,2,1
57548,4,3,201628,201628,201631,0,3,2
57549,3,1,201631,201631,201632,0,1,0
57550,5,2,201636,201636,201638,0,2,4
57551,1,1,201637,201638,201639,1,2,0
57552,4,3,201641,201641,201644,0,3,2
57553,2,3,201643,201644,201647,1,4,0
57554,2,1,201645,201647,201648,2,3,0
57555,1,1,201646,201648,201649,2,3,0
57556,3,3,201649,201649,201652,0,3,0
57557,5,3,201654,201654,201657,0,3,2
57558,5,3,201659,201659,201662,0,3,2
57559,5,1,201664,201664,201665,0,1,2
57560,6,2,201670,201670,201672,0,2,5
57561,1,1,201671,201672,201673,1,2,0
57562,2,1,201673,201673,201674,0,1,0
57563,1,1,201674,201674,201675,0,1,0
57564,1,3,201675,201675,201678,0,3,0
57565,4,3,201679,201679,201682,0,3,1
57566,4,1,201683,201683,201684,0,1,1
57567,5,1,201688,201688,201689,0,1,4
57568,4,2,201692,201692,201694,0,2,3
57569,2,3,201694,201694,201697,0,3,0
57570,4,2,201698,201698,201700,0,2,1
57571,4,1,201702,201702,201703,0,1,2
57572,6,3,201708,201708,201711,0,3,5
57573,5,3,201713,201713,201716,0,3,2
57574,4,2,201717,201717,201719,0,2,1
57575,4,1,201721,201721,201722,0,1,2
57576,2,1,201723,201723,201724,0,1,1
57577,4,2,201727,201727,201729,0,2,3
57578,2,3,201729,201729,201732,0,3,0
57579,6,1,201735,201735,201736,0,1,3
57580,5,1,201740,201740,201741,0,1,4
57581,4,1,201744,201744,201745,0,1,3
57582,2,3,201746,201746,201749,0,3,1
57583,1,3,201747,201749,201752,2,5,0
57584,3,2,201750,201752,201754,2,4,0
57585,5,2,201755,201755,201757,0,2,1
57586,2,2,201757,201757,201759,0,2,0
57587,3,3,201760,201760,201763,0,3,1
57588,5,3,201765,201765,201768,0,3,2
57589,5,1,201770,201770,201771,0,1,2
57590,3,1,201773,201773,201774,0,1,2
57591,2,2,201775,201775,201777,0,2,1
57592,1,3,201776,201777,201780,1,4,0
57593,1,2,201777,201780,201782,3,5,0
57594,1,2,201778,201782,201784,4,6,0
57595,2,1,201780,201784,201785,4,5,0
57596,3,2,201783,201785,201787,2,4,0
57597,6,3,201789,201789,201792,0,3,2
57598,3,2,201792,201792,201794,0,2,0
57599,3,3,201795,201795,201798,0,3,1
57600,2,3,201797,201798,201801,1,4,0
57601,1,2,201798,201801,201803,3,5,0
57602,6,1,201804,201804,201805,0,1,1
57603,3,1,201807,201807,201808,0,1,2
57604,5,3,201812,201812,201815,0,3,4
57605,5,1,201817,201817,201818,0,1,2
57606,5,3,201822,201822,201825,0,3,4
57607,4,2,201826,201826,201828,0,2,1
57608,6,2,201832,201832,201834,0,2,4
57609,5,2,201837,201837,201839,0,2,3
57610,2,1,201839,201839,201840,0,1,0
57611,4,3,201843,201843,201846,0,3,3
57612,2,2,201845,201846,201848,1,3,0
57613,3,2,201848,201848,201850,0,2,0
57614,2,2,201850,201850,201852,0,2,0
57615,6,3,201856,201856,201859,0,3,4
57616,1,3,201857,201859,201862,2,5,0
57617,6,2,201863,201863,201865,0,2,1
57618,3,1,201866,201866,201867,0,1,1
57619,6,3,201872,201872,201875,0,3,5
57620,3,1,201875,201875,201876,0,1,0
57621,2,3,201877,201877,201880,0,3,1
57622,2,1,201879,201880,201881,1,2,0
57623,5,3,201884,201884,201887,0,3,3
57624,1,1,201885,201887,201888,2,3,0
57625,1,2,201886,201888,201890,2,4,0
57626,1,3,201887,201890,201893,3,6,0
57627,5,2,201892,201893,201895,1,3,0
57628,5,2,201897,201897,201899,0,2,2
57629,2,1,201899,201899,201900,0,1,0
57630,2,3,201901,201901,201904,0,3,1
57631,5,2,201906,201906,201908,0,2,2
57632,5,1,201911,201911,201912,0,1,3
57633,5,1,201916,201916,201917,0,1,4
57634,5,2,201921,201921,201923,0,2,4
57635,3,3,201924,201924,201927,0,3,1
57636,5,1,201929,201929,201930,0,1,2
57637,5,1,201934,201934,201935,0,1,4
57638,5,3,201939,201939,201942,0,3,4
57639,2,3,201941,201942,201945,1,4,0
57640,2,3,201943,201945,201948,2,5,0
57641,5,1,201948,201948,201949,0,1,0
57642,2,1,201950,201950,201951,0,1,1
57643,6,2,201956,201956,201958,0,2,5
57644,6,2,201962,201962,201964,0,2,4
57645,4,2,201966,201966,201968,0,2,2
57646,1,2,201967,201968,201970,1,3,0
57647,5,1,201972,201972,201973,0,1,2
57648,5,1,201977,201977,201978,0,1,4
57649,1,1,201978,201978,201979,0,1,0
57650,2,1,201980,201980,201981,0,1,1
57651,3,1,201983,201983,201984,0,1,2
57652,4,1,201987,201987,201988,0,1,3
57653,3,1,201990,201990,201991,0,1,2
57654,1,2,201991,201991,201993,0,2,0
57655,2,1,201993,201993,201994,0,1,0
57656,6,3,201999,201999,202002,0,3,5
57657,6,2,202005,202005,202007,0,2,3
57658,1,2,202006,202007,202009,1,3,0
57659,6,2,202012,202012,202014,0,2,3
57660,5,3,202017,202017,202020,0,3,3
57661,5,1,202022,202022,202023,0,1,2
57662,5,3,202027,202027,202030,0,3,4
57663,2,2,202029,202030,202032,1,3,0
57664,5,1,202034,202034,202035,0,1,2
57665,5,1,202039,202039,202040,0,1,4
57666,6,3,202045,202045,202048,0,3,5
57667,6,3,202051,202051,202054,0,3,3
57668,1,1,202052,202054,202055,2,3,0
57669,4,3,202056,202056,202059,0,3,1
57670,6,3,202062,202062,202065,0,3,3
57671,4,2,202066,202066,202068,0,2,1
57672,6,2,202072,202072,202074,0,2,4
57673,1,2,202073,202074,202076,1,3,0
57674,6,2,202079,202079,202081,0,2,3
57675,1,2,202080,202081,202083,1,3,0
57676,5,2,202085,202085,202087,0,2,2
57677,5,1,202090,202090,202091,0,1,3
57678,6,1,202096,202096,202097,0,1,5
57679,1,1,202097,202097,202098,0,1,0
57680,2,2,202099,202099,202101,0,2,1
57681,6,3,202105,202105,202108,0,3,4
57682,1,2,202106,202108,202110,2,4,0
57683,1,3,202107,202110,202113,3,6,0
57684,4,3,202111,202113,202116,2,5,0
57685,2,2,202113,202116,202118,3,5,0
57686,1,3,202114,202118,202121,4,7,0
57687,2,2,202116,202121,202123,5,7,0
57688,1,1,202117,202123,202124,6,7,0
57689,3,1,202120,202124,202125,4,5,0
57690,4,1,202124,202125,202126,1,2,0
57691,2,1,202126,202126,202127,0,1,0
57692,4,3,202130,202130,202133,0,3,3
57693,6,2,202136,202136,202138,0,2,3
57694,3,1,202139,202139,202140,0,1,1
57695,5,2,202144,202144,202146,0,2,4
57696,4,1,202148,202148,202149,0,1,2
57697,1,2,202149,202149,202151,0,2,0
57698,1,2,202150,202151,202153,1,3,0
57699,5,3,202155,202155,202158,0,3,2
57700,1,1,202156,202158,202159,2,3,0
57701,2,2,202158,202159,202161,1,3,0
57702,5,2,202163,202163,202165,0,2,2
57703,6,2,202169,202169,202171,0,2,4
57704,5,1,202174,202174,202175,0,1,3
57705,6,2,202180,202180,202182,0,2,5
57706,3,2,202183,202183,202185,0,2,1
57707,1,1,202184,202185,202186,1,2,0
57708,1,1,202185,202186,202187,1,2,0
57709,4,1,202189,202189,202190,0,1,2
57710,2,1,202191,202191,202192,0,1,1
57711,3,2,202194,202194,202196,0,2,2
57712,2,2,202196,202196,202198,0,2,0
57713,5,2,202201,202201,202203,0,2,3
57714,4,3,202205,202205,202208,0,3,2
57715,2,1,202207,202208,202209,1,2,0
57716,4,3,202211,202211,202214,0,3,2
57717,2,1,202213,202214,202215,1,2,0
57718,6,3,202219,202219,202222,0,3,4
57719,3,1,202222,202222,202223,0,1,0
57720,1,3,202223,202223,202226,0,3,0
57721,3,2,202226,202226,202228,0,2,0
57722,6,1,202232,202232,202233,0,1,4
57723,5,2,202237,202237,202239,0,2,4
57724,2,1,202239,202239,202240,0,1,0
57725,4,2,202243,202243,202245,0,2,3
57726,2,1,202245,202245,202246,0,1,0
57727,3,2,202248,202248,202250,0,2,2
57728,4,1,202252,202252,202253,0,1,2
57729,1,3,202253,202253,202256,0,3,0
57730,3,1,202256,202256,202257,0,1,0
57731,6,3,202262,202262,202265,0,3,5
57732,5,1,202267,202267,202268,0,1,2
57733,4,3,202271,202271,202274,0,3,3
57734,6,1,202277,202277,202278,0,1,3
57735,1,1,202278,202278,202279,0,1,0
57736,6,2,202284,202284,202286,0,2,5
57737,3,2,202287,202287,202289,0,2,1
57738,2,3,202289,202289,202292,0,3,0
57739,2,2,202291,202292,202294,1,3,0
57740,6,2,202297,202297,202299,0,2,3
57741,6,2,202303,202303,202305,0,2,4
57742,5,1,202308,202308,202309,0,1,3
57743,5,2,202313,202313,202315,0,2,4
57744,2,2,202315,202315,202317,0,2,0
57745,2,3,202317,202317,202320,0,3,0
57746,1,2,202318,202320,202322,2,4,0
57747,4,3,202322,202322,202325,0,3,0
57748,6,2,202328,202328,202330,0,2,3
57749,6,1,202334,202334,202335,0,1,4
57750,4,1,202338,202338,202339,0,1,3
57751,1,2,202339,202339,202341,0,2,0
57752,4,2,202343,202343,202345,0,2,2
57753,1,2,202344,202345,202347,1,3,0
57754,4,1,202348,202348,202349,0,1,1
57755,3,3,202351,202351,202354,0,3,2
57756,6,3,202357,202357,202360,0,3,3
57757,4,2,202361,202361,202363,0,2,1
57758,4,3,202365,202365,202368,0,3,2
57759,1,3,202366,202368,202371,2,5,0
57760,6,2,202372,202372,202374,0,2,1
57761,6,3,202378,202378,202381,0,3,4
57762,5,1,202383,202383,202384,0,1,2
57763,1,3,202384,202384,202387,0,3,0
57764,3,3,202387,202387,202390,0,3,0
57765,1,1,202388,202390,202391,2,3,0
57766,4,1,202392,202392,202393,0,1,1
57767,2,2,202394,202394,202396,0,2,1
57768,5,1,202399,202399,202400,0,1,3
57769,6,2,202405,202405,202407,0,2,5
57770,4,2,202409,202409,202411,0,2,2
57771,6,3,202415,202415,202418,0,3,4
57772,5,3,202420,202420,202423,0,3,2
57773,5,3,202425,202425,202428,0,3,2
57774,3,3,202428,202428,202431,0,3,0
57775,4,1,202432,202432,202433,0,1,1
57776,3,2,202435,202435,202437,0,2,2
57777,3,3,202438,202438,202441,0,3,1
57778,5,2,202443,202443,202445,0,2,2
57779,3,3,202446,202446,202449,0,3,1
57780,2,1,202448,202449,202450,1,2,0
57781,4,2,202452,202452,202454,0,2,2
57782,2,2,202454,202454,202456,0,2,0
57783,5,1,202459,202459,202460,0,1,3
57784,3,2,202462,202462,202464,0,2,2
57785,2,3,202464,202464,202467,0,3,0
57786,2,3,202466,202467,202470,1,4,0
57787,5,2,202471,202471,202473,0,2,1
57788,3,2,202474,202474,202476,0,2,1
57789,4,3,202478,202478,202481,0,3,2
57790,6,3,202484,202484,202487,0,3,3
57791,4,1,202488,202488,202489,0,1,1
57792,1,1,202489,202489,202490,0,1,0
57793,6,3,202495,202495,202498,0,3,5
57794,1,2,202496,202498,202500,2,4,0
57795,3,1,202499,202500,202501,1,2,0
57796,6,1,202505,202505,202506,0,1,4
57797,5,2,202510,202510,202512,0,2,4
57798,3,3,202513,202513,202516,0,3,1
57799,1,2,202514,202516,202518,2,4,0
57800,3,3,202517,202518,202521,1,4,0
57801,5,3,202522,202522,202525,0,3,1
57802,6,3,202528,202528,202531,0,3,3
57803,4,1,202532,202532,202533,0,1,1
57804,4,1,202536,202536,202537,0,1,3
57805,5,1,202541,202541,202542,0,1,4
57806,2,1,202543,202543,202544,0,1,1
57807,1,3,202544,202544,202547,0,3,0
57808,1,3,202545,202547,202550,2,5,0
57809,5,3,202550,202550,202553,0,3,0
57810,1,3,202551,202553,202556,2,5,0
57811,6,1,202557,202557,202558,0,1,1
57812,4,2,202561,202561,202563,0,2,3
57813,3,1,202564,202564,202565,0,1,1
57814,1,1,202565,202565,202566,0,1,0
57815,1,2,202566,202566,202568,0,2,0
57816,6,1,202572,202572,202573,0,1,4
57817,1,3,202573,202573,202576,0,3,0
57818,2,3,202575,202576,202579,1,4,0
57819,1,1,202576,202579,202580,3,4,0
57820,2,1,202578,202580,202581,2,3,0
57821,5,1,202583,202583,202584,0,1,2
57822,4,2,202587,202587,202589,0,2,3
57823,6,1,202593,202593,202594,0,1,4
57824,6,2,202599,202599,202601,0,2,5
57825,2,1,202601,202601,202602,0,1,0
57826,3,2,202604,202604,202606,0,2,2
57827,1,2,202605,202606,202608,1,3,0
57828,3,1,202608,202608,202609,0,1,0
57829,1,1,202609,202609,202610,0,1,0
57830,4,3,202613,202613,202616,0,3,3
57831,2,3,202615,202616,202619,1,4,0
57832,5,2,202620,202620,202622,0,2,1
57833,2,3,202622,202622,202625,0,3,0
57834,5,2,202627,202627,202629,0,2,2
57835,3,1,202630,202630,202631,0,1,1
57836,6,2,202636,202636,202638,0,2,5
57837,3,3,202639,202639,202642,0,3,1
57838,1,3,202640,202642,202645,2,5,0
57839,4,3,202644,202645,202648,1,4,0
57840,4,2,202648,202648,202650,0,2,0
57841,4,1,202652,202652,202653,0,1,2
57842,6,2,202658,202658,202660,0,2,5
57843,5,3,202663,202663,202666,0,3,3
57844,5,2,202668,202668,202670,0,2,2
57845,3,3,202671,202671,202674,0,3,1
57846,3,2,202674,202674,202676,0,2,0
57847,1,1,202675,202676,202677,1,2,0
57848,5,2,202680,202680,202682,0,2,3
57849,6,3,202686,202686,202689,0,3,4
57850,2,1,202688,202689,202690,1,2,0
57851,4,2,202692,202692,202694,0,2,2
57852,5,2,202697,202697,202699,0,2,3
57853,5,2,202702,202702,202704,0,2,3
57854,1,3,202703,202704,202707,1,4,0
57855,1,3,202704,202707,202710,3,6,0
57856,5,3,202709,202710,202713,1,4,0
57857,2,1,202711,202713,202714,2,3,0
57858,6,3,202717,202717,202720,0,3,3
57859,4,2,202721,202721,202723,0,2,1
57860,4,1,202725,202725,202726,0,1,2
57861,5,1,202730,202730,202731,0,1,4
57862,4,3,202734,202734,202737,0,3,3
57863,2,2,202736,202737,202739,1,3,0
57864,4,2,202740,202740,202742,0,2,1
57865,2,2,202742,202742,202744,0,2,0
57866,2,2,202744,202744,202746,0,2,0
57867,3,1,202747,202747,202748,0,1,1
57868,5,3,202752,202752,202755,0,3,4
57869,4,3,202756,202756,202759,0,3,1
57870,6,1,202762,202762,202763,0,1,3
57871,3,2,202765,202765,202767,0,2,2
57872,4,2,202769,202769,202771,0,2,2
57873,5,3,202774,202774,202777,0,3,3
57874,6,3,202780,202780,202783,0,3,3
57875,1,3,202781,202783,202786,2,5,0
57876,6,1,202787,202787,202788,0,1,1
57877,5,1,202792,202792,202793,0,1,4
57878,4,1,202796,202796,202797,0,1,3
57879,5,2,202801,202801,202803,0,2,4
57880,3,3,202804,202804,202807,0,3,1
57881,5,1,202809,202809,202810,0,1,2
57882,2,1,202811,202811,202812,0,1,1
57883,5,3,202816,202816,202819,0,3,4
57884,2,3,202818,202819,202822,1,4,0
57885,5,3,202823,202823,202826,0,3,1
57886,3,1,202826,202826,202827,0,1,0
57887,3,3,202829,202829,202832,0,3,2
57888,1,1,202830,202832,202833,2,3,0
57889,5,2,202835,202835,202837,0,2,2
57890,5,1,202840,202840,202841,0,1,3
57891,4,3,202844,202844,202847,0,3,3
57892,6,3,202850,202850,202853,0,3,3
57893,5,3,202855,202855,202858,0,3,2
57894,2,2,202857,202858,202860,1,3,0
57895,4,1,202861,202861,202862,0,1,1
57896,2,2,202863,202863,202865,0,2,1
57897,2,1,202865,202865,202866,0,1,0
57898,1,3,202866,202866,202869,0,3,0
57899,3,2,202869,202869,202871,0,2,0
57900,1,1,202870,202871,202872,1,2,0
57901,3,1,202873,202873,202874,0,1,1
57902,6,2,202879,202879,202881,0,2,5
57903,3,3,202882,202882,202885,0,3,1
57904,3,3,202885,202885,202888,0,3,0
57905,5,1,202890,202890,202891,0,1,2
57906,6,1,202896,202896,202897,0,1,5
57907,3,1,202899,202899,202900,0,1,2
57908,2,2,202901,202901,202903,0,2,1
57909,5,2,202906,202906,202908,0,2,3
57910,6,1,202912,202912,202913,0,1,4
57911,1,2,202913,202913,202915,0,2,0
57912,2,3,202915,202915,202918,0,3,0
57913,6,2,202921,202921,202923,0,2,3
57914,3,2,202924,202924,202926,0,2,1
57915,2,1,202926,202926,202927,0,1,0
57916,2,3,202928,202928,202931,0,3,1
57917,4,2,202932,202932,202934,0,2,1
57918,1,3,202933,202934,202937,1,4,0
57919,1,3,202934,202937,202940,3,6,0
57920,2,1,202936,202940,202941,4,5,0
57921,6,2,202942,202942,202944,0,2,1
57922,1,2,202943,202944,202946,1,3,0
57923,3,3,202946,202946,202949,0,3,0
57924,6,1,202952,202952,202953,0,1,3
57925,6,3,202958,202958,202961,0,3,5
57926,1,2,202959,202961,202963,2,4,0
57927,5,1,202964,202964,202965,0,1,1
57928,2,1,202966,202966,202967,0,1,1
57929,5,1,202971,202971,202972,0,1,4
57930,4,2,202975,202975,202977,0,2,3
57931,3,1,202978,202978,202979,0,1,1
57932,6,1,202984,202984,202985,0,1,5
57933,4,3,202988,202988,202991,0,3,3
57934,4,2,202992,202992,202994,0,2,1
57935,4,2,202996,202996,202998,0,2,2
57936,5,3,203001,203001,203004,0,3,3
57937,3,1,203004,203004,203005,0,1,0
57938,4,3,203008,203008,203011,0,3,3
57939,5,2,203013,203013,203015,0,2,2
57940,5,2,203018,203018,203020,0,2,3
57941,5,1,203023,203023,203024,0,1,3
57942,5,3,203028,203028,203031,0,3,4
57943,1,3,203029,203031,203034,2,5,0
57944,3,2,203032,203034,203036,2,4,0
57945,1,2,203033,203036,203038,3,5,0
57946,3,2,203036,203038,203040,2,4,0
57947,2,2,203038,203040,203042,2,4,0
57948,6,2,203044,203044,203046,0,2,2
57949,3,1,203047,203047,203048,0,1,1
57950,3,1,203050,203050,203051,0,1,2
57951,6,2,203056,203056,203058,0,2,5
57952,6,3,203062,203062,203065,0,3,4
57953,1,2,203063,203065,203067,2,4,0
57954,5,3,203068,203068,203071,0,3,1
57955,4,1,203072,203072,203073,0,1,1
57956,6,3,203078,203078,203081,0,3,5
57957,2,1,203080,203081,203082,1,2,0
57958,1,1,203081,203082,203083,1,2,0
57959,2,1,203083,203083,203084,0,1,0
57960,6,1,203089,203089,203090,0,1,5
57961,5,1,203094,203094,203095,0,1,4
57962,6,3,203100,203100,203103,0,3,5
57963,6,2,203106,203106,203108,0,2,3
57964,3,1,203109,203109,203110,0,1,1
57965,3,1,203112,203112,203113,0,1,2
57966,4,3,203116,203116,203119,0,3,3
57967,1,3,203117,203119,203122,2,5,0
57968,3,2,203120,203122,203124,2,4,0
57969,3,3,203123,203124,203127,1,4,0
57970,2,2,203125,203127,203129,2,4,0
57971,2,3,203127,203129,203132,2,5,0
57972,5,3,203132,203132,203135,0,3,0
57973,4,1,203136,203136,203137,0,1,1
57974,2,3,203138,203138,203141,0,3,1
57975,1,2,203139,203141,203143,2,4,0
57976,2,1,203141,203143,203144,2,3,0
57977,1,3,203142,203144,203147,2,5,0
57978,3,3,203145,203147,203150,2,5,0
57979,3,3,203148,203150,203153,2,5,0
57980,2,2,203150,203153,203155,3,5,0
57981,5,1,203155,203155,203156,0,1,0
57982,5,1,203160,203160,203161,0,1,4
57983,6,2,203166,203166,203168,0,2,5
57984,1,1,203167,203168,203169,1,2,0
57985,2,3,203169,203169,203172,0,3,0
57986,6,1,203175,203175,203176,0,1,3
57987,5,1,203180,203180,203181,0,1,4
57988,4,1,203184,203184,203185,0,1,3
57989,4,1,203188,203188,203189,0,1,3
57990,5,3,203193,203193,203196,0,3,4
57991,3,2,203196,203196,203198,0,2,0
57992,6,3,203202,203202,203205,0,3,4
57993,6,1,203208,203208,203209,0,1,3
57994,1,2,203209,203209,203211,0,2,0
57995,6,1,203215,203215,203216,0,1,4
57996,2,1,203217,203217,203218,0,1,1
57997,1,1,203218,203218,203219,0,1,0
57998,5,2,203223,203223,203225,0,2,4
57999,1,1,203224,203225,203226,1,2,0
58000,5,1,203229,203229,203230,0,1,3
58001,2,1,203231,203231,203232,0,1,1
58002,4,2,203235,203235,203237,0,2,3
58003,4,3,203239,203239,203242,0,3,2
58004,3,3,203242,203242,203245,0,3,0
58005,1,3,203243,203245,203248,2,5,0
58006,3,1,203246,203248,203249,2,3,0
58007,3,2,203249,203249,203251,0,2,0
58008,3,2,203252,203252,203254,0,2,1
58009,5,2,203257,203257,203259,0,2,3
58010,5,2,203262,203262,203264,0,2,3
58011,3,3,203265,203265,203268,0,3,1
58012,2,2,203267,203268,203270,1,3,0
58013,3,1,203270,203270,203271,0,1,0
58014,4,1,203274,203274,203275,0,1,3
58015,1,3,203275,203275,203278,0,3,0
58016,1,3,203276,203278,203281,2,5,0
58017,4,3,203280,203281,203284,1,4,0
58018,4,2,203284,203284,203286,0,2,0
58019,3,1,203287,203287,203288,0,1,1
58020,4,1,203291,203291,203292,0,1,3
58021,2,2,203293,203293,203295,0,2,1
58022,4,3,203297,203297,203300,0,3,2
58023,6,2,203303,203303,203305,0,2,3
58024,1,1,203304,203305,203306,1,2,0
58025,6,3,203310,203310,203313,0,3,4
58026,6,3,203316,203316,203319,0,3,3
58027,1,3,203317,203319,203322,2,5,0
58028,6,1,203323,203323,203324,0,1,1
58029,5,1,203328,203328,203329,0,1,4
58030,6,1,203334,203334,203335,0,1,5
58031,5,1,203339,203339,203340,0,1,4
58032,3,1,203342,203342,203343,0,1,2
58033,2,1,203344,203344,203345,0,1,1
58034,2,2,203346,203346,203348,0,2,1
58035,1,2,203347,203348,203350,1,3,0
58036,4,3,203351,203351,203354,0,3,1
58037,3,1,203354,203354,203355,0,1,0
58038,4,1,203358,203358,203359,0,1,3
58039,3,1,203361,203361,203362,0,1,2
58040,2,2,203363,203363,203365,0,2,1
58041,5,3,203368,203368,203371,0,3,3
58042,6,1,203374,203374,203375,0,1,3
58043,2,1,203376,203376,203377,0,1,1
58044,3,3,203379,203379,203382,0,3,2
58045,2,3,203381,203382,203385,1,4,0
58046,5,3,203386,203386,203389,0,3,1
58047,3,2,203389,203389,203391,0,2,0
58048,4,1,203393,203393,203394,0,1,2
58049,6,3,203399,203399,203402,0,3,5
58050,5,2,203404,203404,203406,0,2,2
58051,6,3,203410,203410,203413,0,3,4
58052,1,1,203411,203413,203414,2,3,0
58053,3,3,203414,203414,203417,0,3,0
58054,5,2,203419,203419,203421,0,2,2
58055,1,3,203420,203421,203424,1,4,0
58056,1,3,203421,203424,203427,3,6,0
58057,3,3,203424,203427,203430,3,6,0
58058,3,2,203427,203430,203432,3,5,0
58059,5,3,203432,203432,203435,0,3,0
58060,2,3,203434,203435,203438,1,4,0
58061,5,3,203439,203439,203442,0,3,1
58062,6,3,203445,203445,203448,0,3,3
58063,6,3,203451,203451,203454,0,3,3
58064,6,2,203457,203457,203459,0,2,3
58065,5,1,203462,203462,203463,0,1,3
58066,2,2,203464,203464,203466,0,2,1
58067,2,1,203466,203466,203467,0,1,0
58068,4,1,203470,203470,203471,0,1,3
58069,1,3,203471,203471,203474,0,3,0
58070,3,1,203474,203474,203475,0,1,0
58071,3,2,203477,203477,203479,0,2,2
58072,1,3,203478,203479,203482,1,4,0
58073,1,1,203479,203482,203483,3,4,0
58074,4,3,203483,203483,203486,0,3,0
58075,4,1,203487,203487,203488,0,1,1
58076,2,1,203489,203489,203490,0,1,1
58077,4,1,203493,203493,203494,0,1,3
58078,3,1,203496,203496,203497,0,1,2
58079,4,2,203500,203500,203502,0,2,3
58080,5,2,203505,203505,203507,0,2,3
58081,6,1,203511,203511,203512,0,1,4
58082,4,3,203515,203515,203518,0,3,3
58083,1,3,203516,203518,203521,2,5,0
58084,6,1,203522,203522,203523,0,1,1
58085,2,2,203524,203524,203526,0,2,1
58086,3,2,203527,203527,203529,0,2,1
58087,2,2,203529,203529,203531,0,2,0
58088,6,2,203535,203535,203537,0,2,4
58089,1,2,203536,203537,203539,1,3,0
58090,6,2,203542,203542,203544,0,2,3
58091,2,1,203544,203544,203545,0,1,0
58092,6,1,203550,203550,203551,0,1,5
58093,6,3,203556,203556,203559,0,3,5
58094,3,3,203559,203559,203562,0,3,0
58095,4,2,203563,203563,203565,0,2,1
58096,3,3,203566,203566,203569,0,3,1
58097,1,2,203567,203569,203571,2,4,0
58098,5,2,203572,203572,203574,0,2,1
58099,6,1,203578,203578,203579,0,1,4
58100,6,3,203584,203584,203587,0,3,5
58101,3,1,203587,203587,203588,0,1,0
58102,3,3,203590,203590,203593,0,3,2
58103,6,3,203596,203596,203599,0,3,3
58104,4,2,203600,203600,203602,0,2,1
58105,5,2,203605,203605,203607,0,2,3
58106,5,2,203610,203610,203612,0,2,3
58107,6,2,203616,203616,203618,0,2,4
58108,2,1,203618,203618,203619,0,1,0
58109,4,2,203622,203622,203624,0,2,3
58110,6,2,203628,203628,203630,0,2,4
58111,3,2,203631,203631,203633,0,2,1
58112,3,3,203634,203634,203637,0,3,1
58113,6,2,203640,203640,203642,0,2,3
58114,3,3,203643,203643,203646,0,3,1
58115,6,2,203649,203649,203651,0,2,3
58116,4,2,203653,203653,203655,0,2,2
58117,2,3,203655,203655,203658,0,3,0
58118,6,1,203661,203661,203662,0,1,3
58119,4,3,203665,203665,203668,0,3,3
58120,6,1,203671,203671,203672,0,1,3
58121,4,3,203675,203675,203678,0,3,3
58122,6,1,203681,203681,203682,0,1,3
58123,3,1,203684,203684,203685,0,1,2
58124,2,2,203686,203686,203688,0,2,1
58125,1,3,203687,203688,203691,1,4,0
58126,2,2,203689,203691,203693,2,4,0
58127,3,3,203692,203693,203696,1,4,0
58128,2,2,203694,203696,203698,2,4,0
58129,6,1,203700,203700,203701,0,1,2
58130,4,3,203704,203704,203707,0,3,3
58131,4,3,203708,203708,203711,0,3,1
58132,2,2,203710,203711,203713,1,3,0
58133,4,3,203714,203714,203717,0,3,1
58134,5,3,203719,203719,203722,0,3,2
58135,6,2,203725,203725,203727,0,2,3
58136,5,1,203730,203730,203731,0,1,3
58137,3,3,203733,203733,203736,0,3,2
58138,3,2,203736,203736,203738,0,2,0
58139,3,1,203739,203739,203740,0,1,1
58140,4,2,203743,203743,203745,0,2,3
58141,6,3,203749,203749,203752,0,3,4
58142,6,2,203755,203755,203757,0,2,3
58143,4,2,203759,203759,203761,0,2,2
58144,5,1,203764,203764,203765,0,1,3
58145,2,3,203766,203766,203769,0,3,1
58146,1,2,203767,203769,203771,2,4,0
58147,6,3,203773,203773,203776,0,3,2
58148,5,2,203778,203778,203780,0,2,2
58149,5,1,203783,203783,203784,0,1,3
58150,4,1,203787,203787,203788,0,1,3
58151,6,2,203793,203793,203795,0,2,5
58152,4,2,203797,203797,203799,0,2,2
58153,1,2,203798,203799,203801,1,3,0
58154,1,1,203799,203801,203802,2,3,0
58155,3,1,203802,203802,203803,0,1,0
58156,6,1,203808,203808,203809,0,1,5
58157,2,3,203810,203810,203813,0,3,1
58158,4,3,203814,203814,203817,0,3,1
58159,6,3,203820,203820,203823,0,3,3
58160,6,3,203826,203826,203829,0,3,3
58161,2,3,203828,203829,203832,1,4,0
58162,4,3,203832,203832,203835,0,3,0
58163,2,3,203834,203835,203838,1,4,0
58164,4,3,203838,203838,203841,0,3,0
58165,5,2,203843,203843,203845,0,2,2
58166,4,2,203847,203847,203849,0,2,2
58167,6,2,203853,203853,203855,0,2,4
58168,2,1,203855,203855,203856,0,1,0
58169,3,3,203858,203858,203861,0,3,2
58170,4,2,203862,203862,203864,0,2,1
58171,3,1,203865,203865,203866,0,1,1
58172,4,1,203869,203869,203870,0,1,3
58173,1,3,203870,203870,203873,0,3,0
58174,4,1,203874,203874,203875,0,1,1
58175,1,2,203875,203875,203877,0,2,0
58176,2,1,203877,203877,203878,0,1,0
58177,5,1,203882,203882,203883,0,1,4
58178,3,3,203885,203885,203888,0,3,2
58179,2,1,203887,203888,203889,1,2,0
58180,6,1,203893,203893,203894,0,1,4
58181,5,1,203898,203898,203899,0,1,4
58182,1,1,203899,203899,203900,0,1,0
58183,6,1,203905,203905,203906,0,1,5
58184,1,3,203906,203906,203909,0,3,0
58185,6,1,203912,203912,203913,0,1,3
58186,5,2,203917,203917,203919,0,2,4
58187,2,2,203919,203919,203921,0,2,0
58188,5,2,203924,203924,203926,0,2,3
58189,5,1,203929,203929,203930,0,1,3
58190,6,3,203935,203935,203938,0,3,5
58191,6,2,203941,203941,203943,0,2,3
58192,1,2,203942,203943,203945,1,3,0
58193,6,1,203948,203948,203949,0,1,3
58194,3,3,203951,203951,203954,0,3,2
58195,5,1,203956,203956,203957,0,1,2
58196,1,3,203957,203957,203960,0,3,0
58197,5,2,203962,203962,203964,0,2,2
58198,6,1,203968,203968,203969,0,1,4
58199,6,2,203974,203974,203976,0,2,5
58200,5,3,203979,203979,203982,0,3,3
58201,6,1,203985,203985,203986,0,1,3
58202,1,2,203986,203986,203988,0,2,0
58203,4,1,203990,203990,203991,0,1,2
58204,4,2,203994,203994,203996,0,2,3
58205,1,1,203995,203996,203997,1,2,0
58206,1,1,203996,203997,203998,1,2,0
58207,2,1,203998,203998,203999,0,1,0
58208,6,3,204004,204004,204007,0,3,5
58209,5,1,204009,204009,204010,0,1,2
58210,5,1,204014,204014,204015,0,1,4
58211,5,1,204019,204019,204020,0,1,4
58212,4,2,204023,204023,204025,0,2,3
58213,4,3,204027,204027,204030,0,3,2
58214,1,1,204028,204030,204031,2,3,0
58215,5,3,204033,204033,204036,0,3,2
58216,6,1,204039,204039,204040,0,1,3
58217,4,2,204043,204043,204045,0,2,3
58218,4,2,204047,204047,204049,0,2,2
58219,5,3,204052,204052,204055,0,3,3
58220,2,3,204054,204055,204058,1,4,0
58221,6,1,204060,204060,204061,0,1,2
58222,1,2,204061,204061,204063,0,2,0
58223,5,1,204066,204066,204067,0,1,3
58224,4,3,204070,204070,204073,0,3,3
58225,1,2,204071,204073,204075,2,4,0
58226,5,3,204076,204076,204079,0,3,1
58227,3,1,204079,204079,204080,0,1,0
58228,5,1,204084,204084,204085,0,1,4
58229,3,1,204087,204087,204088,0,1,2
58230,1,1,204088,204088,204089,0,1,0
58231,2,2,204090,204090,204092,0,2,1
58232,3,1,204093,204093,204094,0,1,1
58233,6,2,204099,204099,204101,0,2,5
58234,1,3,204100,204101,204104,1,4,0
58235,6,3,204106,204106,204109,0,3,2
58236,1,1,204107,204109,204110,2,3,0
58237,6,3,204113,204113,204116,0,3,3
58238,6,3,204119,204119,204122,0,3,3
58239,2,2,204121,204122,204124,1,3,0
58240,6,3,204127,204127,204130,0,3,3
58241,3,3,204130,204130,204133,0,3,0
58242,2,3,204132,204133,204136,1,4,0
58243,1,3,204133,204136,204139,3,6,0
58244,3,3,204136,204139,204142,3,6,0
58245,5,3,204141,204142,204145,1,4,0
58246,5,3,204146,204146,204149,0,3,1
58247,2,3,204148,204149,204152,1,4,0
58248,5,3,204153,204153,204156,0,3,1
58249,1,2,204154,204156,204158,2,4,0
58250,6,1,204160,204160,204161,0,1,2
58251,3,1,204163,204163,204164,0,1,2
58252,2,1,204165,204165,204166,0,1,1
58253,3,1,204168,204168,204169,0,1,2
58254,3,1,204171,204171,204172,0,1,2
58255,5,1,204176,204176,204177,0,1,4
58256,3,1,204179,204179,204180,0,1,2
58257,1,1,204180,204180,204181,0,1,0
58258,5,3,204185,204185,204188,0,3,4
58259,3,3,204188,204188,204191,0,3,0
58260,5,3,204193,204193,204196,0,3,2
58261,4,3,204197,204197,204200,0,3,1
58262,1,3,204198,204200,204203,2,5,0
58263,4,3,204202,204203,204206,1,4,0
58264,6,3,204208,204208,204211,0,3,2
58265,3,1,204211,204211,204212,0,1,0
58266,4,3,204215,204215,204218,0,3,3
58267,5,3,204220,204220,204223,0,3,2
58268,5,2,204225,204225,204227,0,2,2
58269,3,1,204228,204228,204229,0,1,1
58270,2,2,204230,204230,204232,0,2,1
58271,6,2,204236,204236,204238,0,2,4
58272,1,2,204237,204238,204240,1,3,0
58273,3,1,204240,204240,204241,0,1,0
58274,4,1,204244,204244,204245,0,1,3
58275,4,3,204248,204248,204251,0,3,3
58276,5,2,204253,204253,204255,0,2,2
58277,2,1,204255,204255,204256,0,1,0
58278,4,1,204259,204259,204260,0,1,3
58279,3,1,204262,204262,204263,0,1,2
58280,3,2,204265,204265,204267,0,2,2
58281,4,2,204269,204269,204271,0,2,2
58282,2,1,204271,204271,204272,0,1,0
58283,4,3,204275,204275,204278,0,3,3
58284,3,1,204278,204278,204279,0,1,0
58285,4,3,204282,204282,204285,0,3,3
58286,5,3,204287,204287,204290,0,3,2
58287,4,1,204291,204291,204292,0,1,1
58288,4,3,204295,204295,204298,0,3,3
58289,5,2,204300,204300,204302,0,2,2
58290,6,3,204306,204306,204309,0,3,4
58291,2,2,204308,204309,204311,1,3,0
58292,4,1,204312,204312,204313,0,1,1
58293,1,1,204313,204313,204314,0,1,0
58294,2,3,204315,204315,204318,0,3,1
58295,1,2,204316,204318,204320,2,4,0
58296,1,2,204317,204320,204322,3,5,0
58297,6,2,204323,204323,204325,0,2,1
58298,3,2,204326,204326,204328,0,2,1
58299,4,3,204330,204330,204333,0,3,2
58300,2,3,204332,204333,204336,1,4,0
58301,6,1,204338,204338,204339,0,1,2
58302,1,3,204339,204339,204342,0,3,0
58303,4,3,204343,204343,204346,0,3,1
58304,1,1,204344,204346,204347,2,3,0
58305,2,2,204346,204347,204349,1,3,0
58306,5,2,204351,204351,204353,0,2,2
58307,6,2,204357,204357,204359,0,2,4
58308,5,3,204362,204362,204365,0,3,3
58309,4,1,204366,204366,204367,0,1,1
58310,1,1,204367,204367,204368,0,1,0
58311,5,2,204372,204372,204374,0,2,4
58312,1,2,204373,204374,204376,1,3,0
58313,6,3,204379,204379,204382,0,3,3
58314,6,3,204385,204385,204388,0,3,3
58315,5,3,204390,204390,204393,0,3,2
58316,5,1,204395,204395,204396,0,1,2
58317,4,3,204399,204399,204402,0,3,3
58318,5,1,204404,204404,204405,0,1,2
58319,5,3,204409,204409,204412,0,3,4
58320,6,1,204415,204415,204416,0,1,3
58321,5,3,204420,204420,204423,0,3,4
58322,3,3,204423,204423,204426,0,3,0
58323,6,3,204429,204429,204432,0,3,3
58324,1,3,204430,204432,204435,2,5,0
58325,5,2,204435,204435,204437,0,2,0
58326,6,3,204441,204441,204444,0,3,4
58327,3,3,204444,204444,204447,0,3,0
58328,2,1,204446,204447,204448,1,2,0
58329,5,2,204451,204451,204453,0,2,3
58330,3,2,204454,204454,204456,0,2,1
58331,2,1,204456,204456,204457,0,1,0
58332,2,3,204458,204458,204461,0,3,1
58333,6,1,204464,204464,204465,0,1,3
58334,4,3,204468,204468,204471,0,3,3
58335,1,1,204469,204471,204472,2,3,0
58336,1,3,204470,204472,204475,2,5,0
58337,1,2,204471,204475,204477,4,6,0
58338,5,1,204476,204477,204478,1,2,0
58339,2,1,204478,204478,204479,0,1,0
58340,5,1,204483,204483,204484,0,1,4
58341,3,1,204486,204486,204487,0,1,2
58342,5,3,204491,204491,204494,0,3,4
58343,1,3,204492,204494,204497,2,5,0
58344,3,2,204495,204497,204499,2,4,0
58345,5,1,204500,204500,204501,0,1,1
58346,4,2,204504,204504,204506,0,2,3
58347,2,1,204506,204506,204507,0,1,0
58348,4,1,204510,204510,204511,0,1,3
58349,2,2,204512,204512,204514,0,2,1
58350,4,3,204516,204516,204519,0,3,2
58351,3,1,204519,204519,204520,0,1,0
58352,2,3,204521,204521,204524,0,3,1
58353,1,2,204522,204524,204526,2,4,0
58354,4,1,204526,204526,204527,0,1,0
58355,6,3,204532,204532,204535,0,3,5
58356,6,2,204538,204538,204540,0,2,3
58357,2,1,204540,204540,204541,0,1,0
58358,5,2,204545,204545,204547,0,2,4
58359,5,2,204550,204550,204552,0,2,3
58360,4,3,204554,204554,204557,0,3,2
58361,1,1,204555,204557,204558,2,3,0
58362,4,1,204559,204559,204560,0,1,1
58363,3,3,204562,204562,204565,0,3,2
58364,4,3,204566,204566,204569,0,3,1
58365,3,3,204569,204569,204572,0,3,0
58366,2,3,204571,204572,204575,1,4,0
58367,6,3,204577,204577,204580,0,3,2
58368,3,3,204580,204580,204583,0,3,0
58369,3,3,204583,204583,204586,0,3,0
58370,3,2,204586,204586,204588,0,2,0
58371,5,2,204591,204591,204593,0,2,3
58372,5,1,204596,204596,204597,0,1,3
58373,2,3,204598,204598,204601,0,3,1
58374,3,2,204601,204601,204603,0,2,0
58375,2,1,204603,204603,204604,0,1,0
58376,6,2,204609,204609,204611,0,2,5
58377,4,2,204613,204613,204615,0,2,2
58378,6,1,204619,204619,204620,0,1,4
58379,4,2,204623,204623,204625,0,2,3
58380,1,2,204624,204625,204627,1,3,0
58381,2,1,204626,204627,204628,1,2,0
58382,6,3,204632,204632,204635,0,3,4
58383,3,2,204635,204635,204637,0,2,0
58384,1,1,204636,204637,204638,1,2,0
58385,4,1,204640,204640,204641,0,1,2
58386,3,3,204643,204643,204646,0,3,2
58387,5,1,204648,204648,204649,0,1,2
58388,5,2,204653,204653,204655,0,2,4
58389,1,1,204654,204655,204656,1,2,0
58390,6,1,204660,204660,204661,0,1,4
58391,2,3,204662,204662,204665,0,3,1
58392,5,1,204667,204667,204668,0,1,2
58393,2,2,204669,204669,204671,0,2,1
58394,1,2,204670,204671,204673,1,3,0
58395,1,3,204671,204673,204676,2,5,0
58396,6,1,204677,204677,204678,0,1,1
58397,4,2,204681,204681,204683,0,2,3
58398,5,2,204686,204686,204688,0,2,3
58399,2,1,204688,204688,204689,0,1,0
58400,4,1,204692,204692,204693,0,1,3
58401,5,1,204697,204697,204698,0,1,4
58402,5,3,204702,204702,204705,0,3,4
58403,4,3,204706,204706,204709,0,3,1
58404,4,2,204710,204710,204712,0,2,1
58405,2,2,204712,204712,204714,0,2,0
58406,1,1,204713,204714,204715,1,2,0
58407,2,2,204715,204715,204717,0,2,0
58408,3,1,204718,204718,204719,0,1,1
58409,5,1,204723,204723,204724,0,1,4
58410,1,2,204724,204724,204726,0,2,0
58411,5,1,204729,204729,204730,0,1,3
58412,3,1,204732,204732,204733,0,1,2
58413,5,2,204737,204737,204739,0,2,4
58414,2,2,204739,204739,204741,0,2,0
58415,1,1,204740,204741,204742,1,2,0
58416,6,2,204746,204746,204748,0,2,4
58417,1,1,204747,204748,204749,1,2,0
58418,1,2,204748,204749,204751,1,3,0
58419,3,1,204751,204751,204752,0,1,0
58420,5,2,204756,204756,204758,0,2,4
58421,1,1,204757,204758,204759,1,2,0
58422,6,3,204763,204763,204766,0,3,4
58423,5,1,204768,204768,204769,0,1,2
58424,4,2,204772,204772,204774,0,2,3
58425,6,2,204778,204778,204780,0,2,4
58426,6,3,204784,204784,204787,0,3,4
58427,5,2,204789,204789,204791,0,2,2
58428,3,2,204792,204792,204794,0,2,1
58429,5,3,204797,204797,204800,0,3,3
58430,3,3,204800,204800,204803,0,3,0
58431,1,2,204801,204803,204805,2,4,0
58432,4,1,204805,204805,204806,0,1,0
58433,5,1,204810,204810,204811,0,1,4
58434,5,2,204815,204815,204817,0,2,4
58435,6,1,204821,204821,204822,0,1,4
58436,6,3,204827,204827,204830,0,3,5
58437,3,1,204830,204830,204831,0,1,0
58438,1,1,204831,204831,204832,0,1,0
58439,6,1,204837,204837,204838,0,1,5
58440,5,1,204842,204842,204843,0,1,4
58441,6,1,204848,204848,204849,0,1,5
58442,4,1,204852,204852,204853,0,1,3
58443,3,1,204855,204855,204856,0,1,2
58444,2,1,204857,204857,204858,0,1,1
58445,1,1,204858,204858,204859,0,1,0
58446,1,2,204859,204859,204861,0,2,0
58447,4,3,204863,204863,204866,0,3,2
58448,6,1,204869,204869,204870,0,1,3
58449,2,1,204871,204871,204872,0,1,1
58450,1,3,204872,204872,204875,0,3,0
58451,3,3,204875,204875,204878,0,3,0
58452,1,2,204876,204878,204880,2,4,0
58453,4,2,204880,204880,204882,0,2,0
58454,4,3,204884,204884,204887,0,3,2
58455,4,3,204888,204888,204891,0,3,1
58456,2,3,204890,204891,204894,1,4,0
58457,2,1,204892,204894,204895,2,3,0
58458,6,2,204898,204898,204900,0,2,3
58459,6,3,204904,204904,204907,0,3,4
58460,3,3,204907,204907,204910,0,3,0
58461,3,3,204910,204910,204913,0,3,0
58462,3,1,204913,204913,204914,0,1,0
58463,2,2,204915,204915,204917,0,2,1
58464,1,3,204916,204917,204920,1,4,0
58465,3,1,204919,204920,204921,1,2,0
58466,1,1,204920,204921,204922,1,2,0
58467,4,1,204924,204924,204925,0,1,2
58468,6,2,204930,204930,204932,0,2,5
58469,6,3,204936,204936,204939,0,3,4
58470,5,2,204941,204941,204943,0,2,2
58471,6,3,204947,204947,204950,0,3,4
58472,4,1,204951,204951,204952,0,1,1
58473,5,1,204956,204956,204957,0,1,4
58474,2,2,204958,204958,204960,0,2,1
58475,1,1,204959,204960,204961,1,2,0
58476,2,3,204961,204961,204964,0,3,0
58477,5,1,204966,204966,204967,0,1,2
58478,3,2,204969,204969,204971,0,2,2
58479,6,3,204975,204975,204978,0,3,4
58480,5,3,204980,204980,204983,0,3,2
58481,4,1,204984,204984,204985,0,1,1
58482,5,2,204989,204989,204991,0,2,4
58483,5,1,204994,204994,204995,0,1,3
58484,3,3,204997,204997,205000,0,3,2
58485,3,3,205000,205000,205003,0,3,0
58486,4,2,205004,205004,205006,0,2,1
58487,6,3,205010,205010,205013,0,3,4
58488,3,1,205013,205013,205014,0,1,0
58489,3,2,205016,205016,205018,0,2,2
58490,2,1,205018,205018,205019,0,1,0
58491,1,1,205019,205019,205020,0,1,0
58492,5,1,205024,205024,205025,0,1,4
58493,3,3,205027,205027,205030,0,3,2
58494,4,2,205031,205031,205033,0,2,1
58495,3,1,205034,205034,205035,0,1,1
58496,4,1,205038,205038,205039,0,1,3
58497,1,1,205039,205039,205040,0,1,0
58498,2,2,205041,205041,205043,0,2,1
58499,5,2,205046,205046,205048,0,2,3
58500,4,2,205050,205050,205052,0,2,2
58501,3,3,205053,205053,205056,0,3,1
58502,5,2,205058,205058,205060,0,2,2
58503,5,2,205063,205063,205065,0,2,3
58504,3,2,205066,205066,205068,0,2,1
58505,1,3,205067,205068,205071,1,4,0
58506,3,2,205070,205071,205073,1,3,0
58507,5,1,205075,205075,205076,0,1,2
58508,4,3,205079,205079,205082,0,3,3
58509,6,2,205085,205085,205087,0,2,3
58510,2,2,205087,205087,205089,0,2,0
58511,2,2,205089,205089,205091,0,2,0
58512,6,2,205095,205095,205097,0,2,4
58513,1,2,205096,205097,205099,1,3,0
58514,3,3,205099,205099,205102,0,3,0
58515,1,3,205100,205102,205105,2,5,0
58516,3,3,205103,205105,205108,2,5,0
58517,4,3,205107,205108,205111,1,4,0
58518,2,3,205109,205111,205114,2,5,0
58519,1,3,205110,205114,205117,4,7,0
58520,3,2,205113,205117,205119,4,6,0
58521,3,2,205116,205119,205121,3,5,0
58522,5,3,205121,205121,205124,0,3,0
58523,1,1,205122,205124,205125,2,3,0
58524,3,1,205125,205125,205126,0,1,0
58525,2,3,205127,205127,205130,0,3,1
58526,3,1,205130,205130,205131,0,1,0
58527,3,2,205133,205133,205135,0,2,2
58528,3,3,205136,205136,205139,0,3,1
58529,2,1,205138,205139,205140,1,2,0
58530,4,2,205142,205142,205144,0,2,2
58531,2,2,205144,205144,205146,0,2,0
58532,4,2,205148,205148,205150,0,2,2
58533,5,1,205153,205153,205154,0,1,3
58534,3,1,205156,205156,205157,0,1,2
58535,6,2,205162,205162,205164,0,2,5
58536,6,2,205168,205168,205170,0,2,4
58537,5,2,205173,205173,205175,0,2,3
58538,1,2,205174,205175,205177,1,3,0
58539,3,1,205177,205177,205178,0,1,0
58540,4,3,205181,205181,205184,0,3,3
58541,2,1,205183,205184,205185,1,2,0
58542,1,2,205184,205185,205187,1,3,0
58543,5,3,205189,205189,205192,0,3,2
58544,5,3,205194,205194,205197,0,3,2
58545,2,1,205196,205197,205198,1,2,0
58546,3,1,205199,205199,205200,0,1,1
58547,1,3,205200,205200,205203,0,3,0
58548,2,2,205202,205203,205205,1,3,0
58549,2,3,205204,205205,205208,1,4,0
58550,4,3,205208,205208,205211,0,3,0
58551,1,3,205209,205211,205214,2,5,0
58552,4,1,205213,205214,205215,1,2,0
58553,3,1,205216,205216,205217,0,1,1
58554,5,1,205221,205221,205222,0,1,4
58555,2,1,205223,205223,205224,0,1,1
58556,2,3,205225,205225,205228,0,3,1
58557,4,3,205229,205229,205232,0,3,1
58558,1,3,205230,205232,205235,2,5,0
58559,5,1,205235,205235,205236,0,1,0
58560,3,1,205238,205238,205239,0,1,2
58561,1,3,205239,205239,205242,0,3,0
58562,1,3,205240,205242,205245,2,5,0
58563,3,1,205243,205245,205246,2,3,0
58564,4,2,205247,205247,205249,0,2,1
58565,4,3,205251,205251,205254,0,3,2
58566,3,3,205254,205254,205257,0,3,0
58567,3,1,205257,205257,205258,0,1,0
58568,1,1,205258,205258,205259,0,1,0
58569,2,2,205260,205260,205262,0,2,1
58570,6,2,205266,205266,205268,0,2,4
58571,6,1,205272,205272,205273,0,1,4
58572,5,3,205277,205277,205280,0,3,4
58573,4,3,205281,205281,205284,0,3,1
58574,3,2,205284,205284,205286,0,2,0
58575,2,1,205286,205286,205287,0,1,0
58576,3,3,205289,205289,205292,0,3,2
58577,3,1,205292,205292,205293,0,1,0
58578,5,1,205297,205297,205298,0,1,4
58579,4,2,205301,205301,205303,0,2,3
58580,1,1,205302,205303,205304,1,2,0
58581,2,2,205304,205304,205306,0,2,0
58582,6,1,205310,205310,205311,0,1,4
58583,5,2,205315,205315,205317,0,2,4
58584,1,3,205316,205317,205320,1,4,0
58585,4,2,205320,205320,205322,0,2,0
58586,5,3,205325,205325,205328,0,3,3
58587,3,1,205328,205328,205329,0,1,0
58588,4,2,205332,205332,205334,0,2,3
58589,1,2,205333,205334,205336,1,3,0
58590,3,2,205336,205336,205338,0,2,0
58591,4,2,205340,205340,205342,0,2,2
58592,4,1,205344,205344,205345,0,1,2
58593,6,3,205350,205350,205353,0,3,5
58594,4,1,205354,205354,205355,0,1,1
58595,5,1,205359,205359,205360,0,1,4
58596,3,1,205362,205362,205363,0,1,2
58597,5,1,205367,205367,205368,0,1,4
58598,4,1,205371,205371,205372,0,1,3
58599,1,3,205372,205372,205375,0,3,0
58600,5,3,205377,205377,205380,0,3,2
58601,6,2,205383,205383,205385,0,2,3
58602,1,2,205384,205385,205387,1,3,0
58603,5,3,205389,205389,205392,0,3,2
58604,4,3,205393,205393,205396,0,3,1
58605,1,1,205394,205396,205397,2,3,0
58606,6,2,205400,205400,205402,0,2,3
58607,6,3,205406,205406,205409,0,3,4
58608,5,1,205411,205411,205412,0,1,2
58609,5,1,205416,205416,205417,0,1,4
58610,6,2,205422,205422,205424,0,2,5
58611,5,1,205427,205427,205428,0,1,3
58612,1,3,205428,205428,205431,0,3,0
58613,4,3,205432,205432,205435,0,3,1
58614,1,3,205433,205435,205438,2,5,0
58615,3,3,205436,205438,205441,2,5,0
58616,4,1,205440,205441,205442,1,2,0
58617,1,2,205441,205442,205444,1,3,0
58618,4,3,205445,205445,205448,0,3,1
58619,6,3,205451,205451,205454,0,3,3
58620,5,1,205456,205456,205457,0,1,2
58621,5,2,205461,205461,205463,0,2,4
58622,1,3,205462,205463,205466,1,4,0
58623,2,3,205464,205466,205469,2,5,0
58624,6,3,205470,205470,205473,0,3,1
58625,4,1,205474,205474,205475,0,1,1
58626,3,3,205477,205477,205480,0,3,2
58627,1,1,205478,205480,205481,2,3,0
58628,1,2,205479,205481,205483,2,4,0
58629,5,2,205484,205484,205486,0,2,1
58630,1,2,205485,205486,205488,1,3,0
58631,6,3,205491,205491,205494,0,3,3
58632,6,2,205497,205497,205499,0,2,3
58633,4,3,205501,205501,205504,0,3,2
58634,2,3,205503,205504,205507,1,4,0
58635,3,1,205506,205507,205508,1,2,0
58636,3,2,205509,205509,205511,0,2,1
58637,6,2,205515,205515,205517,0,2,4
58638,1,1,205516,205517,205518,1,2,0
58639,1,3,205517,205518,205521,1,4,0
58640,6,3,205523,205523,205526,0,3,2
58641,1,3,205524,205526,205529,2,5,0
58642,4,3,205528,205529,205532,1,4,0
58643,2,3,205530,205532,205535,2,5,0
58644,6,3,205536,205536,205539,0,3,1
58645,6,1,205542,205542,205543,0,1,3
58646,2,1,205544,205544,205545,0,1,1
58647,2,3,205546,205546,205549,0,3,1
58648,3,3,205549,205549,205552,0,3,0
58649,5,3,205554,205554,205557,0,3,2
58650,2,3,205556,205557,205560,1,4,0
58651,2,2,205558,205560,205562,2,4,0
58652,4,1,205562,205562,205563,0,1,0
58653,3,2,205565,205565,205567,0,2,2
58654,2,2,205567,205567,205569,0,2,0
58655,6,3,205573,205573,205576,0,3,4
58656,2,3,205575,205576,205579,1,4,0
58657,2,2,205577,205579,205581,2,4,0
58658,3,1,205580,205581,205582,1,2,0
58659,3,3,205583,205583,205586,0,3,1
58660,3,2,205586,205586,205588,0,2,0
58661,5,2,205591,205591,205593,0,2,3
58662,4,3,205595,205595,205598,0,3,2
58663,3,1,205598,205598,205599,0,1,0
58664,4,1,205602,205602,205603,0,1,3
58665,4,1,205606,205606,205607,0,1,3
58666,4,1,205610,205610,205611,0,1,3
58667,3,1,205613,205613,205614,0,1,2
58668,6,3,205619,205619,205622,0,3,5
58669,5,2,205624,205624,205626,0,2,2
58670,5,1,205629,205629,205630,0,1,3
58671,3,2,205632,205632,205634,0,2,2
58672,6,2,205638,205638,205640,0,2,4
58673,4,2,205642,205642,205644,0,2,2
58674,1,2,205643,205644,205646,1,3,0
58675,5,2,205648,205648,205650,0,2,2
58676,6,1,205654,205654,205655,0,1,4
58677,1,3,205655,205655,205658,0,3,0
58678,3,1,205658,205658,205659,0,1,0
58679,3,1,205661,205661,205662,0,1,2
58680,4,3,205665,205665,205668,0,3,3
58681,3,1,205668,205668,205669,0,1,0
58682,1,3,205669,205669,205672,0,3,0
58683,4,3,205673,205673,205676,0,3,1
58684,6,1,205679,205679,205680,0,1,3
58685,5,2,205684,205684,205686,0,2,4
58686,2,1,205686,205686,205687,0,1,0
58687,5,2,205691,205691,205693,0,2,4
58688,3,3,205694,205694,205697,0,3,1
58689,3,1,205697,205697,205698,0,1,0
58690,2,3,205699,205699,205702,0,3,1
58691,6,1,205705,205705,205706,0,1,3
58692,1,3,205706,205706,205709,0,3,0
58693,5,3,205711,205711,205714,0,3,2
58694,2,3,205713,205714,205717,1,4,0
58695,2,2,205715,205717,205719,2,4,0
58696,2,3,205717,205719,205722,2,5,0
58697,2,2,205719,205722,205724,3,5,0
58698,5,2,205724,205724,205726,0,2,0
58699,1,2,205725,205726,205728,1,3,0
58700,1,3,205726,205728,205731,2,5,0
58701,1,1,205727,205731,205732,4,5,0
58702,1,1,205728,205732,205733,4,5,0
58703,5,2,205733,205733,205735,0,2,0
58704,3,1,205736,205736,205737,0,1,1
58705,3,3,205739,205739,205742,0,3,2
58706,4,3,205743,205743,205746,0,3,1
58707,5,2,205748,205748,205750,0,2,2
58708,1,1,205749,205750,205751,1,2,0
58709,1,1,205750,205751,205752,1,2,0
58710,6,3,205756,205756,205759,0,3,4
58711,1,1,205757,205759,205760,2,3,0
58712,3,2,205760,205760,205762,0,2,0
58713,3,3,205763,205763,205766,0,3,1
58714,3,1,205766,205766,205767,0,1,0
58715,1,3,205767,205767,205770,0,3,0
58716,5,3,205772,205772,205775,0,3,2
58717,6,3,205778,205778,205781,0,3,3
58718,3,3,205781,205781,205784,0,3,0
58719,3,1,205784,205784,205785,0,1,0
58720,6,3,205790,205790,205793,0,3,5
58721,6,3,205796,205796,205799,0,3,3
58722,1,3,205797,205799,205802,2,5,0
58723,6,2,205803,205803,205805,0,2,1
58724,5,3,205808,205808,205811,0,3,3
58725,3,1,205811,205811,205812,0,1,0
58726,3,3,205814,205814,205817,0,3,2
58727,6,1,205820,205820,205821,0,1,3
58728,6,3,205826,205826,205829,0,3,5
58729,2,1,205828,205829,205830,1,2,0
58730,5,1,205833,205833,205834,0,1,3
58731,1,3,205834,205834,205837,0,3,0
58732,1,1,205835,205837,205838,2,3,0
58733,2,3,205837,205838,205841,1,4,0
58734,4,2,205841,205841,205843,0,2,0
58735,2,2,205843,205843,205845,0,2,0
58736,5,3,205848,205848,205851,0,3,3
58737,5,2,205853,205853,205855,0,2,2
58738,2,1,205855,205855,205856,0,1,0
58739,4,1,205859,205859,205860,0,1,3
58740,4,3,205863,205863,205866,0,3,3
58741,3,1,205866,205866,205867,0,1,0
58742,1,1,205867,205867,205868,0,1,0
58743,4,2,205871,205871,205873,0,2,3
58744,2,2,205873,205873,205875,0,2,0
58745,4,3,205877,205877,205880,0,3,2
58746,2,3,205879,205880,205883,1,4,0
58747,2,2,205881,205883,205885,2,4,0
58748,6,1,205887,205887,205888,0,1,2
58749,3,1,205890,205890,205891,0,1,2
58750,1,3,205891,205891,205894,0,3,0
58751,4,2,205895,205895,205897,0,2,1
58752,1,2,205896,205897,205899,1,3,0
58753,3,1,205899,205899,205900,0,1,0
58754,5,2,205904,205904,205906,0,2,4
58755,1,2,205905,205906,205908,1,3,0
58756,3,1,205908,205908,205909,0,1,0
58757,4,2,205912,205912,205914,0,2,3
58758,4,1,205916,205916,205917,0,1,2
58759,5,3,205921,205921,205924,0,3,4
58760,4,2,205925,205925,205927,0,2,1
58761,1,3,205926,205927,205930,1,4,0
58762,4,3,205930,205930,205933,0,3,0
58763,4,2,205934,205934,205936,0,2,1
58764,1,1,205935,205936,205937,1,2,0
58765,3,3,205938,205938,205941,0,3,1
58766,5,2,205943,205943,205945,0,2,2
58767,3,1,205946,205946,205947,0,1,1
58768,5,2,205951,205951,205953,0,2,4
58769,6,2,205957,205957,205959,0,2,4
58770,2,3,205959,205959,205962,0,3,0
58771,3,2,205962,205962,205964,0,2,0
58772,3,1,205965,205965,205966,0,1,1
58773,1,1,205966,205966,205967,0,1,0
58774,6,1,205972,205972,205973,0,1,5
58775,5,1,205977,205977,205978,0,1,4
58776,6,2,205983,205983,205985,0,2,5
58777,5,2,205988,205988,205990,0,2,3
58778,4,1,205992,205992,205993,0,1,2
58779,4,2,205996,205996,205998,0,2,3
58780,3,2,205999,205999,206001,0,2,1
58781,2,1,206001,206001,206002,0,1,0
58782,6,2,206007,206007,206009,0,2,5
58783,3,1,206010,206010,206011,0,1,1
58784,3,1,206013,206013,206014,0,1,2
58785,5,1,206018,206018,206019,0,1,4
58786,1,2,206019,206019,206021,0,2,0
58787,5,1,206024,206024,206025,0,1,3
58788,5,3,206029,206029,206032,0,3,4
58789,4,1,206033,206033,206034,0,1,1
58790,3,1,206036,206036,206037,0,1,2
58791,4,3,206040,206040,206043,0,3,3
58792,4,3,206044,206044,206047,0,3,1
58793,2,2,206046,206047,206049,1,3,0
58794,3,1,206049,206049,206050,0,1,0
58795,6,2,206055,206055,206057,0,2,5
58796,6,2,206061,206061,206063,0,2,4
58797,2,1,206063,206063,206064,0,1,0
58798,1,3,206064,206064,206067,0,3,0
58799,5,3,206069,206069,206072,0,3,2
58800,5,3,206074,206074,206077,0,3,2
58801,3,1,206077,206077,206078,0,1,0
58802,6,2,206083,206083,206085,0,2,5
58803,4,3,206087,206087,206090,0,3,2
58804,4,3,206091,206091,206094,0,3,1
58805,4,1,206095,206095,206096,0,1,1
58806,6,3,206101,206101,206104,0,3,5
58807,5,2,206106,206106,206108,0,2,2
58808,6,1,206112,206112,206113,0,1,4
58809,5,3,206117,206117,206120,0,3,4
58810,1,2,206118,206120,206122,2,4,0
58811,6,2,206124,206124,206126,0,2,2
58812,1,1,206125,206126,206127,1,2,0
58813,2,2,206127,206127,206129,0,2,0
58814,2,2,206129,206129,206131,0,2,0
58815,3,3,206132,206132,206135,0,3,1
58816,4,2,206136,206136,206138,0,2,1
58817,5,2,206141,206141,206143,0,2,3
58818,1,3,206142,206143,206146,1,4,0
58819,2,1,206144,206146,206147,2,3,0
58820,4,3,206148,206148,206151,0,3,1
58821,3,3,206151,206151,206154,0,3,0
58822,4,1,206155,206155,206156,0,1,1
58823,2,3,206157,206157,206160,0,3,1
58824,6,3,206163,206163,206166,0,3,3
58825,4,3,206167,206167,206170,0,3,1
58826,2,2,206169,206170,206172,1,3,0
58827,5,2,206174,206174,206176,0,2,2
58828,5,1,206179,206179,206180,0,1,3
58829,4,3,206183,206183,206186,0,3,3
58830,4,2,206187,206187,206189,0,2,1
58831,6,2,206193,206193,206195,0,2,4
58832,1,2,206194,206195,206197,1,3,0
58833,5,2,206199,206199,206201,0,2,2
58834,3,3,206202,206202,206205,0,3,1
58835,2,2,206204,206205,206207,1,3,0
58836,2,3,206206,206207,206210,1,4,0
58837,4,3,206210,206210,206213,0,3,0
58838,2,2,206212,206213,206215,1,3,0
58839,1,3,206213,206215,206218,2,5,0
58840,5,3,206218,206218,206221,0,3,0
58841,3,3,206221,206221,206224,0,3,0
58842,1,2,206222,206224,206226,2,4,0
58843,3,3,206225,206226,206229,1,4,0
58844,6,2,206231,206231,206233,0,2,2
58845,3,1,206234,206234,206235,0,1,1
58846,3,2,206237,206237,206239,0,2,2
58847,4,2,206241,206241,206243,0,2,2
58848,5,3,206246,206246,206249,0,3,3
58849,3,2,206249,206249,206251,0,2,0
58850,2,3,206251,206251,206254,0,3,0
58851,3,3,206254,206254,206257,0,3,0
58852,4,1,206258,206258,206259,0,1,1
58853,1,2,206259,206259,206261,0,2,0
58854,4,2,206263,206263,206265,0,2,2
58855,2,3,206265,206265,206268,0,3,0
58856,6,2,206271,206271,206273,0,2,3
58857,2,3,206273,206273,206276,0,3,0
58858,1,2,206274,206276,206278,2,4,0
58859,6,2,206280,206280,206282,0,2,2
58860,5,2,206285,206285,206287,0,2,3
58861,6,1,206291,206291,206292,0,1,4
58862,2,2,206293,206293,206295,0,2,1
58863,1,1,206294,206295,206296,1,2,0
58864,6,3,206300,206300,206303,0,3,4
58865,4,3,206304,206304,206307,0,3,1
58866,5,3,206309,206309,206312,0,3,2
58867,4,1,206313,206313,206314,0,1,1
58868,4,1,206317,206317,206318,0,1,3
58869,2,3,206319,206319,206322,0,3,1
58870,1,1,206320,206322,206323,2,3,0
58871,3,3,206323,206323,206326,0,3,0
58872,1,3,206324,206326,206329,2,5,0
58873,4,2,206328,206329,206331,1,3,0
58874,4,1,206332,206332,206333,0,1,1
58875,4,2,206336,206336,206338,0,2,3
58876,3,3,206339,206339,206342,0,3,1
58877,6,1,206345,206345,206346,0,1,3
58878,5,2,206350,206350,206352,0,2,4
58879,1,3,206351,206352,206355,1,4,0
58880,1,1,206352,206355,206356,3,4,0
58881,5,3,206357,206357,206360,0,3,1
58882,2,1,206359,206360,206361,1,2,0
58883,3,1,206362,206362,206363,0,1,1
58884,4,3,206366,206366,206369,0,3,3
58885,5,3,206371,206371,206374,0,3,2
58886,1,2,206372,206374,206376,2,4,0
58887,2,1,206374,206376,206377,2,3,0
58888,3,2,206377,206377,206379,0,2,0
58889,2,3,206379,206379,206382,0,3,0
58890,2,2,206381,206382,206384,1,3,0
58891,2,1,206383,206384,206385,1,2,0
58892,3,3,206386,206386,206389,0,3,1
58893,3,2,206389,206389,206391,0,2,0
58894,3,3,206392,206392,206395,0,3,1
58895,6,1,206398,206398,206399,0,1,3
58896,6,3,206404,206404,206407,0,3,5
58897,3,1,206407,206407,206408,0,1,0
58898,6,1,206413,206413,206414,0,1,5
58899,5,1,206418,206418,206419,0,1,4
58900,3,1,206421,206421,206422,0,1,2
58901,4,3,206425,206425,206428,0,3,3
58902,5,2,206430,206430,206432,0,2,2
58903,2,2,206432,206432,206434,0,2,0
58904,6,2,206438,206438,206440,0,2,4
58905,3,3,206441,206441,206444,0,3,1
58906,4,1,206445,206445,206446,0,1,1
58907,2,3,206447,206447,206450,0,3,1
58908,1,2,206448,206450,206452,2,4,0
58909,3,3,206451,206452,206455,1,4,0
58910,6,3,206457,206457,206460,0,3,2
58911,1,3,206458,206460,206463,2,5,0
58912,6,3,206464,206464,206467,0,3,1
58913,6,2,206470,206470,206472,0,2,3
58914,2,2,206472,206472,206474,0,2,0
58915,4,2,206476,206476,206478,0,2,2
58916,1,3,206477,206478,206481,1,4,0
58917,1,2,206478,206481,206483,3,5,0
58918,5,2,206483,206483,206485,0,2,0
58919,2,3,206485,206485,206488,0,3,0
58920,1,3,206486,206488,206491,2,5,0
58921,4,3,206490,206491,206494,1,4,0
58922,6,2,206496,206496,206498,0,2,2
58923,2,3,206498,206498,206501,0,3,0
58924,2,1,206500,206501,206502,1,2,0
58925,2,1,206502,206502,206503,0,1,0
58926,4,1,206506,206506,206507,0,1,3
58927,4,3,206510,206510,206513,0,3,3
58928,6,3,206516,206516,206519,0,3,3
58929,6,1,206522,206522,206523,0,1,3
58930,2,1,206524,206524,206525,0,1,1
58931,1,1,206525,206525,206526,0,1,0
58932,4,3,206529,206529,206532,0,3,3
58933,3,3,206532,206532,206535,0,3,0
58934,1,2,206533,206535,206537,2,4,0
58935,3,1,206536,206537,206538,1,2,0
58936,4,2,206540,206540,206542,0,2,2
58937,6,2,206546,206546,206548,0,2,4
58938,1,1,206547,206548,206549,1,2,0
58939,5,1,206552,206552,206553,0,1,3
58940,3,3,206555,206555,206558,0,3,2
58941,2,3,206557,206558,206561,1,4,0
58942,2,1,206559,206561,206562,2,3,0
58943,5,1,206564,206564,206565,0,1,2
58944,2,1,206566,206566,206567,0,1,1
58945,1,1,206567,206567,206568,0,1,0
58946,2,3,206569,206569,206572,0,3,1
58947,4,1,206573,206573,206574,0,1,1
58948,2,1,206575,206575,206576,0,1,1
58949,5,1,206580,206580,206581,0,1,4
58950,4,2,206584,206584,206586,0,2,3
58951,4,2,206588,206588,206590,0,2,2
58952,5,1,206593,206593,206594,0,1,3
58953,6,3,206599,206599,206602,0,3,5
58954,4,3,206603,206603,206606,0,3,1
58955,1,3,206604,206606,206609,2,5,0
58956,1,2,206605,206609,206611,4,6,0
58957,2,2,206607,206611,206613,4,6,0
58958,3,3,206610,206613,206616,3,6,0
58959,6,3,206616,206616,206619,0,3,0
58960,2,3,206618,206619,206622,1,4,0
58961,4,1,206622,206622,206623,0,1,0
58962,1,2,206623,206623,206625,0,2,0
58963,5,1,206628,206628,206629,0,1,3
58964,2,3,206630,206630,206633,0,3,1
58965,5,3,206635,206635,206638,0,3,2
58966,1,3,206636,206638,206641,2,5,0
58967,5,2,206641,206641,206643,0,2,0
58968,6,1,206647,206647,206648,0,1,4
58969,4,3,206651,206651,206654,0,3,3
58970,6,1,206657,206657,206658,0,1,3
58971,1,2,206658,206658,206660,0,2,0
58972,3,2,206661,206661,206663,0,2,1
58973,5,1,206666,206666,206667,0,1,3
58974,3,1,206669,206669,206670,0,1,2
58975,3,3,206672,206672,206675,0,3,2
58976,4,3,206676,206676,206679,0,3,1
58977,3,3,206679,206679,206682,0,3,0
58978,6,2,206685,206685,206687,0,2,3
58979,6,3,206691,206691,206694,0,3,4
58980,1,1,206692,206694,206695,2,3,0
58981,2,1,206694,206695,206696,1,2,0
58982,6,3,206700,206700,206703,0,3,4
58983,1,1,206701,206703,206704,2,3,0
58984,2,2,206703,206704,206706,1,3,0
58985,3,2,206706,206706,206708,0,2,0
58986,3,1,206709,206709,206710,0,1,1
58987,4,2,206713,206713,206715,0,2,3
58988,5,2,206718,206718,206720,0,2,3
58989,3,2,206721,206721,206723,0,2,1
58990,4,2,206725,206725,206727,0,2,2
58991,2,2,206727,206727,206729,0,2,0
58992,2,2,206729,206729,206731,0,2,0
58993,2,2,206731,206731,206733,0,2,0
58994,5,1,206736,206736,206737,0,1,3
58995,4,1,206740,206740,206741,0,1,3
58996,3,3,206743,206743,206746,0,3,2
58997,2,3,206745,206746,206749,1,4,0
58998,1,3,206746,206749,206752,3,6,0
58999,4,2,206750,206752,206754,2,4,0
59000,6,2,206756,206756,206758,0,2,2
59001,1,3,206757,206758,206761,1,4,0
59002,2,2,206759,206761,206763,2,4,0
59003,6,2,206765,206765,206767,0,2,2
59004,4,3,206769,206769,206772,0,3,2
59005,6,3,206775,206775,206778,0,3,3
59006,2,1,206777,206778,206779,1,2,0
59007,3,3,206780,206780,206783,0,3,1
59008,4,1,206784,206784,206785,0,1,1
59009,4,1,206788,206788,206789,0,1,3
59010,6,1,206794,206794,206795,0,1,5
59011,4,3,206798,206798,206801,0,3,3
59012,5,3,206803,206803,206806,0,3,2
59013,3,3,206806,206806,206809,0,3,0
59014,3,2,206809,206809,206811,0,2,0
59015,2,3,206811,206811,206814,0,3,0
59016,4,1,206815,206815,206816,0,1,1
59017,5,1,206820,206820,206821,0,1,4
59018,2,3,206822,206822,206825,0,3,1
59019,1,1,206823,206825,206826,2,3,0
59020,2,3,206825,206826,206829,1,4,0
59021,3,2,206828,206829,206831,1,3,0
59022,4,3,206832,206832,206835,0,3,1
59023,5,2,206837,206837,206839,0,2,2
59024,3,3,206840,206840,206843,0,3,1
59025,1,3,206841,206843,206846,2,5,0
59026,3,2,206844,206846,206848,2,4,0
59027,2,2,206846,206848,206850,2,4,0
59028,1,2,206847,206850,206852,3,5,0
59029,6,1,206853,206853,206854,0,1,1
59030,2,1,206855,206855,206856,0,1,1
59031,6,3,206861,206861,206864,0,3,5
59032,4,3,206865,206865,206868,0,3,1
59033,1,3,206866,206868,206871,2,5,0
59034,6,1,206872,206872,206873,0,1,1
59035,2,3,206874,206874,206877,0,3,1
59036,3,1,206877,206877,206878,0,1,0
59037,6,3,206883,206883,206886,0,3,5
59038,5,3,206888,206888,206891,0,3,2
59039,3,2,206891,206891,206893,0,2,0
59040,1,3,206892,206893,206896,1,4,0
59041,6,2,206898,206898,206900,0,2,2
59042,1,1,206899,206900,206901,1,2,0
59043,6,1,206905,206905,206906,0,1,4
59044,6,3,206911,206911,206914,0,3,5
59045,2,3,206913,206914,206917,1,4,0
59046,6,3,206919,206919,206922,0,3,2
59047,1,3,206920,206922,206925,2,5,0
59048,1,3,206921,206925,206928,4,7,0
59049,6,3,206927,206928,206931,1,4,0
59050,1,2,206928,206931,206933,3,5,0
59051,3,3,206931,206933,206936,2,5,0
59052,2,3,206933,206936,206939,3,6,0
59053,3,2,206936,206939,206941,3,5,0
59054,4,2,206940,206941,206943,1,3,0
59055,1,1,206941,206943,206944,2,3,0
59056,5,3,206946,206946,206949,0,3,2
59057,2,1,206948,206949,206950,1,2,0
59058,1,2,206949,206950,206952,1,3,0
59059,1,1,206950,206952,206953,2,3,0
59060,6,3,206956,206956,206959,0,3,3
59061,2,1,206958,206959,206960,1,2,0
59062,2,2,206960,206960,206962,0,2,0
59063,6,2,206966,206966,206968,0,2,4
59064,6,3,206972,206972,206975,0,3,4
59065,2,1,206974,206975,206976,1,2,0
59066,2,3,206976,206976,206979,0,3,0
59067,1,3,206977,206979,206982,2,5,0
59068,5,1,206982,206982,206983,0,1,0
59069,2,1,206984,206984,206985,0,1,1
59070,2,3,206986,206986,206989,0,3,1
59071,4,1,206990,206990,206991,0,1,1
59072,4,1,206994,206994,206995,0,1,3
59073,2,2,206996,206996,206998,0,2,1
59074,5,1,207001,207001,207002,0,1,3
59075,2,1,207003,207003,207004,0,1,1
59076,2,2,207005,207005,207007,0,2,1
59077,5,3,207010,207010,207013,0,3,3
59078,5,1,207015,207015,207016,0,1,2
59079,2,3,207017,207017,207020,0,3,1
59080,4,3,207021,207021,207024,0,3,1
59081,6,2,207027,207027,207029,0,2,3
59082,5,2,207032,207032,207034,0,2,3
59083,2,1,207034,207034,207035,0,1,0
59084,2,3,207036,207036,207039,0,3,1
59085,4,2,207040,207040,207042,0,2,1
59086,1,3,207041,207042,207045,1,4,0
59087,3,3,207044,207045,207048,1,4,0
59088,6,1,207050,207050,207051,0,1,2
59089,1,2,207051,207051,207053,0,2,0
59090,2,2,207053,207053,207055,0,2,0
59091,2,3,207055,207055,207058,0,3,0
59092,1,2,207056,207058,207060,2,4,0
59093,4,1,207060,207060,207061,0,1,0
59094,2,2,207062,207062,207064,0,2,1
59095,1,2,207063,207064,207066,1,3,0
59096,2,3,207065,207066,207069,1,4,0
59097,4,2,207069,207069,207071,0,2,0
59098,4,1,207073,207073,207074,0,1,2
59099,6,1,207079,207079,207080,0,1,5
59100,2,3,207081,207081,207084,0,3,1
59101,3,2,207084,207084,207086,0,2,0
59102,5,3,207089,207089,207092,0,3,3
59103,5,2,207094,207094,207096,0,2,2
59104,2,3,207096,207096,207099,0,3,0
59105,2,1,207098,207099,207100,1,2,0
59106,1,1,207099,207100,207101,1,2,0
59107,6,2,207105,207105,207107,0,2,4
59108,1,2,207106,207107,207109,1,3,0
59109,1,1,207107,207109,207110,2,3,0
59110,1,3,207108,207110,207113,2,5,0
59111,6,3,207114,207114,207117,0,3,1
59112,6,2,207120,207120,207122,0,2,3
59113,6,2,207126,207126,207128,0,2,4
59114,6,2,207132,207132,207134,0,2,4
59115,5,2,207137,207137,207139,0,2,3
59116,5,1,207142,207142,207143,0,1,3
59117,5,3,207147,207147,207150,0,3,4
59118,2,3,207149,207150,207153,1,4,0
59119,4,2,207153,207153,207155,0,2,0
59120,1,2,207154,207155,207157,1,3,0
59121,3,3,207157,207157,207160,0,3,0
59122,4,1,207161,207161,207162,0,1,1
59123,3,3,207164,207164,207167,0,3,2
59124,5,3,207169,207169,207172,0,3,2
59125,3,3,207172,207172,207175,0,3,0
59126,4,2,207176,207176,207178,0,2,1
59127,2,1,207178,207178,207179,0,1,0
59128,2,2,207180,207180,207182,0,2,1
59129,1,2,207181,207182,207184,1,3,0
59130,4,2,207185,207185,207187,0,2,1
59131,1,2,207186,207187,207189,1,3,0
59132,1,2,207187,207189,207191,2,4,0
59133,2,1,207189,207191,207192,2,3,0
59134,2,2,207191,207192,207194,1,3,0
59135,2,3,207193,207194,207197,1,4,0
59136,2,3,207195,207197,207200,2,5,0
59137,1,3,207196,207200,207203,4,7,0
59138,1,3,207197,207203,207206,6,9,0
59139,5,1,207202,207206,207207,4,5,0
59140,1,2,207203,207207,207209,4,6,0
59141,5,3,207208,207209,207212,1,4,0
59142,6,2,207214,207214,207216,0,2,2
59143,5,3,207219,207219,207222,0,3,3
59144,6,3,207225,207225,207228,0,3,3
59145,1,1,207226,207228,207229,2,3,0
59146,2,3,207228,207229,207232,1,4,0
59147,6,3,207234,207234,207237,0,3,2
59148,4,1,207238,207238,207239,0,1,1
59149,2,1,207240,207240,207241,0,1,1
59150,2,2,207242,207242,207244,0,2,1
59151,5,1,207247,207247,207248,0,1,3
59152,3,2,207250,207250,207252,0,2,2
59153,5,1,207255,207255,207256,0,1,3
59154,4,3,207259,207259,207262,0,3,3
59155,3,3,207262,207262,207265,0,3,0
59156,4,1,207266,207266,207267,0,1,1
59157,6,3,207272,207272,207275,0,3,5
59158,4,3,207276,207276,207279,0,3,1
59159,6,3,207282,207282,207285,0,3,3
59160,4,2,207286,207286,207288,0,2,1
59161,2,3,207288,207288,207291,0,3,0
59162,1,2,207289,207291,207293,2,4,0
59163,2,3,207291,207293,207296,2,5,0
59164,4,3,207295,207296,207299,1,4,0
59165,6,2,207301,207301,207303,0,2,2
59166,6,2,207307,207307,207309,0,2,4
59167,5,1,207312,207312,207313,0,1,3
59168,3,2,207315,207315,207317,0,2,2
59169,1,1,207316,207317,207318,1,2,0
59170,2,2,207318,207318,207320,0,2,0
59171,6,2,207324,207324,207326,0,2,4
59172,6,1,207330,207330,207331,0,1,4
59173,2,1,207332,207332,207333,0,1,1
59174,1,1,207333,207333,207334,0,1,0
59175,3,3,207336,207336,207339,0,3,2
59176,6,3,207342,207342,207345,0,3,3
59177,5,1,207347,207347,207348,0,1,2
59178,3,3,207350,207350,207353,0,3,2
59179,1,1,207351,207353,207354,2,3,0
59180,2,3,207353,207354,207357,1,4,0
59181,3,3,207356,207357,207360,1,4,0
59182,3,1,207359,207360,207361,1,2,0
59183,4,3,207363,207363,207366,0,3,2
59184,6,1,207369,207369,207370,0,1,3
59185,1,1,207370,207370,207371,0,1,0
59186,6,1,207376,207376,207377,0,1,5
59187,4,3,207380,207380,207383,0,3,3
59188,2,2,207382,207383,207385,1,3,0
59189,2,2,207384,207385,207387,1,3,0
59190,3,3,207387,207387,207390,0,3,0
59191,3,2,207390,207390,207392,0,2,0
59192,6,2,207396,207396,207398,0,2,4
59193,4,1,207400,207400,207401,0,1,2
59194,6,1,207406,207406,207407,0,1,5
59195,5,3,207411,207411,207414,0,3,4
59196,2,3,207413,207414,207417,1,4,0
59197,6,2,207419,207419,207421,0,2,2
59198,4,3,207423,207423,207426,0,3,2
59199,3,1,207426,207426,207427,0,1,0
59200,5,3,207431,207431,207434,0,3,4
59201,4,1,207435,207435,207436,0,1,1
59202,4,1,207439,207439,207440,0,1,3
59203,6,3,207445,207445,207448,0,3,5
59204,6,1,207451,207451,207452,0,1,3
59205,4,1,207455,207455,207456,0,1,3
59206,6,1,207461,207461,207462,0,1,5
59207,2,3,207463,207463,207466,0,3,1
59208,2,1,207465,207466,207467,1,2,0
59209,3,3,207468,207468,207471,0,3,1
59210,3,1,207471,207471,207472,0,1,0
59211,2,3,207473,207473,207476,0,3,1
59212,4,1,207477,207477,207478,0,1,1
59213,2,2,207479,207479,207481,0,2,1
59214,1,2,207480,207481,207483,1,3,0
59215,5,1,207485,207485,207486,0,1,2
59216,2,3,207487,207487,207490,0,3,1
59217,4,2,207491,207491,207493,0,2,1
59218,3,3,207494,207494,207497,0,3,1
59219,2,3,207496,207497,207500,1,4,0
59220,1,1,207497,207500,207501,3,4,0
59221,2,1,207499,207501,207502,2,3,0
59222,6,3,207505,207505,207508,0,3,3
59223,2,3,207507,207508,207511,1,4,0
59224,4,3,207511,207511,207514,0,3,0
59225,5,2,207516,207516,207518,0,2,2
59226,5,1,207521,207521,207522,0,1,3
59227,5,2,207526,207526,207528,0,2,4
59228,1,1,207527,207528,207529,1,2,0
59229,5,1,207532,207532,207533,0,1,3
59230,6,1,207538,207538,207539,0,1,5
59231,3,1,207541,207541,207542,0,1,2
59232,2,1,207543,207543,207544,0,1,1
59233,5,3,207548,207548,207551,0,3,4
59234,1,2,207549,207551,207553,2,4,0
59235,4,3,207553,207553,207556,0,3,0
59236,3,2,207556,207556,207558,0,2,0
59237,4,3,207560,207560,207563,0,3,2
59238,5,3,207565,207565,207568,0,3,2
59239,3,2,207568,207568,207570,0,2,0
59240,2,3,207570,207570,207573,0,3,0
59241,2,3,207572,207573,207576,1,4,0
59242,4,1,207576,207576,207577,0,1,0
59243,5,2,207581,207581,207583,0,2,4
59244,1,1,207582,207583,207584,1,2,0
59245,4,2,207586,207586,207588,0,2,2
59246,3,1,207589,207589,207590,0,1,1
59247,2,1,207591,207591,207592,0,1,1
59248,1,3,207592,207592,207595,0,3,0
59249,6,2,207598,207598,207600,0,2,3
59250,3,3,207601,207601,207604,0,3,1
59251,5,3,207606,207606,207609,0,3,2
59252,4,2,207610,207610,207612,0,2,1
59253,6,3,207616,207616,207619,0,3,4
59254,4,3,207620,207620,207623,0,3,1
59255,3,1,207623,207623,207624,0,1,0
59256,4,2,207627,207627,207629,0,2,3
59257,2,1,207629,207629,207630,0,1,0
59258,5,2,207634,207634,207636,0,2,4
59259,2,1,207636,207636,207637,0,1,0
59260,4,3,207640,207640,207643,0,3,3
59261,1,2,207641,207643,207645,2,4,0
59262,3,2,207644,207645,207647,1,3,0
59263,3,1,207647,207647,207648,0,1,0
59264,1,2,207648,207648,207650,0,2,0
59265,4,2,207652,207652,207654,0,2,2
59266,1,3,207653,207654,207657,1,4,0
59267,2,3,207655,207657,207660,2,5,0
59268,3,2,207658,207660,207662,2,4,0
59269,2,2,207660,207662,207664,2,4,0
59270,4,3,207664,207664,207667,0,3,0
59271,6,3,207670,207670,207673,0,3,3
59272,6,1,207676,207676,207677,0,1,3
59273,3,2,207679,207679,207681,0,2,2
59274,6,3,207685,207685,207688,0,3,4
59275,3,3,207688,207688,207691,0,3,0
59276,4,1,207692,207692,207693,0,1,1
59277,1,1,207693,207693,207694,0,1,0
59278,1,3,207694,207694,207697,0,3,0
59279,5,2,207699,207699,207701,0,2,2
59280,5,1,207704,207704,207705,0,1,3
59281,2,1,207706,207706,207707,0,1,1
59282,4,1,207710,207710,207711,0,1,3
59283,2,2,207712,207712,207714,0,2,1
59284,4,3,207716,207716,207719,0,3,2
59285,2,2,207718,207719,207721,1,3,0
59286,4,1,207722,207722,207723,0,1,1
59287,4,2,207726,207726,207728,0,2,3
59288,2,3,207728,207728,207731,0,3,0
59289,5,3,207733,207733,207736,0,3,2
59290,1,3,207734,207736,207739,2,5,0
59291,3,1,207737,207739,207740,2,3,0
59292,3,2,207740,207740,207742,0,2,0
59293,1,3,207741,207742,207745,1,4,0
59294,6,2,207747,207747,207749,0,2,2
59295,3,3,207750,207750,207753,0,3,1
59296,3,2,207753,207753,207755,0,2,0
59297,1,3,207754,207755,207758,1,4,0
59298,5,2,207759,207759,207761,0,2,1
59299,3,3,207762,207762,207765,0,3,1
59300,1,2,207763,207765,207767,2,4,0
59301,2,1,207765,207767,207768,2,3,0
59302,4,2,207769,207769,207771,0,2,1
59303,3,1,207772,207772,207773,0,1,1
59304,2,2,207774,207774,207776,0,2,1
59305,2,2,207776,207776,207778,0,2,0
59306,2,2,207778,207778,207780,0,2,0
59307,3,1,207781,207781,207782,0,1,1
59308,5,3,207786,207786,207789,0,3,4
59309,6,2,207792,207792,207794,0,2,3
59310,2,1,207794,207794,207795,0,1,0
59311,5,1,207799,207799,207800,0,1,4
59312,3,2,207802,207802,207804,0,2,2
59313,6,2,207808,207808,207810,0,2,4
59314,5,3,207813,207813,207816,0,3,3
59315,2,3,207815,207816,207819,1,4,0
59316,5,2,207820,207820,207822,0,2,1
59317,2,3,207822,207822,207825,0,3,0
59318,6,1,207828,207828,207829,0,1,3
59319,2,1,207830,207830,207831,0,1,1
59320,1,1,207831,207831,207832,0,1,0
59321,1,1,207832,207832,207833,0,1,0
59322,2,1,207834,207834,207835,0,1,1
59323,4,1,207838,207838,207839,0,1,3
59324,3,3,207841,207841,207844,0,3,2
59325,6,3,207847,207847,207850,0,3,3
59326,1,3,207848,207850,207853,2,5,0
59327,6,2,207854,207854,207856,0,2,1
59328,3,3,207857,207857,207860,0,3,1
59329,4,1,207861,207861,207862,0,1,1
59330,2,3,207863,207863,207866,0,3,1
59331,6,3,207869,207869,207872,0,3,3
59332,3,1,207872,207872,207873,0,1,0
59333,5,2,207877,207877,207879,0,2,4
59334,1,2,207878,207879,207881,1,3,0
59335,1,3,207879,207881,207884,2,5,0
59336,3,2,207882,207884,207886,2,4,0
59337,4,1,207886,207886,207887,0,1,0
59338,2,2,207888,207888,207890,0,2,1
59339,3,2,207891,207891,207893,0,2,1
59340,6,2,207897,207897,207899,0,2,4
59341,1,2,207898,207899,207901,1,3,0
59342,3,3,207901,207901,207904,0,3,0
59343,1,1,207902,207904,207905,2,3,0
59344,6,2,207908,207908,207910,0,2,3
59345,6,2,207914,207914,207916,0,2,4
59346,2,1,207916,207916,207917,0,1,0
59347,3,2,207919,207919,207921,0,2,2
59348,2,2,207921,207921,207923,0,2,0
59349,4,2,207925,207925,207927,0,2,2
59350,5,2,207930,207930,207932,0,2,3
59351,1,1,207931,207932,207933,1,2,0
59352,4,3,207935,207935,207938,0,3,2
59353,4,1,207939,207939,207940,0,1,1
59354,6,1,207945,207945,207946,0,1,5
59355,6,2,207951,207951,207953,0,2,5
59356,4,2,207955,207955,207957,0,2,2
59357,2,2,207957,207957,207959,0,2,0
59358,2,1,207959,207959,207960,0,1,0
59359,3,1,207962,207962,207963,0,1,2
59360,1,1,207963,207963,207964,0,1,0
59361,4,1,207967,207967,207968,0,1,3
59362,1,1,207968,207968,207969,0,1,0
59363,5,2,207973,207973,207975,0,2,4
59364,3,2,207976,207976,207978,0,2,1
59365,6,2,207982,207982,207984,0,2,4
59366,5,1,207987,207987,207988,0,1,3
59367,1,2,207988,207988,207990,0,2,0
59368,3,3,207991,207991,207994,0,3,1
59369,1,2,207992,207994,207996,2,4,0
59370,6,2,207998,207998,208000,0,2,2
59371,6,3,208004,208004,208007,0,3,4
59372,4,1,208008,208008,208009,0,1,1
59373,5,2,208013,208013,208015,0,2,4
59374,1,2,208014,208015,208017,1,3,0
59375,5,1,208019,208019,208020,0,1,2
59376,4,2,208023,208023,208025,0,2,3
59377,6,3,208029,208029,208032,0,3,4
59378,5,2,208034,208034,208036,0,2,2
59379,6,1,208040,208040,208041,0,1,4
59380,3,3,208043,208043,208046,0,3,2
59381,3,1,208046,208046,208047,0,1,0
59382,3,2,208049,208049,208051,0,2,2
59383,1,3,208050,208051,208054,1,4,0
59384,6,2,208056,208056,208058,0,2,2
59385,1,3,208057,208058,208061,1,4,0
59386,4,1,208061,208061,208062,0,1,0
59387,1,1,208062,208062,208063,0,1,0
59388,2,3,208064,208064,208067,0,3,1
59389,2,3,208066,208067,208070,1,4,0
59390,1,2,208067,208070,208072,3,5,0
59391,4,1,208071,208072,208073,1,2,0
59392,1,1,208072,208073,208074,1,2,0
59393,4,1,208076,208076,208077,0,1,2
59394,3,1,208079,208079,208080,0,1,2
59395,3,2,208082,208082,208084,0,2,2
59396,3,2,208085,208085,208087,0,2,1
59397,1,3,208086,208087,208090,1,4,0
59398,5,1,208091,208091,208092,0,1,1
59399,1,3,208092,208092,208095,0,3,0
59400,1,3,208093,208095,208098,2,5,0
59401,5,3,208098,208098,208101,0,3,0
59402,5,1,208103,208103,208104,0,1,2
59403,3,2,208106,208106,208108,0,2,2
59404,4,2,208110,208110,208112,0,2,2
59405,4,3,208114,208114,208117,0,3,2
59406,5,1,208119,208119,208120,0,1,2
59407,2,3,208121,208121,208124,0,3,1
59408,2,1,208123,208124,208125,1,2,0
59409,4,2,208127,208127,208129,0,2,2
59410,5,2,208132,208132,208134,0,2,3
59411,2,2,208134,208134,208136,0,2,0
59412,2,2,208136,208136,208138,0,2,0
59413,5,1,208141,208141,208142,0,1,3
59414,6,3,208147,208147,208150,0,3,5
59415,2,1,208149,208150,208151,1,2,0
59416,1,2,208150,208151,208153,1,3,0
59417,6,1,208156,208156,208157,0,1,3
59418,2,2,208158,208158,208160,0,2,1
59419,6,2,208164,208164,208166,0,2,4
59420,4,1,208168,208168,208169,0,1,2
59421,5,3,208173,208173,208176,0,3,4
59422,6,2,208179,208179,208181,0,2,3
59423,3,3,208182,208182,208185,0,3,1
59424,4,2,208186,208186,208188,0,2,1
59425,5,1,208191,208191,208192,0,1,3
59426,5,2,208196,208196,208198,0,2,4
59427,5,2,208201,208201,208203,0,2,3
59428,4,2,208205,208205,208207,0,2,2
59429,1,3,208206,208207,208210,1,4,0
59430,3,3,208209,208210,208213,1,4,0
59431,1,1,208210,208213,208214,3,4,0
59432,3,3,208213,208214,208217,1,4,0
59433,6,1,208219,208219,208220,0,1,2
59434,3,3,208222,208222,208225,0,3,2
59435,2,3,208224,208225,208228,1,4,0
59436,6,1,208230,208230,208231,0,1,2
59437,3,3,208233,208233,208236,0,3,2
59438,3,2,208236,208236,208238,0,2,0
59439,3,1,208239,208239,208240,0,1,1
59440,2,3,208241,208241,208244,0,3,1
59441,3,3,208244,208244,208247,0,3,0
59442,1,2,208245,208247,208249,2,4,0
59443,4,1,208249,208249,208250,0,1,0
59444,3,3,208252,208252,208255,0,3,2
59445,6,1,208258,208258,208259,0,1,3
59446,1,3,208259,208259,208262,0,3,0
59447,3,1,208262,208262,208263,0,1,0
59448,1,3,208263,208263,208266,0,3,0
59449,5,2,208268,208268,208270,0,2,2
59450,3,2,208271,208271,208273,0,2,1
59451,2,3,208273,208273,208276,0,3,0
59452,2,2,208275,208276,208278,1,3,0
59453,3,3,208278,208278,208281,0,3,0
59454,1,3,208279,208281,208284,2,5,0
59455,1,3,208280,208284,208287,4,7,0
59456,5,3,208285,208287,208290,2,5,0
59457,6,3,208291,208291,208294,0,3,1
59458,4,1,208295,208295,208296,0,1,1
59459,4,3,208299,208299,208302,0,3,3
59460,3,2,208302,208302,208304,0,2,0
59461,2,3,208304,208304,208307,0,3,0
59462,2,2,208306,208307,208309,1,3,0
59463,1,1,208307,208309,208310,2,3,0
59464,6,2,208313,208313,208315,0,2,3
59465,3,1,208316,208316,208317,0,1,1
59466,6,3,208322,208322,208325,0,3,5
59467,4,3,208326,208326,208329,0,3,1
59468,5,3,208331,208331,208334,0,3,2
59469,4,3,208335,208335,208338,0,3,1
59470,6,3,208341,208341,208344,0,3,3
59471,3,1,208344,208344,208345,0,1,0
59472,6,3,208350,208350,208353,0,3,5
59473,6,1,208356,208356,208357,0,1,3
59474,6,2,208362,208362,208364,0,2,5
59475,2,1,208364,208364,208365,0,1,0
59476,4,2,208368,208368,208370,0,2,3
59477,6,1,208374,208374,208375,0,1,4
59478,4,3,208378,208378,208381,0,3,3
59479,3,1,208381,208381,208382,0,1,0
59480,5,3,208386,208386,208389,0,3,4
59481,5,3,208391,208391,208394,0,3,2
59482,3,2,208394,208394,208396,0,2,0
59483,1,3,208395,208396,208399,1,4,0
59484,6,2,208401,208401,208403,0,2,2
59485,2,3,208403,208403,208406,0,3,0
59486,6,2,208409,208409,208411,0,2,3
59487,4,3,208413,208413,208416,0,3,2
59488,1,3,208414,208416,208419,2,5,0
59489,1,1,208415,208419,208420,4,5,0
59490,4,1,208419,208420,208421,1,2,0
59491,3,1,208422,208422,208423,0,1,1
59492,5,1,208427,208427,208428,0,1,4
59493,2,3,208429,208429,208432,0,3,1
59494,1,2,208430,208432,208434,2,4,0
59495,1,2,208431,208434,208436,3,5,0
59496,4,3,208435,208436,208439,1,4,0
59497,6,2,208441,208441,208443,0,2,2
59498,5,3,208446,208446,208449,0,3,3
59499,4,1,208450,208450,208451,0,1,1
59500,2,1,208452,208452,208453,0,1,1
59501,1,3,208453,208453,208456,0,3,0
59502,2,3,208455,208456,208459,1,4,0
59503,2,2,208457,208459,208461,2,4,0
59504,3,2,208460,208461,208463,1,3,0
59505,1,2,208461,208463,208465,2,4,0
59506,5,1,208466,208466,208467,0,1,1
59507,3,2,208469,208469,208471,0,2,2
59508,1,2,208470,208471,208473,1,3,0
59509,4,3,208474,208474,208477,0,3,1
59510,3,1,208477,208477,208478,0,1,0
59511,1,1,208478,208478,208479,0,1,0
59512,1,1,208479,208479,208480,0,1,0
59513,1,1,208480,208480,208481,0,1,0
59514,2,1,208482,208482,208483,0,1,1
59515,2,3,208484,208484,208487,0,3,1
59516,4,1,208488,208488,208489,0,1,1
59517,4,1,208492,208492,208493,0,1,3
59518,1,3,208493,208493,208496,0,3,0
59519,6,1,208499,208499,208500,0,1,3
59520,3,1,208502,208502,208503,0,1,2
59521,1,2,208503,208503,208505,0,2,0
59522,6,3,208509,208509,208512,0,3,4
59523,2,3,208511,208512,208515,1,4,0
59524,5,3,208516,208516,208519,0,3,1
59525,4,3,208520,208520,208523,0,3,1
59526,1,1,208521,208523,208524,2,3,0
59527,1,2,208522,208524,208526,2,4,0
59528,5,2,208527,208527,208529,0,2,1
59529,4,2,208531,208531,208533,0,2,2
59530,2,1,208533,208533,208534,0,1,0
59531,4,2,208537,208537,208539,0,2,3
59532,1,2,208538,208539,208541,1,3,0
59533,2,2,208540,208541,208543,1,3,0
59534,6,2,208546,208546,208548,0,2,3
59535,5,1,208551,208551,208552,0,1,3
59536,5,1,208556,208556,208557,0,1,4
59537,3,2,208559,208559,208561,0,2,2
59538,5,2,208564,208564,208566,0,2,3
59539,1,2,208565,208566,208568,1,3,0
59540,3,2,208568,208568,208570,0,2,0
59541,5,2,208573,208573,208575,0,2,3
59542,2,1,208575,208575,208576,0,1,0
59543,5,2,208580,208580,208582,0,2,4
59544,1,1,208581,208582,208583,1,2,0
59545,1,3,208582,208583,208586,1,4,0
59546,6,1,208588,208588,208589,0,1,2
59547,1,1,208589,208589,208590,0,1,0
59548,6,2,208595,208595,208597,0,2,5
59549,1,3,208596,208597,208600,1,4,0
59550,2,2,208598,208600,208602,2,4,0
59551,4,2,208602,208602,208604,0,2,0
59552,2,1,208604,208604,208605,0,1,0
59553,5,1,208609,208609,208610,0,1,4
59554,5,2,208614,208614,208616,0,2,4
59555,5,2,208619,208619,208621,0,2,3
59556,4,2,208623,208623,208625,0,2,2
59557,4,2,208627,208627,208629,0,2,2
59558,5,2,208632,208632,208634,0,2,3
59559,2,1,208634,208634,208635,0,1,0
59560,1,2,208635,208635,208637,0,2,0
59561,5,2,208640,208640,208642,0,2,3
59562,2,1,208642,208642,208643,0,1,0
59563,5,2,208647,208647,208649,0,2,4
59564,1,1,208648,208649,208650,1,2,0
59565,1,2,208649,208650,208652,1,3,0
59566,5,1,208654,208654,208655,0,1,2
59567,1,2,208655,208655,208657,0,2,0
59568,3,2,208658,208658,208660,0,2,1
59569,1,1,208659,208660,208661,1,2,0
59570,2,3,208661,208661,208664,0,3,0
59571,3,2,208664,208664,208666,0,2,0
59572,6,1,208670,208670,208671,0,1,4
59573,2,3,208672,208672,208675,0,3,1
59574,2,3,208674,208675,208678,1,4,0
59575,1,1,208675,208678,208679,3,4,0
59576,1,3,208676,208679,208682,3,6,0
59577,6,2,208682,208682,208684,0,2,0
59578,6,2,208688,208688,208690,0,2,4
59579,1,1,208689,208690,208691,1,2,0
59580,3,2,208692,208692,208694,0,2,1
59581,6,1,208698,208698,208699,0,1,4
59582,1,3,208699,208699,208702,0,3,0
59583,4,2,208703,208703,208705,0,2,1
59584,4,3,208707,208707,208710,0,3,2
59585,6,3,208713,208713,208716,0,3,3
59586,2,2,208715,208716,208718,1,3,0
59587,2,1,208717,208718,208719,1,2,0
59588,5,1,208722,208722,208723,0,1,3
59589,2,1,208724,208724,208725,0,1,1
59590,2,1,208726,208726,208727,0,1,1
59591,5,3,208731,208731,208734,0,3,4
59592,1,1,208732,208734,208735,2,3,0
59593,6,2,208738,208738,208740,0,2,3
59594,2,2,208740,208740,208742,0,2,0
59595,4,3,208744,208744,208747,0,3,2
59596,2,3,208746,208747,208750,1,4,0
59597,2,1,208748,208750,208751,2,3,0
59598,1,3,208749,208751,208754,2,5,0
59599,5,2,208754,208754,208756,0,2,0
59600,1,3,208755,208756,208759,1,4,0
59601,3,2,208758,208759,208761,1,3,0
59602,5,1,208763,208763,208764,0,1,2
59603,1,2,208764,208764,208766,0,2,0
59604,5,2,208769,208769,208771,0,2,3
59605,1,3,208770,208771,208774,1,4,0
59606,1,2,208771,208774,208776,3,5,0
59607,1,1,208772,208776,208777,4,5,0
59608,4,2,208776,208777,208779,1,3,0
59609,1,3,208777,208779,208782,2,5,0
59610,6,1,208783,208783,208784,0,1,1
59611,2,2,208785,208785,208787,0,2,1
59612,2,2,208787,208787,208789,0,2,0
59613,2,1,208789,208789,208790,0,1,0
59614,3,3,208792,208792,208795,0,3,2
59615,6,3,208798,208798,208801,0,3,3
59616,2,3,208800,208801,208804,1,4,0
59617,1,3,208801,208804,208807,3,6,0
59618,1,2,208802,208807,208809,5,7,0
59619,6,1,208808,208809,208810,1,2,0
59620,1,2,208809,208810,208812,1,3,0
59621,1,3,208810,208812,208815,2,5,0
59622,2,1,208812,208815,208816,3,4,0
59623,1,2,208813,208816,208818,3,5,0
59624,6,1,208819,208819,208820,0,1,1
59625,5,1,208824,208824,208825,0,1,4
59626,5,1,208829,208829,208830,0,1,4
59627,5,3,208834,208834,208837,0,3,4
59628,6,3,208840,208840,208843,0,3,3
59629,3,1,208843,208843,208844,0,1,0
59630,5,1,208848,208848,208849,0,1,4
59631,6,2,208854,208854,208856,0,2,5
59632,2,3,208856,208856,208859,0,3,0
59633,3,3,208859,208859,208862,0,3,0
59634,6,2,208865,208865,208867,0,2,3
59635,5,1,208870,208870,208871,0,1,3
59636,6,2,208876,208876,208878,0,2,5
59637,3,2,208879,208879,208881,0,2,1
59638,5,3,208884,208884,208887,0,3,3
59639,5,3,208889,208889,208892,0,3,2
59640,5,1,208894,208894,208895,0,1,2
59641,6,3,208900,208900,208903,0,3,5
59642,2,1,208902,208903,208904,1,2,0
59643,2,3,208904,208904,208907,0,3,0
59644,5,2,208909,208909,208911,0,2,2
59645,4,3,208913,208913,208916,0,3,2
59646,4,2,208917,208917,208919,0,2,1
59647,1,3,208918,208919,208922,1,4,0
59648,3,3,208921,208922,208925,1,4,0
59649,3,1,208924,208925,208926,1,2,0
59650,3,1,208927,208927,208928,0,1,1
59651,4,1,208931,208931,208932,0,1,3
59652,1,3,208932,208932,208935,0,3,0
59653,6,2,208938,208938,208940,0,2,3
59654,2,3,208940,208940,208943,0,3,0
59655,6,1,208946,208946,208947,0,1,3
59656,3,1,208949,208949,208950,0,1,2
59657,1,2,208950,208950,208952,0,2,0
59658,2,2,208952,208952,208954,0,2,0
59659,2,1,208954,208954,208955,0,1,0
59660,4,2,208958,208958,208960,0,2,3
59661,4,2,208962,208962,208964,0,2,2
59662,3,3,208965,208965,208968,0,3,1
59663,4,1,208969,208969,208970,0,1,1
59664,3,1,208972,208972,208973,0,1,2
59665,5,1,208977,208977,208978,0,1,4
59666,2,1,208979,208979,208980,0,1,1
59667,4,2,208983,208983,208985,0,2,3
59668,3,3,208986,208986,208989,0,3,1
59669,4,1,208990,208990,208991,0,1,1
59670,5,2,208995,208995,208997,0,2,4
59671,1,2,208996,208997,208999,1,3,0
59672,2,1,208998,208999,209000,1,2,0
59673,3,1,209001,209001,209002,0,1,1
59674,6,1,209007,209007,209008,0,1,5
59675,2,3,209009,209009,209012,0,3,1
59676,1,1,209010,209012,209013,2,3,0
59677,2,2,209012,209013,209015,1,3,0
59678,5,1,209017,209017,209018,0,1,2
59679,5,3,209022,209022,209025,0,3,4
59680,1,2,209023,209025,209027,2,4,0
59681,1,2,209024,209027,209029,3,5,0
59682,1,1,209025,209029,209030,4,5,0
59683,2,2,209027,209030,209032,3,5,0
59684,4,1,209031,209032,209033,1,2,0
59685,1,1,209032,209033,209034,1,2,0
59686,1,2,209033,209034,209036,1,3,0
59687,1,3,209034,209036,209039,2,5,0
59688,4,1,209038,209039,209040,1,2,0
59689,1,1,209039,209040,209041,1,2,0
59690,2,2,209041,209041,209043,0,2,0
59691,1,3,209042,209043,209046,1,4,0
59692,2,1,209044,209046,209047,2,3,0
59693,4,1,209048,209048,209049,0,1,1
59694,5,1,209053,209053,209054,0,1,4
59695,2,3,209055,209055,209058,0,3,1
59696,2,1,209057,209058,209059,1,2,0
59697,1,3,209058,209059,209062,1,4,0
59698,1,1,209059,209062,209063,3,4,0
59699,4,1,209063,209063,209064,0,1,0
59700,3,1,209066,209066,209067,0,1,2
59701,6,3,209072,209072,209075,0,3,5
59702,4,1,209076,209076,209077,0,1,1
59703,5,3,209081,209081,209084,0,3,4
59704,3,2,209084,209084,209086,0,2,0
59705,5,2,209089,209089,209091,0,2,3
59706,6,3,209095,209095,209098,0,3,4
59707,6,2,209101,209101,209103,0,2,3
59708,2,3,209103,209103,209106,0,3,0
59709,1,3,209104,209106,209109,2,5,0
59710,4,1,209108,209109,209110,1,2,0
59711,6,2,209114,209114,209116,0,2,4
59712,6,3,209120,209120,209123,0,3,4
59713,1,1,209121,209123,209124,2,3,0
59714,3,3,209124,209124,209127,0,3,0
59715,4,1,209128,209128,209129,0,1,1
59716,6,3,209134,209134,209137,0,3,5
59717,4,2,209138,209138,209140,0,2,1
59718,4,2,209142,209142,209144,0,2,2
59719,2,3,209144,209144,209147,0,3,0
59720,2,2,209146,209147,209149,1,3,0
59721,6,1,209152,209152,209153,0,1,3
59722,4,3,209156,209156,209159,0,3,3
59723,4,2,209160,209160,209162,0,2,1
59724,4,2,209164,209164,209166,0,2,2
59725,5,2,209169,209169,209171,0,2,3
59726,3,2,209172,209172,209174,0,2,1
59727,6,2,209178,209178,209180,0,2,4
59728,2,2,209180,209180,209182,0,2,0
59729,4,1,209184,209184,209185,0,1,2
59730,3,2,209187,209187,209189,0,2,2
59731,5,3,209192,209192,209195,0,3,3
59732,4,2,209196,209196,209198,0,2,1
59733,2,1,209198,209198,209199,0,1,0
59734,6,3,209204,209204,209207,0,3,5
59735,5,3,209209,209209,209212,0,3,2
59736,1,1,209210,209212,209213,2,3,0
59737,1,2,209211,209213,209215,2,4,0
59738,4,3,209215,209215,209218,0,3,0
59739,4,3,209219,209219,209222,0,3,1
59740,4,3,209223,209223,209226,0,3,1
59741,6,1,209229,209229,209230,0,1,3
59742,5,3,209234,209234,209237,0,3,4
59743,3,1,209237,209237,209238,0,1,0
59744,1,1,209238,209238,209239,0,1,0
59745,4,3,209242,209242,209245,0,3,3
59746,1,2,209243,209245,209247,2,4,0
59747,1,1,209244,209247,209248,3,4,0
59748,6,3,209250,209250,209253,0,3,2
59749,3,2,209253,209253,209255,0,2,0
59750,3,3,209256,209256,209259,0,3,1
59751,5,3,209261,209261,209264,0,3,2
59752,5,3,209266,209266,209269,0,3,2
59753,6,1,209272,209272,209273,0,1,3
59754,4,2,209276,209276,209278,0,2,3
59755,4,1,209280,209280,209281,0,1,2
59756,3,2,209283,209283,209285,0,2,2
59757,6,3,209289,209289,209292,0,3,4
59758,3,1,209292,209292,209293,0,1,0
59759,2,3,209294,209294,209297,0,3,1
59760,4,3,209298,209298,209301,0,3,1
59761,3,2,209301,209301,209303,0,2,0
59762,1,2,209302,209303,209305,1,3,0
59763,6,3,209308,209308,209311,0,3,3
59764,4,3,209312,209312,209315,0,3,1
59765,6,1,209318,209318,209319,0,1,3
59766,5,3,209323,209323,209326,0,3,4
59767,2,2,209325,209326,209328,1,3,0
59768,1,3,209326,209328,209331,2,5,0
59769,6,3,209332,209332,209335,0,3,1
59770,5,1,209337,209337,209338,0,1,2
59771,1,1,209338,209338,209339,0,1,0
59772,6,2,209344,209344,209346,0,2,5
59773,3,1,209347,209347,209348,0,1,1
59774,3,1,209350,209350,209351,0,1,2
59775,3,3,209353,209353,209356,0,3,2
59776,4,2,209357,209357,209359,0,2,1
59777,6,3,209363,209363,209366,0,3,4
59778,2,2,209365,209366,209368,1,3,0
59779,5,1,209370,209370,209371,0,1,2
59780,6,3,209376,209376,209379,0,3,5
59781,3,2,209379,209379,209381,0,2,0
59782,1,3,209380,209381,209384,1,4,0
59783,5,1,209385,209385,209386,0,1,1
59784,3,1,209388,209388,209389,0,1,2
59785,5,3,209393,209393,209396,0,3,4
59786,6,1,209399,209399,209400,0,1,3
59787,4,1,209403,209403,209404,0,1,3
59788,5,2,209408,209408,209410,0,2,4
59789,6,1,209414,209414,209415,0,1,4
59790,4,2,209418,209418,209420,0,2,3
59791,5,1,209423,209423,209424,0,1,3
59792,6,2,209429,209429,209431,0,2,5
59793,1,3,209430,209431,209434,1,4,0
59794,2,2,209432,209434,209436,2,4,0
59795,2,3,209434,209436,209439,2,5,0
59796,4,2,209438,209439,209441,1,3,0
59797,1,2,209439,209441,209443,2,4,0
59798,6,1,209445,209445,209446,0,1,2
59799,1,2,209446,209446,209448,0,2,0
59800,6,2,209452,209452,209454,0,2,4
59801,4,2,209456,209456,209458,0,2,2
59802,5,3,209461,209461,209464,0,3,3
59803,4,1,209465,209465,209466,0,1,1
59804,2,3,209467,209467,209470,0,3,1
59805,1,1,209468,209470,209471,2,3,0
59806,2,2,209470,209471,209473,1,3,0
59807,3,2,209473,209473,209475,0,2,0
59808,5,3,209478,209478,209481,0,3,3
59809,4,3,209482,209482,209485,0,3,1
59810,1,1,209483,209485,209486,2,3,0
59811,6,1,209489,209489,209490,0,1,3
59812,5,2,209494,209494,209496,0,2,4
59813,2,1,209496,209496,209497,0,1,0
59814,5,2,209501,209501,209503,0,2,4
59815,3,2,209504,209504,209506,0,2,1
59816,6,3,209510,209510,209513,0,3,4
59817,5,1,209515,209515,209516,0,1,2
59818,1,3,209516,209516,209519,0,3,0
59819,1,2,209517,209519,209521,2,4,0
59820,3,1,209520,209521,209522,1,2,0
59821,2,3,209522,209522,209525,0,3,0
59822,5,3,209527,209527,209530,0,3,2
59823,3,1,209530,209530,209531,0,1,0
59824,2,1,209532,209532,209533,0,1,1
59825,1,2,209533,209533,209535,0,2,0
59826,3,3,209536,209536,209539,0,3,1
59827,5,1,209541,209541,209542,0,1,2
59828,1,2,209542,209542,209544,0,2,0
59829,2,2,209544,209544,209546,0,2,0
59830,1,2,209545,209546,209548,1,3,0
59831,2,1,209547,209548,209549,1,2,0
59832,2,3,209549,209549,209552,0,3,0
59833,4,2,209553,209553,209555,0,2,1
59834,3,2,209556,209556,209558,0,2,1
59835,5,3,209561,209561,209564,0,3,3
59836,2,2,209563,209564,209566,1,3,0
59837,5,3,209568,209568,209571,0,3,2
59838,4,2,209572,209572,209574,0,2,1
59839,3,1,209575,209575,209576,0,1,1
59840,5,2,209580,209580,209582,0,2,4
59841,3,2,209583,209583,209585,0,2,1
59842,1,3,209584,209585,209588,1,4,0
59843,3,3,209587,209588,209591,1,4,0
59844,6,2,209593,209593,209595,0,2,2
59845,5,2,209598,209598,209600,0,2,3
59846,6,3,209604,209604,209607,0,3,4
59847,1,1,209605,209607,209608,2,3,0
59848,6,2,209611,209611,209613,0,2,3
59849,6,2,209617,209617,209619,0,2,4
59850,1,1,209618,209619,209620,1,2,0
59851,1,2,209619,209620,209622,1,3,0
59852,3,1,209622,209622,209623,0,1,0
59853,6,2,209628,209628,209630,0,2,5
59854,1,2,209629,209630,209632,1,3,0
59855,2,2,209631,209632,209634,1,3,0
59856,4,1,209635,209635,209636,0,1,1
59857,1,1,209636,209636,209637,0,1,0
59858,2,1,209638,209638,209639,0,1,1
59859,5,2,209643,209643,209645,0,2,4
59860,3,3,209646,209646,209649,0,3,1
59861,5,2,209651,209651,209653,0,2,2
59862,5,1,209656,209656,209657,0,1,3
59863,2,3,209658,209658,209661,0,3,1
59864,1,1,209659,209661,209662,2,3,0
59865,6,1,209665,209665,209666,0,1,3
59866,2,2,209667,209667,209669,0,2,1
59867,1,3,209668,209669,209672,1,4,0
59868,1,1,209669,209672,209673,3,4,0
59869,3,2,209672,209673,209675,1,3,0
59870,6,2,209678,209678,209680,0,2,3
59871,4,3,209682,209682,209685,0,3,2
59872,6,3,209688,209688,209691,0,3,3
59873,6,3,209694,209694,209697,0,3,3
59874,2,3,209696,209697,209700,1,4,0
59875,2,2,209698,209700,209702,2,4,0
59876,6,3,209704,209704,209707,0,3,2
59877,2,1,209706,209707,209708,1,2,0
59878,1,2,209707,209708,209710,1,3,0
59879,2,2,209709,209710,209712,1,3,0
59880,2,2,209711,209712,209714,1,3,0
59881,4,2,209715,209715,209717,0,2,1
59882,4,1,209719,209719,209720,0,1,2
59883,2,3,209721,209721,209724,0,3,1
59884,2,2,209723,209724,209726,1,3,0
59885,5,1,209728,209728,209729,0,1,2
59886,4,1,209732,209732,209733,0,1,3
59887,4,3,209736,209736,209739,0,3,3
59888,4,2,209740,209740,209742,0,2,1
59889,1,3,209741,209742,209745,1,4,0
59890,1,1,209742,209745,209746,3,4,0
59891,3,2,209745,209746,209748,1,3,0
59892,5,1,209750,209750,209751,0,1,2
59893,3,1,209753,209753,209754,0,1,2
59894,6,3,209759,209759,209762,0,3,5
59895,3,2,209762,209762,209764,0,2,0
59896,5,1,209767,209767,209768,0,1,3
59897,4,2,209771,209771,209773,0,2,3
59898,5,2,209776,209776,209778,0,2,3
59899,3,2,209779,209779,209781,0,2,1
59900,5,1,209784,209784,209785,0,1,3
59901,4,1,209788,209788,209789,0,1,3
59902,5,2,209793,209793,209795,0,2,4
59903,6,2,209799,209799,209801,0,2,4
59904,1,1,209800,209801,209802,1,2,0
59905,2,2,209802,209802,209804,0,2,0
59906,2,1,209804,209804,209805,0,1,0
59907,2,2,209806,209806,209808,0,2,1
59908,1,1,209807,209808,209809,1,2,0
59909,2,2,209809,209809,209811,0,2,0
59910,1,1,209810,209811,209812,1,2,0
59911,2,3,209812,209812,209815,0,3,0
59912,1,3,209813,209815,209818,2,5,0
59913,1,3,209814,209818,209821,4,7,0
59914,6,2,209820,209821,209823,1,3,0
59915,4,2,209824,209824,209826,0,2,1
59916,1,1,209825,209826,209827,1,2,0
59917,5,3,209830,209830,209833,0,3,3
59918,5,1,209835,209835,209836,0,1,2
59919,1,1,209836,209836,209837,0,1,0
59920,6,1,209842,209842,209843,0,1,5
59921,3,1,209845,209845,209846,0,1,2
59922,4,1,209849,209849,209850,0,1,3
59923,2,2,209851,209851,209853,0,2,1
59924,4,1,209855,209855,209856,0,1,2
59925,4,2,209859,209859,209861,0,2,3
59926,1,3,209860,209861,209864,1,4,0
59927,1,3,209861,209864,209867,3,6,0
59928,6,2,209867,209867,209869,0,2,0
59929,4,3,209871,209871,209874,0,3,2
59930,1,2,209872,209874,209876,2,4,0
59931,6,3,209878,209878,209881,0,3,2
59932,4,1,209882,209882,209883,0,1,1
59933,4,3,209886,209886,209889,0,3,3
59934,5,3,209891,209891,209894,0,3,2
59935,5,2,209896,209896,209898,0,2,2
59936,6,2,209902,209902,209904,0,2,4
59937,3,3,209905,209905,209908,0,3,1
59938,6,2,209911,209911,209913,0,2,3
59939,5,1,209916,209916,209917,0,1,3
59940,1,2,209917,209917,209919,0,2,0
59941,5,1,209922,209922,209923,0,1,3
59942,6,3,209928,209928,209931,0,3,5
59943,1,2,209929,209931,209933,2,4,0
59944,2,3,209931,209933,209936,2,5,0
59945,3,1,209934,209936,209937,2,3,0
59946,1,2,209935,209937,209939,2,4,0
59947,3,3,209938,209939,209942,1,4,0
59948,1,2,209939,209942,209944,3,5,0
59949,3,3,209942,209944,209947,2,5,0
59950,3,3,209945,209947,209950,2,5,0
59951,2,3,209947,209950,209953,3,6,0
59952,1,3,209948,209953,209956,5,8,0
59953,6,1,209954,209956,209957,2,3,0
59954,3,1,209957,209957,209958,0,1,0
59955,2,1,209959,209959,209960,0,1,1
59956,1,1,209960,209960,209961,0,1,0
59957,4,1,209964,209964,209965,0,1,3
59958,6,1,209970,209970,209971,0,1,5
59959,6,3,209976,209976,209979,0,3,5
59960,1,1,209977,209979,209980,2,3,0
59961,6,3,209983,209983,209986,0,3,3
59962,5,1,209988,209988,209989,0,1,2
59963,6,3,209994,209994,209997,0,3,5
59964,6,3,210000,210000,210003,0,3,3
59965,6,2,210006,210006,210008,0,2,3
59966,4,3,210010,210010,210013,0,3,2
59967,2,2,210012,210013,210015,1,3,0
59968,4,2,210016,210016,210018,0,2,1
59969,6,2,210022,210022,210024,0,2,4
59970,4,1,210026,210026,210027,0,1,2
59971,6,3,210032,210032,210035,0,3,5
59972,3,1,210035,210035,210036,0,1,0
59973,3,1,210038,210038,210039,0,1,2
59974,2,3,210040,210040,210043,0,3,1
59975,1,2,210041,210043,210045,2,4,0
59976,4,3,210045,210045,210048,0,3,0
59977,5,2,210050,210050,210052,0,2,2
59978,2,1,210052,210052,210053,0,1,0
59979,1,3,210053,210053,210056,0,3,0
59980,5,1,210058,210058,210059,0,1,2
59981,2,1,210060,210060,210061,0,1,1
59982,3,1,210063,210063,210064,0,1,2
59983,5,2,210068,210068,210070,0,2,4
59984,3,1,210071,210071,210072,0,1,1
59985,6,2,210077,210077,210079,0,2,5
59986,2,3,210079,210079,210082,0,3,0
59987,4,3,210083,210083,210086,0,3,1
59988,2,3,210085,210086,210089,1,4,0
59989,4,3,210089,210089,210092,0,3,0
59990,4,3,210093,210093,210096,0,3,1
59991,5,2,210098,210098,210100,0,2,2
59992,5,2,210103,210103,210105,0,2,3
59993,6,2,210109,210109,210111,0,2,4
59994,2,1,210111,210111,210112,0,1,0
59995,4,3,210115,210115,210118,0,3,3
59996,4,1,210119,210119,210120,0,1,1
59997,6,3,210125,210125,210128,0,3,5
59998,2,2,210127,210128,210130,1,3,0
59999,5,3,210132,210132,210135,0,3,2
60000,4,1,210136,210136,210137,0,1,1
60001,1,3,210137,210137,210140,0,3,0
60002,2,2,210139,210140,210142,1,3,0
60003,4,3,210143,210143,210146,0,3,1
60004,2,1,210145,210146,210147,1,2,0
60005,6,1,210151,210151,210152,0,1,4
60006,2,2,210153,210153,210155,0,2,1
60007,5,1,210158,210158,210159,0,1,3
60008,5,1,210163,210163,210164,0,1,4
60009,2,2,210165,210165,210167,0,2,1
60010,2,1,210167,210167,210168,0,1,0
60011,1,1,210168,210168,210169,0,1,0
60012,3,2,210171,210171,210173,0,2,2
60013,3,2,210174,210174,210176,0,2,1
60014,5,3,210179,210179,210182,0,3,3
60015,5,1,210184,210184,210185,0,1,2
60016,3,2,210187,210187,210189,0,2,2
60017,1,2,210188,210189,210191,1,3,0
60018,6,1,210194,210194,210195,0,1,3
60019,6,1,210200,210200,210201,0,1,5
60020,1,3,210201,210201,210204,0,3,0
60021,6,1,210207,210207,210208,0,1,3
60022,5,1,210212,210212,210213,0,1,4
60023,2,1,210214,210214,210215,0,1,1
60024,2,3,210216,210216,210219,0,3,1
60025,2,3,210218,210219,210222,1,4,0
60026,2,3,210220,210222,210225,2,5,0
60027,6,3,210226,210226,210229,0,3,1
60028,4,1,210230,210230,210231,0,1,1
60029,2,2,210232,210232,210234,0,2,1
60030,4,1,210236,210236,210237,0,1,2
60031,3,1,210239,210239,210240,0,1,2
60032,1,3,210240,210240,210243,0,3,0
60033,6,1,210246,210246,210247,0,1,3
60034,1,1,210247,210247,210248,0,1,0
60035,2,3,210249,210249,210252,0,3,1
60036,4,3,210253,210253,210256,0,3,1
60037,3,3,210256,210256,210259,0,3,0
60038,2,2,210258,210259,210261,1,3,0
60039,3,1,210261,210261,210262,0,1,0
60040,5,2,210266,210266,210268,0,2,4
60041,6,2,210272,210272,210274,0,2,4
60042,3,1,210275,210275,210276,0,1,1
60043,4,1,210279,210279,210280,0,1,3
60044,3,2,210282,210282,210284,0,2,2
60045,1,2,210283,210284,210286,1,3,0
60046,3,3,210286,210286,210289,0,3,0
60047,6,1,210292,210292,210293,0,1,3
60048,1,2,210293,210293,210295,0,2,0
60049,6,2,210299,210299,210301,0,2,4
60050,3,2,210302,210302,210304,0,2,1
60051,5,2,210307,210307,210309,0,2,3
60052,2,1,210309,210309,210310,0,1,0
60053,6,2,210315,210315,210317,0,2,5
60054,2,2,210317,210317,210319,0,2,0
60055,1,3,210318,210319,210322,1,4,0
60056,4,2,210322,210322,210324,0,2,0
60057,2,1,210324,210324,210325,0,1,0
60058,5,2,210329,210329,210331,0,2,4
60059,4,1,210333,210333,210334,0,1,2
60060,2,1,210335,210335,210336,0,1,1
60061,4,3,210339,210339,210342,0,3,3
60062,2,2,210341,210342,210344,1,3,0
60063,1,3,210342,210344,210347,2,5,0
60064,5,3,210347,210347,210350,0,3,0
60065,1,2,210348,210350,210352,2,4,0
60066,6,2,210354,210354,210356,0,2,2
60067,5,3,210359,210359,210362,0,3,3
60068,6,2,210365,210365,210367,0,2,3
60069,5,3,210370,210370,210373,0,3,3
60070,3,3,210373,210373,210376,0,3,0
60071,5,2,210378,210378,210380,0,2,2
60072,5,2,210383,210383,210385,0,2,3
60073,6,3,210389,210389,210392,0,3,4
60074,3,1,210392,210392,210393,0,1,0
60075,4,3,210396,210396,210399,0,3,3
60076,6,1,210402,210402,210403,0,1,3
60077,3,1,210405,210405,210406,0,1,2
60078,6,3,210411,210411,210414,0,3,5
60079,1,1,210412,210414,210415,2,3,0
60080,6,2,210418,210418,210420,0,2,3
60081,2,1,210420,210420,210421,0,1,0
60082,4,1,210424,210424,210425,0,1,3
60083,3,3,210427,210427,210430,0,3,2
60084,3,3,210430,210430,210433,0,3,0
60085,6,2,210436,210436,210438,0,2,3
60086,6,3,210442,210442,210445,0,3,4
60087,3,2,210445,210445,210447,0,2,0
60088,5,1,210450,210450,210451,0,1,3
60089,6,3,210456,210456,210459,0,3,5
60090,3,1,210459,210459,210460,0,1,0
60091,6,3,210465,210465,210468,0,3,5
60092,4,2,210469,210469,210471,0,2,1
60093,1,2,210470,210471,210473,1,3,0
60094,5,1,210475,210475,210476,0,1,2
60095,1,3,210476,210476,210479,0,3,0
60096,3,3,210479,210479,210482,0,3,0
60097,3,1,210482,210482,210483,0,1,0
60098,1,2,210483,210483,210485,0,2,0
60099,5,2,210488,210488,210490,0,2,3
60100,6,2,210494,210494,210496,0,2,4
60101,1,3,210495,210496,210499,1,4,0
60102,6,2,210501,210501,210503,0,2,2
60103,4,3,210505,210505,210508,0,3,2
60104,5,2,210510,210510,210512,0,2,2
60105,6,2,210516,210516,210518,0,2,4
60106,2,3,210518,210518,210521,0,3,0
60107,3,2,210521,210521,210523,0,2,0
60108,3,1,210524,210524,210525,0,1,1
60109,4,2,210528,210528,210530,0,2,3
60110,2,2,210530,210530,210532,0,2,0
60111,6,2,210536,210536,210538,0,2,4
60112,3,3,210539,210539,210542,0,3,1
60113,6,3,210545,210545,210548,0,3,3
60114,1,1,210546,210548,210549,2,3,0
60115,3,1,210549,210549,210550,0,1,0
60116,1,1,210550,210550,210551,0,1,0
60117,2,3,210552,210552,210555,0,3,1
60118,4,2,210556,210556,210558,0,2,1
60119,4,3,210560,210560,210563,0,3,2
60120,4,2,210564,210564,210566,0,2,1
60121,2,2,210566,210566,210568,0,2,0
60122,4,3,210570,210570,210573,0,3,2
60123,2,3,210572,210573,210576,1,4,0
60124,3,2,210575,210576,210578,1,3,0
60125,1,1,210576,210578,210579,2,3,0
60126,4,1,210580,210580,210581,0,1,1
60127,4,1,210584,210584,210585,0,1,3
60128,4,2,210588,210588,210590,0,2,3
60129,1,3,210589,210590,210593,1,4,0
60130,5,2,210594,210594,210596,0,2,1
60131,4,3,210598,210598,210601,0,3,2
60132,6,2,210604,210604,210606,0,2,3
60133,2,2,210606,210606,210608,0,2,0
60134,1,3,210607,210608,210611,1,4,0
60135,3,2,210610,210611,210613,1,3,0
60136,3,1,210613,210613,210614,0,1,0
60137,1,3,210614,210614,210617,0,3,0
60138,6,1,210620,210620,210621,0,1,3
60139,3,3,210623,210623,210626,0,3,2
60140,6,2,210629,210629,210631,0,2,3
60141,6,3,210635,210635,210638,0,3,4
60142,6,3,210641,210641,210644,0,3,3
60143,2,1,210643,210644,210645,1,2,0
60144,6,2,210649,210649,210651,0,2,4
60145,5,1,210654,210654,210655,0,1,3
60146,1,2,210655,210655,210657,0,2,0
60147,3,3,210658,210658,210661,0,3,1
60148,4,3,210662,210662,210665,0,3,1
60149,1,1,210663,210665,210666,2,3,0
60150,3,1,210666,210666,210667,0,1,0
60151,1,3,210667,210667,210670,0,3,0
60152,5,3,210672,210672,210675,0,3,2
60153,1,2,210673,210675,210677,2,4,0
60154,6,2,210679,210679,210681,0,2,2
60155,1,3,210680,210681,210684,1,4,0
60156,3,3,210683,210684,210687,1,4,0
60157,5,1,210688,210688,210689,0,1,1
60158,1,3,210689,210689,210692,0,3,0
60159,1,1,210690,210692,210693,2,3,0
60160,1,1,210691,210693,210694,2,3,0
60161,2,2,210693,210694,210696,1,3,0
60162,6,2,210699,210699,210701,0,2,3
60163,3,2,210702,210702,210704,0,2,1
60164,1,1,210703,210704,210705,1,2,0
60165,6,2,210709,210709,210711,0,2,4
60166,2,3,210711,210711,210714,0,3,0
60167,3,1,210714,210714,210715,0,1,0
60168,3,3,210717,210717,210720,0,3,2
60169,5,2,210722,210722,210724,0,2,2
60170,4,3,210726,210726,210729,0,3,2
60171,3,1,210729,210729,210730,0,1,0
60172,5,2,210734,210734,210736,0,2,4
60173,4,3,210738,210738,210741,0,3,2
60174,1,1,210739,210741,210742,2,3,0
60175,2,3,210741,210742,210745,1,4,0
60176,1,1,210742,210745,210746,3,4,0
60177,3,3,210745,210746,210749,1,4,0
60178,3,2,210748,210749,210751,1,3,0
60179,3,2,210751,210751,210753,0,2,0
60180,1,2,210752,210753,210755,1,3,0
60181,2,1,210754,210755,210756,1,2,0
60182,5,3,210759,210759,210762,0,3,3
60183,1,2,210760,210762,210764,2,4,0
60184,2,3,210762,210764,210767,2,5,0
60185,5,3,210767,210767,210770,0,3,0
60186,3,3,210770,210770,210773,0,3,0
60187,4,3,210774,210774,210777,0,3,1
60188,1,3,210775,210777,210780,2,5,0
60189,3,1,210778,210780,210781,2,3,0
60190,2,3,210780,210781,210784,1,4,0
60191,5,2,210785,210785,210787,0,2,1
60192,3,1,210788,210788,210789,0,1,1
60193,2,2,210790,210790,210792,0,2,1
60194,3,3,210793,210793,210796,0,3,1
60195,5,2,210798,210798,210800,0,2,2
60196,5,3,210803,210803,210806,0,3,3
60197,6,1,210809,210809,210810,0,1,3
60198,3,2,210812,210812,210814,0,2,2
60199,3,3,210815,210815,210818,0,3,1
60200,6,3,210821,210821,210824,0,3,3
60201,5,3,210826,210826,210829,0,3,2
60202,6,1,210832,210832,210833,0,1,3
60203,2,1,210834,210834,210835,0,1,1
60204,2,1,210836,210836,210837,0,1,1
60205,2,3,210838,210838,210841,0,3,1
60206,3,3,210841,210841,210844,0,3,0
60207,4,3,210845,210845,210848,0,3,1
60208,5,2,210850,210850,210852,0,2,2
60209,1,3,210851,210852,210855,1,4,0
60210,4,1,210855,210855,210856,0,1,0
60211,5,3,210860,210860,210863,0,3,4
60212,3,3,210863,210863,210866,0,3,0
60213,1,1,210864,210866,210867,2,3,0
60214,1,3,210865,210867,210870,2,5,0
60215,2,2,210867,210870,210872,3,5,0
60216,6,3,210873,210873,210876,0,3,1
60217,2,2,210875,210876,210878,1,3,0
60218,6,3,210881,210881,210884,0,3,3
60219,1,2,210882,210884,210886,2,4,0
60220,2,3,210884,210886,210889,2,5,0
60221,4,3,210888,210889,210892,1,4,0
60222,1,1,210889,210892,210893,3,4,0
60223,4,3,210893,210893,210896,0,3,0
60224,6,2,210899,210899,210901,0,2,3
60225,1,1,210900,210901,210902,1,2,0
60226,6,1,210906,210906,210907,0,1,4
60227,3,2,210909,210909,210911,0,2,2
60228,3,1,210912,210912,210913,0,1,1
60229,2,1,210914,210914,210915,0,1,1
60230,1,3,210915,210915,210918,0,3,0
60231,5,2,210920,210920,210922,0,2,2
60232,6,2,210926,210926,210928,0,2,4
60233,3,2,210929,210929,210931,0,2,1
60234,5,1,210934,210934,210935,0,1,3
60235,1,1,210935,210935,210936,0,1,0
60236,1,3,210936,210936,210939,0,3,0
60237,5,1,210941,210941,210942,0,1,2
60238,2,3,210943,210943,210946,0,3,1
60239,4,3,210947,210947,210950,0,3,1
60240,1,3,210948,210950,210953,2,5,0
60241,5,2,210953,210953,210955,0,2,0
60242,2,1,210955,210955,210956,0,1,0
60243,6,1,210961,210961,210962,0,1,5
60244,4,1,210965,210965,210966,0,1,3
60245,5,2,210970,210970,210972,0,2,4
60246,6,1,210976,210976,210977,0,1,4
60247,6,2,210982,210982,210984,0,2,5
60248,4,1,210986,210986,210987,0,1,2
60249,3,3,210989,210989,210992,0,3,2
60250,4,2,210993,210993,210995,0,2,1
60251,3,3,210996,210996,210999,0,3,1
60252,6,3,211002,211002,211005,0,3,3
60253,5,3,211007,211007,211010,0,3,2
60254,2,2,211009,211010,211012,1,3,0
60255,2,1,211011,211012,211013,1,2,0
60256,2,1,211013,211013,211014,0,1,0
60257,2,1,211015,211015,211016,0,1,1
60258,5,2,211020,211020,211022,0,2,4
60259,1,2,211021,211022,211024,1,3,0
60260,2,3,211023,211024,211027,1,4,0
60261,6,2,211029,211029,211031,0,2,2
60262,2,3,211031,211031,211034,0,3,0
60263,2,2,211033,211034,211036,1,3,0
60264,5,1,211038,211038,211039,0,1,2
60265,1,2,211039,211039,211041,0,2,0
60266,2,3,211041,211041,211044,0,3,0
60267,1,3,211042,211044,211047,2,5,0
60268,4,3,211046,211047,211050,1,4,0
60269,4,2,211050,211050,211052,0,2,0
60270,4,1,211054,211054,211055,0,1,2
60271,2,3,211056,211056,211059,0,3,1
60272,6,2,211062,211062,211064,0,2,3
60273,5,1,211067,211067,211068,0,1,3
60274,3,2,211070,211070,211072,0,2,2
60275,6,3,211076,211076,211079,0,3,4
60276,5,2,211081,211081,211083,0,2,2
60277,3,3,211084,211084,211087,0,3,1
60278,6,3,211090,211090,211093,0,3,3
60279,1,1,211091,211093,211094,2,3,0
60280,6,1,211097,211097,211098,0,1,3
60281,5,1,211102,211102,211103,0,1,4
60282,4,3,211106,211106,211109,0,3,3
60283,5,1,211111,211111,211112,0,1,2
60284,1,2,211112,211112,211114,0,2,0
60285,2,3,211114,211114,211117,0,3,0
60286,5,3,211119,211119,211122,0,3,2
60287,6,2,211125,211125,211127,0,2,3
60288,5,1,211130,211130,211131,0,1,3
60289,3,1,211133,211133,211134,0,1,2
60290,6,2,211139,211139,211141,0,2,5
60291,1,1,211140,211141,211142,1,2,0
60292,3,3,211143,211143,211146,0,3,1
60293,3,1,211146,211146,211147,0,1,0
60294,5,1,211151,211151,211152,0,1,4
60295,5,3,211156,211156,211159,0,3,4
60296,1,2,211157,211159,211161,2,4,0
60297,2,2,211159,211161,211163,2,4,0
60298,5,2,211164,211164,211166,0,2,1
60299,5,2,211169,211169,211171,0,2,3
60300,6,1,211175,211175,211176,0,1,4
60301,6,3,211181,211181,211184,0,3,5
60302,5,1,211186,211186,211187,0,1,2
60303,4,1,211190,211190,211191,0,1,3
60304,2,1,211192,211192,211193,0,1,1
60305,6,3,211198,211198,211201,0,3,5
60306,3,2,211201,211201,211203,0,2,0
60307,5,2,211206,211206,211208,0,2,3
60308,1,3,211207,211208,211211,1,4,0
60309,1,2,211208,211211,211213,3,5,0
60310,4,3,211212,211213,211216,1,4,0
60311,2,3,211214,211216,211219,2,5,0
60312,3,2,211217,211219,211221,2,4,0
60313,3,1,211220,211221,211222,1,2,0
60314,5,3,211225,211225,211228,0,3,3
60315,4,3,211229,211229,211232,0,3,1
60316,3,3,211232,211232,211235,0,3,0
60317,3,2,211235,211235,211237,0,2,0
60318,1,3,211236,211237,211240,1,4,0
60319,2,2,211238,211240,211242,2,4,0
60320,6,3,211244,211244,211247,0,3,2
60321,1,3,211245,211247,211250,2,5,0
60322,4,3,211249,211250,211253,1,4,0
60323,6,3,211255,211255,211258,0,3,2
60324,4,2,211259,211259,211261,0,2,1
60325,5,2,211264,211264,211266,0,2,3
60326,3,3,211267,211267,211270,0,3,1
60327,1,3,211268,211270,211273,2,5,0
60328,5,3,211273,211273,211276,0,3,0
60329,2,3,211275,211276,211279,1,4,0
60330,6,1,211281,211281,211282,0,1,2
60331,5,1,211286,211286,211287,0,1,4
60332,6,1,211292,211292,211293,0,1,5
60333,5,2,211297,211297,211299,0,2,4
60334,3,1,211300,211300,211301,0,1,1
60335,1,2,211301,211301,211303,0,2,0
60336,2,3,211303,211303,211306,0,3,0
60337,2,2,211305,211306,211308,1,3,0
60338,1,3,211306,211308,211311,2,5,0
60339,2,3,211308,211311,211314,3,6,0
60340,4,3,211312,211314,211317,2,5,0
60341,6,2,211318,211318,211320,0,2,1
60342,3,2,211321,211321,211323,0,2,1
60343,5,1,211326,211326,211327,0,1,3
60344,1,2,211327,211327,211329,0,2,0
60345,3,1,211330,211330,211331,0,1,1
60346,5,1,211335,211335,211336,0,1,4
60347,3,2,211338,211338,211340,0,2,2
60348,1,3,211339,211340,211343,1,4,0
60349,4,2,211343,211343,211345,0,2,0
60350,4,1,211347,211347,211348,0,1,2
60351,4,1,211351,211351,211352,0,1,3
60352,6,2,211357,211357,211359,0,2,5
60353,5,2,211362,211362,211364,0,2,3
60354,1,1,211363,211364,211365,1,2,0
60355,4,3,211367,211367,211370,0,3,2
60356,4,1,211371,211371,211372,0,1,1
60357,3,1,211374,211374,211375,0,1,2
60358,3,1,211377,211377,211378,0,1,2
60359,6,1,211383,211383,211384,0,1,5
60360,2,3,211385,211385,211388,0,3,1
60361,5,1,211390,211390,211391,0,1,2
60362,5,1,211395,211395,211396,0,1,4
60363,6,2,211401,211401,211403,0,2,5
60364,5,2,211406,211406,211408,0,2,3
60365,5,3,211411,211411,211414,0,3,3
60366,2,1,211413,211414,211415,1,2,0
60367,5,1,211418,211418,211419,0,1,3
60368,2,1,211420,211420,211421,0,1,1
60369,2,2,211422,211422,211424,0,2,1
60370,3,3,211425,211425,211428,0,3,1
60371,6,3,211431,211431,211434,0,3,3
60372,2,2,211433,211434,211436,1,3,0
60373,2,3,211435,211436,211439,1,4,0
60374,5,1,211440,211440,211441,0,1,1
60375,2,1,211442,211442,211443,0,1,1
60376,3,1,211445,211445,211446,0,1,2
60377,2,3,211447,211447,211450,0,3,1
60378,3,3,211450,211450,211453,0,3,0
60379,3,1,211453,211453,211454,0,1,0
60380,5,3,211458,211458,211461,0,3,4
60381,4,1,211462,211462,211463,0,1,1
60382,4,1,211466,211466,211467,0,1,3
60383,4,1,211470,211470,211471,0,1,3
60384,3,2,211473,211473,211475,0,2,2
60385,6,2,211479,211479,211481,0,2,4
60386,2,1,211481,211481,211482,0,1,0
60387,4,3,211485,211485,211488,0,3,3
60388,6,2,211491,211491,211493,0,2,3
60389,3,3,211494,211494,211497,0,3,1
60390,3,2,211497,211497,211499,0,2,0
60391,6,2,211503,211503,211505,0,2,4
60392,3,3,211506,211506,211509,0,3,1
60393,3,3,211509,211509,211512,0,3,0
60394,6,2,211515,211515,211517,0,2,3
60395,3,2,211518,211518,211520,0,2,1
60396,4,2,211522,211522,211524,0,2,2
60397,3,1,211525,211525,211526,0,1,1
60398,2,3,211527,211527,211530,0,3,1
60399,3,3,211530,211530,211533,0,3,0
60400,6,3,211536,211536,211539,0,3,3
60401,4,3,211540,211540,211543,0,3,1
60402,2,3,211542,211543,211546,1,4,0
60403,3,2,211545,211546,211548,1,3,0
60404,3,3,211548,211548,211551,0,3,0
60405,6,3,211554,211554,211557,0,3,3
60406,4,1,211558,211558,211559,0,1,1
60407,2,1,211560,211560,211561,0,1,1
60408,4,1,211564,211564,211565,0,1,3
60409,5,3,211569,211569,211572,0,3,4
60410,5,1,211574,211574,211575,0,1,2
60411,4,2,211578,211578,211580,0,2,3
60412,4,3,211582,211582,211585,0,3,2
60413,5,2,211587,211587,211589,0,2,2
60414,3,3,211590,211590,211593,0,3,1
60415,3,1,211593,211593,211594,0,1,0
60416,4,3,211597,211597,211600,0,3,3
60417,4,1,211601,211601,211602,0,1,1
60418,5,2,211606,211606,211608,0,2,4
60419,4,3,211610,211610,211613,0,3,2
60420,6,2,211616,211616,211618,0,2,3
60421,5,2,211621,211621,211623,0,2,3
60422,5,1,211626,211626,211627,0,1,3
60423,1,3,211627,211627,211630,0,3,0
60424,6,2,211633,211633,211635,0,2,3
60425,6,2,211639,211639,211641,0,2,4
60426,2,3,211641,211641,211644,0,3,0
60427,2,2,211643,211644,211646,1,3,0
60428,2,1,211645,211646,211647,1,2,0
60429,5,1,211650,211650,211651,0,1,3
60430,3,3,211653,211653,211656,0,3,2
60431,2,2,211655,211656,211658,1,3,0
60432,3,3,211658,211658,211661,0,3,0
60433,2,1,211660,211661,211662,1,2,0
60434,3,2,211663,211663,211665,0,2,1
60435,1,2,211664,211665,211667,1,3,0
60436,3,3,211667,211667,211670,0,3,0
60437,6,3,211673,211673,211676,0,3,3
60438,3,3,211676,211676,211679,0,3,0
60439,3,3,211679,211679,211682,0,3,0
60440,4,2,211683,211683,211685,0,2,1
60441,1,1,211684,211685,211686,1,2,0
60442,3,3,211687,211687,211690,0,3,1
60443,6,2,211693,211693,211695,0,2,3
60444,5,3,211698,211698,211701,0,3,3
60445,1,2,211699,211701,211703,2,4,0
60446,2,3,211701,211703,211706,2,5,0
60447,3,3,211704,211706,211709,2,5,0
60448,3,3,211707,211709,211712,2,5,0
60449,6,3,211713,211713,211716,0,3,1
60450,3,1,211716,211716,211717,0,1,0
60451,4,3,211720,211720,211723,0,3,3
60452,3,2,211723,211723,211725,0,2,0
60453,3,3,211726,211726,211729,0,3,1
60454,2,1,211728,211729,211730,1,2,0
60455,6,2,211734,211734,211736,0,2,4
60456,4,1,211738,211738,211739,0,1,2
60457,2,1,211740,211740,211741,0,1,1
60458,2,1,211742,211742,211743,0,1,1
60459,3,1,211745,211745,211746,0,1,2
60460,5,3,211750,211750,211753,0,3,4
60461,5,1,211755,211755,211756,0,1,2
60462,5,2,211760,211760,211762,0,2,4
60463,1,3,211761,211762,211765,1,4,0
60464,4,3,211765,211765,211768,0,3,0
60465,4,2,211769,211769,211771,0,2,1
60466,3,3,211772,211772,211775,0,3,1
60467,2,1,211774,211775,211776,1,2,0
60468,6,1,211780,211780,211781,0,1,4
60469,4,1,211784,211784,211785,0,1,3
60470,1,3,211785,211785,211788,0,3,0
60471,1,2,211786,211788,211790,2,4,0
60472,6,2,211792,211792,211794,0,2,2
60473,3,2,211795,211795,211797,0,2,1
60474,6,3,211801,211801,211804,0,3,4
60475,4,3,211805,211805,211808,0,3,1
60476,5,3,211810,211810,211813,0,3,2
60477,2,3,211812,211813,211816,1,4,0
60478,3,3,211815,211816,211819,1,4,0
60479,2,1,211817,211819,211820,2,3,0
60480,6,3,211823,211823,211826,0,3,3
60481,2,1,211825,211826,211827,1,2,0
60482,4,1,211829,211829,211830,0,1,2
60483,3,1,211832,211832,211833,0,1,2
60484,1,1,211833,211833,211834,0,1,0
60485,4,3,211837,211837,211840,0,3,3
60486,5,3,211842,211842,211845,0,3,2
60487,3,2,211845,211845,211847,0,2,0
60488,1,1,211846,211847,211848,1,2,0
60489,4,3,211850,211850,211853,0,3,2
60490,6,3,211856,211856,211859,0,3,3
60491,3,3,211859,211859,211862,0,3,0
60492,1,1,211860,211862,211863,2,3,0
60493,6,2,211866,211866,211868,0,2,3
60494,1,1,211867,211868,211869,1,2,0
60495,4,1,211871,211871,211872,0,1,2
60496,2,1,211873,211873,211874,0,1,1
60497,4,1,211877,211877,211878,0,1,3
60498,5,3,211882,211882,211885,0,3,4
60499,4,3,211886,211886,211889,0,3,1
60500,1,1,211887,211889,211890,2,3,0
60501,3,2,211890,211890,211892,0,2,0
60502,2,3,211892,211892,211895,0,3,0
60503,6,1,211898,211898,211899,0,1,3
60504,4,3,211902,211902,211905,0,3,3
60505,1,3,211903,211905,211908,2,5,0
60506,4,3,211907,211908,211911,1,4,0
60507,1,1,211908,211911,211912,3,4,0
60508,2,2,211910,211912,211914,2,4,0
60509,4,2,211914,211914,211916,0,2,0
60510,1,2,211915,211916,211918,1,3,0
60511,3,3,211918,211918,211921,0,3,0
60512,4,1,211922,211922,211923,0,1,1
60513,1,3,211923,211923,211926,0,3,0
60514,2,2,211925,211926,211928,1,3,0
60515,3,1,211928,211928,211929,0,1,0
60516,3,3,211931,211931,211934,0,3,2
60517,2,3,211933,211934,211937,1,4,0
60518,3,3,211936,211937,211940,1,4,0
60519,4,1,211940,211940,211941,0,1,0
60520,6,3,211946,211946,211949,0,3,5
60521,3,1,211949,211949,211950,0,1,0
60522,5,3,211954,211954,211957,0,3,4
60523,6,2,211960,211960,211962,0,2,3
60524,6,3,211966,211966,211969,0,3,4
60525,2,1,211968,211969,211970,1,2,0
60526,3,1,211971,211971,211972,0,1,1
60527,4,3,211975,211975,211978,0,3,3
60528,6,3,211981,211981,211984,0,3,3
60529,5,3,211986,211986,211989,0,3,2
60530,5,2,211991,211991,211993,0,2,2
60531,4,3,211995,211995,211998,0,3,2
60532,5,3,212000,212000,212003,0,3,2
60533,5,3,212005,212005,212008,0,3,2
60534,5,3,212010,212010,212013,0,3,2
60535,2,3,212012,212013,212016,1,4,0
60536,2,3,212014,212016,212019,2,5,0
60537,5,1,212019,212019,212020,0,1,0
60538,1,1,212020,212020,212021,0,1,0
60539,3,2,212023,212023,212025,0,2,2
60540,2,2,212025,212025,212027,0,2,0
60541,3,3,212028,212028,212031,0,3,1
60542,4,3,212032,212032,212035,0,3,1
60543,2,1,212034,212035,212036,1,2,0
60544,3,2,212037,212037,212039,0,2,1
60545,2,2,212039,212039,212041,0,2,0
60546,4,3,212043,212043,212046,0,3,2
60547,1,1,212044,212046,212047,2,3,0
60548,4,1,212048,212048,212049,0,1,1
60549,3,2,212051,212051,212053,0,2,2
60550,3,2,212054,212054,212056,0,2,1
60551,3,1,212057,212057,212058,0,1,1
60552,3,3,212060,212060,212063,0,3,2
60553,3,2,212063,212063,212065,0,2,0
60554,3,3,212066,212066,212069,0,3,1
60555,1,3,212067,212069,212072,2,5,0
60556,1,1,212068,212072,212073,4,5,0
60557,2,3,212070,212073,212076,3,6,0
60558,6,1,212076,212076,212077,0,1,0
60559,2,2,212078,212078,212080,0,2,1
60560,2,2,212080,212080,212082,0,2,0
60561,1,3,212081,212082,212085,1,4,0
60562,6,3,212087,212087,212090,0,3,2
60563,1,1,212088,212090,212091,2,3,0
60564,1,1,212089,212091,212092,2,3,0
60565,2,2,212091,212092,212094,1,3,0
60566,3,2,212094,212094,212096,0,2,0
60567,4,3,212098,212098,212101,0,3,2
60568,3,2,212101,212101,212103,0,2,0
60569,3,2,212104,212104,212106,0,2,1
60570,1,1,212105,212106,212107,1,2,0
60571,6,3,212111,212111,212114,0,3,4
60572,2,3,212113,212114,212117,1,4,0
60573,1,2,212114,212117,212119,3,5,0
60574,2,2,212116,212119,212121,3,5,0
60575,3,2,212119,212121,212123,2,4,0
60576,6,2,212125,212125,212127,0,2,2
60577,4,1,212129,212129,212130,0,1,2
60578,4,1,212133,212133,212134,0,1,3
60579,3,3,212136,212136,212139,0,3,2
60580,3,1,212139,212139,212140,0,1,0
60581,4,2,212143,212143,212145,0,2,3
60582,3,1,212146,212146,212147,0,1,1
60583,2,2,212148,212148,212150,0,2,1
60584,5,3,212153,212153,212156,0,3,3
60585,3,3,212156,212156,212159,0,3,0
60586,6,3,212162,212162,212165,0,3,3
60587,5,3,212167,212167,212170,0,3,2
60588,6,2,212173,212173,212175,0,2,3
60589,3,1,212176,212176,212177,0,1,1
60590,6,1,212182,212182,212183,0,1,5
60591,5,1,212187,212187,212188,0,1,4
60592,5,1,212192,212192,212193,0,1,4
60593,4,1,212196,212196,212197,0,1,3
60594,4,3,212200,212200,212203,0,3,3
60595,6,3,212206,212206,212209,0,3,3
60596,6,1,212212,212212,212213,0,1,3
60597,6,2,212218,212218,212220,0,2,5
60598,4,1,212222,212222,212223,0,1,2
60599,4,3,212226,212226,212229,0,3,3
60600,4,3,212230,212230,212233,0,3,1
60601,3,1,212233,212233,212234,0,1,0
60602,3,2,212236,212236,212238,0,2,2
60603,1,2,212237,212238,212240,1,3,0
60604,5,3,212242,212242,212245,0,3,2
60605,4,3,212246,212246,212249,0,3,1
60606,6,1,212252,212252,212253,0,1,3
60607,2,3,212254,212254,212257,0,3,1
60608,6,1,212260,212260,212261,0,1,3
60609,2,3,212262,212262,212265,0,3,1
60610,1,3,212263,212265,212268,2,5,0
60611,6,2,212269,212269,212271,0,2,1
60612,3,1,212272,212272,212273,0,1,1
60613,5,2,212277,212277,212279,0,2,4
60614,4,2,212281,212281,212283,0,2,2
60615,6,1,212287,212287,212288,0,1,4
60616,5,3,212292,212292,212295,0,3,4
60617,2,3,212294,212295,212298,1,4,0
60618,4,3,212298,212298,212301,0,3,0
60619,3,2,212301,212301,212303,0,2,0
60620,5,2,212306,212306,212308,0,2,3
60621,1,2,212307,212308,212310,1,3,0
60622,6,3,212313,212313,212316,0,3,3
60623,1,1,212314,212316,212317,2,3,0
60624,4,3,212318,212318,212321,0,3,1
60625,5,1,212323,212323,212324,0,1,2
60626,1,2,212324,212324,212326,0,2,0
60627,5,3,212329,212329,212332,0,3,3
60628,2,3,212331,212332,212335,1,4,0
60629,2,3,212333,212335,212338,2,5,0
60630,6,1,212339,212339,212340,0,1,1
60631,4,1,212343,212343,212344,0,1,3
60632,3,1,212346,212346,212347,0,1,2
60633,6,3,212352,212352,212355,0,3,5
60634,5,2,212357,212357,212359,0,2,2
60635,4,1,212361,212361,212362,0,1,2
60636,3,1,212364,212364,212365,0,1,2
60637,5,3,212369,212369,212372,0,3,4
60638,3,3,212372,212372,212375,0,3,0
60639,5,1,212377,212377,212378,0,1,2
60640,5,2,212382,212382,212384,0,2,4
60641,2,1,212384,212384,212385,0,1,0
60642,4,3,212388,212388,212391,0,3,3
60643,5,3,212393,212393,212396,0,3,2
60644,6,2,212399,212399,212401,0,2,3
60645,3,2,212402,212402,212404,0,2,1
60646,3,2,212405,212405,212407,0,2,1
60647,5,2,212410,212410,212412,0,2,3
60648,3,3,212413,212413,212416,0,3,1
60649,4,1,212417,212417,212418,0,1,1
60650,5,2,212422,212422,212424,0,2,4
60651,1,2,212423,212424,212426,1,3,0
60652,3,3,212426,212426,212429,0,3,0
60653,1,1,212427,212429,212430,2,3,0
60654,6,1,212433,212433,212434,0,1,3
60655,2,3,212435,212435,212438,0,3,1
60656,3,1,212438,212438,212439,0,1,0
60657,3,2,212441,212441,212443,0,2,2
60658,4,1,212445,212445,212446,0,1,2
60659,1,1,212446,212446,212447,0,1,0
60660,4,3,212450,212450,212453,0,3,3
60661,2,2,212452,212453,212455,1,3,0
60662,1,2,212453,212455,212457,2,4,0
60663,2,2,212455,212457,212459,2,4,0
60664,3,1,212458,212459,212460,1,2,0
60665,3,2,212461,212461,212463,0,2,1
60666,3,3,212464,212464,212467,0,3,1
60667,6,2,212470,212470,212472,0,2,3
60668,3,3,212473,212473,212476,0,3,1
60669,6,2,212479,212479,212481,0,2,3
60670,6,3,212485,212485,212488,0,3,4
60671,5,1,212490,212490,212491,0,1,2
60672,2,3,212492,212492,212495,0,3,1
60673,1,1,212493,212495,212496,2,3,0
60674,2,1,212495,212496,212497,1,2,0
60675,2,1,212497,212497,212498,0,1,0
60676,6,1,212503,212503,212504,0,1,5
60677,5,1,212508,212508,212509,0,1,4
60678,4,1,212512,212512,212513,0,1,3
60679,5,3,212517,212517,212520,0,3,4
60680,3,1,212520,212520,212521,0,1,0
60681,6,2,212526,212526,212528,0,2,5
60682,6,2,212532,212532,212534,0,2,4
60683,2,2,212534,212534,212536,0,2,0
60684,4,1,212538,212538,212539,0,1,2
60685,3,1,212541,212541,212542,0,1,2
60686,5,3,212546,212546,212549,0,3,4
60687,4,3,212550,212550,212553,0,3,1
60688,5,3,212555,212555,212558,0,3,2
60689,5,1,212560,212560,212561,0,1,2
60690,3,2,212563,212563,212565,0,2,2
60691,5,1,212568,212568,212569,0,1,3
60692,2,2,212570,212570,212572,0,2,1
60693,6,2,212576,212576,212578,0,2,4
60694,4,3,212580,212580,212583,0,3,2
60695,6,2,212586,212586,212588,0,2,3
60696,4,3,212590,212590,212593,0,3,2
60697,5,3,212595,212595,212598,0,3,2
60698,6,1,212601,212601,212602,0,1,3
60699,1,3,212602,212602,212605,0,3,0
60700,5,1,212607,212607,212608,0,1,2
60701,6,1,212613,212613,212614,0,1,5
60702,2,1,212615,212615,212616,0,1,1
60703,5,2,212620,212620,212622,0,2,4
60704,6,3,212626,212626,212629,0,3,4
60705,1,3,212627,212629,212632,2,5,0
60706,2,3,212629,212632,212635,3,6,0
60707,6,2,212635,212635,212637,0,2,0
60708,4,2,212639,212639,212641,0,2,2
60709,6,3,212645,212645,212648,0,3,4
60710,5,2,212650,212650,212652,0,2,2
60711,6,3,212656,212656,212659,0,3,4
60712,6,3,212662,212662,212665,0,3,3
60713,4,2,212666,212666,212668,0,2,1
60714,1,1,212667,212668,212669,1,2,0
60715,3,1,212670,212670,212671,0,1,1
60716,5,3,212675,212675,212678,0,3,4
60717,5,3,212680,212680,212683,0,3,2
60718,4,2,212684,212684,212686,0,2,1
60719,3,3,212687,212687,212690,0,3,1
60720,1,3,212688,212690,212693,2,5,0
60721,1,1,212689,212693,212694,4,5,0
60722,2,1,212691,212694,212695,3,4,0
60723,3,3,212694,212695,212698,1,4,0
60724,4,1,212698,212698,212699,0,1,0
60725,2,3,212700,212700,212703,0,3,1
60726,4,1,212704,212704,212705,0,1,1
60727,6,1,212710,212710,212711,0,1,5
60728,1,3,212711,212711,212714,0,3,0
60729,5,2,212716,212716,212718,0,2,2
60730,3,3,212719,212719,212722,0,3,1
60731,1,3,212720,212722,212725,2,5,0
60732,5,3,212725,212725,212728,0,3,0
60733,4,2,212729,212729,212731,0,2,1
60734,2,1,212731,212731,212732,0,1,0
60735,6,2,212737,212737,212739,0,2,5
60736,6,2,212743,212743,212745,0,2,4
60737,1,1,212744,212745,212746,1,2,0
60738,3,1,212747,212747,212748,0,1,1
60739,6,3,212753,212753,212756,0,3,5
60740,1,3,212754,212756,212759,2,5,0
60741,4,1,212758,212759,212760,1,2,0
60742,6,2,212764,212764,212766,0,2,4
60743,1,1,212765,212766,212767,1,2,0
60744,4,3,212769,212769,212772,0,3,2
60745,3,1,212772,212772,212773,0,1,0
60746,4,1,212776,212776,212777,0,1,3
60747,3,1,212779,212779,212780,0,1,2
60748,6,3,212785,212785,212788,0,3,5
60749,5,2,212790,212790,212792,0,2,2
60750,4,3,212794,212794,212797,0,3,2
60751,4,2,212798,212798,212800,0,2,1
60752,2,3,212800,212800,212803,0,3,0
60753,2,3,212802,212803,212806,1,4,0
60754,6,2,212808,212808,212810,0,2,2
60755,5,1,212813,212813,212814,0,1,3
60756,4,3,212817,212817,212820,0,3,3
60757,5,2,212822,212822,212824,0,2,2
60758,4,1,212826,212826,212827,0,1,2
60759,3,1,212829,212829,212830,0,1,2
60760,2,3,212831,212831,212834,0,3,1
60761,3,2,212834,212834,212836,0,2,0
60762,5,2,212839,212839,212841,0,2,3
60763,3,2,212842,212842,212844,0,2,1
60764,1,3,212843,212844,212847,1,4,0
60765,5,2,212848,212848,212850,0,2,1
60766,5,2,212853,212853,212855,0,2,3
60767,1,3,212854,212855,212858,1,4,0
60768,6,1,212860,212860,212861,0,1,2
60769,2,1,212862,212862,212863,0,1,1
60770,3,2,212865,212865,212867,0,2,2
60771,6,3,212871,212871,212874,0,3,4
60772,5,1,212876,212876,212877,0,1,2
60773,5,1,212881,212881,212882,0,1,4
60774,5,1,212886,212886,212887,0,1,4
60775,3,3,212889,212889,212892,0,3,2
60776,3,1,212892,212892,212893,0,1,0
60777,3,1,212895,212895,212896,0,1,2
60778,1,3,212896,212896,212899,0,3,0
60779,5,3,212901,212901,212904,0,3,2
60780,4,3,212905,212905,212908,0,3,1
60781,6,3,212911,212911,212914,0,3,3
60782,5,1,212916,212916,212917,0,1,2
60783,6,2,212922,212922,212924,0,2,5
60784,1,2,212923,212924,212926,1,3,0
60785,1,1,212924,212926,212927,2,3,0
60786,5,2,212929,212929,212931,0,2,2
60787,6,3,212935,212935,212938,0,3,4
60788,6,3,212941,212941,212944,0,3,3
60789,2,3,212943,212944,212947,1,4,0
60790,4,3,212947,212947,212950,0,3,0
60791,2,1,212949,212950,212951,1,2,0
60792,5,1,212954,212954,212955,0,1,3
60793,4,1,212958,212958,212959,0,1,3
60794,4,3,212962,212962,212965,0,3,3
60795,3,3,212965,212965,212968,0,3,0
60796,1,1,212966,212968,212969,2,3,0
60797,3,1,212969,212969,212970,0,1,0
60798,3,2,212972,212972,212974,0,2,2
60799,1,3,212973,212974,212977,1,4,0
60800,3,3,212976,212977,212980,1,4,0
60801,3,2,212979,212980,212982,1,3,0
60802,6,1,212985,212985,212986,0,1,3
60803,2,2,212987,212987,212989,0,2,1
60804,5,1,212992,212992,212993,0,1,3
60805,3,3,212995,212995,212998,0,3,2
60806,5,1,213000,213000,213001,0,1,2
60807,2,1,213002,213002,213003,0,1,1
60808,6,2,213008,213008,213010,0,2,5
60809,2,3,213010,213010,213013,0,3,0
60810,3,3,213013,213013,213016,0,3,0
60811,6,2,213019,213019,213021,0,2,3
60812,2,3,213021,213021,213024,0,3,0
60813,2,2,213023,213024,213026,1,3,0
60814,1,3,213024,213026,213029,2,5,0
60815,2,3,213026,213029,213032,3,6,0
60816,6,2,213032,213032,213034,0,2,0
60817,6,3,213038,213038,213041,0,3,4
60818,3,2,213041,213041,213043,0,2,0
60819,6,1,213047,213047,213048,0,1,4
60820,6,3,213053,213053,213056,0,3,5
60821,5,1,213058,213058,213059,0,1,2
60822,5,2,213063,213063,213065,0,2,4
60823,1,3,213064,213065,213068,1,4,0
60824,4,3,213068,213068,213071,0,3,0
60825,6,2,213074,213074,213076,0,2,3
60826,1,3,213075,213076,213079,1,4,0
60827,6,2,213081,213081,213083,0,2,2
60828,5,2,213086,213086,213088,0,2,3
60829,1,1,213087,213088,213089,1,2,0
60830,6,3,213093,213093,213096,0,3,4
60831,1,3,213094,213096,213099,2,5,0
60832,5,2,213099,213099,213101,0,2,0
60833,2,3,213101,213101,213104,0,3,0
60834,1,3,213102,213104,213107,2,5,0
60835,6,2,213108,213108,213110,0,2,1
60836,4,1,213112,213112,213113,0,1,2
60837,6,1,213118,213118,213119,0,1,5
60838,6,2,213124,213124,213126,0,2,5
60839,2,1,213126,213126,213127,0,1,0
60840,2,1,213128,213128,213129,0,1,1
60841,4,2,213132,213132,213134,0,2,3
60842,3,3,213135,213135,213138,0,3,1
60843,3,2,213138,213138,213140,0,2,0
60844,6,3,213144,213144,213147,0,3,4
60845,3,2,213147,213147,213149,0,2,0
60846,4,3,213151,213151,213154,0,3,2
60847,6,3,213157,213157,213160,0,3,3
60848,6,3,213163,213163,213166,0,3,3
60849,1,1,213164,213166,213167,2,3,0
60850,4,2,213168,213168,213170,0,2,1
60851,5,3,213173,213173,213176,0,3,3
60852,4,3,213177,213177,213180,0,3,1
60853,4,3,213181,213181,213184,0,3,1
60854,1,2,213182,213184,213186,2,4,0
60855,1,1,213183,213186,213187,3,4,0
60856,3,1,213186,213187,213188,1,2,0
60857,1,2,213187,213188,213190,1,3,0
60858,2,1,213189,213190,213191,1,2,0
60859,5,3,213194,213194,213197,0,3,3
60860,6,3,213200,213200,213203,0,3,3
60861,5,3,213205,213205,213208,0,3,2
60862,5,3,213210,213210,213213,0,3,2
60863,6,2,213216,213216,213218,0,2,3
60864,4,3,213220,213220,213223,0,3,2
60865,3,1,213223,213223,213224,0,1,0
60866,1,2,213224,213224,213226,0,2,0
60867,4,2,213228,213228,213230,0,2,2
60868,1,1,213229,213230,213231,1,2,0
60869,6,2,213235,213235,213237,0,2,4
60870,3,3,213238,213238,213241,0,3,1
60871,6,3,213244,213244,213247,0,3,3
60872,1,2,213245,213247,213249,2,4,0
60873,3,2,213248,213249,213251,1,3,0
60874,4,1,213252,213252,213253,0,1,1
60875,5,1,213257,213257,213258,0,1,4
60876,6,2,213263,213263,213265,0,2,5
60877,4,2,213267,213267,213269,0,2,2
60878,2,2,213269,213269,213271,0,2,0
60879,1,1,213270,213271,213272,1,2,0
60880,5,2,213275,213275,213277,0,2,3
60881,6,2,213281,213281,213283,0,2,4
60882,3,3,213284,213284,213287,0,3,1
60883,3,3,213287,213287,213290,0,3,0
60884,4,2,213291,213291,213293,0,2,1
60885,3,2,213294,213294,213296,0,2,1
60886,5,2,213299,213299,213301,0,2,3
60887,1,2,213300,213301,213303,1,3,0
60888,3,3,213303,213303,213306,0,3,0
60889,2,2,213305,213306,213308,1,3,0
60890,3,3,213308,213308,213311,0,3,0
60891,3,2,213311,213311,213313,0,2,0
60892,4,1,213315,213315,213316,0,1,2
60893,3,1,213318,213318,213319,0,1,2
60894,6,1,213324,213324,213325,0,1,5
60895,3,2,213327,213327,213329,0,2,2
60896,4,1,213331,213331,213332,0,1,2
60897,6,3,213337,213337,213340,0,3,5
60898,5,2,213342,213342,213344,0,2,2
60899,4,3,213346,213346,213349,0,3,2
60900,1,2,213347,213349,213351,2,4,0
60901,1,1,213348,213351,213352,3,4,0
60902,4,3,213352,213352,213355,0,3,0
60903,6,1,213358,213358,213359,0,1,3
60904,2,2,213360,213360,213362,0,2,1
60905,3,2,213363,213363,213365,0,2,1
60906,5,3,213368,213368,213371,0,3,3
60907,6,1,213374,213374,213375,0,1,3
60908,4,2,213378,213378,213380,0,2,3
60909,4,1,213382,213382,213383,0,1,2
60910,6,1,213388,213388,213389,0,1,5
60911,1,3,213389,213389,213392,0,3,0
60912,3,3,213392,213392,213395,0,3,0
60913,2,1,213394,213395,213396,1,2,0
60914,6,2,213400,213400,213402,0,2,4
60915,2,2,213402,213402,213404,0,2,0
60916,2,1,213404,213404,213405,0,1,0
60917,6,3,213410,213410,213413,0,3,5
60918,1,2,213411,213413,213415,2,4,0
60919,4,1,213415,213415,213416,0,1,0
60920,6,2,213421,213421,213423,0,2,5
60921,4,2,213425,213425,213427,0,2,2
60922,4,2,213429,213429,213431,0,2,2
60923,2,1,213431,213431,213432,0,1,0
60924,3,1,213434,213434,213435,0,1,2
60925,3,3,213437,213437,213440,0,3,2
60926,6,1,213443,213443,213444,0,1,3
60927,5,3,213448,213448,213451,0,3,4
60928,5,3,213453,213453,213456,0,3,2
60929,1,3,213454,213456,213459,2,5,0
60930,3,3,213457,213459,213462,2,5,0
60931,3,1,213460,213462,213463,2,3,0
60932,3,3,213463,213463,213466,0,3,0
60933,6,2,213469,213469,213471,0,2,3
60934,6,2,213475,213475,213477,0,2,4
60935,6,3,213481,213481,213484,0,3,4
60936,4,1,213485,213485,213486,0,1,1
60937,1,3,213486,213486,213489,0,3,0
60938,2,3,213488,213489,213492,1,4,0
60939,1,1,213489,213492,213493,3,4,0
60940,5,2,213494,213494,213496,0,2,1
60941,5,1,213499,213499,213500,0,1,3
60942,5,2,213504,213504,213506,0,2,4
60943,6,2,213510,213510,213512,0,2,4
60944,2,3,213512,213512,213515,0,3,0
60945,3,1,213515,213515,213516,0,1,0
60946,5,1,213520,213520,213521,0,1,4
60947,5,2,213525,213525,213527,0,2,4
60948,1,2,213526,213527,213529,1,3,0
60949,2,2,213528,213529,213531,1,3,0
60950,1,1,213529,213531,213532,2,3,0
60951,6,2,213535,213535,213537,0,2,3
60952,6,2,213541,213541,213543,0,2,4
60953,2,2,213543,213543,213545,0,2,0
60954,6,3,213549,213549,213552,0,3,4
60955,5,3,213554,213554,213557,0,3,2
60956,6,3,213560,213560,213563,0,3,3
60957,4,1,213564,213564,213565,0,1,1
60958,4,2,213568,213568,213570,0,2,3
60959,2,1,213570,213570,213571,0,1,0
60960,2,2,213572,213572,213574,0,2,1
60961,3,2,213575,213575,213577,0,2,1
60962,2,1,213577,213577,213578,0,1,0
60963,6,3,213583,213583,213586,0,3,5
60964,4,3,213587,213587,213590,0,3,1
60965,1,3,213588,213590,213593,2,5,0
60966,3,1,213591,213593,213594,2,3,0
60967,4,1,213595,213595,213596,0,1,1
60968,4,2,213599,213599,213601,0,2,3
60969,6,2,213605,213605,213607,0,2,4
60970,5,3,213610,213610,213613,0,3,3
60971,2,3,213612,213613,213616,1,4,0
60972,6,1,213618,213618,213619,0,1,2
60973,1,1,213619,213619,213620,0,1,0
60974,6,1,213625,213625,213626,0,1,5
60975,5,1,213630,213630,213631,0,1,4
60976,2,3,213632,213632,213635,0,3,1
60977,3,3,213635,213635,213638,0,3,0
60978,1,2,213636,213638,213640,2,4,0
60979,5,3,213641,213641,213644,0,3,1
60980,6,1,213647,213647,213648,0,1,3
60981,2,1,213649,213649,213650,0,1,1
60982,2,2,213651,213651,213653,0,2,1
60983,5,2,213656,213656,213658,0,2,3
60984,2,2,213658,213658,213660,0,2,0
60985,2,2,213660,213660,213662,0,2,0
60986,5,2,213665,213665,213667,0,2,3
60987,6,1,213671,213671,213672,0,1,4
60988,4,2,213675,213675,213677,0,2,3
60989,5,2,213680,213680,213682,0,2,3
60990,4,2,213684,213684,213686,0,2,2
60991,2,2,213686,213686,213688,0,2,0
60992,4,3,213690,213690,213693,0,3,2
60993,3,2,213693,213693,213695,0,2,0
60994,4,1,213697,213697,213698,0,1,2
60995,2,1,213699,213699,213700,0,1,1
60996,3,1,213702,213702,213703,0,1,2
60997,5,1,213707,213707,213708,0,1,4
60998,1,2,213708,213708,213710,0,2,0
60999,1,3,213709,213710,213713,1,4,0
61000,4,2,213713,213713,213715,0,2,0
61001,4,3,213717,213717,213720,0,3,2
61002,1,2,213718,213720,213722,2,4,0
61003,1,2,213719,213722,213724,3,5,0
61004,5,3,213724,213724,213727,0,3,0
61005,2,2,213726,213727,213729,1,3,0
61006,2,2,213728,213729,213731,1,3,0
61007,2,2,213730,213731,213733,1,3,0
61008,6,2,213736,213736,213738,0,2,3
61009,3,2,213739,213739,213741,0,2,1
61010,6,1,213745,213745,213746,0,1,4
61011,2,3,213747,213747,213750,0,3,1
61012,4,2,213751,213751,213753,0,2,1
61013,2,3,213753,213753,213756,0,3,0
61014,3,3,213756,213756,213759,0,3,0
61015,1,1,213757,213759,213760,2,3,0
61016,5,1,213762,213762,213763,0,1,2
61017,5,1,213767,213767,213768,0,1,4
61018,5,1,213772,213772,213773,0,1,4
61019,4,1,213776,213776,213777,0,1,3
61020,3,1,213779,213779,213780,0,1,2
61021,6,2,213785,213785,213787,0,2,5
61022,3,1,213788,213788,213789,0,1,1
61023,2,2,213790,213790,213792,0,2,1
61024,4,1,213794,213794,213795,0,1,2
61025,5,3,213799,213799,213802,0,3,4
61026,2,1,213801,213802,213803,1,2,0
61027,1,1,213802,213803,213804,1,2,0
61028,3,2,213805,213805,213807,0,2,1
61029,2,3,213807,213807,213810,0,3,0
61030,2,1,213809,213810,213811,1,2,0
61031,5,3,213814,213814,213817,0,3,3
61032,2,3,213816,213817,213820,1,4,0
61033,4,3,213820,213820,213823,0,3,0
61034,5,3,213825,213825,213828,0,3,2
61035,3,1,213828,213828,213829,0,1,0
61036,6,3,213834,213834,213837,0,3,5
61037,4,2,213838,213838,213840,0,2,1
61038,1,3,213839,213840,213843,1,4,0
61039,4,1,213843,213843,213844,0,1,0
61040,1,3,213844,213844,213847,0,3,0
61041,1,1,213845,213847,213848,2,3,0
61042,5,1,213850,213850,213851,0,1,2
61043,2,3,213852,213852,213855,0,3,1
61044,1,2,213853,213855,213857,2,4,0
61045,4,2,213857,213857,213859,0,2,0
61046,6,2,213863,213863,213865,0,2,4
61047,3,1,213866,213866,213867,0,1,1
61048,1,2,213867,213867,213869,0,2,0
61049,4,1,213871,213871,213872,0,1,2
61050,1,1,213872,213872,213873,0,1,0
61051,6,3,213878,213878,213881,0,3,5
61052,1,3,213879,213881,213884,2,5,0
61053,4,2,213883,213884,213886,1,3,0
61054,5,3,213888,213888,213891,0,3,2
61055,2,3,213890,213891,213894,1,4,0
61056,6,2,213896,213896,213898,0,2,2
61057,5,1,213901,213901,213902,0,1,3
61058,4,2,213905,213905,213907,0,2,3
61059,2,2,213907,213907,213909,0,2,0
61060,3,1,213910,213910,213911,0,1,1
61061,2,2,213912,213912,213914,0,2,1
61062,5,3,213917,213917,213920,0,3,3
61063,3,3,213920,213920,213923,0,3,0
61064,3,1,213923,213923,213924,0,1,0
61065,5,1,213928,213928,213929,0,1,4
61066,4,1,213932,213932,213933,0,1,3
61067,4,3,213936,213936,213939,0,3,3
61068,4,3,213940,213940,213943,0,3,1
61069,5,1,213945,213945,213946,0,1,2
61070,2,1,213947,213947,213948,0,1,1
61071,2,3,213949,213949,213952,0,3,1
61072,5,2,213954,213954,213956,0,2,2
61073,2,3,213956,213956,213959,0,3,0
61074,6,2,213962,213962,213964,0,2,3
61075,4,3,213966,213966,213969,0,3,2
61076,1,2,213967,213969,213971,2,4,0
61077,5,3,213972,213972,213975,0,3,1
61078,4,1,213976,213976,213977,0,1,1
61079,3,3,213979,213979,213982,0,3,2
61080,5,1,213984,213984,213985,0,1,2
61081,1,1,213985,213985,213986,0,1,0
61082,1,2,213986,213986,213988,0,2,0
61083,4,1,213990,213990,213991,0,1,2
61084,4,2,213994,213994,213996,0,2,3
61085,6,3,214000,214000,214003,0,3,4
61086,4,3,214004,214004,214007,0,3,1
61087,6,1,214010,214010,214011,0,1,3
61088,3,3,214013,214013,214016,0,3,2
61089,6,1,214019,214019,214020,0,1,3
61090,5,3,214024,214024,214027,0,3,4
61091,3,2,214027,214027,214029,0,2,0
61092,4,1,214031,214031,214032,0,1,2
61093,2,1,214033,214033,214034,0,1,1
61094,5,2,214038,214038,214040,0,2,4
61095,5,3,214043,214043,214046,0,3,3
61096,4,3,214047,214047,214050,0,3,1
61097,3,1,214050,214050,214051,0,1,0
61098,6,3,214056,214056,214059,0,3,5
61099,1,2,214057,214059,214061,2,4,0
61100,4,2,214061,214061,214063,0,2,0
61101,6,1,214067,214067,214068,0,1,4
61102,5,1,214072,214072,214073,0,1,4
61103,4,2,214076,214076,214078,0,2,3
61104,6,3,214082,214082,214085,0,3,4
61105,5,1,214087,214087,214088,0,1,2
61106,3,3,214090,214090,214093,0,3,2
61107,4,2,214094,214094,214096,0,2,1
61108,2,1,214096,214096,214097,0,1,0
61109,5,1,214101,214101,214102,0,1,4
61110,4,3,214105,214105,214108,0,3,3
61111,5,2,214110,214110,214112,0,2,2
61112,3,1,214113,214113,214114,0,1,1
61113,4,2,214117,214117,214119,0,2,3
61114,3,3,214120,214120,214123,0,3,1
61115,4,2,214124,214124,214126,0,2,1
61116,4,3,214128,214128,214131,0,3,2
61117,1,3,214129,214131,214134,2,5,0
61118,4,1,214133,214134,214135,1,2,0
61119,4,1,214137,214137,214138,0,1,2
61120,4,3,214141,214141,214144,0,3,3
61121,4,3,214145,214145,214148,0,3,1
61122,1,3,214146,214148,214151,2,5,0
61123,4,3,214150,214151,214154,1,4,0
61124,2,2,214152,214154,214156,2,4,0
61125,3,1,214155,214156,214157,1,2,0
61126,6,3,214161,214161,214164,0,3,4
61127,2,1,214163,214164,214165,1,2,0
61128,2,2,214165,214165,214167,0,2,0
61129,3,2,214168,214168,214170,0,2,1
61130,6,1,214174,214174,214175,0,1,4
61131,3,2,214177,214177,214179,0,2,2
61132,5,2,214182,214182,214184,0,2,3
61133,3,1,214185,214185,214186,0,1,1
61134,1,1,214186,214186,214187,0,1,0
61135,3,3,214189,214189,214192,0,3,2
61136,2,1,214191,214192,214193,1,2,0
61137,1,3,214192,214193,214196,1,4,0
61138,5,1,214197,214197,214198,0,1,1
61139,6,3,214203,214203,214206,0,3,5
61140,5,1,214208,214208,214209,0,1,2
61141,6,2,214214,214214,214216,0,2,5
61142,4,1,214218,214218,214219,0,1,2
61143,5,1,214223,214223,214224,0,1,4
61144,6,2,214229,214229,214231,0,2,5
61145,3,3,214232,214232,214235,0,3,1
61146,4,2,214236,214236,214238,0,2,1
61147,2,3,214238,214238,214241,0,3,0
61148,3,3,214241,214241,214244,0,3,0
61149,6,1,214247,214247,214248,0,1,3
61150,1,3,214248,214248,214251,0,3,0
61151,2,3,214250,214251,214254,1,4,0
61152,4,1,214254,214254,214255,0,1,0
61153,3,2,214257,214257,214259,0,2,2
61154,6,3,214263,214263,214266,0,3,4
61155,6,3,214269,214269,214272,0,3,3
61156,6,3,214275,214275,214278,0,3,3
61157,5,2,214280,214280,214282,0,2,2
61158,5,1,214285,214285,214286,0,1,3
61159,2,3,214287,214287,214290,0,3,1
61160,4,1,214291,214291,214292,0,1,1
61161,2,1,214293,214293,214294,0,1,1
61162,2,1,214295,214295,214296,0,1,1
61163,4,2,214299,214299,214301,0,2,3
61164,3,2,214302,214302,214304,0,2,1
61165,3,1,214305,214305,214306,0,1,1
61166,5,2,214310,214310,214312,0,2,4
61167,5,3,214315,214315,214318,0,3,3
61168,2,1,214317,214318,214319,1,2,0
61169,3,1,214320,214320,214321,0,1,1
61170,6,2,214326,214326,214328,0,2,5
61171,4,1,214330,214330,214331,0,1,2
61172,2,2,214332,214332,214334,0,2,1
61173,6,1,214338,214338,214339,0,1,4
61174,5,3,214343,214343,214346,0,3,4
61175,1,3,214344,214346,214349,2,5,0
61176,2,1,214346,214349,214350,3,4,0
61177,4,1,214350,214350,214351,0,1,0
61178,5,2,214355,214355,214357,0,2,4
61179,5,3,214360,214360,214363,0,3,3
61180,5,2,214365,214365,214367,0,2,2
61181,3,2,214368,214368,214370,0,2,1
61182,5,1,214373,214373,214374,0,1,3
61183,3,3,214376,214376,214379,0,3,2
61184,2,3,214378,214379,214382,1,4,0
61185,2,3,214380,214382,214385,2,5,0
61186,1,3,214381,214385,214388,4,7,0
61187,1,3,214382,214388,214391,6,9,0
61188,5,1,214387,214391,214392,4,5,0
61189,1,1,214388,214392,214393,4,5,0
61190,3,2,214391,214393,214395,2,4,0
61191,5,1,214396,214396,214397,0,1,1
61192,2,3,214398,214398,214401,0,3,1
61193,3,2,214401,214401,214403,0,2,0
61194,3,3,214404,214404,214407,0,3,1
61195,6,1,214410,214410,214411,0,1,3
61196,6,3,214416,214416,214419,0,3,5
61197,2,3,214418,214419,214422,1,4,0
61198,6,3,214424,214424,214427,0,3,2
61199,1,1,214425,214427,214428,2,3,0
61200,3,1,214428,214428,214429,0,1,0
61201,4,3,214432,214432,214435,0,3,3
61202,3,2,214435,214435,214437,0,2,0
61203,6,1,214441,214441,214442,0,1,4
61204,4,2,214445,214445,214447,0,2,3
61205,3,3,214448,214448,214451,0,3,1
61206,3,3,214451,214451,214454,0,3,0
61207,2,2,214453,214454,214456,1,3,0
61208,4,3,214457,214457,214460,0,3,1
61209,2,1,214459,214460,214461,1,2,0
61210,4,2,214463,214463,214465,0,2,2
61211,3,3,214466,214466,214469,0,3,1
61212,1,3,214467,214469,214472,2,5,0
61213,1,1,214468,214472,214473,4,5,0
61214,1,3,214469,214473,214476,4,7,0
61215,3,2,214472,214476,214478,4,6,0
61216,4,2,214476,214478,214480,2,4,0
61217,2,3,214478,214480,214483,2,5,0
61218,5,3,214483,214483,214486,0,3,0
61219,4,2,214487,214487,214489,0,2,1
61220,4,1,214491,214491,214492,0,1,2
61221,2,2,214493,214493,214495,0,2,1
61222,1,2,214494,214495,214497,1,3,0
61223,5,1,214499,214499,214500,0,1,2
61224,4,3,214503,214503,214506,0,3,3
61225,1,1,214504,214506,214507,2,3,0
61226,2,3,214506,214507,214510,1,4,0
61227,6,3,214512,214512,214515,0,3,2
61228,1,1,214513,214515,214516,2,3,0
61229,4,1,214517,214517,214518,0,1,1
61230,1,2,214518,214518,214520,0,2,0
61231,5,2,214523,214523,214525,0,2,3
61232,3,1,214526,214526,214527,0,1,1
61233,2,3,214528,214528,214531,0,3,1
61234,1,1,214529,214531,214532,2,3,0
61235,3,1,214532,214532,214533,0,1,0
61236,6,1,214538,214538,214539,0,1,5
61237,1,1,214539,214539,214540,0,1,0
61238,6,3,214545,214545,214548,0,3,5
61239,6,1,214551,214551,214552,0,1,3
61240,5,2,214556,214556,214558,0,2,4
61241,6,2,214562,214562,214564,0,2,4
61242,5,1,214567,214567,214568,0,1,3
61243,4,1,214571,214571,214572,0,1,3
61244,4,3,214575,214575,214578,0,3,3
61245,4,1,214579,214579,214580,0,1,1
61246,5,2,214584,214584,214586,0,2,4
61247,5,3,214589,214589,214592,0,3,3
61248,5,3,214594,214594,214597,0,3,2
61249,2,3,214596,214597,214600,1,4,0
61250,6,1,214602,214602,214603,0,1,2
61251,5,1,214607,214607,214608,0,1,4
61252,2,1,214609,214609,214610,0,1,1
61253,1,2,214610,214610,214612,0,2,0
61254,3,2,214613,214613,214615,0,2,1
61255,3,2,214616,214616,214618,0,2,1
61256,4,2,214620,214620,214622,0,2,2
61257,1,2,214621,214622,214624,1,3,0
61258,3,3,214624,214624,214627,0,3,0
61259,2,3,214626,214627,214630,1,4,0
61260,5,2,214631,214631,214633,0,2,1
61261,6,3,214637,214637,214640,0,3,4
61262,6,3,214643,214643,214646,0,3,3
61263,5,1,214648,214648,214649,0,1,2
61264,4,3,214652,214652,214655,0,3,3
61265,5,2,214657,214657,214659,0,2,2
61266,5,2,214662,214662,214664,0,2,3
61267,4,1,214666,214666,214667,0,1,2
61268,1,1,214667,214667,214668,0,1,0
61269,6,2,214673,214673,214675,0,2,5
61270,5,2,214678,214678,214680,0,2,3
61271,2,1,214680,214680,214681,0,1,0
61272,1,2,214681,214681,214683,0,2,0
61273,3,1,214684,214684,214685,0,1,1
61274,1,1,214685,214685,214686,0,1,0
61275,1,2,214686,214686,214688,0,2,0
61276,3,3,214689,214689,214692,0,3,1
61277,1,1,214690,214692,214693,2,3,0
61278,3,3,214693,214693,214696,0,3,0
61279,3,3,214696,214696,214699,0,3,0
61280,5,3,214701,214701,214704,0,3,2
61281,3,3,214704,214704,214707,0,3,0
61282,5,1,214709,214709,214710,0,1,2
61283,5,2,214714,214714,214716,0,2,4
61284,1,3,214715,214716,214719,1,4,0
61285,3,1,214718,214719,214720,1,2,0
61286,1,3,214719,214720,214723,1,4,0
61287,5,2,214724,214724,214726,0,2,1
61288,5,1,214729,214729,214730,0,1,3
61289,3,3,214732,214732,214735,0,3,2
61290,5,1,214737,214737,214738,0,1,2
61291,1,2,214738,214738,214740,0,2,0
61292,1,3,214739,214740,214743,1,4,0
61293,3,3,214742,214743,214746,1,4,0
61294,2,2,214744,214746,214748,2,4,0
61295,1,3,214745,214748,214751,3,6,0
61296,3,2,214748,214751,214753,3,5,0
61297,1,3,214749,214753,214756,4,7,0
61298,2,1,214751,214756,214757,5,6,0
61299,2,2,214753,214757,214759,4,6,0
61300,5,2,214758,214759,214761,1,3,0
61301,3,1,214761,214761,214762,0,1,0
61302,5,1,214766,214766,214767,0,1,4
61303,5,2,214771,214771,214773,0,2,4
61304,1,3,214772,214773,214776,1,4,0
61305,2,2,214774,214776,214778,2,4,0
61306,1,2,214775,214778,214780,3,5,0
61307,1,2,214776,214780,214782,4,6,0
61308,2,1,214778,214782,214783,4,5,0
61309,4,3,214782,214783,214786,1,4,0
61310,5,1,214787,214787,214788,0,1,1
61311,4,2,214791,214791,214793,0,2,3
61312,5,1,214796,214796,214797,0,1,3
61313,2,1,214798,214798,214799,0,1,1
61314,5,3,214803,214803,214806,0,3,4
61315,2,1,214805,214806,214807,1,2,0
61316,1,2,214806,214807,214809,1,3,0
61317,3,3,214809,214809,214812,0,3,0
61318,3,3,214812,214812,214815,0,3,0
61319,5,2,214817,214817,214819,0,2,2
61320,3,3,214820,214820,214823,0,3,1
61321,6,3,214826,214826,214829,0,3,3
61322,5,1,214831,214831,214832,0,1,2
61323,3,3,214834,214834,214837,0,3,2
61324,6,2,214840,214840,214842,0,2,3
61325,6,3,214846,214846,214849,0,3,4
61326,3,3,214849,214849,214852,0,3,0
61327,4,1,214853,214853,214854,0,1,1
61328,4,2,214857,214857,214859,0,2,3
61329,4,1,214861,214861,214862,0,1,2
61330,4,3,214865,214865,214868,0,3,3
61331,4,1,214869,214869,214870,0,1,1
61332,5,2,214874,214874,214876,0,2,4
61333,3,1,214877,214877,214878,0,1,1
61334,3,2,214880,214880,214882,0,2,2
61335,5,1,214885,214885,214886,0,1,3
61336,5,3,214890,214890,214893,0,3,4
61337,4,2,214894,214894,214896,0,2,1
61338,5,3,214899,214899,214902,0,3,3
61339,2,1,214901,214902,214903,1,2,0
61340,4,3,214905,214905,214908,0,3,2
61341,4,1,214909,214909,214910,0,1,1
61342,5,2,214914,214914,214916,0,2,4
61343,6,3,214920,214920,214923,0,3,4
61344,6,2,214926,214926,214928,0,2,3
61345,6,1,214932,214932,214933,0,1,4
61346,4,3,214936,214936,214939,0,3,3
61347,1,1,214937,214939,214940,2,3,0
61348,2,3,214939,214940,214943,1,4,0
61349,4,2,214943,214943,214945,0,2,0
61350,6,1,214949,214949,214950,0,1,4
61351,3,3,214952,214952,214955,0,3,2
61352,4,2,214956,214956,214958,0,2,1
61353,6,1,214962,214962,214963,0,1,4
61354,1,1,214963,214963,214964,0,1,0
61355,3,3,214966,214966,214969,0,3,2
61356,1,1,214967,214969,214970,2,3,0
61357,1,2,214968,214970,214972,2,4,0
61358,3,2,214971,214972,214974,1,3,0
61359,6,2,214977,214977,214979,0,2,3
61360,6,3,214983,214983,214986,0,3,4
61361,6,2,214989,214989,214991,0,2,3
61362,3,2,214992,214992,214994,0,2,1
61363,3,3,214995,214995,214998,0,3,1
61364,2,2,214997,214998,215000,1,3,0
61365,5,1,215002,215002,215003,0,1,2
61366,3,1,215005,215005,215006,0,1,2
61367,3,1,215008,215008,215009,0,1,2
61368,6,2,215014,215014,215016,0,2,5
61369,4,1,215018,215018,215019,0,1,2
61370,4,2,215022,215022,215024,0,2,3
61371,4,1,215026,215026,215027,0,1,2
61372,5,3,215031,215031,215034,0,3,4
61373,6,1,215037,215037,215038,0,1,3
61374,6,3,215043,215043,215046,0,3,5
61375,5,3,215048,215048,215051,0,3,2
61376,3,2,215051,215051,215053,0,2,0
61377,4,1,215055,215055,215056,0,1,2
61378,6,3,215061,215061,215064,0,3,5
61379,5,3,215066,215066,215069,0,3,2
61380,1,1,215067,215069,215070,2,3,0
61381,3,3,215070,215070,215073,0,3,0
61382,5,1,215075,215075,215076,0,1,2
61383,2,3,215077,215077,215080,0,3,1
61384,2,2,215079,215080,215082,1,3,0
61385,2,1,215081,215082,215083,1,2,0
61386,6,3,215087,215087,215090,0,3,4
61387,6,3,215093,215093,215096,0,3,3
61388,2,3,215095,215096,215099,1,4,0
61389,5,2,215100,215100,215102,0,2,1
61390,5,2,215105,215105,215107,0,2,3
61391,5,2,215110,215110,215112,0,2,3
61392,4,3,215114,215114,215117,0,3,2
61393,3,1,215117,215117,215118,0,1,0
61394,4,2,215121,215121,215123,0,2,3
61395,6,2,215127,215127,215129,0,2,4
61396,6,1,215133,215133,215134,0,1,4
61397,2,3,215135,215135,215138,0,3,1
61398,4,3,215139,215139,215142,0,3,1
61399,1,3,215140,215142,215145,2,5,0
61400,2,3,215142,215145,215148,3,6,0
61401,5,1,215147,215148,215149,1,2,0
61402,4,2,215151,215151,215153,0,2,2
61403,1,3,215152,215153,215156,1,4,0
61404,3,1,215155,215156,215157,1,2,0
61405,2,3,215157,215157,215160,0,3,0
61406,2,3,215159,215160,215163,1,4,0
61407,5,3,215164,215164,215167,0,3,1
61408,6,1,215170,215170,215171,0,1,3
61409,3,3,215173,215173,215176,0,3,2
61410,1,2,215174,215176,215178,2,4,0
61411,5,3,215179,215179,215182,0,3,1
61412,3,1,215182,215182,215183,0,1,0
61413,3,2,215185,215185,215187,0,2,2
61414,2,1,215187,215187,215188,0,1,0
61415,4,2,215191,215191,215193,0,2,3
61416,2,2,215193,215193,215195,0,2,0
61417,2,3,215195,215195,215198,0,3,0
61418,1,1,215196,215198,215199,2,3,0
61419,5,1,215201,215201,215202,0,1,2
61420,5,1,215206,215206,215207,0,1,4
61421,3,2,215209,215209,215211,0,2,2
61422,1,1,215210,215211,215212,1,2,0
61423,6,1,215216,215216,215217,0,1,4
61424,6,3,215222,215222,215225,0,3,5
61425,4,2,215226,215226,215228,0,2,1
61426,2,3,215228,215228,215231,0,3,0
61427,6,1,215234,215234,215235,0,1,3
61428,5,2,215239,215239,215241,0,2,4
61429,3,2,215242,215242,215244,0,2,1
61430,4,2,215246,215246,215248,0,2,2
61431,3,2,215249,215249,215251,0,2,1
61432,3,2,215252,215252,215254,0,2,1
61433,5,3,215257,215257,215260,0,3,3
61434,2,3,215259,215260,215263,1,4,0
61435,3,2,215262,215263,215265,1,3,0
61436,2,2,215264,215265,215267,1,3,0
61437,2,2,215266,215267,215269,1,3,0
61438,6,1,215272,215272,215273,0,1,3
61439,2,2,215274,215274,215276,0,2,1
61440,3,1,215277,215277,215278,0,1,1
61441,4,1,215281,215281,215282,0,1,3
61442,5,1,215286,215286,215287,0,1,4
61443,4,2,215290,215290,215292,0,2,3
61444,4,3,215294,215294,215297,0,3,2
61445,3,2,215297,215297,215299,0,2,0
61446,3,3,215300,215300,215303,0,3,1
61447,5,1,215305,215305,215306,0,1,2
61448,4,2,215309,215309,215311,0,2,3
61449,5,3,215314,215314,215317,0,3,3
61450,6,1,215320,215320,215321,0,1,3
61451,1,1,215321,215321,215322,0,1,0
61452,1,1,215322,215322,215323,0,1,0
61453,1,3,215323,215323,215326,0,3,0
61454,3,2,215326,215326,215328,0,2,0
61455,1,1,215327,215328,215329,1,2,0
61456,4,2,215331,215331,215333,0,2,2
61457,4,1,215335,215335,215336,0,1,2
61458,2,1,215337,215337,215338,0,1,1
61459,2,1,215339,215339,215340,0,1,1
61460,6,1,215345,215345,215346,0,1,5
61461,3,1,215348,215348,215349,0,1,2
61462,3,3,215351,215351,215354,0,3,2
61463,2,3,215353,215354,215357,1,4,0
61464,5,2,215358,215358,215360,0,2,1
61465,3,3,215361,215361,215364,0,3,1
61466,5,1,215366,215366,215367,0,1,2
61467,5,2,215371,215371,215373,0,2,4
61468,6,2,215377,215377,215379,0,2,4
61469,4,3,215381,215381,215384,0,3,2
61470,2,2,215383,215384,215386,1,3,0
61471,2,2,215385,215386,215388,1,3,0
61472,5,1,215390,215390,215391,0,1,2
61473,4,3,215394,215394,215397,0,3,3
61474,3,1,215397,215397,215398,0,1,0
61475,1,1,215398,215398,215399,0,1,0
61476,6,1,215404,215404,215405,0,1,5
61477,3,3,215407,215407,215410,0,3,2
61478,2,2,215409,215410,215412,1,3,0
61479,4,1,215413,215413,215414,0,1,1
61480,2,1,215415,215415,215416,0,1,1
61481,2,3,215417,215417,215420,0,3,1
61482,5,2,215422,215422,215424,0,2,2
61483,6,1,215428,215428,215429,0,1,4
61484,3,3,215431,215431,215434,0,3,2
61485,4,3,215435,215435,215438,0,3,1
61486,3,1,215438,215438,215439,0,1,0
61487,3,1,215441,215441,215442,0,1,2
61488,4,1,215445,215445,215446,0,1,3
61489,5,1,215450,215450,215451,0,1,4
61490,4,2,215454,215454,215456,0,2,3
61491,2,3,215456,215456,215459,0,3,0
61492,3,3,215459,215459,215462,0,3,0
61493,1,3,215460,215462,215465,2,5,0
61494,3,3,215463,215465,215468,2,5,0
61495,4,1,215467,215468,215469,1,2,0
61496,5,1,215472,215472,215473,0,1,3
61497,5,1,215477,215477,215478,0,1,4
61498,5,2,215482,215482,215484,0,2,4
61499,2,3,215484,215484,215487,0,3,0
61500,3,3,215487,215487,215490,0,3,0
61501,5,2,215492,215492,215494,0,2,2
61502,2,2,215494,215494,215496,0,2,0
61503,4,2,215498,215498,215500,0,2,2
61504,1,1,215499,215500,215501,1,2,0
61505,6,3,215505,215505,215508,0,3,4
61506,2,2,215507,215508,215510,1,3,0
61507,5,3,215512,215512,215515,0,3,2
61508,3,1,215515,215515,215516,0,1,0
61509,4,1,215519,215519,215520,0,1,3
61510,1,1,215520,215520,215521,0,1,0
61511,2,3,215522,215522,215525,0,3,1
61512,2,2,215524,215525,215527,1,3,0
61513,4,2,215528,215528,215530,0,2,1
61514,5,1,215533,215533,215534,0,1,3
61515,3,3,215536,215536,215539,0,3,2
61516,2,3,215538,215539,215542,1,4,0
61517,5,2,215543,215543,215545,0,2,1
61518,5,1,215548,215548,215549,0,1,3
61519,1,2,215549,215549,215551,0,2,0
61520,1,2,215550,215551,215553,1,3,0
61521,5,3,215555,215555,215558,0,3,2
61522,6,2,215561,215561,215563,0,2,3
61523,3,1,215564,215564,215565,0,1,1
61524,4,3,215568,215568,215571,0,3,3
61525,1,1,215569,215571,215572,2,3,0
61526,4,1,215573,215573,215574,0,1,1
61527,5,3,215578,215578,215581,0,3,4
61528,1,2,215579,215581,215583,2,4,0
61529,5,2,215584,215584,215586,0,2,1
61530,1,2,215585,215586,215588,1,3,0
61531,3,1,215588,215588,215589,0,1,0
61532,6,2,215594,215594,215596,0,2,5
61533,3,2,215597,215597,215599,0,2,1
61534,2,2,215599,215599,215601,0,2,0
61535,6,3,215605,215605,215608,0,3,4
61536,1,3,215606,215608,215611,2,5,0
61537,4,1,215610,215611,215612,1,2,0
61538,2,3,215612,215612,215615,0,3,0
61539,2,2,215614,215615,215617,1,3,0
61540,4,3,215618,215618,215621,0,3,1
61541,2,2,215620,215621,215623,1,3,0
61542,4,3,215624,215624,215627,0,3,1
61543,2,3,215626,215627,215630,1,4,0
61544,5,1,215631,215631,215632,0,1,1
61545,4,3,215635,215635,215638,0,3,3
61546,5,1,215640,215640,215641,0,1,2
61547,3,1,215643,215643,215644,0,1,2
61548,2,2,215645,215645,215647,0,2,1
61549,5,2,215650,215650,215652,0,2,3
61550,3,3,215653,215653,215656,0,3,1
61551,6,1,215659,215659,215660,0,1,3
61552,2,1,215661,215661,215662,0,1,1
61553,5,2,215666,215666,215668,0,2,4
61554,6,1,215672,215672,215673,0,1,4
61555,3,1,215675,215675,215676,0,1,2
61556,5,1,215680,215680,215681,0,1,4
61557,2,3,215682,215682,215685,0,3,1
61558,2,1,215684,215685,215686,1,2,0
61559,6,1,215690,215690,215691,0,1,4
61560,4,1,215694,215694,215695,0,1,3
61561,3,2,215697,215697,215699,0,2,2
61562,6,2,215703,215703,215705,0,2,4
61563,3,2,215706,215706,215708,0,2,1
61564,6,2,215712,215712,215714,0,2,4
61565,2,1,215714,215714,215715,0,1,0
61566,2,3,215716,215716,215719,0,3,1
61567,6,2,215722,215722,215724,0,2,3
61568,4,1,215726,215726,215727,0,1,2
61569,4,2,215730,215730,215732,0,2,3
61570,5,1,215735,215735,215736,0,1,3
61571,2,1,215737,215737,215738,0,1,1
61572,5,2,215742,215742,215744,0,2,4
61573,4,1,215746,215746,215747,0,1,2
61574,5,1,215751,215751,215752,0,1,4
61575,1,3,215752,215752,215755,0,3,0
61576,6,3,215758,215758,215761,0,3,3
61577,6,3,215764,215764,215767,0,3,3
61578,4,2,215768,215768,215770,0,2,1
61579,6,1,215774,215774,215775,0,1,4
61580,4,3,215778,215778,215781,0,3,3
61581,3,1,215781,215781,215782,0,1,0
61582,3,2,215784,215784,215786,0,2,2
61583,5,1,215789,215789,215790,0,1,3
61584,6,2,215795,215795,215797,0,2,5
61585,2,2,215797,215797,215799,0,2,0
61586,3,3,215800,215800,215803,0,3,1
61587,1,1,215801,215803,215804,2,3,0
61588,5,1,215806,215806,215807,0,1,2
61589,2,3,215808,215808,215811,0,3,1
61590,3,3,215811,215811,215814,0,3,0
61591,2,1,215813,215814,215815,1,2,0
61592,6,1,215819,215819,215820,0,1,4
61593,3,3,215822,215822,215825,0,3,2
61594,3,3,215825,215825,215828,0,3,0
61595,4,1,215829,215829,215830,0,1,1
61596,6,2,215835,215835,215837,0,2,5
61597,3,2,215838,215838,215840,0,2,1
61598,2,2,215840,215840,215842,0,2,0
61599,1,1,215841,215842,215843,1,2,0
61600,2,2,215843,215843,215845,0,2,0
61601,1,1,215844,215845,215846,1,2,0
61602,4,3,215848,215848,215851,0,3,2
61603,2,3,215850,215851,215854,1,4,0
61604,5,2,215855,215855,215857,0,2,1
61605,4,1,215859,215859,215860,0,1,2
61606,2,1,215861,215861,215862,0,1,1
61607,4,1,215865,215865,215866,0,1,3
61608,3,3,215868,215868,215871,0,3,2
61609,4,1,215872,215872,215873,0,1,1
61610,3,1,215875,215875,215876,0,1,2
61611,1,3,215876,215876,215879,0,3,0
61612,2,3,215878,215879,215882,1,4,0
61613,4,3,215882,215882,215885,0,3,0
61614,2,1,215884,215885,215886,1,2,0
61615,6,2,215890,215890,215892,0,2,4
61616,4,3,215894,215894,215897,0,3,2
61617,6,3,215900,215900,215903,0,3,3
61618,2,1,215902,215903,215904,1,2,0
61619,2,3,215904,215904,215907,0,3,0
61620,1,3,215905,215907,215910,2,5,0
61621,6,1,215911,215911,215912,0,1,1
61622,4,2,215915,215915,215917,0,2,3
61623,3,2,215918,215918,215920,0,2,1
61624,6,1,215924,215924,215925,0,1,4
61625,1,2,215925,215925,215927,0,2,0
61626,1,1,215926,215927,215928,1,2,0
61627,3,2,215929,215929,215931,0,2,1
61628,2,3,215931,215931,215934,0,3,0
61629,4,1,215935,215935,215936,0,1,1
61630,4,2,215939,215939,215941,0,2,3
61631,6,2,215945,215945,215947,0,2,4
61632,5,1,215950,215950,215951,0,1,3
61633,1,2,215951,215951,215953,0,2,0
61634,2,2,215953,215953,215955,0,2,0
61635,4,3,215957,215957,215960,0,3,2
61636,4,3,215961,215961,215964,0,3,1
61637,4,2,215965,215965,215967,0,2,1
61638,1,2,215966,215967,215969,1,3,0
61639,2,3,215968,215969,215972,1,4,0
61640,3,2,215971,215972,215974,1,3,0
61641,1,2,215972,215974,215976,2,4,0
61642,2,1,215974,215976,215977,2,3,0
61643,1,3,215975,215977,215980,2,5,0
61644,2,3,215977,215980,215983,3,6,0
61645,6,1,215983,215983,215984,0,1,0
61646,5,3,215988,215988,215991,0,3,4
61647,2,1,215990,215991,215992,1,2,0
61648,6,1,215996,215996,215997,0,1,4
61649,2,1,215998,215998,215999,0,1,1
61650,2,2,216000,216000,216002,0,2,1
61651,2,3,216002,216002,216005,0,3,0
61652,3,1,216005,216005,216006,0,1,0
61653,1,2,216006,216006,216008,0,2,0
61654,3,2,216009,216009,216011,0,2,1
61655,4,1,216013,216013,216014,0,1,2
61656,1,2,216014,216014,216016,0,2,0
61657,6,2,216020,216020,216022,0,2,4
61658,5,2,216025,216025,216027,0,2,3
61659,6,3,216031,216031,216034,0,3,4
61660,3,1,216034,216034,216035,0,1,0
61661,2,2,216036,216036,216038,0,2,1
61662,5,1,216041,216041,216042,0,1,3
61663,1,3,216042,216042,216045,0,3,0
61664,3,3,216045,216045,216048,0,3,0
61665,6,2,216051,216051,216053,0,2,3
61666,3,1,216054,216054,216055,0,1,1
61667,6,1,216060,216060,216061,0,1,5
61668,4,3,216064,216064,216067,0,3,3
61669,3,1,216067,216067,216068,0,1,0
61670,4,1,216071,216071,216072,0,1,3
61671,2,3,216073,216073,216076,0,3,1
61672,6,2,216079,216079,216081,0,2,3
61673,3,3,216082,216082,216085,0,3,1
61674,5,1,216087,216087,216088,0,1,2
61675,3,3,216090,216090,216093,0,3,2
61676,1,2,216091,216093,216095,2,4,0
61677,4,3,216095,216095,216098,0,3,0
61678,5,2,216100,216100,216102,0,2,2
61679,2,3,216102,216102,216105,0,3,0
61680,2,3,216104,216105,216108,1,4,0
61681,2,1,216106,216108,216109,2,3,0
61682,1,1,216107,216109,216110,2,3,0
61683,1,1,216108,216110,216111,2,3,0
61684,3,3,216111,216111,216114,0,3,0
61685,5,2,216116,216116,216118,0,2,2
61686,2,2,216118,216118,216120,0,2,0
61687,3,1,216121,216121,216122,0,1,1
61688,4,1,216125,216125,216126,0,1,3
61689,6,2,216131,216131,216133,0,2,5
61690,3,2,216134,216134,216136,0,2,1
61691,5,2,216139,216139,216141,0,2,3
61692,1,3,216140,216141,216144,1,4,0
61693,6,3,216146,216146,216149,0,3,2
61694,4,1,216150,216150,216151,0,1,1
61695,5,2,216155,216155,216157,0,2,4
61696,4,1,216159,216159,216160,0,1,2
61697,1,1,216160,216160,216161,0,1,0
61698,1,2,216161,216161,216163,0,2,0
61699,6,1,216167,216167,216168,0,1,4
61700,3,2,216170,216170,216172,0,2,2
61701,2,2,216172,216172,216174,0,2,0
61702,6,3,216178,216178,216181,0,3,4
61703,4,2,216182,216182,216184,0,2,1
61704,5,2,216187,216187,216189,0,2,3
61705,1,1,216188,216189,216190,1,2,0
61706,5,3,216193,216193,216196,0,3,3
61707,2,3,216195,216196,216199,1,4,0
61708,1,3,216196,216199,216202,3,6,0
61709,3,3,216199,216202,216205,3,6,0
61710,5,1,216204,216205,216206,1,2,0
61711,6,1,216210,216210,216211,0,1,4
61712,1,2,216211,216211,216213,0,2,0
61713,2,3,216213,216213,216216,0,3,0
61714,4,1,216217,216217,216218,0,1,1
61715,4,3,216221,216221,216224,0,3,3
61716,4,3,216225,216225,216228,0,3,1
61717,2,2,216227,216228,216230,1,3,0
61718,2,1,216229,216230,216231,1,2,0
61719,6,2,216235,216235,216237,0,2,4
61720,1,2,216236,216237,216239,1,3,0
61721,6,1,216242,216242,216243,0,1,3
61722,6,3,216248,216248,216251,0,3,5
61723,6,3,216254,216254,216257,0,3,3
61724,6,2,216260,216260,216262,0,2,3
61725,4,2,216264,216264,216266,0,2,2
61726,3,1,216267,216267,216268,0,1,1
61727,5,1,216272,216272,216273,0,1,4
61728,4,1,216276,216276,216277,0,1,3
61729,2,1,216278,216278,216279,0,1,1
61730,1,2,216279,216279,216281,0,2,0
61731,6,1,216285,216285,216286,0,1,4
61732,4,3,216289,216289,216292,0,3,3
61733,6,3,216295,216295,216298,0,3,3
61734,5,1,216300,216300,216301,0,1,2
61735,1,3,216301,216301,216304,0,3,0
61736,6,3,216307,216307,216310,0,3,3
61737,5,1,216312,216312,216313,0,1,2
61738,2,2,216314,216314,216316,0,2,1
61739,5,3,216319,216319,216322,0,3,3
61740,4,1,216323,216323,216324,0,1,1
61741,3,3,216326,216326,216329,0,3,2
61742,4,1,216330,216330,216331,0,1,1
61743,3,3,216333,216333,216336,0,3,2
61744,6,3,216339,216339,216342,0,3,3
61745,3,1,216342,216342,216343,0,1,0
61746,4,2,216346,216346,216348,0,2,3
61747,3,1,216349,216349,216350,0,1,1
61748,2,2,216351,216351,216353,0,2,1
61749,2,1,216353,216353,216354,0,1,0
61750,3,3,216356,216356,216359,0,3,2
61751,5,3,216361,216361,216364,0,3,2
61752,2,2,216363,216364,216366,1,3,0
61753,3,2,216366,216366,216368,0,2,0
61754,6,3,216372,216372,216375,0,3,4
61755,2,2,216374,216375,216377,1,3,0
61756,1,1,216375,216377,216378,2,3,0
61757,5,3,216380,216380,216383,0,3,2
61758,5,2,216385,216385,216387,0,2,2
61759,5,3,216390,216390,216393,0,3,3
61760,1,2,216391,216393,216395,2,4,0
61761,4,2,216395,216395,216397,0,2,0
61762,3,3,216398,216398,216401,0,3,1
61763,1,2,216399,216401,216403,2,4,0
61764,3,2,216402,216403,216405,1,3,0
61765,3,2,216405,216405,216407,0,2,0
61766,2,3,216407,216407,216410,0,3,0
61767,5,1,216412,216412,216413,0,1,2
61768,5,3,216417,216417,216420,0,3,4
61769,4,2,216421,216421,216423,0,2,1
61770,1,2,216422,216423,216425,1,3,0
61771,6,2,216428,216428,216430,0,2,3
61772,5,3,216433,216433,216436,0,3,3
61773,4,1,216437,216437,216438,0,1,1
61774,5,2,216442,216442,216444,0,2,4
61775,1,1,216443,216444,216445,1,2,0
61776,2,3,216445,216445,216448,0,3,0
61777,3,3,216448,216448,216451,0,3,0
61778,3,2,216451,216451,216453,0,2,0
61779,4,3,216455,216455,216458,0,3,2
61780,1,2,216456,216458,216460,2,4,0
61781,2,1,216458,216460,216461,2,3,0
61782,1,1,216459,216461,216462,2,3,0
61783,4,1,216463,216463,216464,0,1,1
61784,5,2,216468,216468,216470,0,2,4
61785,1,1,216469,216470,216471,1,2,0
61786,2,3,216471,216471,216474,0,3,0
61787,5,2,216476,216476,216478,0,2,2
61788,1,2,216477,216478,216480,1,3,0
61789,2,2,216479,216480,216482,1,3,0
61790,6,3,216485,216485,216488,0,3,3
61791,4,1,216489,216489,216490,0,1,1
61792,6,1,216495,216495,216496,0,1,5
61793,2,3,216497,216497,216500,0,3,1
61794,1,1,216498,216500,216501,2,3,0
61795,3,2,216501,216501,216503,0,2,0
61796,6,1,216507,216507,216508,0,1,4
61797,6,1,216513,216513,216514,0,1,5
61798,4,2,216517,216517,216519,0,2,3
61799,2,1,216519,216519,216520,0,1,0
61800,3,1,216522,216522,216523,0,1,2
61801,1,3,216523,216523,216526,0,3,0
61802,3,1,216526,216526,216527,0,1,0
61803,3,3,216529,216529,216532,0,3,2
61804,3,2,216532,216532,216534,0,2,0
61805,4,1,216536,216536,216537,0,1,2
61806,5,2,216541,216541,216543,0,2,4
61807,6,2,216547,216547,216549,0,2,4
61808,3,3,216550,216550,216553,0,3,1
61809,6,3,216556,216556,216559,0,3,3
61810,2,2,216558,216559,216561,1,3,0
61811,4,2,216562,216562,216564,0,2,1
61812,2,3,216564,216564,216567,0,3,0
61813,3,2,216567,216567,216569,0,2,0
61814,1,3,216568,216569,216572,1,4,0
61815,3,2,216571,216572,216574,1,3,0
61816,5,3,216576,216576,216579,0,3,2
61817,6,3,216582,216582,216585,0,3,3
61818,5,3,216587,216587,216590,0,3,2
61819,1,3,216588,216590,216593,2,5,0
61820,6,2,216594,216594,216596,0,2,1
61821,2,1,216596,216596,216597,0,1,0
61822,2,2,216598,216598,216600,0,2,1
61823,6,3,216604,216604,216607,0,3,4
61824,2,1,216606,216607,216608,1,2,0
61825,6,2,216612,216612,216614,0,2,4
61826,6,1,216618,216618,216619,0,1,4
61827,3,3,216621,216621,216624,0,3,2
61828,1,3,216622,216624,216627,2,5,0
61829,3,2,216625,216627,216629,2,4,0
61830,6,1,216631,216631,216632,0,1,2
61831,2,2,216633,216633,216635,0,2,1
61832,2,3,216635,216635,216638,0,3,0
61833,5,1,216640,216640,216641,0,1,2
61834,3,3,216643,216643,216646,0,3,2
61835,1,2,216644,216646,216648,2,4,0
61836,1,1,216645,216648,216649,3,4,0
61837,6,3,216651,216651,216654,0,3,2
61838,3,2,216654,216654,216656,0,2,0
61839,5,2,216659,216659,216661,0,2,3
61840,6,3,216665,216665,216668,0,3,4
61841,6,1,216671,216671,216672,0,1,3
61842,4,2,216675,216675,216677,0,2,3
61843,1,1,216676,216677,216678,1,2,0
61844,3,2,216679,216679,216681,0,2,1
61845,1,1,216680,216681,216682,1,2,0
61846,5,3,216685,216685,216688,0,3,3
61847,3,1,216688,216688,216689,0,1,0
61848,2,2,216690,216690,216692,0,2,1
61849,3,3,216693,216693,216696,0,3,1
61850,6,3,216699,216699,216702,0,3,3
61851,2,1,216701,216702,216703,1,2,0
61852,4,2,216705,216705,216707,0,2,2
61853,1,3,216706,216707,216710,1,4,0
61854,4,3,216710,216710,216713,0,3,0
61855,1,2,216711,216713,216715,2,4,0
61856,1,3,216712,216715,216718,3,6,0
61857,3,2,216715,216718,216720,3,5,0
61858,3,2,216718,216720,216722,2,4,0
61859,3,1,216721,216722,216723,1,2,0
61860,6,1,216727,216727,216728,0,1,4
61861,1,2,216728,216728,216730,0,2,0
61862,1,3,216729,216730,216733,1,4,0
61863,2,3,216731,216733,216736,2,5,0
61864,3,3,216734,216736,216739,2,5,0
61865,5,2,216739,216739,216741,0,2,0
61866,2,3,216741,216741,216744,0,3,0
61867,5,2,216746,216746,216748,0,2,2
61868,5,1,216751,216751,216752,0,1,3
61869,5,2,216756,216756,216758,0,2,4
61870,3,3,216759,216759,216762,0,3,1
61871,6,1,216765,216765,216766,0,1,3
61872,6,2,216771,216771,216773,0,2,5
61873,1,2,216772,216773,216775,1,3,0
61874,5,3,216777,216777,216780,0,3,2
61875,2,1,216779,216780,216781,1,2,0
61876,3,2,216782,216782,216784,0,2,1
61877,3,1,216785,216785,216786,0,1,1
61878,5,1,216790,216790,216791,0,1,4
61879,5,1,216795,216795,216796,0,1,4
61880,1,3,216796,216796,216799,0,3,0
61881,3,1,216799,216799,216800,0,1,0
61882,3,3,216802,216802,216805,0,3,2
61883,6,2,216808,216808,216810,0,2,3
61884,2,3,216810,216810,216813,0,3,0
61885,2,2,216812,216813,216815,1,3,0
61886,2,1,216814,216815,216816,1,2,0
61887,6,2,216820,216820,216822,0,2,4
61888,1,3,216821,216822,216825,1,4,0
61889,2,3,216823,216825,216828,2,5,0
61890,5,3,216828,216828,216831,0,3,0
61891,1,2,216829,216831,216833,2,4,0
61892,1,1,216830,216833,216834,3,4,0
61893,3,1,216833,216834,216835,1,2,0
61894,5,2,216838,216838,216840,0,2,3
61895,1,2,216839,216840,216842,1,3,0
61896,1,3,216840,216842,216845,2,5,0
61897,5,3,216845,216845,216848,0,3,0
61898,5,1,216850,216850,216851,0,1,2
61899,1,3,216851,216851,216854,0,3,0
61900,4,2,216855,216855,216857,0,2,1
61901,3,1,216858,216858,216859,0,1,1
61902,2,2,216860,216860,216862,0,2,1
61903,1,1,216861,216862,216863,1,2,0
61904,3,3,216864,216864,216867,0,3,1
61905,1,1,216865,216867,216868,2,3,0
61906,1,3,216866,216868,216871,2,5,0
61907,6,2,216872,216872,216874,0,2,1
61908,4,1,216876,216876,216877,0,1,2
61909,3,3,216879,216879,216882,0,3,2
61910,2,3,216881,216882,216885,1,4,0
61911,4,1,216885,216885,216886,0,1,0
61912,2,2,216887,216887,216889,0,2,1
61913,3,2,216890,216890,216892,0,2,1
61914,2,2,216892,216892,216894,0,2,0
61915,3,3,216895,216895,216898,0,3,1
61916,1,1,216896,216898,216899,2,3,0
61917,3,2,216899,216899,216901,0,2,0
61918,3,1,216902,216902,216903,0,1,1
61919,5,1,216907,216907,216908,0,1,4
61920,5,3,216912,216912,216915,0,3,4
61921,2,2,216914,216915,216917,1,3,0
61922,2,2,216916,216917,216919,1,3,0
61923,4,3,216920,216920,216923,0,3,1
61924,5,2,216925,216925,216927,0,2,2
61925,5,2,216930,216930,216932,0,2,3
61926,3,3,216933,216933,216936,0,3,1
61927,1,2,216934,216936,216938,2,4,0
61928,5,1,216939,216939,216940,0,1,1
61929,3,1,216942,216942,216943,0,1,2
61930,5,2,216947,216947,216949,0,2,4
61931,3,1,216950,216950,216951,0,1,1
61932,1,2,216951,216951,216953,0,2,0
61933,5,2,216956,216956,216958,0,2,3
61934,6,2,216962,216962,216964,0,2,4
61935,4,2,216966,216966,216968,0,2,2
61936,2,1,216968,216968,216969,0,1,0
61937,3,2,216971,216971,216973,0,2,2
61938,4,2,216975,216975,216977,0,2,2
61939,6,3,216981,216981,216984,0,3,4
61940,5,2,216986,216986,216988,0,2,2
61941,2,2,216988,216988,216990,0,2,0
61942,6,3,216994,216994,216997,0,3,4
61943,4,2,216998,216998,217000,0,2,1
61944,2,2,217000,217000,217002,0,2,0
61945,1,3,217001,217002,217005,1,4,0
61946,3,2,217004,217005,217007,1,3,0
61947,2,1,217006,217007,217008,1,2,0
61948,1,1,217007,217008,217009,1,2,0
61949,2,1,217009,217009,217010,0,1,0
61950,3,2,217012,217012,217014,0,2,2
61951,2,2,217014,217014,217016,0,2,0
61952,1,1,217015,217016,217017,1,2,0
61953,5,2,217020,217020,217022,0,2,3
61954,5,2,217025,217025,217027,0,2,3
61955,2,1,217027,217027,217028,0,1,0
61956,5,3,217032,217032,217035,0,3,4
61957,5,3,217037,217037,217040,0,3,2
61958,3,3,217040,217040,217043,0,3,0
61959,4,1,217044,217044,217045,0,1,1
61960,6,2,217050,217050,217052,0,2,5
61961,2,3,217052,217052,217055,0,3,0
61962,6,1,217058,217058,217059,0,1,3
61963,4,1,217062,217062,217063,0,1,3
61964,1,2,217063,217063,217065,0,2,0
61965,6,1,217069,217069,217070,0,1,4
61966,3,3,217072,217072,217075,0,3,2
61967,1,1,217073,217075,217076,2,3,0
61968,1,1,217074,217076,217077,2,3,0
61969,3,3,217077,217077,217080,0,3,0
61970,2,2,217079,217080,217082,1,3,0
61971,3,3,217082,217082,217085,0,3,0
61972,5,2,217087,217087,217089,0,2,2
61973,4,2,217091,217091,217093,0,2,2
61974,5,2,217096,217096,217098,0,2,3
61975,1,3,217097,217098,217101,1,4,0
61976,1,2,217098,217101,217103,3,5,0
61977,6,3,217104,217104,217107,0,3,1
61978,2,1,217106,217107,217108,1,2,0
61979,1,1,217107,217108,217109,1,2,0
61980,2,2,217109,217109,217111,0,2,0
61981,4,3,217113,217113,217116,0,3,2
61982,4,2,217117,217117,217119,0,2,1
61983,4,3,217121,217121,217124,0,3,2
61984,6,3,217127,217127,217130,0,3,3
61985,2,2,217129,217130,217132,1,3,0
61986,2,3,217131,217132,217135,1,4,0
61987,6,2,217137,217137,217139,0,2,2
61988,5,2,217142,217142,217144,0,2,3
61989,3,1,217145,217145,217146,0,1,1
61990,6,3,217151,217151,217154,0,3,5
61991,1,2,217152,217154,217156,2,4,0
61992,3,1,217155,217156,217157,1,2,0
61993,6,3,217161,217161,217164,0,3,4
61994,2,2,217163,217164,217166,1,3,0
61995,3,2,217166,217166,217168,0,2,0
61996,1,1,217167,217168,217169,1,2,0
61997,4,2,217171,217171,217173,0,2,2
61998,4,3,217175,217175,217178,0,3,2
61999,1,2,217176,217178,217180,2,4,0
62000,5,3,217181,217181,217184,0,3,1
62001,1,3,217182,217184,217187,2,5,0
62002,1,3,217183,217187,217190,4,7,0
62003,4,3,217187,217190,217193,3,6,0
62004,3,2,217190,217193,217195,3,5,0
62005,4,2,217194,217195,217197,1,3,0
62006,2,1,217196,217197,217198,1,2,0
62007,6,1,217202,217202,217203,0,1,4
62008,3,1,217205,217205,217206,0,1,2
62009,2,2,217207,217207,217209,0,2,1
62010,2,1,217209,217209,217210,0,1,0
62011,3,2,217212,217212,217214,0,2,2
62012,3,1,217215,217215,217216,0,1,1
62013,6,3,217221,217221,217224,0,3,5
62014,1,1,217222,217224,217225,2,3,0
62015,5,3,217227,217227,217230,0,3,2
62016,5,1,217232,217232,217233,0,1,2
62017,6,1,217238,217238,217239,0,1,5
62018,5,1,217243,217243,217244,0,1,4
62019,1,2,217244,217244,217246,0,2,0
62020,2,1,217246,217246,217247,0,1,0
62021,1,1,217247,217247,217248,0,1,0
62022,6,2,217253,217253,217255,0,2,5
62023,3,3,217256,217256,217259,0,3,1
62024,2,2,217258,217259,217261,1,3,0
62025,3,2,217261,217261,217263,0,2,0
62026,1,3,217262,217263,217266,1,4,0
62027,5,2,217267,217267,217269,0,2,1
62028,1,3,217268,217269,217272,1,4,0
62029,5,2,217273,217273,217275,0,2,1
62030,6,1,217279,217279,217280,0,1,4
62031,2,1,217281,217281,217282,0,1,1
62032,4,3,217285,217285,217288,0,3,3
62033,5,1,217290,217290,217291,0,1,2
62034,2,2,217292,217292,217294,0,2,1
62035,2,3,217294,217294,217297,0,3,0
62036,2,2,217296,217297,217299,1,3,0
62037,3,3,217299,217299,217302,0,3,0
62038,2,1,217301,217302,217303,1,2,0
62039,2,3,217303,217303,217306,0,3,0
62040,1,3,217304,217306,217309,2,5,0
62041,2,2,217306,217309,217311,3,5,0
62042,1,1,217307,217311,217312,4,5,0
62043,3,2,217310,217312,217314,2,4,0
62044,2,1,217312,217314,217315,2,3,0
62045,1,3,217313,217315,217318,2,5,0
62046,2,2,217315,217318,217320,3,5,0
62047,3,3,217318,217320,217323,2,5,0
62048,4,3,217322,217323,217326,1,4,0
62049,6,2,217328,217328,217330,0,2,2
62050,4,1,217332,217332,217333,0,1,2
62051,4,1,217336,217336,217337,0,1,3
62052,5,2,217341,217341,217343,0,2,4
62053,4,1,217345,217345,217346,0,1,2
62054,3,1,217348,217348,217349,0,1,2
62055,2,3,217350,217350,217353,0,3,1
62056,4,1,217354,217354,217355,0,1,1
62057,5,1,217359,217359,217360,0,1,4
62058,4,1,217363,217363,217364,0,1,3
62059,5,2,217368,217368,217370,0,2,4
62060,1,2,217369,217370,217372,1,3,0
62061,2,2,217371,217372,217374,1,3,0
62062,4,2,217375,217375,217377,0,2,1
62063,2,1,217377,217377,217378,0,1,0
62064,5,2,217382,217382,217384,0,2,4
62065,4,2,217386,217386,217388,0,2,2
62066,5,2,217391,217391,217393,0,2,3
62067,3,3,217394,217394,217397,0,3,1
62068,1,1,217395,217397,217398,2,3,0
62069,5,3,217400,217400,217403,0,3,2
62070,1,3,217401,217403,217406,2,5,0
62071,3,2,217404,217406,217408,2,4,0
62072,6,1,217410,217410,217411,0,1,2
62073,3,2,217413,217413,217415,0,2,2
62074,6,2,217419,217419,217421,0,2,4
62075,4,1,217423,217423,217424,0,1,2
62076,6,1,217429,217429,217430,0,1,5
62077,4,1,217433,217433,217434,0,1,3
62078,6,1,217439,217439,217440,0,1,5
62079,1,3,217440,217440,217443,0,3,0
62080,5,3,217445,217445,217448,0,3,2
62081,2,2,217447,217448,217450,1,3,0
62082,1,2,217448,217450,217452,2,4,0
62083,3,3,217451,217452,217455,1,4,0
62084,2,1,217453,217455,217456,2,3,0
62085,6,3,217459,217459,217462,0,3,3
62086,6,2,217465,217465,217467,0,2,3
62087,1,3,217466,217467,217470,1,4,0
62088,5,2,217471,217471,217473,0,2,1
62089,6,2,217477,217477,217479,0,2,4
62090,4,3,217481,217481,217484,0,3,2
62091,6,1,217487,217487,217488,0,1,3
62092,6,3,217493,217493,217496,0,3,5
62093,5,1,217498,217498,217499,0,1,2
62094,4,1,217502,217502,217503,0,1,3
62095,6,1,217508,217508,217509,0,1,5
62096,5,3,217513,217513,217516,0,3,4
62097,5,3,217518,217518,217521,0,3,2
62098,2,3,217520,217521,217524,1,4,0
62099,4,1,217524,217524,217525,0,1,0
62100,2,2,217526,217526,217528,0,2,1
62101,3,1,217529,217529,217530,0,1,1
62102,2,1,217531,217531,217532,0,1,1
62103,3,3,217534,217534,217537,0,3,2
62104,3,3,217537,217537,217540,0,3,0
62105,2,2,217539,217540,217542,1,3,0
62106,2,3,217541,217542,217545,1,4,0
62107,3,3,217544,217545,217548,1,4,0
62108,3,2,217547,217548,217550,1,3,0
62109,2,2,217549,217550,217552,1,3,0
62110,2,2,217551,217552,217554,1,3,0
62111,5,2,217556,217556,217558,0,2,2
62112,2,2,217558,217558,217560,0,2,0
62113,1,2,217559,217560,217562,1,3,0
62114,6,2,217565,217565,217567,0,2,3
62115,4,2,217569,217569,217571,0,2,2
62116,6,2,217575,217575,217577,0,2,4
62117,3,2,217578,217578,217580,0,2,1
62118,6,1,217584,217584,217585,0,1,4
62119,6,2,217590,217590,217592,0,2,5
62120,3,1,217593,217593,217594,0,1,1
62121,1,3,217594,217594,217597,0,3,0
62122,2,2,217596,217597,217599,1,3,0
62123,4,1,217600,217600,217601,0,1,1
62124,6,1,217606,217606,217607,0,1,5
62125,5,2,217611,217611,217613,0,2,4
62126,6,1,217617,217617,217618,0,1,4
62127,4,1,217621,217621,217622,0,1,3
62128,4,2,217625,217625,217627,0,2,3
62129,2,2,217627,217627,217629,0,2,0
62130,4,2,217631,217631,217633,0,2,2
62131,5,2,217636,217636,217638,0,2,3
62132,6,3,217642,217642,217645,0,3,4
62133,1,1,217643,217645,217646,2,3,0
62134,2,2,217645,217646,217648,1,3,0
62135,3,2,217648,217648,217650,0,2,0
62136,4,2,217652,217652,217654,0,2,2
62137,3,2,217655,217655,217657,0,2,1
62138,3,1,217658,217658,217659,0,1,1
62139,3,2,217661,217661,217663,0,2,2
62140,5,1,217666,217666,217667,0,1,3
62141,6,1,217672,217672,217673,0,1,5
62142,4,2,217676,217676,217678,0,2,3
62143,1,1,217677,217678,217679,1,2,0
62144,2,2,217679,217679,217681,0,2,0
62145,6,3,217685,217685,217688,0,3,4
62146,3,3,217688,217688,217691,0,3,0
62147,5,1,217693,217693,217694,0,1,2
62148,4,2,217697,217697,217699,0,2,3
62149,5,3,217702,217702,217705,0,3,3
62150,1,3,217703,217705,217708,2,5,0
62151,2,2,217705,217708,217710,3,5,0
62152,1,3,217706,217710,217713,4,7,0
62153,6,3,217712,217713,217716,1,4,0
62154,2,3,217714,217716,217719,2,5,0
62155,6,2,217720,217720,217722,0,2,1
62156,1,1,217721,217722,217723,1,2,0
62157,4,3,217725,217725,217728,0,3,2
62158,2,1,217727,217728,217729,1,2,0
62159,2,1,217729,217729,217730,0,1,0
62160,4,1,217733,217733,217734,0,1,3
62161,5,3,217738,217738,217741,0,3,4
62162,2,1,217740,217741,217742,1,2,0
62163,3,3,217743,217743,217746,0,3,1
62164,6,1,217749,217749,217750,0,1,3
62165,5,2,217754,217754,217756,0,2,4
62166,3,2,217757,217757,217759,0,2,1
62167,5,1,217762,217762,217763,0,1,3
62168,4,1,217766,217766,217767,0,1,3
62169,2,1,217768,217768,217769,0,1,1
62170,2,2,217770,217770,217772,0,2,1
62171,6,2,217776,217776,217778,0,2,4
62172,2,3,217778,217778,217781,0,3,0
62173,4,1,217782,217782,217783,0,1,1
62174,2,2,217784,217784,217786,0,2,1
62175,5,3,217789,217789,217792,0,3,3
62176,1,1,217790,217792,217793,2,3,0
62177,2,3,217792,217793,217796,1,4,0
62178,5,2,217797,217797,217799,0,2,1
62179,4,1,217801,217801,217802,0,1,2
62180,2,3,217803,217803,217806,0,3,1
62181,5,2,217808,217808,217810,0,2,2
62182,1,2,217809,217810,217812,1,3,0
62183,6,3,217815,217815,217818,0,3,3
62184,4,2,217819,217819,217821,0,2,1
62185,6,1,217825,217825,217826,0,1,4
62186,3,1,217828,217828,217829,0,1,2
62187,6,2,217834,217834,217836,0,2,5
62188,6,2,217840,217840,217842,0,2,4
62189,6,2,217846,217846,217848,0,2,4
62190,5,3,217851,217851,217854,0,3,3
62191,2,2,217853,217854,217856,1,3,0
62192,3,1,217856,217856,217857,0,1,0
62193,5,2,217861,217861,217863,0,2,4
62194,5,1,217866,217866,217867,0,1,3
62195,2,1,217868,217868,217869,0,1,1
62196,3,3,217871,217871,217874,0,3,2
62197,3,3,217874,217874,217877,0,3,0
62198,6,2,217880,217880,217882,0,2,3
62199,6,3,217886,217886,217889,0,3,4
62200,1,2,217887,217889,217891,2,4,0
62201,1,1,217888,217891,217892,3,4,0
62202,3,2,217891,217892,217894,1,3,0
62203,5,1,217896,217896,217897,0,1,2
62204,1,1,217897,217897,217898,0,1,0
62205,5,1,217902,217902,217903,0,1,4
62206,5,1,217907,217907,217908,0,1,4
62207,5,2,217912,217912,217914,0,2,4
62208,1,3,217913,217914,217917,1,4,0
62209,6,1,217919,217919,217920,0,1,2
62210,2,3,217921,217921,217924,0,3,1
62211,6,1,217927,217927,217928,0,1,3
62212,2,1,217929,217929,217930,0,1,1
62213,6,1,217935,217935,217936,0,1,5
62214,5,1,217940,217940,217941,0,1,4
62215,6,1,217946,217946,217947,0,1,5
62216,2,3,217948,217948,217951,0,3,1
62217,1,2,217949,217951,217953,2,4,0
62218,1,3,217950,217953,217956,3,6,0
62219,1,1,217951,217956,217957,5,6,0
62220,4,1,217955,217957,217958,2,3,0
62221,4,1,217959,217959,217960,0,1,1
62222,4,2,217963,217963,217965,0,2,3
62223,3,1,217966,217966,217967,0,1,1
62224,3,1,217969,217969,217970,0,1,2
62225,3,2,217972,217972,217974,0,2,2
62226,3,1,217975,217975,217976,0,1,1
62227,5,1,217980,217980,217981,0,1,4
62228,6,1,217986,217986,217987,0,1,5
62229,4,3,217990,217990,217993,0,3,3
62230,5,1,217995,217995,217996,0,1,2
62231,5,3,218000,218000,218003,0,3,4
62232,5,1,218005,218005,218006,0,1,2
62233,5,1,218010,218010,218011,0,1,4
62234,2,2,218012,218012,218014,0,2,1
62235,5,3,218017,218017,218020,0,3,3
62236,6,3,218023,218023,218026,0,3,3
62237,1,3,218024,218026,218029,2,5,0
62238,3,2,218027,218029,218031,2,4,0
62239,4,3,218031,218031,218034,0,3,0
62240,1,3,218032,218034,218037,2,5,0
62241,1,3,218033,218037,218040,4,7,0
62242,5,2,218038,218040,218042,2,4,0
62243,1,2,218039,218042,218044,3,5,0
62244,5,3,218044,218044,218047,0,3,0
62245,2,2,218046,218047,218049,1,3,0
62246,1,2,218047,218049,218051,2,4,0
62247,2,2,218049,218051,218053,2,4,0
62248,5,1,218054,218054,218055,0,1,1
62249,6,3,218060,218060,218063,0,3,5
62250,6,3,218066,218066,218069,0,3,3
62251,4,1,218070,218070,218071,0,1,1
62252,1,2,218071,218071,218073,0,2,0
62253,1,1,218072,218073,218074,1,2,0
62254,5,1,218077,218077,218078,0,1,3
62255,2,3,218079,218079,218082,0,3,1
62256,6,3,218085,218085,218088,0,3,3
62257,3,1,218088,218088,218089,0,1,0
62258,5,3,218093,218093,218096,0,3,4
62259,3,1,218096,218096,218097,0,1,0
62260,1,2,218097,218097,218099,0,2,0
62261,5,3,218102,218102,218105,0,3,3
62262,1,2,218103,218105,218107,2,4,0
62263,2,1,218105,218107,218108,2,3,0
62264,2,3,218107,218108,218111,1,4,0
62265,6,1,218113,218113,218114,0,1,2
62266,5,3,218118,218118,218121,0,3,4
62267,3,2,218121,218121,218123,0,2,0
62268,2,3,218123,218123,218126,0,3,0
62269,4,1,218127,218127,218128,0,1,1
62270,2,3,218129,218129,218132,0,3,1
62271,3,3,218132,218132,218135,0,3,0
62272,3,2,218135,218135,218137,0,2,0
62273,2,3,218137,218137,218140,0,3,0
62274,2,2,218139,218140,218142,1,3,0
62275,3,1,218142,218142,218143,0,1,0
62276,2,2,218144,218144,218146,0,2,1
62277,4,2,218148,218148,218150,0,2,2
62278,6,2,218154,218154,218156,0,2,4
62279,6,2,218160,218160,218162,0,2,4
62280,1,2,218161,218162,218164,1,3,0
62281,5,3,218166,218166,218169,0,3,2
62282,1,1,218167,218169,218170,2,3,0
62283,5,2,218172,218172,218174,0,2,2
62284,3,1,218175,218175,218176,0,1,1
62285,2,2,218177,218177,218179,0,2,1
62286,5,1,218182,218182,218183,0,1,3
62287,3,1,218185,218185,218186,0,1,2
62288,3,2,218188,218188,218190,0,2,2
62289,4,3,218192,218192,218195,0,3,2
62290,4,3,218196,218196,218199,0,3,1
62291,1,2,218197,218199,218201,2,4,0
62292,4,3,218201,218201,218204,0,3,0
62293,5,1,218206,218206,218207,0,1,2
62294,3,1,218209,218209,218210,0,1,2
62295,3,3,218212,218212,218215,0,3,2
62296,6,2,218218,218218,218220,0,2,3
62297,6,2,218224,218224,218226,0,2,4
62298,3,1,218227,218227,218228,0,1,1
62299,6,3,218233,218233,218236,0,3,5
62300,2,2,218235,218236,218238,1,3,0
62301,3,2,218238,218238,218240,0,2,0
62302,3,3,218241,218241,218244,0,3,1
62303,5,1,218246,218246,218247,0,1,2
62304,4,1,218250,218250,218251,0,1,3
62305,4,3,218254,218254,218257,0,3,3
62306,1,3,218255,218257,218260,2,5,0
62307,5,2,218260,218260,218262,0,2,0
62308,6,2,218266,218266,218268,0,2,4
62309,3,1,218269,218269,218270,0,1,1
62310,3,3,218272,218272,218275,0,3,2
62311,3,2,218275,218275,218277,0,2,0
62312,2,1,218277,218277,218278,0,1,0
62313,6,2,218283,218283,218285,0,2,5
62314,3,1,218286,218286,218287,0,1,1
62315,2,1,218288,218288,218289,0,1,1
62316,1,2,218289,218289,218291,0,2,0
62317,5,1,218294,218294,218295,0,1,3
62318,3,3,218297,218297,218300,0,3,2
62319,5,3,218302,218302,218305,0,3,2
62320,1,3,218303,218305,218308,2,5,0
62321,2,3,218305,218308,218311,3,6,0
62322,2,1,218307,218311,218312,4,5,0
62323,1,2,218308,218312,218314,4,6,0
62324,1,3,218309,218314,218317,5,8,0
62325,4,3,218313,218317,218320,4,7,0
62326,2,1,218315,218320,218321,5,6,0
62327,6,1,218321,218321,218322,0,1,0
62328,5,3,218326,218326,218329,0,3,4
62329,4,3,218330,218330,218333,0,3,1
62330,6,1,218336,218336,218337,0,1,3
62331,1,3,218337,218337,218340,0,3,0
62332,1,1,218338,218340,218341,2,3,0
62333,3,2,218341,218341,218343,0,2,0
62334,1,2,218342,218343,218345,1,3,0
62335,2,3,218344,218345,218348,1,4,0
62336,4,3,218348,218348,218351,0,3,0
62337,2,1,218350,218351,218352,1,2,0
62338,3,3,218353,218353,218356,0,3,1
62339,2,3,218355,218356,218359,1,4,0
62340,1,2,218356,218359,218361,3,5,0
62341,1,1,218357,218361,218362,4,5,0
62342,3,1,218360,218362,218363,2,3,0
62343,2,3,218362,218363,218366,1,4,0
62344,1,1,218363,218366,218367,3,4,0
62345,4,1,218367,218367,218368,0,1,0
62346,1,3,218368,218368,218371,0,3,0
62347,2,1,218370,218371,218372,1,2,0
62348,4,1,218374,218374,218375,0,1,2
62349,2,3,218376,218376,218379,0,3,1
62350,2,2,218378,218379,218381,1,3,0
62351,2,3,218380,218381,218384,1,4,0
62352,3,3,218383,218384,218387,1,4,0
62353,5,1,218388,218388,218389,0,1,1
62354,3,2,218391,218391,218393,0,2,2
62355,1,3,218392,218393,218396,1,4,0
62356,4,2,218396,218396,218398,0,2,0
62357,4,2,218400,218400,218402,0,2,2
62358,3,1,218403,218403,218404,0,1,1
62359,3,2,218406,218406,218408,0,2,2
62360,3,1,218409,218409,218410,0,1,1
62361,3,1,218412,218412,218413,0,1,2
62362,2,3,218414,218414,218417,0,3,1
62363,3,3,218417,218417,218420,0,3,0
62364,6,3,218423,218423,218426,0,3,3
62365,3,2,218426,218426,218428,0,2,0
62366,3,3,218429,218429,218432,0,3,1
62367,6,1,218435,218435,218436,0,1,3
62368,5,1,218440,218440,218441,0,1,4
62369,3,2,218443,218443,218445,0,2,2
62370,6,3,218449,218449,218452,0,3,4
62371,5,2,218454,218454,218456,0,2,2
62372,3,3,218457,218457,218460,0,3,1
62373,4,3,218461,218461,218464,0,3,1
62374,5,1,218466,218466,218467,0,1,2
62375,3,2,218469,218469,218471,0,2,2
62376,2,2,218471,218471,218473,0,2,0
62377,3,3,218474,218474,218477,0,3,1
62378,4,3,218478,218478,218481,0,3,1
62379,4,2,218482,218482,218484,0,2,1
62380,3,3,218485,218485,218488,0,3,1
62381,2,1,218487,218488,218489,1,2,0
62382,2,2,218489,218489,218491,0,2,0
62383,4,3,218493,218493,218496,0,3,2
62384,4,3,218497,218497,218500,0,3,1
62385,4,3,218501,218501,218504,0,3,1
62386,4,2,218505,218505,218507,0,2,1
62387,2,3,218507,218507,218510,0,3,0
62388,3,2,218510,218510,218512,0,2,0
62389,1,2,218511,218512,218514,1,3,0
62390,1,1,218512,218514,218515,2,3,0
62391,5,1,218517,218517,218518,0,1,2
62392,6,2,218523,218523,218525,0,2,5
62393,5,2,218528,218528,218530,0,2,3
62394,3,3,218531,218531,218534,0,3,1
62395,4,3,218535,218535,218538,0,3,1
62396,6,3,218541,218541,218544,0,3,3
62397,6,2,218547,218547,218549,0,2,3
62398,5,3,218552,218552,218555,0,3,3
62399,2,1,218554,218555,218556,1,2,0
62400,4,2,218558,218558,218560,0,2,2
62401,2,1,218560,218560,218561,0,1,0
62402,1,2,218561,218561,218563,0,2,0
62403,1,3,218562,218563,218566,1,4,0
62404,2,2,218564,218566,218568,2,4,0
62405,3,3,218567,218568,218571,1,4,0
62406,6,1,218573,218573,218574,0,1,2
62407,6,3,218579,218579,218582,0,3,5
62408,6,3,218585,218585,218588,0,3,3
62409,1,2,218586,218588,218590,2,4,0
62410,3,3,218589,218590,218593,1,4,0
62411,5,3,218594,218594,218597,0,3,1
62412,5,1,218599,218599,218600,0,1,2
62413,5,3,218604,218604,218607,0,3,4
62414,3,1,218607,218607,218608,0,1,0
62415,1,1,218608,218608,218609,0,1,0
62416,3,3,218611,218611,218614,0,3,2
62417,6,2,218617,218617,218619,0,2,3
62418,6,2,218623,218623,218625,0,2,4
62419,5,2,218628,218628,218630,0,2,3
62420,3,2,218631,218631,218633,0,2,1
62421,3,1,218634,218634,218635,0,1,1
62422,6,2,218640,218640,218642,0,2,5
62423,2,2,218642,218642,218644,0,2,0
62424,5,3,218647,218647,218650,0,3,3
62425,2,3,218649,218650,218653,1,4,0
62426,1,3,218650,218653,218656,3,6,0
62427,3,1,218653,218656,218657,3,4,0
62428,1,2,218654,218657,218659,3,5,0
62429,5,2,218659,218659,218661,0,2,0
62430,4,2,218663,218663,218665,0,2,2
62431,5,1,218668,218668,218669,0,1,3
62432,1,2,218669,218669,218671,0,2,0
62433,2,2,218671,218671,218673,0,2,0
62434,2,3,218673,218673,218676,0,3,0
62435,3,2,218676,218676,218678,0,2,0
62436,6,3,218682,218682,218685,0,3,4
62437,4,3,218686,218686,218689,0,3,1
62438,6,3,218692,218692,218695,0,3,3
62439,6,2,218698,218698,218700,0,2,3
62440,3,3,218701,218701,218704,0,3,1
62441,4,1,218705,218705,218706,0,1,1
62442,4,3,218709,218709,218712,0,3,3
62443,2,1,218711,218712,218713,1,2,0
62444,2,3,218713,218713,218716,0,3,0
62445,4,1,218717,218717,218718,0,1,1
62446,4,3,218721,218721,218724,0,3,3
62447,6,2,218727,218727,218729,0,2,3
62448,5,1,218732,218732,218733,0,1,3
62449,2,2,218734,218734,218736,0,2,1
62450,2,1,218736,218736,218737,0,1,0
62451,2,1,218738,218738,218739,0,1,1
62452,3,2,218741,218741,218743,0,2,2
62453,4,1,218745,218745,218746,0,1,2
62454,3,1,218748,218748,218749,0,1,2
62455,2,2,218750,218750,218752,0,2,1
62456,5,1,218755,218755,218756,0,1,3
62457,4,3,218759,218759,218762,0,3,3
62458,3,3,218762,218762,218765,0,3,0
62459,2,1,218764,218765,218766,1,2,0
62460,5,3,218769,218769,218772,0,3,3
62461,5,1,218774,218774,218775,0,1,2
62462,5,2,218779,218779,218781,0,2,4
62463,4,2,218783,218783,218785,0,2,2
62464,2,2,218785,218785,218787,0,2,0
62465,5,1,218790,218790,218791,0,1,3
62466,3,3,218793,218793,218796,0,3,2
62467,1,1,218794,218796,218797,2,3,0
62468,4,3,218798,218798,218801,0,3,1
62469,1,1,218799,218801,218802,2,3,0
62470,1,3,218800,218802,218805,2,5,0
62471,4,3,218804,218805,218808,1,4,0
62472,4,1,218808,218808,218809,0,1,0
62473,5,2,218813,218813,218815,0,2,4
62474,2,2,218815,218815,218817,0,2,0
62475,6,3,218821,218821,218824,0,3,4
62476,3,3,218824,218824,218827,0,3,0
62477,6,2,218830,218830,218832,0,2,3
62478,3,2,218833,218833,218835,0,2,1
62479,3,1,218836,218836,218837,0,1,1
62480,3,1,218839,218839,218840,0,1,2
62481,5,3,218844,218844,218847,0,3,4
62482,5,1,218849,218849,218850,0,1,2
62483,1,2,218850,218850,218852,0,2,0
62484,4,2,218854,218854,218856,0,2,2
62485,3,3,218857,218857,218860,0,3,1
62486,2,1,218859,218860,218861,1,2,0
62487,6,2,218865,218865,218867,0,2,4
62488,6,1,218871,218871,218872,0,1,4
62489,5,1,218876,218876,218877,0,1,4
62490,6,1,218882,218882,218883,0,1,5
62491,4,2,218886,218886,218888,0,2,3
62492,3,2,218889,218889,218891,0,2,1
62493,5,2,218894,218894,218896,0,2,3
62494,4,1,218898,218898,218899,0,1,2
62495,5,2,218903,218903,218905,0,2,4
62496,1,2,218904,218905,218907,1,3,0
62497,4,3,218908,218908,218911,0,3,1
62498,4,1,218912,218912,218913,0,1,1
62499,1,1,218913,218913,218914,0,1,0
62500,1,1,218914,218914,218915,0,1,0
62501,4,1,218918,218918,218919,0,1,3
62502,3,2,218921,218921,218923,0,2,2
62503,2,3,218923,218923,218926,0,3,0
62504,2,3,218925,218926,218929,1,4,0
62505,6,1,218931,218931,218932,0,1,2
62506,1,2,218932,218932,218934,0,2,0
62507,5,3,218937,218937,218940,0,3,3
62508,5,3,218942,218942,218945,0,3,2
62509,3,2,218945,218945,218947,0,2,0
62510,3,3,218948,218948,218951,0,3,1
62511,5,3,218953,218953,218956,0,3,2
62512,3,2,218956,218956,218958,0,2,0
62513,5,1,218961,218961,218962,0,1,3
62514,3,2,218964,218964,218966,0,2,2
62515,2,2,218966,218966,218968,0,2,0
62516,4,1,218970,218970,218971,0,1,2
62517,4,2,218974,218974,218976,0,2,3
62518,3,2,218977,218977,218979,0,2,1
62519,3,3,218980,218980,218983,0,3,1
62520,1,3,218981,218983,218986,2,5,0
62521,4,1,218985,218986,218987,1,2,0
62522,2,1,218987,218987,218988,0,1,0
62523,2,1,218989,218989,218990,0,1,1
62524,3,3,218992,218992,218995,0,3,2
62525,6,1,218998,218998,218999,0,1,3
62526,3,3,219001,219001,219004,0,3,2
62527,3,2,219004,219004,219006,0,2,0
62528,3,1,219007,219007,219008,0,1,1
62529,5,3,219012,219012,219015,0,3,4
62530,2,1,219014,219015,219016,1,2,0
62531,1,2,219015,219016,219018,1,3,0
62532,6,2,219021,219021,219023,0,2,3
62533,4,1,219025,219025,219026,0,1,2
62534,5,3,219030,219030,219033,0,3,4
62535,6,1,219036,219036,219037,0,1,3
62536,2,1,219038,219038,219039,0,1,1
62537,2,1,219040,219040,219041,0,1,1
62538,5,3,219045,219045,219048,0,3,4
62539,2,2,219047,219048,219050,1,3,0
62540,2,2,219049,219050,219052,1,3,0
62541,1,1,219050,219052,219053,2,3,0
62542,6,3,219056,219056,219059,0,3,3
62543,5,3,219061,219061,219064,0,3,2
62544,3,1,219064,219064,219065,0,1,0
62545,5,3,219069,219069,219072,0,3,4
62546,4,3,219073,219073,219076,0,3,1
62547,2,1,219075,219076,219077,1,2,0
62548,1,1,219076,219077,219078,1,2,0
62549,6,1,219082,219082,219083,0,1,4
62550,6,3,219088,219088,219091,0,3,5
62551,2,3,219090,219091,219094,1,4,0
62552,1,3,219091,219094,219097,3,6,0
62553,3,2,219094,219097,219099,3,5,0
62554,6,1,219100,219100,219101,0,1,1
62555,1,2,219101,219101,219103,0,2,0
62556,4,3,219105,219105,219108,0,3,2
62557,2,3,219107,219108,219111,1,4,0
62558,4,2,219111,219111,219113,0,2,0
62559,5,3,219116,219116,219119,0,3,3
62560,5,3,219121,219121,219124,0,3,2
62561,2,1,219123,219124,219125,1,2,0
62562,5,1,219128,219128,219129,0,1,3
62563,4,3,219132,219132,219135,0,3,3
62564,4,3,219136,219136,219139,0,3,1
62565,6,1,219142,219142,219143,0,1,3
62566,3,1,219145,219145,219146,0,1,2
62567,5,1,219150,219150,219151,0,1,4
62568,4,1,219154,219154,219155,0,1,3
62569,1,2,219155,219155,219157,0,2,0
62570,4,1,219159,219159,219160,0,1,2
62571,6,2,219165,219165,219167,0,2,5
62572,6,2,219171,219171,219173,0,2,4
62573,5,2,219176,219176,219178,0,2,3
62574,6,3,219182,219182,219185,0,3,4
62575,2,1,219184,219185,219186,1,2,0
62576,1,3,219185,219186,219189,1,4,0
62577,1,3,219186,219189,219192,3,6,0
62578,2,2,219188,219192,219194,4,6,0
62579,2,2,219190,219194,219196,4,6,0
62580,1,1,219191,219196,219197,5,6,0
62581,2,1,219193,219197,219198,4,5,0
62582,2,2,219195,219198,219200,3,5,0
62583,4,2,219199,219200,219202,1,3,0
62584,4,3,219203,219203,219206,0,3,1
62585,5,1,219208,219208,219209,0,1,2
62586,1,3,219209,219209,219212,0,3,0
62587,4,1,219213,219213,219214,0,1,1
62588,1,2,219214,219214,219216,0,2,0
62589,6,3,219220,219220,219223,0,3,4
62590,5,2,219225,219225,219227,0,2,2
62591,4,3,219229,219229,219232,0,3,2
62592,2,2,219231,219232,219234,1,3,0
62593,4,3,219235,219235,219238,0,3,1
62594,3,3,219238,219238,219241,0,3,0
62595,4,2,219242,219242,219244,0,2,1
62596,5,3,219247,219247,219250,0,3,3
62597,4,1,219251,219251,219252,0,1,1
62598,2,1,219253,219253,219254,0,1,1
62599,5,1,219258,219258,219259,0,1,4
62600,5,3,219263,219263,219266,0,3,4
62601,6,3,219269,219269,219272,0,3,3
62602,2,1,219271,219272,219273,1,2,0
62603,1,3,219272,219273,219276,1,4,0
62604,1,1,219273,219276,219277,3,4,0
62605,2,2,219275,219277,219279,2,4,0
62606,5,1,219280,219280,219281,0,1,1
62607,5,3,219285,219285,219288,0,3,4
62608,6,2,219291,219291,219293,0,2,3
62609,6,2,219297,219297,219299,0,2,4
62610,1,1,219298,219299,219300,1,2,0
62611,5,2,219303,219303,219305,0,2,3
62612,3,3,219306,219306,219309,0,3,1
62613,1,3,219307,219309,219312,2,5,0
62614,4,2,219311,219312,219314,1,3,0
62615,2,3,219313,219314,219317,1,4,0
62616,2,2,219315,219317,219319,2,4,0
62617,4,3,219319,219319,219322,0,3,0
62618,2,1,219321,219322,219323,1,2,0
62619,4,3,219325,219325,219328,0,3,2
62620,4,3,219329,219329,219332,0,3,1
62621,6,1,219335,219335,219336,0,1,3
62622,2,2,219337,219337,219339,0,2,1
62623,4,3,219341,219341,219344,0,3,2
62624,6,2,219347,219347,219349,0,2,3
62625,6,2,219353,219353,219355,0,2,4
62626,6,1,219359,219359,219360,0,1,4
62627,6,1,219365,219365,219366,0,1,5
62628,6,2,219371,219371,219373,0,2,5
62629,4,3,219375,219375,219378,0,3,2
62630,6,3,219381,219381,219384,0,3,3
62631,1,1,219382,219384,219385,2,3,0
62632,1,2,219383,219385,219387,2,4,0
62633,2,2,219385,219387,219389,2,4,0
62634,2,1,219387,219389,219390,2,3,0
62635,2,2,219389,219390,219392,1,3,0
62636,4,1,219393,219393,219394,0,1,1
62637,6,1,219399,219399,219400,0,1,5
62638,3,3,219402,219402,219405,0,3,2
62639,3,1,219405,219405,219406,0,1,0
62640,2,2,219407,219407,219409,0,2,1
62641,2,1,219409,219409,219410,0,1,0
62642,1,1,219410,219410,219411,0,1,0
62643,4,2,219414,219414,219416,0,2,3
62644,2,3,219416,219416,219419,0,3,0
62645,1,3,219417,219419,219422,2,5,0
62646,4,3,219421,219422,219425,1,4,0
62647,1,3,219422,219425,219428,3,6,0
62648,1,3,219423,219428,219431,5,8,0
62649,6,1,219429,219431,219432,2,3,0
62650,1,1,219430,219432,219433,2,3,0
62651,1,2,219431,219433,219435,2,4,0
62652,6,2,219437,219437,219439,0,2,2
62653,6,1,219443,219443,219444,0,1,4
62654,2,2,219445,219445,219447,0,2,1
62655,3,3,219448,219448,219451,0,3,1
62656,2,2,219450,219451,219453,1,3,0
62657,3,2,219453,219453,219455,0,2,0
62658,6,1,219459,219459,219460,0,1,4
62659,3,3,219462,219462,219465,0,3,2
62660,1,2,219463,219465,219467,2,4,0
62661,1,3,219464,219467,219470,3,6,0
62662,2,3,219466,219470,219473,4,7,0
62663,3,1,219469,219473,219474,4,5,0
62664,6,3,219475,219475,219478,0,3,1
62665,5,3,219480,219480,219483,0,3,2
62666,5,1,219485,219485,219486,0,1,2
62667,2,1,219487,219487,219488,0,1,1
62668,3,2,219490,219490,219492,0,2,2
62669,5,1,219495,219495,219496,0,1,3
62670,4,1,219499,219499,219500,0,1,3
62671,5,1,219504,219504,219505,0,1,4
62672,6,3,219510,219510,219513,0,3,5
62673,2,1,219512,219513,219514,1,2,0
62674,3,2,219515,219515,219517,0,2,1
62675,1,1,219516,219517,219518,1,2,0
62676,6,1,219522,219522,219523,0,1,4
62677,5,1,219527,219527,219528,0,1,4
62678,3,2,219530,219530,219532,0,2,2
62679,3,1,219533,219533,219534,0,1,1
62680,3,2,219536,219536,219538,0,2,2
62681,6,2,219542,219542,219544,0,2,4
62682,3,1,219545,219545,219546,0,1,1
62683,6,1,219551,219551,219552,0,1,5
62684,6,3,219557,219557,219560,0,3,5
62685,4,1,219561,219561,219562,0,1,1
62686,6,1,219567,219567,219568,0,1,5
62687,5,1,219572,219572,219573,0,1,4
62688,6,1,219578,219578,219579,0,1,5
62689,3,1,219581,219581,219582,0,1,2
62690,1,1,219582,219582,219583,0,1,0
62691,1,2,219583,219583,219585,0,2,0
62692,3,2,219586,219586,219588,0,2,1
62693,6,1,219592,219592,219593,0,1,4
62694,2,3,219594,219594,219597,0,3,1
62695,4,2,219598,219598,219600,0,2,1
62696,4,2,219602,219602,219604,0,2,2
62697,2,1,219604,219604,219605,0,1,0
62698,6,1,219610,219610,219611,0,1,5
62699,1,3,219611,219611,219614,0,3,0
62700,5,3,219616,219616,219619,0,3,2
62701,5,1,219621,219621,219622,0,1,2
62702,2,2,219623,219623,219625,0,2,1
62703,1,2,219624,219625,219627,1,3,0
62704,2,2,219626,219627,219629,1,3,0
62705,4,1,219630,219630,219631,0,1,1
62706,1,2,219631,219631,219633,0,2,0
62707,4,1,219635,219635,219636,0,1,2
62708,3,2,219638,219638,219640,0,2,2
62709,4,2,219642,219642,219644,0,2,2
62710,2,1,219644,219644,219645,0,1,0
62711,2,3,219646,219646,219649,0,3,1
62712,1,1,219647,219649,219650,2,3,0
62713,2,1,219649,219650,219651,1,2,0
62714,4,3,219653,219653,219656,0,3,2
62715,6,1,219659,219659,219660,0,1,3
62716,2,3,219661,219661,219664,0,3,1
62717,2,3,219663,219664,219667,1,4,0
62718,2,2,219665,219667,219669,2,4,0
62719,5,3,219670,219670,219673,0,3,1
62720,2,2,219672,219673,219675,1,3,0
62721,3,3,219675,219675,219678,0,3,0
62722,3,3,219678,219678,219681,0,3,0
62723,1,3,219679,219681,219684,2,5,0
62724,6,1,219685,219685,219686,0,1,1
62725,3,1,219688,219688,219689,0,1,2
62726,6,3,219694,219694,219697,0,3,5
62727,2,3,219696,219697,219700,1,4,0
62728,1,3,219697,219700,219703,3,6,0
62729,2,2,219699,219703,219705,4,6,0
62730,2,3,219701,219705,219708,4,7,0
62731,3,3,219704,219708,219711,4,7,0
62732,5,3,219709,219711,219714,2,5,0
62733,1,2,219710,219714,219716,4,6,0
62734,3,1,219713,219716,219717,3,4,0
62735,5,3,219718,219718,219721,0,3,1
62736,5,2,219723,219723,219725,0,2,2
62737,6,1,219729,219729,219730,0,1,4
62738,4,2,219733,219733,219735,0,2,3
62739,1,2,219734,219735,219737,1,3,0
62740,4,2,219738,219738,219740,0,2,1
62741,2,1,219740,219740,219741,0,1,0
62742,3,3,219743,219743,219746,0,3,2
62743,4,2,219747,219747,219749,0,2,1
62744,6,2,219753,219753,219755,0,2,4
62745,5,3,219758,219758,219761,0,3,3
62746,4,3,219762,219762,219765,0,3,1
62747,1,2,219763,219765,219767,2,4,0
62748,4,1,219767,219767,219768,0,1,0
62749,5,1,219772,219772,219773,0,1,4
62750,6,2,219778,219778,219780,0,2,5
62751,1,1,219779,219780,219781,1,2,0
62752,5,2,219784,219784,219786,0,2,3
62753,1,3,219785,219786,219789,1,4,0
62754,1,2,219786,219789,219791,3,5,0
62755,3,2,219789,219791,219793,2,4,0
62756,3,1,219792,219793,219794,1,2,0
62757,4,1,219796,219796,219797,0,1,2
62758,6,1,219802,219802,219803,0,1,5
62759,2,3,219804,219804,219807,0,3,1
62760,6,1,219810,219810,219811,0,1,3
62761,6,2,219816,219816,219818,0,2,5
62762,5,2,219821,219821,219823,0,2,3
62763,6,1,219827,219827,219828,0,1,4
62764,4,2,219831,219831,219833,0,2,3
62765,2,3,219833,219833,219836,0,3,0
62766,1,2,219834,219836,219838,2,4,0
62767,5,3,219839,219839,219842,0,3,1
62768,2,1,219841,219842,219843,1,2,0
62769,5,3,219846,219846,219849,0,3,3
62770,2,1,219848,219849,219850,1,2,0
62771,4,2,219852,219852,219854,0,2,2
62772,2,1,219854,219854,219855,0,1,0
62773,2,2,219856,219856,219858,0,2,1
62774,5,3,219861,219861,219864,0,3,3
62775,6,3,219867,219867,219870,0,3,3
62776,1,2,219868,219870,219872,2,4,0
62777,3,1,219871,219872,219873,1,2,0
62778,3,2,219874,219874,219876,0,2,1
62779,2,3,219876,219876,219879,0,3,0
62780,4,3,219880,219880,219883,0,3,1
62781,1,1,219881,219883,219884,2,3,0
62782,6,2,219887,219887,219889,0,2,3
62783,5,2,219892,219892,219894,0,2,3
62784,4,1,219896,219896,219897,0,1,2
62785,3,2,219899,219899,219901,0,2,2
62786,6,3,219905,219905,219908,0,3,4
62787,5,1,219910,219910,219911,0,1,2
62788,6,2,219916,219916,219918,0,2,5
62789,5,2,219921,219921,219923,0,2,3
62790,2,2,219923,219923,219925,0,2,0
62791,5,1,219928,219928,219929,0,1,3
62792,3,1,219931,219931,219932,0,1,2
62793,3,1,219934,219934,219935,0,1,2
62794,3,3,219937,219937,219940,0,3,2
62795,5,1,219942,219942,219943,0,1,2
62796,1,1,219943,219943,219944,0,1,0
62797,2,2,219945,219945,219947,0,2,1
62798,4,1,219949,219949,219950,0,1,2
62799,5,3,219954,219954,219957,0,3,4
62800,4,1,219958,219958,219959,0,1,1
62801,3,1,219961,219961,219962,0,1,2
62802,5,2,219966,219966,219968,0,2,4
62803,6,3,219972,219972,219975,0,3,4
62804,6,2,219978,219978,219980,0,2,3
62805,5,1,219983,219983,219984,0,1,3
62806,4,3,219987,219987,219990,0,3,3
62807,4,3,219991,219991,219994,0,3,1
62808,4,3,219995,219995,219998,0,3,1
62809,5,1,220000,220000,220001,0,1,2
62810,5,2,220005,220005,220007,0,2,4
62811,2,2,220007,220007,220009,0,2,0
62812,5,1,220012,220012,220013,0,1,3
62813,2,1,220014,220014,220015,0,1,1
62814,3,2,220017,220017,220019,0,2,2
62815,1,2,220018,220019,220021,1,3,0
62816,1,3,220019,220021,220024,2,5,0
62817,2,2,220021,220024,220026,3,5,0
62818,2,1,220023,220026,220027,3,4,0
62819,3,1,220026,220027,220028,1,2,0
62820,2,2,220028,220028,220030,0,2,0
62821,1,2,220029,220030,220032,1,3,0
62822,1,1,220030,220032,220033,2,3,0
62823,5,3,220035,220035,220038,0,3,2
62824,3,2,220038,220038,220040,0,2,0
62825,5,1,220043,220043,220044,0,1,3
62826,5,3,220048,220048,220051,0,3,4
62827,5,1,220053,220053,220054,0,1,2
62828,5,2,220058,220058,220060,0,2,4
62829,2,2,220060,220060,220062,0,2,0
62830,4,2,220064,220064,220066,0,2,2
62831,5,3,220069,220069,220072,0,3,3
62832,1,1,220070,220072,220073,2,3,0
62833,5,2,220075,220075,220077,0,2,2
62834,2,2,220077,220077,220079,0,2,0
62835,4,2,220081,220081,220083,0,2,2
62836,2,2,220083,220083,220085,0,2,0
62837,4,1,220087,220087,220088,0,1,2
62838,4,2,220091,220091,220093,0,2,3
62839,3,2,220094,220094,220096,0,2,1
62840,6,2,220100,220100,220102,0,2,4
62841,1,2,220101,220102,220104,1,3,0
62842,1,2,220102,220104,220106,2,4,0
62843,4,3,220106,220106,220109,0,3,0
62844,4,1,220110,220110,220111,0,1,1
62845,6,1,220116,220116,220117,0,1,5
62846,2,3,220118,220118,220121,0,3,1
62847,3,1,220121,220121,220122,0,1,0
62848,4,2,220125,220125,220127,0,2,3
62849,1,3,220126,220127,220130,1,4,0
62850,1,1,220127,220130,220131,3,4,0
62851,5,2,220132,220132,220134,0,2,1
62852,3,2,220135,220135,220137,0,2,1
62853,3,1,220138,220138,220139,0,1,1
62854,1,3,220139,220139,220142,0,3,0
62855,2,2,220141,220142,220144,1,3,0
62856,3,1,220144,220144,220145,0,1,0
62857,5,2,220149,220149,220151,0,2,4
62858,1,3,220150,220151,220154,1,4,0
62859,1,2,220151,220154,220156,3,5,0
62860,5,1,220156,220156,220157,0,1,0
62861,2,1,220158,220158,220159,0,1,1
62862,3,3,220161,220161,220164,0,3,2
62863,3,2,220164,220164,220166,0,2,0
62864,2,2,220166,220166,220168,0,2,0
62865,2,1,220168,220168,220169,0,1,0
62866,2,1,220170,220170,220171,0,1,1
62867,6,3,220176,220176,220179,0,3,5
62868,2,3,220178,220179,220182,1,4,0
62869,3,3,220181,220182,220185,1,4,0
62870,5,1,220186,220186,220187,0,1,1
62871,5,3,220191,220191,220194,0,3,4
62872,2,2,220193,220194,220196,1,3,0
62873,3,2,220196,220196,220198,0,2,0
62874,6,1,220202,220202,220203,0,1,4
62875,3,3,220205,220205,220208,0,3,2
62876,3,3,220208,220208,220211,0,3,0
62877,5,3,220213,220213,220216,0,3,2
62878,4,2,220217,220217,220219,0,2,1
62879,4,2,220221,220221,220223,0,2,2
62880,5,3,220226,220226,220229,0,3,3
62881,4,3,220230,220230,220233,0,3,1
62882,6,3,220236,220236,220239,0,3,3
62883,4,1,220240,220240,220241,0,1,1
62884,5,3,220245,220245,220248,0,3,4
62885,5,1,220250,220250,220251,0,1,2
62886,4,1,220254,220254,220255,0,1,3
62887,1,1,220255,220255,220256,0,1,0
62888,6,3,220261,220261,220264,0,3,5
62889,1,1,220262,220264,220265,2,3,0
62890,3,2,220265,220265,220267,0,2,0
62891,6,1,220271,220271,220272,0,1,4
62892,1,1,220272,220272,220273,0,1,0
62893,3,2,220275,220275,220277,0,2,2
62894,5,2,220280,220280,220282,0,2,3
62895,6,1,220286,220286,220287,0,1,4
62896,6,1,220292,220292,220293,0,1,5
62897,1,1,220293,220293,220294,0,1,0
62898,1,3,220294,220294,220297,0,3,0
62899,1,1,220295,220297,220298,2,3,0
62900,5,1,220300,220300,220301,0,1,2
62901,5,3,220305,220305,220308,0,3,4
62902,6,3,220311,220311,220314,0,3,3
62903,4,2,220315,220315,220317,0,2,1
62904,1,2,220316,220317,220319,1,3,0
62905,1,2,220317,220319,220321,2,4,0
62906,5,3,220322,220322,220325,0,3,1
62907,4,1,220326,220326,220327,0,1,1
62908,4,3,220330,220330,220333,0,3,3
62909,4,3,220334,220334,220337,0,3,1
62910,2,3,220336,220337,220340,1,4,0
62911,5,3,220341,220341,220344,0,3,1
62912,5,2,220346,220346,220348,0,2,2
62913,6,2,220352,220352,220354,0,2,4
62914,5,1,220357,220357,220358,0,1,3
62915,5,3,220362,220362,220365,0,3,4
62916,5,1,220367,220367,220368,0,1,2
62917,2,3,220369,220369,220372,0,3,1
62918,3,2,220372,220372,220374,0,2,0
62919,2,3,220374,220374,220377,0,3,0
62920,6,1,220380,220380,220381,0,1,3
62921,3,2,220383,220383,220385,0,2,2
62922,3,2,220386,220386,220388,0,2,1
62923,5,1,220391,220391,220392,0,1,3
62924,6,2,220397,220397,220399,0,2,5
62925,3,2,220400,220400,220402,0,2,1
62926,2,3,220402,220402,220405,0,3,0
62927,5,2,220407,220407,220409,0,2,2
62928,5,2,220412,220412,220414,0,2,3
62929,4,3,220416,220416,220419,0,3,2
62930,2,3,220418,220419,220422,1,4,0
62931,2,1,220420,220422,220423,2,3,0
62932,3,3,220423,220423,220426,0,3,0
62933,4,3,220427,220427,220430,0,3,1
62934,2,2,220429,220430,220432,1,3,0
62935,1,1,220430,220432,220433,2,3,0
62936,5,3,220435,220435,220438,0,3,2
62937,5,2,220440,220440,220442,0,2,2
62938,6,1,220446,220446,220447,0,1,4
62939,5,2,220451,220451,220453,0,2,4
62940,1,1,220452,220453,220454,1,2,0
62941,5,3,220457,220457,220460,0,3,3
62942,3,3,220460,220460,220463,0,3,0
62943,1,2,220461,220463,220465,2,4,0
62944,3,3,220464,220465,220468,1,4,0
62945,1,3,220465,220468,220471,3,6,0
62946,6,2,220471,220471,220473,0,2,0
62947,6,1,220477,220477,220478,0,1,4
62948,5,2,220482,220482,220484,0,2,4
62949,4,2,220486,220486,220488,0,2,2
62950,3,1,220489,220489,220490,0,1,1
62951,5,1,220494,220494,220495,0,1,4
62952,3,1,220497,220497,220498,0,1,2
62953,1,3,220498,220498,220501,0,3,0
62954,3,2,220501,220501,220503,0,2,0
62955,3,2,220504,220504,220506,0,2,1
62956,5,2,220509,220509,220511,0,2,3
62957,6,3,220515,220515,220518,0,3,4
62958,3,1,220518,220518,220519,0,1,0
62959,6,3,220524,220524,220527,0,3,5
62960,1,3,220525,220527,220530,2,5,0
62961,5,2,220530,220530,220532,0,2,0
62962,6,3,220536,220536,220539,0,3,4
62963,5,1,220541,220541,220542,0,1,2
62964,6,1,220547,220547,220548,0,1,5
62965,6,2,220553,220553,220555,0,2,5
62966,5,3,220558,220558,220561,0,3,3
62967,5,1,220563,220563,220564,0,1,2
62968,2,1,220565,220565,220566,0,1,1
62969,5,3,220570,220570,220573,0,3,4
62970,3,3,220573,220573,220576,0,3,0
62971,4,3,220577,220577,220580,0,3,1
62972,3,1,220580,220580,220581,0,1,0
62973,5,2,220585,220585,220587,0,2,4
62974,4,3,220589,220589,220592,0,3,2
62975,1,1,220590,220592,220593,2,3,0
62976,1,2,220591,220593,220595,2,4,0
62977,1,3,220592,220595,220598,3,6,0
62978,2,1,220594,220598,220599,4,5,0
62979,4,2,220598,220599,220601,1,3,0
62980,4,3,220602,220602,220605,0,3,1
62981,5,1,220607,220607,220608,0,1,2
62982,2,3,220609,220609,220612,0,3,1
62983,1,1,220610,220612,220613,2,3,0
62984,1,2,220611,220613,220615,2,4,0
62985,3,1,220614,220615,220616,1,2,0
62986,6,3,220620,220620,220623,0,3,4
62987,2,2,220622,220623,220625,1,3,0
62988,4,3,220626,220626,220629,0,3,1
62989,3,3,220629,220629,220632,0,3,0
62990,5,1,220634,220634,220635,0,1,2
62991,6,1,220640,220640,220641,0,1,5
62992,4,2,220644,220644,220646,0,2,3
62993,2,3,220646,220646,220649,0,3,0
62994,2,3,220648,220649,220652,1,4,0
62995,3,3,220651,220652,220655,1,4,0
62996,4,3,220655,220655,220658,0,3,0
62997,6,3,220661,220661,220664,0,3,3
62998,3,1,220664,220664,220665,0,1,0
62999,2,2,220666,220666,220668,0,2,1
63000,5,2,220671,220671,220673,0,2,3
63001,5,2,220676,220676,220678,0,2,3
63002,5,1,220681,220681,220682,0,1,3
63003,3,1,220684,220684,220685,0,1,2
63004,4,2,220688,220688,220690,0,2,3
63005,6,2,220694,220694,220696,0,2,4
63006,3,2,220697,220697,220699,0,2,1
63007,3,1,220700,220700,220701,0,1,1
63008,6,3,220706,220706,220709,0,3,5
63009,2,3,220708,220709,220712,1,4,0
63010,5,2,220713,220713,220715,0,2,1
63011,5,1,220718,220718,220719,0,1,3
63012,4,3,220722,220722,220725,0,3,3
63013,1,3,220723,220725,220728,2,5,0
63014,4,1,220727,220728,220729,1,2,0
63015,5,1,220732,220732,220733,0,1,3
63016,2,3,220734,220734,220737,0,3,1
63017,4,2,220738,220738,220740,0,2,1
63018,4,2,220742,220742,220744,0,2,2
63019,4,2,220746,220746,220748,0,2,2
63020,3,3,220749,220749,220752,0,3,1
63021,5,1,220754,220754,220755,0,1,2
63022,3,2,220757,220757,220759,0,2,2
63023,3,1,220760,220760,220761,0,1,1
63024,6,3,220766,220766,220769,0,3,5
63025,4,1,220770,220770,220771,0,1,1
63026,6,1,220776,220776,220777,0,1,5
63027,1,1,220777,220777,220778,0,1,0
63028,4,1,220781,220781,220782,0,1,3
63029,6,1,220787,220787,220788,0,1,5
63030,6,1,220793,220793,220794,0,1,5
63031,3,2,220796,220796,220798,0,2,2
63032,6,2,220802,220802,220804,0,2,4
63033,3,3,220805,220805,220808,0,3,1
63034,6,2,220811,220811,220813,0,2,3
63035,6,1,220817,220817,220818,0,1,4
63036,6,1,220823,220823,220824,0,1,5
63037,2,3,220825,220825,220828,0,3,1
63038,1,3,220826,220828,220831,2,5,0
63039,1,1,220827,220831,220832,4,5,0
63040,6,2,220833,220833,220835,0,2,1
63041,4,1,220837,220837,220838,0,1,2
63042,1,1,220838,220838,220839,0,1,0
63043,1,1,220839,220839,220840,0,1,0
63044,3,1,220842,220842,220843,0,1,2
63045,3,2,220845,220845,220847,0,2,2
63046,1,3,220846,220847,220850,1,4,0
63047,5,3,220851,220851,220854,0,3,1
63048,4,2,220855,220855,220857,0,2,1
63049,5,3,220860,220860,220863,0,3,3
63050,2,1,220862,220863,220864,1,2,0
63051,2,3,220864,220864,220867,0,3,0
63052,5,1,220869,220869,220870,0,1,2
63053,2,1,220871,220871,220872,0,1,1
63054,1,2,220872,220872,220874,0,2,0
63055,5,1,220877,220877,220878,0,1,3
63056,4,1,220881,220881,220882,0,1,3
63057,1,1,220882,220882,220883,0,1,0
63058,2,2,220884,220884,220886,0,2,1
63059,2,3,220886,220886,220889,0,3,0
63060,5,2,220891,220891,220893,0,2,2
63061,5,1,220896,220896,220897,0,1,3
63062,3,1,220899,220899,220900,0,1,2
63063,4,2,220903,220903,220905,0,2,3
63064,2,1,220905,220905,220906,0,1,0
63065,2,2,220907,220907,220909,0,2,1
63066,6,3,220913,220913,220916,0,3,4
63067,5,2,220918,220918,220920,0,2,2
63068,2,1,220920,220920,220921,0,1,0
63069,3,2,220923,220923,220925,0,2,2
63070,6,3,220929,220929,220932,0,3,4
63071,4,3,220933,220933,220936,0,3,1
63072,6,3,220939,220939,220942,0,3,3
63073,2,1,220941,220942,220943,1,2,0
63074,5,1,220946,220946,220947,0,1,3
63075,6,2,220952,220952,220954,0,2,5
63076,5,2,220957,220957,220959,0,2,3
63077,3,2,220960,220960,220962,0,2,1
63078,5,1,220965,220965,220966,0,1,3
63079,6,1,220971,220971,220972,0,1,5
63080,6,1,220977,220977,220978,0,1,5
63081,2,2,220979,220979,220981,0,2,1
63082,6,2,220985,220985,220987,0,2,4
63083,3,3,220988,220988,220991,0,3,1
63084,6,2,220994,220994,220996,0,2,3
63085,2,1,220996,220996,220997,0,1,0
63086,5,2,221001,221001,221003,0,2,4
63087,2,2,221003,221003,221005,0,2,0
63088,2,1,221005,221005,221006,0,1,0
63089,4,2,221009,221009,221011,0,2,3
63090,6,3,221015,221015,221018,0,3,4
63091,2,3,221017,221018,221021,1,4,0
63092,1,1,221018,221021,221022,3,4,0
63093,4,1,221022,221022,221023,0,1,0
63094,3,2,221025,221025,221027,0,2,2
63095,4,3,221029,221029,221032,0,3,2
63096,2,2,221031,221032,221034,1,3,0
63097,5,3,221036,221036,221039,0,3,2
63098,1,2,221037,221039,221041,2,4,0
63099,5,1,221042,221042,221043,0,1,1
63100,6,3,221048,221048,221051,0,3,5
63101,6,2,221054,221054,221056,0,2,3
63102,1,1,221055,221056,221057,1,2,0
63103,5,2,221060,221060,221062,0,2,3
63104,6,3,221066,221066,221069,0,3,4
63105,5,1,221071,221071,221072,0,1,2
63106,3,3,221074,221074,221077,0,3,2
63107,1,2,221075,221077,221079,2,4,0
63108,2,2,221077,221079,221081,2,4,0
63109,5,3,221082,221082,221085,0,3,1
63110,4,2,221086,221086,221088,0,2,1
63111,5,3,221091,221091,221094,0,3,3
63112,4,3,221095,221095,221098,0,3,1
63113,2,3,221097,221098,221101,1,4,0
63114,2,2,221099,221101,221103,2,4,0
63115,2,3,221101,221103,221106,2,5,0
63116,2,2,221103,221106,221108,3,5,0
63117,4,1,221107,221108,221109,1,2,0
63118,6,1,221113,221113,221114,0,1,4
63119,6,2,221119,221119,221121,0,2,5
63120,6,1,221125,221125,221126,0,1,4
63121,2,3,221127,221127,221130,0,3,1
63122,2,1,221129,221130,221131,1,2,0
63123,2,3,221131,221131,221134,0,3,0
63124,3,1,221134,221134,221135,0,1,0
63125,4,1,221138,221138,221139,0,1,3
63126,2,3,221140,221140,221143,0,3,1
63127,6,2,221146,221146,221148,0,2,3
63128,4,2,221150,221150,221152,0,2,2
63129,4,3,221154,221154,221157,0,3,2
63130,5,3,221159,221159,221162,0,3,2
63131,5,1,221164,221164,221165,0,1,2
63132,4,2,221168,221168,221170,0,2,3
63133,4,2,221172,221172,221174,0,2,2
63134,2,2,221174,221174,221176,0,2,0
63135,1,3,221175,221176,221179,1,4,0
63136,5,2,221180,221180,221182,0,2,1
63137,6,2,221186,221186,221188,0,2,4
63138,4,3,221190,221190,221193,0,3,2
63139,1,1,221191,221193,221194,2,3,0
63140,1,2,221192,221194,221196,2,4,0
63141,3,1,221195,221196,221197,1,2,0
63142,6,3,221201,221201,221204,0,3,4
63143,5,3,221206,221206,221209,0,3,2
63144,1,2,221207,221209,221211,2,4,0
63145,5,3,221212,221212,221215,0,3,1
63146,4,2,221216,221216,221218,0,2,1
63147,4,2,221220,221220,221222,0,2,2
63148,5,2,221225,221225,221227,0,2,3
63149,2,2,221227,221227,221229,0,2,0
63150,5,1,221232,221232,221233,0,1,3
63151,2,3,221234,221234,221237,0,3,1
63152,4,3,221238,221238,221241,0,3,1
63153,6,3,221244,221244,221247,0,3,3
63154,5,1,221249,221249,221250,0,1,2
63155,4,1,221253,221253,221254,0,1,3
63156,5,3,221258,221258,221261,0,3,4
63157,6,1,221264,221264,221265,0,1,3
63158,4,3,221268,221268,221271,0,3,3
63159,5,3,221273,221273,221276,0,3,2
63160,1,1,221274,221276,221277,2,3,0
63161,1,3,221275,221277,221280,2,5,0
63162,2,2,221277,221280,221282,3,5,0
63163,1,2,221278,221282,221284,4,6,0
63164,5,3,221283,221284,221287,1,4,0
63165,6,2,221289,221289,221291,0,2,2
63166,4,2,221293,221293,221295,0,2,2
63167,6,1,221299,221299,221300,0,1,4
63168,5,2,221304,221304,221306,0,2,4
63169,1,2,221305,221306,221308,1,3,0
63170,6,2,221311,221311,221313,0,2,3
63171,2,2,221313,221313,221315,0,2,0
63172,4,1,221317,221317,221318,0,1,2
63173,3,3,221320,221320,221323,0,3,2
63174,6,3,221326,221326,221329,0,3,3
63175,1,3,221327,221329,221332,2,5,0
63176,5,2,221332,221332,221334,0,2,0
63177,2,3,221334,221334,221337,0,3,0
63178,5,1,221339,221339,221340,0,1,2
63179,2,3,221341,221341,221344,0,3,1
63180,1,3,221342,221344,221347,2,5,0
63181,1,3,221343,221347,221350,4,7,0
63182,4,2,221347,221350,221352,3,5,0
63183,3,2,221350,221352,221354,2,4,0
63184,4,2,221354,221354,221356,0,2,0
63185,1,2,221355,221356,221358,1,3,0
63186,3,3,221358,221358,221361,0,3,0
63187,2,2,221360,221361,221363,1,3,0
63188,4,3,221364,221364,221367,0,3,1
63189,5,1,221369,221369,221370,0,1,2
63190,5,2,221374,221374,221376,0,2,4
63191,4,3,221378,221378,221381,0,3,2
63192,2,2,221380,221381,221383,1,3,0
63193,5,3,221385,221385,221388,0,3,2
63194,3,2,221388,221388,221390,0,2,0
63195,6,3,221394,221394,221397,0,3,4
63196,2,2,221396,221397,221399,1,3,0
63197,2,3,221398,221399,221402,1,4,0
63198,1,2,221399,221402,221404,3,5,0
63199,3,1,221402,221404,221405,2,3,0
63200,5,1,221407,221407,221408,0,1,2
63201,5,3,221412,221412,221415,0,3,4
63202,2,3,221414,221415,221418,1,4,0
63203,2,2,221416,221418,221420,2,4,0
63204,3,2,221419,221420,221422,1,3,0
63205,5,3,221424,221424,221427,0,3,2
63206,6,3,221430,221430,221433,0,3,3
63207,3,3,221433,221433,221436,0,3,0
63208,2,3,221435,221436,221439,1,4,0
63209,1,2,221436,221439,221441,3,5,0
63210,3,1,221439,221441,221442,2,3,0
63211,3,2,221442,221442,221444,0,2,0
63212,4,3,221446,221446,221449,0,3,2
63213,6,1,221452,221452,221453,0,1,3
63214,2,3,221454,221454,221457,0,3,1
63215,1,1,221455,221457,221458,2,3,0
63216,2,2,221457,221458,221460,1,3,0
63217,3,2,221460,221460,221462,0,2,0
63218,2,2,221462,221462,221464,0,2,0
63219,5,3,221467,221467,221470,0,3,3
63220,6,1,221473,221473,221474,0,1,3
63221,4,1,221477,221477,221478,0,1,3
63222,4,1,221481,221481,221482,0,1,3
63223,3,1,221484,221484,221485,0,1,2
63224,6,3,221490,221490,221493,0,3,5
63225,1,1,221491,221493,221494,2,3,0
63226,5,2,221496,221496,221498,0,2,2
63227,6,2,221502,221502,221504,0,2,4
63228,2,1,221504,221504,221505,0,1,0
63229,3,1,221507,221507,221508,0,1,2
63230,3,2,221510,221510,221512,0,2,2
63231,1,3,221511,221512,221515,1,4,0
63232,6,2,221517,221517,221519,0,2,2
63233,1,1,221518,221519,221520,1,2,0
63234,1,3,221519,221520,221523,1,4,0
63235,6,2,221525,221525,221527,0,2,2
63236,2,1,221527,221527,221528,0,1,0
63237,2,3,221529,221529,221532,0,3,1
63238,1,3,221530,221532,221535,2,5,0
63239,6,2,221536,221536,221538,0,2,1
63240,6,3,221542,221542,221545,0,3,4
63241,3,2,221545,221545,221547,0,2,0
63242,5,3,221550,221550,221553,0,3,3
63243,4,1,221554,221554,221555,0,1,1
63244,5,1,221559,221559,221560,0,1,4
63245,3,1,221562,221562,221563,0,1,2
63246,3,2,221565,221565,221567,0,2,2
63247,3,1,221568,221568,221569,0,1,1
63248,3,3,221571,221571,221574,0,3,2
63249,4,1,221575,221575,221576,0,1,1
63250,3,1,221578,221578,221579,0,1,2
63251,6,3,221584,221584,221587,0,3,5
63252,1,1,221585,221587,221588,2,3,0
63253,2,3,221587,221588,221591,1,4,0
63254,1,2,221588,221591,221593,3,5,0
63255,4,1,221592,221593,221594,1,2,0
63256,2,2,221594,221594,221596,0,2,0
63257,5,2,221599,221599,221601,0,2,3
63258,2,1,221601,221601,221602,0,1,0
63259,2,2,221603,221603,221605,0,2,1
63260,4,2,221607,221607,221609,0,2,2
63261,3,3,221610,221610,221613,0,3,1
63262,4,2,221614,221614,221616,0,2,1
63263,1,3,221615,221616,221619,1,4,0
63264,2,1,221617,221619,221620,2,3,0
63265,3,2,221620,221620,221622,0,2,0
63266,5,1,221625,221625,221626,0,1,3
63267,1,3,221626,221626,221629,0,3,0
63268,5,2,221631,221631,221633,0,2,2
63269,5,1,221636,221636,221637,0,1,3
63270,6,3,221642,221642,221645,0,3,5
63271,2,2,221644,221645,221647,1,3,0
63272,4,3,221648,221648,221651,0,3,1
63273,2,2,221650,221651,221653,1,3,0
63274,5,2,221655,221655,221657,0,2,2
63275,6,3,221661,221661,221664,0,3,4
63276,3,2,221664,221664,221666,0,2,0
63277,5,2,221669,221669,221671,0,2,3
63278,1,1,221670,221671,221672,1,2,0
63279,5,1,221675,221675,221676,0,1,3
63280,1,3,221676,221676,221679,0,3,0
63281,3,1,221679,221679,221680,0,1,0
63282,5,2,221684,221684,221686,0,2,4
63283,1,3,221685,221686,221689,1,4,0
63284,4,1,221689,221689,221690,0,1,0
63285,3,2,221692,221692,221694,0,2,2
63286,4,1,221696,221696,221697,0,1,2
63287,5,3,221701,221701,221704,0,3,4
63288,4,1,221705,221705,221706,0,1,1
63289,4,3,221709,221709,221712,0,3,3
63290,2,2,221711,221712,221714,1,3,0
63291,6,1,221717,221717,221718,0,1,3
63292,2,2,221719,221719,221721,0,2,1
63293,3,3,221722,221722,221725,0,3,1
63294,2,2,221724,221725,221727,1,3,0
63295,5,1,221729,221729,221730,0,1,2
63296,3,1,221732,221732,221733,0,1,2
63297,1,3,221733,221733,221736,0,3,0
63298,5,3,221738,221738,221741,0,3,2
63299,5,3,221743,221743,221746,0,3,2
63300,2,2,221745,221746,221748,1,3,0
63301,5,1,221750,221750,221751,0,1,2
63302,1,1,221751,221751,221752,0,1,0
63303,2,2,221753,221753,221755,0,2,1
63304,4,2,221757,221757,221759,0,2,2
63305,1,1,221758,221759,221760,1,2,0
63306,6,2,221764,221764,221766,0,2,4
63307,5,3,221769,221769,221772,0,3,3
63308,1,2,221770,221772,221774,2,4,0
63309,6,3,221776,221776,221779,0,3,2
63310,6,2,221782,221782,221784,0,2,3
63311,4,2,221786,221786,221788,0,2,2
63312,4,1,221790,221790,221791,0,1,2
63313,1,1,221791,221791,221792,0,1,0
63314,6,3,221797,221797,221800,0,3,5
63315,1,1,221798,221800,221801,2,3,0
63316,1,1,221799,221801,221802,2,3,0
63317,5,2,221804,221804,221806,0,2,2
63318,1,3,221805,221806,221809,1,4,0
63319,1,3,221806,221809,221812,3,6,0
63320,5,3,221811,221812,221815,1,4,0
63321,5,3,221816,221816,221819,0,3,1
63322,3,2,221819,221819,221821,0,2,0
63323,6,2,221825,221825,221827,0,2,4
63324,3,3,221828,221828,221831,0,3,1
63325,1,3,221829,221831,221834,2,5,0
63326,1,2,221830,221834,221836,4,6,0
63327,2,2,221832,221836,221838,4,6,0
63328,6,1,221838,221838,221839,0,1,0
63329,3,1,221841,221841,221842,0,1,2
63330,4,2,221845,221845,221847,0,2,3
63331,1,3,221846,221847,221850,1,4,0
63332,3,1,221849,221850,221851,1,2,0
63333,5,3,221854,221854,221857,0,3,3
63334,2,3,221856,221857,221860,1,4,0
63335,6,3,221862,221862,221865,0,3,2
63336,6,2,221868,221868,221870,0,2,3
63337,3,1,221871,221871,221872,0,1,1
63338,5,3,221876,221876,221879,0,3,4
63339,2,1,221878,221879,221880,1,2,0
63340,4,2,221882,221882,221884,0,2,2
63341,1,1,221883,221884,221885,1,2,0
63342,2,1,221885,221885,221886,0,1,0
63343,4,3,221889,221889,221892,0,3,3
63344,5,2,221894,221894,221896,0,2,2
63345,5,1,221899,221899,221900,0,1,3
63346,3,1,221902,221902,221903,0,1,2
63347,1,1,221903,221903,221904,0,1,0
63348,5,1,221908,221908,221909,0,1,4
63349,5,3,221913,221913,221916,0,3,4
63350,3,3,221916,221916,221919,0,3,0
63351,6,2,221922,221922,221924,0,2,3
63352,1,1,221923,221924,221925,1,2,0
63353,4,1,221927,221927,221928,0,1,2
63354,4,3,221931,221931,221934,0,3,3
63355,2,1,221933,221934,221935,1,2,0
63356,6,3,221939,221939,221942,0,3,4
63357,3,3,221942,221942,221945,0,3,0
63358,1,1,221943,221945,221946,2,3,0
63359,6,3,221949,221949,221952,0,3,3
63360,3,1,221952,221952,221953,0,1,0
63361,3,3,221955,221955,221958,0,3,2
63362,1,3,221956,221958,221961,2,5,0
63363,1,3,221957,221961,221964,4,7,0
63364,5,2,221962,221964,221966,2,4,0
63365,1,1,221963,221966,221967,3,4,0
63366,6,2,221969,221969,221971,0,2,2
63367,1,1,221970,221971,221972,1,2,0
63368,1,1,221971,221972,221973,1,2,0
63369,5,2,221976,221976,221978,0,2,3
63370,6,1,221982,221982,221983,0,1,4
63371,4,1,221986,221986,221987,0,1,3
63372,3,1,221989,221989,221990,0,1,2
63373,6,3,221995,221995,221998,0,3,5
63374,6,1,222001,222001,222002,0,1,3
63375,4,1,222005,222005,222006,0,1,3
63376,2,3,222007,222007,222010,0,3,1
63377,1,1,222008,222010,222011,2,3,0
63378,2,2,222010,222011,222013,1,3,0
63379,1,2,222011,222013,222015,2,4,0
63380,5,2,222016,222016,222018,0,2,1
63381,6,3,222022,222022,222025,0,3,4
63382,3,3,222025,222025,222028,0,3,0
63383,3,1,222028,222028,222029,0,1,0
63384,6,2,222034,222034,222036,0,2,5
63385,4,1,222038,222038,222039,0,1,2
63386,3,3,222041,222041,222044,0,3,2
63387,5,3,222046,222046,222049,0,3,2
63388,3,3,222049,222049,222052,0,3,0
63389,6,1,222055,222055,222056,0,1,3
63390,1,3,222056,222056,222059,0,3,0
63391,2,3,222058,222059,222062,1,4,0
63392,3,1,222061,222062,222063,1,2,0
63393,3,3,222064,222064,222067,0,3,1
63394,2,3,222066,222067,222070,1,4,0
63395,3,3,222069,222070,222073,1,4,0
63396,4,1,222073,222073,222074,0,1,0
63397,5,1,222078,222078,222079,0,1,4
63398,4,3,222082,222082,222085,0,3,3
63399,2,1,222084,222085,222086,1,2,0
63400,3,1,222087,222087,222088,0,1,1
63401,5,2,222092,222092,222094,0,2,4
63402,4,1,222096,222096,222097,0,1,2
63403,4,2,222100,222100,222102,0,2,3
63404,3,1,222103,222103,222104,0,1,1
63405,6,3,222109,222109,222112,0,3,5
63406,4,2,222113,222113,222115,0,2,1
63407,6,3,222119,222119,222122,0,3,4
63408,5,1,222124,222124,222125,0,1,2
63409,1,2,222125,222125,222127,0,2,0
63410,5,1,222130,222130,222131,0,1,3
63411,6,3,222136,222136,222139,0,3,5
63412,6,2,222142,222142,222144,0,2,3
63413,4,2,222146,222146,222148,0,2,2
63414,6,3,222152,222152,222155,0,3,4
63415,6,3,222158,222158,222161,0,3,3
63416,1,1,222159,222161,222162,2,3,0
63417,1,1,222160,222162,222163,2,3,0
63418,5,1,222165,222165,222166,0,1,2
63419,2,2,222167,222167,222169,0,2,1
63420,6,1,222173,222173,222174,0,1,4
63421,4,3,222177,222177,222180,0,3,3
63422,3,2,222180,222180,222182,0,2,0
63423,3,3,222183,222183,222186,0,3,1
63424,5,3,222188,222188,222191,0,3,2
63425,2,2,222190,222191,222193,1,3,0
63426,4,2,222194,222194,222196,0,2,1
63427,6,3,222200,222200,222203,0,3,4
63428,3,3,222203,222203,222206,0,3,0
63429,4,2,222207,222207,222209,0,2,1
63430,2,2,222209,222209,222211,0,2,0
63431,4,2,222213,222213,222215,0,2,2
63432,1,2,222214,222215,222217,1,3,0
63433,5,1,222219,222219,222220,0,1,2
63434,2,2,222221,222221,222223,0,2,1
63435,2,2,222223,222223,222225,0,2,0
63436,6,1,222229,222229,222230,0,1,4
63437,3,2,222232,222232,222234,0,2,2
63438,3,1,222235,222235,222236,0,1,1
63439,3,3,222238,222238,222241,0,3,2
63440,5,1,222243,222243,222244,0,1,2
63441,1,2,222244,222244,222246,0,2,0
63442,2,3,222246,222246,222249,0,3,0
63443,2,1,222248,222249,222250,1,2,0
63444,3,3,222251,222251,222254,0,3,1
63445,4,3,222255,222255,222258,0,3,1
63446,6,2,222261,222261,222263,0,2,3
63447,2,3,222263,222263,222266,0,3,0
63448,6,3,222269,222269,222272,0,3,3
63449,5,2,222274,222274,222276,0,2,2
63450,4,2,222278,222278,222280,0,2,2
63451,6,3,222284,222284,222287,0,3,4
63452,4,3,222288,222288,222291,0,3,1
63453,2,2,222290,222291,222293,1,3,0
63454,5,1,222295,222295,222296,0,1,2
63455,5,1,222300,222300,222301,0,1,4
63456,1,2,222301,222301,222303,0,2,0
63457,5,3,222306,222306,222309,0,3,3
63458,6,2,222312,222312,222314,0,2,3
63459,1,3,222313,222314,222317,1,4,0
63460,6,3,222319,222319,222322,0,3,2
63461,2,2,222321,222322,222324,1,3,0
63462,5,1,222326,222326,222327,0,1,2
63463,5,1,222331,222331,222332,0,1,4
63464,4,2,222335,222335,222337,0,2,3
63465,6,2,222341,222341,222343,0,2,4
63466,2,2,222343,222343,222345,0,2,0
63467,5,3,222348,222348,222351,0,3,3
63468,2,2,222350,222351,222353,1,3,0
63469,1,1,222351,222353,222354,2,3,0
63470,1,1,222352,222354,222355,2,3,0
63471,1,1,222353,222355,222356,2,3,0
63472,5,3,222358,222358,222361,0,3,2
63473,1,2,222359,222361,222363,2,4,0
63474,1,3,222360,222363,222366,3,6,0
63475,4,2,222364,222366,222368,2,4,0
63476,6,3,222370,222370,222373,0,3,2
63477,2,1,222372,222373,222374,1,2,0
63478,4,2,222376,222376,222378,0,2,2
63479,6,1,222382,222382,222383,0,1,4
63480,4,3,222386,222386,222389,0,3,3
63481,5,2,222391,222391,222393,0,2,2
63482,4,1,222395,222395,222396,0,1,2
63483,4,3,222399,222399,222402,0,3,3
63484,6,1,222405,222405,222406,0,1,3
63485,5,1,222410,222410,222411,0,1,4
63486,3,3,222413,222413,222416,0,3,2
63487,5,1,222418,222418,222419,0,1,2
63488,4,1,222422,222422,222423,0,1,3
63489,1,1,222423,222423,222424,0,1,0
63490,1,3,222424,222424,222427,0,3,0
63491,5,2,222429,222429,222431,0,2,2
63492,6,1,222435,222435,222436,0,1,4
63493,3,2,222438,222438,222440,0,2,2
63494,4,1,222442,222442,222443,0,1,2
63495,1,1,222443,222443,222444,0,1,0
63496,3,1,222446,222446,222447,0,1,2
63497,4,3,222450,222450,222453,0,3,3
63498,2,2,222452,222453,222455,1,3,0
63499,1,1,222453,222455,222456,2,3,0
63500,1,1,222454,222456,222457,2,3,0
63501,1,2,222455,222457,222459,2,4,0
63502,3,3,222458,222459,222462,1,4,0
63503,4,3,222462,222462,222465,0,3,0
63504,4,1,222466,222466,222467,0,1,1
63505,2,1,222468,222468,222469,0,1,1
63506,3,3,222471,222471,222474,0,3,2
63507,2,1,222473,222474,222475,1,2,0
63508,6,2,222479,222479,222481,0,2,4
63509,6,3,222485,222485,222488,0,3,4
63510,5,1,222490,222490,222491,0,1,2
63511,3,3,222493,222493,222496,0,3,2
63512,1,2,222494,222496,222498,2,4,0
63513,3,1,222497,222498,222499,1,2,0
63514,1,2,222498,222499,222501,1,3,0
63515,4,1,222502,222502,222503,0,1,1
63516,6,3,222508,222508,222511,0,3,5
63517,6,2,222514,222514,222516,0,2,3
63518,1,1,222515,222516,222517,1,2,0
63519,5,2,222520,222520,222522,0,2,3
63520,6,1,222526,222526,222527,0,1,4
63521,4,2,222530,222530,222532,0,2,3
63522,3,3,222533,222533,222536,0,3,1
63523,3,1,222536,222536,222537,0,1,0
63524,2,3,222538,222538,222541,0,3,1
63525,1,2,222539,222541,222543,2,4,0
63526,2,2,222541,222543,222545,2,4,0
63527,4,1,222545,222545,222546,0,1,0
63528,6,3,222551,222551,222554,0,3,5
63529,2,1,222553,222554,222555,1,2,0
63530,5,3,222558,222558,222561,0,3,3
63531,6,1,222564,222564,222565,0,1,3
63532,1,3,222565,222565,222568,0,3,0
63533,2,2,222567,222568,222570,1,3,0
63534,2,3,222569,222570,222573,1,4,0
63535,5,1,222574,222574,222575,0,1,1
63536,3,2,222577,222577,222579,0,2,2
63537,3,1,222580,222580,222581,0,1,1
63538,6,2,222586,222586,222588,0,2,5
63539,4,3,222590,222590,222593,0,3,2
63540,6,2,222596,222596,222598,0,2,3
63541,1,1,222597,222598,222599,1,2,0
63542,4,3,222601,222601,222604,0,3,2
63543,1,1,222602,222604,222605,2,3,0
63544,4,2,222606,222606,222608,0,2,1
63545,2,3,222608,222608,222611,0,3,0
63546,3,1,222611,222611,222612,0,1,0
63547,2,2,222613,222613,222615,0,2,1
63548,3,3,222616,222616,222619,0,3,1
63549,1,2,222617,222619,222621,2,4,0
63550,2,1,222619,222621,222622,2,3,0
63551,2,1,222621,222622,222623,1,2,0
63552,6,2,222627,222627,222629,0,2,4
63553,3,1,222630,222630,222631,0,1,1
63554,6,3,222636,222636,222639,0,3,5
63555,1,2,222637,222639,222641,2,4,0
63556,2,3,222639,222641,222644,2,5,0
63557,1,3,222640,222644,222647,4,7,0
63558,1,1,222641,222647,222648,6,7,0
63559,6,2,222647,222648,222650,1,3,0
63560,1,3,222648,222650,222653,2,5,0
63561,2,1,222650,222653,222654,3,4,0
63562,1,2,222651,222654,222656,3,5,0
63563,5,2,222656,222656,222658,0,2,0
63564,2,3,222658,222658,222661,0,3,0
63565,3,2,222661,222661,222663,0,2,0
63566,2,1,222663,222663,222664,0,1,0
63567,5,1,222668,222668,222669,0,1,4
63568,5,2,222673,222673,222675,0,2,4
63569,2,2,222675,222675,222677,0,2,0
63570,4,1,222679,222679,222680,0,1,2
63571,4,3,222683,222683,222686,0,3,3
63572,2,1,222685,222686,222687,1,2,0
63573,2,3,222687,222687,222690,0,3,0
63574,4,2,222691,222691,222693,0,2,1
63575,1,2,222692,222693,222695,1,3,0
63576,1,3,222693,222695,222698,2,5,0
63577,3,3,222696,222698,222701,2,5,0
63578,2,3,222698,222701,222704,3,6,0
63579,6,2,222704,222704,222706,0,2,0
63580,3,2,222707,222707,222709,0,2,1
63581,2,2,222709,222709,222711,0,2,0
63582,6,2,222715,222715,222717,0,2,4
63583,3,2,222718,222718,222720,0,2,1
63584,2,1,222720,222720,222721,0,1,0
63585,3,3,222723,222723,222726,0,3,2
63586,5,1,222728,222728,222729,0,1,2
63587,2,2,222730,222730,222732,0,2,1
63588,3,3,222733,222733,222736,0,3,1
63589,3,2,222736,222736,222738,0,2,0
63590,6,3,222742,222742,222745,0,3,4
63591,1,2,222743,222745,222747,2,4,0
63592,3,3,222746,222747,222750,1,4,0
63593,3,1,222749,222750,222751,1,2,0
63594,3,3,222752,222752,222755,0,3,1
63595,6,3,222758,222758,222761,0,3,3
63596,1,1,222759,222761,222762,2,3,0
63597,3,3,222762,222762,222765,0,3,0
63598,4,3,222766,222766,222769,0,3,1
63599,4,3,222770,222770,222773,0,3,1
63600,1,3,222771,222773,222776,2,5,0
63601,1,3,222772,222776,222779,4,7,0
63602,3,2,222775,222779,222781,4,6,0
63603,4,3,222779,222781,222784,2,5,0
63604,4,1,222783,222784,222785,1,2,0
63605,4,3,222787,222787,222790,0,3,2
63606,6,3,222793,222793,222796,0,3,3
63607,2,3,222795,222796,222799,1,4,0
63608,2,1,222797,222799,222800,2,3,0
63609,4,3,222801,222801,222804,0,3,1
63610,2,2,222803,222804,222806,1,3,0
63611,4,2,222807,222807,222809,0,2,1
63612,5,3,222812,222812,222815,0,3,3
63613,4,1,222816,222816,222817,0,1,1
63614,4,3,222820,222820,222823,0,3,3
63615,2,2,222822,222823,222825,1,3,0
63616,6,1,222828,222828,222829,0,1,3
63617,6,1,222834,222834,222835,0,1,5
63618,6,2,222840,222840,222842,0,2,5
63619,5,1,222845,222845,222846,0,1,3
63620,2,1,222847,222847,222848,0,1,1
63621,4,1,222851,222851,222852,0,1,3
63622,2,2,222853,222853,222855,0,2,1
63623,4,2,222857,222857,222859,0,2,2
63624,3,1,222860,222860,222861,0,1,1
63625,1,1,222861,222861,222862,0,1,0
63626,3,3,222864,222864,222867,0,3,2
63627,5,3,222869,222869,222872,0,3,2
63628,4,2,222873,222873,222875,0,2,1
63629,3,3,222876,222876,222879,0,3,1
63630,6,2,222882,222882,222884,0,2,3
63631,1,2,222883,222884,222886,1,3,0
63632,1,2,222884,222886,222888,2,4,0
63633,3,3,222887,222888,222891,1,4,0
63634,1,2,222888,222891,222893,3,5,0
63635,1,2,222889,222893,222895,4,6,0
63636,5,2,222894,222895,222897,1,3,0
63637,3,2,222897,222897,222899,0,2,0
63638,5,3,222902,222902,222905,0,3,3
63639,2,1,222904,222905,222906,1,2,0
63640,3,3,222907,222907,222910,0,3,1
63641,3,1,222910,222910,222911,0,1,0
63642,3,3,222913,222913,222916,0,3,2
63643,1,3,222914,222916,222919,2,5,0
63644,4,1,222918,222919,222920,1,2,0
63645,1,3,222919,222920,222923,1,4,0
63646,1,2,222920,222923,222925,3,5,0
63647,3,3,222923,222925,222928,2,5,0
63648,4,2,222927,222928,222930,1,3,0
63649,3,3,222930,222930,222933,0,3,0
63650,3,1,222933,222933,222934,0,1,0
63651,5,2,222938,222938,222940,0,2,4
63652,1,3,222939,222940,222943,1,4,0
63653,4,3,222943,222943,222946,0,3,0
63654,1,3,222944,222946,222949,2,5,0
63655,2,2,222946,222949,222951,3,5,0
63656,4,2,222950,222951,222953,1,3,0
63657,6,1,222956,222956,222957,0,1,3
63658,3,2,222959,222959,222961,0,2,2
63659,1,2,222960,222961,222963,1,3,0
63660,5,3,222965,222965,222968,0,3,2
63661,2,3,222967,222968,222971,1,4,0
63662,5,2,222972,222972,222974,0,2,1
63663,1,2,222973,222974,222976,1,3,0
63664,3,1,222976,222976,222977,0,1,0
63665,1,3,222977,222977,222980,0,3,0
63666,4,1,222981,222981,222982,0,1,1
63667,4,2,222985,222985,222987,0,2,3
63668,5,1,222990,222990,222991,0,1,3
63669,5,3,222995,222995,222998,0,3,4
63670,1,3,222996,222998,223001,2,5,0
63671,5,1,223001,223001,223002,0,1,0
63672,5,1,223006,223006,223007,0,1,4
63673,6,2,223012,223012,223014,0,2,5
63674,2,2,223014,223014,223016,0,2,0
63675,5,3,223019,223019,223022,0,3,3
63676,2,3,223021,223022,223025,1,4,0
63677,3,2,223024,223025,223027,1,3,0
63678,5,3,223029,223029,223032,0,3,2
63679,3,2,223032,223032,223034,0,2,0
63680,5,3,223037,223037,223040,0,3,3
63681,1,2,223038,223040,223042,2,4,0
63682,2,2,223040,223042,223044,2,4,0
63683,1,1,223041,223044,223045,3,4,0
63684,2,1,223043,223045,223046,2,3,0
63685,3,3,223046,223046,223049,0,3,0
63686,2,3,223048,223049,223052,1,4,0
63687,2,2,223050,223052,223054,2,4,0
63688,5,1,223055,223055,223056,0,1,1
63689,4,1,223059,223059,223060,0,1,3
63690,3,2,223062,223062,223064,0,2,2
63691,3,3,223065,223065,223068,0,3,1
63692,3,1,223068,223068,223069,0,1,0
63693,2,1,223070,223070,223071,0,1,1
63694,4,1,223074,223074,223075,0,1,3
63695,4,3,223078,223078,223081,0,3,3
63696,6,1,223084,223084,223085,0,1,3
63697,1,1,223085,223085,223086,0,1,0
63698,3,1,223088,223088,223089,0,1,2
63699,5,1,223093,223093,223094,0,1,4
63700,5,2,223098,223098,223100,0,2,4
63701,3,1,223101,223101,223102,0,1,1
63702,3,2,223104,223104,223106,0,2,2
63703,4,2,223108,223108,223110,0,2,2
63704,1,3,223109,223110,223113,1,4,0
63705,5,1,223114,223114,223115,0,1,1
63706,1,2,223115,223115,223117,0,2,0
63707,3,2,223118,223118,223120,0,2,1
63708,2,3,223120,223120,223123,0,3,0
63709,1,3,223121,223123,223126,2,5,0
63710,4,3,223125,223126,223129,1,4,0
63711,6,2,223131,223131,223133,0,2,2
63712,1,2,223132,223133,223135,1,3,0
63713,3,3,223135,223135,223138,0,3,0
63714,6,2,223141,223141,223143,0,2,3
63715,2,1,223143,223143,223144,0,1,0
63716,1,2,223144,223144,223146,0,2,0
63717,6,2,223150,223150,223152,0,2,4
63718,1,3,223151,223152,223155,1,4,0
63719,5,2,223156,223156,223158,0,2,1
63720,2,3,223158,223158,223161,0,3,0
63721,4,1,223162,223162,223163,0,1,1
63722,6,1,223168,223168,223169,0,1,5
63723,2,1,223170,223170,223171,0,1,1
63724,3,1,223173,223173,223174,0,1,2
63725,6,2,223179,223179,223181,0,2,5
63726,2,2,223181,223181,223183,0,2,0
63727,6,1,223187,223187,223188,0,1,4
63728,5,2,223192,223192,223194,0,2,4
63729,1,1,223193,223194,223195,1,2,0
63730,2,2,223195,223195,223197,0,2,0
63731,4,1,223199,223199,223200,0,1,2
63732,6,3,223205,223205,223208,0,3,5
63733,4,2,223209,223209,223211,0,2,1
63734,5,1,223214,223214,223215,0,1,3
63735,6,1,223220,223220,223221,0,1,5
63736,1,2,223221,223221,223223,0,2,0
63737,6,2,223227,223227,223229,0,2,4
63738,6,3,223233,223233,223236,0,3,4
63739,3,1,223236,223236,223237,0,1,0
63740,2,1,223238,223238,223239,0,1,1
63741,3,3,223241,223241,223244,0,3,2
63742,5,2,223246,223246,223248,0,2,2
63743,5,3,223251,223251,223254,0,3,3
63744,1,3,223252,223254,223257,2,5,0
63745,2,3,223254,223257,223260,3,6,0
63746,5,1,223259,223260,223261,1,2,0
63747,4,2,223263,223263,223265,0,2,2
63748,1,3,223264,223265,223268,1,4,0
63749,2,2,223266,223268,223270,2,4,0
63750,5,1,223271,223271,223272,0,1,1
63751,6,1,223277,223277,223278,0,1,5
63752,2,3,223279,223279,223282,0,3,1
63753,1,3,223280,223282,223285,2,5,0
63754,4,2,223284,223285,223287,1,3,0
63755,4,1,223288,223288,223289,0,1,1
63756,3,2,223291,223291,223293,0,2,2
63757,5,3,223296,223296,223299,0,3,3
63758,5,3,223301,223301,223304,0,3,2
63759,1,2,223302,223304,223306,2,4,0
63760,6,1,223308,223308,223309,0,1,2
63761,6,1,223314,223314,223315,0,1,5
63762,4,1,223318,223318,223319,0,1,3
63763,6,1,223324,223324,223325,0,1,5
63764,1,1,223325,223325,223326,0,1,0
63765,6,2,223331,223331,223333,0,2,5
63766,6,2,223337,223337,223339,0,2,4
63767,5,3,223342,223342,223345,0,3,3
63768,3,1,223345,223345,223346,0,1,0
63769,5,2,223350,223350,223352,0,2,4
63770,4,1,223354,223354,223355,0,1,2
63771,1,3,223355,223355,223358,0,3,0
63772,1,3,223356,223358,223361,2,5,0
63773,6,1,223362,223362,223363,0,1,1
63774,3,1,223365,223365,223366,0,1,2
63775,6,2,223371,223371,223373,0,2,5
63776,4,2,223375,223375,223377,0,2,2
63777,4,3,223379,223379,223382,0,3,2
63778,2,3,223381,223382,223385,1,4,0
63779,3,1,223384,223385,223386,1,2,0
63780,6,2,223390,223390,223392,0,2,4
63781,2,3,223392,223392,223395,0,3,0
63782,4,1,223396,223396,223397,0,1,1
63783,5,2,223401,223401,223403,0,2,4
63784,5,3,223406,223406,223409,0,3,3
63785,5,1,223411,223411,223412,0,1,2
63786,4,1,223415,223415,223416,0,1,3
63787,4,1,223419,223419,223420,0,1,3
63788,2,1,223421,223421,223422,0,1,1
63789,4,3,223425,223425,223428,0,3,3
63790,1,2,223426,223428,223430,2,4,0
63791,4,1,223430,223430,223431,0,1,0
63792,5,3,223435,223435,223438,0,3,4
63793,1,2,223436,223438,223440,2,4,0
63794,2,2,223438,223440,223442,2,4,0
63795,3,3,223441,223442,223445,1,4,0
63796,2,1,223443,223445,223446,2,3,0
63797,5,2,223448,223448,223450,0,2,2
63798,4,2,223452,223452,223454,0,2,2
63799,3,1,223455,223455,223456,0,1,1
63800,5,2,223460,223460,223462,0,2,4
63801,3,2,223463,223463,223465,0,2,1
63802,3,3,223466,223466,223469,0,3,1
63803,1,1,223467,223469,223470,2,3,0
63804,5,3,223472,223472,223475,0,3,2
63805,3,1,223475,223475,223476,0,1,0
63806,2,1,223477,223477,223478,0,1,1
63807,1,3,223478,223478,223481,0,3,0
63808,3,3,223481,223481,223484,0,3,0
63809,4,2,223485,223485,223487,0,2,1
63810,4,2,223489,223489,223491,0,2,2
63811,2,1,223491,223491,223492,0,1,0
63812,2,2,223493,223493,223495,0,2,1
63813,6,2,223499,223499,223501,0,2,4
63814,5,2,223504,223504,223506,0,2,3
63815,1,3,223505,223506,223509,1,4,0
63816,1,3,223506,223509,223512,3,6,0
63817,6,2,223512,223512,223514,0,2,0
63818,1,1,223513,223514,223515,1,2,0
63819,4,3,223517,223517,223520,0,3,2
63820,6,3,223523,223523,223526,0,3,3
63821,2,1,223525,223526,223527,1,2,0
63822,1,2,223526,223527,223529,1,3,0
63823,5,1,223531,223531,223532,0,1,2
63824,6,3,223537,223537,223540,0,3,5
63825,3,2,223540,223540,223542,0,2,0
63826,6,2,223546,223546,223548,0,2,4
63827,1,2,223547,223548,223550,1,3,0
63828,4,3,223551,223551,223554,0,3,1
63829,3,3,223554,223554,223557,0,3,0
63830,2,1,223556,223557,223558,1,2,0
63831,2,1,223558,223558,223559,0,1,0
63832,2,3,223560,223560,223563,0,3,1
63833,2,2,223562,223563,223565,1,3,0
63834,3,3,223565,223565,223568,0,3,0
63835,6,3,223571,223571,223574,0,3,3
63836,3,1,223574,223574,223575,0,1,0
63837,5,2,223579,223579,223581,0,2,4
63838,6,1,223585,223585,223586,0,1,4
63839,5,3,223590,223590,223593,0,3,4
63840,4,1,223594,223594,223595,0,1,1
63841,1,2,223595,223595,223597,0,2,0
63842,3,2,223598,223598,223600,0,2,1
63843,5,3,223603,223603,223606,0,3,3
63844,1,1,223604,223606,223607,2,3,0
63845,4,1,223608,223608,223609,0,1,1
63846,3,1,223611,223611,223612,0,1,2
63847,4,2,223615,223615,223617,0,2,3
63848,6,2,223621,223621,223623,0,2,4
63849,1,2,223622,223623,223625,1,3,0
63850,4,1,223626,223626,223627,0,1,1
63851,4,1,223630,223630,223631,0,1,3
63852,4,1,223634,223634,223635,0,1,3
63853,4,1,223638,223638,223639,0,1,3
63854,6,1,223644,223644,223645,0,1,5
63855,3,3,223647,223647,223650,0,3,2
63856,3,3,223650,223650,223653,0,3,0
63857,5,1,223655,223655,223656,0,1,2
63858,2,3,223657,223657,223660,0,3,1
63859,5,3,223662,223662,223665,0,3,2
63860,2,3,223664,223665,223668,1,4,0
63861,5,3,223669,223669,223672,0,3,1
63862,2,2,223671,223672,223674,1,3,0
63863,5,1,223676,223676,223677,0,1,2
63864,6,2,223682,223682,223684,0,2,5
63865,3,1,223685,223685,223686,0,1,1
63866,6,2,223691,223691,223693,0,2,5
63867,4,2,223695,223695,223697,0,2,2
63868,5,2,223700,223700,223702,0,2,3
63869,3,1,223703,223703,223704,0,1,1
63870,6,1,223709,223709,223710,0,1,5
63871,4,1,223713,223713,223714,0,1,3
63872,4,3,223717,223717,223720,0,3,3
63873,5,1,223722,223722,223723,0,1,2
63874,6,1,223728,223728,223729,0,1,5
63875,3,2,223731,223731,223733,0,2,2
63876,1,3,223732,223733,223736,1,4,0
63877,1,1,223733,223736,223737,3,4,0
63878,4,3,223737,223737,223740,0,3,0
63879,5,1,223742,223742,223743,0,1,2
63880,4,2,223746,223746,223748,0,2,3
63881,5,1,223751,223751,223752,0,1,3
63882,5,1,223756,223756,223757,0,1,4
63883,4,3,223760,223760,223763,0,3,3
63884,4,1,223764,223764,223765,0,1,1
63885,6,2,223770,223770,223772,0,2,5
63886,3,1,223773,223773,223774,0,1,1
63887,4,2,223777,223777,223779,0,2,3
63888,3,1,223780,223780,223781,0,1,1
63889,6,3,223786,223786,223789,0,3,5
63890,2,3,223788,223789,223792,1,4,0
63891,1,2,223789,223792,223794,3,5,0
63892,6,3,223795,223795,223798,0,3,1
63893,1,1,223796,223798,223799,2,3,0
63894,2,1,223798,223799,223800,1,2,0
63895,3,1,223801,223801,223802,0,1,1
63896,2,2,223803,223803,223805,0,2,1
63897,4,2,223807,223807,223809,0,2,2
63898,5,1,223812,223812,223813,0,1,3
63899,4,1,223816,223816,223817,0,1,3
63900,1,2,223817,223817,223819,0,2,0
63901,5,2,223822,223822,223824,0,2,3
63902,2,1,223824,223824,223825,0,1,0
63903,3,1,223827,223827,223828,0,1,2
63904,3,1,223830,223830,223831,0,1,2
63905,2,1,223832,223832,223833,0,1,1
63906,2,2,223834,223834,223836,0,2,1
63907,3,2,223837,223837,223839,0,2,1
63908,1,2,223838,223839,223841,1,3,0
63909,5,2,223843,223843,223845,0,2,2
63910,2,1,223845,223845,223846,0,1,0
63911,3,2,223848,223848,223850,0,2,2
63912,2,2,223850,223850,223852,0,2,0
63913,3,2,223853,223853,223855,0,2,1
63914,5,3,223858,223858,223861,0,3,3
63915,4,3,223862,223862,223865,0,3,1
63916,6,1,223868,223868,223869,0,1,3
63917,4,1,223872,223872,223873,0,1,3
63918,3,1,223875,223875,223876,0,1,2
63919,2,2,223877,223877,223879,0,2,1
63920,4,1,223881,223881,223882,0,1,2
63921,4,2,223885,223885,223887,0,2,3
63922,6,2,223891,223891,223893,0,2,4
63923,4,1,223895,223895,223896,0,1,2
63924,3,1,223898,223898,223899,0,1,2
63925,6,3,223904,223904,223907,0,3,5
63926,6,3,223910,223910,223913,0,3,3
63927,3,2,223913,223913,223915,0,2,0
63928,5,3,223918,223918,223921,0,3,3
63929,4,2,223922,223922,223924,0,2,1
63930,5,1,223927,223927,223928,0,1,3
63931,5,3,223932,223932,223935,0,3,4
63932,4,3,223936,223936,223939,0,3,1
63933,3,1,223939,223939,223940,0,1,0
63934,4,1,223943,223943,223944,0,1,3
63935,5,3,223948,223948,223951,0,3,4
63936,5,1,223953,223953,223954,0,1,2
63937,5,3,223958,223958,223961,0,3,4
63938,5,2,223963,223963,223965,0,2,2
63939,3,3,223966,223966,223969,0,3,1
63940,2,1,223968,223969,223970,1,2,0
63941,2,1,223970,223970,223971,0,1,0
63942,3,3,223973,223973,223976,0,3,2
63943,3,1,223976,223976,223977,0,1,0
63944,6,3,223982,223982,223985,0,3,5
63945,1,3,223983,223985,223988,2,5,0
63946,1,2,223984,223988,223990,4,6,0
63947,1,2,223985,223990,223992,5,7,0
63948,6,1,223991,223992,223993,1,2,0
63949,6,1,223997,223997,223998,0,1,4
63950,1,1,223998,223998,223999,0,1,0
63951,6,2,224004,224004,224006,0,2,5
63952,2,3,224006,224006,224009,0,3,0
63953,4,3,224010,224010,224013,0,3,1
63954,6,3,224016,224016,224019,0,3,3
63955,5,1,224021,224021,224022,0,1,2
63956,2,1,224023,224023,224024,0,1,1
63957,6,2,224029,224029,224031,0,2,5
63958,3,3,224032,224032,224035,0,3,1
63959,2,2,224034,224035,224037,1,3,0
63960,3,2,224037,224037,224039,0,2,0
63961,3,1,224040,224040,224041,0,1,1
63962,6,3,224046,224046,224049,0,3,5
63963,2,1,224048,224049,224050,1,2,0
63964,4,3,224052,224052,224055,0,3,2
63965,5,2,224057,224057,224059,0,2,2
63966,6,1,224063,224063,224064,0,1,4
63967,1,2,224064,224064,224066,0,2,0
63968,3,1,224067,224067,224068,0,1,1
63969,3,2,224070,224070,224072,0,2,2
63970,4,2,224074,224074,224076,0,2,2
63971,3,2,224077,224077,224079,0,2,1
63972,2,3,224079,224079,224082,0,3,0
63973,4,3,224083,224083,224086,0,3,1
63974,4,1,224087,224087,224088,0,1,1
63975,6,1,224093,224093,224094,0,1,5
63976,4,1,224097,224097,224098,0,1,3
63977,6,1,224103,224103,224104,0,1,5
63978,4,3,224107,224107,224110,0,3,3
63979,5,3,224112,224112,224115,0,3,2
63980,1,2,224113,224115,224117,2,4,0
63981,6,3,224119,224119,224122,0,3,2
63982,5,2,224124,224124,224126,0,2,2
63983,5,1,224129,224129,224130,0,1,3
63984,3,2,224132,224132,224134,0,2,2
63985,5,2,224137,224137,224139,0,2,3
63986,5,3,224142,224142,224145,0,3,3
63987,6,3,224148,224148,224151,0,3,3
63988,6,3,224154,224154,224157,0,3,3
63989,2,3,224156,224157,224160,1,4,0
63990,5,1,224161,224161,224162,0,1,1
63991,1,3,224162,224162,224165,0,3,0
63992,2,2,224164,224165,224167,1,3,0
63993,6,2,224170,224170,224172,0,2,3
63994,6,2,224176,224176,224178,0,2,4
63995,2,3,224178,224178,224181,0,3,0
63996,1,3,224179,224181,224184,2,5,0
63997,1,3,224180,224184,224187,4,7,0
63998,6,2,224186,224187,224189,1,3,0
63999,2,3,224188,224189,224192,1,4,0
64000,3,2,224191,224192,224194,1,3,0
64001,1,3,224192,224194,224197,2,5,0
64002,5,1,224197,224197,224198,0,1,0
64003,4,3,224201,224201,224204,0,3,3
64004,4,3,224205,224205,224208,0,3,1
64005,3,1,224208,224208,224209,0,1,0
64006,5,1,224213,224213,224214,0,1,4
64007,1,1,224214,224214,224215,0,1,0
64008,4,3,224218,224218,224221,0,3,3
64009,4,3,224222,224222,224225,0,3,1
64010,3,1,224225,224225,224226,0,1,0
64011,2,3,224227,224227,224230,0,3,1
64012,2,3,224229,224230,224233,1,4,0
64013,1,1,224230,224233,224234,3,4,0
64014,3,3,224233,224234,224237,1,4,0
64015,3,1,224236,224237,224238,1,2,0
64016,6,1,224242,224242,224243,0,1,4
64017,4,3,224246,224246,224249,0,3,3
64018,5,3,224251,224251,224254,0,3,2
64019,5,1,224256,224256,224257,0,1,2
64020,4,2,224260,224260,224262,0,2,3
64021,2,2,224262,224262,224264,0,2,0
64022,3,2,224265,224265,224267,0,2,1
64023,5,1,224270,224270,224271,0,1,3
64024,6,1,224276,224276,224277,0,1,5
64025,2,2,224278,224278,224280,0,2,1
64026,6,2,224284,224284,224286,0,2,4
64027,6,1,224290,224290,224291,0,1,4
64028,1,1,224291,224291,224292,0,1,0
64029,4,1,224295,224295,224296,0,1,3
64030,5,3,224300,224300,224303,0,3,4
64031,3,2,224303,224303,224305,0,2,0
64032,6,3,224309,224309,224312,0,3,4
64033,1,2,224310,224312,224314,2,4,0
64034,1,3,224311,224314,224317,3,6,0
64035,1,2,224312,224317,224319,5,7,0
64036,5,1,224317,224319,224320,2,3,0
64037,2,3,224319,224320,224323,1,4,0
64038,3,2,224322,224323,224325,1,3,0
64039,4,1,224326,224326,224327,0,1,1
64040,2,2,224328,224328,224330,0,2,1
64041,5,3,224333,224333,224336,0,3,3
64042,1,1,224334,224336,224337,2,3,0
64043,3,3,224337,224337,224340,0,3,0
64044,2,3,224339,224340,224343,1,4,0
64045,2,2,224341,224343,224345,2,4,0
64046,2,2,224343,224345,224347,2,4,0
64047,3,1,224346,224347,224348,1,2,0
64048,5,1,224351,224351,224352,0,1,3
64049,6,1,224357,224357,224358,0,1,5
64050,5,1,224362,224362,224363,0,1,4
64051,1,3,224363,224363,224366,0,3,0
64052,4,3,224367,224367,224370,0,3,1
64053,4,3,224371,224371,224374,0,3,1
64054,4,1,224375,224375,224376,0,1,1
64055,2,2,224377,224377,224379,0,2,1
64056,4,1,224381,224381,224382,0,1,2
64057,1,1,224382,224382,224383,0,1,0
64058,3,1,224385,224385,224386,0,1,2
64059,3,1,224388,224388,224389,0,1,2
64060,3,3,224391,224391,224394,0,3,2
64061,2,3,224393,224394,224397,1,4,0
64062,6,2,224399,224399,224401,0,2,2
64063,1,3,224400,224401,224404,1,4,0
64064,1,3,224401,224404,224407,3,6,0
64065,2,1,224403,224407,224408,4,5,0
64066,3,2,224406,224408,224410,2,4,0
64067,1,2,224407,224410,224412,3,5,0
64068,6,2,224413,224413,224415,0,2,1
64069,2,1,224415,224415,224416,0,1,0
64070,4,3,224419,224419,224422,0,3,3
64071,1,2,224420,224422,224424,2,4,0
64072,1,3,224421,224424,224427,3,6,0
64073,6,2,224427,224427,224429,0,2,0
64074,5,3,224432,224432,224435,0,3,3
64075,1,1,224433,224435,224436,2,3,0
64076,4,2,224437,224437,224439,0,2,1
64077,4,1,224441,224441,224442,0,1,2
64078,5,3,224446,224446,224449,0,3,4
64079,2,1,224448,224449,224450,1,2,0
64080,3,3,224451,224451,224454,0,3,1
64081,6,1,224457,224457,224458,0,1,3
64082,4,2,224461,224461,224463,0,2,3
64083,2,3,224463,224463,224466,0,3,0
64084,2,3,224465,224466,224469,1,4,0
64085,1,1,224466,224469,224470,3,4,0
64086,4,2,224470,224470,224472,0,2,0
64087,3,1,224473,224473,224474,0,1,1
64088,2,3,224475,224475,224478,0,3,1
64089,1,1,224476,224478,224479,2,3,0
64090,6,1,224482,224482,224483,0,1,3
64091,3,1,224485,224485,224486,0,1,2
64092,3,2,224488,224488,224490,0,2,2
64093,4,3,224492,224492,224495,0,3,2
64094,5,1,224497,224497,224498,0,1,2
64095,3,2,224500,224500,224502,0,2,2
64096,4,3,224504,224504,224507,0,3,2
64097,4,3,224508,224508,224511,0,3,1
64098,1,3,224509,224511,224514,2,5,0
64099,4,2,224513,224514,224516,1,3,0
64100,2,2,224515,224516,224518,1,3,0
64101,3,1,224518,224518,224519,0,1,0
64102,4,3,224522,224522,224525,0,3,3
64103,4,1,224526,224526,224527,0,1,1
64104,6,1,224532,224532,224533,0,1,5
64105,1,2,224533,224533,224535,0,2,0
64106,1,2,224534,224535,224537,1,3,0
64107,2,3,224536,224537,224540,1,4,0
64108,1,2,224537,224540,224542,3,5,0
64109,6,2,224543,224543,224545,0,2,1
64110,2,3,224545,224545,224548,0,3,0
64111,2,3,224547,224548,224551,1,4,0
64112,4,2,224551,224551,224553,0,2,0
64113,5,3,224556,224556,224559,0,3,3
64114,5,2,224561,224561,224563,0,2,2
64115,3,2,224564,224564,224566,0,2,1
64116,1,2,224565,224566,224568,1,3,0
64117,5,1,224570,224570,224571,0,1,2
64118,5,3,224575,224575,224578,0,3,4
64119,3,1,224578,224578,224579,0,1,0
64120,5,2,224583,224583,224585,0,2,4
64121,4,3,224587,224587,224590,0,3,2
64122,4,3,224591,224591,224594,0,3,1
64123,5,2,224596,224596,224598,0,2,2
64124,3,3,224599,224599,224602,0,3,1
64125,2,1,224601,224602,224603,1,2,0
64126,3,1,224604,224604,224605,0,1,1
64127,4,3,224608,224608,224611,0,3,3
64128,1,3,224609,224611,224614,2,5,0
64129,2,2,224611,224614,224616,3,5,0
64130,4,2,224615,224616,224618,1,3,0
64131,4,1,224619,224619,224620,0,1,1
64132,5,3,224624,224624,224627,0,3,4
64133,3,1,224627,224627,224628,0,1,0
64134,6,2,224633,224633,224635,0,2,5
64135,2,3,224635,224635,224638,0,3,0
64136,2,1,224637,224638,224639,1,2,0
64137,3,1,224640,224640,224641,0,1,1
64138,3,1,224643,224643,224644,0,1,2
64139,6,3,224649,224649,224652,0,3,5
64140,3,3,224652,224652,224655,0,3,0
64141,6,2,224658,224658,224660,0,2,3
64142,4,2,224662,224662,224664,0,2,2
64143,2,1,224664,224664,224665,0,1,0
64144,4,1,224668,224668,224669,0,1,3
64145,1,3,224669,224669,224672,0,3,0
64146,1,3,224670,224672,224675,2,5,0
64147,1,1,224671,224675,224676,4,5,0
64148,5,1,224676,224676,224677,0,1,0
64149,5,2,224681,224681,224683,0,2,4
64150,1,3,224682,224683,224686,1,4,0
64151,1,1,224683,224686,224687,3,4,0
64152,4,2,224687,224687,224689,0,2,0
64153,1,1,224688,224689,224690,1,2,0
64154,6,3,224694,224694,224697,0,3,4
64155,3,3,224697,224697,224700,0,3,0
64156,4,3,224701,224701,224704,0,3,1
64157,4,3,224705,224705,224708,0,3,1
64158,6,2,224711,224711,224713,0,2,3
64159,6,1,224717,224717,224718,0,1,4
64160,2,2,224719,224719,224721,0,2,1
64161,6,3,224725,224725,224728,0,3,4
64162,2,3,224727,224728,224731,1,4,0
64163,3,1,224730,224731,224732,1,2,0
64164,4,1,224734,224734,224735,0,1,2
64165,6,1,224740,224740,224741,0,1,5
64166,1,3,224741,224741,224744,0,3,0
64167,4,1,224745,224745,224746,0,1,1
64168,4,3,224749,224749,224752,0,3,3
64169,6,2,224755,224755,224757,0,2,3
64170,2,2,224757,224757,224759,0,2,0
64171,1,1,224758,224759,224760,1,2,0
64172,5,2,224763,224763,224765,0,2,3
64173,2,2,224765,224765,224767,0,2,0
64174,5,1,224770,224770,224771,0,1,3
64175,2,2,224772,224772,224774,0,2,1
64176,6,1,224778,224778,224779,0,1,4
64177,1,1,224779,224779,224780,0,1,0
64178,4,1,224783,224783,224784,0,1,3
64179,3,2,224786,224786,224788,0,2,2
64180,3,3,224789,224789,224792,0,3,1
64181,5,1,224794,224794,224795,0,1,2
64182,5,3,224799,224799,224802,0,3,4
64183,6,2,224805,224805,224807,0,2,3
64184,6,1,224811,224811,224812,0,1,4
64185,5,3,224816,224816,224819,0,3,4
64186,3,3,224819,224819,224822,0,3,0
64187,4,2,224823,224823,224825,0,2,1
64188,1,2,224824,224825,224827,1,3,0
64189,4,1,224828,224828,224829,0,1,1
64190,4,2,224832,224832,224834,0,2,3
64191,1,2,224833,224834,224836,1,3,0
64192,5,3,224838,224838,224841,0,3,2
64193,3,3,224841,224841,224844,0,3,0
64194,3,2,224844,224844,224846,0,2,0
64195,4,3,224848,224848,224851,0,3,2
64196,4,1,224852,224852,224853,0,1,1
64197,2,1,224854,224854,224855,0,1,1
64198,4,1,224858,224858,224859,0,1,3
64199,3,3,224861,224861,224864,0,3,2
64200,3,2,224864,224864,224866,0,2,0
64201,4,3,224868,224868,224871,0,3,2
64202,4,2,224872,224872,224874,0,2,1
64203,4,2,224876,224876,224878,0,2,2
64204,4,1,224880,224880,224881,0,1,2
64205,4,2,224884,224884,224886,0,2,3
64206,1,1,224885,224886,224887,1,2,0
64207,2,3,224887,224887,224890,0,3,0
64208,2,3,224889,224890,224893,1,4,0
64209,5,1,224894,224894,224895,0,1,1
64210,3,3,224897,224897,224900,0,3,2
64211,2,1,224899,224900,224901,1,2,0
64212,4,3,224903,224903,224906,0,3,2
64213,6,2,224909,224909,224911,0,2,3
64214,3,2,224912,224912,224914,0,2,1
64215,6,3,224918,224918,224921,0,3,4
64216,2,3,224920,224921,224924,1,4,0
64217,6,3,224926,224926,224929,0,3,2
64218,6,3,224932,224932,224935,0,3,3
64219,4,3,224936,224936,224939,0,3,1
64220,1,3,224937,224939,224942,2,5,0
64221,4,3,224941,224942,224945,1,4,0
64222,2,1,224943,224945,224946,2,3,0
64223,2,2,224945,224946,224948,1,3,0
64224,4,1,224949,224949,224950,0,1,1
64225,2,3,224951,224951,224954,0,3,1
64226,2,1,224953,224954,224955,1,2,0
64227,5,1,224958,224958,224959,0,1,3
64228,3,3,224961,224961,224964,0,3,2
64229,5,2,224966,224966,224968,0,2,2
64230,5,1,224971,224971,224972,0,1,3
64231,1,3,224972,224972,224975,0,3,0
64232,2,1,224974,224975,224976,1,2,0
64233,4,3,224978,224978,224981,0,3,2
64234,1,2,224979,224981,224983,2,4,0
64235,2,3,224981,224983,224986,2,5,0
64236,3,2,224984,224986,224988,2,4,0
64237,6,2,224990,224990,224992,0,2,2
64238,5,1,224995,224995,224996,0,1,3
64239,4,2,224999,224999,225001,0,2,3
64240,1,3,225000,225001,225004,1,4,0
64241,6,2,225006,225006,225008,0,2,2
64242,6,3,225012,225012,225015,0,3,4
64243,5,1,225017,225017,225018,0,1,2
64244,2,3,225019,225019,225022,0,3,1
64245,1,1,225020,225022,225023,2,3,0
64246,3,1,225023,225023,225024,0,1,0
64247,6,2,225029,225029,225031,0,2,5
64248,4,2,225033,225033,225035,0,2,2
64249,6,3,225039,225039,225042,0,3,4
64250,2,3,225041,225042,225045,1,4,0
64251,1,3,225042,225045,225048,3,6,0
64252,5,1,225047,225048,225049,1,2,0
64253,4,2,225051,225051,225053,0,2,2
64254,1,2,225052,225053,225055,1,3,0
64255,6,1,225058,225058,225059,0,1,3
64256,5,2,225063,225063,225065,0,2,4
64257,1,1,225064,225065,225066,1,2,0
64258,2,3,225066,225066,225069,0,3,0
64259,2,1,225068,225069,225070,1,2,0
64260,3,1,225071,225071,225072,0,1,1
64261,2,1,225073,225073,225074,0,1,1
64262,2,2,225075,225075,225077,0,2,1
64263,6,2,225081,225081,225083,0,2,4
64264,2,3,225083,225083,225086,0,3,0
64265,4,3,225087,225087,225090,0,3,1
64266,1,1,225088,225090,225091,2,3,0
64267,5,2,225093,225093,225095,0,2,2
64268,1,2,225094,225095,225097,1,3,0
64269,3,3,225097,225097,225100,0,3,0
64270,2,2,225099,225100,225102,1,3,0
64271,4,3,225103,225103,225106,0,3,1
64272,5,2,225108,225108,225110,0,2,2
64273,3,1,225111,225111,225112,0,1,1
64274,5,3,225116,225116,225119,0,3,4
64275,6,3,225122,225122,225125,0,3,3
64276,1,1,225123,225125,225126,2,3,0
64277,1,2,225124,225126,225128,2,4,0
64278,4,1,225128,225128,225129,0,1,0
64279,1,2,225129,225129,225131,0,2,0
64280,1,2,225130,225131,225133,1,3,0
64281,4,2,225134,225134,225136,0,2,1
64282,3,1,225137,225137,225138,0,1,1
64283,2,3,225139,225139,225142,0,3,1
64284,1,2,225140,225142,225144,2,4,0
64285,1,1,225141,225144,225145,3,4,0
64286,4,1,225145,225145,225146,0,1,0
64287,5,3,225150,225150,225153,0,3,4
64288,6,1,225156,225156,225157,0,1,3
64289,6,2,225162,225162,225164,0,2,5
64290,4,3,225166,225166,225169,0,3,2
64291,6,1,225172,225172,225173,0,1,3
64292,1,2,225173,225173,225175,0,2,0
64293,3,1,225176,225176,225177,0,1,1
64294,4,1,225180,225180,225181,0,1,3
64295,2,2,225182,225182,225184,0,2,1
64296,6,3,225188,225188,225191,0,3,4
64297,4,3,225192,225192,225195,0,3,1
64298,6,3,225198,225198,225201,0,3,3
64299,1,1,225199,225201,225202,2,3,0
64300,1,1,225200,225202,225203,2,3,0
64301,2,3,225202,225203,225206,1,4,0
64302,5,2,225207,225207,225209,0,2,1
64303,2,1,225209,225209,225210,0,1,0
64304,4,2,225213,225213,225215,0,2,3
64305,1,3,225214,225215,225218,1,4,0
64306,1,2,225215,225218,225220,3,5,0
64307,4,1,225219,225220,225221,1,2,0
64308,5,2,225224,225224,225226,0,2,3
64309,2,3,225226,225226,225229,0,3,0
64310,3,2,225229,225229,225231,0,2,0
64311,6,2,225235,225235,225237,0,2,4
64312,5,3,225240,225240,225243,0,3,3
64313,4,1,225244,225244,225245,0,1,1
64314,1,3,225245,225245,225248,0,3,0
64315,6,3,225251,225251,225254,0,3,3
64316,6,2,225257,225257,225259,0,2,3
64317,3,1,225260,225260,225261,0,1,1
64318,5,3,225265,225265,225268,0,3,4
64319,5,2,225270,225270,225272,0,2,2
64320,2,2,225272,225272,225274,0,2,0
64321,2,1,225274,225274,225275,0,1,0
64322,5,2,225279,225279,225281,0,2,4
64323,1,2,225280,225281,225283,1,3,0
64324,6,2,225286,225286,225288,0,2,3
64325,5,2,225291,225291,225293,0,2,3
64326,2,3,225293,225293,225296,0,3,0
64327,4,1,225297,225297,225298,0,1,1
64328,5,3,225302,225302,225305,0,3,4
64329,4,1,225306,225306,225307,0,1,1
64330,1,3,225307,225307,225310,0,3,0
64331,2,3,225309,225310,225313,1,4,0
64332,2,2,225311,225313,225315,2,4,0
64333,5,2,225316,225316,225318,0,2,1
64334,2,3,225318,225318,225321,0,3,0
64335,3,2,225321,225321,225323,0,2,0
64336,1,3,225322,225323,225326,1,4,0
64337,4,2,225326,225326,225328,0,2,0
64338,3,2,225329,225329,225331,0,2,1
64339,5,2,225334,225334,225336,0,2,3
64340,2,3,225336,225336,225339,0,3,0
64341,2,2,225338,225339,225341,1,3,0
64342,3,1,225341,225341,225342,0,1,0
64343,3,2,225344,225344,225346,0,2,2
64344,4,1,225348,225348,225349,0,1,2
64345,4,2,225352,225352,225354,0,2,3
64346,6,2,225358,225358,225360,0,2,4
64347,1,2,225359,225360,225362,1,3,0
64348,6,1,225365,225365,225366,0,1,3
64349,3,2,225368,225368,225370,0,2,2
64350,2,3,225370,225370,225373,0,3,0
64351,6,1,225376,225376,225377,0,1,3
64352,1,1,225377,225377,225378,0,1,0
64353,2,1,225379,225379,225380,0,1,1
64354,5,2,225384,225384,225386,0,2,4
64355,6,2,225390,225390,225392,0,2,4
64356,3,3,225393,225393,225396,0,3,1
64357,3,2,225396,225396,225398,0,2,0
64358,4,1,225400,225400,225401,0,1,2
64359,2,2,225402,225402,225404,0,2,1
64360,5,2,225407,225407,225409,0,2,3
64361,1,2,225408,225409,225411,1,3,0
64362,5,1,225413,225413,225414,0,1,2
64363,3,3,225416,225416,225419,0,3,2
64364,3,1,225419,225419,225420,0,1,0
64365,5,2,225424,225424,225426,0,2,4
64366,6,2,225430,225430,225432,0,2,4
64367,6,1,225436,225436,225437,0,1,4
64368,6,1,225442,225442,225443,0,1,5
64369,2,3,225444,225444,225447,0,3,1
64370,5,3,225449,225449,225452,0,3,2
64371,2,3,225451,225452,225455,1,4,0
64372,6,1,225457,225457,225458,0,1,2
64373,6,1,225463,225463,225464,0,1,5
64374,4,3,225467,225467,225470,0,3,3
64375,1,1,225468,225470,225471,2,3,0
64376,1,2,225469,225471,225473,2,4,0
64377,5,3,225474,225474,225477,0,3,1
64378,4,2,225478,225478,225480,0,2,1
64379,5,2,225483,225483,225485,0,2,3
64380,2,3,225485,225485,225488,0,3,0
64381,5,3,225490,225490,225493,0,3,2
64382,1,3,225491,225493,225496,2,5,0
64383,4,1,225495,225496,225497,1,2,0
64384,1,2,225496,225497,225499,1,3,0
64385,6,1,225502,225502,225503,0,1,3
64386,6,1,225508,225508,225509,0,1,5
64387,3,1,225511,225511,225512,0,1,2
64388,5,2,225516,225516,225518,0,2,4
64389,2,2,225518,225518,225520,0,2,0
64390,5,3,225523,225523,225526,0,3,3
64391,5,3,225528,225528,225531,0,3,2
64392,1,3,225529,225531,225534,2,5,0
64393,6,1,225535,225535,225536,0,1,1
64394,5,1,225540,225540,225541,0,1,4
64395,5,2,225545,225545,225547,0,2,4
64396,4,2,225549,225549,225551,0,2,2
64397,2,2,225551,225551,225553,0,2,0
64398,6,1,225557,225557,225558,0,1,4
64399,4,3,225561,225561,225564,0,3,3
64400,3,2,225564,225564,225566,0,2,0
64401,6,3,225570,225570,225573,0,3,4
64402,1,2,225571,225573,225575,2,4,0
64403,3,1,225574,225575,225576,1,2,0
64404,1,3,225575,225576,225579,1,4,0
64405,3,3,225578,225579,225582,1,4,0
64406,4,1,225582,225582,225583,0,1,0
64407,2,2,225584,225584,225586,0,2,1
64408,2,3,225586,225586,225589,0,3,0
64409,5,3,225591,225591,225594,0,3,2
64410,5,3,225596,225596,225599,0,3,2
64411,4,2,225600,225600,225602,0,2,1
64412,3,1,225603,225603,225604,0,1,1
64413,3,1,225606,225606,225607,0,1,2
64414,3,3,225609,225609,225612,0,3,2
64415,2,1,225611,225612,225613,1,2,0
64416,5,2,225616,225616,225618,0,2,3
64417,3,1,225619,225619,225620,0,1,1
64418,5,2,225624,225624,225626,0,2,4
64419,6,2,225630,225630,225632,0,2,4
64420,6,3,225636,225636,225639,0,3,4
64421,3,1,225639,225639,225640,0,1,0
64422,3,1,225642,225642,225643,0,1,2
64423,5,2,225647,225647,225649,0,2,4
64424,5,2,225652,225652,225654,0,2,3
64425,1,3,225653,225654,225657,1,4,0
64426,2,1,225655,225657,225658,2,3,0
64427,6,3,225661,225661,225664,0,3,3
64428,6,2,225667,225667,225669,0,2,3
64429,5,2,225672,225672,225674,0,2,3
64430,6,2,225678,225678,225680,0,2,4
64431,4,1,225682,225682,225683,0,1,2
64432,6,1,225688,225688,225689,0,1,5
64433,6,1,225694,225694,225695,0,1,5
64434,6,1,225700,225700,225701,0,1,5
64435,5,2,225705,225705,225707,0,2,4
64436,5,2,225710,225710,225712,0,2,3
64437,5,2,225715,225715,225717,0,2,3
64438,3,1,225718,225718,225719,0,1,1
64439,6,3,225724,225724,225727,0,3,5
64440,2,3,225726,225727,225730,1,4,0
64441,3,3,225729,225730,225733,1,4,0
64442,3,1,225732,225733,225734,1,2,0
64443,5,3,225737,225737,225740,0,3,3
64444,4,3,225741,225741,225744,0,3,1
64445,2,2,225743,225744,225746,1,3,0
64446,6,1,225749,225749,225750,0,1,3
64447,4,1,225753,225753,225754,0,1,3
64448,4,1,225757,225757,225758,0,1,3
64449,6,1,225763,225763,225764,0,1,5
64450,5,1,225768,225768,225769,0,1,4
64451,1,3,225769,225769,225772,0,3,0
64452,5,3,225774,225774,225777,0,3,2
64453,3,2,225777,225777,225779,0,2,0
64454,3,1,225780,225780,225781,0,1,1
64455,3,2,225783,225783,225785,0,2,2
64456,5,3,225788,225788,225791,0,3,3
64457,1,3,225789,225791,225794,2,5,0
64458,3,2,225792,225794,225796,2,4,0
64459,5,2,225797,225797,225799,0,2,1
64460,3,1,225800,225800,225801,0,1,1
64461,5,2,225805,225805,225807,0,2,4
64462,2,1,225807,225807,225808,0,1,0
64463,5,2,225812,225812,225814,0,2,4
64464,5,3,225817,225817,225820,0,3,3
64465,5,2,225822,225822,225824,0,2,2
64466,6,3,225828,225828,225831,0,3,4
64467,3,2,225831,225831,225833,0,2,0
64468,2,3,225833,225833,225836,0,3,0
64469,5,1,225838,225838,225839,0,1,2
64470,1,2,225839,225839,225841,0,2,0
64471,3,3,225842,225842,225845,0,3,1
64472,2,1,225844,225845,225846,1,2,0
64473,5,2,225849,225849,225851,0,2,3
64474,1,3,225850,225851,225854,1,4,0
64475,5,2,225855,225855,225857,0,2,1
64476,3,3,225858,225858,225861,0,3,1
64477,1,3,225859,225861,225864,2,5,0
64478,5,1,225864,225864,225865,0,1,0
64479,3,2,225867,225867,225869,0,2,2
64480,6,3,225873,225873,225876,0,3,4
64481,3,1,225876,225876,225877,0,1,0
64482,2,3,225878,225878,225881,0,3,1
64483,3,1,225881,225881,225882,0,1,0
64484,5,1,225886,225886,225887,0,1,4
64485,5,3,225891,225891,225894,0,3,4
64486,6,3,225897,225897,225900,0,3,3
64487,4,1,225901,225901,225902,0,1,1
64488,5,1,225906,225906,225907,0,1,4
64489,4,3,225910,225910,225913,0,3,3
64490,3,2,225913,225913,225915,0,2,0
64491,5,2,225918,225918,225920,0,2,3
64492,2,2,225920,225920,225922,0,2,0
64493,3,3,225923,225923,225926,0,3,1
64494,6,1,225929,225929,225930,0,1,3
64495,4,3,225933,225933,225936,0,3,3
64496,3,2,225936,225936,225938,0,2,0
64497,4,2,225940,225940,225942,0,2,2
64498,5,1,225945,225945,225946,0,1,3
64499,5,1,225950,225950,225951,0,1,4
64500,3,2,225953,225953,225955,0,2,2
64501,1,2,225954,225955,225957,1,3,0
64502,3,3,225957,225957,225960,0,3,0
64503,3,2,225960,225960,225962,0,2,0
64504,4,1,225964,225964,225965,0,1,2
64505,5,2,225969,225969,225971,0,2,4
64506,2,2,225971,225971,225973,0,2,0
64507,3,3,225974,225974,225977,0,3,1
64508,4,1,225978,225978,225979,0,1,1
64509,5,3,225983,225983,225986,0,3,4
64510,1,2,225984,225986,225988,2,4,0
64511,1,2,225985,225988,225990,3,5,0
64512,3,3,225988,225990,225993,2,5,0
64513,2,3,225990,225993,225996,3,6,0
64514,6,3,225996,225996,225999,0,3,0
64515,4,1,226000,226000,226001,0,1,1
64516,5,2,226005,226005,226007,0,2,4
64517,6,2,226011,226011,226013,0,2,4
64518,6,1,226017,226017,226018,0,1,4
64519,1,3,226018,226018,226021,0,3,0
64520,1,1,226019,226021,226022,2,3,0
64521,5,3,226024,226024,226027,0,3,2
64522,1,2,226025,226027,226029,2,4,0
64523,6,3,226031,226031,226034,0,3,2
64524,3,2,226034,226034,226036,0,2,0
64525,6,3,226040,226040,226043,0,3,4
64526,2,2,226042,226043,226045,1,3,0
64527,6,3,226048,226048,226051,0,3,3
64528,4,1,226052,226052,226053,0,1,1
64529,4,1,226056,226056,226057,0,1,3
64530,3,2,226059,226059,226061,0,2,2
64531,2,1,226061,226061,226062,0,1,0
64532,2,2,226063,226063,226065,0,2,1
64533,4,3,226067,226067,226070,0,3,2
64534,2,3,226069,226070,226073,1,4,0
64535,2,1,226071,226073,226074,2,3,0
64536,3,3,226074,226074,226077,0,3,0
64537,6,1,226080,226080,226081,0,1,3
64538,6,3,226086,226086,226089,0,3,5
64539,6,2,226092,226092,226094,0,2,3
64540,1,1,226093,226094,226095,1,2,0
64541,1,2,226094,226095,226097,1,3,0
64542,5,3,226099,226099,226102,0,3,2
64543,1,2,226100,226102,226104,2,4,0
64544,3,1,226103,226104,226105,1,2,0
64545,5,1,226108,226108,226109,0,1,3
64546,3,2,226111,226111,226113,0,2,2
64547,5,1,226116,226116,226117,0,1,3
64548,2,2,226118,226118,226120,0,2,1
64549,2,2,226120,226120,226122,0,2,0
64550,1,3,226121,226122,226125,1,4,0
64551,2,2,226123,226125,226127,2,4,0
64552,6,3,226129,226129,226132,0,3,2
64553,2,1,226131,226132,226133,1,2,0
64554,5,1,226136,226136,226137,0,1,3
64555,1,3,226137,226137,226140,0,3,0
64556,5,1,226142,226142,226143,0,1,2
64557,5,1,226147,226147,226148,0,1,4
64558,3,3,226150,226150,226153,0,3,2
64559,1,3,226151,226153,226156,2,5,0
64560,4,3,226155,226156,226159,1,4,0
64561,5,3,226160,226160,226163,0,3,1
64562,6,2,226166,226166,226168,0,2,3
64563,2,3,226168,226168,226171,0,3,0
64564,4,1,226172,226172,226173,0,1,1
64565,1,1,226173,226173,226174,0,1,0
64566,3,2,226176,226176,226178,0,2,2
64567,6,2,226182,226182,226184,0,2,4
64568,2,3,226184,226184,226187,0,3,0
64569,2,2,226186,226187,226189,1,3,0
64570,4,3,226190,226190,226193,0,3,1
64571,2,1,226192,226193,226194,1,2,0
64572,5,1,226197,226197,226198,0,1,3
64573,3,1,226200,226200,226201,0,1,2
64574,2,2,226202,226202,226204,0,2,1
64575,5,1,226207,226207,226208,0,1,3
64576,6,3,226213,226213,226216,0,3,5
64577,5,2,226218,226218,226220,0,2,2
64578,4,3,226222,226222,226225,0,3,2
64579,5,2,226227,226227,226229,0,2,2
64580,5,2,226232,226232,226234,0,2,3
64581,3,3,226235,226235,226238,0,3,1
64582,5,1,226240,226240,226241,0,1,2
64583,1,1,226241,226241,226242,0,1,0
64584,6,2,226247,226247,226249,0,2,5
64585,6,3,226253,226253,226256,0,3,4
64586,1,1,226254,226256,226257,2,3,0
64587,4,1,226258,226258,226259,0,1,1
64588,6,1,226264,226264,226265,0,1,5
64589,5,1,226269,226269,226270,0,1,4
64590,4,2,226273,226273,226275,0,2,3
64591,4,1,226277,226277,226278,0,1,2
64592,5,2,226282,226282,226284,0,2,4
64593,5,2,226287,226287,226289,0,2,3
64594,6,2,226293,226293,226295,0,2,4
64595,1,1,226294,226295,226296,1,2,0
64596,1,2,226295,226296,226298,1,3,0
64597,3,3,226298,226298,226301,0,3,0
64598,6,1,226304,226304,226305,0,1,3
64599,1,3,226305,226305,226308,0,3,0
64600,2,3,226307,226308,226311,1,4,0
64601,4,3,226311,226311,226314,0,3,0
64602,3,1,226314,226314,226315,0,1,0
64603,6,1,226320,226320,226321,0,1,5
64604,1,3,226321,226321,226324,0,3,0
64605,6,1,226327,226327,226328,0,1,3
64606,4,3,226331,226331,226334,0,3,3
64607,4,1,226335,226335,226336,0,1,1
64608,3,2,226338,226338,226340,0,2,2
64609,2,2,226340,226340,226342,0,2,0
64610,4,1,226344,226344,226345,0,1,2
64611,1,2,226345,226345,226347,0,2,0
64612,2,2,226347,226347,226349,0,2,0
64613,3,1,226350,226350,226351,0,1,1
64614,3,1,226353,226353,226354,0,1,2
64615,5,1,226358,226358,226359,0,1,4
64616,4,3,226362,226362,226365,0,3,3
64617,1,3,226363,226365,226368,2,5,0
64618,2,2,226365,226368,226370,3,5,0
64619,3,1,226368,226370,226371,2,3,0
64620,3,2,226371,226371,226373,0,2,0
64621,5,1,226376,226376,226377,0,1,3
64622,6,1,226382,226382,226383,0,1,5
64623,1,1,226383,226383,226384,0,1,0
64624,5,2,226388,226388,226390,0,2,4
64625,6,1,226394,226394,226395,0,1,4
64626,2,3,226396,226396,226399,0,3,1
64627,2,2,226398,226399,226401,1,3,0
64628,6,3,226404,226404,226407,0,3,3
64629,6,2,226410,226410,226412,0,2,3
64630,2,2,226412,226412,226414,0,2,0
64631,3,3,226415,226415,226418,0,3,1
64632,6,3,226421,226421,226424,0,3,3
64633,6,3,226427,226427,226430,0,3,3
64634,4,3,226431,226431,226434,0,3,1
64635,2,2,226433,226434,226436,1,3,0
64636,3,2,226436,226436,226438,0,2,0
64637,5,3,226441,226441,226444,0,3,3
64638,2,3,226443,226444,226447,1,4,0
64639,6,1,226449,226449,226450,0,1,2
64640,2,1,226451,226451,226452,0,1,1
64641,3,1,226454,226454,226455,0,1,2
64642,3,2,226457,226457,226459,0,2,2
64643,6,3,226463,226463,226466,0,3,4
64644,3,3,226466,226466,226469,0,3,0
64645,2,1,226468,226469,226470,1,2,0
64646,4,3,226472,226472,226475,0,3,2
64647,4,2,226476,226476,226478,0,2,1
64648,2,3,226478,226478,226481,0,3,0
64649,2,1,226480,226481,226482,1,2,0
64650,1,3,226481,226482,226485,1,4,0
64651,6,2,226487,226487,226489,0,2,2
64652,1,1,226488,226489,226490,1,2,0
64653,3,3,226491,226491,226494,0,3,1
64654,1,1,226492,226494,226495,2,3,0
64655,4,2,226496,226496,226498,0,2,1
64656,2,2,226498,226498,226500,0,2,0
64657,3,3,226501,226501,226504,0,3,1
64658,3,1,226504,226504,226505,0,1,0
64659,2,1,226506,226506,226507,0,1,1
64660,3,1,226509,226509,226510,0,1,2
64661,2,1,226511,226511,226512,0,1,1
64662,6,2,226517,226517,226519,0,2,5
64663,4,1,226521,226521,226522,0,1,2
64664,4,2,226525,226525,226527,0,2,3
64665,3,2,226528,226528,226530,0,2,1
64666,6,2,226534,226534,226536,0,2,4
64667,4,1,226538,226538,226539,0,1,2
64668,2,1,226540,226540,226541,0,1,1
64669,4,2,226544,226544,226546,0,2,3
64670,2,3,226546,226546,226549,0,3,0
64671,5,3,226551,226551,226554,0,3,2
64672,6,3,226557,226557,226560,0,3,3
64673,6,1,226563,226563,226564,0,1,3
64674,6,2,226569,226569,226571,0,2,5
64675,3,2,226572,226572,226574,0,2,1
64676,2,3,226574,226574,226577,0,3,0
64677,4,2,226578,226578,226580,0,2,1
64678,2,3,226580,226580,226583,0,3,0
64679,5,1,226585,226585,226586,0,1,2
64680,3,1,226588,226588,226589,0,1,2
64681,3,1,226591,226591,226592,0,1,2
64682,6,3,226597,226597,226600,0,3,5
64683,6,2,226603,226603,226605,0,2,3
64684,6,1,226609,226609,226610,0,1,4
64685,1,1,226610,226610,226611,0,1,0
64686,6,1,226616,226616,226617,0,1,5
64687,1,2,226617,226617,226619,0,2,0
64688,4,1,226621,226621,226622,0,1,2
64689,6,2,226627,226627,226629,0,2,5
64690,2,2,226629,226629,226631,0,2,0
64691,2,1,226631,226631,226632,0,1,0
64692,5,1,226636,226636,226637,0,1,4
64693,3,1,226639,226639,226640,0,1,2
64694,2,3,226641,226641,226644,0,3,1
64695,3,1,226644,226644,226645,0,1,0
64696,2,3,226646,226646,226649,0,3,1
64697,5,1,226651,226651,226652,0,1,2
64698,4,1,226655,226655,226656,0,1,3
64699,1,1,226656,226656,226657,0,1,0
64700,2,2,226658,226658,226660,0,2,1
64701,5,3,226663,226663,226666,0,3,3
64702,2,2,226665,226666,226668,1,3,0
64703,2,1,226667,226668,226669,1,2,0
64704,6,3,226673,226673,226676,0,3,4
64705,6,3,226679,226679,226682,0,3,3
64706,1,2,226680,226682,226684,2,4,0
64707,3,1,226683,226684,226685,1,2,0
64708,6,3,226689,226689,226692,0,3,4
64709,5,3,226694,226694,226697,0,3,2
64710,2,1,226696,226697,226698,1,2,0
64711,1,1,226697,226698,226699,1,2,0
64712,1,3,226698,226699,226702,1,4,0
64713,3,2,226701,226702,226704,1,3,0
64714,1,2,226702,226704,226706,2,4,0
64715,5,2,226707,226707,226709,0,2,1
64716,1,3,226708,226709,226712,1,4,0
64717,4,2,226712,226712,226714,0,2,0
64718,6,1,226718,226718,226719,0,1,4
64719,2,3,226720,226720,226723,0,3,1
64720,6,2,226726,226726,226728,0,2,3
64721,2,2,226728,226728,226730,0,2,0
64722,1,2,226729,226730,226732,1,3,0
64723,6,3,226735,226735,226738,0,3,3
64724,5,2,226740,226740,226742,0,2,2
64725,2,3,226742,226742,226745,0,3,0
64726,4,3,226746,226746,226749,0,3,1
64727,2,1,226748,226749,226750,1,2,0
64728,4,2,226752,226752,226754,0,2,2
64729,1,1,226753,226754,226755,1,2,0
64730,1,2,226754,226755,226757,1,3,0
64731,2,1,226756,226757,226758,1,2,0
64732,3,3,226759,226759,226762,0,3,1
64733,5,3,226764,226764,226767,0,3,2
64734,1,1,226765,226767,226768,2,3,0
64735,2,3,226767,226768,226771,1,4,0
64736,4,3,226771,226771,226774,0,3,0
64737,1,3,226772,226774,226777,2,5,0
64738,6,1,226778,226778,226779,0,1,1
64739,6,2,226784,226784,226786,0,2,5
64740,3,3,226787,226787,226790,0,3,1
64741,4,3,226791,226791,226794,0,3,1
64742,3,1,226794,226794,226795,0,1,0
64743,5,3,226799,226799,226802,0,3,4
64744,3,1,226802,226802,226803,0,1,0
64745,3,1,226805,226805,226806,0,1,2
64746,2,3,226807,226807,226810,0,3,1
64747,6,2,226813,226813,226815,0,2,3
64748,6,2,226819,226819,226821,0,2,4
64749,3,1,226822,226822,226823,0,1,1
64750,2,3,226824,226824,226827,0,3,1
64751,1,2,226825,226827,226829,2,4,0
64752,6,2,226831,226831,226833,0,2,2
64753,3,1,226834,226834,226835,0,1,1
64754,1,3,226835,226835,226838,0,3,0
64755,3,1,226838,226838,226839,0,1,0
64756,6,3,226844,226844,226847,0,3,5
64757,4,3,226848,226848,226851,0,3,1
64758,4,3,226852,226852,226855,0,3,1
64759,1,3,226853,226855,226858,2,5,0
64760,1,3,226854,226858,226861,4,7,0
64761,6,1,226860,226861,226862,1,2,0
64762,1,2,226861,226862,226864,1,3,0
64763,1,1,226862,226864,226865,2,3,0
64764,4,3,226866,226866,226869,0,3,1
64765,4,2,226870,226870,226872,0,2,1
64766,1,2,226871,226872,226874,1,3,0
64767,3,2,226874,226874,226876,0,2,0
64768,1,2,226875,226876,226878,1,3,0
64769,2,3,226877,226878,226881,1,4,0
64770,1,1,226878,226881,226882,3,4,0
64771,4,3,226882,226882,226885,0,3,0
64772,1,1,226883,226885,226886,2,3,0
64773,4,1,226887,226887,226888,0,1,1
64774,6,1,226893,226893,226894,0,1,5
64775,5,1,226898,226898,226899,0,1,4
64776,1,2,226899,226899,226901,0,2,0
64777,2,1,226901,226901,226902,0,1,0
64778,4,1,226905,226905,226906,0,1,3
64779,5,3,226910,226910,226913,0,3,4
64780,4,2,226914,226914,226916,0,2,1
64781,3,3,226917,226917,226920,0,3,1
64782,6,1,226923,226923,226924,0,1,3
64783,5,1,226928,226928,226929,0,1,4
64784,1,1,226929,226929,226930,0,1,0
64785,2,2,226931,226931,226933,0,2,1
64786,2,1,226933,226933,226934,0,1,0
64787,1,1,226934,226934,226935,0,1,0
64788,3,1,226937,226937,226938,0,1,2
64789,1,3,226938,226938,226941,0,3,0
64790,5,1,226943,226943,226944,0,1,2
64791,6,3,226949,226949,226952,0,3,5
64792,4,3,226953,226953,226956,0,3,1
64793,3,3,226956,226956,226959,0,3,0
64794,4,1,226960,226960,226961,0,1,1
64795,2,1,226962,226962,226963,0,1,1
64796,5,3,226967,226967,226970,0,3,4
64797,6,1,226973,226973,226974,0,1,3
64798,1,1,226974,226974,226975,0,1,0
64799,6,3,226980,226980,226983,0,3,5
64800,3,2,226983,226983,226985,0,2,0
64801,1,3,226984,226985,226988,1,4,0
64802,5,3,226989,226989,226992,0,3,1
64803,6,3,226995,226995,226998,0,3,3
64804,6,1,227001,227001,227002,0,1,3
64805,3,1,227004,227004,227005,0,1,2
64806,5,1,227009,227009,227010,0,1,4
64807,6,3,227015,227015,227018,0,3,5
64808,2,3,227017,227018,227021,1,4,0
64809,3,1,227020,227021,227022,1,2,0
64810,4,3,227024,227024,227027,0,3,2
64811,6,2,227030,227030,227032,0,2,3
64812,3,2,227033,227033,227035,0,2,1
64813,5,3,227038,227038,227041,0,3,3
64814,5,3,227043,227043,227046,0,3,2
64815,1,1,227044,227046,227047,2,3,0
64816,1,2,227045,227047,227049,2,4,0
64817,1,2,227046,227049,227051,3,5,0
64818,2,2,227048,227051,227053,3,5,0
64819,1,3,227049,227053,227056,4,7,0
64820,6,3,227055,227056,227059,1,4,0
64821,5,2,227060,227060,227062,0,2,1
64822,5,1,227065,227065,227066,0,1,3
64823,2,3,227067,227067,227070,0,3,1
64824,5,1,227072,227072,227073,0,1,2
64825,6,3,227078,227078,227081,0,3,5
64826,4,3,227082,227082,227085,0,3,1
64827,4,2,227086,227086,227088,0,2,1
64828,3,1,227089,227089,227090,0,1,1
64829,4,2,227093,227093,227095,0,2,3
64830,5,3,227098,227098,227101,0,3,3
64831,6,2,227104,227104,227106,0,2,3
64832,2,3,227106,227106,227109,0,3,0
64833,2,2,227108,227109,227111,1,3,0
64834,1,1,227109,227111,227112,2,3,0
64835,2,2,227111,227112,227114,1,3,0
64836,5,1,227116,227116,227117,0,1,2
64837,2,1,227118,227118,227119,0,1,1
64838,5,1,227123,227123,227124,0,1,4
64839,6,3,227129,227129,227132,0,3,5
64840,3,3,227132,227132,227135,0,3,0
64841,6,2,227138,227138,227140,0,2,3
64842,5,2,227143,227143,227145,0,2,3
64843,5,3,227148,227148,227151,0,3,3
64844,4,2,227152,227152,227154,0,2,1
64845,5,2,227157,227157,227159,0,2,3
64846,2,1,227159,227159,227160,0,1,0
64847,5,1,227164,227164,227165,0,1,4
64848,6,2,227170,227170,227172,0,2,5
64849,5,2,227175,227175,227177,0,2,3
64850,5,2,227180,227180,227182,0,2,3
64851,5,3,227185,227185,227188,0,3,3
64852,4,2,227189,227189,227191,0,2,1
64853,6,1,227195,227195,227196,0,1,4
64854,3,3,227198,227198,227201,0,3,2
64855,2,1,227200,227201,227202,1,2,0
64856,4,2,227204,227204,227206,0,2,2
64857,6,2,227210,227210,227212,0,2,4
64858,4,2,227214,227214,227216,0,2,2
64859,6,1,227220,227220,227221,0,1,4
64860,5,2,227225,227225,227227,0,2,4
64861,6,1,227231,227231,227232,0,1,4
64862,5,3,227236,227236,227239,0,3,4
64863,2,2,227238,227239,227241,1,3,0
64864,6,3,227244,227244,227247,0,3,3
64865,3,2,227247,227247,227249,0,2,0
64866,3,3,227250,227250,227253,0,3,1
64867,3,2,227253,227253,227255,0,2,0
64868,3,2,227256,227256,227258,0,2,1
64869,4,2,227260,227260,227262,0,2,2
64870,6,3,227266,227266,227269,0,3,4
64871,2,2,227268,227269,227271,1,3,0
64872,3,3,227271,227271,227274,0,3,0
64873,3,3,227274,227274,227277,0,3,0
64874,6,2,227280,227280,227282,0,2,3
64875,4,2,227284,227284,227286,0,2,2
64876,2,2,227286,227286,227288,0,2,0
64877,4,3,227290,227290,227293,0,3,2
64878,5,2,227295,227295,227297,0,2,2
64879,4,2,227299,227299,227301,0,2,2
64880,4,2,227303,227303,227305,0,2,2
64881,5,3,227308,227308,227311,0,3,3
64882,3,3,227311,227311,227314,0,3,0
64883,1,3,227312,227314,227317,2,5,0
64884,1,2,227313,227317,227319,4,6,0
64885,4,1,227317,227319,227320,2,3,0
64886,3,1,227320,227320,227321,0,1,0
64887,6,3,227326,227326,227329,0,3,5
64888,2,3,227328,227329,227332,1,4,0
64889,2,1,227330,227332,227333,2,3,0
64890,3,3,227333,227333,227336,0,3,0
64891,4,1,227337,227337,227338,0,1,1
64892,4,3,227341,227341,227344,0,3,3
64893,2,1,227343,227344,227345,1,2,0
64894,3,1,227346,227346,227347,0,1,1
64895,2,3,227348,227348,227351,0,3,1
64896,1,3,227349,227351,227354,2,5,0
64897,2,1,227351,227354,227355,3,4,0
64898,6,2,227357,227357,227359,0,2,2
64899,4,1,227361,227361,227362,0,1,2
64900,5,3,227366,227366,227369,0,3,4
64901,3,3,227369,227369,227372,0,3,0
64902,5,1,227374,227374,227375,0,1,2
64903,1,2,227375,227375,227377,0,2,0
64904,5,3,227380,227380,227383,0,3,3
64905,4,2,227384,227384,227386,0,2,1
64906,4,3,227388,227388,227391,0,3,2
64907,4,3,227392,227392,227395,0,3,1
64908,4,3,227396,227396,227399,0,3,1
64909,4,1,227400,227400,227401,0,1,1
64910,3,3,227403,227403,227406,0,3,2
64911,1,3,227404,227406,227409,2,5,0
64912,4,2,227408,227409,227411,1,3,0
64913,1,2,227409,227411,227413,2,4,0
64914,5,3,227414,227414,227417,0,3,1
64915,3,1,227417,227417,227418,0,1,0
64916,3,2,227420,227420,227422,0,2,2
64917,4,2,227424,227424,227426,0,2,2
64918,6,3,227430,227430,227433,0,3,4
64919,4,3,227434,227434,227437,0,3,1
64920,6,3,227440,227440,227443,0,3,3
64921,2,2,227442,227443,227445,1,3,0
64922,3,2,227445,227445,227447,0,2,0
64923,2,1,227447,227447,227448,0,1,0
64924,6,3,227453,227453,227456,0,3,5
64925,1,1,227454,227456,227457,2,3,0
64926,1,2,227455,227457,227459,2,4,0
64927,6,1,227461,227461,227462,0,1,2
64928,4,1,227465,227465,227466,0,1,3
64929,4,2,227469,227469,227471,0,2,3
64930,6,1,227475,227475,227476,0,1,4
64931,1,2,227476,227476,227478,0,2,0
64932,2,2,227478,227478,227480,0,2,0
64933,4,3,227482,227482,227485,0,3,2
64934,3,2,227485,227485,227487,0,2,0
64935,3,2,227488,227488,227490,0,2,1
64936,3,3,227491,227491,227494,0,3,1
64937,5,2,227496,227496,227498,0,2,2
64938,4,2,227500,227500,227502,0,2,2
64939,4,1,227504,227504,227505,0,1,2
64940,1,3,227505,227505,227508,0,3,0
64941,2,3,227507,227508,227511,1,4,0
64942,1,2,227508,227511,227513,3,5,0
64943,5,1,227513,227513,227514,0,1,0
64944,3,1,227516,227516,227517,0,1,2
64945,5,3,227521,227521,227524,0,3,4
64946,4,1,227525,227525,227526,0,1,1
64947,2,2,227527,227527,227529,0,2,1
64948,2,3,227529,227529,227532,0,3,0
64949,1,1,227530,227532,227533,2,3,0
64950,3,1,227533,227533,227534,0,1,0
64951,3,2,227536,227536,227538,0,2,2
64952,1,1,227537,227538,227539,1,2,0
64953,2,1,227539,227539,227540,0,1,0
64954,6,1,227545,227545,227546,0,1,5
64955,3,2,227548,227548,227550,0,2,2
64956,4,1,227552,227552,227553,0,1,2
64957,2,3,227554,227554,227557,0,3,1
64958,1,3,227555,227557,227560,2,5,0
64959,5,2,227560,227560,227562,0,2,0
64960,6,3,227566,227566,227569,0,3,4
64961,1,1,227567,227569,227570,2,3,0
64962,4,2,227571,227571,227573,0,2,1
64963,4,3,227575,227575,227578,0,3,2
64964,6,1,227581,227581,227582,0,1,3
64965,3,2,227584,227584,227586,0,2,2
64966,6,1,227590,227590,227591,0,1,4
64967,6,3,227596,227596,227599,0,3,5
64968,1,2,227597,227599,227601,2,4,0
64969,2,2,227599,227601,227603,2,4,0
64970,2,1,227601,227603,227604,2,3,0
64971,6,2,227607,227607,227609,0,2,3
64972,4,1,227611,227611,227612,0,1,2
64973,3,3,227614,227614,227617,0,3,2
64974,3,1,227617,227617,227618,0,1,0
64975,4,3,227621,227621,227624,0,3,3
64976,2,2,227623,227624,227626,1,3,0
64977,5,2,227628,227628,227630,0,2,2
64978,5,1,227633,227633,227634,0,1,3
64979,3,1,227636,227636,227637,0,1,2
64980,6,3,227642,227642,227645,0,3,5
64981,4,1,227646,227646,227647,0,1,1
64982,2,3,227648,227648,227651,0,3,1
64983,4,1,227652,227652,227653,0,1,1
64984,5,2,227657,227657,227659,0,2,4
64985,5,1,227662,227662,227663,0,1,3
64986,3,3,227665,227665,227668,0,3,2
64987,1,2,227666,227668,227670,2,4,0
64988,3,1,227669,227670,227671,1,2,0
64989,6,1,227675,227675,227676,0,1,4
64990,3,2,227678,227678,227680,0,2,2
64991,2,3,227680,227680,227683,0,3,0
64992,3,1,227683,227683,227684,0,1,0
64993,1,1,227684,227684,227685,0,1,0
64994,3,1,227687,227687,227688,0,1,2
64995,3,3,227690,227690,227693,0,3,2
64996,4,1,227694,227694,227695,0,1,1
64997,6,1,227700,227700,227701,0,1,5
64998,2,3,227702,227702,227705,0,3,1
64999,3,2,227705,227705,227707,0,2,0
65000,6,1,227711,227711,227712,0,1,4
65001,6,2,227717,227717,227719,0,2,5
65002,5,2,227722,227722,227724,0,2,3
65003,5,2,227727,227727,227729,0,2,3
65004,2,1,227729,227729,227730,0,1,0
65005,3,1,227732,227732,227733,0,1,2
65006,3,1,227735,227735,227736,0,1,2
65007,2,3,227737,227737,227740,0,3,1
65008,6,2,227743,227743,227745,0,2,3
65009,4,1,227747,227747,227748,0,1,2
65010,5,3,227752,227752,227755,0,3,4
65011,6,1,227758,227758,227759,0,1,3
65012,1,1,227759,227759,227760,0,1,0
65013,5,3,227764,227764,227767,0,3,4
65014,1,2,227765,227767,227769,2,4,0
65015,5,2,227770,227770,227772,0,2,1
65016,6,1,227776,227776,227777,0,1,4
65017,3,3,227779,227779,227782,0,3,2
65018,6,2,227785,227785,227787,0,2,3
65019,1,1,227786,227787,227788,1,2,0
65020,6,3,227792,227792,227795,0,3,4
65021,3,2,227795,227795,227797,0,2,0
65022,2,3,227797,227797,227800,0,3,0
65023,4,2,227801,227801,227803,0,2,1
65024,6,3,227807,227807,227810,0,3,4
65025,1,3,227808,227810,227813,2,5,0
65026,3,2,227811,227813,227815,2,4,0
65027,4,1,227815,227815,227816,0,1,0
65028,4,3,227819,227819,227822,0,3,3
65029,6,3,227825,227825,227828,0,3,3
65030,6,3,227831,227831,227834,0,3,3
65031,1,3,227832,227834,227837,2,5,0
65032,6,2,227838,227838,227840,0,2,1
65033,4,2,227842,227842,227844,0,2,2
65034,6,3,227848,227848,227851,0,3,4
65035,3,1,227851,227851,227852,0,1,0
65036,5,3,227856,227856,227859,0,3,4
65037,2,3,227858,227859,227862,1,4,0
65038,1,1,227859,227862,227863,3,4,0
65039,4,2,227863,227863,227865,0,2,0
65040,4,2,227867,227867,227869,0,2,2
65041,2,3,227869,227869,227872,0,3,0
65042,2,2,227871,227872,227874,1,3,0
65043,4,3,227875,227875,227878,0,3,1
65044,5,1,227880,227880,227881,0,1,2
65045,2,2,227882,227882,227884,0,2,1
65046,6,1,227888,227888,227889,0,1,4
65047,3,1,227891,227891,227892,0,1,2
65048,4,2,227895,227895,227897,0,2,3
65049,4,3,227899,227899,227902,0,3,2
65050,3,3,227902,227902,227905,0,3,0
65051,4,3,227906,227906,227909,0,3,1
65052,1,2,227907,227909,227911,2,4,0
65053,4,2,227911,227911,227913,0,2,0
65054,6,2,227917,227917,227919,0,2,4
65055,6,2,227923,227923,227925,0,2,4
65056,5,2,227928,227928,227930,0,2,3
65057,6,3,227934,227934,227937,0,3,4
65058,6,3,227940,227940,227943,0,3,3
65059,6,3,227946,227946,227949,0,3,3
65060,2,2,227948,227949,227951,1,3,0
65061,1,3,227949,227951,227954,2,5,0
65062,3,2,227952,227954,227956,2,4,0
65063,4,2,227956,227956,227958,0,2,0
65064,2,2,227958,227958,227960,0,2,0
65065,1,1,227959,227960,227961,1,2,0
65066,3,2,227962,227962,227964,0,2,1
65067,4,1,227966,227966,227967,0,1,2
65068,5,2,227971,227971,227973,0,2,4
65069,2,1,227973,227973,227974,0,1,0
65070,2,3,227975,227975,227978,0,3,1
65071,4,2,227979,227979,227981,0,2,1
65072,2,2,227981,227981,227983,0,2,0
65073,5,1,227986,227986,227987,0,1,3
65074,2,3,227988,227988,227991,0,3,1
65075,4,2,227992,227992,227994,0,2,1
65076,1,3,227993,227994,227997,1,4,0
65077,6,3,227999,227999,228002,0,3,2
65078,3,2,228002,228002,228004,0,2,0
65079,6,2,228008,228008,228010,0,2,4
65080,1,2,228009,228010,228012,1,3,0
65081,2,1,228011,228012,228013,1,2,0
65082,5,2,228016,228016,228018,0,2,3
65083,5,3,228021,228021,228024,0,3,3
65084,1,2,228022,228024,228026,2,4,0
65085,2,3,228024,228026,228029,2,5,0
65086,1,2,228025,228029,228031,4,6,0
65087,1,2,228026,228031,228033,5,7,0
65088,4,2,228030,228033,228035,3,5,0
65089,2,3,228032,228035,228038,3,6,0
65090,6,2,228038,228038,228040,0,2,0
65091,5,3,228043,228043,228046,0,3,3
65092,1,3,228044,228046,228049,2,5,0
65093,2,3,228046,228049,228052,3,6,0
65094,3,1,228049,228052,228053,3,4,0
65095,2,2,228051,228053,228055,2,4,0
65096,6,2,228057,228057,228059,0,2,2
65097,6,2,228063,228063,228065,0,2,4
65098,6,2,228069,228069,228071,0,2,4
65099,3,1,228072,228072,228073,0,1,1
65100,6,1,228078,228078,228079,0,1,5
65101,3,2,228081,228081,228083,0,2,2
65102,1,3,228082,228083,228086,1,4,0
65103,1,3,228083,228086,228089,3,6,0
65104,2,2,228085,228089,228091,4,6,0
65105,4,3,228089,228091,228094,2,5,0
65106,6,2,228095,228095,228097,0,2,1
65107,5,1,228100,228100,228101,0,1,3
65108,1,1,228101,228101,228102,0,1,0
65109,3,1,228104,228104,228105,0,1,2
65110,5,3,228109,228109,228112,0,3,4
65111,6,1,228115,228115,228116,0,1,3
65112,5,2,228120,228120,228122,0,2,4
65113,1,2,228121,228122,228124,1,3,0
65114,5,2,228126,228126,228128,0,2,2
65115,1,3,228127,228128,228131,1,4,0
65116,4,3,228131,228131,228134,0,3,0
65117,5,2,228136,228136,228138,0,2,2
65118,3,3,228139,228139,228142,0,3,1
65119,5,1,228144,228144,228145,0,1,2
65120,1,2,228145,228145,228147,0,2,0
65121,3,1,228148,228148,228149,0,1,1
65122,5,3,228153,228153,228156,0,3,4
65123,3,3,228156,228156,228159,0,3,0
65124,1,2,228157,228159,228161,2,4,0
65125,5,2,228162,228162,228164,0,2,1
65126,2,3,228164,228164,228167,0,3,0
65127,1,1,228165,228167,228168,2,3,0
65128,3,1,228168,228168,228169,0,1,0
65129,4,1,228172,228172,228173,0,1,3
65130,6,3,228178,228178,228181,0,3,5
65131,4,2,228182,228182,228184,0,2,1
65132,5,2,228187,228187,228189,0,2,3
65133,2,1,228189,228189,228190,0,1,0
65134,3,1,228192,228192,228193,0,1,2
65135,4,2,228196,228196,228198,0,2,3
65136,3,2,228199,228199,228201,0,2,1
65137,3,3,228202,228202,228205,0,3,1
65138,1,3,228203,228205,228208,2,5,0
65139,4,1,228207,228208,228209,1,2,0
65140,2,2,228209,228209,228211,0,2,0
65141,4,1,228213,228213,228214,0,1,2
65142,3,1,228216,228216,228217,0,1,2
65143,3,3,228219,228219,228222,0,3,2
65144,5,1,228224,228224,228225,0,1,2
65145,3,2,228227,228227,228229,0,2,2
65146,6,1,228233,228233,228234,0,1,4
65147,1,1,228234,228234,228235,0,1,0
65148,4,2,228238,228238,228240,0,2,3
65149,2,2,228240,228240,228242,0,2,0
65150,1,1,228241,228242,228243,1,2,0
65151,4,1,228245,228245,228246,0,1,2
65152,6,2,228251,228251,228253,0,2,5
65153,2,1,228253,228253,228254,0,1,0
65154,5,3,228258,228258,228261,0,3,4
65155,6,3,228264,228264,228267,0,3,3
65156,3,1,228267,228267,228268,0,1,0
65157,4,1,228271,228271,228272,0,1,3
65158,4,3,228275,228275,228278,0,3,3
65159,5,3,228280,228280,228283,0,3,2
65160,6,3,228286,228286,228289,0,3,3
65161,4,3,228290,228290,228293,0,3,1
65162,2,1,228292,228293,228294,1,2,0
65163,4,1,228296,228296,228297,0,1,2
65164,1,2,228297,228297,228299,0,2,0
65165,5,3,228302,228302,228305,0,3,3
65166,1,3,228303,228305,228308,2,5,0
65167,5,3,228308,228308,228311,0,3,0
65168,2,2,228310,228311,228313,1,3,0
65169,3,3,228313,228313,228316,0,3,0
65170,2,1,228315,228316,228317,1,2,0
65171,6,2,228321,228321,228323,0,2,4
65172,4,1,228325,228325,228326,0,1,2
65173,6,3,228331,228331,228334,0,3,5
65174,4,2,228335,228335,228337,0,2,1
65175,4,2,228339,228339,228341,0,2,2
65176,5,1,228344,228344,228345,0,1,3
65177,6,2,228350,228350,228352,0,2,5
65178,4,3,228354,228354,228357,0,3,2
65179,3,3,228357,228357,228360,0,3,0
65180,5,3,228362,228362,228365,0,3,2
65181,6,2,228368,228368,228370,0,2,3
65182,3,3,228371,228371,228374,0,3,1
65183,3,3,228374,228374,228377,0,3,0
65184,1,1,228375,228377,228378,2,3,0
65185,1,2,228376,228378,228380,2,4,0
65186,4,1,228380,228380,228381,0,1,0
65187,3,2,228383,228383,228385,0,2,2
65188,1,2,228384,228385,228387,1,3,0
65189,4,1,228388,228388,228389,0,1,1
65190,6,2,228394,228394,228396,0,2,5
65191,4,3,228398,228398,228401,0,3,2
65192,2,3,228400,228401,228404,1,4,0
65193,3,2,228403,228404,228406,1,3,0
65194,1,2,228404,228406,228408,2,4,0
65195,3,3,228407,228408,228411,1,4,0
65196,6,1,228413,228413,228414,0,1,2
65197,2,3,228415,228415,228418,0,3,1
65198,1,2,228416,228418,228420,2,4,0
65199,5,3,228421,228421,228424,0,3,1
65200,4,1,228425,228425,228426,0,1,1
65201,6,3,228431,228431,228434,0,3,5
65202,2,1,228433,228434,228435,1,2,0
65203,6,2,228439,228439,228441,0,2,4
65204,3,3,228442,228442,228445,0,3,1
65205,2,1,228444,228445,228446,1,2,0
65206,4,3,228448,228448,228451,0,3,2
65207,6,1,228454,228454,228455,0,1,3
65208,6,2,228460,228460,228462,0,2,5
65209,5,3,228465,228465,228468,0,3,3
65210,3,1,228468,228468,228469,0,1,0
65211,6,1,228474,228474,228475,0,1,5
65212,5,2,228479,228479,228481,0,2,4
65213,6,1,228485,228485,228486,0,1,4
65214,4,3,228489,228489,228492,0,3,3
65215,3,1,228492,228492,228493,0,1,0
65216,4,2,228496,228496,228498,0,2,3
65217,4,3,228500,228500,228503,0,3,2
65218,4,3,228504,228504,228507,0,3,1
65219,1,1,228505,228507,228508,2,3,0
65220,4,2,228509,228509,228511,0,2,1
65221,6,1,228515,228515,228516,0,1,4
65222,6,2,228521,228521,228523,0,2,5
65223,6,3,228527,228527,228530,0,3,4
65224,4,1,228531,228531,228532,0,1,1
65225,2,1,228533,228533,228534,0,1,1
65226,5,2,228538,228538,228540,0,2,4
65227,4,3,228542,228542,228545,0,3,2
65228,3,1,228545,228545,228546,0,1,0
65229,1,2,228546,228546,228548,0,2,0
65230,3,2,228549,228549,228551,0,2,1
65231,1,2,228550,228551,228553,1,3,0
65232,4,2,228554,228554,228556,0,2,1
65233,1,2,228555,228556,228558,1,3,0
65234,1,1,228556,228558,228559,2,3,0
65235,6,3,228562,228562,228565,0,3,3
65236,6,3,228568,228568,228571,0,3,3
65237,2,2,228570,228571,228573,1,3,0
65238,5,1,228575,228575,228576,0,1,2
65239,2,3,228577,228577,228580,0,3,1
65240,3,3,228580,228580,228583,0,3,0
65241,5,1,228585,228585,228586,0,1,2
65242,4,3,228589,228589,228592,0,3,3
65243,4,2,228593,228593,228595,0,2,1
65244,1,2,228594,228595,228597,1,3,0
65245,3,3,228597,228597,228600,0,3,0
65246,4,2,228601,228601,228603,0,2,1
65247,6,1,228607,228607,228608,0,1,4
65248,5,3,228612,228612,228615,0,3,4
65249,1,2,228613,228615,228617,2,4,0
65250,3,3,228616,228617,228620,1,4,0
65251,2,3,228618,228620,228623,2,5,0
65252,4,2,228622,228623,228625,1,3,0
65253,3,1,228625,228625,228626,0,1,0
65254,1,2,228626,228626,228628,0,2,0
65255,6,3,228632,228632,228635,0,3,4
65256,6,3,228638,228638,228641,0,3,3
65257,1,3,228639,228641,228644,2,5,0
65258,3,1,228642,228644,228645,2,3,0
65259,5,3,228647,228647,228650,0,3,2
65260,1,3,228648,228650,228653,2,5,0
65261,1,3,228649,228653,228656,4,7,0
65262,5,2,228654,228656,228658,2,4,0
65263,3,3,228657,228658,228661,1,4,0
65264,4,1,228661,228661,228662,0,1,0
65265,6,1,228667,228667,228668,0,1,5
65266,5,1,228672,228672,228673,0,1,4
65267,3,3,228675,228675,228678,0,3,2
65268,2,2,228677,228678,228680,1,3,0
65269,3,2,228680,228680,228682,0,2,0
65270,5,1,228685,228685,228686,0,1,3
65271,6,3,228691,228691,228694,0,3,5
65272,6,2,228697,228697,228699,0,2,3
65273,4,1,228701,228701,228702,0,1,2
65274,1,3,228702,228702,228705,0,3,0
65275,2,2,228704,228705,228707,1,3,0
65276,4,1,228708,228708,228709,0,1,1
65277,1,3,228709,228709,228712,0,3,0
65278,2,2,228711,228712,228714,1,3,0
65279,4,3,228715,228715,228718,0,3,1
65280,3,2,228718,228718,228720,0,2,0
65281,4,3,228722,228722,228725,0,3,2
65282,1,3,228723,228725,228728,2,5,0
65283,2,3,228725,228728,228731,3,6,0
65284,5,1,228730,228731,228732,1,2,0
65285,4,3,228734,228734,228737,0,3,2
65286,6,2,228740,228740,228742,0,2,3
65287,1,3,228741,228742,228745,1,4,0
65288,2,2,228743,228745,228747,2,4,0
65289,1,1,228744,228747,228748,3,4,0
65290,3,3,228747,228748,228751,1,4,0
65291,4,1,228751,228751,228752,0,1,0
65292,6,3,228757,228757,228760,0,3,5
65293,4,3,228761,228761,228764,0,3,1
65294,5,2,228766,228766,228768,0,2,2
65295,3,1,228769,228769,228770,0,1,1
65296,1,1,228770,228770,228771,0,1,0
65297,4,2,228774,228774,228776,0,2,3
65298,1,2,228775,228776,228778,1,3,0
65299,4,3,228779,228779,228782,0,3,1
65300,5,1,228784,228784,228785,0,1,2
65301,6,1,228790,228790,228791,0,1,5
65302,5,1,228795,228795,228796,0,1,4
65303,1,2,228796,228796,228798,0,2,0
65304,6,2,228802,228802,228804,0,2,4
65305,1,2,228803,228804,228806,1,3,0
65306,4,1,228807,228807,228808,0,1,1
65307,6,3,228813,228813,228816,0,3,5
65308,4,1,228817,228817,228818,0,1,1
65309,2,3,228819,228819,228822,0,3,1
65310,5,2,228824,228824,228826,0,2,2
65311,3,1,228827,228827,228828,0,1,1
65312,2,1,228829,228829,228830,0,1,1
65313,1,1,228830,228830,228831,0,1,0
65314,6,3,228836,228836,228839,0,3,5
65315,2,3,228838,228839,228842,1,4,0
65316,4,3,228842,228842,228845,0,3,0
65317,6,1,228848,228848,228849,0,1,3
65318,4,3,228852,228852,228855,0,3,3
65319,6,3,228858,228858,228861,0,3,3
65320,1,1,228859,228861,228862,2,3,0
65321,5,2,228864,228864,228866,0,2,2
65322,6,1,228870,228870,228871,0,1,4
65323,1,2,228871,228871,228873,0,2,0
65324,1,2,228872,228873,228875,1,3,0
65325,4,2,228876,228876,228878,0,2,1
65326,2,2,228878,228878,228880,0,2,0
65327,2,3,228880,228880,228883,0,3,0
65328,4,2,228884,228884,228886,0,2,1
65329,3,1,228887,228887,228888,0,1,1
65330,3,2,228890,228890,228892,0,2,2
65331,1,2,228891,228892,228894,1,3,0
65332,3,3,228894,228894,228897,0,3,0
65333,1,1,228895,228897,228898,2,3,0
65334,6,2,228901,228901,228903,0,2,3
65335,3,1,228904,228904,228905,0,1,1
65336,4,3,228908,228908,228911,0,3,3
65337,2,2,228910,228911,228913,1,3,0
65338,3,2,228913,228913,228915,0,2,0
65339,4,1,228917,228917,228918,0,1,2
65340,1,2,228918,228918,228920,0,2,0
65341,5,3,228923,228923,228926,0,3,3
65342,3,3,228926,228926,228929,0,3,0
65343,6,3,228932,228932,228935,0,3,3
65344,2,1,228934,228935,228936,1,2,0
65345,3,3,228937,228937,228940,0,3,1
65346,6,1,228943,228943,228944,0,1,3
65347,5,3,228948,228948,228951,0,3,4
65348,2,3,228950,228951,228954,1,4,0
65349,3,2,228953,228954,228956,1,3,0
65350,4,2,228957,228957,228959,0,2,1
65351,5,2,228962,228962,228964,0,2,3
65352,6,3,228968,228968,228971,0,3,4
65353,2,2,228970,228971,228973,1,3,0
65354,2,2,228972,228973,228975,1,3,0
65355,2,3,228974,228975,228978,1,4,0
65356,4,3,228978,228978,228981,0,3,0
65357,2,1,228980,228981,228982,1,2,0
65358,1,2,228981,228982,228984,1,3,0
65359,2,1,228983,228984,228985,1,2,0
65360,1,1,228984,228985,228986,1,2,0
65361,6,3,228990,228990,228993,0,3,4
65362,5,1,228995,228995,228996,0,1,2
65363,2,3,228997,228997,229000,0,3,1
65364,1,3,228998,229000,229003,2,5,0
65365,3,1,229001,229003,229004,2,3,0
65366,5,1,229006,229006,229007,0,1,2
65367,3,1,229009,229009,229010,0,1,2
65368,5,2,229014,229014,229016,0,2,4
65369,4,2,229018,229018,229020,0,2,2
65370,3,2,229021,229021,229023,0,2,1
65371,1,2,229022,229023,229025,1,3,0
65372,6,3,229028,229028,229031,0,3,3
65373,3,2,229031,229031,229033,0,2,0
65374,3,1,229034,229034,229035,0,1,1
65375,5,3,229039,229039,229042,0,3,4
65376,2,1,229041,229042,229043,1,2,0
65377,2,2,229043,229043,229045,0,2,0
65378,6,1,229049,229049,229050,0,1,4
65379,1,3,229050,229050,229053,0,3,0
65380,6,3,229056,229056,229059,0,3,3
65381,6,3,229062,229062,229065,0,3,3
65382,3,2,229065,229065,229067,0,2,0
65383,5,2,229070,229070,229072,0,2,3
65384,6,2,229076,229076,229078,0,2,4
65385,4,1,229080,229080,229081,0,1,2
65386,2,1,229082,229082,229083,0,1,1
65387,1,3,229083,229083,229086,0,3,0
65388,5,2,229088,229088,229090,0,2,2
65389,4,1,229092,229092,229093,0,1,2
65390,3,1,229095,229095,229096,0,1,2
65391,5,3,229100,229100,229103,0,3,4
65392,4,1,229104,229104,229105,0,1,1
65393,6,2,229110,229110,229112,0,2,5
65394,4,2,229114,229114,229116,0,2,2
65395,3,3,229117,229117,229120,0,3,1
65396,5,3,229122,229122,229125,0,3,2
65397,1,2,229123,229125,229127,2,4,0
65398,5,3,229128,229128,229131,0,3,1
65399,1,2,229129,229131,229133,2,4,0
65400,2,3,229131,229133,229136,2,5,0
65401,3,1,229134,229136,229137,2,3,0
65402,5,3,229139,229139,229142,0,3,2
65403,2,2,229141,229142,229144,1,3,0
65404,1,2,229142,229144,229146,2,4,0
65405,1,3,229143,229146,229149,3,6,0
65406,3,3,229146,229149,229152,3,6,0
65407,1,1,229147,229152,229153,5,6,0
65408,5,3,229152,229153,229156,1,4,0
65409,1,1,229153,229156,229157,3,4,0
65410,1,1,229154,229157,229158,3,4,0
65411,4,1,229158,229158,229159,0,1,0
65412,6,3,229164,229164,229167,0,3,5
65413,6,1,229170,229170,229171,0,1,3
65414,1,3,229171,229171,229174,0,3,0
65415,4,2,229175,229175,229177,0,2,1
65416,1,3,229176,229177,229180,1,4,0
65417,1,1,229177,229180,229181,3,4,0
65418,5,2,229182,229182,229184,0,2,1
65419,3,1,229185,229185,229186,0,1,1
65420,4,2,229189,229189,229191,0,2,3
65421,6,3,229195,229195,229198,0,3,4
65422,5,2,229200,229200,229202,0,2,2
65423,4,1,229204,229204,229205,0,1,2
65424,6,3,229210,229210,229213,0,3,5
65425,2,2,229212,229213,229215,1,3,0
65426,4,1,229216,229216,229217,0,1,1
65427,1,2,229217,229217,229219,0,2,0
65428,1,3,229218,229219,229222,1,4,0
65429,3,1,229221,229222,229223,1,2,0
65430,2,1,229223,229223,229224,0,1,0
65431,4,3,229227,229227,229230,0,3,3
65432,1,2,229228,229230,229232,2,4,0
65433,6,3,229234,229234,229237,0,3,2
65434,6,1,229240,229240,229241,0,1,3
65435,2,1,229242,229242,229243,0,1,1
65436,1,2,229243,229243,229245,0,2,0
65437,3,3,229246,229246,229249,0,3,1
65438,1,2,229247,229249,229251,2,4,0
65439,3,1,229250,229251,229252,1,2,0
65440,1,3,229251,229252,229255,1,4,0
65441,3,1,229254,229255,229256,1,2,0
65442,1,2,229255,229256,229258,1,3,0
65443,6,3,229261,229261,229264,0,3,3
65444,1,2,229262,229264,229266,2,4,0
65445,4,3,229266,229266,229269,0,3,0
65446,3,3,229269,229269,229272,0,3,0
65447,4,2,229273,229273,229275,0,2,1
65448,6,1,229279,229279,229280,0,1,4
65449,6,3,229285,229285,229288,0,3,5
65450,6,1,229291,229291,229292,0,1,3
65451,2,2,229293,229293,229295,0,2,1
65452,5,2,229298,229298,229300,0,2,3
65453,3,1,229301,229301,229302,0,1,1
65454,6,1,229307,229307,229308,0,1,5
65455,4,2,229311,229311,229313,0,2,3
65456,5,3,229316,229316,229319,0,3,3
65457,4,2,229320,229320,229322,0,2,1
65458,2,2,229322,229322,229324,0,2,0
65459,4,1,229326,229326,229327,0,1,2
65460,6,2,229332,229332,229334,0,2,5
65461,3,2,229335,229335,229337,0,2,1
65462,4,1,229339,229339,229340,0,1,2
65463,2,3,229341,229341,229344,0,3,1
65464,1,2,229342,229344,229346,2,4,0
65465,1,1,229343,229346,229347,3,4,0
65466,4,2,229347,229347,229349,0,2,0
65467,3,3,229350,229350,229353,0,3,1
65468,5,3,229355,229355,229358,0,3,2
65469,5,1,229360,229360,229361,0,1,2
65470,5,3,229365,229365,229368,0,3,4
65471,2,2,229367,229368,229370,1,3,0
65472,6,2,229373,229373,229375,0,2,3
65473,2,2,229375,229375,229377,0,2,0
65474,6,2,229381,229381,229383,0,2,4
65475,6,3,229387,229387,229390,0,3,4
65476,3,2,229390,229390,229392,0,2,0
65477,3,1,229393,229393,229394,0,1,1
65478,2,1,229395,229395,229396,0,1,1
65479,5,1,229400,229400,229401,0,1,4
65480,3,1,229403,229403,229404,0,1,2
65481,4,2,229407,229407,229409,0,2,3
65482,6,1,229413,229413,229414,0,1,4
65483,1,1,229414,229414,229415,0,1,0
65484,3,2,229417,229417,229419,0,2,2
65485,4,1,229421,229421,229422,0,1,2
65486,2,2,229423,229423,229425,0,2,1
65487,5,1,229428,229428,229429,0,1,3
65488,6,2,229434,229434,229436,0,2,5
65489,6,3,229440,229440,229443,0,3,4
65490,4,3,229444,229444,229447,0,3,1
65491,4,3,229448,229448,229451,0,3,1
65492,1,2,229449,229451,229453,2,4,0
65493,5,2,229454,229454,229456,0,2,1
65494,1,2,229455,229456,229458,1,3,0
65495,4,1,229459,229459,229460,0,1,1
65496,1,1,229460,229460,229461,0,1,0
65497,3,2,229463,229463,229465,0,2,2
65498,4,1,229467,229467,229468,0,1,2
65499,4,2,229471,229471,229473,0,2,3
65500,6,3,229477,229477,229480,0,3,4
65501,2,1,229479,229480,229481,1,2,0
65502,1,3,229480,229481,229484,1,4,0
65503,6,3,229486,229486,229489,0,3,2
65504,1,3,229487,229489,229492,2,5,0
65505,6,1,229493,229493,229494,0,1,1
65506,2,3,229495,229495,229498,0,3,1
65507,2,1,229497,229498,229499,1,2,0
65508,1,2,229498,229499,229501,1,3,0
65509,4,1,229502,229502,229503,0,1,1
65510,2,1,229504,229504,229505,0,1,1
65511,4,2,229508,229508,229510,0,2,3
65512,6,2,229514,229514,229516,0,2,4
65513,1,3,229515,229516,229519,1,4,0
65514,1,3,229516,229519,229522,3,6,0
65515,4,1,229520,229522,229523,2,3,0
65516,4,1,229524,229524,229525,0,1,1
65517,3,2,229527,229527,229529,0,2,2
65518,6,2,229533,229533,229535,0,2,4
65519,1,1,229534,229535,229536,1,2,0
65520,1,3,229535,229536,229539,1,4,0
65521,3,2,229538,229539,229541,1,3,0
65522,2,1,229540,229541,229542,1,2,0
65523,1,2,229541,229542,229544,1,3,0
65524,3,2,229544,229544,229546,0,2,0
65525,1,3,229545,229546,229549,1,4,0
65526,2,3,229547,229549,229552,2,5,0
65527,3,1,229550,229552,229553,2,3,0
65528,2,3,229552,229553,229556,1,4,0
65529,4,1,229556,229556,229557,0,1,0
65530,3,3,229559,229559,229562,0,3,2
65531,2,2,229561,229562,229564,1,3,0
65532,5,1,229566,229566,229567,0,1,2
65533,6,3,229572,229572,229575,0,3,5
65534,6,3,229578,229578,229581,0,3,3
65535,6,2,229584,229584,229586,0,2,3
65536,4,2,229588,229588,229590,0,2,2
65537,1,3,229589,229590,229593,1,4,0
65538,2,2,229591,229593,229595,2,4,0
65539,1,2,229592,229595,229597,3,5,0
65540,2,1,229594,229597,229598,3,4,0
65541,3,1,229597,229598,229599,1,2,0
65542,4,2,229601,229601,229603,0,2,2
65543,1,2,229602,229603,229605,1,3,0
65544,3,3,229605,229605,229608,0,3,0
65545,4,2,229609,229609,229611,0,2,1
65546,3,1,229612,229612,229613,0,1,1
65547,4,3,229616,229616,229619,0,3,3
65548,4,1,229620,229620,229621,0,1,1
65549,5,1,229625,229625,229626,0,1,4
65550,1,3,229626,229626,229629,0,3,0
65551,6,3,229632,229632,229635,0,3,3
65552,1,2,229633,229635,229637,2,4,0
65553,3,3,229636,229637,229640,1,4,0
65554,2,1,229638,229640,229641,2,3,0
65555,5,3,229643,229643,229646,0,3,2
65556,6,2,229649,229649,229651,0,2,3
65557,1,1,229650,229651,229652,1,2,0
65558,2,3,229652,229652,229655,0,3,0
65559,2,2,229654,229655,229657,1,3,0
65560,5,2,229659,229659,229661,0,2,2
65561,5,2,229664,229664,229666,0,2,3
65562,6,2,229670,229670,229672,0,2,4
65563,6,1,229676,229676,229677,0,1,4
65564,1,2,229677,229677,229679,0,2,0
65565,2,3,229679,229679,229682,0,3,0
65566,6,2,229685,229685,229687,0,2,3
65567,4,3,229689,229689,229692,0,3,2
65568,2,3,229691,229692,229695,1,4,0
65569,2,3,229693,229695,229698,2,5,0
65570,2,1,229695,229698,229699,3,4,0
65571,1,3,229696,229699,229702,3,6,0
65572,2,3,229698,229702,229705,4,7,0
65573,2,1,229700,229705,229706,5,6,0
65574,5,3,229705,229706,229709,1,4,0
65575,1,3,229706,229709,229712,3,6,0
65576,6,3,229712,229712,229715,0,3,0
65577,1,3,229713,229715,229718,2,5,0
65578,1,1,229714,229718,229719,4,5,0
65579,3,2,229717,229719,229721,2,4,0
65580,6,1,229723,229723,229724,0,1,2
65581,2,3,229725,229725,229728,0,3,1
65582,3,2,229728,229728,229730,0,2,0
65583,3,2,229731,229731,229733,0,2,1
65584,4,1,229735,229735,229736,0,1,2
65585,1,1,229736,229736,229737,0,1,0
65586,2,1,229738,229738,229739,0,1,1
65587,6,3,229744,229744,229747,0,3,5
65588,1,2,229745,229747,229749,2,4,0
65589,6,3,229751,229751,229754,0,3,2
65590,6,2,229757,229757,229759,0,2,3
65591,6,2,229763,229763,229765,0,2,4
65592,6,1,229769,229769,229770,0,1,4
65593,4,2,229773,229773,229775,0,2,3
65594,2,2,229775,229775,229777,0,2,0
65595,5,3,229780,229780,229783,0,3,3
65596,3,3,229783,229783,229786,0,3,0
65597,1,1,229784,229786,229787,2,3,0
65598,1,3,229785,229787,229790,2,5,0
65599,3,2,229788,229790,229792,2,4,0
65600,2,1,229790,229792,229793,2,3,0
65601,1,1,229791,229793,229794,2,3,0
65602,3,2,229794,229794,229796,0,2,0
65603,4,1,229798,229798,229799,0,1,2
65604,6,3,229804,229804,229807,0,3,5
65605,3,1,229807,229807,229808,0,1,0
65606,2,1,229809,229809,229810,0,1,1
65607,2,1,229811,229811,229812,0,1,1
65608,1,1,229812,229812,229813,0,1,0
65609,2,3,229814,229814,229817,0,3,1
65610,4,1,229818,229818,229819,0,1,1
65611,2,1,229820,229820,229821,0,1,1
65612,3,3,229823,229823,229826,0,3,2
65613,6,2,229829,229829,229831,0,2,3
65614,4,1,229833,229833,229834,0,1,2
65615,4,1,229837,229837,229838,0,1,3
65616,6,3,229843,229843,229846,0,3,5
65617,2,1,229845,229846,229847,1,2,0
65618,2,1,229847,229847,229848,0,1,0
65619,1,3,229848,229848,229851,0,3,0
65620,4,2,229852,229852,229854,0,2,1
65621,4,3,229856,229856,229859,0,3,2
65622,2,2,229858,229859,229861,1,3,0
65623,6,1,229864,229864,229865,0,1,3
65624,5,1,229869,229869,229870,0,1,4
65625,6,3,229875,229875,229878,0,3,5
65626,3,1,229878,229878,229879,0,1,0
65627,4,2,229882,229882,229884,0,2,3
65628,4,1,229886,229886,229887,0,1,2
65629,4,3,229890,229890,229893,0,3,3
65630,3,3,229893,229893,229896,0,3,0
65631,1,2,229894,229896,229898,2,4,0
65632,4,1,229898,229898,229899,0,1,0
65633,5,2,229903,229903,229905,0,2,4
65634,5,3,229908,229908,229911,0,3,3
65635,1,2,229909,229911,229913,2,4,0
65636,6,3,229915,229915,229918,0,3,2
65637,3,2,229918,229918,229920,0,2,0
65638,1,2,229919,229920,229922,1,3,0
65639,4,1,229923,229923,229924,0,1,1
65640,6,3,229929,229929,229932,0,3,5
65641,3,3,229932,229932,229935,0,3,0
65642,2,2,229934,229935,229937,1,3,0
65643,5,1,229939,229939,229940,0,1,2
65644,4,2,229943,229943,229945,0,2,3
65645,2,2,229945,229945,229947,0,2,0
65646,1,1,229946,229947,229948,1,2,0
65647,1,2,229947,229948,229950,1,3,0
65648,6,2,229953,229953,229955,0,2,3
65649,1,3,229954,229955,229958,1,4,0
65650,1,1,229955,229958,229959,3,4,0
65651,6,2,229961,229961,229963,0,2,2
65652,2,1,229963,229963,229964,0,1,0
65653,3,2,229966,229966,229968,0,2,2
65654,6,2,229972,229972,229974,0,2,4
65655,6,2,229978,229978,229980,0,2,4
65656,1,2,229979,229980,229982,1,3,0
65657,3,3,229982,229982,229985,0,3,0
65658,6,1,229988,229988,229989,0,1,3
65659,3,2,229991,229991,229993,0,2,2
65660,3,3,229994,229994,229997,0,3,1
65661,5,3,229999,229999,230002,0,3,2
65662,5,2,230004,230004,230006,0,2,2
65663,4,3,230008,230008,230011,0,3,2
65664,2,2,230010,230011,230013,1,3,0
65665,5,1,230015,230015,230016,0,1,2
65666,4,3,230019,230019,230022,0,3,3
65667,3,1,230022,230022,230023,0,1,0
65668,5,2,230027,230027,230029,0,2,4
65669,1,1,230028,230029,230030,1,2,0
65670,2,3,230030,230030,230033,0,3,0
65671,1,2,230031,230033,230035,2,4,0
65672,2,2,230033,230035,230037,2,4,0
65673,3,3,230036,230037,230040,1,4,0
65674,6,2,230042,230042,230044,0,2,2
65675,4,3,230046,230046,230049,0,3,2
65676,2,2,230048,230049,230051,1,3,0
65677,2,2,230050,230051,230053,1,3,0
65678,3,3,230053,230053,230056,0,3,0
65679,1,3,230054,230056,230059,2,5,0
65680,6,3,230060,230060,230063,0,3,1
65681,6,2,230066,230066,230068,0,2,3
65682,1,3,230067,230068,230071,1,4,0
65683,3,3,230070,230071,230074,1,4,0
65684,6,1,230076,230076,230077,0,1,2
65685,5,3,230081,230081,230084,0,3,4
65686,1,2,230082,230084,230086,2,4,0
65687,5,2,230087,230087,230089,0,2,1
65688,1,2,230088,230089,230091,1,3,0
65689,3,3,230091,230091,230094,0,3,0
65690,5,2,230096,230096,230098,0,2,2
65691,4,2,230100,230100,230102,0,2,2
65692,1,2,230101,230102,230104,1,3,0
65693,6,3,230107,230107,230110,0,3,3
65694,2,1,230109,230110,230111,1,2,0
65695,2,1,230111,230111,230112,0,1,0
65696,3,2,230114,230114,230116,0,2,2
65697,6,1,230120,230120,230121,0,1,4
65698,2,3,230122,230122,230125,0,3,1
65699,3,1,230125,230125,230126,0,1,0
65700,2,2,230127,230127,230129,0,2,1
65701,2,1,230129,230129,230130,0,1,0
65702,5,2,230134,230134,230136,0,2,4
65703,1,3,230135,230136,230139,1,4,0
65704,6,3,230141,230141,230144,0,3,2
65705,3,1,230144,230144,230145,0,1,0
65706,3,3,230147,230147,230150,0,3,2
65707,4,2,230151,230151,230153,0,2,1
65708,3,2,230154,230154,230156,0,2,1
65709,5,3,230159,230159,230162,0,3,3
65710,4,3,230163,230163,230166,0,3,1
65711,4,1,230167,230167,230168,0,1,1
65712,3,2,230170,230170,230172,0,2,2
65713,4,3,230174,230174,230177,0,3,2
65714,5,2,230179,230179,230181,0,2,2
65715,3,3,230182,230182,230185,0,3,1
65716,6,1,230188,230188,230189,0,1,3
65717,3,1,230191,230191,230192,0,1,2
65718,6,3,230197,230197,230200,0,3,5
65719,6,1,230203,230203,230204,0,1,3
65720,1,3,230204,230204,230207,0,3,0
65721,2,2,230206,230207,230209,1,3,0
65722,5,1,230211,230211,230212,0,1,2
65723,1,3,230212,230212,230215,0,3,0
65724,3,2,230215,230215,230217,0,2,0
65725,6,3,230221,230221,230224,0,3,4
65726,2,2,230223,230224,230226,1,3,0
65727,6,3,230229,230229,230232,0,3,3
65728,4,3,230233,230233,230236,0,3,1
65729,5,2,230238,230238,230240,0,2,2
65730,5,2,230243,230243,230245,0,2,3
65731,5,1,230248,230248,230249,0,1,3
65732,4,3,230252,230252,230255,0,3,3
65733,5,2,230257,230257,230259,0,2,2
65734,1,3,230258,230259,230262,1,4,0
65735,5,3,230263,230263,230266,0,3,1
65736,2,1,230265,230266,230267,1,2,0
65737,4,1,230269,230269,230270,0,1,2
65738,1,3,230270,230270,230273,0,3,0
65739,6,1,230276,230276,230277,0,1,3
65740,3,3,230279,230279,230282,0,3,2
65741,2,1,230281,230282,230283,1,2,0
65742,3,1,230284,230284,230285,0,1,1
65743,4,1,230288,230288,230289,0,1,3
65744,5,2,230293,230293,230295,0,2,4
65745,2,3,230295,230295,230298,0,3,0
65746,6,1,230301,230301,230302,0,1,3
65747,2,3,230303,230303,230306,0,3,1
65748,6,1,230309,230309,230310,0,1,3
65749,6,3,230315,230315,230318,0,3,5
65750,2,2,230317,230318,230320,1,3,0
65751,5,2,230322,230322,230324,0,2,2
65752,6,2,230328,230328,230330,0,2,4
65753,4,3,230332,230332,230335,0,3,2
65754,2,3,230334,230335,230338,1,4,0
65755,5,1,230339,230339,230340,0,1,1
65756,6,3,230345,230345,230348,0,3,5
65757,5,3,230350,230350,230353,0,3,2
65758,1,1,230351,230353,230354,2,3,0
65759,6,1,230357,230357,230358,0,1,3
65760,6,3,230363,230363,230366,0,3,5
65761,3,2,230366,230366,230368,0,2,0
65762,6,1,230372,230372,230373,0,1,4
65763,4,3,230376,230376,230379,0,3,3
65764,2,2,230378,230379,230381,1,3,0
65765,1,2,230379,230381,230383,2,4,0
65766,5,1,230384,230384,230385,0,1,1
65767,6,1,230390,230390,230391,0,1,5
65768,1,3,230391,230391,230394,0,3,0
65769,3,1,230394,230394,230395,0,1,0
65770,1,3,230395,230395,230398,0,3,0
65771,4,2,230399,230399,230401,0,2,1
65772,1,3,230400,230401,230404,1,4,0
65773,4,1,230404,230404,230405,0,1,0
65774,6,1,230410,230410,230411,0,1,5
65775,5,3,230415,230415,230418,0,3,4
65776,2,3,230417,230418,230421,1,4,0
65777,5,1,230422,230422,230423,0,1,1
65778,4,1,230426,230426,230427,0,1,3
65779,5,2,230431,230431,230433,0,2,4
65780,5,3,230436,230436,230439,0,3,3
65781,2,3,230438,230439,230442,1,4,0
65782,2,1,230440,230442,230443,2,3,0
65783,4,1,230444,230444,230445,0,1,1
65784,2,3,230446,230446,230449,0,3,1
65785,1,2,230447,230449,230451,2,4,0
65786,2,3,230449,230451,230454,2,5,0
65787,6,3,230455,230455,230458,0,3,1
65788,4,1,230459,230459,230460,0,1,1
65789,1,2,230460,230460,230462,0,2,0
65790,3,3,230463,230463,230466,0,3,1
65791,3,2,230466,230466,230468,0,2,0
65792,3,1,230469,230469,230470,0,1,1
65793,2,1,230471,230471,230472,0,1,1
65794,1,1,230472,230472,230473,0,1,0
65795,3,1,230475,230475,230476,0,1,2
65796,4,2,230479,230479,230481,0,2,3
65797,5,2,230484,230484,230486,0,2,3
65798,4,1,230488,230488,230489,0,1,2
65799,4,1,230492,230492,230493,0,1,3
65800,1,1,230493,230493,230494,0,1,0
65801,5,1,230498,230498,230499,0,1,4
65802,3,2,230501,230501,230503,0,2,2
65803,3,3,230504,230504,230507,0,3,1
65804,1,1,230505,230507,230508,2,3,0
65805,4,1,230509,230509,230510,0,1,1
65806,2,3,230511,230511,230514,0,3,1
65807,4,3,230515,230515,230518,0,3,1
65808,3,3,230518,230518,230521,0,3,0
65809,6,3,230524,230524,230527,0,3,3
65810,2,2,230526,230527,230529,1,3,0
65811,4,1,230530,230530,230531,0,1,1
65812,6,2,230536,230536,230538,0,2,5
65813,6,1,230542,230542,230543,0,1,4
65814,6,3,230548,230548,230551,0,3,5
65815,3,1,230551,230551,230552,0,1,0
65816,6,3,230557,230557,230560,0,3,5
65817,2,3,230559,230560,230563,1,4,0
65818,3,1,230562,230563,230564,1,2,0
65819,2,1,230564,230564,230565,0,1,0
65820,2,1,230566,230566,230567,0,1,1
65821,1,1,230567,230567,230568,0,1,0
65822,3,1,230570,230570,230571,0,1,2
65823,6,1,230576,230576,230577,0,1,5
65824,2,2,230578,230578,230580,0,2,1
65825,4,2,230582,230582,230584,0,2,2
65826,4,3,230586,230586,230589,0,3,2
65827,1,3,230587,230589,230592,2,5,0
65828,6,1,230593,230593,230594,0,1,1
65829,2,1,230595,230595,230596,0,1,1
65830,6,1,230601,230601,230602,0,1,5
65831,6,3,230607,230607,230610,0,3,5
65832,1,3,230608,230610,230613,2,5,0
65833,2,3,230610,230613,230616,3,6,0
65834,4,3,230614,230616,230619,2,5,0
65835,4,1,230618,230619,230620,1,2,0
65836,2,2,230620,230620,230622,0,2,0
65837,2,1,230622,230622,230623,0,1,0
65838,6,3,230628,230628,230631,0,3,5
65839,6,1,230634,230634,230635,0,1,3
65840,5,1,230639,230639,230640,0,1,4
65841,6,1,230645,230645,230646,0,1,5
65842,6,2,230651,230651,230653,0,2,5
65843,2,1,230653,230653,230654,0,1,0
65844,2,2,230655,230655,230657,0,2,1
65845,6,1,230661,230661,230662,0,1,4
65846,2,1,230663,230663,230664,0,1,1
65847,1,3,230664,230664,230667,0,3,0
65848,6,3,230670,230670,230673,0,3,3
65849,6,1,230676,230676,230677,0,1,3
65850,3,3,230679,230679,230682,0,3,2
65851,3,1,230682,230682,230683,0,1,0
65852,1,1,230683,230683,230684,0,1,0
65853,6,1,230689,230689,230690,0,1,5
65854,2,2,230691,230691,230693,0,2,1
65855,6,2,230697,230697,230699,0,2,4
65856,2,2,230699,230699,230701,0,2,0
65857,4,1,230703,230703,230704,0,1,2
65858,3,1,230706,230706,230707,0,1,2
65859,5,1,230711,230711,230712,0,1,4
65860,5,2,230716,230716,230718,0,2,4
65861,5,2,230721,230721,230723,0,2,3
65862,5,1,230726,230726,230727,0,1,3
65863,5,2,230731,230731,230733,0,2,4
65864,4,2,230735,230735,230737,0,2,2
65865,1,1,230736,230737,230738,1,2,0
65866,5,3,230741,230741,230744,0,3,3
65867,3,1,230744,230744,230745,0,1,0
65868,1,2,230745,230745,230747,0,2,0
65869,4,2,230749,230749,230751,0,2,2
65870,1,1,230750,230751,230752,1,2,0
65871,6,3,230756,230756,230759,0,3,4
65872,6,1,230762,230762,230763,0,1,3
65873,3,2,230765,230765,230767,0,2,2
65874,3,2,230768,230768,230770,0,2,1
65875,5,3,230773,230773,230776,0,3,3
65876,1,2,230774,230776,230778,2,4,0
65877,1,1,230775,230778,230779,3,4,0
65878,2,1,230777,230779,230780,2,3,0
65879,3,1,230780,230780,230781,0,1,0
65880,6,3,230786,230786,230789,0,3,5
65881,3,2,230789,230789,230791,0,2,0
65882,3,2,230792,230792,230794,0,2,1
65883,3,2,230795,230795,230797,0,2,1
65884,6,3,230801,230801,230804,0,3,4
65885,5,2,230806,230806,230808,0,2,2
65886,2,1,230808,230808,230809,0,1,0
65887,5,3,230813,230813,230816,0,3,4
65888,5,3,230818,230818,230821,0,3,2
65889,5,1,230823,230823,230824,0,1,2
65890,5,3,230828,230828,230831,0,3,4
65891,6,1,230834,230834,230835,0,1,3
65892,1,2,230835,230835,230837,0,2,0
65893,1,2,230836,230837,230839,1,3,0
65894,5,1,230841,230841,230842,0,1,2
65895,6,1,230847,230847,230848,0,1,5
65896,6,2,230853,230853,230855,0,2,5
65897,3,2,230856,230856,230858,0,2,1
65898,1,2,230857,230858,230860,1,3,0
65899,2,1,230859,230860,230861,1,2,0
65900,2,3,230861,230861,230864,0,3,0
65901,5,3,230866,230866,230869,0,3,2
65902,4,2,230870,230870,230872,0,2,1
65903,3,2,230873,230873,230875,0,2,1
65904,3,2,230876,230876,230878,0,2,1
65905,6,2,230882,230882,230884,0,2,4
65906,3,1,230885,230885,230886,0,1,1
65907,1,3,230886,230886,230889,0,3,0
65908,6,3,230892,230892,230895,0,3,3
65909,2,2,230894,230895,230897,1,3,0
65910,5,3,230899,230899,230902,0,3,2
65911,6,2,230905,230905,230907,0,2,3
65912,4,1,230909,230909,230910,0,1,2
65913,1,3,230910,230910,230913,0,3,0
65914,4,2,230914,230914,230916,0,2,1
65915,3,3,230917,230917,230920,0,3,1
65916,4,3,230921,230921,230924,0,3,1
65917,1,3,230922,230924,230927,2,5,0
65918,1,3,230923,230927,230930,4,7,0
65919,2,3,230925,230930,230933,5,8,0
65920,1,1,230926,230933,230934,7,8,0
65921,6,3,230932,230934,230937,2,5,0
65922,3,3,230935,230937,230940,2,5,0
65923,3,3,230938,230940,230943,2,5,0
65924,6,2,230944,230944,230946,0,2,1
65925,5,1,230949,230949,230950,0,1,3
65926,2,3,230951,230951,230954,0,3,1
65927,5,1,230956,230956,230957,0,1,2
65928,3,2,230959,230959,230961,0,2,2
65929,4,3,230963,230963,230966,0,3,2
65930,1,1,230964,230966,230967,2,3,0
65931,3,1,230967,230967,230968,0,1,0
65932,4,1,230971,230971,230972,0,1,3
65933,5,2,230976,230976,230978,0,2,4
65934,1,3,230977,230978,230981,1,4,0
65935,3,1,230980,230981,230982,1,2,0
65936,1,1,230981,230982,230983,1,2,0
65937,2,2,230983,230983,230985,0,2,0
65938,6,2,230989,230989,230991,0,2,4
65939,3,3,230992,230992,230995,0,3,1
65940,6,3,230998,230998,231001,0,3,3
65941,3,3,231001,231001,231004,0,3,0
65942,1,1,231002,231004,231005,2,3,0
65943,1,2,231003,231005,231007,2,4,0
65944,6,2,231009,231009,231011,0,2,2
65945,3,2,231012,231012,231014,0,2,1
65946,3,1,231015,231015,231016,0,1,1
65947,3,1,231018,231018,231019,0,1,2
65948,1,3,231019,231019,231022,0,3,0
65949,4,1,231023,231023,231024,0,1,1
65950,5,3,231028,231028,231031,0,3,4
65951,2,1,231030,231031,231032,1,2,0
65952,2,2,231032,231032,231034,0,2,0
65953,4,3,231036,231036,231039,0,3,2
65954,1,2,231037,231039,231041,2,4,0
65955,1,2,231038,231041,231043,3,5,0
65956,4,2,231042,231043,231045,1,3,0
65957,2,2,231044,231045,231047,1,3,0
65958,1,1,231045,231047,231048,2,3,0
65959,5,3,231050,231050,231053,0,3,2
65960,2,3,231052,231053,231056,1,4,0
65961,6,3,231058,231058,231061,0,3,2
65962,1,1,231059,231061,231062,2,3,0
65963,6,2,231065,231065,231067,0,2,3
65964,4,1,231069,231069,231070,0,1,2
65965,3,1,231072,231072,231073,0,1,2
65966,6,2,231078,231078,231080,0,2,5
65967,6,2,231084,231084,231086,0,2,4
65968,1,2,231085,231086,231088,1,3,0
65969,3,1,231088,231088,231089,0,1,0
65970,3,3,231091,231091,231094,0,3,2
65971,2,3,231093,231094,231097,1,4,0
65972,6,3,231099,231099,231102,0,3,2
65973,3,2,231102,231102,231104,0,2,0
65974,5,1,231107,231107,231108,0,1,3
65975,6,1,231113,231113,231114,0,1,5
65976,4,1,231117,231117,231118,0,1,3
65977,5,3,231122,231122,231125,0,3,4
65978,2,3,231124,231125,231128,1,4,0
65979,4,1,231128,231128,231129,0,1,0
65980,3,1,231131,231131,231132,0,1,2
65981,3,1,231134,231134,231135,0,1,2
65982,2,3,231136,231136,231139,0,3,1
65983,4,2,231140,231140,231142,0,2,1
65984,4,2,231144,231144,231146,0,2,2
65985,2,3,231146,231146,231149,0,3,0
65986,3,1,231149,231149,231150,0,1,0
65987,5,2,231154,231154,231156,0,2,4
65988,6,1,231160,231160,231161,0,1,4
65989,3,3,231163,231163,231166,0,3,2
65990,4,1,231167,231167,231168,0,1,1
65991,6,1,231173,231173,231174,0,1,5
65992,2,1,231175,231175,231176,0,1,1
65993,4,2,231179,231179,231181,0,2,3
65994,6,2,231185,231185,231187,0,2,4
65995,4,2,231189,231189,231191,0,2,2
65996,2,1,231191,231191,231192,0,1,0
65997,5,2,231196,231196,231198,0,2,4
65998,1,1,231197,231198,231199,1,2,0
65999,6,3,231203,231203,231206,0,3,4
66000,6,2,231209,231209,231211,0,2,3
66001,6,2,231215,231215,231217,0,2,4
66002,2,3,231217,231217,231220,0,3,0
66003,3,2,231220,231220,231222,0,2,0
66004,5,3,231225,231225,231228,0,3,3
66005,5,2,231230,231230,231232,0,2,2
66006,3,3,231233,231233,231236,0,3,1
66007,3,1,231236,231236,231237,0,1,0
66008,4,1,231240,231240,231241,0,1,3
66009,1,1,231241,231241,231242,0,1,0
66010,4,2,231245,231245,231247,0,2,3
66011,6,3,231251,231251,231254,0,3,4
66012,1,3,231252,231254,231257,2,5,0
66013,6,2,231258,231258,231260,0,2,1
66014,1,2,231259,231260,231262,1,3,0
66015,1,3,231260,231262,231265,2,5,0
66016,6,2,231266,231266,231268,0,2,1
66017,2,3,231268,231268,231271,0,3,0
66018,4,3,231272,231272,231275,0,3,1
66019,4,3,231276,231276,231279,0,3,1
66020,4,2,231280,231280,231282,0,2,1
66021,4,2,231284,231284,231286,0,2,2
66022,4,3,231288,231288,231291,0,3,2
66023,1,2,231289,231291,231293,2,4,0
66024,6,2,231295,231295,231297,0,2,2
66025,3,2,231298,231298,231300,0,2,1
66026,1,3,231299,231300,231303,1,4,0
66027,5,3,231304,231304,231307,0,3,1
66028,1,1,231305,231307,231308,2,3,0
66029,6,3,231311,231311,231314,0,3,3
66030,4,2,231315,231315,231317,0,2,1
66031,4,2,231319,231319,231321,0,2,2
66032,2,1,231321,231321,231322,0,1,0
66033,1,3,231322,231322,231325,0,3,0
66034,6,3,231328,231328,231331,0,3,3
66035,3,2,231331,231331,231333,0,2,0
66036,4,3,231335,231335,231338,0,3,2
66037,4,3,231339,231339,231342,0,3,1
66038,5,1,231344,231344,231345,0,1,2
66039,2,3,231346,231346,231349,0,3,1
66040,3,3,231349,231349,231352,0,3,0
66041,1,2,231350,231352,231354,2,4,0
66042,5,3,231355,231355,231358,0,3,1
66043,1,3,231356,231358,231361,2,5,0
66044,4,1,231360,231361,231362,1,2,0
66045,3,3,231363,231363,231366,0,3,1
66046,1,2,231364,231366,231368,2,4,0
66047,1,1,231365,231368,231369,3,4,0
66048,2,3,231367,231369,231372,2,5,0
66049,4,2,231371,231372,231374,1,3,0
66050,5,3,231376,231376,231379,0,3,2
66051,1,2,231377,231379,231381,2,4,0
66052,4,2,231381,231381,231383,0,2,0
66053,1,1,231382,231383,231384,1,2,0
66054,1,3,231383,231384,231387,1,4,0
66055,6,3,231389,231389,231392,0,3,2
66056,2,3,231391,231392,231395,1,4,0
66057,5,1,231396,231396,231397,0,1,1
66058,3,1,231399,231399,231400,0,1,2
66059,3,2,231402,231402,231404,0,2,2
66060,1,2,231403,231404,231406,1,3,0
66061,5,1,231408,231408,231409,0,1,2
66062,2,1,231410,231410,231411,0,1,1
66063,2,3,231412,231412,231415,0,3,1
66064,4,1,231416,231416,231417,0,1,1
66065,5,3,231421,231421,231424,0,3,4
66066,6,2,231427,231427,231429,0,2,3
66067,6,1,231433,231433,231434,0,1,4
66068,5,2,231438,231438,231440,0,2,4
66069,1,2,231439,231440,231442,1,3,0
66070,6,2,231445,231445,231447,0,2,3
66071,6,1,231451,231451,231452,0,1,4
66072,6,1,231457,231457,231458,0,1,5
66073,3,3,231460,231460,231463,0,3,2
66074,3,2,231463,231463,231465,0,2,0
66075,5,2,231468,231468,231470,0,2,3
66076,4,2,231472,231472,231474,0,2,2
66077,2,1,231474,231474,231475,0,1,0
66078,5,3,231479,231479,231482,0,3,4
66079,4,1,231483,231483,231484,0,1,1
66080,6,3,231489,231489,231492,0,3,5
66081,5,1,231494,231494,231495,0,1,2
66082,2,2,231496,231496,231498,0,2,1
66083,2,3,231498,231498,231501,0,3,0
66084,1,1,231499,231501,231502,2,3,0
66085,2,3,231501,231502,231505,1,4,0
66086,5,1,231506,231506,231507,0,1,1
66087,5,1,231511,231511,231512,0,1,4
66088,3,3,231514,231514,231517,0,3,2
66089,1,1,231515,231517,231518,2,3,0
66090,2,1,231517,231518,231519,1,2,0
66091,5,2,231522,231522,231524,0,2,3
66092,5,2,231527,231527,231529,0,2,3
66093,3,3,231530,231530,231533,0,3,1
66094,6,1,231536,231536,231537,0,1,3
66095,4,3,231540,231540,231543,0,3,3
66096,2,1,231542,231543,231544,1,2,0
66097,4,2,231546,231546,231548,0,2,2
66098,2,2,231548,231548,231550,0,2,0
66099,4,3,231552,231552,231555,0,3,2
66100,3,2,231555,231555,231557,0,2,0
66101,4,2,231559,231559,231561,0,2,2
66102,4,3,231563,231563,231566,0,3,2
66103,5,2,231568,231568,231570,0,2,2
66104,2,1,231570,231570,231571,0,1,0
66105,3,3,231573,231573,231576,0,3,2
66106,1,1,231574,231576,231577,2,3,0
66107,3,1,231577,231577,231578,0,1,0
66108,6,2,231583,231583,231585,0,2,5
66109,4,2,231587,231587,231589,0,2,2
66110,6,3,231593,231593,231596,0,3,4
66111,4,1,231597,231597,231598,0,1,1
66112,4,2,231601,231601,231603,0,2,3
66113,5,3,231606,231606,231609,0,3,3
66114,2,3,231608,231609,231612,1,4,0
66115,6,1,231614,231614,231615,0,1,2
66116,4,1,231618,231618,231619,0,1,3
66117,6,2,231624,231624,231626,0,2,5
66118,4,1,231628,231628,231629,0,1,2
66119,6,1,231634,231634,231635,0,1,5
66120,5,1,231639,231639,231640,0,1,4
66121,4,3,231643,231643,231646,0,3,3
66122,5,3,231648,231648,231651,0,3,2
66123,4,2,231652,231652,231654,0,2,1
66124,6,1,231658,231658,231659,0,1,4
66125,4,1,231662,231662,231663,0,1,3
66126,5,1,231667,231667,231668,0,1,4
66127,6,1,231673,231673,231674,0,1,5
66128,3,3,231676,231676,231679,0,3,2
66129,5,3,231681,231681,231684,0,3,2
66130,1,3,231682,231684,231687,2,5,0
66131,4,1,231686,231687,231688,1,2,0
66132,3,1,231689,231689,231690,0,1,1
66133,3,3,231692,231692,231695,0,3,2
66134,2,2,231694,231695,231697,1,3,0
66135,4,1,231698,231698,231699,0,1,1
66136,5,2,231703,231703,231705,0,2,4
66137,4,2,231707,231707,231709,0,2,2
66138,4,1,231711,231711,231712,0,1,2
66139,5,3,231716,231716,231719,0,3,4
66140,3,1,231719,231719,231720,0,1,0
66141,5,3,231724,231724,231727,0,3,4
66142,5,1,231729,231729,231730,0,1,2
66143,4,1,231733,231733,231734,0,1,3
66144,2,2,231735,231735,231737,0,2,1
66145,5,2,231740,231740,231742,0,2,3
66146,5,2,231745,231745,231747,0,2,3
66147,1,2,231746,231747,231749,1,3,0
66148,5,1,231751,231751,231752,0,1,2
66149,3,3,231754,231754,231757,0,3,2
66150,3,1,231757,231757,231758,0,1,0
66151,1,2,231758,231758,231760,0,2,0
66152,6,3,231764,231764,231767,0,3,4
66153,2,3,231766,231767,231770,1,4,0
66154,5,2,231771,231771,231773,0,2,1
66155,2,1,231773,231773,231774,0,1,0
66156,3,2,231776,231776,231778,0,2,2
66157,2,1,231778,231778,231779,0,1,0
66158,3,2,231781,231781,231783,0,2,2
66159,3,2,231784,231784,231786,0,2,1
66160,6,1,231790,231790,231791,0,1,4
66161,5,3,231795,231795,231798,0,3,4
66162,6,3,231801,231801,231804,0,3,3
66163,1,2,231802,231804,231806,2,4,0
66164,1,3,231803,231806,231809,3,6,0
66165,5,2,231808,231809,231811,1,3,0
66166,4,3,231812,231812,231815,0,3,1
66167,3,3,231815,231815,231818,0,3,0
66168,5,2,231820,231820,231822,0,2,2
66169,4,3,231824,231824,231827,0,3,2
66170,4,1,231828,231828,231829,0,1,1
66171,4,2,231832,231832,231834,0,2,3
66172,5,2,231837,231837,231839,0,2,3
66173,6,2,231843,231843,231845,0,2,4
66174,6,3,231849,231849,231852,0,3,4
66175,6,3,231855,231855,231858,0,3,3
66176,2,3,231857,231858,231861,1,4,0
66177,6,2,231863,231863,231865,0,2,2
66178,4,1,231867,231867,231868,0,1,2
66179,2,2,231869,231869,231871,0,2,1
66180,2,3,231871,231871,231874,0,3,0
66181,5,2,231876,231876,231878,0,2,2
66182,3,3,231879,231879,231882,0,3,1
66183,1,1,231880,231882,231883,2,3,0
66184,2,2,231882,231883,231885,1,3,0
66185,5,3,231887,231887,231890,0,3,2
66186,1,3,231888,231890,231893,2,5,0
66187,4,2,231892,231893,231895,1,3,0
66188,4,3,231896,231896,231899,0,3,1
66189,6,2,231902,231902,231904,0,2,3
66190,2,1,231904,231904,231905,0,1,0
66191,6,3,231910,231910,231913,0,3,5
66192,4,2,231914,231914,231916,0,2,1
66193,2,3,231916,231916,231919,0,3,0
66194,5,2,231921,231921,231923,0,2,2
66195,5,1,231926,231926,231927,0,1,3
66196,1,1,231927,231927,231928,0,1,0
66197,4,2,231931,231931,231933,0,2,3
66198,1,3,231932,231933,231936,1,4,0
66199,3,1,231935,231936,231937,1,2,0
66200,2,3,231937,231937,231940,0,3,0
66201,3,3,231940,231940,231943,0,3,0
66202,3,1,231943,231943,231944,0,1,0
66203,5,2,231948,231948,231950,0,2,4
66204,1,2,231949,231950,231952,1,3,0
66205,1,3,231950,231952,231955,2,5,0
66206,4,1,231954,231955,231956,1,2,0
66207,6,3,231960,231960,231963,0,3,4
66208,4,2,231964,231964,231966,0,2,1
66209,1,2,231965,231966,231968,1,3,0
66210,5,2,231970,231970,231972,0,2,2
66211,4,1,231974,231974,231975,0,1,2
66212,4,2,231978,231978,231980,0,2,3
66213,1,1,231979,231980,231981,1,2,0
66214,4,2,231983,231983,231985,0,2,2
66215,3,2,231986,231986,231988,0,2,1
66216,1,3,231987,231988,231991,1,4,0
66217,1,3,231988,231991,231994,3,6,0
66218,5,2,231993,231994,231996,1,3,0
66219,1,2,231994,231996,231998,2,4,0
66220,2,3,231996,231998,232001,2,5,0
66221,1,2,231997,232001,232003,4,6,0
66222,4,2,232001,232003,232005,2,4,0
66223,2,1,232003,232005,232006,2,3,0
66224,2,1,232005,232006,232007,1,2,0
66225,2,1,232007,232007,232008,0,1,0
66226,1,1,232008,232008,232009,0,1,0
66227,4,2,232012,232012,232014,0,2,3
66228,5,1,232017,232017,232018,0,1,3
66229,1,2,232018,232018,232020,0,2,0
66230,2,1,232020,232020,232021,0,1,0
66231,2,1,232022,232022,232023,0,1,1
66232,5,2,232027,232027,232029,0,2,4
66233,6,2,232033,232033,232035,0,2,4
66234,6,1,232039,232039,232040,0,1,4
66235,2,1,232041,232041,232042,0,1,1
66236,5,3,232046,232046,232049,0,3,4
66237,3,1,232049,232049,232050,0,1,0
66238,5,3,232054,232054,232057,0,3,4
66239,5,1,232059,232059,232060,0,1,2
66240,1,3,232060,232060,232063,0,3,0
66241,3,3,232063,232063,232066,0,3,0
66242,1,1,232064,232066,232067,2,3,0
66243,1,2,232065,232067,232069,2,4,0
66244,3,1,232068,232069,232070,1,2,0
66245,4,1,232072,232072,232073,0,1,2
66246,2,3,232074,232074,232077,0,3,1
66247,6,3,232080,232080,232083,0,3,3
66248,3,2,232083,232083,232085,0,2,0
66249,1,3,232084,232085,232088,1,4,0
66250,4,2,232088,232088,232090,0,2,0
66251,5,3,232093,232093,232096,0,3,3
66252,5,1,232098,232098,232099,0,1,2
66253,4,1,232102,232102,232103,0,1,3
66254,4,3,232106,232106,232109,0,3,3
66255,2,2,232108,232109,232111,1,3,0
66256,4,3,232112,232112,232115,0,3,1
66257,2,1,232114,232115,232116,1,2,0
66258,4,2,232118,232118,232120,0,2,2
66259,2,1,232120,232120,232121,0,1,0
66260,4,2,232124,232124,232126,0,2,3
66261,5,1,232129,232129,232130,0,1,3
66262,3,3,232132,232132,232135,0,3,2
66263,5,3,232137,232137,232140,0,3,2
66264,4,1,232141,232141,232142,0,1,1
66265,4,1,232145,232145,232146,0,1,3
66266,3,1,232148,232148,232149,0,1,2
66267,6,2,232154,232154,232156,0,2,5
66268,6,1,232160,232160,232161,0,1,4
66269,5,1,232165,232165,232166,0,1,4
66270,3,1,232168,232168,232169,0,1,2
66271,4,1,232172,232172,232173,0,1,3
66272,2,3,232174,232174,232177,0,3,1
66273,1,3,232175,232177,232180,2,5,0
66274,1,1,232176,232180,232181,4,5,0
66275,6,3,232182,232182,232185,0,3,1
66276,5,1,232187,232187,232188,0,1,2
66277,2,2,232189,232189,232191,0,2,1
66278,5,2,232194,232194,232196,0,2,3
66279,6,3,232200,232200,232203,0,3,4
66280,3,3,232203,232203,232206,0,3,0
66281,1,3,232204,232206,232209,2,5,0
66282,3,2,232207,232209,232211,2,4,0
66283,5,2,232212,232212,232214,0,2,1
66284,2,3,232214,232214,232217,0,3,0
66285,2,2,232216,232217,232219,1,3,0
66286,3,3,232219,232219,232222,0,3,0
66287,1,1,232220,232222,232223,2,3,0
66288,1,3,232221,232223,232226,2,5,0
66289,1,1,232222,232226,232227,4,5,0
66290,3,2,232225,232227,232229,2,4,0
66291,5,3,232230,232230,232233,0,3,1
66292,2,1,232232,232233,232234,1,2,0
66293,4,2,232236,232236,232238,0,2,2
66294,5,1,232241,232241,232242,0,1,3
66295,6,1,232247,232247,232248,0,1,5
66296,6,2,232253,232253,232255,0,2,5
66297,4,1,232257,232257,232258,0,1,2
66298,5,3,232262,232262,232265,0,3,4
66299,6,1,232268,232268,232269,0,1,3
66300,4,1,232272,232272,232273,0,1,3
66301,6,1,232278,232278,232279,0,1,5
66302,2,2,232280,232280,232282,0,2,1
66303,5,1,232285,232285,232286,0,1,3
66304,6,2,232291,232291,232293,0,2,5
66305,5,1,232296,232296,232297,0,1,3
66306,6,2,232302,232302,232304,0,2,5
66307,2,1,232304,232304,232305,0,1,0
66308,2,1,232306,232306,232307,0,1,1
66309,5,2,232311,232311,232313,0,2,4
66310,2,2,232313,232313,232315,0,2,0
66311,3,3,232316,232316,232319,0,3,1
66312,6,1,232322,232322,232323,0,1,3
66313,4,1,232326,232326,232327,0,1,3
66314,6,1,232332,232332,232333,0,1,5
66315,2,2,232334,232334,232336,0,2,1
66316,4,2,232338,232338,232340,0,2,2
66317,5,2,232343,232343,232345,0,2,3
66318,3,3,232346,232346,232349,0,3,1
66319,5,2,232351,232351,232353,0,2,2
66320,6,2,232357,232357,232359,0,2,4
66321,2,3,232359,232359,232362,0,3,0
66322,5,3,232364,232364,232367,0,3,2
66323,5,1,232369,232369,232370,0,1,2
66324,4,3,232373,232373,232376,0,3,3
66325,1,3,232374,232376,232379,2,5,0
66326,2,1,232376,232379,232380,3,4,0
66327,1,3,232377,232380,232383,3,6,0
66328,6,2,232383,232383,232385,0,2,0
66329,6,2,232389,232389,232391,0,2,4
66330,2,1,232391,232391,232392,0,1,0
66331,6,2,232397,232397,232399,0,2,5
66332,6,1,232403,232403,232404,0,1,4
66333,4,1,232407,232407,232408,0,1,3
66334,4,2,232411,232411,232413,0,2,3
66335,6,3,232417,232417,232420,0,3,4
66336,1,3,232418,232420,232423,2,5,0
66337,5,3,232423,232423,232426,0,3,0
66338,6,1,232429,232429,232430,0,1,3
66339,5,2,232434,232434,232436,0,2,4
66340,6,3,232440,232440,232443,0,3,4
66341,2,3,232442,232443,232446,1,4,0
66342,1,3,232443,232446,232449,3,6,0
66343,1,2,232444,232449,232451,5,7,0
66344,6,3,232450,232451,232454,1,4,0
66345,1,1,232451,232454,232455,3,4,0
66346,4,1,232455,232455,232456,0,1,0
66347,5,1,232460,232460,232461,0,1,4
66348,3,3,232463,232463,232466,0,3,2
66349,3,2,232466,232466,232468,0,2,0
66350,1,2,232467,232468,232470,1,3,0
66351,4,2,232471,232471,232473,0,2,1
66352,3,2,232474,232474,232476,0,2,1
66353,6,2,232480,232480,232482,0,2,4
66354,5,3,232485,232485,232488,0,3,3
66355,2,3,232487,232488,232491,1,4,0
66356,4,2,232491,232491,232493,0,2,0
66357,1,2,232492,232493,232495,1,3,0
66358,5,3,232497,232497,232500,0,3,2
66359,6,2,232503,232503,232505,0,2,3
66360,5,2,232508,232508,232510,0,2,3
66361,5,2,232513,232513,232515,0,2,3
66362,3,2,232516,232516,232518,0,2,1
66363,2,1,232518,232518,232519,0,1,0
66364,4,1,232522,232522,232523,0,1,3
66365,2,2,232524,232524,232526,0,2,1
66366,3,3,232527,232527,232530,0,3,1
66367,3,1,232530,232530,232531,0,1,0
66368,6,1,232536,232536,232537,0,1,5
66369,1,1,232537,232537,232538,0,1,0
66370,4,3,232541,232541,232544,0,3,3
66371,6,1,232547,232547,232548,0,1,3
66372,3,1,232550,232550,232551,0,1,2
66373,5,1,232555,232555,232556,0,1,4
66374,4,1,232559,232559,232560,0,1,3
66375,1,3,232560,232560,232563,0,3,0
66376,6,3,232566,232566,232569,0,3,3
66377,1,2,232567,232569,232571,2,4,0
66378,5,2,232572,232572,232574,0,2,1
66379,6,1,232578,232578,232579,0,1,4
66380,1,1,232579,232579,232580,0,1,0
66381,4,3,232583,232583,232586,0,3,3
66382,2,3,232585,232586,232589,1,4,0
66383,3,2,232588,232589,232591,1,3,0
66384,5,3,232593,232593,232596,0,3,2
66385,4,3,232597,232597,232600,0,3,1
66386,6,2,232603,232603,232605,0,2,3
66387,2,3,232605,232605,232608,0,3,0
66388,4,3,232609,232609,232612,0,3,1
66389,4,1,232613,232613,232614,0,1,1
66390,1,3,232614,232614,232617,0,3,0
66391,6,3,232620,232620,232623,0,3,3
66392,1,2,232621,232623,232625,2,4,0
66393,5,1,232626,232626,232627,0,1,1
66394,6,3,232632,232632,232635,0,3,5
66395,3,1,232635,232635,232636,0,1,0
66396,5,3,232640,232640,232643,0,3,4
66397,4,3,232644,232644,232647,0,3,1
66398,4,3,232648,232648,232651,0,3,1
66399,6,3,232654,232654,232657,0,3,3
66400,6,2,232660,232660,232662,0,2,3
66401,2,1,232662,232662,232663,0,1,0
66402,1,1,232663,232663,232664,0,1,0
66403,5,2,232668,232668,232670,0,2,4
66404,2,2,232670,232670,232672,0,2,0
66405,5,3,232675,232675,232678,0,3,3
66406,2,3,232677,232678,232681,1,4,0
66407,2,3,232679,232681,232684,2,5,0
66408,5,2,232684,232684,232686,0,2,0
66409,4,1,232688,232688,232689,0,1,2
66410,4,2,232692,232692,232694,0,2,3
66411,1,2,232693,232694,232696,1,3,0
66412,2,2,232695,232696,232698,1,3,0
66413,6,1,232701,232701,232702,0,1,3
66414,2,1,232703,232703,232704,0,1,1
66415,1,1,232704,232704,232705,0,1,0
66416,1,3,232705,232705,232708,0,3,0
66417,5,2,232710,232710,232712,0,2,2
66418,4,1,232714,232714,232715,0,1,2
66419,1,1,232715,232715,232716,0,1,0
66420,2,1,232717,232717,232718,0,1,1
66421,2,3,232719,232719,232722,0,3,1
66422,2,2,232721,232722,232724,1,3,0
66423,3,1,232724,232724,232725,0,1,0
66424,6,1,232730,232730,232731,0,1,5
66425,1,2,232731,232731,232733,0,2,0
66426,4,1,232735,232735,232736,0,1,2
66427,3,3,232738,232738,232741,0,3,2
66428,6,3,232744,232744,232747,0,3,3
66429,4,1,232748,232748,232749,0,1,1
66430,5,1,232753,232753,232754,0,1,4
66431,6,1,232759,232759,232760,0,1,5
66432,5,3,232764,232764,232767,0,3,4
66433,2,2,232766,232767,232769,1,3,0
66434,2,2,232768,232769,232771,1,3,0
66435,3,1,232771,232771,232772,0,1,0
66436,4,3,232775,232775,232778,0,3,3
66437,2,1,232777,232778,232779,1,2,0
66438,5,3,232782,232782,232785,0,3,3
66439,6,3,232788,232788,232791,0,3,3
66440,1,3,232789,232791,232794,2,5,0
66441,6,1,232795,232795,232796,0,1,1
66442,4,1,232799,232799,232800,0,1,3
66443,1,2,232800,232800,232802,0,2,0
66444,6,1,232806,232806,232807,0,1,4
66445,6,1,232812,232812,232813,0,1,5
66446,5,1,232817,232817,232818,0,1,4
66447,5,1,232822,232822,232823,0,1,4
66448,4,2,232826,232826,232828,0,2,3
66449,2,3,232828,232828,232831,0,3,0
66450,1,1,232829,232831,232832,2,3,0
66451,3,1,232832,232832,232833,0,1,0
66452,6,2,232838,232838,232840,0,2,5
66453,4,2,232842,232842,232844,0,2,2
66454,5,2,232847,232847,232849,0,2,3
66455,6,3,232853,232853,232856,0,3,4
66456,3,2,232856,232856,232858,0,2,0
66457,6,2,232862,232862,232864,0,2,4
66458,1,1,232863,232864,232865,1,2,0
66459,1,3,232864,232865,232868,1,4,0
66460,6,2,232870,232870,232872,0,2,2
66461,4,2,232874,232874,232876,0,2,2
66462,5,1,232879,232879,232880,0,1,3
66463,4,3,232883,232883,232886,0,3,3
66464,2,3,232885,232886,232889,1,4,0
66465,4,2,232889,232889,232891,0,2,0
66466,1,1,232890,232891,232892,1,2,0
66467,5,1,232895,232895,232896,0,1,3
66468,3,2,232898,232898,232900,0,2,2
66469,4,3,232902,232902,232905,0,3,2
66470,1,3,232903,232905,232908,2,5,0
66471,3,2,232906,232908,232910,2,4,0
66472,1,3,232907,232910,232913,3,6,0
66473,5,1,232912,232913,232914,1,2,0
66474,5,2,232917,232917,232919,0,2,3
66475,1,3,232918,232919,232922,1,4,0
66476,3,3,232921,232922,232925,1,4,0
66477,6,2,232927,232927,232929,0,2,2
66478,5,3,232932,232932,232935,0,3,3
66479,1,2,232933,232935,232937,2,4,0
66480,5,2,232938,232938,232940,0,2,1
66481,3,1,232941,232941,232942,0,1,1
66482,4,1,232945,232945,232946,0,1,3
66483,5,3,232950,232950,232953,0,3,4
66484,3,3,232953,232953,232956,0,3,0
66485,4,2,232957,232957,232959,0,2,1
66486,3,3,232960,232960,232963,0,3,1
66487,4,2,232964,232964,232966,0,2,1
66488,5,3,232969,232969,232972,0,3,3
66489,1,3,232970,232972,232975,2,5,0
66490,1,1,232971,232975,232976,4,5,0
66491,3,1,232974,232976,232977,2,3,0
66492,3,3,232977,232977,232980,0,3,0
66493,2,3,232979,232980,232983,1,4,0
66494,2,1,232981,232983,232984,2,3,0
66495,4,3,232985,232985,232988,0,3,1
66496,6,3,232991,232991,232994,0,3,3
66497,4,1,232995,232995,232996,0,1,1
66498,5,2,233000,233000,233002,0,2,4
66499,6,3,233006,233006,233009,0,3,4
66500,6,1,233012,233012,233013,0,1,3
66501,5,2,233017,233017,233019,0,2,4
66502,1,2,233018,233019,233021,1,3,0
66503,2,3,233020,233021,233024,1,4,0
66504,5,2,233025,233025,233027,0,2,1
66505,6,3,233031,233031,233034,0,3,4
66506,4,1,233035,233035,233036,0,1,1
66507,3,3,233038,233038,233041,0,3,2
66508,1,2,233039,233041,233043,2,4,0
66509,5,3,233044,233044,233047,0,3,1
66510,6,1,233050,233050,233051,0,1,3
66511,2,2,233052,233052,233054,0,2,1
66512,5,3,233057,233057,233060,0,3,3
66513,2,3,233059,233060,233063,1,4,0
66514,5,1,233064,233064,233065,0,1,1
66515,1,3,233065,233065,233068,0,3,0
66516,1,2,233066,233068,233070,2,4,0
66517,2,3,233068,233070,233073,2,5,0
66518,6,1,233074,233074,233075,0,1,1
66519,2,1,233076,233076,233077,0,1,1
66520,6,2,233082,233082,233084,0,2,5
66521,2,3,233084,233084,233087,0,3,0
66522,6,2,233090,233090,233092,0,2,3
66523,5,3,233095,233095,233098,0,3,3
66524,2,2,233097,233098,233100,1,3,0
66525,4,3,233101,233101,233104,0,3,1
66526,1,1,233102,233104,233105,2,3,0
66527,3,1,233105,233105,233106,0,1,0
66528,3,3,233108,233108,233111,0,3,2
66529,6,1,233114,233114,233115,0,1,3
66530,1,1,233115,233115,233116,0,1,0
66531,3,3,233118,233118,233121,0,3,2
66532,6,2,233124,233124,233126,0,2,3
66533,1,3,233125,233126,233129,1,4,0
66534,2,3,233127,233129,233132,2,5,0
66535,2,1,233129,233132,233133,3,4,0
66536,5,1,233134,233134,233135,0,1,1
66537,6,1,233140,233140,233141,0,1,5
66538,2,3,233142,233142,233145,0,3,1
66539,3,2,233145,233145,233147,0,2,0
66540,4,1,233149,233149,233150,0,1,2
66541,2,2,233151,233151,233153,0,2,1
66542,2,3,233153,233153,233156,0,3,0
66543,6,2,233159,233159,233161,0,2,3
66544,6,1,233165,233165,233166,0,1,4
66545,6,3,233171,233171,233174,0,3,5
66546,6,2,233177,233177,233179,0,2,3
66547,5,2,233182,233182,233184,0,2,3
66548,3,3,233185,233185,233188,0,3,1
66549,3,3,233188,233188,233191,0,3,0
66550,6,1,233194,233194,233195,0,1,3
66551,5,3,233199,233199,233202,0,3,4
66552,3,1,233202,233202,233203,0,1,0
66553,3,3,233205,233205,233208,0,3,2
66554,5,2,233210,233210,233212,0,2,2
66555,4,1,233214,233214,233215,0,1,2
66556,1,3,233215,233215,233218,0,3,0
66557,4,3,233219,233219,233222,0,3,1
66558,1,1,233220,233222,233223,2,3,0
66559,4,1,233224,233224,233225,0,1,1
66560,6,1,233230,233230,233231,0,1,5
66561,3,2,233233,233233,233235,0,2,2
66562,2,3,233235,233235,233238,0,3,0
66563,5,2,233240,233240,233242,0,2,2
66564,3,1,233243,233243,233244,0,1,1
66565,6,1,233249,233249,233250,0,1,5
66566,4,1,233253,233253,233254,0,1,3
66567,4,1,233257,233257,233258,0,1,3
66568,4,1,233261,233261,233262,0,1,3
66569,6,2,233267,233267,233269,0,2,5
66570,1,3,233268,233269,233272,1,4,0
66571,4,2,233272,233272,233274,0,2,0
66572,5,1,233277,233277,233278,0,1,3
66573,2,3,233279,233279,233282,0,3,1
66574,3,1,233282,233282,233283,0,1,0
66575,1,2,233283,233283,233285,0,2,0
66576,2,2,233285,233285,233287,0,2,0
66577,3,3,233288,233288,233291,0,3,1
66578,5,2,233293,233293,233295,0,2,2
66579,2,1,233295,233295,233296,0,1,0
66580,4,1,233299,233299,233300,0,1,3
66581,3,2,233302,233302,233304,0,2,2
66582,4,3,233306,233306,233309,0,3,2
66583,4,3,233310,233310,233313,0,3,1
66584,1,1,233311,233313,233314,2,3,0
66585,6,3,233317,233317,233320,0,3,3
66586,4,1,233321,233321,233322,0,1,1
66587,5,3,233326,233326,233329,0,3,4
66588,4,2,233330,233330,233332,0,2,1
66589,2,1,233332,233332,233333,0,1,0
66590,5,2,233337,233337,233339,0,2,4
66591,6,3,233343,233343,233346,0,3,4
66592,6,2,233349,233349,233351,0,2,3
66593,1,1,233350,233351,233352,1,2,0
66594,4,1,233354,233354,233355,0,1,2
66595,1,2,233355,233355,233357,0,2,0
66596,3,1,233358,233358,233359,0,1,1
66597,2,3,233360,233360,233363,0,3,1
66598,2,3,233362,233363,233366,1,4,0
66599,4,1,233366,233366,233367,0,1,0
66600,5,3,233371,233371,233374,0,3,4
66601,2,1,233373,233374,233375,1,2,0
66602,5,1,233378,233378,233379,0,1,3
66603,4,2,233382,233382,233384,0,2,3
66604,1,1,233383,233384,233385,1,2,0
66605,3,2,233386,233386,233388,0,2,1
66606,2,1,233388,233388,233389,0,1,0
66607,5,1,233393,233393,233394,0,1,4
66608,5,2,233398,233398,233400,0,2,4
66609,5,3,233403,233403,233406,0,3,3
66610,5,3,233408,233408,233411,0,3,2
66611,6,3,233414,233414,233417,0,3,3
66612,2,3,233416,233417,233420,1,4,0
66613,3,2,233419,233420,233422,1,3,0
66614,6,3,233425,233425,233428,0,3,3
66615,3,1,233428,233428,233429,0,1,0
66616,1,1,233429,233429,233430,0,1,0
66617,5,1,233434,233434,233435,0,1,4
66618,3,2,233437,233437,233439,0,2,2
66619,4,1,233441,233441,233442,0,1,2
66620,3,2,233444,233444,233446,0,2,2
66621,3,1,233447,233447,233448,0,1,1
66622,1,2,233448,233448,233450,0,2,0
66623,3,3,233451,233451,233454,0,3,1
66624,1,2,233452,233454,233456,2,4,0
66625,6,3,233458,233458,233461,0,3,2
66626,4,1,233462,233462,233463,0,1,1
66627,6,2,233468,233468,233470,0,2,5
66628,1,1,233469,233470,233471,1,2,0
66629,1,2,233470,233471,233473,1,3,0
66630,3,2,233473,233473,233475,0,2,0
66631,3,2,233476,233476,233478,0,2,1
66632,3,1,233479,233479,233480,0,1,1
66633,3,2,233482,233482,233484,0,2,2
66634,1,1,233483,233484,233485,1,2,0
66635,4,1,233487,233487,233488,0,1,2
66636,4,3,233491,233491,233494,0,3,3
66637,3,2,233494,233494,233496,0,2,0
66638,2,3,233496,233496,233499,0,3,0
66639,2,2,233498,233499,233501,1,3,0
66640,2,1,233500,233501,233502,1,2,0
66641,5,1,233505,233505,233506,0,1,3
66642,2,2,233507,233507,233509,0,2,1
66643,1,3,233508,233509,233512,1,4,0
66644,4,2,233512,233512,233514,0,2,0
66645,4,1,233516,233516,233517,0,1,2
66646,3,1,233519,233519,233520,0,1,2
66647,2,2,233521,233521,233523,0,2,1
66648,1,3,233522,233523,233526,1,4,0
66649,5,2,233527,233527,233529,0,2,1
66650,3,2,233530,233530,233532,0,2,1
66651,3,1,233533,233533,233534,0,1,1
66652,2,1,233535,233535,233536,0,1,1
66653,1,3,233536,233536,233539,0,3,0
66654,5,1,233541,233541,233542,0,1,2
66655,2,1,233543,233543,233544,0,1,1
66656,2,3,233545,233545,233548,0,3,1
66657,2,1,233547,233548,233549,1,2,0
66658,6,1,233553,233553,233554,0,1,4
66659,6,2,233559,233559,233561,0,2,5
66660,6,1,233565,233565,233566,0,1,4
66661,2,2,233567,233567,233569,0,2,1
66662,2,2,233569,233569,233571,0,2,0
66663,4,3,233573,233573,233576,0,3,2
66664,2,1,233575,233576,233577,1,2,0
66665,3,1,233578,233578,233579,0,1,1
66666,3,3,233581,233581,233584,0,3,2
66667,5,3,233586,233586,233589,0,3,2
66668,1,1,233587,233589,233590,2,3,0
66669,4,1,233591,233591,233592,0,1,1
66670,5,2,233596,233596,233598,0,2,4
66671,6,1,233602,233602,233603,0,1,4
66672,6,2,233608,233608,233610,0,2,5
66673,1,1,233609,233610,233611,1,2,0
66674,1,3,233610,233611,233614,1,4,0
66675,3,1,233613,233614,233615,1,2,0
66676,1,3,233614,233615,233618,1,4,0
66677,1,1,233615,233618,233619,3,4,0
66678,2,3,233617,233619,233622,2,5,0
66679,4,3,233621,233622,233625,1,4,0
66680,4,2,233625,233625,233627,0,2,0
66681,3,2,233628,233628,233630,0,2,1
66682,5,2,233633,233633,233635,0,2,3
66683,2,3,233635,233635,233638,0,3,0
66684,2,3,233637,233638,233641,1,4,0
66685,2,1,233639,233641,233642,2,3,0
66686,6,3,233645,233645,233648,0,3,3
66687,3,3,233648,233648,233651,0,3,0
66688,6,1,233654,233654,233655,0,1,3
66689,4,2,233658,233658,233660,0,2,3
66690,5,1,233663,233663,233664,0,1,3
66691,2,2,233665,233665,233667,0,2,1
66692,1,2,233666,233667,233669,1,3,0
66693,2,1,233668,233669,233670,1,2,0
66694,2,2,233670,233670,233672,0,2,0
66695,3,2,233673,233673,233675,0,2,1
66696,1,1,233674,233675,233676,1,2,0
66697,5,2,233679,233679,233681,0,2,3
66698,3,1,233682,233682,233683,0,1,1
66699,3,2,233685,233685,233687,0,2,2
66700,5,2,233690,233690,233692,0,2,3
66701,4,1,233694,233694,233695,0,1,2
66702,1,3,233695,233695,233698,0,3,0
66703,4,2,233699,233699,233701,0,2,1
66704,4,1,233703,233703,233704,0,1,2
66705,2,1,233705,233705,233706,0,1,1
66706,6,2,233711,233711,233713,0,2,5
66707,5,3,233716,233716,233719,0,3,3
66708,4,3,233720,233720,233723,0,3,1
66709,3,2,233723,233723,233725,0,2,0
66710,2,3,233725,233725,233728,0,3,0
66711,4,1,233729,233729,233730,0,1,1
66712,3,2,233732,233732,233734,0,2,2
66713,4,2,233736,233736,233738,0,2,2
66714,1,2,233737,233738,233740,1,3,0
66715,3,1,233740,233740,233741,0,1,0
66716,5,3,233745,233745,233748,0,3,4
66717,6,2,233751,233751,233753,0,2,3
66718,2,1,233753,233753,233754,0,1,0
66719,3,3,233756,233756,233759,0,3,2
66720,3,2,233759,233759,233761,0,2,0
66721,2,1,233761,233761,233762,0,1,0
66722,2,1,233763,233763,233764,0,1,1
66723,6,1,233769,233769,233770,0,1,5
66724,3,1,233772,233772,233773,0,1,2
66725,1,2,233773,233773,233775,0,2,0
66726,1,2,233774,233775,233777,1,3,0
66727,1,2,233775,233777,233779,2,4,0
66728,1,1,233776,233779,233780,3,4,0
66729,6,3,233782,233782,233785,0,3,2
66730,4,3,233786,233786,233789,0,3,1
66731,3,3,233789,233789,233792,0,3,0
66732,1,2,233790,233792,233794,2,4,0
66733,4,2,233794,233794,233796,0,2,0
66734,1,1,233795,233796,233797,1,2,0
66735,1,1,233796,233797,233798,1,2,0
66736,5,2,233801,233801,233803,0,2,3
66737,1,2,233802,233803,233805,1,3,0
66738,4,2,233806,233806,233808,0,2,1
66739,6,2,233812,233812,233814,0,2,4
66740,1,3,233813,233814,233817,1,4,0
66741,3,2,233816,233817,233819,1,3,0
66742,2,1,233818,233819,233820,1,2,0
66743,6,3,233824,233824,233827,0,3,4
66744,2,1,233826,233827,233828,1,2,0
66745,6,2,233832,233832,233834,0,2,4
66746,4,2,233836,233836,233838,0,2,2
66747,1,2,233837,233838,233840,1,3,0
66748,1,3,233838,233840,233843,2,5,0
66749,2,1,233840,233843,233844,3,4,0
66750,2,2,233842,233844,233846,2,4,0
66751,4,2,233846,233846,233848,0,2,0
66752,2,2,233848,233848,233850,0,2,0
66753,2,3,233850,233850,233853,0,3,0
66754,3,3,233853,233853,233856,0,3,0
66755,4,2,233857,233857,233859,0,2,1
66756,4,2,233861,233861,233863,0,2,2
66757,4,1,233865,233865,233866,0,1,2
66758,5,2,233870,233870,233872,0,2,4
66759,3,2,233873,233873,233875,0,2,1
66760,4,1,233877,233877,233878,0,1,2
66761,3,1,233880,233880,233881,0,1,2
66762,4,2,233884,233884,233886,0,2,3
66763,5,2,233889,233889,233891,0,2,3
66764,2,3,233891,233891,233894,0,3,0
66765,1,2,233892,233894,233896,2,4,0
66766,2,2,233894,233896,233898,2,4,0
66767,1,1,233895,233898,233899,3,4,0
66768,5,1,233900,233900,233901,0,1,1
66769,1,2,233901,233901,233903,0,2,0
66770,3,1,233904,233904,233905,0,1,1
66771,5,2,233909,233909,233911,0,2,4
66772,5,2,233914,233914,233916,0,2,3
66773,6,1,233920,233920,233921,0,1,4
66774,3,2,233923,233923,233925,0,2,2
66775,1,3,233924,233925,233928,1,4,0
66776,2,1,233926,233928,233929,2,3,0
66777,4,3,233930,233930,233933,0,3,1
66778,6,1,233936,233936,233937,0,1,3
66779,6,2,233942,233942,233944,0,2,5
66780,6,1,233948,233948,233949,0,1,4
66781,6,2,233954,233954,233956,0,2,5
66782,2,2,233956,233956,233958,0,2,0
66783,6,1,233962,233962,233963,0,1,4
66784,3,3,233965,233965,233968,0,3,2
66785,3,3,233968,233968,233971,0,3,0
66786,3,1,233971,233971,233972,0,1,0
66787,2,3,233973,233973,233976,0,3,1
66788,3,3,233976,233976,233979,0,3,0
66789,3,1,233979,233979,233980,0,1,0
66790,3,3,233982,233982,233985,0,3,2
66791,1,2,233983,233985,233987,2,4,0
66792,5,3,233988,233988,233991,0,3,1
66793,2,3,233990,233991,233994,1,4,0
66794,2,2,233992,233994,233996,2,4,0
66795,3,1,233995,233996,233997,1,2,0
66796,5,1,234000,234000,234001,0,1,3
66797,1,3,234001,234001,234004,0,3,0
66798,4,3,234005,234005,234008,0,3,1
66799,1,3,234006,234008,234011,2,5,0
66800,3,2,234009,234011,234013,2,4,0
66801,3,3,234012,234013,234016,1,4,0
66802,1,1,234013,234016,234017,3,4,0
66803,2,3,234015,234017,234020,2,5,0
66804,2,1,234017,234020,234021,3,4,0
66805,3,1,234020,234021,234022,1,2,0
66806,6,3,234026,234026,234029,0,3,4
66807,4,2,234030,234030,234032,0,2,1
66808,6,2,234036,234036,234038,0,2,4
66809,1,1,234037,234038,234039,1,2,0
66810,4,3,234041,234041,234044,0,3,2
66811,3,3,234044,234044,234047,0,3,0
66812,1,1,234045,234047,234048,2,3,0
66813,4,3,234049,234049,234052,0,3,1
66814,5,2,234054,234054,234056,0,2,2
66815,2,3,234056,234056,234059,0,3,0
66816,3,2,234059,234059,234061,0,2,0
66817,2,1,234061,234061,234062,0,1,0
66818,4,2,234065,234065,234067,0,2,3
66819,1,1,234066,234067,234068,1,2,0
66820,2,1,234068,234068,234069,0,1,0
66821,5,3,234073,234073,234076,0,3,4
66822,6,3,234079,234079,234082,0,3,3
66823,5,1,234084,234084,234085,0,1,2
66824,1,2,234085,234085,234087,0,2,0
66825,1,3,234086,234087,234090,1,4,0
66826,2,2,234088,234090,234092,2,4,0
66827,2,2,234090,234092,234094,2,4,0
66828,4,2,234094,234094,234096,0,2,0
66829,1,3,234095,234096,234099,1,4,0
66830,1,1,234096,234099,234100,3,4,0
66831,2,1,234098,234100,234101,2,3,0
66832,3,1,234101,234101,234102,0,1,0
66833,5,3,234106,234106,234109,0,3,4
66834,6,3,234112,234112,234115,0,3,3
66835,3,1,234115,234115,234116,0,1,0
66836,4,2,234119,234119,234121,0,2,3
66837,4,2,234123,234123,234125,0,2,2
66838,1,2,234124,234125,234127,1,3,0
66839,2,3,234126,234127,234130,1,4,0
66840,3,3,234129,234130,234133,1,4,0
66841,6,3,234135,234135,234138,0,3,2
66842,3,2,234138,234138,234140,0,2,0
66843,5,1,234143,234143,234144,0,1,3
66844,2,3,234145,234145,234148,0,3,1
66845,1,3,234146,234148,234151,2,5,0
66846,3,2,234149,234151,234153,2,4,0
66847,4,3,234153,234153,234156,0,3,0
66848,1,1,234154,234156,234157,2,3,0
66849,1,1,234155,234157,234158,2,3,0
66850,6,3,234161,234161,234164,0,3,3
66851,6,2,234167,234167,234169,0,2,3
66852,2,2,234169,234169,234171,0,2,0
66853,1,2,234170,234171,234173,1,3,0
66854,4,2,234174,234174,234176,0,2,1
66855,2,1,234176,234176,234177,0,1,0
66856,3,3,234179,234179,234182,0,3,2
66857,3,1,234182,234182,234183,0,1,0
66858,6,2,234188,234188,234190,0,2,5
66859,4,1,234192,234192,234193,0,1,2
66860,1,3,234193,234193,234196,0,3,0
66861,5,3,234198,234198,234201,0,3,2
66862,5,3,234203,234203,234206,0,3,2
66863,2,2,234205,234206,234208,1,3,0
66864,5,3,234210,234210,234213,0,3,2
66865,2,3,234212,234213,234216,1,4,0
66866,3,2,234215,234216,234218,1,3,0
66867,6,3,234221,234221,234224,0,3,3
66868,1,1,234222,234224,234225,2,3,0
66869,6,1,234228,234228,234229,0,1,3
66870,6,1,234234,234234,234235,0,1,5
66871,2,3,234236,234236,234239,0,3,1
66872,4,1,234240,234240,234241,0,1,1
66873,6,3,234246,234246,234249,0,3,5
66874,4,3,234250,234250,234253,0,3,1
66875,2,1,234252,234253,234254,1,2,0
66876,5,1,234257,234257,234258,0,1,3
66877,4,3,234261,234261,234264,0,3,3
66878,2,1,234263,234264,234265,1,2,0
66879,6,1,234269,234269,234270,0,1,4
66880,3,2,234272,234272,234274,0,2,2
66881,1,2,234273,234274,234276,1,3,0
66882,1,2,234274,234276,234278,2,4,0
66883,6,1,234280,234280,234281,0,1,2
66884,1,1,234281,234281,234282,0,1,0
66885,2,1,234283,234283,234284,0,1,1
66886,4,3,234287,234287,234290,0,3,3
66887,3,2,234290,234290,234292,0,2,0
66888,6,3,234296,234296,234299,0,3,4
66889,5,1,234301,234301,234302,0,1,2
66890,4,2,234305,234305,234307,0,2,3
66891,2,2,234307,234307,234309,0,2,0
66892,5,3,234312,234312,234315,0,3,3
66893,1,3,234313,234315,234318,2,5,0
66894,5,3,234318,234318,234321,0,3,0
66895,1,2,234319,234321,234323,2,4,0
66896,3,2,234322,234323,234325,1,3,0
66897,4,1,234326,234326,234327,0,1,1
66898,3,2,234329,234329,234331,0,2,2
66899,4,2,234333,234333,234335,0,2,2
66900,3,3,234336,234336,234339,0,3,1
66901,1,2,234337,234339,234341,2,4,0
66902,5,2,234342,234342,234344,0,2,1
66903,2,2,234344,234344,234346,0,2,0
66904,2,2,234346,234346,234348,0,2,0
66905,2,1,234348,234348,234349,0,1,0
66906,3,3,234351,234351,234354,0,3,2
66907,1,1,234352,234354,234355,2,3,0
66908,1,2,234353,234355,234357,2,4,0
66909,3,3,234356,234357,234360,1,4,0
66910,3,3,234359,234360,234363,1,4,0
66911,2,1,234361,234363,234364,2,3,0
66912,2,3,234363,234364,234367,1,4,0
66913,3,1,234366,234367,234368,1,2,0
66914,6,2,234372,234372,234374,0,2,4
66915,4,1,234376,234376,234377,0,1,2
66916,4,2,234380,234380,234382,0,2,3
66917,5,3,234385,234385,234388,0,3,3
66918,2,2,234387,234388,234390,1,3,0
66919,1,2,234388,234390,234392,2,4,0
66920,5,3,234393,234393,234396,0,3,1
66921,5,1,234398,234398,234399,0,1,2
66922,6,1,234404,234404,234405,0,1,5
66923,4,1,234408,234408,234409,0,1,3
66924,1,2,234409,234409,234411,0,2,0
66925,6,2,234415,234415,234417,0,2,4
66926,5,3,234420,234420,234423,0,3,3
66927,6,2,234426,234426,234428,0,2,3
66928,6,1,234432,234432,234433,0,1,4
66929,6,3,234438,234438,234441,0,3,5
66930,3,2,234441,234441,234443,0,2,0
66931,6,2,234447,234447,234449,0,2,4
66932,1,2,234448,234449,234451,1,3,0
66933,2,3,234450,234451,234454,1,4,0
66934,1,3,234451,234454,234457,3,6,0
66935,1,1,234452,234457,234458,5,6,0
66936,1,3,234453,234458,234461,5,8,0
66937,1,2,234454,234461,234463,7,9,0
66938,3,2,234457,234463,234465,6,8,0
66939,6,3,234463,234465,234468,2,5,0
66940,5,1,234468,234468,234469,0,1,0
66941,1,2,234469,234469,234471,0,2,0
66942,3,3,234472,234472,234475,0,3,1
66943,4,3,234476,234476,234479,0,3,1
66944,4,2,234480,234480,234482,0,2,1
66945,4,2,234484,234484,234486,0,2,2
66946,4,3,234488,234488,234491,0,3,2
66947,2,2,234490,234491,234493,1,3,0
66948,2,3,234492,234493,234496,1,4,0
66949,5,1,234497,234497,234498,0,1,1
66950,5,3,234502,234502,234505,0,3,4
66951,5,1,234507,234507,234508,0,1,2
66952,3,3,234510,234510,234513,0,3,2
66953,3,3,234513,234513,234516,0,3,0
66954,6,2,234519,234519,234521,0,2,3
66955,1,2,234520,234521,234523,1,3,0
66956,6,1,234526,234526,234527,0,1,3
66957,5,2,234531,234531,234533,0,2,4
66958,6,3,234537,234537,234540,0,3,4
66959,5,1,234542,234542,234543,0,1,2
66960,5,3,234547,234547,234550,0,3,4
66961,5,2,234552,234552,234554,0,2,2
66962,4,2,234556,234556,234558,0,2,2
66963,4,3,234560,234560,234563,0,3,2
66964,2,2,234562,234563,234565,1,3,0
66965,6,3,234568,234568,234571,0,3,3
66966,2,3,234570,234571,234574,1,4,0
66967,1,1,234571,234574,234575,3,4,0
66968,3,1,234574,234575,234576,1,2,0
66969,2,2,234576,234576,234578,0,2,0
66970,3,1,234579,234579,234580,0,1,1
66971,4,2,234583,234583,234585,0,2,3
66972,5,3,234588,234588,234591,0,3,3
66973,6,2,234594,234594,234596,0,2,3
66974,5,1,234599,234599,234600,0,1,3
66975,5,3,234604,234604,234607,0,3,4
66976,2,2,234606,234607,234609,1,3,0
66977,4,1,234610,234610,234611,0,1,1
66978,3,2,234613,234613,234615,0,2,2
66979,5,2,234618,234618,234620,0,2,3
66980,4,3,234622,234622,234625,0,3,2
66981,1,2,234623,234625,234627,2,4,0
66982,6,2,234629,234629,234631,0,2,2
66983,4,1,234633,234633,234634,0,1,2
66984,4,2,234637,234637,234639,0,2,3
66985,2,2,234639,234639,234641,0,2,0
66986,4,3,234643,234643,234646,0,3,2
66987,5,1,234648,234648,234649,0,1,2
66988,1,1,234649,234649,234650,0,1,0
66989,1,1,234650,234650,234651,0,1,0
66990,6,1,234656,234656,234657,0,1,5
66991,3,3,234659,234659,234662,0,3,2
66992,5,2,234664,234664,234666,0,2,2
66993,3,1,234667,234667,234668,0,1,1
66994,5,3,234672,234672,234675,0,3,4
66995,5,3,234677,234677,234680,0,3,2
66996,6,2,234683,234683,234685,0,2,3
66997,1,2,234684,234685,234687,1,3,0
66998,5,3,234689,234689,234692,0,3,2
66999,1,1,234690,234692,234693,2,3,0
67000,4,1,234694,234694,234695,0,1,1
67001,3,2,234697,234697,234699,0,2,2
67002,1,1,234698,234699,234700,1,2,0
67003,4,2,234702,234702,234704,0,2,2
67004,4,3,234706,234706,234709,0,3,2
67005,6,1,234712,234712,234713,0,1,3
67006,2,1,234714,234714,234715,0,1,1
67007,4,3,234718,234718,234721,0,3,3
67008,3,2,234721,234721,234723,0,2,0
67009,6,2,234727,234727,234729,0,2,4
67010,5,3,234732,234732,234735,0,3,3
67011,1,2,234733,234735,234737,2,4,0
67012,6,3,234739,234739,234742,0,3,2
67013,4,1,234743,234743,234744,0,1,1
67014,3,1,234746,234746,234747,0,1,2
67015,2,3,234748,234748,234751,0,3,1
67016,5,1,234753,234753,234754,0,1,2
67017,5,3,234758,234758,234761,0,3,4
67018,4,3,234762,234762,234765,0,3,1
67019,1,1,234763,234765,234766,2,3,0
67020,1,2,234764,234766,234768,2,4,0
67021,6,3,234770,234770,234773,0,3,2
67022,2,1,234772,234773,234774,1,2,0
67023,4,3,234776,234776,234779,0,3,2
67024,2,2,234778,234779,234781,1,3,0
67025,3,1,234781,234781,234782,0,1,0
67026,6,2,234787,234787,234789,0,2,5
67027,3,3,234790,234790,234793,0,3,1
67028,5,3,234795,234795,234798,0,3,2
67029,6,3,234801,234801,234804,0,3,3
67030,2,3,234803,234804,234807,1,4,0
67031,1,1,234804,234807,234808,3,4,0
67032,1,2,234805,234808,234810,3,5,0
67033,3,2,234808,234810,234812,2,4,0
67034,5,1,234813,234813,234814,0,1,1
67035,3,3,234816,234816,234819,0,3,2
67036,3,3,234819,234819,234822,0,3,0
67037,5,2,234824,234824,234826,0,2,2
67038,1,2,234825,234826,234828,1,3,0
67039,5,3,234830,234830,234833,0,3,2
67040,4,1,234834,234834,234835,0,1,1
67041,2,2,234836,234836,234838,0,2,1
67042,5,3,234841,234841,234844,0,3,3
67043,3,1,234844,234844,234845,0,1,0
67044,3,1,234847,234847,234848,0,1,2
67045,2,2,234849,234849,234851,0,2,1
67046,4,2,234853,234853,234855,0,2,2
67047,4,3,234857,234857,234860,0,3,2
67048,6,2,234863,234863,234865,0,2,3
67049,1,1,234864,234865,234866,1,2,0
67050,3,3,234867,234867,234870,0,3,1
67051,1,1,234868,234870,234871,2,3,0
67052,4,1,234872,234872,234873,0,1,1
67053,6,1,234878,234878,234879,0,1,5
67054,5,1,234883,234883,234884,0,1,4
67055,3,1,234886,234886,234887,0,1,2
67056,5,3,234891,234891,234894,0,3,4
67057,2,2,234893,234894,234896,1,3,0
67058,3,3,234896,234896,234899,0,3,0
67059,2,1,234898,234899,234900,1,2,0
67060,5,2,234903,234903,234905,0,2,3
67061,6,3,234909,234909,234912,0,3,4
67062,3,3,234912,234912,234915,0,3,0
67063,3,2,234915,234915,234917,0,2,0
67064,2,3,234917,234917,234920,0,3,0
67065,6,2,234923,234923,234925,0,2,3
67066,6,2,234929,234929,234931,0,2,4
67067,5,2,234934,234934,234936,0,2,3
67068,2,1,234936,234936,234937,0,1,0
67069,6,3,234942,234942,234945,0,3,5
67070,1,3,234943,234945,234948,2,5,0
67071,6,1,234949,234949,234950,0,1,1
67072,6,1,234955,234955,234956,0,1,5
67073,2,3,234957,234957,234960,0,3,1
67074,2,3,234959,234960,234963,1,4,0
67075,1,3,234960,234963,234966,3,6,0
67076,4,1,234964,234966,234967,2,3,0
67077,6,1,234970,234970,234971,0,1,3
67078,2,2,234972,234972,234974,0,2,1
67079,2,2,234974,234974,234976,0,2,0
67080,6,1,234980,234980,234981,0,1,4
67081,1,3,234981,234981,234984,0,3,0
67082,6,3,234987,234987,234990,0,3,3
67083,5,3,234992,234992,234995,0,3,2
67084,5,3,234997,234997,235000,0,3,2
67085,2,1,234999,235000,235001,1,2,0
67086,2,3,235001,235001,235004,0,3,0
67087,2,2,235003,235004,235006,1,3,0
67088,1,1,235004,235006,235007,2,3,0
67089,4,1,235008,235008,235009,0,1,1
67090,4,1,235012,235012,235013,0,1,3
67091,5,3,235017,235017,235020,0,3,4
67092,5,3,235022,235022,235025,0,3,2
67093,2,2,235024,235025,235027,1,3,0
67094,6,2,235030,235030,235032,0,2,3
67095,2,3,235032,235032,235035,0,3,0
67096,6,3,235038,235038,235041,0,3,3
67097,2,1,235040,235041,235042,1,2,0
67098,1,1,235041,235042,235043,1,2,0
67099,6,2,235047,235047,235049,0,2,4
67100,3,2,235050,235050,235052,0,2,1
67101,3,3,235053,235053,235056,0,3,1
67102,6,3,235059,235059,235062,0,3,3
67103,5,1,235064,235064,235065,0,1,2
67104,6,2,235070,235070,235072,0,2,5
67105,3,3,235073,235073,235076,0,3,1
67106,5,3,235078,235078,235081,0,3,2
67107,5,3,235083,235083,235086,0,3,2
67108,4,3,235087,235087,235090,0,3,1
67109,5,3,235092,235092,235095,0,3,2
67110,5,2,235097,235097,235099,0,2,2
67111,4,3,235101,235101,235104,0,3,2
67112,2,2,235103,235104,235106,1,3,0
67113,4,2,235107,235107,235109,0,2,1
67114,5,1,235112,235112,235113,0,1,3
67115,6,2,235118,235118,235120,0,2,5
67116,3,1,235121,235121,235122,0,1,1
67117,2,3,235123,235123,235126,0,3,1
67118,6,1,235129,235129,235130,0,1,3
67119,3,3,235132,235132,235135,0,3,2
67120,5,3,235137,235137,235140,0,3,2
67121,3,2,235140,235140,235142,0,2,0
67122,4,2,235144,235144,235146,0,2,2
67123,4,2,235148,235148,235150,0,2,2
67124,1,3,235149,235150,235153,1,4,0
67125,1,3,235150,235153,235156,3,6,0
67126,6,1,235156,235156,235157,0,1,0
67127,6,3,235162,235162,235165,0,3,5
67128,3,1,235165,235165,235166,0,1,0
67129,3,2,235168,235168,235170,0,2,2
67130,1,1,235169,235170,235171,1,2,0
67131,3,3,235172,235172,235175,0,3,1
67132,3,1,235175,235175,235176,0,1,0
67133,6,1,235181,235181,235182,0,1,5
67134,6,1,235187,235187,235188,0,1,5
67135,2,2,235189,235189,235191,0,2,1
67136,2,2,235191,235191,235193,0,2,0
67137,3,1,235194,235194,235195,0,1,1
67138,5,1,235199,235199,235200,0,1,4
67139,5,1,235204,235204,235205,0,1,4
67140,4,2,235208,235208,235210,0,2,3
67141,3,3,235211,235211,235214,0,3,1
67142,5,3,235216,235216,235219,0,3,2
67143,6,1,235222,235222,235223,0,1,3
67144,2,3,235224,235224,235227,0,3,1
67145,6,2,235230,235230,235232,0,2,3
67146,1,1,235231,235232,235233,1,2,0
67147,5,1,235236,235236,235237,0,1,3
67148,4,3,235240,235240,235243,0,3,3
67149,5,3,235245,235245,235248,0,3,2
67150,4,3,235249,235249,235252,0,3,1
67151,4,2,235253,235253,235255,0,2,1
67152,4,1,235257,235257,235258,0,1,2
67153,5,1,235262,235262,235263,0,1,4
67154,2,1,235264,235264,235265,0,1,1
67155,5,3,235269,235269,235272,0,3,4
67156,3,1,235272,235272,235273,0,1,0
67157,5,1,235277,235277,235278,0,1,4
67158,6,2,235283,235283,235285,0,2,5
67159,1,1,235284,235285,235286,1,2,0
67160,5,1,235289,235289,235290,0,1,3
67161,1,2,235290,235290,235292,0,2,0
67162,1,3,235291,235292,235295,1,4,0
67163,3,2,235294,235295,235297,1,3,0
67164,6,1,235300,235300,235301,0,1,3
67165,4,3,235304,235304,235307,0,3,3
67166,6,1,235310,235310,235311,0,1,3
67167,1,3,235311,235311,235314,0,3,0
67168,1,2,235312,235314,235316,2,4,0
67169,3,3,235315,235316,235319,1,4,0
67170,1,2,235316,235319,235321,3,5,0
67171,2,3,235318,235321,235324,3,6,0
67172,4,2,235322,235324,235326,2,4,0
67173,6,2,235328,235328,235330,0,2,2
67174,5,3,235333,235333,235336,0,3,3
67175,2,2,235335,235336,235338,1,3,0
67176,3,3,235338,235338,235341,0,3,0
67177,1,1,235339,235341,235342,2,3,0
67178,2,1,235341,235342,235343,1,2,0
67179,1,2,235342,235343,235345,1,3,0
67180,3,1,235345,235345,235346,0,1,0
67181,4,3,235349,235349,235352,0,3,3
67182,4,3,235353,235353,235356,0,3,1
67183,3,3,235356,235356,235359,0,3,0
67184,6,1,235362,235362,235363,0,1,3
67185,2,2,235364,235364,235366,0,2,1
67186,4,3,235368,235368,235371,0,3,2
67187,6,1,235374,235374,235375,0,1,3
67188,2,3,235376,235376,235379,0,3,1
67189,2,2,235378,235379,235381,1,3,0
67190,6,3,235384,235384,235387,0,3,3
67191,6,2,235390,235390,235392,0,2,3
67192,4,3,235394,235394,235397,0,3,2
67193,3,3,235397,235397,235400,0,3,0
67194,4,2,235401,235401,235403,0,2,1
67195,6,2,235407,235407,235409,0,2,4
67196,6,2,235413,235413,235415,0,2,4
67197,2,2,235415,235415,235417,0,2,0
67198,5,3,235420,235420,235423,0,3,3
67199,1,2,235421,235423,235425,2,4,0
67200,4,2,235425,235425,235427,0,2,0
67201,1,1,235426,235427,235428,1,2,0
67202,2,3,235428,235428,235431,0,3,0
67203,6,1,235434,235434,235435,0,1,3
67204,3,3,235437,235437,235440,0,3,2
67205,6,2,235443,235443,235445,0,2,3
67206,3,1,235446,235446,235447,0,1,1
67207,2,2,235448,235448,235450,0,2,1
67208,4,3,235452,235452,235455,0,3,2
67209,6,1,235458,235458,235459,0,1,3
67210,2,1,235460,235460,235461,0,1,1
67211,2,3,235462,235462,235465,0,3,1
67212,5,2,235467,235467,235469,0,2,2
67213,6,2,235473,235473,235475,0,2,4
67214,6,3,235479,235479,235482,0,3,4
67215,6,3,235485,235485,235488,0,3,3
67216,3,1,235488,235488,235489,0,1,0
67217,2,2,235490,235490,235492,0,2,1
67218,4,3,235494,235494,235497,0,3,2
67219,1,2,235495,235497,235499,2,4,0
67220,5,3,235500,235500,235503,0,3,1
67221,3,1,235503,235503,235504,0,1,0
67222,1,1,235504,235504,235505,0,1,0
67223,1,1,235505,235505,235506,0,1,0
67224,6,2,235511,235511,235513,0,2,5
67225,3,3,235514,235514,235517,0,3,1
67226,4,1,235518,235518,235519,0,1,1
67227,1,1,235519,235519,235520,0,1,0
67228,5,1,235524,235524,235525,0,1,4
67229,4,3,235528,235528,235531,0,3,3
67230,3,2,235531,235531,235533,0,2,0
67231,2,1,235533,235533,235534,0,1,0
67232,5,2,235538,235538,235540,0,2,4
67233,1,1,235539,235540,235541,1,2,0
67234,4,1,235543,235543,235544,0,1,2
67235,4,2,235547,235547,235549,0,2,3
67236,2,3,235549,235549,235552,0,3,0
67237,1,1,235550,235552,235553,2,3,0
67238,1,1,235551,235553,235554,2,3,0
67239,1,3,235552,235554,235557,2,5,0
67240,1,2,235553,235557,235559,4,6,0
67241,1,2,235554,235559,235561,5,7,0
67242,3,1,235557,235561,235562,4,5,0
67243,6,1,235563,235563,235564,0,1,1
67244,2,2,235565,235565,235567,0,2,1
67245,5,3,235570,235570,235573,0,3,3
67246,6,2,235576,235576,235578,0,2,3
67247,6,3,235582,235582,235585,0,3,4
67248,2,3,235584,235585,235588,1,4,0
67249,4,2,235588,235588,235590,0,2,0
67250,3,3,235591,235591,235594,0,3,1
67251,5,3,235596,235596,235599,0,3,2
67252,3,3,235599,235599,235602,0,3,0
67253,2,1,235601,235602,235603,1,2,0
67254,1,3,235602,235603,235606,1,4,0
67255,2,2,235604,235606,235608,2,4,0
67256,6,1,235610,235610,235611,0,1,2
67257,4,2,235614,235614,235616,0,2,3
67258,4,2,235618,235618,235620,0,2,2
67259,6,1,235624,235624,235625,0,1,4
67260,1,2,235625,235625,235627,0,2,0
67261,4,2,235629,235629,235631,0,2,2
67262,3,3,235632,235632,235635,0,3,1
67263,2,2,235634,235635,235637,1,3,0
67264,2,2,235636,235637,235639,1,3,0
67265,6,3,235642,235642,235645,0,3,3
67266,6,2,235648,235648,235650,0,2,3
67267,6,3,235654,235654,235657,0,3,4
67268,6,1,235660,235660,235661,0,1,3
67269,1,1,235661,235661,235662,0,1,0
67270,3,3,235664,235664,235667,0,3,2
67271,5,2,235669,235669,235671,0,2,2
67272,1,3,235670,235671,235674,1,4,0
67273,3,1,235673,235674,235675,1,2,0
67274,4,1,235677,235677,235678,0,1,2
67275,5,3,235682,235682,235685,0,3,4
67276,2,3,235684,235685,235688,1,4,0
67277,6,1,235690,235690,235691,0,1,2
67278,6,1,235696,235696,235697,0,1,5
67279,3,2,235699,235699,235701,0,2,2
67280,1,2,235700,235701,235703,1,3,0
67281,6,1,235706,235706,235707,0,1,3
67282,6,3,235712,235712,235715,0,3,5
67283,1,1,235713,235715,235716,2,3,0
67284,4,1,235717,235717,235718,0,1,1
67285,2,2,235719,235719,235721,0,2,1
67286,6,2,235725,235725,235727,0,2,4
67287,6,3,235731,235731,235734,0,3,4
67288,1,1,235732,235734,235735,2,3,0
67289,3,3,235735,235735,235738,0,3,0
67290,3,2,235738,235738,235740,0,2,0
67291,6,2,235744,235744,235746,0,2,4
67292,5,1,235749,235749,235750,0,1,3
67293,6,2,235755,235755,235757,0,2,5
67294,4,3,235759,235759,235762,0,3,2
67295,4,3,235763,235763,235766,0,3,1
67296,1,2,235764,235766,235768,2,4,0
67297,2,1,235766,235768,235769,2,3,0
67298,5,3,235771,235771,235774,0,3,2
67299,3,3,235774,235774,235777,0,3,0
67300,5,3,235779,235779,235782,0,3,2
67301,4,1,235783,235783,235784,0,1,1
67302,3,1,235786,235786,235787,0,1,2
67303,3,2,235789,235789,235791,0,2,2
67304,1,3,235790,235791,235794,1,4,0
67305,4,3,235794,235794,235797,0,3,0
67306,1,1,235795,235797,235798,2,3,0
67307,5,3,235800,235800,235803,0,3,2
67308,1,3,235801,235803,235806,2,5,0
67309,6,2,235807,235807,235809,0,2,1
67310,2,3,235809,235809,235812,0,3,0
67311,3,2,235812,235812,235814,0,2,0
67312,6,3,235818,235818,235821,0,3,4
67313,1,1,235819,235821,235822,2,3,0
67314,2,3,235821,235822,235825,1,4,0
67315,5,2,235826,235826,235828,0,2,1
67316,4,2,235830,235830,235832,0,2,2
67317,4,2,235834,235834,235836,0,2,2
67318,6,2,235840,235840,235842,0,2,4
67319,2,1,235842,235842,235843,0,1,0
67320,4,3,235846,235846,235849,0,3,3
67321,2,3,235848,235849,235852,1,4,0
67322,5,1,235853,235853,235854,0,1,1
67323,4,1,235857,235857,235858,0,1,3
67324,6,3,235863,235863,235866,0,3,5
67325,6,3,235869,235869,235872,0,3,3
67326,4,1,235873,235873,235874,0,1,1
67327,1,3,235874,235874,235877,0,3,0
67328,3,1,235877,235877,235878,0,1,0
67329,6,1,235883,235883,235884,0,1,5
67330,3,3,235886,235886,235889,0,3,2
67331,3,3,235889,235889,235892,0,3,0
67332,4,3,235893,235893,235896,0,3,1
67333,6,3,235899,235899,235902,0,3,3
67334,1,2,235900,235902,235904,2,4,0
67335,1,2,235901,235904,235906,3,5,0
67336,6,2,235907,235907,235909,0,2,1
67337,6,3,235913,235913,235916,0,3,4
67338,1,2,235914,235916,235918,2,4,0
67339,1,1,235915,235918,235919,3,4,0
67340,1,2,235916,235919,235921,3,5,0
67341,3,2,235919,235921,235923,2,4,0
67342,5,2,235924,235924,235926,0,2,1
67343,3,2,235927,235927,235929,0,2,1
67344,1,1,235928,235929,235930,1,2,0
67345,1,2,235929,235930,235932,1,3,0
67346,3,2,235932,235932,235934,0,2,0
67347,4,3,235936,235936,235939,0,3,2
67348,4,2,235940,235940,235942,0,2,1
67349,3,2,235943,235943,235945,0,2,1
67350,4,2,235947,235947,235949,0,2,2
67351,3,1,235950,235950,235951,0,1,1
67352,3,1,235953,235953,235954,0,1,2
67353,1,3,235954,235954,235957,0,3,0
67354,2,1,235956,235957,235958,1,2,0
67355,5,1,235961,235961,235962,0,1,3
67356,5,1,235966,235966,235967,0,1,4
67357,2,2,235968,235968,235970,0,2,1
67358,3,3,235971,235971,235974,0,3,1
67359,1,3,235972,235974,235977,2,5,0
67360,6,1,235978,235978,235979,0,1,1
67361,6,3,235984,235984,235987,0,3,5
67362,5,2,235989,235989,235991,0,2,2
67363,4,2,235993,235993,235995,0,2,2
67364,1,1,235994,235995,235996,1,2,0
67365,1,1,235995,235996,235997,1,2,0
67366,3,2,235998,235998,236000,0,2,1
67367,4,2,236002,236002,236004,0,2,2
67368,4,3,236006,236006,236009,0,3,2
67369,1,1,236007,236009,236010,2,3,0
67370,4,1,236011,236011,236012,0,1,1
67371,1,1,236012,236012,236013,0,1,0
67372,3,1,236015,236015,236016,0,1,2
67373,3,3,236018,236018,236021,0,3,2
67374,1,2,236019,236021,236023,2,4,0
67375,5,1,236024,236024,236025,0,1,1
67376,6,3,236030,236030,236033,0,3,5
67377,6,2,236036,236036,236038,0,2,3
67378,2,1,236038,236038,236039,0,1,0
67379,4,2,236042,236042,236044,0,2,3
67380,3,1,236045,236045,236046,0,1,1
67381,5,2,236050,236050,236052,0,2,4
67382,5,3,236055,236055,236058,0,3,3
67383,3,3,236058,236058,236061,0,3,0
67384,6,3,236064,236064,236067,0,3,3
67385,1,3,236065,236067,236070,2,5,0
67386,5,2,236070,236070,236072,0,2,0
67387,6,3,236076,236076,236079,0,3,4
67388,3,2,236079,236079,236081,0,2,0
67389,6,2,236085,236085,236087,0,2,4
67390,5,1,236090,236090,236091,0,1,3
67391,1,1,236091,236091,236092,0,1,0
67392,1,2,236092,236092,236094,0,2,0
67393,5,2,236097,236097,236099,0,2,3
67394,1,1,236098,236099,236100,1,2,0
67395,6,1,236104,236104,236105,0,1,4
67396,4,3,236108,236108,236111,0,3,3
67397,5,3,236113,236113,236116,0,3,2
67398,4,1,236117,236117,236118,0,1,1
67399,6,1,236123,236123,236124,0,1,5
67400,4,1,236127,236127,236128,0,1,3
67401,1,2,236128,236128,236130,0,2,0
67402,2,2,236130,236130,236132,0,2,0
67403,5,1,236135,236135,236136,0,1,3
67404,5,1,236140,236140,236141,0,1,4
67405,3,1,236143,236143,236144,0,1,2
67406,2,3,236145,236145,236148,0,3,1
67407,6,1,236151,236151,236152,0,1,3
67408,3,3,236154,236154,236157,0,3,2
67409,5,3,236159,236159,236162,0,3,2
67410,3,3,236162,236162,236165,0,3,0
67411,1,1,236163,236165,236166,2,3,0
67412,2,3,236165,236166,236169,1,4,0
67413,3,2,236168,236169,236171,1,3,0
67414,1,3,236169,236171,236174,2,5,0
67415,6,3,236175,236175,236178,0,3,1
67416,6,1,236181,236181,236182,0,1,3
67417,4,2,236185,236185,236187,0,2,3
67418,1,1,236186,236187,236188,1,2,0
67419,1,3,236187,236188,236191,1,4,0
67420,5,2,236192,236192,236194,0,2,1
67421,3,3,236195,236195,236198,0,3,1
67422,4,2,236199,236199,236201,0,2,1
67423,5,2,236204,236204,236206,0,2,3
67424,6,2,236210,236210,236212,0,2,4
67425,3,2,236213,236213,236215,0,2,1
67426,4,1,236217,236217,236218,0,1,2
67427,1,3,236218,236218,236221,0,3,0
67428,5,2,236223,236223,236225,0,2,2
67429,4,2,236227,236227,236229,0,2,2
67430,4,2,236231,236231,236233,0,2,2
67431,5,2,236236,236236,236238,0,2,3
67432,1,2,236237,236238,236240,1,3,0
67433,4,1,236241,236241,236242,0,1,1
67434,6,2,236247,236247,236249,0,2,5
67435,4,2,236251,236251,236253,0,2,2
67436,6,2,236257,236257,236259,0,2,4
67437,3,3,236260,236260,236263,0,3,1
67438,2,2,236262,236263,236265,1,3,0
67439,1,2,236263,236265,236267,2,4,0
67440,4,3,236267,236267,236270,0,3,0
67441,1,1,236268,236270,236271,2,3,0
67442,1,1,236269,236271,236272,2,3,0
67443,5,3,236274,236274,236277,0,3,2
67444,3,1,236277,236277,236278,0,1,0
67445,2,2,236279,236279,236281,0,2,1
67446,5,2,236284,236284,236286,0,2,3
67447,3,3,236287,236287,236290,0,3,1
67448,6,1,236293,236293,236294,0,1,3
67449,6,2,236299,236299,236301,0,2,5
67450,4,3,236303,236303,236306,0,3,2
67451,6,1,236309,236309,236310,0,1,3
67452,2,2,236311,236311,236313,0,2,1
67453,3,1,236314,236314,236315,0,1,1
67454,4,1,236318,236318,236319,0,1,3
67455,5,3,236323,236323,236326,0,3,4
67456,2,3,236325,236326,236329,1,4,0
67457,6,2,236331,236331,236333,0,2,2
67458,4,2,236335,236335,236337,0,2,2
67459,6,2,236341,236341,236343,0,2,4
67460,1,2,236342,236343,236345,1,3,0
67461,4,2,236346,236346,236348,0,2,1
67462,1,1,236347,236348,236349,1,2,0
67463,5,3,236352,236352,236355,0,3,3
67464,2,1,236354,236355,236356,1,2,0
67465,3,3,236357,236357,236360,0,3,1
67466,5,1,236362,236362,236363,0,1,2
67467,3,2,236365,236365,236367,0,2,2
67468,2,2,236367,236367,236369,0,2,0
67469,5,2,236372,236372,236374,0,2,3
67470,5,1,236377,236377,236378,0,1,3
67471,3,3,236380,236380,236383,0,3,2
67472,3,2,236383,236383,236385,0,2,0
67473,6,2,236389,236389,236391,0,2,4
67474,5,3,236394,236394,236397,0,3,3
67475,1,3,236395,236397,236400,2,5,0
67476,4,3,236399,236400,236403,1,4,0
67477,5,3,236404,236404,236407,0,3,1
67478,6,1,236410,236410,236411,0,1,3
67479,6,3,236416,236416,236419,0,3,5
67480,1,1,236417,236419,236420,2,3,0
67481,6,1,236423,236423,236424,0,1,3
67482,1,3,236424,236424,236427,0,3,0
67483,5,2,236429,236429,236431,0,2,2
67484,1,3,236430,236431,236434,1,4,0
67485,6,2,236436,236436,236438,0,2,2
67486,6,3,236442,236442,236445,0,3,4
67487,2,1,236444,236445,236446,1,2,0
67488,6,1,236450,236450,236451,0,1,4
67489,6,3,236456,236456,236459,0,3,5
67490,6,3,236462,236462,236465,0,3,3
67491,2,1,236464,236465,236466,1,2,0
67492,5,2,236469,236469,236471,0,2,3
67493,4,2,236473,236473,236475,0,2,2
67494,3,1,236476,236476,236477,0,1,1
67495,1,2,236477,236477,236479,0,2,0
67496,4,1,236481,236481,236482,0,1,2
67497,6,1,236487,236487,236488,0,1,5
67498,4,3,236491,236491,236494,0,3,3
67499,5,1,236496,236496,236497,0,1,2
67500,3,1,236499,236499,236500,0,1,2
67501,4,3,236503,236503,236506,0,3,3
67502,4,3,236507,236507,236510,0,3,1
67503,3,2,236510,236510,236512,0,2,0
67504,4,2,236514,236514,236516,0,2,2
67505,2,1,236516,236516,236517,0,1,0
67506,3,1,236519,236519,236520,0,1,2
67507,1,2,236520,236520,236522,0,2,0
67508,2,3,236522,236522,236525,0,3,0
67509,2,2,236524,236525,236527,1,3,0
67510,6,2,236530,236530,236532,0,2,3
67511,5,2,236535,236535,236537,0,2,3
67512,4,2,236539,236539,236541,0,2,2
67513,4,1,236543,236543,236544,0,1,2
67514,2,3,236545,236545,236548,0,3,1
67515,3,2,236548,236548,236550,0,2,0
67516,5,1,236553,236553,236554,0,1,3
67517,3,3,236556,236556,236559,0,3,2
67518,6,1,236562,236562,236563,0,1,3
67519,6,1,236568,236568,236569,0,1,5
67520,4,2,236572,236572,236574,0,2,3
67521,2,3,236574,236574,236577,0,3,0
67522,1,3,236575,236577,236580,2,5,0
67523,6,3,236581,236581,236584,0,3,1
67524,1,3,236582,236584,236587,2,5,0
67525,3,1,236585,236587,236588,2,3,0
67526,4,3,236589,236589,236592,0,3,1
67527,6,3,236595,236595,236598,0,3,3
67528,3,1,236598,236598,236599,0,1,0
67529,6,3,236604,236604,236607,0,3,5
67530,3,1,236607,236607,236608,0,1,0
67531,3,3,236610,236610,236613,0,3,2
67532,5,1,236615,236615,236616,0,1,2
67533,4,2,236619,236619,236621,0,2,3
67534,5,2,236624,236624,236626,0,2,3
67535,5,2,236629,236629,236631,0,2,3
67536,5,3,236634,236634,236637,0,3,3
67537,1,2,236635,236637,236639,2,4,0
67538,6,1,236641,236641,236642,0,1,2
67539,4,2,236645,236645,236647,0,2,3
67540,4,3,236649,236649,236652,0,3,2
67541,4,1,236653,236653,236654,0,1,1
67542,3,1,236656,236656,236657,0,1,2
67543,5,1,236661,236661,236662,0,1,4
67544,4,3,236665,236665,236668,0,3,3
67545,2,3,236667,236668,236671,1,4,0
67546,3,3,236670,236671,236674,1,4,0
67547,3,3,236673,236674,236677,1,4,0
67548,4,3,236677,236677,236680,0,3,0
67549,5,3,236682,236682,236685,0,3,2
67550,4,3,236686,236686,236689,0,3,1
67551,5,2,236691,236691,236693,0,2,2
67552,4,1,236695,236695,236696,0,1,2
67553,1,2,236696,236696,236698,0,2,0
67554,4,2,236700,236700,236702,0,2,2
67555,5,1,236705,236705,236706,0,1,3
67556,3,2,236708,236708,236710,0,2,2
67557,4,2,236712,236712,236714,0,2,2
67558,1,2,236713,236714,236716,1,3,0
67559,3,2,236716,236716,236718,0,2,0
67560,2,3,236718,236718,236721,0,3,0
67561,5,3,236723,236723,236726,0,3,2
67562,1,1,236724,236726,236727,2,3,0
67563,3,2,236727,236727,236729,0,2,0
67564,3,2,236730,236730,236732,0,2,1
67565,2,1,236732,236732,236733,0,1,0
67566,1,3,236733,236733,236736,0,3,0
67567,1,2,236734,236736,236738,2,4,0
67568,1,3,236735,236738,236741,3,6,0
67569,4,2,236739,236741,236743,2,4,0
67570,1,3,236740,236743,236746,3,6,0
67571,1,1,236741,236746,236747,5,6,0
67572,2,1,236743,236747,236748,4,5,0
67573,6,3,236749,236749,236752,0,3,1
67574,4,2,236753,236753,236755,0,2,1
67575,2,3,236755,236755,236758,0,3,0
67576,5,3,236760,236760,236763,0,3,2
67577,6,3,236766,236766,236769,0,3,3
67578,4,2,236770,236770,236772,0,2,1
67579,5,1,236775,236775,236776,0,1,3
67580,1,1,236776,236776,236777,0,1,0
67581,4,3,236780,236780,236783,0,3,3
67582,1,1,236781,236783,236784,2,3,0
67583,1,2,236782,236784,236786,2,4,0
67584,3,2,236785,236786,236788,1,3,0
67585,3,1,236788,236788,236789,0,1,0
67586,2,1,236790,236790,236791,0,1,1
67587,1,3,236791,236791,236794,0,3,0
67588,2,3,236793,236794,236797,1,4,0
67589,2,1,236795,236797,236798,2,3,0
67590,6,1,236801,236801,236802,0,1,3
67591,2,2,236803,236803,236805,0,2,1
67592,6,3,236809,236809,236812,0,3,4
67593,2,2,236811,236812,236814,1,3,0
67594,2,1,236813,236814,236815,1,2,0
67595,4,2,236817,236817,236819,0,2,2
67596,5,3,236822,236822,236825,0,3,3
67597,6,2,236828,236828,236830,0,2,3
67598,6,3,236834,236834,236837,0,3,4
67599,5,1,236839,236839,236840,0,1,2
67600,3,2,236842,236842,236844,0,2,2
67601,2,3,236844,236844,236847,0,3,0
67602,6,3,236850,236850,236853,0,3,3
67603,1,2,236851,236853,236855,2,4,0
67604,4,1,236855,236855,236856,0,1,0
67605,3,3,236858,236858,236861,0,3,2
67606,1,2,236859,236861,236863,2,4,0
67607,1,2,236860,236863,236865,3,5,0
67608,5,3,236865,236865,236868,0,3,0
67609,3,2,236868,236868,236870,0,2,0
67610,4,1,236872,236872,236873,0,1,2
67611,2,1,236874,236874,236875,0,1,1
67612,2,3,236876,236876,236879,0,3,1
67613,2,2,236878,236879,236881,1,3,0
67614,2,3,236880,236881,236884,1,4,0
67615,4,2,236884,236884,236886,0,2,0
67616,3,3,236887,236887,236890,0,3,1
67617,1,2,236888,236890,236892,2,4,0
67618,1,2,236889,236892,236894,3,5,0
67619,5,2,236894,236894,236896,0,2,0
67620,6,2,236900,236900,236902,0,2,4
67621,5,2,236905,236905,236907,0,2,3
67622,5,2,236910,236910,236912,0,2,3
67623,1,1,236911,236912,236913,1,2,0
67624,2,3,236913,236913,236916,0,3,0
67625,1,3,236914,236916,236919,2,5,0
67626,1,2,236915,236919,236921,4,6,0
67627,4,2,236919,236921,236923,2,4,0
67628,4,3,236923,236923,236926,0,3,0
67629,2,2,236925,236926,236928,1,3,0
67630,6,3,236931,236931,236934,0,3,3
67631,5,3,236936,236936,236939,0,3,2
67632,1,1,236937,236939,236940,2,3,0
67633,3,2,236940,236940,236942,0,2,0
67634,4,2,236944,236944,236946,0,2,2
67635,5,2,236949,236949,236951,0,2,3
67636,4,2,236953,236953,236955,0,2,2
67637,6,2,236959,236959,236961,0,2,4
67638,2,2,236961,236961,236963,0,2,0
67639,1,1,236962,236963,236964,1,2,0
67640,5,1,236967,236967,236968,0,1,3
67641,3,2,236970,236970,236972,0,2,2
67642,2,1,236972,236972,236973,0,1,0
67643,5,2,236977,236977,236979,0,2,4
67644,5,3,236982,236982,236985,0,3,3
67645,5,3,236987,236987,236990,0,3,2
67646,3,3,236990,236990,236993,0,3,0
67647,1,3,236991,236993,236996,2,5,0
67648,4,3,236995,236996,236999,1,4,0
67649,5,1,237000,237000,237001,0,1,1
67650,1,3,237001,237001,237004,0,3,0
67651,3,3,237004,237004,237007,0,3,0
67652,1,1,237005,237007,237008,2,3,0
67653,3,1,237008,237008,237009,0,1,0
67654,6,1,237014,237014,237015,0,1,5
67655,4,2,237018,237018,237020,0,2,3
67656,3,3,237021,237021,237024,0,3,1
67657,2,2,237023,237024,237026,1,3,0
67658,5,2,237028,237028,237030,0,2,2
67659,4,1,237032,237032,237033,0,1,2
67660,5,2,237037,237037,237039,0,2,4
67661,4,3,237041,237041,237044,0,3,2
67662,5,3,237046,237046,237049,0,3,2
67663,3,3,237049,237049,237052,0,3,0
67664,3,2,237052,237052,237054,0,2,0
67665,3,3,237055,237055,237058,0,3,1
67666,2,2,237057,237058,237060,1,3,0
67667,2,3,237059,237060,237063,1,4,0
67668,2,3,237061,237063,237066,2,5,0
67669,1,1,237062,237066,237067,4,5,0
67670,6,1,237068,237068,237069,0,1,1
67671,5,3,237073,237073,237076,0,3,4
67672,5,2,237078,237078,237080,0,2,2
67673,3,2,237081,237081,237083,0,2,1
67674,6,1,237087,237087,237088,0,1,4
67675,3,1,237090,237090,237091,0,1,2
67676,5,3,237095,237095,237098,0,3,4
67677,3,2,237098,237098,237100,0,2,0
67678,2,2,237100,237100,237102,0,2,0
67679,3,2,237103,237103,237105,0,2,1
67680,6,1,237109,237109,237110,0,1,4
67681,1,1,237110,237110,237111,0,1,0
67682,3,2,237113,237113,237115,0,2,2
67683,4,2,237117,237117,237119,0,2,2
67684,5,1,237122,237122,237123,0,1,3
67685,4,3,237126,237126,237129,0,3,3
67686,4,1,237130,237130,237131,0,1,1
67687,5,1,237135,237135,237136,0,1,4
67688,1,2,237136,237136,237138,0,2,0
67689,6,3,237142,237142,237145,0,3,4
67690,1,1,237143,237145,237146,2,3,0
67691,1,1,237144,237146,237147,2,3,0
67692,4,1,237148,237148,237149,0,1,1
67693,6,3,237154,237154,237157,0,3,5
67694,4,1,237158,237158,237159,0,1,1
67695,4,1,237162,237162,237163,0,1,3
67696,6,3,237168,237168,237171,0,3,5
67697,5,1,237173,237173,237174,0,1,2
67698,6,1,237179,237179,237180,0,1,5
67699,1,3,237180,237180,237183,0,3,0
67700,6,2,237186,237186,237188,0,2,3
67701,2,3,237188,237188,237191,0,3,0
67702,3,3,237191,237191,237194,0,3,0
67703,6,3,237197,237197,237200,0,3,3
67704,3,3,237200,237200,237203,0,3,0
67705,6,2,237206,237206,237208,0,2,3
67706,5,2,237211,237211,237213,0,2,3
67707,1,3,237212,237213,237216,1,4,0
67708,4,3,237216,237216,237219,0,3,0
67709,5,3,237221,237221,237224,0,3,2
67710,4,2,237225,237225,237227,0,2,1
67711,4,3,237229,237229,237232,0,3,2
67712,4,3,237233,237233,237236,0,3,1
67713,1,1,237234,237236,237237,2,3,0
67714,4,1,237238,237238,237239,0,1,1
67715,4,2,237242,237242,237244,0,2,3
67716,1,2,237243,237244,237246,1,3,0
67717,4,3,237247,237247,237250,0,3,1
67718,2,2,237249,237250,237252,1,3,0
67719,4,3,237253,237253,237256,0,3,1
67720,2,1,237255,237256,237257,1,2,0
67721,4,3,237259,237259,237262,0,3,2
67722,6,2,237265,237265,237267,0,2,3
67723,5,3,237270,237270,237273,0,3,3
67724,5,3,237275,237275,237278,0,3,2
67725,3,2,237278,237278,237280,0,2,0
67726,1,3,237279,237280,237283,1,4,0
67727,5,3,237284,237284,237287,0,3,1
67728,5,3,237289,237289,237292,0,3,2
67729,5,3,237294,237294,237297,0,3,2
67730,6,1,237300,237300,237301,0,1,3
67731,6,1,237306,237306,237307,0,1,5
67732,3,1,237309,237309,237310,0,1,2
67733,2,1,237311,237311,237312,0,1,1
67734,5,1,237316,237316,237317,0,1,4
67735,3,1,237319,237319,237320,0,1,2
67736,4,2,237323,237323,237325,0,2,3
67737,2,3,237325,237325,237328,0,3,0
67738,6,2,237331,237331,237333,0,2,3
67739,3,3,237334,237334,237337,0,3,1
67740,4,1,237338,237338,237339,0,1,1
67741,6,2,237344,237344,237346,0,2,5
67742,5,3,237349,237349,237352,0,3,3
67743,3,3,237352,237352,237355,0,3,0
67744,1,3,237353,237355,237358,2,5,0
67745,2,3,237355,237358,237361,3,6,0
67746,1,1,237356,237361,237362,5,6,0
67747,6,1,237362,237362,237363,0,1,0
67748,6,1,237368,237368,237369,0,1,5
67749,1,3,237369,237369,237372,0,3,0
67750,5,3,237374,237374,237377,0,3,2
67751,5,1,237379,237379,237380,0,1,2
67752,2,2,237381,237381,237383,0,2,1
67753,3,1,237384,237384,237385,0,1,1
67754,5,2,237389,237389,237391,0,2,4
67755,1,3,237390,237391,237394,1,4,0
67756,5,2,237395,237395,237397,0,2,1
67757,2,2,237397,237397,237399,0,2,0
67758,5,2,237402,237402,237404,0,2,3
67759,5,2,237407,237407,237409,0,2,3
67760,1,1,237408,237409,237410,1,2,0
67761,1,2,237409,237410,237412,1,3,0
67762,6,2,237415,237415,237417,0,2,3
67763,2,2,237417,237417,237419,0,2,0
67764,5,3,237422,237422,237425,0,3,3
67765,3,2,237425,237425,237427,0,2,0
67766,5,1,237430,237430,237431,0,1,3
67767,1,2,237431,237431,237433,0,2,0
67768,1,3,237432,237433,237436,1,4,0
67769,1,2,237433,237436,237438,3,5,0
67770,6,1,237439,237439,237440,0,1,1
67771,4,3,237443,237443,237446,0,3,3
67772,1,1,237444,237446,237447,2,3,0
67773,1,3,237445,237447,237450,2,5,0
67774,5,2,237450,237450,237452,0,2,0
67775,6,1,237456,237456,237457,0,1,4
67776,3,2,237459,237459,237461,0,2,2
67777,6,3,237465,237465,237468,0,3,4
67778,5,1,237470,237470,237471,0,1,2
67779,5,1,237475,237475,237476,0,1,4
67780,2,2,237477,237477,237479,0,2,1
67781,3,3,237480,237480,237483,0,3,1
67782,1,3,237481,237483,237486,2,5,0
67783,2,1,237483,237486,237487,3,4,0
67784,5,2,237488,237488,237490,0,2,1
67785,3,1,237491,237491,237492,0,1,1
67786,4,2,237495,237495,237497,0,2,3
67787,6,1,237501,237501,237502,0,1,4
67788,3,2,237504,237504,237506,0,2,2
67789,4,2,237508,237508,237510,0,2,2
67790,3,1,237511,237511,237512,0,1,1
67791,5,1,237516,237516,237517,0,1,4
67792,5,3,237521,237521,237524,0,3,4
67793,1,2,237522,237524,237526,2,4,0
67794,4,1,237526,237526,237527,0,1,0
67795,5,1,237531,237531,237532,0,1,4
67796,4,3,237535,237535,237538,0,3,3
67797,4,1,237539,237539,237540,0,1,1
67798,2,1,237541,237541,237542,0,1,1
67799,2,3,237543,237543,237546,0,3,1
67800,3,3,237546,237546,237549,0,3,0
67801,4,2,237550,237550,237552,0,2,1
67802,4,1,237554,237554,237555,0,1,2
67803,2,2,237556,237556,237558,0,2,1
67804,4,1,237560,237560,237561,0,1,2
67805,1,1,237561,237561,237562,0,1,0
67806,4,2,237565,237565,237567,0,2,3
67807,6,3,237571,237571,237574,0,3,4
67808,1,1,237572,237574,237575,2,3,0
67809,5,3,237577,237577,237580,0,3,2
67810,1,2,237578,237580,237582,2,4,0
67811,1,2,237579,237582,237584,3,5,0
67812,1,2,237580,237584,237586,4,6,0
67813,1,3,237581,237586,237589,5,8,0
67814,1,1,237582,237589,237590,7,8,0
67815,4,2,237586,237590,237592,4,6,0
67816,4,2,237590,237592,237594,2,4,0
67817,1,3,237591,237594,237597,3,6,0
67818,5,1,237596,237597,237598,1,2,0
67819,3,2,237599,237599,237601,0,2,1
67820,2,2,237601,237601,237603,0,2,0
67821,6,2,237607,237607,237609,0,2,4
67822,6,2,237613,237613,237615,0,2,4
67823,5,2,237618,237618,237620,0,2,3
67824,6,2,237624,237624,237626,0,2,4
67825,3,2,237627,237627,237629,0,2,1
67826,5,3,237632,237632,237635,0,3,3
67827,5,1,237637,237637,237638,0,1,2
67828,5,2,237642,237642,237644,0,2,4
67829,4,3,237646,237646,237649,0,3,2
67830,2,1,237648,237649,237650,1,2,0
67831,4,3,237652,237652,237655,0,3,2
67832,3,1,237655,237655,237656,0,1,0
67833,1,1,237656,237656,237657,0,1,0
67834,5,1,237661,237661,237662,0,1,4
67835,2,1,237663,237663,237664,0,1,1
67836,5,3,237668,237668,237671,0,3,4
67837,5,3,237673,237673,237676,0,3,2
67838,2,3,237675,237676,237679,1,4,0
67839,1,2,237676,237679,237681,3,5,0
67840,1,2,237677,237681,237683,4,6,0
67841,6,2,237683,237683,237685,0,2,0
67842,5,2,237688,237688,237690,0,2,3
67843,4,2,237692,237692,237694,0,2,2
67844,2,1,237694,237694,237695,0,1,0
67845,1,3,237695,237695,237698,0,3,0
67846,5,2,237700,237700,237702,0,2,2
67847,1,3,237701,237702,237705,1,4,0
67848,2,3,237703,237705,237708,2,5,0
67849,6,1,237709,237709,237710,0,1,1
67850,2,3,237711,237711,237714,0,3,1
67851,2,1,237713,237714,237715,1,2,0
67852,1,3,237714,237715,237718,1,4,0
67853,2,2,237716,237718,237720,2,4,0
67854,2,1,237718,237720,237721,2,3,0
67855,6,2,237724,237724,237726,0,2,3
67856,5,2,237729,237729,237731,0,2,3
67857,1,1,237730,237731,237732,1,2,0
67858,1,1,237731,237732,237733,1,2,0
67859,1,3,237732,237733,237736,1,4,0
67860,6,3,237738,237738,237741,0,3,2
67861,4,1,237742,237742,237743,0,1,1
67862,5,1,237747,237747,237748,0,1,4
67863,2,1,237749,237749,237750,0,1,1
67864,2,3,237751,237751,237754,0,3,1
67865,3,3,237754,237754,237757,0,3,0
67866,2,2,237756,237757,237759,1,3,0
67867,4,1,237760,237760,237761,0,1,1
67868,6,2,237766,237766,237768,0,2,5
67869,3,2,237769,237769,237771,0,2,1
67870,1,2,237770,237771,237773,1,3,0
67871,1,3,237771,237773,237776,2,5,0
67872,1,3,237772,237776,237779,4,7,0
67873,6,2,237778,237779,237781,1,3,0
67874,2,2,237780,237781,237783,1,3,0
67875,3,3,237783,237783,237786,0,3,0
67876,6,3,237789,237789,237792,0,3,3
67877,3,3,237792,237792,237795,0,3,0
67878,1,3,237793,237795,237798,2,5,0
67879,2,3,237795,237798,237801,3,6,0
67880,3,1,237798,237801,237802,3,4,0
67881,5,1,237803,237803,237804,0,1,1
67882,1,1,237804,237804,237805,0,1,0
67883,2,3,237806,237806,237809,0,3,1
67884,5,1,237811,237811,237812,0,1,2
67885,6,3,237817,237817,237820,0,3,5
67886,6,3,237823,237823,237826,0,3,3
67887,1,3,237824,237826,237829,2,5,0
67888,2,2,237826,237829,237831,3,5,0
67889,3,1,237829,237831,237832,2,3,0
67890,6,2,237835,237835,237837,0,2,3
67891,1,2,237836,237837,237839,1,3,0
67892,6,2,237842,237842,237844,0,2,3
67893,5,1,237847,237847,237848,0,1,3
67894,6,1,237853,237853,237854,0,1,5
67895,2,3,237855,237855,237858,0,3,1
67896,1,1,237856,237858,237859,2,3,0
67897,5,1,237861,237861,237862,0,1,2
67898,3,2,237864,237864,237866,0,2,2
67899,5,2,237869,237869,237871,0,2,3
67900,2,2,237871,237871,237873,0,2,0
67901,6,3,237877,237877,237880,0,3,4
67902,5,3,237882,237882,237885,0,3,2
67903,4,3,237886,237886,237889,0,3,1
67904,3,3,237889,237889,237892,0,3,0
67905,4,3,237893,237893,237896,0,3,1
67906,2,3,237895,237896,237899,1,4,0
67907,3,1,237898,237899,237900,1,2,0
67908,4,1,237902,237902,237903,0,1,2
67909,1,1,237903,237903,237904,0,1,0
67910,1,2,237904,237904,237906,0,2,0
67911,2,3,237906,237906,237909,0,3,0
67912,6,3,237912,237912,237915,0,3,3
67913,4,1,237916,237916,237917,0,1,1
67914,4,1,237920,237920,237921,0,1,3
67915,3,3,237923,237923,237926,0,3,2
67916,3,2,237926,237926,237928,0,2,0
67917,5,1,237931,237931,237932,0,1,3
67918,5,1,237936,237936,237937,0,1,4
67919,2,1,237938,237938,237939,0,1,1
67920,1,1,237939,237939,237940,0,1,0
67921,6,3,237945,237945,237948,0,3,5
67922,1,3,237946,237948,237951,2,5,0
67923,3,2,237949,237951,237953,2,4,0
67924,5,3,237954,237954,237957,0,3,1
67925,1,2,237955,237957,237959,2,4,0
67926,4,2,237959,237959,237961,0,2,0
67927,3,3,237962,237962,237965,0,3,1
67928,6,3,237968,237968,237971,0,3,3
67929,4,2,237972,237972,237974,0,2,1
67930,3,2,237975,237975,237977,0,2,1
67931,6,3,237981,237981,237984,0,3,4
67932,1,3,237982,237984,237987,2,5,0
67933,5,3,237987,237987,237990,0,3,0
67934,6,2,237993,237993,237995,0,2,3
67935,5,2,237998,237998,238000,0,2,3
67936,3,1,238001,238001,238002,0,1,1
67937,6,2,238007,238007,238009,0,2,5
67938,4,1,238011,238011,238012,0,1,2
67939,3,1,238014,238014,238015,0,1,2
67940,4,2,238018,238018,238020,0,2,3
67941,3,1,238021,238021,238022,0,1,1
67942,3,3,238024,238024,238027,0,3,2
67943,1,1,238025,238027,238028,2,3,0
67944,3,3,238028,238028,238031,0,3,0
67945,1,3,238029,238031,238034,2,5,0
67946,4,2,238033,238034,238036,1,3,0
67947,4,2,238037,238037,238039,0,2,1
67948,2,3,238039,238039,238042,0,3,0
67949,6,1,238045,238045,238046,0,1,3
67950,2,3,238047,238047,238050,0,3,1
67951,3,3,238050,238050,238053,0,3,0
67952,1,2,238051,238053,238055,2,4,0
67953,5,3,238056,238056,238059,0,3,1
67954,1,2,238057,238059,238061,2,4,0
67955,1,2,238058,238061,238063,3,5,0
67956,6,3,238064,238064,238067,0,3,1
67957,6,3,238070,238070,238073,0,3,3
67958,2,2,238072,238073,238075,1,3,0
67959,3,2,238075,238075,238077,0,2,0
67960,1,1,238076,238077,238078,1,2,0
67961,1,1,238077,238078,238079,1,2,0
67962,1,2,238078,238079,238081,1,3,0
67963,3,2,238081,238081,238083,0,2,0
67964,2,2,238083,238083,238085,0,2,0
67965,5,1,238088,238088,238089,0,1,3
67966,5,3,238093,238093,238096,0,3,4
67967,4,3,238097,238097,238100,0,3,1
67968,2,3,238099,238100,238103,1,4,0
67969,2,1,238101,238103,238104,2,3,0
67970,2,1,238103,238104,238105,1,2,0
67971,2,3,238105,238105,238108,0,3,0
67972,3,3,238108,238108,238111,0,3,0
67973,4,3,238112,238112,238115,0,3,1
67974,6,1,238118,238118,238119,0,1,3
67975,4,3,238122,238122,238125,0,3,3
67976,1,1,238123,238125,238126,2,3,0
67977,6,2,238129,238129,238131,0,2,3
67978,5,1,238134,238134,238135,0,1,3
67979,2,2,238136,238136,238138,0,2,1
67980,6,3,238142,238142,238145,0,3,4
67981,6,2,238148,238148,238150,0,2,3
67982,5,2,238153,238153,238155,0,2,3
67983,2,3,238155,238155,238158,0,3,0
67984,2,2,238157,238158,238160,1,3,0
67985,2,1,238159,238160,238161,1,2,0
67986,1,2,238160,238161,238163,1,3,0
67987,1,2,238161,238163,238165,2,4,0
67988,3,2,238164,238165,238167,1,3,0
67989,1,1,238165,238167,238168,2,3,0
67990,5,1,238170,238170,238171,0,1,2
67991,1,1,238171,238171,238172,0,1,0
67992,3,3,238174,238174,238177,0,3,2
67993,1,3,238175,238177,238180,2,5,0
67994,1,1,238176,238180,238181,4,5,0
67995,6,3,238182,238182,238185,0,3,1
67996,6,1,238188,238188,238189,0,1,3
67997,1,2,238189,238189,238191,0,2,0
67998,5,3,238194,238194,238197,0,3,3
67999,5,2,238199,238199,238201,0,2,2
68000,1,3,238200,238201,238204,1,4,0
68001,4,3,238204,238204,238207,0,3,0
68002,5,2,238209,238209,238211,0,2,2
68003,3,2,238212,238212,238214,0,2,1
68004,6,3,238218,238218,238221,0,3,4
68005,1,1,238219,238221,238222,2,3,0
68006,2,2,238221,238222,238224,1,3,0
68007,2,2,238223,238224,238226,1,3,0
68008,3,3,238226,238226,238229,0,3,0
68009,5,3,238231,238231,238234,0,3,2
68010,4,1,238235,238235,238236,0,1,1
68011,2,2,238237,238237,238239,0,2,1
68012,2,3,238239,238239,238242,0,3,0
68013,4,1,238243,238243,238244,0,1,1
68014,1,2,238244,238244,238246,0,2,0
68015,3,1,238247,238247,238248,0,1,1
68016,6,2,238253,238253,238255,0,2,5
68017,4,3,238257,238257,238260,0,3,2
68018,2,2,238259,238260,238262,1,3,0
68019,4,3,238263,238263,238266,0,3,1
68020,3,2,238266,238266,238268,0,2,0
68021,2,1,238268,238268,238269,0,1,0
68022,5,2,238273,238273,238275,0,2,4
68023,3,3,238276,238276,238279,0,3,1
68024,5,3,238281,238281,238284,0,3,2
68025,4,2,238285,238285,238287,0,2,1
68026,4,1,238289,238289,238290,0,1,2
68027,6,1,238295,238295,238296,0,1,5
68028,6,1,238301,238301,238302,0,1,5
68029,1,3,238302,238302,238305,0,3,0
68030,5,1,238307,238307,238308,0,1,2
68031,4,3,238311,238311,238314,0,3,3
68032,6,1,238317,238317,238318,0,1,3
68033,5,1,238322,238322,238323,0,1,4
68034,5,2,238327,238327,238329,0,2,4
68035,1,3,238328,238329,238332,1,4,0
68036,6,1,238334,238334,238335,0,1,2
68037,4,2,238338,238338,238340,0,2,3
68038,2,2,238340,238340,238342,0,2,0
68039,5,3,238345,238345,238348,0,3,3
68040,4,2,238349,238349,238351,0,2,1
68041,3,1,238352,238352,238353,0,1,1
68042,1,3,238353,238353,238356,0,3,0
68043,5,3,238358,238358,238361,0,3,2
68044,2,2,238360,238361,238363,1,3,0
68045,2,3,238362,238363,238366,1,4,0
68046,3,3,238365,238366,238369,1,4,0
68047,3,3,238368,238369,238372,1,4,0
68048,1,3,238369,238372,238375,3,6,0
68049,4,3,238373,238375,238378,2,5,0
68050,3,1,238376,238378,238379,2,3,0
68051,4,3,238380,238380,238383,0,3,1
68052,5,3,238385,238385,238388,0,3,2
68053,2,2,238387,238388,238390,1,3,0
68054,5,2,238392,238392,238394,0,2,2
68055,5,1,238397,238397,238398,0,1,3
68056,2,1,238399,238399,238400,0,1,1
68057,1,1,238400,238400,238401,0,1,0
68058,4,3,238404,238404,238407,0,3,3
68059,5,2,238409,238409,238411,0,2,2
68060,2,3,238411,238411,238414,0,3,0
68061,1,3,238412,238414,238417,2,5,0
68062,1,2,238413,238417,238419,4,6,0
68063,2,2,238415,238419,238421,4,6,0
68064,5,2,238420,238421,238423,1,3,0
68065,6,1,238426,238426,238427,0,1,3
68066,1,2,238427,238427,238429,0,2,0
68067,1,3,238428,238429,238432,1,4,0
68068,6,2,238434,238434,238436,0,2,2
68069,4,1,238438,238438,238439,0,1,2
68070,4,1,238442,238442,238443,0,1,3
68071,6,3,238448,238448,238451,0,3,5
68072,6,3,238454,238454,238457,0,3,3
68073,6,1,238460,238460,238461,0,1,3
68074,2,1,238462,238462,238463,0,1,1
68075,3,2,238465,238465,238467,0,2,2
68076,1,2,238466,238467,238469,1,3,0
68077,2,2,238468,238469,238471,1,3,0
68078,4,2,238472,238472,238474,0,2,1
68079,6,3,238478,238478,238481,0,3,4
68080,6,3,238484,238484,238487,0,3,3
68081,5,1,238489,238489,238490,0,1,2
68082,3,2,238492,238492,238494,0,2,2
68083,6,1,238498,238498,238499,0,1,4
68084,1,1,238499,238499,238500,0,1,0
68085,4,2,238503,238503,238505,0,2,3
68086,2,3,238505,238505,238508,0,3,0
68087,6,3,238511,238511,238514,0,3,3
68088,5,1,238516,238516,238517,0,1,2
68089,1,2,238517,238517,238519,0,2,0
68090,4,1,238521,238521,238522,0,1,2
68091,5,2,238526,238526,238528,0,2,4
68092,2,2,238528,238528,238530,0,2,0
68093,3,1,238531,238531,238532,0,1,1
68094,4,1,238535,238535,238536,0,1,3
68095,4,2,238539,238539,238541,0,2,3
68096,3,2,238542,238542,238544,0,2,1
68097,5,3,238547,238547,238550,0,3,3
68098,5,3,238552,238552,238555,0,3,2
68099,5,1,238557,238557,238558,0,1,2
68100,4,1,238561,238561,238562,0,1,3
68101,4,3,238565,238565,238568,0,3,3
68102,3,2,238568,238568,238570,0,2,0
68103,5,2,238573,238573,238575,0,2,3
68104,5,3,238578,238578,238581,0,3,3
68105,3,1,238581,238581,238582,0,1,0
68106,3,3,238584,238584,238587,0,3,2
68107,5,2,238589,238589,238591,0,2,2
68108,4,2,238593,238593,238595,0,2,2
68109,6,1,238599,238599,238600,0,1,4
68110,5,2,238604,238604,238606,0,2,4
68111,5,1,238609,238609,238610,0,1,3
68112,5,1,238614,238614,238615,0,1,4
68113,2,1,238616,238616,238617,0,1,1
68114,4,1,238620,238620,238621,0,1,3
68115,6,3,238626,238626,238629,0,3,5
68116,4,3,238630,238630,238633,0,3,1
68117,5,3,238635,238635,238638,0,3,2
68118,4,1,238639,238639,238640,0,1,1
68119,1,1,238640,238640,238641,0,1,0
68120,4,2,238644,238644,238646,0,2,3
68121,3,2,238647,238647,238649,0,2,1
68122,3,2,238650,238650,238652,0,2,1
68123,4,3,238654,238654,238657,0,3,2
68124,5,3,238659,238659,238662,0,3,2
68125,2,2,238661,238662,238664,1,3,0
68126,6,1,238667,238667,238668,0,1,3
68127,5,3,238672,238672,238675,0,3,4
68128,1,3,238673,238675,238678,2,5,0
68129,1,2,238674,238678,238680,4,6,0
68130,4,2,238678,238680,238682,2,4,0
68131,4,3,238682,238682,238685,0,3,0
68132,2,3,238684,238685,238688,1,4,0
68133,3,1,238687,238688,238689,1,2,0
68134,6,1,238693,238693,238694,0,1,4
68135,6,2,238699,238699,238701,0,2,5
68136,2,2,238701,238701,238703,0,2,0
68137,1,3,238702,238703,238706,1,4,0
68138,4,2,238706,238706,238708,0,2,0
68139,3,3,238709,238709,238712,0,3,1
68140,1,1,238710,238712,238713,2,3,0
68141,5,3,238715,238715,238718,0,3,2
68142,4,2,238719,238719,238721,0,2,1
68143,6,1,238725,238725,238726,0,1,4
68144,4,3,238729,238729,238732,0,3,3
68145,2,1,238731,238732,238733,1,2,0
68146,2,3,238733,238733,238736,0,3,0
68147,4,1,238737,238737,238738,0,1,1
68148,1,3,238738,238738,238741,0,3,0
68149,6,2,238744,238744,238746,0,2,3
68150,6,3,238750,238750,238753,0,3,4
68151,5,2,238755,238755,238757,0,2,2
68152,3,2,238758,238758,238760,0,2,1
68153,4,3,238762,238762,238765,0,3,2
68154,5,2,238767,238767,238769,0,2,2
68155,5,3,238772,238772,238775,0,3,3
68156,5,3,238777,238777,238780,0,3,2
68157,4,2,238781,238781,238783,0,2,1
68158,6,3,238787,238787,238790,0,3,4
68159,6,2,238793,238793,238795,0,2,3
68160,6,1,238799,238799,238800,0,1,4
68161,2,2,238801,238801,238803,0,2,1
68162,5,3,238806,238806,238809,0,3,3
68163,6,2,238812,238812,238814,0,2,3
68164,3,1,238815,238815,238816,0,1,1
68165,6,3,238821,238821,238824,0,3,5
68166,4,3,238825,238825,238828,0,3,1
68167,6,3,238831,238831,238834,0,3,3
68168,1,2,238832,238834,238836,2,4,0
68169,2,1,238834,238836,238837,2,3,0
68170,4,2,238838,238838,238840,0,2,1
68171,4,3,238842,238842,238845,0,3,2
68172,5,1,238847,238847,238848,0,1,2
68173,5,2,238852,238852,238854,0,2,4
68174,2,2,238854,238854,238856,0,2,0
68175,1,3,238855,238856,238859,1,4,0
68176,4,1,238859,238859,238860,0,1,0
68177,2,2,238861,238861,238863,0,2,1
68178,6,3,238867,238867,238870,0,3,4
68179,6,1,238873,238873,238874,0,1,3
68180,2,1,238875,238875,238876,0,1,1
68181,5,2,238880,238880,238882,0,2,4
68182,1,1,238881,238882,238883,1,2,0
68183,1,2,238882,238883,238885,1,3,0
68184,2,3,238884,238885,238888,1,4,0
68185,4,1,238888,238888,238889,0,1,0
68186,2,1,238890,238890,238891,0,1,1
68187,2,3,238892,238892,238895,0,3,1
68188,5,2,238897,238897,238899,0,2,2
68189,2,2,238899,238899,238901,0,2,0
68190,4,1,238903,238903,238904,0,1,2
68191,3,3,238906,238906,238909,0,3,2
68192,2,1,238908,238909,238910,1,2,0
68193,2,2,238910,238910,238912,0,2,0
68194,1,2,238911,238912,238914,1,3,0
68195,3,3,238914,238914,238917,0,3,0
68196,5,3,238919,238919,238922,0,3,2
68197,1,3,238920,238922,238925,2,5,0
68198,4,1,238924,238925,238926,1,2,0
68199,1,3,238925,238926,238929,1,4,0
68200,3,3,238928,238929,238932,1,4,0
68201,1,3,238929,238932,238935,3,6,0
68202,5,1,238934,238935,238936,1,2,0
68203,5,3,238939,238939,238942,0,3,3
68204,2,2,238941,238942,238944,1,3,0
68205,6,3,238947,238947,238950,0,3,3
68206,2,1,238949,238950,238951,1,2,0
68207,4,2,238953,238953,238955,0,2,2
68208,3,2,238956,238956,238958,0,2,1
68209,4,3,238960,238960,238963,0,3,2
68210,5,3,238965,238965,238968,0,3,2
68211,5,1,238970,238970,238971,0,1,2
68212,6,2,238976,238976,238978,0,2,5
68213,1,2,238977,238978,238980,1,3,0
68214,2,1,238979,238980,238981,1,2,0
68215,1,2,238980,238981,238983,1,3,0
68216,4,3,238984,238984,238987,0,3,1
68217,3,3,238987,238987,238990,0,3,0
68218,5,3,238992,238992,238995,0,3,2
68219,1,1,238993,238995,238996,2,3,0
68220,4,2,238997,238997,238999,0,2,1
68221,5,2,239002,239002,239004,0,2,3
68222,6,2,239008,239008,239010,0,2,4
68223,1,1,239009,239010,239011,1,2,0
68224,4,2,239013,239013,239015,0,2,2
68225,2,3,239015,239015,239018,0,3,0
68226,2,2,239017,239018,239020,1,3,0
68227,6,2,239023,239023,239025,0,2,3
68228,6,1,239029,239029,239030,0,1,4
68229,3,1,239032,239032,239033,0,1,2
68230,5,3,239037,239037,239040,0,3,4
68231,6,3,239043,239043,239046,0,3,3
68232,4,3,239047,239047,239050,0,3,1
68233,4,3,239051,239051,239054,0,3,1
68234,6,3,239057,239057,239060,0,3,3
68235,4,1,239061,239061,239062,0,1,1
68236,5,2,239066,239066,239068,0,2,4
68237,6,1,239072,239072,239073,0,1,4
68238,5,3,239077,239077,239080,0,3,4
68239,1,1,239078,239080,239081,2,3,0
68240,2,1,239080,239081,239082,1,2,0
68241,5,2,239085,239085,239087,0,2,3
68242,1,2,239086,239087,239089,1,3,0
68243,5,2,239091,239091,239093,0,2,2
68244,3,1,239094,239094,239095,0,1,1
68245,4,2,239098,239098,239100,0,2,3
68246,2,3,239100,239100,239103,0,3,0
68247,4,1,239104,239104,239105,0,1,1
68248,5,3,239109,239109,239112,0,3,4
68249,6,2,239115,239115,239117,0,2,3
68250,5,2,239120,239120,239122,0,2,3
68251,2,3,239122,239122,239125,0,3,0
68252,6,3,239128,239128,239131,0,3,3
68253,3,3,239131,239131,239134,0,3,0
68254,1,2,239132,239134,239136,2,4,0
68255,5,2,239137,239137,239139,0,2,1
68256,1,2,239138,239139,239141,1,3,0
68257,5,2,239143,239143,239145,0,2,2
68258,1,2,239144,239145,239147,1,3,0
68259,1,2,239145,239147,239149,2,4,0
68260,6,1,239151,239151,239152,0,1,2
68261,1,3,239152,239152,239155,0,3,0
68262,3,2,239155,239155,239157,0,2,0
68263,6,1,239161,239161,239162,0,1,4
68264,3,2,239164,239164,239166,0,2,2
68265,1,2,239165,239166,239168,1,3,0
68266,4,1,239169,239169,239170,0,1,1
68267,6,1,239175,239175,239176,0,1,5
68268,4,1,239179,239179,239180,0,1,3
68269,5,1,239184,239184,239185,0,1,4
68270,6,3,239190,239190,239193,0,3,5
68271,6,2,239196,239196,239198,0,2,3
68272,4,2,239200,239200,239202,0,2,2
68273,1,1,239201,239202,239203,1,2,0
68274,6,2,239207,239207,239209,0,2,4
68275,5,2,239212,239212,239214,0,2,3
68276,1,1,239213,239214,239215,1,2,0
68277,5,1,239218,239218,239219,0,1,3
68278,6,1,239224,239224,239225,0,1,5
68279,1,2,239225,239225,239227,0,2,0
68280,4,3,239229,239229,239232,0,3,2
68281,5,2,239234,239234,239236,0,2,2
68282,5,3,239239,239239,239242,0,3,3
68283,4,1,239243,239243,239244,0,1,1
68284,4,1,239247,239247,239248,0,1,3
68285,6,3,239253,239253,239256,0,3,5
68286,1,3,239254,239256,239259,2,5,0
68287,6,3,239260,239260,239263,0,3,1
68288,6,2,239266,239266,239268,0,2,3
68289,6,1,239272,239272,239273,0,1,4
68290,1,3,239273,239273,239276,0,3,0
68291,2,2,239275,239276,239278,1,3,0
68292,1,1,239276,239278,239279,2,3,0
68293,6,3,239282,239282,239285,0,3,3
68294,4,2,239286,239286,239288,0,2,1
68295,5,1,239291,239291,239292,0,1,3
68296,1,3,239292,239292,239295,0,3,0
68297,5,3,239297,239297,239300,0,3,2
68298,4,2,239301,239301,239303,0,2,1
68299,6,3,239307,239307,239310,0,3,4
68300,3,3,239310,239310,239313,0,3,0
68301,1,1,239311,239313,239314,2,3,0
68302,5,2,239316,239316,239318,0,2,2
68303,3,3,239319,239319,239322,0,3,1
68304,2,1,239321,239322,239323,1,2,0
68305,4,3,239325,239325,239328,0,3,2
68306,2,3,239327,239328,239331,1,4,0
68307,1,1,239328,239331,239332,3,4,0
68308,6,3,239334,239334,239337,0,3,2
68309,1,1,239335,239337,239338,2,3,0
68310,1,3,239336,239338,239341,2,5,0
68311,5,1,239341,239341,239342,0,1,0
68312,4,2,239345,239345,239347,0,2,3
68313,1,1,239346,239347,239348,1,2,0
68314,4,2,239350,239350,239352,0,2,2
68315,3,3,239353,239353,239356,0,3,1
68316,3,3,239356,239356,239359,0,3,0
68317,3,1,239359,239359,239360,0,1,0
68318,1,2,239360,239360,239362,0,2,0
68319,3,1,239363,239363,239364,0,1,1
68320,6,2,239369,239369,239371,0,2,5
68321,6,2,239375,239375,239377,0,2,4
68322,6,3,239381,239381,239384,0,3,4
68323,5,2,239386,239386,239388,0,2,2
68324,1,2,239387,239388,239390,1,3,0
68325,6,2,239393,239393,239395,0,2,3
68326,3,2,239396,239396,239398,0,2,1
68327,5,3,239401,239401,239404,0,3,3
68328,2,2,239403,239404,239406,1,3,0
68329,3,3,239406,239406,239409,0,3,0
68330,4,2,239410,239410,239412,0,2,1
68331,6,2,239416,239416,239418,0,2,4
68332,5,3,239421,239421,239424,0,3,3
68333,6,1,239427,239427,239428,0,1,3
68334,2,2,239429,239429,239431,0,2,1
68335,2,1,239431,239431,239432,0,1,0
68336,2,2,239433,239433,239435,0,2,1
68337,1,2,239434,239435,239437,1,3,0
68338,5,1,239439,239439,239440,0,1,2
68339,6,2,239445,239445,239447,0,2,5
68340,2,3,239447,239447,239450,0,3,0
68341,6,3,239453,239453,239456,0,3,3
68342,4,2,239457,239457,239459,0,2,1
68343,5,2,239462,239462,239464,0,2,3
68344,1,2,239463,239464,239466,1,3,0
68345,3,3,239466,239466,239469,0,3,0
68346,1,3,239467,239469,239472,2,5,0
68347,4,1,239471,239472,239473,1,2,0
68348,2,2,239473,239473,239475,0,2,0
68349,4,2,239477,239477,239479,0,2,2
68350,2,1,239479,239479,239480,0,1,0
68351,6,2,239485,239485,239487,0,2,5
68352,2,3,239487,239487,239490,0,3,0
68353,6,2,239493,239493,239495,0,2,3
68354,1,1,239494,239495,239496,1,2,0
68355,5,3,239499,239499,239502,0,3,3
68356,3,1,239502,239502,239503,0,1,0
68357,6,2,239508,239508,239510,0,2,5
68358,6,2,239514,239514,239516,0,2,4
68359,3,1,239517,239517,239518,0,1,1
68360,2,2,239519,239519,239521,0,2,1
68361,3,2,239522,239522,239524,0,2,1
68362,4,2,239526,239526,239528,0,2,2
68363,3,1,239529,239529,239530,0,1,1
68364,1,2,239530,239530,239532,0,2,0
68365,6,2,239536,239536,239538,0,2,4
68366,3,2,239539,239539,239541,0,2,1
68367,4,1,239543,239543,239544,0,1,2
68368,2,3,239545,239545,239548,0,3,1
68369,6,2,239551,239551,239553,0,2,3
68370,3,1,239554,239554,239555,0,1,1
68371,3,3,239557,239557,239560,0,3,2
68372,2,1,239559,239560,239561,1,2,0
68373,3,3,239562,239562,239565,0,3,1
68374,1,2,239563,239565,239567,2,4,0
68375,3,3,239566,239567,239570,1,4,0
68376,6,3,239572,239572,239575,0,3,2
68377,5,1,239577,239577,239578,0,1,2
68378,4,2,239581,239581,239583,0,2,3
68379,1,3,239582,239583,239586,1,4,0
68380,3,2,239585,239586,239588,1,3,0
68381,1,1,239586,239588,239589,2,3,0
68382,1,1,239587,239589,239590,2,3,0
68383,4,2,239591,239591,239593,0,2,1
68384,1,2,239592,239593,239595,1,3,0
68385,6,3,239598,239598,239601,0,3,3
68386,2,3,239600,239601,239604,1,4,0
68387,6,2,239606,239606,239608,0,2,2
68388,1,2,239607,239608,239610,1,3,0
68389,1,3,239608,239610,239613,2,5,0
68390,1,1,239609,239613,239614,4,5,0
68391,3,1,239612,239614,239615,2,3,0
68392,4,2,239616,239616,239618,0,2,1
68393,3,3,239619,239619,239622,0,3,1
68394,5,3,239624,239624,239627,0,3,2
68395,4,2,239628,239628,239630,0,2,1
68396,1,3,239629,239630,239633,1,4,0
68397,6,2,239635,239635,239637,0,2,2
68398,3,3,239638,239638,239641,0,3,1
68399,5,2,239643,239643,239645,0,2,2
68400,2,1,239645,239645,239646,0,1,0
68401,2,1,239647,239647,239648,0,1,1
68402,6,1,239653,239653,239654,0,1,5
68403,1,3,239654,239654,239657,0,3,0
68404,3,1,239657,239657,239658,0,1,0
68405,2,3,239659,239659,239662,0,3,1
68406,3,1,239662,239662,239663,0,1,0
68407,1,1,239663,239663,239664,0,1,0
68408,3,2,239666,239666,239668,0,2,2
68409,4,3,239670,239670,239673,0,3,2
68410,6,2,239676,239676,239678,0,2,3
68411,4,3,239680,239680,239683,0,3,2
68412,1,1,239681,239683,239684,2,3,0
68413,6,1,239687,239687,239688,0,1,3
68414,2,3,239689,239689,239692,0,3,1
68415,3,2,239692,239692,239694,0,2,0
68416,3,3,239695,239695,239698,0,3,1
68417,4,1,239699,239699,239700,0,1,1
68418,1,1,239700,239700,239701,0,1,0
68419,1,2,239701,239701,239703,0,2,0
68420,4,2,239705,239705,239707,0,2,2
68421,2,2,239707,239707,239709,0,2,0
68422,2,2,239709,239709,239711,0,2,0
68423,6,1,239715,239715,239716,0,1,4
68424,5,3,239720,239720,239723,0,3,4
68425,3,3,239723,239723,239726,0,3,0
68426,4,1,239727,239727,239728,0,1,1
68427,3,1,239730,239730,239731,0,1,2
68428,4,3,239734,239734,239737,0,3,3
68429,3,3,239737,239737,239740,0,3,0
68430,4,3,239741,239741,239744,0,3,1
68431,2,3,239743,239744,239747,1,4,0
68432,3,3,239746,239747,239750,1,4,0
68433,6,3,239752,239752,239755,0,3,2
68434,4,3,239756,239756,239759,0,3,1
68435,2,2,239758,239759,239761,1,3,0
68436,2,2,239760,239761,239763,1,3,0
68437,2,1,239762,239763,239764,1,2,0
68438,6,3,239768,239768,239771,0,3,4
68439,6,3,239774,239774,239777,0,3,3
68440,3,1,239777,239777,239778,0,1,0
68441,6,1,239783,239783,239784,0,1,5
68442,3,3,239786,239786,239789,0,3,2
68443,3,2,239789,239789,239791,0,2,0
68444,3,3,239792,239792,239795,0,3,1
68445,2,1,239794,239795,239796,1,2,0
68446,5,1,239799,239799,239800,0,1,3
68447,1,1,239800,239800,239801,0,1,0
68448,1,1,239801,239801,239802,0,1,0
68449,2,3,239803,239803,239806,0,3,1
68450,4,3,239807,239807,239810,0,3,1
68451,2,1,239809,239810,239811,1,2,0
68452,4,2,239813,239813,239815,0,2,2
68453,4,1,239817,239817,239818,0,1,2
68454,1,1,239818,239818,239819,0,1,0
68455,1,1,239819,239819,239820,0,1,0
68456,2,2,239821,239821,239823,0,2,1
68457,1,2,239822,239823,239825,1,3,0
68458,5,3,239827,239827,239830,0,3,2
68459,1,2,239828,239830,239832,2,4,0
68460,1,2,239829,239832,239834,3,5,0
68461,1,2,239830,239834,239836,4,6,0
68462,6,2,239836,239836,239838,0,2,0
68463,4,3,239840,239840,239843,0,3,2
68464,1,1,239841,239843,239844,2,3,0
68465,2,2,239843,239844,239846,1,3,0
68466,6,3,239849,239849,239852,0,3,3
68467,1,1,239850,239852,239853,2,3,0
68468,4,1,239854,239854,239855,0,1,1
68469,2,3,239856,239856,239859,0,3,1
68470,2,3,239858,239859,239862,1,4,0
68471,5,3,239863,239863,239866,0,3,1
68472,4,2,239867,239867,239869,0,2,1
68473,4,2,239871,239871,239873,0,2,2
68474,5,1,239876,239876,239877,0,1,3
68475,6,2,239882,239882,239884,0,2,5
68476,3,2,239885,239885,239887,0,2,1
68477,6,2,239891,239891,239893,0,2,4
68478,5,3,239896,239896,239899,0,3,3
68479,2,2,239898,239899,239901,1,3,0
68480,4,2,239902,239902,239904,0,2,1
68481,1,3,239903,239904,239907,1,4,0
68482,4,2,239907,239907,239909,0,2,0
68483,2,2,239909,239909,239911,0,2,0
68484,5,1,239914,239914,239915,0,1,3
68485,6,3,239920,239920,239923,0,3,5
68486,2,1,239922,239923,239924,1,2,0
68487,6,3,239928,239928,239931,0,3,4
68488,1,1,239929,239931,239932,2,3,0
68489,6,2,239935,239935,239937,0,2,3
68490,2,1,239937,239937,239938,0,1,0
68491,2,3,239939,239939,239942,0,3,1
68492,1,3,239940,239942,239945,2,5,0
68493,2,3,239942,239945,239948,3,6,0
68494,5,2,239947,239948,239950,1,3,0
68495,6,2,239953,239953,239955,0,2,3
68496,6,1,239959,239959,239960,0,1,4
68497,2,1,239961,239961,239962,0,1,1
68498,2,2,239963,239963,239965,0,2,1
68499,6,3,239969,239969,239972,0,3,4
68500,2,1,239971,239972,239973,1,2,0
68501,4,1,239975,239975,239976,0,1,2
68502,5,3,239980,239980,239983,0,3,4
68503,6,3,239986,239986,239989,0,3,3
68504,3,3,239989,239989,239992,0,3,0
68505,6,2,239995,239995,239997,0,2,3
68506,3,2,239998,239998,240000,0,2,1
68507,2,3,240000,240000,240003,0,3,0
68508,5,3,240005,240005,240008,0,3,2
68509,4,2,240009,240009,240011,0,2,1
68510,3,1,240012,240012,240013,0,1,1
68511,5,3,240017,240017,240020,0,3,4
68512,3,3,240020,240020,240023,0,3,0
68513,5,1,240025,240025,240026,0,1,2
68514,2,3,240027,240027,240030,0,3,1
68515,1,1,240028,240030,240031,2,3,0
68516,2,3,240030,240031,240034,1,4,0
68517,2,3,240032,240034,240037,2,5,0
68518,1,1,240033,240037,240038,4,5,0
68519,5,2,240038,240038,240040,0,2,0
68520,3,1,240041,240041,240042,0,1,1
68521,2,1,240043,240043,240044,0,1,1
68522,2,1,240045,240045,240046,0,1,1
68523,3,1,240048,240048,240049,0,1,2
68524,1,2,240049,240049,240051,0,2,0
68525,6,3,240055,240055,240058,0,3,4
68526,6,1,240061,240061,240062,0,1,3
68527,6,1,240067,240067,240068,0,1,5
68528,4,3,240071,240071,240074,0,3,3
68529,4,1,240075,240075,240076,0,1,1
68530,1,2,240076,240076,240078,0,2,0
68531,5,1,240081,240081,240082,0,1,3
68532,3,1,240084,240084,240085,0,1,2
68533,4,3,240088,240088,240091,0,3,3
68534,4,1,240092,240092,240093,0,1,1
68535,3,3,240095,240095,240098,0,3,2
68536,5,2,240100,240100,240102,0,2,2
68537,4,2,240104,240104,240106,0,2,2
68538,4,3,240108,240108,240111,0,3,2
68539,4,2,240112,240112,240114,0,2,1
68540,2,2,240114,240114,240116,0,2,0
68541,2,3,240116,240116,240119,0,3,0
68542,1,1,240117,240119,240120,2,3,0
68543,3,3,240120,240120,240123,0,3,0
68544,5,1,240125,240125,240126,0,1,2
68545,1,1,240126,240126,240127,0,1,0
68546,2,1,240128,240128,240129,0,1,1
68547,2,1,240130,240130,240131,0,1,1
68548,6,2,240136,240136,240138,0,2,5
68549,4,2,240140,240140,240142,0,2,2
68550,6,3,240146,240146,240149,0,3,4
68551,3,1,240149,240149,240150,0,1,0
68552,6,3,240155,240155,240158,0,3,5
68553,3,2,240158,240158,240160,0,2,0
68554,1,1,240159,240160,240161,1,2,0
68555,3,3,240162,240162,240165,0,3,1
68556,6,1,240168,240168,240169,0,1,3
68557,3,1,240171,240171,240172,0,1,2
68558,2,2,240173,240173,240175,0,2,1
68559,2,2,240175,240175,240177,0,2,0
68560,1,1,240176,240177,240178,1,2,0
68561,1,3,240177,240178,240181,1,4,0
68562,1,2,240178,240181,240183,3,5,0
68563,3,2,240181,240183,240185,2,4,0
68564,4,1,240185,240185,240186,0,1,0
68565,5,2,240190,240190,240192,0,2,4
68566,2,2,240192,240192,240194,0,2,0
68567,4,3,240196,240196,240199,0,3,2
68568,5,1,240201,240201,240202,0,1,2
68569,3,3,240204,240204,240207,0,3,2
68570,1,3,240205,240207,240210,2,5,0
68571,4,3,240209,240210,240213,1,4,0
68572,2,1,240211,240213,240214,2,3,0
68573,1,2,240212,240214,240216,2,4,0
68574,6,3,240218,240218,240221,0,3,2
68575,4,3,240222,240222,240225,0,3,1
68576,2,1,240224,240225,240226,1,2,0
68577,4,2,240228,240228,240230,0,2,2
68578,2,2,240230,240230,240232,0,2,0
68579,5,1,240235,240235,240236,0,1,3
68580,2,2,240237,240237,240239,0,2,1
68581,2,3,240239,240239,240242,0,3,0
68582,2,1,240241,240242,240243,1,2,0
68583,1,3,240242,240243,240246,1,4,0
68584,4,1,240246,240246,240247,0,1,0
68585,5,1,240251,240251,240252,0,1,4
68586,4,1,240255,240255,240256,0,1,3
68587,1,3,240256,240256,240259,0,3,0
68588,1,3,240257,240259,240262,2,5,0
68589,3,1,240260,240262,240263,2,3,0
68590,6,3,240266,240266,240269,0,3,3
68591,5,2,240271,240271,240273,0,2,2
68592,6,2,240277,240277,240279,0,2,4
68593,6,1,240283,240283,240284,0,1,4
68594,2,1,240285,240285,240286,0,1,1
68595,5,1,240290,240290,240291,0,1,4
68596,1,3,240291,240291,240294,0,3,0
68597,6,3,240297,240297,240300,0,3,3
68598,1,3,240298,240300,240303,2,5,0
68599,6,3,240304,240304,240307,0,3,1
68600,2,2,240306,240307,240309,1,3,0
68601,6,2,240312,240312,240314,0,2,3
68602,4,1,240316,240316,240317,0,1,2
68603,1,3,240317,240317,240320,0,3,0
68604,5,1,240322,240322,240323,0,1,2
68605,5,2,240327,240327,240329,0,2,4
68606,1,3,240328,240329,240332,1,4,0
68607,1,3,240329,240332,240335,3,6,0
68608,5,2,240334,240335,240337,1,3,0
68609,6,3,240340,240340,240343,0,3,3
68610,4,1,240344,240344,240345,0,1,1
68611,4,1,240348,240348,240349,0,1,3
68612,5,2,240353,240353,240355,0,2,4
68613,3,3,240356,240356,240359,0,3,1
68614,3,2,240359,240359,240361,0,2,0
68615,6,3,240365,240365,240368,0,3,4
68616,3,3,240368,240368,240371,0,3,0
68617,4,2,240372,240372,240374,0,2,1
68618,5,2,240377,240377,240379,0,2,3
68619,2,2,240379,240379,240381,0,2,0
68620,4,3,240383,240383,240386,0,3,2
68621,2,2,240385,240386,240388,1,3,0
68622,6,1,240391,240391,240392,0,1,3
68623,1,1,240392,240392,240393,0,1,0
68624,2,1,240394,240394,240395,0,1,1
68625,2,1,240396,240396,240397,0,1,1
68626,1,1,240397,240397,240398,0,1,0
68627,1,2,240398,240398,240400,0,2,0
68628,6,2,240404,240404,240406,0,2,4
68629,5,1,240409,240409,240410,0,1,3
68630,3,1,240412,240412,240413,0,1,2
68631,2,2,240414,240414,240416,0,2,1
68632,5,3,240419,240419,240422,0,3,3
68633,6,3,240425,240425,240428,0,3,3
68634,1,1,240426,240428,240429,2,3,0
68635,4,1,240430,240430,240431,0,1,1
68636,5,2,240435,240435,240437,0,2,4
68637,4,2,240439,240439,240441,0,2,2
68638,4,2,240443,240443,240445,0,2,2
68639,2,3,240445,240445,240448,0,3,0
68640,3,1,240448,240448,240449,0,1,0
68641,2,1,240450,240450,240451,0,1,1
68642,2,3,240452,240452,240455,0,3,1
68643,1,2,240453,240455,240457,2,4,0
68644,5,3,240458,240458,240461,0,3,1
68645,2,3,240460,240461,240464,1,4,0
68646,2,1,240462,240464,240465,2,3,0
68647,6,2,240468,240468,240470,0,2,3
68648,1,3,240469,240470,240473,1,4,0
68649,4,2,240473,240473,240475,0,2,0
68650,1,2,240474,240475,240477,1,3,0
68651,5,1,240479,240479,240480,0,1,2
68652,1,1,240480,240480,240481,0,1,0
68653,4,3,240484,240484,240487,0,3,3
68654,6,1,240490,240490,240491,0,1,3
68655,5,3,240495,240495,240498,0,3,4
68656,2,2,240497,240498,240500,1,3,0
68657,2,1,240499,240500,240501,1,2,0
68658,3,1,240502,240502,240503,0,1,1
68659,4,1,240506,240506,240507,0,1,3
68660,1,2,240507,240507,240509,0,2,0
68661,1,2,240508,240509,240511,1,3,0
68662,1,1,240509,240511,240512,2,3,0
68663,6,2,240515,240515,240517,0,2,3
68664,6,2,240521,240521,240523,0,2,4
68665,5,2,240526,240526,240528,0,2,3
68666,6,3,240532,240532,240535,0,3,4
68667,1,1,240533,240535,240536,2,3,0
68668,6,2,240539,240539,240541,0,2,3
68669,2,1,240541,240541,240542,0,1,0
68670,1,1,240542,240542,240543,0,1,0
68671,4,3,240546,240546,240549,0,3,3
68672,4,2,240550,240550,240552,0,2,1
68673,6,3,240556,240556,240559,0,3,4
68674,1,3,240557,240559,240562,2,5,0
68675,3,2,240560,240562,240564,2,4,0
68676,1,3,240561,240564,240567,3,6,0
68677,5,2,240566,240567,240569,1,3,0
68678,4,3,240570,240570,240573,0,3,1
68679,3,1,240573,240573,240574,0,1,0
68680,4,3,240577,240577,240580,0,3,3
68681,5,3,240582,240582,240585,0,3,2
68682,3,2,240585,240585,240587,0,2,0
68683,5,3,240590,240590,240593,0,3,3
68684,6,3,240596,240596,240599,0,3,3
68685,6,1,240602,240602,240603,0,1,3
68686,4,3,240606,240606,240609,0,3,3
68687,3,3,240609,240609,240612,0,3,0
68688,5,1,240614,240614,240615,0,1,2
68689,2,3,240616,240616,240619,0,3,1
68690,6,3,240622,240622,240625,0,3,3
68691,6,1,240628,240628,240629,0,1,3
68692,3,3,240631,240631,240634,0,3,2
68693,2,1,240633,240634,240635,1,2,0
68694,3,2,240636,240636,240638,0,2,1
68695,5,2,240641,240641,240643,0,2,3
68696,1,3,240642,240643,240646,1,4,0
68697,1,2,240643,240646,240648,3,5,0
68698,6,3,240649,240649,240652,0,3,1
68699,1,1,240650,240652,240653,2,3,0
68700,1,2,240651,240653,240655,2,4,0
68701,6,1,240657,240657,240658,0,1,2
68702,4,3,240661,240661,240664,0,3,3
68703,3,1,240664,240664,240665,0,1,0
68704,4,2,240668,240668,240670,0,2,3
68705,1,2,240669,240670,240672,1,3,0
68706,6,1,240675,240675,240676,0,1,3
68707,3,3,240678,240678,240681,0,3,2
68708,4,1,240682,240682,240683,0,1,1
68709,4,3,240686,240686,240689,0,3,3
68710,3,2,240689,240689,240691,0,2,0
68711,3,2,240692,240692,240694,0,2,1
68712,1,3,240693,240694,240697,1,4,0
68713,5,3,240698,240698,240701,0,3,1
68714,1,2,240699,240701,240703,2,4,0
68715,4,3,240703,240703,240706,0,3,0
68716,6,2,240709,240709,240711,0,2,3
68717,5,1,240714,240714,240715,0,1,3
68718,5,2,240719,240719,240721,0,2,4
68719,3,2,240722,240722,240724,0,2,1
68720,2,1,240724,240724,240725,0,1,0
68721,5,2,240729,240729,240731,0,2,4
68722,3,3,240732,240732,240735,0,3,1
68723,5,1,240737,240737,240738,0,1,2
68724,3,3,240740,240740,240743,0,3,2
68725,2,1,240742,240743,240744,1,2,0
68726,2,3,240744,240744,240747,0,3,0
68727,4,1,240748,240748,240749,0,1,1
68728,5,2,240753,240753,240755,0,2,4
68729,1,3,240754,240755,240758,1,4,0
68730,5,2,240759,240759,240761,0,2,1
68731,5,1,240764,240764,240765,0,1,3
68732,2,3,240766,240766,240769,0,3,1
68733,5,1,240771,240771,240772,0,1,2
68734,5,1,240776,240776,240777,0,1,4
68735,6,1,240782,240782,240783,0,1,5
68736,6,3,240788,240788,240791,0,3,5
68737,1,3,240789,240791,240794,2,5,0
68738,6,1,240795,240795,240796,0,1,1
68739,1,3,240796,240796,240799,0,3,0
68740,5,2,240801,240801,240803,0,2,2
68741,4,2,240805,240805,240807,0,2,2
68742,3,1,240808,240808,240809,0,1,1
68743,1,3,240809,240809,240812,0,3,0
68744,6,3,240815,240815,240818,0,3,3
68745,2,1,240817,240818,240819,1,2,0
68746,6,2,240823,240823,240825,0,2,4
68747,4,2,240827,240827,240829,0,2,2
68748,3,2,240830,240830,240832,0,2,1
68749,5,1,240835,240835,240836,0,1,3
68750,5,3,240840,240840,240843,0,3,4
68751,5,2,240845,240845,240847,0,2,2
68752,2,1,240847,240847,240848,0,1,0
68753,2,1,240849,240849,240850,0,1,1
68754,5,3,240854,240854,240857,0,3,4
68755,5,2,240859,240859,240861,0,2,2
68756,5,1,240864,240864,240865,0,1,3
68757,1,3,240865,240865,240868,0,3,0
68758,4,2,240869,240869,240871,0,2,1
68759,3,3,240872,240872,240875,0,3,1
68760,6,3,240878,240878,240881,0,3,3
68761,2,2,240880,240881,240883,1,3,0
68762,5,3,240885,240885,240888,0,3,2
68763,2,1,240887,240888,240889,1,2,0
68764,3,1,240890,240890,240891,0,1,1
68765,3,1,240893,240893,240894,0,1,2
68766,5,3,240898,240898,240901,0,3,4
68767,3,2,240901,240901,240903,0,2,0
68768,5,2,240906,240906,240908,0,2,3
68769,3,3,240909,240909,240912,0,3,1
68770,2,3,240911,240912,240915,1,4,0
68771,6,2,240917,240917,240919,0,2,2
68772,5,1,240922,240922,240923,0,1,3
68773,1,2,240923,240923,240925,0,2,0
68774,2,2,240925,240925,240927,0,2,0
68775,2,1,240927,240927,240928,0,1,0
68776,3,3,240930,240930,240933,0,3,2
68777,3,2,240933,240933,240935,0,2,0
68778,3,1,240936,240936,240937,0,1,1
68779,5,3,240941,240941,240944,0,3,4
68780,6,3,240947,240947,240950,0,3,3
68781,2,3,240949,240950,240953,1,4,0
68782,6,2,240955,240955,240957,0,2,2
68783,5,2,240960,240960,240962,0,2,3
68784,4,1,240964,240964,240965,0,1,2
68785,1,3,240965,240965,240968,0,3,0
68786,4,2,240969,240969,240971,0,2,1
68787,5,3,240974,240974,240977,0,3,3
68788,6,2,240980,240980,240982,0,2,3
68789,1,2,240981,240982,240984,1,3,0
68790,2,3,240983,240984,240987,1,4,0
68791,3,3,240986,240987,240990,1,4,0
68792,1,3,240987,240990,240993,3,6,0
68793,1,1,240988,240993,240994,5,6,0
68794,4,3,240992,240994,240997,2,5,0
68795,4,3,240996,240997,241000,1,4,0
68796,1,3,240997,241000,241003,3,6,0
68797,3,1,241000,241003,241004,3,4,0
68798,4,2,241004,241004,241006,0,2,0
68799,5,2,241009,241009,241011,0,2,3
68800,4,2,241013,241013,241015,0,2,2
68801,4,2,241017,241017,241019,0,2,2
68802,3,2,241020,241020,241022,0,2,1
68803,1,2,241021,241022,241024,1,3,0
68804,6,2,241027,241027,241029,0,2,3
68805,6,2,241033,241033,241035,0,2,4
68806,3,3,241036,241036,241039,0,3,1
68807,3,1,241039,241039,241040,0,1,0
68808,1,2,241040,241040,241042,0,2,0
68809,6,1,241046,241046,241047,0,1,4
68810,3,2,241049,241049,241051,0,2,2
68811,5,1,241054,241054,241055,0,1,3
68812,3,3,241057,241057,241060,0,3,2
68813,5,2,241062,241062,241064,0,2,2
68814,5,2,241067,241067,241069,0,2,3
68815,6,1,241073,241073,241074,0,1,4
68816,3,2,241076,241076,241078,0,2,2
68817,5,1,241081,241081,241082,0,1,3
68818,5,3,241086,241086,241089,0,3,4
68819,1,3,241087,241089,241092,2,5,0
68820,1,2,241088,241092,241094,4,6,0
68821,3,2,241091,241094,241096,3,5,0
68822,5,3,241096,241096,241099,0,3,0
68823,6,2,241102,241102,241104,0,2,3
68824,5,3,241107,241107,241110,0,3,3
68825,2,2,241109,241110,241112,1,3,0
68826,2,2,241111,241112,241114,1,3,0
68827,4,2,241115,241115,241117,0,2,1
68828,2,3,241117,241117,241120,0,3,0
68829,4,2,241121,241121,241123,0,2,1
68830,1,1,241122,241123,241124,1,2,0
68831,5,2,241127,241127,241129,0,2,3
68832,1,3,241128,241129,241132,1,4,0
68833,4,1,241132,241132,241133,0,1,0
68834,3,2,241135,241135,241137,0,2,2
68835,6,3,241141,241141,241144,0,3,4
68836,1,2,241142,241144,241146,2,4,0
68837,6,2,241148,241148,241150,0,2,2
68838,6,1,241154,241154,241155,0,1,4
68839,2,2,241156,241156,241158,0,2,1
68840,1,2,241157,241158,241160,1,3,0
68841,2,1,241159,241160,241161,1,2,0
68842,6,2,241165,241165,241167,0,2,4
68843,4,1,241169,241169,241170,0,1,2
68844,1,1,241170,241170,241171,0,1,0
68845,4,2,241174,241174,241176,0,2,3
68846,3,3,241177,241177,241180,0,3,1
68847,5,3,241182,241182,241185,0,3,2
68848,5,3,241187,241187,241190,0,3,2
68849,1,2,241188,241190,241192,2,4,0
68850,5,3,241193,241193,241196,0,3,1
68851,2,1,241195,241196,241197,1,2,0
68852,4,1,241199,241199,241200,0,1,2
68853,2,1,241201,241201,241202,0,1,1
68854,2,3,241203,241203,241206,0,3,1
68855,1,2,241204,241206,241208,2,4,0
68856,4,1,241208,241208,241209,0,1,0
68857,2,1,241210,241210,241211,0,1,1
68858,4,2,241214,241214,241216,0,2,3
68859,6,1,241220,241220,241221,0,1,4
68860,2,3,241222,241222,241225,0,3,1
68861,5,2,241227,241227,241229,0,2,2
68862,5,2,241232,241232,241234,0,2,3
68863,3,1,241235,241235,241236,0,1,1
68864,1,1,241236,241236,241237,0,1,0
68865,5,3,241241,241241,241244,0,3,4
68866,3,2,241244,241244,241246,0,2,0
68867,5,1,241249,241249,241250,0,1,3
68868,3,3,241252,241252,241255,0,3,2
68869,5,1,241257,241257,241258,0,1,2
68870,6,1,241263,241263,241264,0,1,5
68871,4,1,241267,241267,241268,0,1,3
68872,6,1,241273,241273,241274,0,1,5
68873,4,1,241277,241277,241278,0,1,3
68874,5,2,241282,241282,241284,0,2,4
68875,2,1,241284,241284,241285,0,1,0
68876,1,3,241285,241285,241288,0,3,0
68877,1,2,241286,241288,241290,2,4,0
68878,6,1,241292,241292,241293,0,1,2
68879,6,3,241298,241298,241301,0,3,5
68880,1,1,241299,241301,241302,2,3,0
68881,2,1,241301,241302,241303,1,2,0
68882,1,3,241302,241303,241306,1,4,0
68883,3,3,241305,241306,241309,1,4,0
68884,6,3,241311,241311,241314,0,3,2
68885,5,1,241316,241316,241317,0,1,2
68886,4,2,241320,241320,241322,0,2,3
68887,6,3,241326,241326,241329,0,3,4
68888,3,1,241329,241329,241330,0,1,0
68889,3,3,241332,241332,241335,0,3,2
68890,1,3,241333,241335,241338,2,5,0
68891,6,2,241339,241339,241341,0,2,1
68892,6,3,241345,241345,241348,0,3,4
68893,2,1,241347,241348,241349,1,2,0
68894,6,2,241353,241353,241355,0,2,4
68895,6,1,241359,241359,241360,0,1,4
68896,3,1,241362,241362,241363,0,1,2
68897,5,3,241367,241367,241370,0,3,4
68898,6,3,241373,241373,241376,0,3,3
68899,1,3,241374,241376,241379,2,5,0
68900,6,1,241380,241380,241381,0,1,1
68901,1,1,241381,241381,241382,0,1,0
68902,3,3,241384,241384,241387,0,3,2
68903,1,2,241385,241387,241389,2,4,0
68904,5,1,241390,241390,241391,0,1,1
68905,6,2,241396,241396,241398,0,2,5
68906,3,3,241399,241399,241402,0,3,1
68907,2,2,241401,241402,241404,1,3,0
68908,6,1,241407,241407,241408,0,1,3
68909,1,3,241408,241408,241411,0,3,0
68910,3,1,241411,241411,241412,0,1,0
68911,5,3,241416,241416,241419,0,3,4
68912,1,3,241417,241419,241422,2,5,0
68913,6,2,241423,241423,241425,0,2,1
68914,2,3,241425,241425,241428,0,3,0
68915,5,3,241430,241430,241433,0,3,2
68916,2,1,241432,241433,241434,1,2,0
68917,3,3,241435,241435,241438,0,3,1
68918,5,3,241440,241440,241443,0,3,2
68919,5,1,241445,241445,241446,0,1,2
68920,6,3,241451,241451,241454,0,3,5
68921,2,3,241453,241454,241457,1,4,0
68922,3,2,241456,241457,241459,1,3,0
68923,3,3,241459,241459,241462,0,3,0
68924,2,1,241461,241462,241463,1,2,0
68925,5,1,241466,241466,241467,0,1,3
68926,4,3,241470,241470,241473,0,3,3
68927,1,2,241471,241473,241475,2,4,0
68928,1,2,241472,241475,241477,3,5,0
68929,2,3,241474,241477,241480,3,6,0
68930,2,1,241476,241480,241481,4,5,0
68931,5,2,241481,241481,241483,0,2,0
68932,5,3,241486,241486,241489,0,3,3
68933,2,1,241488,241489,241490,1,2,0
68934,6,1,241494,241494,241495,0,1,4
68935,2,3,241496,241496,241499,0,3,1
68936,1,3,241497,241499,241502,2,5,0
68937,6,1,241503,241503,241504,0,1,1
68938,6,1,241509,241509,241510,0,1,5
68939,4,2,241513,241513,241515,0,2,3
68940,1,3,241514,241515,241518,1,4,0
68941,2,1,241516,241518,241519,2,3,0
68942,5,1,241521,241521,241522,0,1,2
68943,6,1,241527,241527,241528,0,1,5
68944,1,3,241528,241528,241531,0,3,0
68945,3,1,241531,241531,241532,0,1,0
68946,2,1,241533,241533,241534,0,1,1
68947,4,1,241537,241537,241538,0,1,3
68948,5,3,241542,241542,241545,0,3,4
68949,2,3,241544,241545,241548,1,4,0
68950,3,2,241547,241548,241550,1,3,0
68951,2,3,241549,241550,241553,1,4,0
68952,1,1,241550,241553,241554,3,4,0
68953,5,1,241555,241555,241556,0,1,1
68954,4,3,241559,241559,241562,0,3,3
68955,1,3,241560,241562,241565,2,5,0
68956,5,2,241565,241565,241567,0,2,0
68957,5,1,241570,241570,241571,0,1,3
68958,6,2,241576,241576,241578,0,2,5
68959,6,1,241582,241582,241583,0,1,4
68960,6,1,241588,241588,241589,0,1,5
68961,3,1,241591,241591,241592,0,1,2
68962,3,2,241594,241594,241596,0,2,2
68963,3,2,241597,241597,241599,0,2,1
68964,3,2,241600,241600,241602,0,2,1
68965,3,2,241603,241603,241605,0,2,1
68966,4,3,241607,241607,241610,0,3,2
68967,1,1,241608,241610,241611,2,3,0
68968,2,1,241610,241611,241612,1,2,0
68969,2,2,241612,241612,241614,0,2,0
68970,2,2,241614,241614,241616,0,2,0
68971,1,3,241615,241616,241619,1,4,0
68972,4,1,241619,241619,241620,0,1,0
68973,2,1,241621,241621,241622,0,1,1
68974,5,3,241626,241626,241629,0,3,4
68975,5,1,241631,241631,241632,0,1,2
68976,2,3,241633,241633,241636,0,3,1
68977,1,2,241634,241636,241638,2,4,0
68978,1,1,241635,241638,241639,3,4,0
68979,3,2,241638,241639,241641,1,3,0
68980,2,2,241640,241641,241643,1,3,0
68981,4,2,241644,241644,241646,0,2,1
68982,2,1,241646,241646,241647,0,1,0
68983,5,3,241651,241651,241654,0,3,4
68984,6,3,241657,241657,241660,0,3,3
68985,6,1,241663,241663,241664,0,1,3
68986,5,1,241668,241668,241669,0,1,4
68987,4,1,241672,241672,241673,0,1,3
68988,4,2,241676,241676,241678,0,2,3
68989,2,1,241678,241678,241679,0,1,0
68990,2,1,241680,241680,241681,0,1,1
68991,4,3,241684,241684,241687,0,3,3
68992,4,1,241688,241688,241689,0,1,1
68993,2,3,241690,241690,241693,0,3,1
68994,5,3,241695,241695,241698,0,3,2
68995,4,3,241699,241699,241702,0,3,1
68996,2,2,241701,241702,241704,1,3,0
68997,4,1,241705,241705,241706,0,1,1
68998,6,3,241711,241711,241714,0,3,5
68999,1,1,241712,241714,241715,2,3,0
69000,1,3,241713,241715,241718,2,5,0
69001,3,3,241716,241718,241721,2,5,0
69002,6,3,241722,241722,241725,0,3,1
69003,2,3,241724,241725,241728,1,4,0
69004,3,2,241727,241728,241730,1,3,0
69005,5,1,241732,241732,241733,0,1,2
69006,3,1,241735,241735,241736,0,1,2
69007,1,2,241736,241736,241738,0,2,0
69008,6,2,241742,241742,241744,0,2,4
69009,6,2,241748,241748,241750,0,2,4
69010,5,1,241753,241753,241754,0,1,3
69011,3,2,241756,241756,241758,0,2,2
69012,6,1,241762,241762,241763,0,1,4
69013,6,2,241768,241768,241770,0,2,5
69014,5,1,241773,241773,241774,0,1,3
69015,6,1,241779,241779,241780,0,1,5
69016,3,3,241782,241782,241785,0,3,2
69017,1,1,241783,241785,241786,2,3,0
69018,4,2,241787,241787,241789,0,2,1
69019,4,3,241791,241791,241794,0,3,2
69020,4,2,241795,241795,241797,0,2,1
69021,5,1,241800,241800,241801,0,1,3
69022,6,1,241806,241806,241807,0,1,5
69023,5,3,241811,241811,241814,0,3,4
69024,1,2,241812,241814,241816,2,4,0
69025,5,3,241817,241817,241820,0,3,1
69026,6,1,241823,241823,241824,0,1,3
69027,3,3,241826,241826,241829,0,3,2
69028,4,1,241830,241830,241831,0,1,1
69029,3,2,241833,241833,241835,0,2,2
69030,5,1,241838,241838,241839,0,1,3
69031,5,3,241843,241843,241846,0,3,4
69032,4,1,241847,241847,241848,0,1,1
69033,3,3,241850,241850,241853,0,3,2
69034,2,3,241852,241853,241856,1,4,0
69035,4,1,241856,241856,241857,0,1,0
69036,3,2,241859,241859,241861,0,2,2
69037,1,3,241860,241861,241864,1,4,0
69038,2,2,241862,241864,241866,2,4,0
69039,1,3,241863,241866,241869,3,6,0
69040,2,1,241865,241869,241870,4,5,0
69041,5,3,241870,241870,241873,0,3,0
69042,6,1,241876,241876,241877,0,1,3
69043,5,3,241881,241881,241884,0,3,4
69044,5,2,241886,241886,241888,0,2,2
69045,4,2,241890,241890,241892,0,2,2
69046,3,3,241893,241893,241896,0,3,1
69047,5,2,241898,241898,241900,0,2,2
69048,3,1,241901,241901,241902,0,1,1
69049,6,2,241907,241907,241909,0,2,5
69050,5,3,241912,241912,241915,0,3,3
69051,5,2,241917,241917,241919,0,2,2
69052,4,2,241921,241921,241923,0,2,2
69053,3,3,241924,241924,241927,0,3,1
69054,2,2,241926,241927,241929,1,3,0
69055,3,3,241929,241929,241932,0,3,0
69056,3,2,241932,241932,241934,0,2,0
69057,6,2,241938,241938,241940,0,2,4
69058,5,3,241943,241943,241946,0,3,3
69059,2,1,241945,241946,241947,1,2,0
69060,3,2,241948,241948,241950,0,2,1
69061,1,3,241949,241950,241953,1,4,0
69062,5,2,241954,241954,241956,0,2,1
69063,2,3,241956,241956,241959,0,3,0
69064,4,3,241960,241960,241963,0,3,1
69065,5,3,241965,241965,241968,0,3,2
69066,1,2,241966,241968,241970,2,4,0
69067,5,2,241971,241971,241973,0,2,1
69068,2,3,241973,241973,241976,0,3,0
69069,6,3,241979,241979,241982,0,3,3
69070,5,3,241984,241984,241987,0,3,2
69071,3,3,241987,241987,241990,0,3,0
69072,2,1,241989,241990,241991,1,2,0
69073,1,1,241990,241991,241992,1,2,0
69074,1,3,241991,241992,241995,1,4,0
69075,2,3,241993,241995,241998,2,5,0
69076,3,3,241996,241998,242001,2,5,0
69077,5,2,242001,242001,242003,0,2,0
69078,5,2,242006,242006,242008,0,2,3
69079,6,2,242012,242012,242014,0,2,4
69080,1,3,242013,242014,242017,1,4,0
69081,1,3,242014,242017,242020,3,6,0
69082,4,3,242018,242020,242023,2,5,0
69083,2,2,242020,242023,242025,3,5,0
69084,4,3,242024,242025,242028,1,4,0
69085,1,3,242025,242028,242031,3,6,0
69086,6,3,242031,242031,242034,0,3,0
69087,1,1,242032,242034,242035,2,3,0
69088,5,1,242037,242037,242038,0,1,2
69089,4,3,242041,242041,242044,0,3,3
69090,1,3,242042,242044,242047,2,5,0
69091,2,2,242044,242047,242049,3,5,0
69092,6,3,242050,242050,242053,0,3,1
69093,5,3,242055,242055,242058,0,3,2
69094,3,3,242058,242058,242061,0,3,0
69095,5,1,242063,242063,242064,0,1,2
69096,2,1,242065,242065,242066,0,1,1
69097,2,2,242067,242067,242069,0,2,1
69098,2,3,242069,242069,242072,0,3,0
69099,2,2,242071,242072,242074,1,3,0
69100,2,2,242073,242074,242076,1,3,0
69101,1,1,242074,242076,242077,2,3,0
69102,4,3,242078,242078,242081,0,3,1
69103,4,3,242082,242082,242085,0,3,1
69104,5,2,242087,242087,242089,0,2,2
69105,4,1,242091,242091,242092,0,1,2
69106,5,1,242096,242096,242097,0,1,4
69107,3,1,242099,242099,242100,0,1,2
69108,2,2,242101,242101,242103,0,2,1
69109,2,3,242103,242103,242106,0,3,0
69110,1,3,242104,242106,242109,2,5,0
69111,6,1,242110,242110,242111,0,1,1
69112,5,2,242115,242115,242117,0,2,4
69113,1,1,242116,242117,242118,1,2,0
69114,1,1,242117,242118,242119,1,2,0
69115,1,3,242118,242119,242122,1,4,0
69116,2,3,242120,242122,242125,2,5,0
69117,4,2,242124,242125,242127,1,3,0
69118,5,1,242129,242129,242130,0,1,2
69119,1,3,242130,242130,242133,0,3,0
69120,4,2,242134,242134,242136,0,2,1
69121,5,1,242139,242139,242140,0,1,3
69122,3,3,242142,242142,242145,0,3,2
69123,6,2,242148,242148,242150,0,2,3
69124,2,2,242150,242150,242152,0,2,0
69125,4,2,242154,242154,242156,0,2,2
69126,6,1,242160,242160,242161,0,1,4
69127,4,3,242164,242164,242167,0,3,3
69128,5,2,242169,242169,242171,0,2,2
69129,3,3,242172,242172,242175,0,3,1
69130,3,1,242175,242175,242176,0,1,0
69131,6,3,242181,242181,242184,0,3,5
69132,4,3,242185,242185,242188,0,3,1
69133,6,1,242191,242191,242192,0,1,3
69134,4,3,242195,242195,242198,0,3,3
69135,6,2,242201,242201,242203,0,2,3
69136,2,3,242203,242203,242206,0,3,0
69137,3,1,242206,242206,242207,0,1,0
69138,5,2,242211,242211,242213,0,2,4
69139,6,3,242217,242217,242220,0,3,4
69140,4,1,242221,242221,242222,0,1,1
69141,5,2,242226,242226,242228,0,2,4
69142,4,3,242230,242230,242233,0,3,2
69143,4,3,242234,242234,242237,0,3,1
69144,6,1,242240,242240,242241,0,1,3
69145,3,2,242243,242243,242245,0,2,2
69146,3,1,242246,242246,242247,0,1,1
69147,2,3,242248,242248,242251,0,3,1
69148,5,1,242253,242253,242254,0,1,2
69149,6,3,242259,242259,242262,0,3,5
69150,6,3,242265,242265,242268,0,3,3
69151,2,1,242267,242268,242269,1,2,0
69152,3,2,242270,242270,242272,0,2,1
69153,1,3,242271,242272,242275,1,4,0
69154,5,3,242276,242276,242279,0,3,1
69155,3,3,242279,242279,242282,0,3,0
69156,6,1,242285,242285,242286,0,1,3
69157,1,3,242286,242286,242289,0,3,0
69158,4,1,242290,242290,242291,0,1,1
69159,5,2,242295,242295,242297,0,2,4
69160,1,1,242296,242297,242298,1,2,0
69161,6,1,242302,242302,242303,0,1,4
69162,1,1,242303,242303,242304,0,1,0
69163,5,1,242308,242308,242309,0,1,4
69164,3,2,242311,242311,242313,0,2,2
69165,4,2,242315,242315,242317,0,2,2
69166,3,3,242318,242318,242321,0,3,1
69167,5,3,242323,242323,242326,0,3,2
69168,5,1,242328,242328,242329,0,1,2
69169,3,2,242331,242331,242333,0,2,2
69170,1,2,242332,242333,242335,1,3,0
69171,5,1,242337,242337,242338,0,1,2
69172,5,1,242342,242342,242343,0,1,4
69173,1,1,242343,242343,242344,0,1,0
69174,2,2,242345,242345,242347,0,2,1
69175,5,3,242350,242350,242353,0,3,3
69176,4,3,242354,242354,242357,0,3,1
69177,4,2,242358,242358,242360,0,2,1
69178,2,3,242360,242360,242363,0,3,0
69179,6,3,242366,242366,242369,0,3,3
69180,4,2,242370,242370,242372,0,2,1
69181,6,3,242376,242376,242379,0,3,4
69182,3,1,242379,242379,242380,0,1,0
69183,5,1,242384,242384,242385,0,1,4
69184,6,2,242390,242390,242392,0,2,5
69185,3,1,242393,242393,242394,0,1,1
69186,4,2,242397,242397,242399,0,2,3
69187,4,1,242401,242401,242402,0,1,2
69188,1,1,242402,242402,242403,0,1,0
69189,2,2,242404,242404,242406,0,2,1
69190,4,3,242408,242408,242411,0,3,2
69191,1,3,242409,242411,242414,2,5,0
69192,2,1,242411,242414,242415,3,4,0
69193,4,2,242415,242415,242417,0,2,0
69194,2,3,242417,242417,242420,0,3,0
69195,2,2,242419,242420,242422,1,3,0
69196,2,3,242421,242422,242425,1,4,0
69197,6,1,242427,242427,242428,0,1,2
69198,6,1,242433,242433,242434,0,1,5
69199,6,1,242439,242439,242440,0,1,5
69200,1,3,242440,242440,242443,0,3,0
69201,6,2,242446,242446,242448,0,2,3
69202,2,2,242448,242448,242450,0,2,0
69203,6,3,242454,242454,242457,0,3,4
69204,4,1,242458,242458,242459,0,1,1
69205,5,1,242463,242463,242464,0,1,4
69206,6,2,242469,242469,242471,0,2,5
69207,5,3,242474,242474,242477,0,3,3
69208,5,2,242479,242479,242481,0,2,2
69209,5,3,242484,242484,242487,0,3,3
69210,6,1,242490,242490,242491,0,1,3
69211,6,2,242496,242496,242498,0,2,5
69212,3,3,242499,242499,242502,0,3,1
69213,6,1,242505,242505,242506,0,1,3
69214,2,2,242507,242507,242509,0,2,1
69215,2,3,242509,242509,242512,0,3,0
69216,6,1,242515,242515,242516,0,1,3
69217,4,2,242519,242519,242521,0,2,3
69218,6,2,242525,242525,242527,0,2,4
69219,2,3,242527,242527,242530,0,3,0
69220,4,1,242531,242531,242532,0,1,1
69221,6,1,242537,242537,242538,0,1,5
69222,5,3,242542,242542,242545,0,3,4
69223,4,1,242546,242546,242547,0,1,1
69224,6,2,242552,242552,242554,0,2,5
69225,6,3,242558,242558,242561,0,3,4
69226,3,3,242561,242561,242564,0,3,0
69227,1,1,242562,242564,242565,2,3,0
69228,1,1,242563,242565,242566,2,3,0
69229,3,3,242566,242566,242569,0,3,0
69230,4,1,242570,242570,242571,0,1,1
69231,2,3,242572,242572,242575,0,3,1
69232,5,3,242577,242577,242580,0,3,2
69233,6,3,242583,242583,242586,0,3,3
69234,2,1,242585,242586,242587,1,2,0
69235,4,1,242589,242589,242590,0,1,2
69236,1,1,242590,242590,242591,0,1,0
69237,4,3,242594,242594,242597,0,3,3
69238,3,1,242597,242597,242598,0,1,0
69239,4,1,242601,242601,242602,0,1,3
69240,5,3,242606,242606,242609,0,3,4
69241,5,2,242611,242611,242613,0,2,2
69242,1,2,242612,242613,242615,1,3,0
69243,5,1,242617,242617,242618,0,1,2
69244,5,2,242622,242622,242624,0,2,4
69245,2,3,242624,242624,242627,0,3,0
69246,5,2,242629,242629,242631,0,2,2
69247,4,1,242633,242633,242634,0,1,2
69248,5,1,242638,242638,242639,0,1,4
69249,4,2,242642,242642,242644,0,2,3
69250,5,1,242647,242647,242648,0,1,3
69251,1,1,242648,242648,242649,0,1,0
69252,4,3,242652,242652,242655,0,3,3
69253,6,3,242658,242658,242661,0,3,3
69254,6,3,242664,242664,242667,0,3,3
69255,4,2,242668,242668,242670,0,2,1
69256,2,3,242670,242670,242673,0,3,0
69257,1,3,242671,242673,242676,2,5,0
69258,3,2,242674,242676,242678,2,4,0
69259,5,3,242679,242679,242682,0,3,1
69260,3,3,242682,242682,242685,0,3,0
69261,5,3,242687,242687,242690,0,3,2
69262,2,1,242689,242690,242691,1,2,0
69263,4,2,242693,242693,242695,0,2,2
69264,4,3,242697,242697,242700,0,3,2
69265,1,3,242698,242700,242703,2,5,0
69266,1,3,242699,242703,242706,4,7,0
69267,3,2,242702,242706,242708,4,6,0
69268,1,1,242703,242708,242709,5,6,0
69269,4,2,242707,242709,242711,2,4,0
69270,5,2,242712,242712,242714,0,2,1
69271,2,1,242714,242714,242715,0,1,0
69272,2,1,242716,242716,242717,0,1,1
69273,4,2,242720,242720,242722,0,2,3
69274,1,1,242721,242722,242723,1,2,0
69275,4,1,242725,242725,242726,0,1,2
69276,5,3,242730,242730,242733,0,3,4
69277,4,3,242734,242734,242737,0,3,1
69278,6,1,242740,242740,242741,0,1,3
69279,4,1,242744,242744,242745,0,1,3
69280,1,1,242745,242745,242746,0,1,0
69281,6,3,242751,242751,242754,0,3,5
69282,3,3,242754,242754,242757,0,3,0
69283,1,3,242755,242757,242760,2,5,0
69284,4,2,242759,242760,242762,1,3,0
69285,4,2,242763,242763,242765,0,2,1
69286,6,2,242769,242769,242771,0,2,4
69287,1,2,242770,242771,242773,1,3,0
69288,6,3,242776,242776,242779,0,3,3
69289,5,2,242781,242781,242783,0,2,2
69290,5,2,242786,242786,242788,0,2,3
69291,1,2,242787,242788,242790,1,3,0
69292,5,2,242792,242792,242794,0,2,2
69293,2,3,242794,242794,242797,0,3,0
69294,2,3,242796,242797,242800,1,4,0
69295,1,2,242797,242800,242802,3,5,0
69296,5,3,242802,242802,242805,0,3,0
69297,5,3,242807,242807,242810,0,3,2
69298,6,1,242813,242813,242814,0,1,3
69299,3,2,242816,242816,242818,0,2,2
69300,5,1,242821,242821,242822,0,1,3
69301,4,3,242825,242825,242828,0,3,3
69302,4,3,242829,242829,242832,0,3,1
69303,2,3,242831,242832,242835,1,4,0
69304,4,1,242835,242835,242836,0,1,0
69305,2,2,242837,242837,242839,0,2,1
69306,4,2,242841,242841,242843,0,2,2
69307,2,3,242843,242843,242846,0,3,0
69308,4,3,242847,242847,242850,0,3,1
69309,1,2,242848,242850,242852,2,4,0
69310,2,3,242850,242852,242855,2,5,0
69311,5,3,242855,242855,242858,0,3,0
69312,6,2,242861,242861,242863,0,2,3
69313,5,3,242866,242866,242869,0,3,3
69314,2,1,242868,242869,242870,1,2,0
69315,4,2,242872,242872,242874,0,2,2
69316,2,3,242874,242874,242877,0,3,0
69317,2,3,242876,242877,242880,1,4,0
69318,3,2,242879,242880,242882,1,3,0
69319,1,1,242880,242882,242883,2,3,0
69320,5,3,242885,242885,242888,0,3,2
69321,6,3,242891,242891,242894,0,3,3
69322,2,1,242893,242894,242895,1,2,0
69323,2,3,242895,242895,242898,0,3,0
69324,4,2,242899,242899,242901,0,2,1
69325,3,3,242902,242902,242905,0,3,1
69326,2,3,242904,242905,242908,1,4,0
69327,3,1,242907,242908,242909,1,2,0
69328,2,1,242909,242909,242910,0,1,0
69329,2,3,242911,242911,242914,0,3,1
69330,6,3,242917,242917,242920,0,3,3
69331,5,3,242922,242922,242925,0,3,2
69332,1,3,242923,242925,242928,2,5,0
69333,4,3,242927,242928,242931,1,4,0
69334,3,2,242930,242931,242933,1,3,0
69335,5,2,242935,242935,242937,0,2,2
69336,2,2,242937,242937,242939,0,2,0
69337,3,1,242940,242940,242941,0,1,1
69338,3,1,242943,242943,242944,0,1,2
69339,1,1,242944,242944,242945,0,1,0
69340,5,3,242949,242949,242952,0,3,4
69341,3,2,242952,242952,242954,0,2,0
69342,3,1,242955,242955,242956,0,1,1
69343,3,1,242958,242958,242959,0,1,2
69344,2,2,242960,242960,242962,0,2,1
69345,2,1,242962,242962,242963,0,1,0
69346,6,1,242968,242968,242969,0,1,5
69347,2,3,242970,242970,242973,0,3,1
69348,4,3,242974,242974,242977,0,3,1
69349,4,1,242978,242978,242979,0,1,1
69350,1,1,242979,242979,242980,0,1,0
69351,3,2,242982,242982,242984,0,2,2
69352,5,3,242987,242987,242990,0,3,3
69353,5,3,242992,242992,242995,0,3,2
69354,2,1,242994,242995,242996,1,2,0
69355,3,2,242997,242997,242999,0,2,1
69356,4,3,243001,243001,243004,0,3,2
69357,1,2,243002,243004,243006,2,4,0
69358,5,3,243007,243007,243010,0,3,1
69359,5,1,243012,243012,243013,0,1,2
69360,2,2,243014,243014,243016,0,2,1
69361,2,3,243016,243016,243019,0,3,0
69362,5,2,243021,243021,243023,0,2,2
69363,4,3,243025,243025,243028,0,3,2
69364,1,3,243026,243028,243031,2,5,0
69365,2,3,243028,243031,243034,3,6,0
69366,3,1,243031,243034,243035,3,4,0
69367,3,3,243034,243035,243038,1,4,0
69368,3,2,243037,243038,243040,1,3,0
69369,2,2,243039,243040,243042,1,3,0
69370,2,3,243041,243042,243045,1,4,0
69371,3,3,243044,243045,243048,1,4,0
69372,2,1,243046,243048,243049,2,3,0
69373,5,2,243051,243051,243053,0,2,2
69374,2,1,243053,243053,243054,0,1,0
69375,2,3,243055,243055,243058,0,3,1
69376,4,3,243059,243059,243062,0,3,1
69377,1,1,243060,243062,243063,2,3,0
69378,3,3,243063,243063,243066,0,3,0
69379,4,3,243067,243067,243070,0,3,1
69380,1,2,243068,243070,243072,2,4,0
69381,6,3,243074,243074,243077,0,3,2
69382,5,2,243079,243079,243081,0,2,2
69383,4,2,243083,243083,243085,0,2,2
69384,4,1,243087,243087,243088,0,1,2
69385,1,2,243088,243088,243090,0,2,0
69386,1,1,243089,243090,243091,1,2,0
69387,5,1,243094,243094,243095,0,1,3
69388,6,2,243100,243100,243102,0,2,5
69389,4,2,243104,243104,243106,0,2,2
69390,6,3,243110,243110,243113,0,3,4
69391,2,3,243112,243113,243116,1,4,0
69392,1,2,243113,243116,243118,3,5,0
69393,6,1,243119,243119,243120,0,1,1
69394,3,3,243122,243122,243125,0,3,2
69395,2,3,243124,243125,243128,1,4,0
69396,4,1,243128,243128,243129,0,1,0
69397,1,3,243129,243129,243132,0,3,0
69398,3,1,243132,243132,243133,0,1,0
69399,1,3,243133,243133,243136,0,3,0
69400,6,3,243139,243139,243142,0,3,3
69401,3,2,243142,243142,243144,0,2,0
69402,1,3,243143,243144,243147,1,4,0
69403,6,2,243149,243149,243151,0,2,2
69404,3,2,243152,243152,243154,0,2,1
69405,6,1,243158,243158,243159,0,1,4
69406,4,1,243162,243162,243163,0,1,3
69407,5,2,243167,243167,243169,0,2,4
69408,2,1,243169,243169,243170,0,1,0
69409,4,2,243173,243173,243175,0,2,3
69410,3,2,243176,243176,243178,0,2,1
69411,1,3,243177,243178,243181,1,4,0
69412,3,1,243180,243181,243182,1,2,0
69413,3,1,243183,243183,243184,0,1,1
69414,1,1,243184,243184,243185,0,1,0
69415,2,2,243186,243186,243188,0,2,1
69416,1,2,243187,243188,243190,1,3,0
69417,3,3,243190,243190,243193,0,3,0
69418,2,2,243192,243193,243195,1,3,0
69419,2,2,243194,243195,243197,1,3,0
69420,4,2,243198,243198,243200,0,2,1
69421,5,3,243203,243203,243206,0,3,3
69422,4,2,243207,243207,243209,0,2,1
69423,6,3,243213,243213,243216,0,3,4
69424,6,2,243219,243219,243221,0,2,3
69425,3,2,243222,243222,243224,0,2,1
69426,6,2,243228,243228,243230,0,2,4
69427,2,3,243230,243230,243233,0,3,0
69428,5,1,243235,243235,243236,0,1,2
69429,1,2,243236,243236,243238,0,2,0
69430,1,1,243237,243238,243239,1,2,0
69431,6,1,243243,243243,243244,0,1,4
69432,6,1,243249,243249,243250,0,1,5
69433,3,2,243252,243252,243254,0,2,2
69434,2,3,243254,243254,243257,0,3,0
69435,4,1,243258,243258,243259,0,1,1
69436,4,3,243262,243262,243265,0,3,3
69437,5,1,243267,243267,243268,0,1,2
69438,3,1,243270,243270,243271,0,1,2
69439,4,2,243274,243274,243276,0,2,3
69440,5,2,243279,243279,243281,0,2,3
69441,1,1,243280,243281,243282,1,2,0
69442,5,3,243285,243285,243288,0,3,3
69443,2,1,243287,243288,243289,1,2,0
69444,4,1,243291,243291,243292,0,1,2
69445,1,1,243292,243292,243293,0,1,0
69446,5,2,243297,243297,243299,0,2,4
69447,1,3,243298,243299,243302,1,4,0
69448,3,3,243301,243302,243305,1,4,0
69449,1,3,243302,243305,243308,3,6,0
69450,1,2,243303,243308,243310,5,7,0
69451,3,2,243306,243310,243312,4,6,0
69452,3,3,243309,243312,243315,3,6,0
69453,4,1,243313,243315,243316,2,3,0
69454,3,1,243316,243316,243317,0,1,0
69455,1,2,243317,243317,243319,0,2,0
69456,5,3,243322,243322,243325,0,3,3
69457,5,2,243327,243327,243329,0,2,2
69458,2,2,243329,243329,243331,0,2,0
69459,4,1,243333,243333,243334,0,1,2
69460,5,2,243338,243338,243340,0,2,4
69461,6,1,243344,243344,243345,0,1,4
69462,2,3,243346,243346,243349,0,3,1
69463,2,2,243348,243349,243351,1,3,0
69464,3,2,243351,243351,243353,0,2,0
69465,6,3,243357,243357,243360,0,3,4
69466,4,1,243361,243361,243362,0,1,1
69467,4,3,243365,243365,243368,0,3,3
69468,6,2,243371,243371,243373,0,2,3
69469,2,1,243373,243373,243374,0,1,0
69470,5,3,243378,243378,243381,0,3,4
69471,3,1,243381,243381,243382,0,1,0
69472,2,1,243383,243383,243384,0,1,1
69473,2,1,243385,243385,243386,0,1,1
69474,6,3,243391,243391,243394,0,3,5
69475,4,1,243395,243395,243396,0,1,1
69476,4,3,243399,243399,243402,0,3,3
69477,1,3,243400,243402,243405,2,5,0
69478,2,3,243402,243405,243408,3,6,0
69479,3,2,243405,243408,243410,3,5,0
69480,2,1,243407,243410,243411,3,4,0
69481,6,3,243413,243413,243416,0,3,2
69482,2,3,243415,243416,243419,1,4,0
69483,6,3,243421,243421,243424,0,3,2
69484,6,2,243427,243427,243429,0,2,3
69485,2,3,243429,243429,243432,0,3,0
69486,6,3,243435,243435,243438,0,3,3
69487,3,3,243438,243438,243441,0,3,0
69488,1,3,243439,243441,243444,2,5,0
69489,3,1,243442,243444,243445,2,3,0
69490,5,3,243447,243447,243450,0,3,2
69491,2,1,243449,243450,243451,1,2,0
69492,1,1,243450,243451,243452,1,2,0
69493,2,1,243452,243452,243453,0,1,0
69494,2,3,243454,243454,243457,0,3,1
69495,6,2,243460,243460,243462,0,2,3
69496,1,1,243461,243462,243463,1,2,0
69497,3,2,243464,243464,243466,0,2,1
69498,5,3,243469,243469,243472,0,3,3
69499,4,3,243473,243473,243476,0,3,1
69500,1,3,243474,243476,243479,2,5,0
69501,2,1,243476,243479,243480,3,4,0
69502,2,3,243478,243480,243483,2,5,0
69503,3,2,243481,243483,243485,2,4,0
69504,3,1,243484,243485,243486,1,2,0
69505,6,1,243490,243490,243491,0,1,4
69506,2,1,243492,243492,243493,0,1,1
69507,2,2,243494,243494,243496,0,2,1
69508,3,3,243497,243497,243500,0,3,1
69509,1,1,243498,243500,243501,2,3,0
69510,3,3,243501,243501,243504,0,3,0
69511,1,2,243502,243504,243506,2,4,0
69512,2,1,243504,243506,243507,2,3,0
69513,3,3,243507,243507,243510,0,3,0
69514,2,1,243509,243510,243511,1,2,0
69515,2,3,243511,243511,243514,0,3,0
69516,4,2,243515,243515,243517,0,2,1
69517,4,3,243519,243519,243522,0,3,2
69518,5,1,243524,243524,243525,0,1,2
69519,5,2,243529,243529,243531,0,2,4
69520,5,1,243534,243534,243535,0,1,3
69521,3,3,243537,243537,243540,0,3,2
69522,5,2,243542,243542,243544,0,2,2
69523,1,1,243543,243544,243545,1,2,0
69524,4,2,243547,243547,243549,0,2,2
69525,3,1,243550,243550,243551,0,1,1
69526,3,2,243553,243553,243555,0,2,2
69527,1,1,243554,243555,243556,1,2,0
69528,5,2,243559,243559,243561,0,2,3
69529,5,1,243564,243564,243565,0,1,3
69530,2,2,243566,243566,243568,0,2,1
69531,6,1,243572,243572,243573,0,1,4
69532,5,1,243577,243577,243578,0,1,4
69533,5,2,243582,243582,243584,0,2,4
69534,1,1,243583,243584,243585,1,2,0
69535,4,2,243587,243587,243589,0,2,2
69536,4,2,243591,243591,243593,0,2,2
69537,6,1,243597,243597,243598,0,1,4
69538,3,2,243600,243600,243602,0,2,2
69539,1,2,243601,243602,243604,1,3,0
69540,1,1,243602,243604,243605,2,3,0
69541,1,2,243603,243605,243607,2,4,0
69542,3,2,243606,243607,243609,1,3,0
69543,2,2,243608,243609,243611,1,3,0
69544,3,1,243611,243611,243612,0,1,0
69545,2,3,243613,243613,243616,0,3,1
69546,3,3,243616,243616,243619,0,3,0
69547,2,1,243618,243619,243620,1,2,0
69548,6,1,243624,243624,243625,0,1,4
69549,3,1,243627,243627,243628,0,1,2
69550,6,1,243633,243633,243634,0,1,5
69551,4,2,243637,243637,243639,0,2,3
69552,4,1,243641,243641,243642,0,1,2
69553,2,1,243643,243643,243644,0,1,1
69554,3,2,243646,243646,243648,0,2,2
69555,1,3,243647,243648,243651,1,4,0
69556,5,2,243652,243652,243654,0,2,1
69557,2,3,243654,243654,243657,0,3,0
69558,1,3,243655,243657,243660,2,5,0
69559,2,2,243657,243660,243662,3,5,0
69560,2,1,243659,243662,243663,3,4,0
69561,4,2,243663,243663,243665,0,2,0
69562,5,2,243668,243668,243670,0,2,3
69563,2,2,243670,243670,243672,0,2,0
69564,3,1,243673,243673,243674,0,1,1
69565,1,1,243674,243674,243675,0,1,0
69566,2,3,243676,243676,243679,0,3,1
69567,5,1,243681,243681,243682,0,1,2
69568,5,1,243686,243686,243687,0,1,4
69569,5,1,243691,243691,243692,0,1,4
69570,5,3,243696,243696,243699,0,3,4
69571,4,1,243700,243700,243701,0,1,1
69572,4,3,243704,243704,243707,0,3,3
69573,5,2,243709,243709,243711,0,2,2
69574,5,3,243714,243714,243717,0,3,3
69575,4,3,243718,243718,243721,0,3,1
69576,3,2,243721,243721,243723,0,2,0
69577,3,3,243724,243724,243727,0,3,1
69578,3,3,243727,243727,243730,0,3,0
69579,1,3,243728,243730,243733,2,5,0
69580,1,1,243729,243733,243734,4,5,0
69581,4,2,243733,243734,243736,1,3,0
69582,2,3,243735,243736,243739,1,4,0
69583,3,3,243738,243739,243742,1,4,0
69584,5,2,243743,243743,243745,0,2,1
69585,6,1,243749,243749,243750,0,1,4
69586,6,2,243755,243755,243757,0,2,5
69587,4,1,243759,243759,243760,0,1,2
69588,6,3,243765,243765,243768,0,3,5
69589,1,3,243766,243768,243771,2,5,0
69590,1,2,243767,243771,243773,4,6,0
69591,2,1,243769,243773,243774,4,5,0
69592,6,1,243775,243775,243776,0,1,1
69593,4,1,243779,243779,243780,0,1,3
69594,5,2,243784,243784,243786,0,2,4
69595,2,2,243786,243786,243788,0,2,0
69596,1,2,243787,243788,243790,1,3,0
69597,2,1,243789,243790,243791,1,2,0
69598,5,3,243794,243794,243797,0,3,3
69599,5,3,243799,243799,243802,0,3,2
69600,1,2,243800,243802,243804,2,4,0
69601,1,1,243801,243804,243805,3,4,0
69602,2,1,243803,243805,243806,2,3,0
69603,1,1,243804,243806,243807,2,3,0
69604,2,3,243806,243807,243810,1,4,0
69605,6,1,243812,243812,243813,0,1,2
69606,6,3,243818,243818,243821,0,3,5
69607,5,3,243823,243823,243826,0,3,2
69608,2,1,243825,243826,243827,1,2,0
69609,2,1,243827,243827,243828,0,1,0
69610,6,1,243833,243833,243834,0,1,5
69611,2,3,243835,243835,243838,0,3,1
69612,4,1,243839,243839,243840,0,1,1
69613,4,2,243843,243843,243845,0,2,3
69614,6,1,243849,243849,243850,0,1,4
69615,4,2,243853,243853,243855,0,2,3
69616,5,3,243858,243858,243861,0,3,3
69617,6,2,243864,243864,243866,0,2,3
69618,6,3,243870,243870,243873,0,3,4
69619,2,3,243872,243873,243876,1,4,0
69620,5,1,243877,243877,243878,0,1,1
69621,1,2,243878,243878,243880,0,2,0
69622,5,2,243883,243883,243885,0,2,3
69623,1,1,243884,243885,243886,1,2,0
69624,6,1,243890,243890,243891,0,1,4
69625,5,1,243895,243895,243896,0,1,4
69626,6,2,243901,243901,243903,0,2,5
69627,6,2,243907,243907,243909,0,2,4
69628,3,2,243910,243910,243912,0,2,1
69629,6,1,243916,243916,243917,0,1,4
69630,6,2,243922,243922,243924,0,2,5
69631,3,2,243925,243925,243927,0,2,1
69632,5,3,243930,243930,243933,0,3,3
69633,5,1,243935,243935,243936,0,1,2
69634,5,2,243940,243940,243942,0,2,4
69635,1,1,243941,243942,243943,1,2,0
69636,6,3,243947,243947,243950,0,3,4
69637,1,1,243948,243950,243951,2,3,0
69638,2,1,243950,243951,243952,1,2,0
69639,6,1,243956,243956,243957,0,1,4
69640,4,3,243960,243960,243963,0,3,3
69641,6,2,243966,243966,243968,0,2,3
69642,3,2,243969,243969,243971,0,2,1
69643,3,1,243972,243972,243973,0,1,1
69644,3,3,243975,243975,243978,0,3,2
69645,5,1,243980,243980,243981,0,1,2
69646,3,1,243983,243983,243984,0,1,2
69647,4,2,243987,243987,243989,0,2,3
69648,5,3,243992,243992,243995,0,3,3
69649,5,3,243997,243997,244000,0,3,2
69650,2,2,243999,244000,244002,1,3,0
69651,2,3,244001,244002,244005,1,4,0
69652,4,3,244005,244005,244008,0,3,0
69653,4,3,244009,244009,244012,0,3,1
69654,3,3,244012,244012,244015,0,3,0
69655,2,2,244014,244015,244017,1,3,0
69656,6,3,244020,244020,244023,0,3,3
69657,1,2,244021,244023,244025,2,4,0
69658,5,2,244026,244026,244028,0,2,1
69659,3,2,244029,244029,244031,0,2,1
69660,4,1,244033,244033,244034,0,1,2
69661,6,3,244039,244039,244042,0,3,5
69662,1,2,244040,244042,244044,2,4,0
69663,4,2,244044,244044,244046,0,2,0
69664,1,2,244045,244046,244048,1,3,0
69665,6,1,244051,244051,244052,0,1,3
69666,3,3,244054,244054,244057,0,3,2
69667,3,1,244057,244057,244058,0,1,0
69668,2,3,244059,244059,244062,0,3,1
69669,4,1,244063,244063,244064,0,1,1
69670,2,3,244065,244065,244068,0,3,1
69671,1,3,244066,244068,244071,2,5,0
69672,2,3,244068,244071,244074,3,6,0
69673,2,2,244070,244074,244076,4,6,0
69674,3,2,244073,244076,244078,3,5,0
69675,4,2,244077,244078,244080,1,3,0
69676,2,3,244079,244080,244083,1,4,0
69677,3,1,244082,244083,244084,1,2,0
69678,5,1,244087,244087,244088,0,1,3
69679,4,2,244091,244091,244093,0,2,3
69680,5,1,244096,244096,244097,0,1,3
69681,3,2,244099,244099,244101,0,2,2
69682,3,3,244102,244102,244105,0,3,1
69683,5,1,244107,244107,244108,0,1,2
69684,4,1,244111,244111,244112,0,1,3
69685,6,2,244117,244117,244119,0,2,5
69686,4,3,244121,244121,244124,0,3,2
69687,5,1,244126,244126,244127,0,1,2
69688,4,3,244130,244130,244133,0,3,3
69689,6,1,244136,244136,244137,0,1,3
69690,4,2,244140,244140,244142,0,2,3
69691,4,3,244144,244144,244147,0,3,2
69692,3,3,244147,244147,244150,0,3,0
69693,6,2,244153,244153,244155,0,2,3
69694,3,3,244156,244156,244159,0,3,1
69695,6,1,244162,244162,244163,0,1,3
69696,3,2,244165,244165,244167,0,2,2
69697,6,3,244171,244171,244174,0,3,4
69698,6,2,244177,244177,244179,0,2,3
69699,2,2,244179,244179,244181,0,2,0
69700,4,2,244183,244183,244185,0,2,2
69701,6,1,244189,244189,244190,0,1,4
69702,4,2,244193,244193,244195,0,2,3
69703,2,1,244195,244195,244196,0,1,0
69704,1,1,244196,244196,244197,0,1,0
69705,2,3,244198,244198,244201,0,3,1
69706,5,3,244203,244203,244206,0,3,2
69707,5,2,244208,244208,244210,0,2,2
69708,6,1,244214,244214,244215,0,1,4
69709,2,1,244216,244216,244217,0,1,1
69710,3,2,244219,244219,244221,0,2,2
69711,3,3,244222,244222,244225,0,3,1
69712,1,2,244223,244225,244227,2,4,0
69713,5,1,244228,244228,244229,0,1,1
69714,4,1,244232,244232,244233,0,1,3
69715,3,1,244235,244235,244236,0,1,2
69716,2,1,244237,244237,244238,0,1,1
69717,4,3,244241,244241,244244,0,3,3
69718,3,1,244244,244244,244245,0,1,0
69719,6,2,244250,244250,244252,0,2,5
69720,4,3,244254,244254,244257,0,3,2
69721,5,2,244259,244259,244261,0,2,2
69722,4,1,244263,244263,244264,0,1,2
69723,3,1,244266,244266,244267,0,1,2
69724,1,1,244267,244267,244268,0,1,0
69725,1,2,244268,244268,244270,0,2,0
69726,5,2,244273,244273,244275,0,2,3
69727,3,3,244276,244276,244279,0,3,1
69728,3,3,244279,244279,244282,0,3,0
69729,5,3,244284,244284,244287,0,3,2
69730,2,2,244286,244287,244289,1,3,0
69731,3,2,244289,244289,244291,0,2,0
69732,2,3,244291,244291,244294,0,3,0
69733,2,2,244293,244294,244296,1,3,0
69734,2,3,244295,244296,244299,1,4,0
69735,4,3,244299,244299,244302,0,3,0
69736,2,2,244301,244302,244304,1,3,0
69737,4,1,244305,244305,244306,0,1,1
69738,3,2,244308,244308,244310,0,2,2
69739,4,3,244312,244312,244315,0,3,2
69740,5,2,244317,244317,244319,0,2,2
69741,3,2,244320,244320,244322,0,2,1
69742,5,1,244325,244325,244326,0,1,3
69743,6,2,244331,244331,244333,0,2,5
69744,1,1,244332,244333,244334,1,2,0
69745,2,2,244334,244334,244336,0,2,0
69746,2,3,244336,244336,244339,0,3,0
69747,2,1,244338,244339,244340,1,2,0
69748,2,2,244340,244340,244342,0,2,0
69749,5,2,244345,244345,244347,0,2,3
69750,3,3,244348,244348,244351,0,3,1
69751,2,2,244350,244351,244353,1,3,0
69752,1,2,244351,244353,244355,2,4,0
69753,1,1,244352,244355,244356,3,4,0
69754,4,3,244356,244356,244359,0,3,0
69755,2,2,244358,244359,244361,1,3,0
69756,3,1,244361,244361,244362,0,1,0
69757,4,1,244365,244365,244366,0,1,3
69758,4,2,244369,244369,244371,0,2,3
69759,1,1,244370,244371,244372,1,2,0
69760,2,2,244372,244372,244374,0,2,0
69761,4,2,244376,244376,244378,0,2,2
69762,3,1,244379,244379,244380,0,1,1
69763,5,1,244384,244384,244385,0,1,4
69764,1,2,244385,244385,244387,0,2,0
69765,4,3,244389,244389,244392,0,3,2
69766,1,2,244390,244392,244394,2,4,0
69767,3,3,244393,244394,244397,1,4,0
69768,4,2,244397,244397,244399,0,2,0
69769,4,3,244401,244401,244404,0,3,2
69770,4,1,244405,244405,244406,0,1,1
69771,5,2,244410,244410,244412,0,2,4
69772,6,3,244416,244416,244419,0,3,4
69773,2,2,244418,244419,244421,1,3,0
69774,6,1,244424,244424,244425,0,1,3
69775,1,3,244425,244425,244428,0,3,0
69776,3,1,244428,244428,244429,0,1,0
69777,4,2,244432,244432,244434,0,2,3
69778,4,1,244436,244436,244437,0,1,2
69779,3,3,244439,244439,244442,0,3,2
69780,6,1,244445,244445,244446,0,1,3
69781,2,1,244447,244447,244448,0,1,1
69782,5,3,244452,244452,244455,0,3,4
69783,2,1,244454,244455,244456,1,2,0
69784,6,2,244460,244460,244462,0,2,4
69785,6,3,244466,244466,244469,0,3,4
69786,3,1,244469,244469,244470,0,1,0
69787,6,2,244475,244475,244477,0,2,5
69788,4,1,244479,244479,244480,0,1,2
69789,6,1,244485,244485,244486,0,1,5
69790,2,3,244487,244487,244490,0,3,1
69791,4,1,244491,244491,244492,0,1,1
69792,3,3,244494,244494,244497,0,3,2
69793,4,1,244498,244498,244499,0,1,1
69794,6,2,244504,244504,244506,0,2,5
69795,5,2,244509,244509,244511,0,2,3
69796,1,3,244510,244511,244514,1,4,0
69797,6,1,244516,244516,244517,0,1,2
69798,2,1,244518,244518,244519,0,1,1
69799,3,3,244521,244521,244524,0,3,2
69800,3,2,244524,244524,244526,0,2,0
69801,4,3,244528,244528,244531,0,3,2
69802,1,1,244529,244531,244532,2,3,0
69803,6,2,244535,244535,244537,0,2,3
69804,2,2,244537,244537,244539,0,2,0
69805,1,3,244538,244539,244542,1,4,0
69806,2,1,244540,244542,244543,2,3,0
69807,3,1,244543,244543,244544,0,1,0
69808,2,2,244545,244545,244547,0,2,1
69809,1,3,244546,244547,244550,1,4,0
69810,5,1,244551,244551,244552,0,1,1
69811,3,2,244554,244554,244556,0,2,2
69812,1,1,244555,244556,244557,1,2,0
69813,3,1,244558,244558,244559,0,1,1
69814,6,3,244564,244564,244567,0,3,5
69815,1,2,244565,244567,244569,2,4,0
69816,2,2,244567,244569,244571,2,4,0
69817,4,1,244571,244571,244572,0,1,0
69818,2,2,244573,244573,244575,0,2,1
69819,3,3,244576,244576,244579,0,3,1
69820,6,3,244582,244582,244585,0,3,3
69821,4,2,244586,244586,244588,0,2,1
69822,2,1,244588,244588,244589,0,1,0
69823,4,1,244592,244592,244593,0,1,3
69824,3,3,244595,244595,244598,0,3,2
69825,3,2,244598,244598,244600,0,2,0
69826,6,2,244604,244604,244606,0,2,4
69827,6,1,244610,244610,244611,0,1,4
69828,3,1,244613,244613,244614,0,1,2
69829,6,1,244619,244619,244620,0,1,5
69830,5,2,244624,244624,244626,0,2,4
69831,5,1,244629,244629,244630,0,1,3
69832,3,1,244632,244632,244633,0,1,2
69833,2,1,244634,244634,244635,0,1,1
69834,5,3,244639,244639,244642,0,3,4
69835,6,3,244645,244645,244648,0,3,3
69836,6,2,244651,244651,244653,0,2,3
69837,1,2,244652,244653,244655,1,3,0
69838,6,2,244658,244658,244660,0,2,3
69839,5,3,244663,244663,244666,0,3,3
69840,4,1,244667,244667,244668,0,1,1
69841,4,2,244671,244671,244673,0,2,3
69842,3,1,244674,244674,244675,0,1,1
69843,3,1,244677,244677,244678,0,1,2
69844,2,2,244679,244679,244681,0,2,1
69845,3,3,244682,244682,244685,0,3,1
69846,4,3,244686,244686,244689,0,3,1
69847,6,1,244692,244692,244693,0,1,3
69848,4,2,244696,244696,244698,0,2,3
69849,5,3,244701,244701,244704,0,3,3
69850,6,1,244707,244707,244708,0,1,3
69851,3,3,244710,244710,244713,0,3,2
69852,4,1,244714,244714,244715,0,1,1
69853,2,1,244716,244716,244717,0,1,1
69854,6,1,244722,244722,244723,0,1,5
69855,2,2,244724,244724,244726,0,2,1
69856,6,1,244730,244730,244731,0,1,4
69857,3,3,244733,244733,244736,0,3,2
69858,1,2,244734,244736,244738,2,4,0
69859,5,3,244739,244739,244742,0,3,1
69860,2,3,244741,244742,244745,1,4,0
69861,4,2,244745,244745,244747,0,2,0
69862,5,1,244750,244750,244751,0,1,3
69863,1,2,244751,244751,244753,0,2,0
69864,3,2,244754,244754,244756,0,2,1
69865,6,2,244760,244760,244762,0,2,4
69866,3,1,244763,244763,244764,0,1,1
69867,2,1,244765,244765,244766,0,1,1
69868,6,2,244771,244771,244773,0,2,5
69869,4,1,244775,244775,244776,0,1,2
69870,1,1,244776,244776,244777,0,1,0
69871,1,1,244777,244777,244778,0,1,0
69872,5,1,244782,244782,244783,0,1,4
69873,6,2,244788,244788,244790,0,2,5
69874,3,3,244791,244791,244794,0,3,1
69875,1,1,244792,244794,244795,2,3,0
69876,6,2,244798,244798,244800,0,2,3
69877,4,1,244802,244802,244803,0,1,2
69878,1,2,244803,244803,244805,0,2,0
69879,1,1,244804,244805,244806,1,2,0
69880,5,3,244809,244809,244812,0,3,3
69881,2,3,244811,244812,244815,1,4,0
69882,3,1,244814,244815,244816,1,2,0
69883,1,3,244815,244816,244819,1,4,0
69884,6,1,244821,244821,244822,0,1,2
69885,6,1,244827,244827,244828,0,1,5
69886,1,2,244828,244828,244830,0,2,0
69887,2,2,244830,244830,244832,0,2,0
69888,3,1,244833,244833,244834,0,1,1
69889,2,3,244835,244835,244838,0,3,1
69890,5,1,244840,244840,244841,0,1,2
69891,2,3,244842,244842,244845,0,3,1
69892,3,1,244845,244845,244846,0,1,0
69893,6,1,244851,244851,244852,0,1,5
69894,6,3,244857,244857,244860,0,3,5
69895,4,1,244861,244861,244862,0,1,1
69896,6,2,244867,244867,244869,0,2,5
69897,2,3,244869,244869,244872,0,3,0
69898,4,1,244873,244873,244874,0,1,1
69899,6,3,244879,244879,244882,0,3,5
69900,4,1,244883,244883,244884,0,1,1
69901,5,1,244888,244888,244889,0,1,4
69902,4,2,244892,244892,244894,0,2,3
69903,4,1,244896,244896,244897,0,1,2
69904,2,1,244898,244898,244899,0,1,1
69905,4,3,244902,244902,244905,0,3,3
69906,3,3,244905,244905,244908,0,3,0
69907,2,3,244907,244908,244911,1,4,0
69908,1,1,244908,244911,244912,3,4,0
69909,3,3,244911,244912,244915,1,4,0
69910,2,3,244913,244915,244918,2,5,0
69911,3,2,244916,244918,244920,2,4,0
69912,1,2,244917,244920,244922,3,5,0
69913,2,3,244919,244922,244925,3,6,0
69914,2,1,244921,244925,244926,4,5,0
69915,5,2,244926,244926,244928,0,2,0
69916,1,1,244927,244928,244929,1,2,0
69917,2,1,244929,244929,244930,0,1,0
69918,2,1,244931,244931,244932,0,1,1
69919,6,1,244937,244937,244938,0,1,5
69920,1,3,244938,244938,244941,0,3,0
69921,3,2,244941,244941,244943,0,2,0
69922,6,3,244947,244947,244950,0,3,4
69923,2,1,244949,244950,244951,1,2,0
69924,1,3,244950,244951,244954,1,4,0
69925,6,2,244956,244956,244958,0,2,2
69926,6,1,244962,244962,244963,0,1,4
69927,3,2,244965,244965,244967,0,2,2
69928,2,3,244967,244967,244970,0,3,0
69929,2,3,244969,244970,244973,1,4,0
69930,1,1,244970,244973,244974,3,4,0
69931,2,1,244972,244974,244975,2,3,0
69932,1,2,244973,244975,244977,2,4,0
69933,1,1,244974,244977,244978,3,4,0
69934,2,2,244976,244978,244980,2,4,0
69935,1,2,244977,244980,244982,3,5,0
69936,4,2,244981,244982,244984,1,3,0
69937,1,3,244982,244984,244987,2,5,0
69938,6,1,244988,244988,244989,0,1,1
69939,5,3,244993,244993,244996,0,3,4
69940,6,1,244999,244999,245000,0,1,3
69941,5,3,245004,245004,245007,0,3,4
69942,2,2,245006,245007,245009,1,3,0
69943,6,3,245012,245012,245015,0,3,3
69944,2,1,245014,245015,245016,1,2,0
69945,4,2,245018,245018,245020,0,2,2
69946,6,1,245024,245024,245025,0,1,4
69947,5,2,245029,245029,245031,0,2,4
69948,4,2,245033,245033,245035,0,2,2
69949,6,2,245039,245039,245041,0,2,4
69950,6,1,245045,245045,245046,0,1,4
69951,3,1,245048,245048,245049,0,1,2
69952,3,1,245051,245051,245052,0,1,2
69953,6,2,245057,245057,245059,0,2,5
69954,3,2,245060,245060,245062,0,2,1
69955,1,1,245061,245062,245063,1,2,0
69956,5,2,245066,245066,245068,0,2,3
69957,2,1,245068,245068,245069,0,1,0
69958,2,2,245070,245070,245072,0,2,1
69959,5,1,245075,245075,245076,0,1,3
69960,5,1,245080,245080,245081,0,1,4
69961,5,1,245085,245085,245086,0,1,4
69962,5,2,245090,245090,245092,0,2,4
69963,6,3,245096,245096,245099,0,3,4
69964,3,1,245099,245099,245100,0,1,0
69965,6,1,245105,245105,245106,0,1,5
69966,3,3,245108,245108,245111,0,3,2
69967,2,2,245110,245111,245113,1,3,0
69968,4,2,245114,245114,245116,0,2,1
69969,4,2,245118,245118,245120,0,2,2
69970,3,1,245121,245121,245122,0,1,1
69971,1,3,245122,245122,245125,0,3,0
69972,1,3,245123,245125,245128,2,5,0
69973,6,3,245129,245129,245132,0,3,1
69974,1,1,245130,245132,245133,2,3,0
69975,5,1,245135,245135,245136,0,1,2
69976,1,3,245136,245136,245139,0,3,0
69977,6,1,245142,245142,245143,0,1,3
69978,6,1,245148,245148,245149,0,1,5
69979,3,2,245151,245151,245153,0,2,2
69980,6,1,245157,245157,245158,0,1,4
69981,4,3,245161,245161,245164,0,3,3
69982,2,3,245163,245164,245167,1,4,0
69983,1,1,245164,245167,245168,3,4,0
69984,3,2,245167,245168,245170,1,3,0
69985,3,1,245170,245170,245171,0,1,0
69986,1,1,245171,245171,245172,0,1,0
69987,2,3,245173,245173,245176,0,3,1
69988,1,3,245174,245176,245179,2,5,0
69989,1,3,245175,245179,245182,4,7,0
69990,2,2,245177,245182,245184,5,7,0
69991,6,3,245183,245184,245187,1,4,0
69992,1,3,245184,245187,245190,3,6,0
69993,3,1,245187,245190,245191,3,4,0
69994,3,2,245190,245191,245193,1,3,0
69995,2,1,245192,245193,245194,1,2,0
69996,3,2,245195,245195,245197,0,2,1
69997,2,1,245197,245197,245198,0,1,0
69998,3,1,245200,245200,245201,0,1,2
69999,4,2,245204,245204,245206,0,2,3
70000,2,1,245206,245206,245207,0,1,0
70001,1,1,245207,245207,245208,0,1,0
70002,4,1,245211,245211,245212,0,1,3
70003,2,1,245213,245213,245214,0,1,1
70004,2,2,245215,245215,245217,0,2,1
70005,1,3,245216,245217,245220,1,4,0
70006,1,3,245217,245220,245223,3,6,0
70007,4,3,245221,245223,245226,2,5,0
70008,2,1,245223,245226,245227,3,4,0
70009,4,1,245227,245227,245228,0,1,0
70010,2,1,245229,245229,245230,0,1,1
70011,2,3,245231,245231,245234,0,3,1
70012,6,3,245237,245237,245240,0,3,3
70013,1,3,245238,245240,245243,2,5,0
70014,6,3,245244,245244,245247,0,3,1
70015,3,1,245247,245247,245248,0,1,0
70016,6,2,245253,245253,245255,0,2,5
70017,5,3,245258,245258,245261,0,3,3
70018,4,3,245262,245262,245265,0,3,1
70019,6,3,245268,245268,245271,0,3,3
70020,1,1,245269,245271,245272,2,3,0
70021,1,3,245270,245272,245275,2,5,0
70022,5,3,245275,245275,245278,0,3,0
70023,4,1,245279,245279,245280,0,1,1
70024,4,2,245283,245283,245285,0,2,3
70025,3,1,245286,245286,245287,0,1,1
70026,6,2,245292,245292,245294,0,2,5
70027,5,1,245297,245297,245298,0,1,3
70028,1,1,245298,245298,245299,0,1,0
70029,4,2,245302,245302,245304,0,2,3
70030,5,1,245307,245307,245308,0,1,3
70031,2,3,245309,245309,245312,0,3,1
70032,4,1,245313,245313,245314,0,1,1
70033,3,3,245316,245316,245319,0,3,2
70034,2,1,245318,245319,245320,1,2,0
70035,6,3,245324,245324,245327,0,3,4
70036,2,1,245326,245327,245328,1,2,0
70037,1,1,245327,245328,245329,1,2,0
70038,2,1,245329,245329,245330,0,1,0
70039,5,3,245334,245334,245337,0,3,4
70040,4,2,245338,245338,245340,0,2,1
70041,2,1,245340,245340,245341,0,1,0
70042,2,3,245342,245342,245345,0,3,1
70043,1,1,245343,245345,245346,2,3,0
70044,6,1,245349,245349,245350,0,1,3
70045,2,3,245351,245351,245354,0,3,1
70046,6,1,245357,245357,245358,0,1,3
70047,3,1,245360,245360,245361,0,1,2
70048,4,1,245364,245364,245365,0,1,3
70049,5,2,245369,245369,245371,0,2,4
70050,6,3,245375,245375,245378,0,3,4
70051,1,1,245376,245378,245379,2,3,0
70052,5,2,245381,245381,245383,0,2,2
70053,4,3,245385,245385,245388,0,3,2
70054,6,1,245391,245391,245392,0,1,3
70055,5,3,245396,245396,245399,0,3,4
70056,2,2,245398,245399,245401,1,3,0
70057,1,2,245399,245401,245403,2,4,0
70058,3,2,245402,245403,245405,1,3,0
70059,1,3,245403,245405,245408,2,5,0
70060,2,2,245405,245408,245410,3,5,0
70061,2,3,245407,245410,245413,3,6,0
70062,2,3,245409,245413,245416,4,7,0
70063,4,1,245413,245416,245417,3,4,0
70064,2,2,245415,245417,245419,2,4,0
70065,6,1,245421,245421,245422,0,1,2
70066,6,2,245427,245427,245429,0,2,5
70067,2,3,245429,245429,245432,0,3,0
70068,2,3,245431,245432,245435,1,4,0
70069,5,3,245436,245436,245439,0,3,1
70070,1,1,245437,245439,245440,2,3,0
70071,6,1,245443,245443,245444,0,1,3
70072,5,2,245448,245448,245450,0,2,4
70073,2,1,245450,245450,245451,0,1,0
70074,1,3,245451,245451,245454,0,3,0
70075,6,3,245457,245457,245460,0,3,3
70076,3,3,245460,245460,245463,0,3,0
70077,3,3,245463,245463,245466,0,3,0
70078,5,3,245468,245468,245471,0,3,2
70079,1,1,245469,245471,245472,2,3,0
70080,5,3,245474,245474,245477,0,3,2
70081,2,1,245476,245477,245478,1,2,0
70082,2,2,245478,245478,245480,0,2,0
70083,1,3,245479,245480,245483,1,4,0
70084,1,3,245480,245483,245486,3,6,0
70085,6,2,245486,245486,245488,0,2,0
70086,1,3,245487,245488,245491,1,4,0
70087,5,2,245492,245492,245494,0,2,1
70088,5,1,245497,245497,245498,0,1,3
70089,6,2,245503,245503,245505,0,2,5
70090,2,2,245505,245505,245507,0,2,0
70091,3,2,245508,245508,245510,0,2,1
70092,2,3,245510,245510,245513,0,3,0
70093,3,2,245513,245513,245515,0,2,0
70094,2,3,245515,245515,245518,0,3,0
70095,2,1,245517,245518,245519,1,2,0
70096,6,2,245523,245523,245525,0,2,4
70097,1,2,245524,245525,245527,1,3,0
70098,2,2,245526,245527,245529,1,3,0
70099,1,2,245527,245529,245531,2,4,0
70100,6,3,245533,245533,245536,0,3,2
70101,3,2,245536,245536,245538,0,2,0
70102,3,1,245539,245539,245540,0,1,1
70103,3,2,245542,245542,245544,0,2,2
70104,6,2,245548,245548,245550,0,2,4
70105,3,1,245551,245551,245552,0,1,1
70106,3,1,245554,245554,245555,0,1,2
70107,4,1,245558,245558,245559,0,1,3
70108,1,3,245559,245559,245562,0,3,0
70109,5,1,245564,245564,245565,0,1,2
70110,5,2,245569,245569,245571,0,2,4
70111,6,3,245575,245575,245578,0,3,4
70112,2,2,245577,245578,245580,1,3,0
70113,1,3,245578,245580,245583,2,5,0
70114,6,2,245584,245584,245586,0,2,1
70115,6,2,245590,245590,245592,0,2,4
70116,5,1,245595,245595,245596,0,1,3
70117,5,1,245600,245600,245601,0,1,4
70118,2,3,245602,245602,245605,0,3,1
70119,1,2,245603,245605,245607,2,4,0
70120,2,1,245605,245607,245608,2,3,0
70121,6,2,245611,245611,245613,0,2,3
70122,1,3,245612,245613,245616,1,4,0
70123,3,1,245615,245616,245617,1,2,0
70124,3,2,245618,245618,245620,0,2,1
70125,1,2,245619,245620,245622,1,3,0
70126,3,3,245622,245622,245625,0,3,0
70127,5,2,245627,245627,245629,0,2,2
70128,6,1,245633,245633,245634,0,1,4
70129,4,1,245637,245637,245638,0,1,3
70130,4,2,245641,245641,245643,0,2,3
70131,2,1,245643,245643,245644,0,1,0
70132,2,3,245645,245645,245648,0,3,1
70133,3,3,245648,245648,245651,0,3,0
70134,1,2,245649,245651,245653,2,4,0
70135,1,1,245650,245653,245654,3,4,0
70136,3,1,245653,245654,245655,1,2,0
70137,5,2,245658,245658,245660,0,2,3
70138,5,1,245663,245663,245664,0,1,3
70139,4,3,245667,245667,245670,0,3,3
70140,2,3,245669,245670,245673,1,4,0
70141,4,3,245673,245673,245676,0,3,0
70142,5,1,245678,245678,245679,0,1,2
70143,5,3,245683,245683,245686,0,3,4
70144,2,1,245685,245686,245687,1,2,0
70145,4,3,245689,245689,245692,0,3,2
70146,1,1,245690,245692,245693,2,3,0
70147,1,3,245691,245693,245696,2,5,0
70148,1,2,245692,245696,245698,4,6,0
70149,5,2,245697,245698,245700,1,3,0
70150,1,1,245698,245700,245701,2,3,0
70151,1,3,245699,245701,245704,2,5,0
70152,4,3,245703,245704,245707,1,4,0
70153,6,3,245709,245709,245712,0,3,2
70154,1,2,245710,245712,245714,2,4,0
70155,4,2,245714,245714,245716,0,2,0
70156,2,1,245716,245716,245717,0,1,0
70157,5,2,245721,245721,245723,0,2,4
70158,5,3,245726,245726,245729,0,3,3
70159,5,3,245731,245731,245734,0,3,2
70160,4,3,245735,245735,245738,0,3,1
70161,3,1,245738,245738,245739,0,1,0
70162,1,2,245739,245739,245741,0,2,0
70163,2,2,245741,245741,245743,0,2,0
70164,1,1,245742,245743,245744,1,2,0
70165,2,3,245744,245744,245747,0,3,0
70166,5,1,245749,245749,245750,0,1,2
70167,1,1,245750,245750,245751,0,1,0
70168,3,3,245753,245753,245756,0,3,2
70169,3,1,245756,245756,245757,0,1,0
70170,6,1,245762,245762,245763,0,1,5
70171,3,2,245765,245765,245767,0,2,2
70172,6,1,245771,245771,245772,0,1,4
70173,1,1,245772,245772,245773,0,1,0
70174,6,1,245778,245778,245779,0,1,5
70175,2,1,245780,245780,245781,0,1,1
70176,5,1,245785,245785,245786,0,1,4
70177,2,3,245787,245787,245790,0,3,1
70178,3,2,245790,245790,245792,0,2,0
70179,4,2,245794,245794,245796,0,2,2
70180,4,2,245798,245798,245800,0,2,2
70181,4,3,245802,245802,245805,0,3,2
70182,5,1,245807,245807,245808,0,1,2
70183,3,2,245810,245810,245812,0,2,2
70184,1,1,245811,245812,245813,1,2,0
70185,2,1,245813,245813,245814,0,1,0
70186,2,3,245815,245815,245818,0,3,1
70187,2,1,245817,245818,245819,1,2,0
70188,3,3,245820,245820,245823,0,3,1
70189,4,1,245824,245824,245825,0,1,1
70190,2,3,245826,245826,245829,0,3,1
70191,6,1,245832,245832,245833,0,1,3
70192,6,3,245838,245838,245841,0,3,5
70193,3,2,245841,245841,245843,0,2,0
70194,4,3,245845,245845,245848,0,3,2
70195,2,1,245847,245848,245849,1,2,0
70196,6,1,245853,245853,245854,0,1,4
70197,5,1,245858,245858,245859,0,1,4
70198,1,2,245859,245859,245861,0,2,0
70199,4,3,245863,245863,245866,0,3,2
70200,6,2,245869,245869,245871,0,2,3
70201,3,2,245872,245872,245874,0,2,1
70202,4,1,245876,245876,245877,0,1,2
70203,2,3,245878,245878,245881,0,3,1
70204,2,2,245880,245881,245883,1,3,0
70205,6,2,245886,245886,245888,0,2,3
70206,5,2,245891,245891,245893,0,2,3
70207,6,3,245897,245897,245900,0,3,4
70208,2,2,245899,245900,245902,1,3,0
70209,6,2,245905,245905,245907,0,2,3
70210,3,1,245908,245908,245909,0,1,1
70211,6,2,245914,245914,245916,0,2,5
70212,2,1,245916,245916,245917,0,1,0
70213,5,3,245921,245921,245924,0,3,4
70214,1,3,245922,245924,245927,2,5,0
70215,5,1,245927,245927,245928,0,1,0
70216,1,3,245928,245928,245931,0,3,0
70217,1,1,245929,245931,245932,2,3,0
70218,3,1,245932,245932,245933,0,1,0
70219,4,3,245936,245936,245939,0,3,3
70220,4,3,245940,245940,245943,0,3,1
70221,1,3,245941,245943,245946,2,5,0
70222,5,2,245946,245946,245948,0,2,0
70223,6,3,245952,245952,245955,0,3,4
70224,5,3,245957,245957,245960,0,3,2
70225,6,2,245963,245963,245965,0,2,3
70226,6,3,245969,245969,245972,0,3,4
70227,1,1,245970,245972,245973,2,3,0
70228,3,1,245973,245973,245974,0,1,0
70229,1,2,245974,245974,245976,0,2,0
70230,4,2,245978,245978,245980,0,2,2
70231,2,2,245980,245980,245982,0,2,0
70232,1,3,245981,245982,245985,1,4,0
70233,3,3,245984,245985,245988,1,4,0
70234,5,3,245989,245989,245992,0,3,1
70235,2,2,245991,245992,245994,1,3,0
70236,5,1,245996,245996,245997,0,1,2
70237,6,3,246002,246002,246005,0,3,5
70238,6,1,246008,246008,246009,0,1,3
70239,6,2,246014,246014,246016,0,2,5
70240,2,1,246016,246016,246017,0,1,0
70241,5,1,246021,246021,246022,0,1,4
70242,1,2,246022,246022,246024,0,2,0
70243,3,1,246025,246025,246026,0,1,1
70244,6,2,246031,246031,246033,0,2,5
70245,1,3,246032,246033,246036,1,4,0
70246,5,1,246037,246037,246038,0,1,1
70247,6,1,246043,246043,246044,0,1,5
70248,5,2,246048,246048,246050,0,2,4
70249,2,1,246050,246050,246051,0,1,0
70250,5,3,246055,246055,246058,0,3,4
70251,4,2,246059,246059,246061,0,2,1
70252,4,2,246063,246063,246065,0,2,2
70253,1,1,246064,246065,246066,1,2,0
70254,3,1,246067,246067,246068,0,1,1
70255,1,1,246068,246068,246069,0,1,0
70256,2,3,246070,246070,246073,0,3,1
70257,5,3,246075,246075,246078,0,3,2
70258,6,1,246081,246081,246082,0,1,3
70259,4,2,246085,246085,246087,0,2,3
70260,5,2,246090,246090,246092,0,2,3
70261,6,1,246096,246096,246097,0,1,4
70262,1,2,246097,246097,246099,0,2,0
70263,6,1,246103,246103,246104,0,1,4
70264,2,2,246105,246105,246107,0,2,1
70265,4,2,246109,246109,246111,0,2,2
70266,5,1,246114,246114,246115,0,1,3
70267,6,1,246120,246120,246121,0,1,5
70268,6,3,246126,246126,246129,0,3,5
70269,2,3,246128,246129,246132,1,4,0
70270,3,1,246131,246132,246133,1,2,0
70271,3,2,246134,246134,246136,0,2,1
70272,6,1,246140,246140,246141,0,1,4
70273,4,2,246144,246144,246146,0,2,3
70274,4,1,246148,246148,246149,0,1,2
70275,5,2,246153,246153,246155,0,2,4
70276,6,3,246159,246159,246162,0,3,4
70277,2,2,246161,246162,246164,1,3,0
70278,6,2,246167,246167,246169,0,2,3
70279,5,2,246172,246172,246174,0,2,3
70280,6,2,246178,246178,246180,0,2,4
70281,5,1,246183,246183,246184,0,1,3
70282,3,1,246186,246186,246187,0,1,2
70283,6,1,246192,246192,246193,0,1,5
70284,5,2,246197,246197,246199,0,2,4
70285,5,1,246202,246202,246203,0,1,3
70286,6,3,246208,246208,246211,0,3,5
70287,5,3,246213,246213,246216,0,3,2
70288,2,2,246215,246216,246218,1,3,0
70289,6,1,246221,246221,246222,0,1,3
70290,1,1,246222,246222,246223,0,1,0
70291,5,1,246227,246227,246228,0,1,4
70292,3,3,246230,246230,246233,0,3,2
70293,6,3,246236,246236,246239,0,3,3
70294,6,2,246242,246242,246244,0,2,3
70295,4,1,246246,246246,246247,0,1,2
70296,1,3,246247,246247,246250,0,3,0
70297,5,1,246252,246252,246253,0,1,2
70298,5,1,246257,246257,246258,0,1,4
70299,3,1,246260,246260,246261,0,1,2
70300,1,3,246261,246261,246264,0,3,0
70301,5,1,246266,246266,246267,0,1,2
70302,1,1,246267,246267,246268,0,1,0
70303,1,1,246268,246268,246269,0,1,0
70304,5,2,246273,246273,246275,0,2,4
70305,3,2,246276,246276,246278,0,2,1
70306,4,1,246280,246280,246281,0,1,2
70307,4,3,246284,246284,246287,0,3,3
70308,5,3,246289,246289,246292,0,3,2
70309,2,1,246291,246292,246293,1,2,0
70310,3,2,246294,246294,246296,0,2,1
70311,3,2,246297,246297,246299,0,2,1
70312,1,2,246298,246299,246301,1,3,0
70313,2,2,246300,246301,246303,1,3,0
70314,3,2,246303,246303,246305,0,2,0
70315,2,2,246305,246305,246307,0,2,0
70316,1,1,246306,246307,246308,1,2,0
70317,1,1,246307,246308,246309,1,2,0
70318,5,2,246312,246312,246314,0,2,3
70319,5,1,246317,246317,246318,0,1,3
70320,2,3,246319,246319,246322,0,3,1
70321,1,1,246320,246322,246323,2,3,0
70322,4,1,246324,246324,246325,0,1,1
70323,5,2,246329,246329,246331,0,2,4
70324,4,2,246333,246333,246335,0,2,2
70325,5,3,246338,246338,246341,0,3,3
70326,1,1,246339,246341,246342,2,3,0
70327,6,3,246345,246345,246348,0,3,3
70328,1,1,246346,246348,246349,2,3,0
70329,5,1,246351,246351,246352,0,1,2
70330,1,1,246352,246352,246353,0,1,0
70331,2,2,246354,246354,246356,0,2,1
70332,4,1,246358,246358,246359,0,1,2
70333,4,2,246362,246362,246364,0,2,3
70334,5,2,246367,246367,246369,0,2,3
70335,1,2,246368,246369,246371,1,3,0
70336,6,3,246374,246374,246377,0,3,3
70337,1,2,246375,246377,246379,2,4,0
70338,4,2,246379,246379,246381,0,2,0
70339,3,2,246382,246382,246384,0,2,1
70340,5,3,246387,246387,246390,0,3,3
70341,2,2,246389,246390,246392,1,3,0
70342,3,3,246392,246392,246395,0,3,0
70343,6,1,246398,246398,246399,0,1,3
70344,1,2,246399,246399,246401,0,2,0
70345,3,2,246402,246402,246404,0,2,1
70346,1,2,246403,246404,246406,1,3,0
70347,1,3,246404,246406,246409,2,5,0
70348,4,1,246408,246409,246410,1,2,0
70349,6,1,246414,246414,246415,0,1,4
70350,6,1,246420,246420,246421,0,1,5
70351,6,3,246426,246426,246429,0,3,5
70352,4,1,246430,246430,246431,0,1,1
70353,4,1,246434,246434,246435,0,1,3
70354,1,1,246435,246435,246436,0,1,0
70355,3,1,246438,246438,246439,0,1,2
70356,4,3,246442,246442,246445,0,3,3
70357,3,2,246445,246445,246447,0,2,0
70358,2,2,246447,246447,246449,0,2,0
70359,1,1,246448,246449,246450,1,2,0
70360,5,2,246453,246453,246455,0,2,3
70361,2,3,246455,246455,246458,0,3,0
70362,2,2,246457,246458,246460,1,3,0
70363,3,2,246460,246460,246462,0,2,0
70364,5,1,246465,246465,246466,0,1,3
70365,6,1,246471,246471,246472,0,1,5
70366,4,1,246475,246475,246476,0,1,3
70367,1,3,246476,246476,246479,0,3,0
70368,3,1,246479,246479,246480,0,1,0
70369,6,2,246485,246485,246487,0,2,5
70370,3,2,246488,246488,246490,0,2,1
70371,2,1,246490,246490,246491,0,1,0
70372,1,1,246491,246491,246492,0,1,0
70373,5,2,246496,246496,246498,0,2,4
70374,3,1,246499,246499,246500,0,1,1
70375,3,3,246502,246502,246505,0,3,2
70376,2,2,246504,246505,246507,1,3,0
70377,3,2,246507,246507,246509,0,2,0
70378,2,2,246509,246509,246511,0,2,0
70379,1,3,246510,246511,246514,1,4,0
70380,2,2,246512,246514,246516,2,4,0
70381,1,2,246513,246516,246518,3,5,0
70382,5,2,246518,246518,246520,0,2,0
70383,3,2,246521,246521,246523,0,2,1
70384,1,1,246522,246523,246524,1,2,0
70385,1,1,246523,246524,246525,1,2,0
70386,3,2,246526,246526,246528,0,2,1
70387,5,3,246531,246531,246534,0,3,3
70388,4,2,246535,246535,246537,0,2,1
70389,1,2,246536,246537,246539,1,3,0
70390,1,3,246537,246539,246542,2,5,0
70391,4,1,246541,246542,246543,1,2,0
70392,1,3,246542,246543,246546,1,4,0
70393,2,3,246544,246546,246549,2,5,0
70394,4,3,246548,246549,246552,1,4,0
70395,4,2,246552,246552,246554,0,2,0
70396,4,1,246556,246556,246557,0,1,2
70397,6,1,246562,246562,246563,0,1,5
70398,4,1,246566,246566,246567,0,1,3
70399,3,2,246569,246569,246571,0,2,2
70400,3,3,246572,246572,246575,0,3,1
70401,6,3,246578,246578,246581,0,3,3
70402,1,3,246579,246581,246584,2,5,0
70403,6,2,246585,246585,246587,0,2,1
70404,2,3,246587,246587,246590,0,3,0
70405,6,3,246593,246593,246596,0,3,3
70406,6,3,246599,246599,246602,0,3,3
70407,3,2,246602,246602,246604,0,2,0
70408,6,3,246608,246608,246611,0,3,4
70409,5,3,246613,246613,246616,0,3,2
70410,3,3,246616,246616,246619,0,3,0
70411,3,3,246619,246619,246622,0,3,0
70412,5,3,246624,246624,246627,0,3,2
70413,6,1,246630,246630,246631,0,1,3
70414,1,2,246631,246631,246633,0,2,0
70415,5,1,246636,246636,246637,0,1,3
70416,5,3,246641,246641,246644,0,3,4
70417,5,2,246646,246646,246648,0,2,2
70418,2,1,246648,246648,246649,0,1,0
70419,6,2,246654,246654,246656,0,2,5
70420,1,2,246655,246656,246658,1,3,0
70421,4,1,246659,246659,246660,0,1,1
70422,4,1,246663,246663,246664,0,1,3
70423,2,1,246665,246665,246666,0,1,1
70424,4,2,246669,246669,246671,0,2,3
70425,1,1,246670,246671,246672,1,2,0
70426,4,3,246674,246674,246677,0,3,2
70427,4,3,246678,246678,246681,0,3,1
70428,6,3,246684,246684,246687,0,3,3
70429,2,3,246686,246687,246690,1,4,0
70430,4,3,246690,246690,246693,0,3,0
70431,4,2,246694,246694,246696,0,2,1
70432,4,3,246698,246698,246701,0,3,2
70433,6,1,246704,246704,246705,0,1,3
70434,4,3,246708,246708,246711,0,3,3
70435,3,1,246711,246711,246712,0,1,0
70436,1,1,246712,246712,246713,0,1,0
70437,4,2,246716,246716,246718,0,2,3
70438,4,2,246720,246720,246722,0,2,2
70439,6,2,246726,246726,246728,0,2,4
70440,1,2,246727,246728,246730,1,3,0
70441,5,2,246732,246732,246734,0,2,2
70442,2,3,246734,246734,246737,0,3,0
70443,4,3,246738,246738,246741,0,3,1
70444,5,1,246743,246743,246744,0,1,2
70445,6,1,246749,246749,246750,0,1,5
70446,5,3,246754,246754,246757,0,3,4
70447,2,2,246756,246757,246759,1,3,0
70448,3,2,246759,246759,246761,0,2,0
70449,2,1,246761,246761,246762,0,1,0
70450,2,2,246763,246763,246765,0,2,1
70451,4,1,246767,246767,246768,0,1,2
70452,3,1,246770,246770,246771,0,1,2
70453,5,2,246775,246775,246777,0,2,4
70454,5,1,246780,246780,246781,0,1,3
70455,6,3,246786,246786,246789,0,3,5
70456,5,1,246791,246791,246792,0,1,2
70457,1,1,246792,246792,246793,0,1,0
70458,1,3,246793,246793,246796,0,3,0
70459,5,3,246798,246798,246801,0,3,2
70460,1,2,246799,246801,246803,2,4,0
70461,4,2,246803,246803,246805,0,2,0
70462,6,3,246809,246809,246812,0,3,4
70463,6,2,246815,246815,246817,0,2,3
70464,3,2,246818,246818,246820,0,2,1
70465,3,3,246821,246821,246824,0,3,1
70466,6,3,246827,246827,246830,0,3,3
70467,6,1,246833,246833,246834,0,1,3
70468,2,3,246835,246835,246838,0,3,1
70469,5,1,246840,246840,246841,0,1,2
70470,5,3,246845,246845,246848,0,3,4
70471,1,2,246846,246848,246850,2,4,0
70472,3,2,246849,246850,246852,1,3,0
70473,3,2,246852,246852,246854,0,2,0
70474,4,3,246856,246856,246859,0,3,2
70475,1,1,246857,246859,246860,2,3,0
70476,5,3,246862,246862,246865,0,3,2
70477,4,2,246866,246866,246868,0,2,1
70478,5,1,246871,246871,246872,0,1,3
70479,2,3,246873,246873,246876,0,3,1
70480,1,1,246874,246876,246877,2,3,0
70481,2,3,246876,246877,246880,1,4,0
70482,2,1,246878,246880,246881,2,3,0
70483,1,1,246879,246881,246882,2,3,0
70484,5,3,246884,246884,246887,0,3,2
70485,5,2,246889,246889,246891,0,2,2
70486,1,1,246890,246891,246892,1,2,0
70487,3,2,246893,246893,246895,0,2,1
70488,6,2,246899,246899,246901,0,2,4
70489,4,3,246903,246903,246906,0,3,2
70490,4,3,246907,246907,246910,0,3,1
70491,1,3,246908,246910,246913,2,5,0
70492,6,2,246914,246914,246916,0,2,1
70493,3,2,246917,246917,246919,0,2,1
70494,1,3,246918,246919,246922,1,4,0
70495,5,2,246923,246923,246925,0,2,1
70496,2,1,246925,246925,246926,0,1,0
70497,5,2,246930,246930,246932,0,2,4
70498,2,1,246932,246932,246933,0,1,0
70499,6,3,246938,246938,246941,0,3,5
70500,5,2,246943,246943,246945,0,2,2
70501,5,1,246948,246948,246949,0,1,3
70502,3,3,246951,246951,246954,0,3,2
70503,6,1,246957,246957,246958,0,1,3
70504,3,3,246960,246960,246963,0,3,2
70505,4,1,246964,246964,246965,0,1,1
70506,6,3,246970,246970,246973,0,3,5
70507,4,3,246974,246974,246977,0,3,1
70508,2,3,246976,246977,246980,1,4,0
70509,6,3,246982,246982,246985,0,3,2
70510,3,3,246985,246985,246988,0,3,0
70511,5,2,246990,246990,246992,0,2,2
70512,3,2,246993,246993,246995,0,2,1
70513,3,3,246996,246996,246999,0,3,1
70514,6,3,247002,247002,247005,0,3,3
70515,4,2,247006,247006,247008,0,2,1
70516,6,1,247012,247012,247013,0,1,4
70517,1,3,247013,247013,247016,0,3,0
70518,4,1,247017,247017,247018,0,1,1
70519,2,1,247019,247019,247020,0,1,1
70520,3,3,247022,247022,247025,0,3,2
70521,2,2,247024,247025,247027,1,3,0
70522,6,1,247030,247030,247031,0,1,3
70523,1,2,247031,247031,247033,0,2,0
70524,2,1,247033,247033,247034,0,1,0
70525,6,2,247039,247039,247041,0,2,5
70526,6,3,247045,247045,247048,0,3,4
70527,3,1,247048,247048,247049,0,1,0
70528,4,3,247052,247052,247055,0,3,3
70529,3,3,247055,247055,247058,0,3,0
70530,2,2,247057,247058,247060,1,3,0
70531,1,3,247058,247060,247063,2,5,0
70532,1,3,247059,247063,247066,4,7,0
70533,1,2,247060,247066,247068,6,8,0
70534,3,2,247063,247068,247070,5,7,0
70535,2,2,247065,247070,247072,5,7,0
70536,3,2,247068,247072,247074,4,6,0
70537,6,2,247074,247074,247076,0,2,0
70538,1,1,247075,247076,247077,1,2,0
70539,5,2,247080,247080,247082,0,2,3
70540,2,3,247082,247082,247085,0,3,0
70541,4,1,247086,247086,247087,0,1,1
70542,4,1,247090,247090,247091,0,1,3
70543,2,1,247092,247092,247093,0,1,1
70544,6,3,247098,247098,247101,0,3,5
70545,5,3,247103,247103,247106,0,3,2
70546,3,3,247106,247106,247109,0,3,0
70547,2,2,247108,247109,247111,1,3,0
70548,3,1,247111,247111,247112,0,1,0
70549,4,1,247115,247115,247116,0,1,3
70550,3,1,247118,247118,247119,0,1,2
70551,6,3,247124,247124,247127,0,3,5
70552,1,3,247125,247127,247130,2,5,0
70553,4,2,247129,247130,247132,1,3,0
70554,5,2,247134,247134,247136,0,2,2
70555,2,3,247136,247136,247139,0,3,0
70556,2,1,247138,247139,247140,1,2,0
70557,6,3,247144,247144,247147,0,3,4
70558,1,3,247145,247147,247150,2,5,0
70559,5,3,247150,247150,247153,0,3,0
70560,3,1,247153,247153,247154,0,1,0
70561,4,3,247157,247157,247160,0,3,3
70562,5,3,247162,247162,247165,0,3,2
70563,6,1,247168,247168,247169,0,1,3
70564,3,2,247171,247171,247173,0,2,2
70565,4,2,247175,247175,247177,0,2,2
70566,3,3,247178,247178,247181,0,3,1
70567,6,3,247184,247184,247187,0,3,3
70568,5,2,247189,247189,247191,0,2,2
70569,1,1,247190,247191,247192,1,2,0
70570,2,3,247192,247192,247195,0,3,0
70571,6,1,247198,247198,247199,0,1,3
70572,4,3,247202,247202,247205,0,3,3
70573,1,2,247203,247205,247207,2,4,0
70574,2,1,247205,247207,247208,2,3,0
70575,1,1,247206,247208,247209,2,3,0
70576,5,2,247211,247211,247213,0,2,2
70577,2,3,247213,247213,247216,0,3,0
70578,2,2,247215,247216,247218,1,3,0
70579,3,2,247218,247218,247220,0,2,0
70580,2,3,247220,247220,247223,0,3,0
70581,3,2,247223,247223,247225,0,2,0
70582,3,2,247226,247226,247228,0,2,1
70583,2,2,247228,247228,247230,0,2,0
70584,3,1,247231,247231,247232,0,1,1
70585,3,2,247234,247234,247236,0,2,2
70586,1,1,247235,247236,247237,1,2,0
70587,3,1,247238,247238,247239,0,1,1
70588,3,3,247241,247241,247244,0,3,2
70589,4,1,247245,247245,247246,0,1,1
70590,6,1,247251,247251,247252,0,1,5
70591,2,1,247253,247253,247254,0,1,1
70592,4,3,247257,247257,247260,0,3,3
70593,6,1,247263,247263,247264,0,1,3
70594,1,3,247264,247264,247267,0,3,0
70595,3,3,247267,247267,247270,0,3,0
70596,3,2,247270,247270,247272,0,2,0
70597,2,1,247272,247272,247273,0,1,0
70598,3,2,247275,247275,247277,0,2,2
70599,5,1,247280,247280,247281,0,1,3
70600,3,1,247283,247283,247284,0,1,2
70601,5,1,247288,247288,247289,0,1,4
70602,5,3,247293,247293,247296,0,3,4
70603,6,1,247299,247299,247300,0,1,3
70604,5,2,247304,247304,247306,0,2,4
70605,3,3,247307,247307,247310,0,3,1
70606,2,2,247309,247310,247312,1,3,0
70607,2,2,247311,247312,247314,1,3,0
70608,1,3,247312,247314,247317,2,5,0
70609,4,3,247316,247317,247320,1,4,0
70610,2,1,247318,247320,247321,2,3,0
70611,6,1,247324,247324,247325,0,1,3
70612,4,2,247328,247328,247330,0,2,3
70613,1,2,247329,247330,247332,1,3,0
70614,2,2,247331,247332,247334,1,3,0
70615,6,2,247337,247337,247339,0,2,3
70616,2,2,247339,247339,247341,0,2,0
70617,1,3,247340,247341,247344,1,4,0
70618,1,2,247341,247344,247346,3,5,0
70619,5,3,247346,247346,247349,0,3,0
70620,5,1,247351,247351,247352,0,1,2
70621,3,3,247354,247354,247357,0,3,2
70622,3,2,247357,247357,247359,0,2,0
70623,6,1,247363,247363,247364,0,1,4
70624,6,2,247369,247369,247371,0,2,5
70625,1,2,247370,247371,247373,1,3,0
70626,4,3,247374,247374,247377,0,3,1
70627,5,3,247379,247379,247382,0,3,2
70628,1,3,247380,247382,247385,2,5,0
70629,3,2,247383,247385,247387,2,4,0
70630,4,1,247387,247387,247388,0,1,0
70631,1,2,247388,247388,247390,0,2,0
70632,4,2,247392,247392,247394,0,2,2
70633,5,1,247397,247397,247398,0,1,3
70634,5,1,247402,247402,247403,0,1,4
70635,1,2,247403,247403,247405,0,2,0
70636,2,1,247405,247405,247406,0,1,0
70637,4,3,247409,247409,247412,0,3,3
70638,1,2,247410,247412,247414,2,4,0
70639,3,3,247413,247414,247417,1,4,0
70640,6,3,247419,247419,247422,0,3,2
70641,5,3,247424,247424,247427,0,3,2
70642,6,2,247430,247430,247432,0,2,3
70643,2,3,247432,247432,247435,0,3,0
70644,5,2,247437,247437,247439,0,2,2
70645,3,1,247440,247440,247441,0,1,1
70646,5,1,247445,247445,247446,0,1,4
70647,1,1,247446,247446,247447,0,1,0
70648,1,2,247447,247447,247449,0,2,0
70649,6,1,247453,247453,247454,0,1,4
70650,1,1,247454,247454,247455,0,1,0
70651,2,1,247456,247456,247457,0,1,1
70652,3,3,247459,247459,247462,0,3,2
70653,6,1,247465,247465,247466,0,1,3
70654,5,2,247470,247470,247472,0,2,4
70655,1,1,247471,247472,247473,1,2,0
70656,4,1,247475,247475,247476,0,1,2
70657,2,3,247477,247477,247480,0,3,1
70658,3,3,247480,247480,247483,0,3,0
70659,3,2,247483,247483,247485,0,2,0
70660,5,2,247488,247488,247490,0,2,3
70661,2,1,247490,247490,247491,0,1,0
70662,1,3,247491,247491,247494,0,3,0
70663,5,3,247496,247496,247499,0,3,2
70664,4,2,247500,247500,247502,0,2,1
70665,5,2,247505,247505,247507,0,2,3
70666,4,1,247509,247509,247510,0,1,2
70667,5,1,247514,247514,247515,0,1,4
70668,4,2,247518,247518,247520,0,2,3
70669,2,2,247520,247520,247522,0,2,0
70670,1,1,247521,247522,247523,1,2,0
70671,1,3,247522,247523,247526,1,4,0
70672,4,3,247526,247526,247529,0,3,0
70673,4,2,247530,247530,247532,0,2,1
70674,1,3,247531,247532,247535,1,4,0
70675,5,3,247536,247536,247539,0,3,1
70676,3,2,247539,247539,247541,0,2,0
70677,1,2,247540,247541,247543,1,3,0
70678,1,1,247541,247543,247544,2,3,0
70679,3,3,247544,247544,247547,0,3,0
70680,5,2,247549,247549,247551,0,2,2
70681,4,1,247553,247553,247554,0,1,2
70682,6,2,247559,247559,247561,0,2,5
70683,4,2,247563,247563,247565,0,2,2
70684,5,2,247568,247568,247570,0,2,3
70685,2,1,247570,247570,247571,0,1,0
70686,6,1,247576,247576,247577,0,1,5
70687,2,3,247578,247578,247581,0,3,1
70688,5,2,247583,247583,247585,0,2,2
70689,6,3,247589,247589,247592,0,3,4
70690,5,3,247594,247594,247597,0,3,2
70691,3,2,247597,247597,247599,0,2,0
70692,1,1,247598,247599,247600,1,2,0
70693,2,2,247600,247600,247602,0,2,0
70694,2,2,247602,247602,247604,0,2,0
70695,6,3,247608,247608,247611,0,3,4
70696,2,2,247610,247611,247613,1,3,0
70697,5,3,247615,247615,247618,0,3,2
70698,2,3,247617,247618,247621,1,4,0
70699,4,3,247621,247621,247624,0,3,0
70700,1,3,247622,247624,247627,2,5,0
70701,3,3,247625,247627,247630,2,5,0
70702,5,2,247630,247630,247632,0,2,0
70703,6,3,247636,247636,247639,0,3,4
70704,6,3,247642,247642,247645,0,3,3
70705,5,1,247647,247647,247648,0,1,2
70706,1,3,247648,247648,247651,0,3,0
70707,2,3,247650,247651,247654,1,4,0
70708,3,3,247653,247654,247657,1,4,0
70709,2,3,247655,247657,247660,2,5,0
70710,6,1,247661,247661,247662,0,1,1
70711,4,1,247665,247665,247666,0,1,3
70712,6,3,247671,247671,247674,0,3,5
70713,2,2,247673,247674,247676,1,3,0
70714,6,2,247679,247679,247681,0,2,3
70715,2,3,247681,247681,247684,0,3,0
70716,2,3,247683,247684,247687,1,4,0
70717,2,1,247685,247687,247688,2,3,0
70718,1,1,247686,247688,247689,2,3,0
70719,3,3,247689,247689,247692,0,3,0
70720,5,2,247694,247694,247696,0,2,2
70721,3,3,247697,247697,247700,0,3,1
70722,6,2,247703,247703,247705,0,2,3
70723,6,3,247709,247709,247712,0,3,4
70724,1,2,247710,247712,247714,2,4,0
70725,2,2,247712,247714,247716,2,4,0
70726,1,1,247713,247716,247717,3,4,0
70727,6,1,247719,247719,247720,0,1,2
70728,1,1,247720,247720,247721,0,1,0
70729,3,2,247723,247723,247725,0,2,2
70730,2,1,247725,247725,247726,0,1,0
70731,6,3,247731,247731,247734,0,3,5
70732,4,1,247735,247735,247736,0,1,1
70733,4,3,247739,247739,247742,0,3,3
70734,5,2,247744,247744,247746,0,2,2
70735,6,1,247750,247750,247751,0,1,4
70736,3,1,247753,247753,247754,0,1,2
70737,1,2,247754,247754,247756,0,2,0
70738,1,3,247755,247756,247759,1,4,0
70739,3,2,247758,247759,247761,1,3,0
70740,5,3,247763,247763,247766,0,3,2
70741,4,1,247767,247767,247768,0,1,1
70742,3,1,247770,247770,247771,0,1,2
70743,2,3,247772,247772,247775,0,3,1
70744,2,2,247774,247775,247777,1,3,0
70745,6,1,247780,247780,247781,0,1,3
70746,2,3,247782,247782,247785,0,3,1
70747,5,1,247787,247787,247788,0,1,2
70748,6,2,247793,247793,247795,0,2,5
70749,3,2,247796,247796,247798,0,2,1
70750,2,1,247798,247798,247799,0,1,0
70751,3,1,247801,247801,247802,0,1,2
70752,3,1,247804,247804,247805,0,1,2
70753,2,3,247806,247806,247809,0,3,1
70754,1,1,247807,247809,247810,2,3,0
70755,3,3,247810,247810,247813,0,3,0
70756,3,2,247813,247813,247815,0,2,0
70757,5,2,247818,247818,247820,0,2,3
70758,2,3,247820,247820,247823,0,3,0
70759,4,1,247824,247824,247825,0,1,1
70760,2,2,247826,247826,247828,0,2,1
70761,1,1,247827,247828,247829,1,2,0
70762,5,2,247832,247832,247834,0,2,3
70763,5,1,247837,247837,247838,0,1,3
70764,1,2,247838,247838,247840,0,2,0
70765,3,2,247841,247841,247843,0,2,1
70766,3,2,247844,247844,247846,0,2,1
70767,1,3,247845,247846,247849,1,4,0
70768,2,3,247847,247849,247852,2,5,0
70769,6,3,247853,247853,247856,0,3,1
70770,6,3,247859,247859,247862,0,3,3
70771,1,1,247860,247862,247863,2,3,0
70772,1,3,247861,247863,247866,2,5,0
70773,1,3,247862,247866,247869,4,7,0
70774,5,3,247867,247869,247872,2,5,0
70775,5,1,247872,247872,247873,0,1,0
70776,5,1,247877,247877,247878,0,1,4
70777,1,1,247878,247878,247879,0,1,0
70778,4,1,247882,247882,247883,0,1,3
70779,5,3,247887,247887,247890,0,3,4
70780,6,3,247893,247893,247896,0,3,3
70781,4,1,247897,247897,247898,0,1,1
70782,4,2,247901,247901,247903,0,2,3
70783,5,3,247906,247906,247909,0,3,3
70784,6,1,247912,247912,247913,0,1,3
70785,3,1,247915,247915,247916,0,1,2
70786,1,2,247916,247916,247918,0,2,0
70787,3,3,247919,247919,247922,0,3,1
70788,2,2,247921,247922,247924,1,3,0
70789,1,3,247922,247924,247927,2,5,0
70790,3,2,247925,247927,247929,2,4,0
70791,1,2,247926,247929,247931,3,5,0
70792,5,1,247931,247931,247932,0,1,0
70793,5,3,247936,247936,247939,0,3,4
70794,4,2,247940,247940,247942,0,2,1
70795,5,2,247945,247945,247947,0,2,3
70796,3,2,247948,247948,247950,0,2,1
70797,4,1,247952,247952,247953,0,1,2
70798,6,2,247958,247958,247960,0,2,5
70799,3,3,247961,247961,247964,0,3,1
70800,4,3,247965,247965,247968,0,3,1
70801,5,2,247970,247970,247972,0,2,2
70802,2,3,247972,247972,247975,0,3,0
70803,3,1,247975,247975,247976,0,1,0
70804,2,2,247977,247977,247979,0,2,1
70805,3,2,247980,247980,247982,0,2,1
70806,1,3,247981,247982,247985,1,4,0
70807,2,3,247983,247985,247988,2,5,0
70808,5,2,247988,247988,247990,0,2,0
70809,2,1,247990,247990,247991,0,1,0
70810,2,3,247992,247992,247995,0,3,1
70811,3,1,247995,247995,247996,0,1,0
70812,2,2,247997,247997,247999,0,2,1
70813,1,1,247998,247999,248000,1,2,0
70814,5,2,248003,248003,248005,0,2,3
70815,4,2,248007,248007,248009,0,2,2
70816,6,1,248013,248013,248014,0,1,4
70817,6,2,248019,248019,248021,0,2,5
70818,5,3,248024,248024,248027,0,3,3
70819,3,1,248027,248027,248028,0,1,0
70820,3,3,248030,248030,248033,0,3,2
70821,1,3,248031,248033,248036,2,5,0
70822,3,1,248034,248036,248037,2,3,0
70823,5,2,248039,248039,248041,0,2,2
70824,6,1,248045,248045,248046,0,1,4
70825,3,2,248048,248048,248050,0,2,2
70826,3,3,248051,248051,248054,0,3,1
70827,2,1,248053,248054,248055,1,2,0
70828,2,2,248055,248055,248057,0,2,0
70829,5,3,248060,248060,248063,0,3,3
70830,4,3,248064,248064,248067,0,3,1
70831,3,2,248067,248067,248069,0,2,0
70832,6,2,248073,248073,248075,0,2,4
70833,3,2,248076,248076,248078,0,2,1
70834,4,2,248080,248080,248082,0,2,2
70835,6,3,248086,248086,248089,0,3,4
70836,4,1,248090,248090,248091,0,1,1
70837,6,3,248096,248096,248099,0,3,5
70838,6,3,248102,248102,248105,0,3,3
70839,1,3,248103,248105,248108,2,5,0
70840,3,1,248106,248108,248109,2,3,0
70841,2,2,248108,248109,248111,1,3,0
70842,1,3,248109,248111,248114,2,5,0
70843,2,3,248111,248114,248117,3,6,0
70844,5,3,248116,248117,248120,1,4,0
70845,2,1,248118,248120,248121,2,3,0
70846,5,2,248123,248123,248125,0,2,2
70847,3,2,248126,248126,248128,0,2,1
70848,1,3,248127,248128,248131,1,4,0
70849,2,1,248129,248131,248132,2,3,0
70850,5,1,248134,248134,248135,0,1,2
70851,1,2,248135,248135,248137,0,2,0
70852,1,2,248136,248137,248139,1,3,0
70853,6,2,248142,248142,248144,0,2,3
70854,5,3,248147,248147,248150,0,3,3
70855,3,2,248150,248150,248152,0,2,0
70856,6,2,248156,248156,248158,0,2,4
70857,2,3,248158,248158,248161,0,3,0
70858,1,1,248159,248161,248162,2,3,0
70859,1,1,248160,248162,248163,2,3,0
70860,6,2,248166,248166,248168,0,2,3
70861,5,3,248171,248171,248174,0,3,3
70862,4,2,248175,248175,248177,0,2,1
70863,5,3,248180,248180,248183,0,3,3
70864,1,3,248181,248183,248186,2,5,0
70865,6,2,248187,248187,248189,0,2,1
70866,3,3,248190,248190,248193,0,3,1
70867,3,1,248193,248193,248194,0,1,0
70868,3,1,248196,248196,248197,0,1,2
70869,3,3,248199,248199,248202,0,3,2
70870,4,3,248203,248203,248206,0,3,1
70871,6,1,248209,248209,248210,0,1,3
70872,3,3,248212,248212,248215,0,3,2
70873,2,3,248214,248215,248218,1,4,0
70874,2,3,248216,248218,248221,2,5,0
70875,3,3,248219,248221,248224,2,5,0
70876,1,3,248220,248224,248227,4,7,0
70877,5,3,248225,248227,248230,2,5,0
70878,1,3,248226,248230,248233,4,7,0
70879,2,2,248228,248233,248235,5,7,0
70880,6,1,248234,248235,248236,1,2,0
70881,2,1,248236,248236,248237,0,1,0
70882,6,1,248242,248242,248243,0,1,5
70883,6,3,248248,248248,248251,0,3,5
70884,6,1,248254,248254,248255,0,1,3
70885,4,2,248258,248258,248260,0,2,3
70886,5,2,248263,248263,248265,0,2,3
70887,2,3,248265,248265,248268,0,3,0
70888,4,1,248269,248269,248270,0,1,1
70889,1,3,248270,248270,248273,0,3,0
70890,3,2,248273,248273,248275,0,2,0
70891,6,2,248279,248279,248281,0,2,4
70892,3,2,248282,248282,248284,0,2,1
70893,4,1,248286,248286,248287,0,1,2
70894,2,1,248288,248288,248289,0,1,1
70895,6,2,248294,248294,248296,0,2,5
70896,4,3,248298,248298,248301,0,3,2
70897,3,3,248301,248301,248304,0,3,0
70898,5,1,248306,248306,248307,0,1,2
70899,3,2,248309,248309,248311,0,2,2
70900,2,1,248311,248311,248312,0,1,0
70901,5,2,248316,248316,248318,0,2,4
70902,1,1,248317,248318,248319,1,2,0
70903,3,1,248320,248320,248321,0,1,1
70904,5,3,248325,248325,248328,0,3,4
70905,5,1,248330,248330,248331,0,1,2
70906,6,3,248336,248336,248339,0,3,5
70907,1,3,248337,248339,248342,2,5,0
70908,2,3,248339,248342,248345,3,6,0
70909,2,3,248341,248345,248348,4,7,0
70910,6,1,248347,248348,248349,1,2,0
70911,2,1,248349,248349,248350,0,1,0
70912,3,2,248352,248352,248354,0,2,2
70913,6,3,248358,248358,248361,0,3,4
70914,3,1,248361,248361,248362,0,1,0
70915,5,2,248366,248366,248368,0,2,4
70916,3,2,248369,248369,248371,0,2,1
70917,6,1,248375,248375,248376,0,1,4
70918,1,2,248376,248376,248378,0,2,0
70919,6,3,248382,248382,248385,0,3,4
70920,5,3,248387,248387,248390,0,3,2
70921,3,1,248390,248390,248391,0,1,0
70922,3,2,248393,248393,248395,0,2,2
70923,2,1,248395,248395,248396,0,1,0
70924,1,1,248396,248396,248397,0,1,0
70925,5,3,248401,248401,248404,0,3,4
70926,5,3,248406,248406,248409,0,3,2
70927,6,1,248412,248412,248413,0,1,3
70928,3,3,248415,248415,248418,0,3,2
70929,4,1,248419,248419,248420,0,1,1
70930,6,1,248425,248425,248426,0,1,5
70931,5,1,248430,248430,248431,0,1,4
70932,6,1,248436,248436,248437,0,1,5
70933,6,2,248442,248442,248444,0,2,5
70934,2,1,248444,248444,248445,0,1,0
70935,3,2,248447,248447,248449,0,2,2
70936,1,2,248448,248449,248451,1,3,0
70937,2,1,248450,248451,248452,1,2,0
70938,2,2,248452,248452,248454,0,2,0
70939,3,3,248455,248455,248458,0,3,1
70940,6,1,248461,248461,248462,0,1,3
70941,1,1,248462,248462,248463,0,1,0
70942,5,3,248467,248467,248470,0,3,4
70943,5,3,248472,248472,248475,0,3,2
70944,4,3,248476,248476,248479,0,3,1
70945,6,2,248482,248482,248484,0,2,3
70946,5,1,248487,248487,248488,0,1,3
70947,2,2,248489,248489,248491,0,2,1
70948,3,3,248492,248492,248495,0,3,1
70949,1,2,248493,248495,248497,2,4,0
70950,1,1,248494,248497,248498,3,4,0
70951,3,1,248497,248498,248499,1,2,0
70952,5,2,248502,248502,248504,0,2,3
70953,5,3,248507,248507,248510,0,3,3
70954,2,2,248509,248510,248512,1,3,0
70955,1,1,248510,248512,248513,2,3,0
70956,6,1,248516,248516,248517,0,1,3
70957,4,3,248520,248520,248523,0,3,3
70958,6,2,248526,248526,248528,0,2,3
70959,4,1,248530,248530,248531,0,1,2
70960,5,1,248535,248535,248536,0,1,4
70961,4,2,248539,248539,248541,0,2,3
70962,3,1,248542,248542,248543,0,1,1
70963,4,2,248546,248546,248548,0,2,3
70964,6,2,248552,248552,248554,0,2,4
70965,5,2,248557,248557,248559,0,2,3
70966,2,1,248559,248559,248560,0,1,0
70967,6,2,248565,248565,248567,0,2,5
70968,4,3,248569,248569,248572,0,3,2
70969,4,3,248573,248573,248576,0,3,1
70970,4,1,248577,248577,248578,0,1,1
70971,5,1,248582,248582,248583,0,1,4
70972,6,1,248588,248588,248589,0,1,5
70973,3,2,248591,248591,248593,0,2,2
70974,4,1,248595,248595,248596,0,1,2
70975,6,1,248601,248601,248602,0,1,5
70976,5,2,248606,248606,248608,0,2,4
70977,3,2,248609,248609,248611,0,2,1
70978,3,2,248612,248612,248614,0,2,1
70979,3,3,248615,248615,248618,0,3,1
70980,6,1,248621,248621,248622,0,1,3
70981,4,3,248625,248625,248628,0,3,3
70982,2,3,248627,248628,248631,1,4,0
70983,6,3,248633,248633,248636,0,3,2
70984,4,2,248637,248637,248639,0,2,1
70985,5,2,248642,248642,248644,0,2,3
70986,4,2,248646,248646,248648,0,2,2
70987,1,1,248647,248648,248649,1,2,0
70988,4,3,248651,248651,248654,0,3,2
70989,4,3,248655,248655,248658,0,3,1
70990,4,2,248659,248659,248661,0,2,1
70991,4,2,248663,248663,248665,0,2,2
70992,5,1,248668,248668,248669,0,1,3
70993,1,2,248669,248669,248671,0,2,0
70994,5,3,248674,248674,248677,0,3,3
70995,4,1,248678,248678,248679,0,1,1
70996,6,2,248684,248684,248686,0,2,5
70997,3,3,248687,248687,248690,0,3,1
70998,1,2,248688,248690,248692,2,4,0
70999,6,1,248694,248694,248695,0,1,2
71000,2,1,248696,248696,248697,0,1,1
71001,1,2,248697,248697,248699,0,2,0
71002,4,3,248701,248701,248704,0,3,2
71003,4,3,248705,248705,248708,0,3,1
71004,3,2,248708,248708,248710,0,2,0
71005,4,3,248712,248712,248715,0,3,2
71006,2,3,248714,248715,248718,1,4,0
71007,3,3,248717,248718,248721,1,4,0
71008,6,2,248723,248723,248725,0,2,2
71009,2,2,248725,248725,248727,0,2,0
71010,3,1,248728,248728,248729,0,1,1
71011,4,3,248732,248732,248735,0,3,3
71012,5,1,248737,248737,248738,0,1,2
71013,3,3,248740,248740,248743,0,3,2
71014,3,2,248743,248743,248745,0,2,0
71015,2,3,248745,248745,248748,0,3,0
71016,4,3,248749,248749,248752,0,3,1
71017,5,2,248754,248754,248756,0,2,2
71018,2,2,248756,248756,248758,0,2,0
71019,5,2,248761,248761,248763,0,2,3
71020,6,1,248767,248767,248768,0,1,4
71021,2,2,248769,248769,248771,0,2,1
71022,3,2,248772,248772,248774,0,2,1
71023,6,1,248778,248778,248779,0,1,4
71024,1,3,248779,248779,248782,0,3,0
71025,1,2,248780,248782,248784,2,4,0
71026,5,2,248785,248785,248787,0,2,1
71027,6,2,248791,248791,248793,0,2,4
71028,6,2,248797,248797,248799,0,2,4
71029,4,3,248801,248801,248804,0,3,2
71030,3,1,248804,248804,248805,0,1,0
71031,2,2,248806,248806,248808,0,2,1
71032,6,3,248812,248812,248815,0,3,4
71033,5,2,248817,248817,248819,0,2,2
71034,6,1,248823,248823,248824,0,1,4
71035,2,1,248825,248825,248826,0,1,1
71036,6,1,248831,248831,248832,0,1,5
71037,6,2,248837,248837,248839,0,2,5
71038,2,2,248839,248839,248841,0,2,0
71039,3,2,248842,248842,248844,0,2,1
71040,3,1,248845,248845,248846,0,1,1
71041,3,1,248848,248848,248849,0,1,2
71042,4,3,248852,248852,248855,0,3,3
71043,6,3,248858,248858,248861,0,3,3
71044,4,2,248862,248862,248864,0,2,1
71045,3,2,248865,248865,248867,0,2,1
71046,3,1,248868,248868,248869,0,1,1
71047,2,2,248870,248870,248872,0,2,1
71048,6,1,248876,248876,248877,0,1,4
71049,4,2,248880,248880,248882,0,2,3
71050,3,1,248883,248883,248884,0,1,1
71051,3,2,248886,248886,248888,0,2,2
71052,6,2,248892,248892,248894,0,2,4
71053,6,2,248898,248898,248900,0,2,4
71054,3,2,248901,248901,248903,0,2,1
71055,5,1,248906,248906,248907,0,1,3
71056,1,2,248907,248907,248909,0,2,0
71057,3,2,248910,248910,248912,0,2,1
71058,4,1,248914,248914,248915,0,1,2
71059,2,1,248916,248916,248917,0,1,1
71060,2,3,248918,248918,248921,0,3,1
71061,1,3,248919,248921,248924,2,5,0
71062,3,3,248922,248924,248927,2,5,0
71063,5,1,248927,248927,248928,0,1,0
71064,2,3,248929,248929,248932,0,3,1
71065,6,1,248935,248935,248936,0,1,3
71066,2,1,248937,248937,248938,0,1,1
71067,6,3,248943,248943,248946,0,3,5
71068,5,3,248948,248948,248951,0,3,2
71069,2,1,248950,248951,248952,1,2,0
71070,2,3,248952,248952,248955,0,3,0
71071,6,2,248958,248958,248960,0,2,3
71072,3,1,248961,248961,248962,0,1,1
71073,5,3,248966,248966,248969,0,3,4
71074,6,2,248972,248972,248974,0,2,3
71075,4,3,248976,248976,248979,0,3,2
71076,5,3,248981,248981,248984,0,3,2
71077,6,3,248987,248987,248990,0,3,3
71078,5,2,248992,248992,248994,0,2,2
71079,1,1,248993,248994,248995,1,2,0
71080,4,2,248997,248997,248999,0,2,2
71081,3,2,249000,249000,249002,0,2,1
71082,1,3,249001,249002,249005,1,4,0
71083,1,3,249002,249005,249008,3,6,0
71084,1,3,249003,249008,249011,5,8,0
71085,4,2,249007,249011,249013,4,6,0
71086,1,3,249008,249013,249016,5,8,0
71087,3,3,249011,249016,249019,5,8,0
71088,6,2,249017,249019,249021,2,4,0
71089,4,2,249021,249021,249023,0,2,0
71090,4,2,249025,249025,249027,0,2,2
71091,6,3,249031,249031,249034,0,3,4
71092,4,2,249035,249035,249037,0,2,1
71093,1,2,249036,249037,249039,1,3,0
71094,6,1,249042,249042,249043,0,1,3
71095,1,1,249043,249043,249044,0,1,0
71096,1,1,249044,249044,249045,0,1,0
71097,2,2,249046,249046,249048,0,2,1
71098,4,3,249050,249050,249053,0,3,2
71099,2,3,249052,249053,249056,1,4,0
71100,4,2,249056,249056,249058,0,2,0
71101,5,2,249061,249061,249063,0,2,3
71102,4,2,249065,249065,249067,0,2,2
71103,6,3,249071,249071,249074,0,3,4
71104,2,1,249073,249074,249075,1,2,0
71105,6,2,249079,249079,249081,0,2,4
71106,1,1,249080,249081,249082,1,2,0
71107,6,2,249086,249086,249088,0,2,4
71108,1,3,249087,249088,249091,1,4,0
71109,2,1,249089,249091,249092,2,3,0
71110,4,2,249093,249093,249095,0,2,1
71111,2,1,249095,249095,249096,0,1,0
71112,4,3,249099,249099,249102,0,3,3
71113,6,3,249105,249105,249108,0,3,3
71114,1,2,249106,249108,249110,2,4,0
71115,4,2,249110,249110,249112,0,2,0
71116,4,3,249114,249114,249117,0,3,2
71117,6,3,249120,249120,249123,0,3,3
71118,4,3,249124,249124,249127,0,3,1
71119,3,3,249127,249127,249130,0,3,0
71120,5,3,249132,249132,249135,0,3,2
71121,1,3,249133,249135,249138,2,5,0
71122,3,2,249136,249138,249140,2,4,0
71123,6,2,249142,249142,249144,0,2,2
71124,4,2,249146,249146,249148,0,2,2
71125,5,3,249151,249151,249154,0,3,3
71126,1,3,249152,249154,249157,2,5,0
71127,2,2,249154,249157,249159,3,5,0
71128,4,1,249158,249159,249160,1,2,0
71129,1,1,249159,249160,249161,1,2,0
71130,2,3,249161,249161,249164,0,3,0
71131,4,2,249165,249165,249167,0,2,1
71132,3,3,249168,249168,249171,0,3,1
71133,2,3,249170,249171,249174,1,4,0
71134,5,2,249175,249175,249177,0,2,1
71135,5,2,249180,249180,249182,0,2,3
71136,1,2,249181,249182,249184,1,3,0
71137,2,2,249183,249184,249186,1,3,0
71138,5,2,249188,249188,249190,0,2,2
71139,2,2,249190,249190,249192,0,2,0
71140,6,2,249196,249196,249198,0,2,4
71141,3,1,249199,249199,249200,0,1,1
71142,1,3,249200,249200,249203,0,3,0
71143,6,2,249206,249206,249208,0,2,3
71144,1,3,249207,249208,249211,1,4,0
71145,5,3,249212,249212,249215,0,3,1
71146,5,1,249217,249217,249218,0,1,2
71147,4,2,249221,249221,249223,0,2,3
71148,3,3,249224,249224,249227,0,3,1
71149,6,1,249230,249230,249231,0,1,3
71150,6,1,249236,249236,249237,0,1,5
71151,4,1,249240,249240,249241,0,1,3
71152,5,3,249245,249245,249248,0,3,4
71153,6,1,249251,249251,249252,0,1,3
71154,4,3,249255,249255,249258,0,3,3
71155,5,2,249260,249260,249262,0,2,2
71156,2,1,249262,249262,249263,0,1,0
71157,4,3,249266,249266,249269,0,3,3
71158,4,1,249270,249270,249271,0,1,1
71159,6,3,249276,249276,249279,0,3,5
71160,6,3,249282,249282,249285,0,3,3
71161,5,3,249287,249287,249290,0,3,2
71162,1,3,249288,249290,249293,2,5,0
71163,2,3,249290,249293,249296,3,6,0
71164,1,3,249291,249296,249299,5,8,0
71165,4,3,249295,249299,249302,4,7,0
71166,3,3,249298,249302,249305,4,7,0
71167,1,3,249299,249305,249308,6,9,0
71168,2,2,249301,249308,249310,7,9,0
71169,1,3,249302,249310,249313,8,11,0
71170,3,3,249305,249313,249316,8,11,0
71171,6,3,249311,249316,249319,5,8,0
71172,3,1,249314,249319,249320,5,6,0
71173,5,1,249319,249320,249321,1,2,0
71174,5,1,249324,249324,249325,0,1,3
71175,1,2,249325,249325,249327,0,2,0
71176,5,2,249330,249330,249332,0,2,3
71177,6,3,249336,249336,249339,0,3,4
71178,5,1,249341,249341,249342,0,1,2
71179,6,2,249347,249347,249349,0,2,5
71180,5,1,249352,249352,249353,0,1,3
71181,2,2,249354,249354,249356,0,2,1
71182,6,2,249360,249360,249362,0,2,4
71183,5,2,249365,249365,249367,0,2,3
71184,6,1,249371,249371,249372,0,1,4
71185,2,1,249373,249373,249374,0,1,1
71186,6,1,249379,249379,249380,0,1,5
71187,1,3,249380,249380,249383,0,3,0
71188,2,2,249382,249383,249385,1,3,0
71189,6,3,249388,249388,249391,0,3,3
71190,6,2,249394,249394,249396,0,2,3
71191,2,3,249396,249396,249399,0,3,0
71192,2,3,249398,249399,249402,1,4,0
71193,3,2,249401,249402,249404,1,3,0
71194,6,2,249407,249407,249409,0,2,3
71195,6,2,249413,249413,249415,0,2,4
71196,5,2,249418,249418,249420,0,2,3
71197,3,3,249421,249421,249424,0,3,1
71198,1,2,249422,249424,249426,2,4,0
71199,3,1,249425,249426,249427,1,2,0
71200,6,3,249431,249431,249434,0,3,4
71201,1,2,249432,249434,249436,2,4,0
71202,1,1,249433,249436,249437,3,4,0
71203,3,3,249436,249437,249440,1,4,0
71204,5,3,249441,249441,249444,0,3,1
71205,6,1,249447,249447,249448,0,1,3
71206,3,3,249450,249450,249453,0,3,2
71207,1,3,249451,249453,249456,2,5,0
71208,1,3,249452,249456,249459,4,7,0
71209,1,1,249453,249459,249460,6,7,0
71210,2,1,249455,249460,249461,5,6,0
71211,6,3,249461,249461,249464,0,3,0
71212,3,2,249464,249464,249466,0,2,0
71213,1,3,249465,249466,249469,1,4,0
71214,3,1,249468,249469,249470,1,2,0
71215,2,2,249470,249470,249472,0,2,0
71216,4,2,249474,249474,249476,0,2,2
71217,3,1,249477,249477,249478,0,1,1
71218,4,2,249481,249481,249483,0,2,3
71219,4,1,249485,249485,249486,0,1,2
71220,5,3,249490,249490,249493,0,3,4
71221,1,2,249491,249493,249495,2,4,0
71222,3,3,249494,249495,249498,1,4,0
71223,4,3,249498,249498,249501,0,3,0
71224,2,2,249500,249501,249503,1,3,0
71225,5,3,249505,249505,249508,0,3,2
71226,1,3,249506,249508,249511,2,5,0
71227,6,3,249512,249512,249515,0,3,1
71228,3,3,249515,249515,249518,0,3,0
71229,4,2,249519,249519,249521,0,2,1
71230,3,2,249522,249522,249524,0,2,1
71231,2,2,249524,249524,249526,0,2,0
71232,5,3,249529,249529,249532,0,3,3
71233,6,1,249535,249535,249536,0,1,3
71234,4,2,249539,249539,249541,0,2,3
71235,6,3,249545,249545,249548,0,3,4
71236,2,3,249547,249548,249551,1,4,0
71237,4,1,249551,249551,249552,0,1,0
71238,4,3,249555,249555,249558,0,3,3
71239,1,3,249556,249558,249561,2,5,0
71240,1,1,249557,249561,249562,4,5,0
71241,6,3,249563,249563,249566,0,3,1
71242,4,2,249567,249567,249569,0,2,1
71243,4,2,249571,249571,249573,0,2,2
71244,3,3,249574,249574,249577,0,3,1
71245,3,2,249577,249577,249579,0,2,0
71246,2,2,249579,249579,249581,0,2,0
71247,3,1,249582,249582,249583,0,1,1
71248,2,3,249584,249584,249587,0,3,1
71249,4,1,249588,249588,249589,0,1,1
71250,2,3,249590,249590,249593,0,3,1
71251,1,1,249591,249593,249594,2,3,0
71252,1,3,249592,249594,249597,2,5,0
71253,1,1,249593,249597,249598,4,5,0
71254,1,2,249594,249598,249600,4,6,0
71255,2,1,249596,249600,249601,4,5,0
71256,6,1,249602,249602,249603,0,1,1
71257,6,2,249608,249608,249610,0,2,5
71258,2,1,249610,249610,249611,0,1,0
71259,5,3,249615,249615,249618,0,3,4
71260,5,2,249620,249620,249622,0,2,2
71261,1,1,249621,249622,249623,1,2,0
71262,2,3,249623,249623,249626,0,3,0
71263,4,2,249627,249627,249629,0,2,1
71264,2,3,249629,249629,249632,0,3,0
71265,2,2,249631,249632,249634,1,3,0
71266,2,2,249633,249634,249636,1,3,0
71267,5,2,249638,249638,249640,0,2,2
71268,3,1,249641,249641,249642,0,1,1
71269,2,3,249643,249643,249646,0,3,1
71270,2,2,249645,249646,249648,1,3,0
71271,2,1,249647,249648,249649,1,2,0
71272,4,1,249651,249651,249652,0,1,2
71273,6,3,249657,249657,249660,0,3,5
71274,6,1,249663,249663,249664,0,1,3
71275,1,2,249664,249664,249666,0,2,0
71276,4,1,249668,249668,249669,0,1,2
71277,1,1,249669,249669,249670,0,1,0
71278,4,1,249673,249673,249674,0,1,3
71279,3,2,249676,249676,249678,0,2,2
71280,6,1,249682,249682,249683,0,1,4
71281,6,3,249688,249688,249691,0,3,5
71282,1,2,249689,249691,249693,2,4,0
71283,5,3,249694,249694,249697,0,3,1
71284,2,1,249696,249697,249698,1,2,0
71285,6,1,249702,249702,249703,0,1,4
71286,4,3,249706,249706,249709,0,3,3
71287,6,3,249712,249712,249715,0,3,3
71288,3,1,249715,249715,249716,0,1,0
71289,6,2,249721,249721,249723,0,2,5
71290,5,1,249726,249726,249727,0,1,3
71291,1,3,249727,249727,249730,0,3,0
71292,5,2,249732,249732,249734,0,2,2
71293,2,3,249734,249734,249737,0,3,0
71294,4,2,249738,249738,249740,0,2,1
71295,3,1,249741,249741,249742,0,1,1
71296,6,1,249747,249747,249748,0,1,5
71297,6,2,249753,249753,249755,0,2,5
71298,1,3,249754,249755,249758,1,4,0
71299,2,2,249756,249758,249760,2,4,0
71300,1,2,249757,249760,249762,3,5,0
71301,5,3,249762,249762,249765,0,3,0
71302,5,3,249767,249767,249770,0,3,2
71303,2,1,249769,249770,249771,1,2,0
71304,5,3,249774,249774,249777,0,3,3
71305,5,3,249779,249779,249782,0,3,2
71306,5,2,249784,249784,249786,0,2,2
71307,1,1,249785,249786,249787,1,2,0
71308,2,2,249787,249787,249789,0,2,0
71309,2,2,249789,249789,249791,0,2,0
71310,2,2,249791,249791,249793,0,2,0
71311,4,1,249795,249795,249796,0,1,2
71312,2,2,249797,249797,249799,0,2,1
71313,2,2,249799,249799,249801,0,2,0
71314,6,1,249805,249805,249806,0,1,4
71315,1,3,249806,249806,249809,0,3,0
71316,3,1,249809,249809,249810,0,1,0
71317,4,3,249813,249813,249816,0,3,3
71318,4,1,249817,249817,249818,0,1,1
71319,6,1,249823,249823,249824,0,1,5
71320,4,3,249827,249827,249830,0,3,3
71321,6,3,249833,249833,249836,0,3,3
71322,6,2,249839,249839,249841,0,2,3
71323,2,2,249841,249841,249843,0,2,0
71324,1,2,249842,249843,249845,1,3,0
71325,2,2,249844,249845,249847,1,3,0
71326,3,3,249847,249847,249850,0,3,0
71327,5,2,249852,249852,249854,0,2,2
71328,5,1,249857,249857,249858,0,1,3
71329,2,3,249859,249859,249862,0,3,1
71330,2,3,249861,249862,249865,1,4,0
71331,6,3,249867,249867,249870,0,3,2
71332,1,3,249868,249870,249873,2,5,0
71333,1,1,249869,249873,249874,4,5,0
71334,5,3,249874,249874,249877,0,3,0
71335,3,1,249877,249877,249878,0,1,0
71336,1,2,249878,249878,249880,0,2,0
71337,6,2,249884,249884,249886,0,2,4
71338,4,2,249888,249888,249890,0,2,2
71339,4,1,249892,249892,249893,0,1,2
71340,5,3,249897,249897,249900,0,3,4
71341,4,3,249901,249901,249904,0,3,1
71342,2,2,249903,249904,249906,1,3,0
71343,2,2,249905,249906,249908,1,3,0
71344,1,2,249906,249908,249910,2,4,0
71345,3,2,249909,249910,249912,1,3,0
71346,2,2,249911,249912,249914,1,3,0
71347,1,2,249912,249914,249916,2,4,0
71348,1,1,249913,249916,249917,3,4,0
71349,5,2,249918,249918,249920,0,2,1
71350,4,1,249922,249922,249923,0,1,2
71351,2,2,249924,249924,249926,0,2,1
71352,3,1,249927,249927,249928,0,1,1
71353,1,1,249928,249928,249929,0,1,0
71354,4,3,249932,249932,249935,0,3,3
71355,2,1,249934,249935,249936,1,2,0
71356,3,3,249937,249937,249940,0,3,1
71357,3,3,249940,249940,249943,0,3,0
71358,5,3,249945,249945,249948,0,3,2
71359,1,2,249946,249948,249950,2,4,0
71360,5,1,249951,249951,249952,0,1,1
71361,3,1,249954,249954,249955,0,1,2
71362,6,3,249960,249960,249963,0,3,5
71363,3,1,249963,249963,249964,0,1,0
71364,6,2,249969,249969,249971,0,2,5
71365,6,2,249975,249975,249977,0,2,4
71366,2,1,249977,249977,249978,0,1,0
71367,5,2,249982,249982,249984,0,2,4
71368,6,2,249988,249988,249990,0,2,4
71369,2,3,249990,249990,249993,0,3,0
71370,2,3,249992,249993,249996,1,4,0
71371,1,2,249993,249996,249998,3,5,0
71372,2,2,249995,249998,250000,3,5,0
71373,4,3,249999,250000,250003,1,4,0
71374,3,1,250002,250003,250004,1,2,0
71375,4,2,250006,250006,250008,0,2,2
71376,5,3,250011,250011,250014,0,3,3
71377,4,2,250015,250015,250017,0,2,1
71378,2,1,250017,250017,250018,0,1,0
71379,2,2,250019,250019,250021,0,2,1
71380,4,1,250023,250023,250024,0,1,2
71381,4,1,250027,250027,250028,0,1,3
71382,3,2,250030,250030,250032,0,2,2
71383,1,3,250031,250032,250035,1,4,0
71384,3,3,250034,250035,250038,1,4,0
71385,2,2,250036,250038,250040,2,4,0
71386,3,3,250039,250040,250043,1,4,0
71387,6,1,250045,250045,250046,0,1,2
71388,3,3,250048,250048,250051,0,3,2
71389,4,1,250052,250052,250053,0,1,1
71390,4,1,250056,250056,250057,0,1,3
71391,4,3,250060,250060,250063,0,3,3
71392,2,1,250062,250063,250064,1,2,0
71393,2,3,250064,250064,250067,0,3,0
71394,1,2,250065,250067,250069,2,4,0
71395,5,1,250070,250070,250071,0,1,1
71396,5,3,250075,250075,250078,0,3,4
71397,5,2,250080,250080,250082,0,2,2
71398,5,3,250085,250085,250088,0,3,3
71399,3,1,250088,250088,250089,0,1,0
71400,6,3,250094,250094,250097,0,3,5
71401,4,3,250098,250098,250101,0,3,1
71402,3,2,250101,250101,250103,0,2,0
71403,6,2,250107,250107,250109,0,2,4
71404,6,1,250113,250113,250114,0,1,4
71405,3,2,250116,250116,250118,0,2,2
71406,3,3,250119,250119,250122,0,3,1
71407,4,1,250123,250123,250124,0,1,1
71408,1,3,250124,250124,250127,0,3,0
71409,1,2,250125,250127,250129,2,4,0
71410,2,1,250127,250129,250130,2,3,0
71411,4,1,250131,250131,250132,0,1,1
71412,1,2,250132,250132,250134,0,2,0
71413,2,2,250134,250134,250136,0,2,0
71414,1,1,250135,250136,250137,1,2,0
71415,4,2,250139,250139,250141,0,2,2
71416,1,1,250140,250141,250142,1,2,0
71417,5,3,250145,250145,250148,0,3,3
71418,6,1,250151,250151,250152,0,1,3
71419,2,1,250153,250153,250154,0,1,1
71420,6,2,250159,250159,250161,0,2,5
71421,1,2,250160,250161,250163,1,3,0
71422,6,3,250166,250166,250169,0,3,3
71423,3,1,250169,250169,250170,0,1,0
71424,4,2,250173,250173,250175,0,2,3
71425,5,2,250178,250178,250180,0,2,3
71426,6,2,250184,250184,250186,0,2,4
71427,3,3,250187,250187,250190,0,3,1
71428,6,2,250193,250193,250195,0,2,3
71429,3,3,250196,250196,250199,0,3,1
71430,2,1,250198,250199,250200,1,2,0
71431,1,1,250199,250200,250201,1,2,0
71432,3,1,250202,250202,250203,0,1,1
71433,2,2,250204,250204,250206,0,2,1
71434,4,1,250208,250208,250209,0,1,2
71435,5,2,250213,250213,250215,0,2,4
71436,5,2,250218,250218,250220,0,2,3
71437,5,1,250223,250223,250224,0,1,3
71438,3,1,250226,250226,250227,0,1,2
71439,4,1,250230,250230,250231,0,1,3
71440,6,3,250236,250236,250239,0,3,5
71441,4,1,250240,250240,250241,0,1,1
71442,3,3,250243,250243,250246,0,3,2
71443,3,2,250246,250246,250248,0,2,0
71444,1,1,250247,250248,250249,1,2,0
71445,1,3,250248,250249,250252,1,4,0
71446,1,3,250249,250252,250255,3,6,0
71447,6,3,250255,250255,250258,0,3,0
71448,4,3,250259,250259,250262,0,3,1
71449,4,3,250263,250263,250266,0,3,1
71450,6,3,250269,250269,250272,0,3,3
71451,5,2,250274,250274,250276,0,2,2
71452,4,3,250278,250278,250281,0,3,2
71453,4,2,250282,250282,250284,0,2,1
71454,2,3,250284,250284,250287,0,3,0
71455,5,2,250289,250289,250291,0,2,2
71456,4,1,250293,250293,250294,0,1,2
71457,5,2,250298,250298,250300,0,2,4
71458,2,2,250300,250300,250302,0,2,0
71459,4,2,250304,250304,250306,0,2,2
71460,2,1,250306,250306,250307,0,1,0
71461,4,3,250310,250310,250313,0,3,3
71462,5,2,250315,250315,250317,0,2,2
71463,6,2,250321,250321,250323,0,2,4
71464,2,1,250323,250323,250324,0,1,0
71465,3,2,250326,250326,250328,0,2,2
71466,1,1,250327,250328,250329,1,2,0
71467,5,3,250332,250332,250335,0,3,3
71468,6,2,250338,250338,250340,0,2,3
71469,5,2,250343,250343,250345,0,2,3
71470,3,3,250346,250346,250349,0,3,1
71471,5,1,250351,250351,250352,0,1,2
71472,3,1,250354,250354,250355,0,1,2
71473,6,2,250360,250360,250362,0,2,5
71474,4,3,250364,250364,250367,0,3,2
71475,4,1,250368,250368,250369,0,1,1
71476,2,2,250370,250370,250372,0,2,1
71477,4,1,250374,250374,250375,0,1,2
71478,3,2,250377,250377,250379,0,2,2
71479,4,3,250381,250381,250384,0,3,2
71480,1,2,250382,250384,250386,2,4,0
71481,4,1,250386,250386,250387,0,1,0
71482,2,1,250388,250388,250389,0,1,1
71483,1,1,250389,250389,250390,0,1,0
71484,5,1,250394,250394,250395,0,1,4
71485,3,1,250397,250397,250398,0,1,2
71486,3,1,250400,250400,250401,0,1,2
71487,1,3,250401,250401,250404,0,3,0
71488,5,2,250406,250406,250408,0,2,2
71489,4,1,250410,250410,250411,0,1,2
71490,4,3,250414,250414,250417,0,3,3
71491,1,2,250415,250417,250419,2,4,0
71492,6,1,250421,250421,250422,0,1,2
71493,1,2,250422,250422,250424,0,2,0
71494,1,3,250423,250424,250427,1,4,0
71495,2,1,250425,250427,250428,2,3,0
71496,6,3,250431,250431,250434,0,3,3
71497,2,2,250433,250434,250436,1,3,0
71498,2,2,250435,250436,250438,1,3,0
71499,1,1,250436,250438,250439,2,3,0
71500,5,1,250441,250441,250442,0,1,2
71501,5,3,250446,250446,250449,0,3,4
71502,1,1,250447,250449,250450,2,3,0
71503,4,2,250451,250451,250453,0,2,1
71504,2,2,250453,250453,250455,0,2,0
71505,5,1,250458,250458,250459,0,1,3
71506,4,3,250462,250462,250465,0,3,3
71507,5,3,250467,250467,250470,0,3,2
71508,6,1,250473,250473,250474,0,1,3
71509,2,2,250475,250475,250477,0,2,1
71510,1,2,250476,250477,250479,1,3,0
71511,5,1,250481,250481,250482,0,1,2
71512,3,1,250484,250484,250485,0,1,2
71513,3,1,250487,250487,250488,0,1,2
71514,6,1,250493,250493,250494,0,1,5
71515,3,1,250496,250496,250497,0,1,2
71516,2,2,250498,250498,250500,0,2,1
71517,6,3,250504,250504,250507,0,3,4
71518,4,3,250508,250508,250511,0,3,1
71519,6,3,250514,250514,250517,0,3,3
71520,5,1,250519,250519,250520,0,1,2
71521,6,2,250525,250525,250527,0,2,5
71522,2,1,250527,250527,250528,0,1,0
71523,2,3,250529,250529,250532,0,3,1
71524,6,2,250535,250535,250537,0,2,3
71525,2,2,250537,250537,250539,0,2,0
71526,5,2,250542,250542,250544,0,2,3
71527,6,1,250548,250548,250549,0,1,4
71528,4,2,250552,250552,250554,0,2,3
71529,5,3,250557,250557,250560,0,3,3
71530,1,3,250558,250560,250563,2,5,0
71531,5,3,250563,250563,250566,0,3,0
71532,2,3,250565,250566,250569,1,4,0
71533,6,1,250571,250571,250572,0,1,2
71534,4,3,250575,250575,250578,0,3,3
71535,4,1,250579,250579,250580,0,1,1
71536,5,1,250584,250584,250585,0,1,4
71537,6,1,250590,250590,250591,0,1,5
71538,3,2,250593,250593,250595,0,2,2
71539,2,3,250595,250595,250598,0,3,0
71540,4,2,250599,250599,250601,0,2,1
71541,2,1,250601,250601,250602,0,1,0
71542,5,3,250606,250606,250609,0,3,4
71543,2,2,250608,250609,250611,1,3,0
71544,6,1,250614,250614,250615,0,1,3
71545,6,2,250620,250620,250622,0,2,5
71546,3,1,250623,250623,250624,0,1,1
71547,4,2,250627,250627,250629,0,2,3
71548,3,3,250630,250630,250633,0,3,1
71549,6,1,250636,250636,250637,0,1,3
71550,4,2,250640,250640,250642,0,2,3
71551,2,1,250642,250642,250643,0,1,0
71552,1,2,250643,250643,250645,0,2,0
71553,3,1,250646,250646,250647,0,1,1
71554,1,3,250647,250647,250650,0,3,0
71555,3,3,250650,250650,250653,0,3,0
71556,5,1,250655,250655,250656,0,1,2
71557,4,1,250659,250659,250660,0,1,3
71558,3,1,250662,250662,250663,0,1,2
71559,4,3,250666,250666,250669,0,3,3
71560,5,1,250671,250671,250672,0,1,2
71561,5,1,250676,250676,250677,0,1,4
71562,6,2,250682,250682,250684,0,2,5
71563,1,3,250683,250684,250687,1,4,0
71564,5,1,250688,250688,250689,0,1,1
71565,4,1,250692,250692,250693,0,1,3
71566,1,3,250693,250693,250696,0,3,0
71567,3,1,250696,250696,250697,0,1,0
71568,1,3,250697,250697,250700,0,3,0
71569,2,3,250699,250700,250703,1,4,0
71570,5,2,250704,250704,250706,0,2,1
71571,1,2,250705,250706,250708,1,3,0
71572,5,3,250710,250710,250713,0,3,2
71573,1,3,250711,250713,250716,2,5,0
71574,1,2,250712,250716,250718,4,6,0
71575,6,2,250718,250718,250720,0,2,0
71576,3,1,250721,250721,250722,0,1,1
71577,3,1,250724,250724,250725,0,1,2
71578,5,2,250729,250729,250731,0,2,4
71579,3,2,250732,250732,250734,0,2,1
71580,5,1,250737,250737,250738,0,1,3
71581,3,3,250740,250740,250743,0,3,2
71582,2,2,250742,250743,250745,1,3,0
71583,3,3,250745,250745,250748,0,3,0
71584,5,3,250750,250750,250753,0,3,2
71585,3,1,250753,250753,250754,0,1,0
71586,3,3,250756,250756,250759,0,3,2
71587,2,1,250758,250759,250760,1,2,0
71588,4,1,250762,250762,250763,0,1,2
71589,1,1,250763,250763,250764,0,1,0
71590,5,3,250768,250768,250771,0,3,4
71591,3,3,250771,250771,250774,0,3,0
71592,3,1,250774,250774,250775,0,1,0
71593,3,2,250777,250777,250779,0,2,2
71594,3,1,250780,250780,250781,0,1,1
71595,2,1,250782,250782,250783,0,1,1
71596,4,3,250786,250786,250789,0,3,3
71597,6,3,250792,250792,250795,0,3,3
71598,4,2,250796,250796,250798,0,2,1
71599,6,2,250802,250802,250804,0,2,4
71600,6,1,250808,250808,250809,0,1,4
71601,6,2,250814,250814,250816,0,2,5
71602,3,3,250817,250817,250820,0,3,1
71603,1,3,250818,250820,250823,2,5,0
71604,6,2,250824,250824,250826,0,2,1
71605,2,1,250826,250826,250827,0,1,0
71606,6,2,250832,250832,250834,0,2,5
71607,5,1,250837,250837,250838,0,1,3
71608,1,2,250838,250838,250840,0,2,0
71609,5,2,250843,250843,250845,0,2,3
71610,1,3,250844,250845,250848,1,4,0
71611,1,1,250845,250848,250849,3,4,0
71612,6,1,250851,250851,250852,0,1,2
71613,5,3,250856,250856,250859,0,3,4
71614,3,3,250859,250859,250862,0,3,0
71615,1,2,250860,250862,250864,2,4,0
71616,5,2,250865,250865,250867,0,2,1
71617,1,1,250866,250867,250868,1,2,0
71618,4,3,250870,250870,250873,0,3,2
71619,4,1,250874,250874,250875,0,1,1
71620,5,2,250879,250879,250881,0,2,4
71621,2,1,250881,250881,250882,0,1,0
71622,6,2,250887,250887,250889,0,2,5
71623,5,2,250892,250892,250894,0,2,3
71624,6,2,250898,250898,250900,0,2,4
71625,2,3,250900,250900,250903,0,3,0
71626,5,1,250905,250905,250906,0,1,2
71627,6,1,250911,250911,250912,0,1,5
71628,2,1,250913,250913,250914,0,1,1
71629,4,1,250917,250917,250918,0,1,3
71630,2,1,250919,250919,250920,0,1,1
71631,2,3,250921,250921,250924,0,3,1
71632,6,1,250927,250927,250928,0,1,3
71633,5,1,250932,250932,250933,0,1,4
71634,3,3,250935,250935,250938,0,3,2
71635,2,2,250937,250938,250940,1,3,0
71636,2,3,250939,250940,250943,1,4,0
71637,2,2,250941,250943,250945,2,4,0
71638,6,1,250947,250947,250948,0,1,2
71639,5,1,250952,250952,250953,0,1,4
71640,5,1,250957,250957,250958,0,1,4
71641,6,3,250963,250963,250966,0,3,5
71642,4,1,250967,250967,250968,0,1,1
71643,4,1,250971,250971,250972,0,1,3
71644,4,1,250975,250975,250976,0,1,3
71645,6,2,250981,250981,250983,0,2,5
71646,4,2,250985,250985,250987,0,2,2
71647,4,2,250989,250989,250991,0,2,2
71648,2,2,250991,250991,250993,0,2,0
71649,3,1,250994,250994,250995,0,1,1
71650,2,1,250996,250996,250997,0,1,1
71651,6,1,251002,251002,251003,0,1,5
71652,5,2,251007,251007,251009,0,2,4
71653,4,1,251011,251011,251012,0,1,2
71654,2,1,251013,251013,251014,0,1,1
71655,2,2,251015,251015,251017,0,2,1
71656,3,2,251018,251018,251020,0,2,1
71657,5,3,251023,251023,251026,0,3,3
71658,3,3,251026,251026,251029,0,3,0
71659,2,1,251028,251029,251030,1,2,0
71660,1,1,251029,251030,251031,1,2,0
71661,5,3,251034,251034,251037,0,3,3
71662,2,2,251036,251037,251039,1,3,0
71663,4,3,251040,251040,251043,0,3,1
71664,5,1,251045,251045,251046,0,1,2
71665,6,3,251051,251051,251054,0,3,5
71666,2,2,251053,251054,251056,1,3,0
71667,5,1,251058,251058,251059,0,1,2
71668,2,1,251060,251060,251061,0,1,1
71669,4,2,251064,251064,251066,0,2,3
71670,6,2,251070,251070,251072,0,2,4
71671,3,3,251073,251073,251076,0,3,1
71672,3,2,251076,251076,251078,0,2,0
71673,5,2,251081,251081,251083,0,2,3
71674,1,3,251082,251083,251086,1,4,0
71675,6,1,251088,251088,251089,0,1,2
71676,5,2,251093,251093,251095,0,2,4
71677,1,3,251094,251095,251098,1,4,0
71678,1,1,251095,251098,251099,3,4,0
71679,5,2,251100,251100,251102,0,2,1
71680,6,3,251106,251106,251109,0,3,4
71681,4,1,251110,251110,251111,0,1,1
71682,2,1,251112,251112,251113,0,1,1
71683,4,2,251116,251116,251118,0,2,3
71684,1,2,251117,251118,251120,1,3,0
71685,5,2,251122,251122,251124,0,2,2
71686,4,1,251126,251126,251127,0,1,2
71687,6,1,251132,251132,251133,0,1,5
71688,4,1,251136,251136,251137,0,1,3
71689,1,1,251137,251137,251138,0,1,0
71690,1,3,251138,251138,251141,0,3,0
71691,2,2,251140,251141,251143,1,3,0
71692,3,3,251143,251143,251146,0,3,0
71693,6,1,251149,251149,251150,0,1,3
71694,6,1,251155,251155,251156,0,1,5
71695,3,2,251158,251158,251160,0,2,2
71696,2,1,251160,251160,251161,0,1,0
71697,1,2,251161,251161,251163,0,2,0
71698,4,1,251165,251165,251166,0,1,2
71699,3,1,251168,251168,251169,0,1,2
71700,3,2,251171,251171,251173,0,2,2
71701,3,2,251174,251174,251176,0,2,1
71702,3,3,251177,251177,251180,0,3,1
71703,5,3,251182,251182,251185,0,3,2
71704,6,1,251188,251188,251189,0,1,3
71705,1,1,251189,251189,251190,0,1,0
71706,3,3,251192,251192,251195,0,3,2
71707,5,3,251197,251197,251200,0,3,2
71708,2,3,251199,251200,251203,1,4,0
71709,6,1,251205,251205,251206,0,1,2
71710,3,2,251208,251208,251210,0,2,2
71711,4,3,251212,251212,251215,0,3,2
71712,6,1,251218,251218,251219,0,1,3
71713,4,3,251222,251222,251225,0,3,3
71714,3,1,251225,251225,251226,0,1,0
71715,3,3,251228,251228,251231,0,3,2
71716,3,1,251231,251231,251232,0,1,0
71717,2,3,251233,251233,251236,0,3,1
71718,6,3,251239,251239,251242,0,3,3
71719,6,2,251245,251245,251247,0,2,3
71720,2,3,251247,251247,251250,0,3,0
71721,5,3,251252,251252,251255,0,3,2
71722,2,1,251254,251255,251256,1,2,0
71723,1,3,251255,251256,251259,1,4,0
71724,6,1,251261,251261,251262,0,1,2
71725,6,2,251267,251267,251269,0,2,5
71726,6,2,251273,251273,251275,0,2,4
71727,3,3,251276,251276,251279,0,3,1
71728,3,1,251279,251279,251280,0,1,0
71729,2,2,251281,251281,251283,0,2,1
71730,5,3,251286,251286,251289,0,3,3
71731,5,3,251291,251291,251294,0,3,2
71732,4,3,251295,251295,251298,0,3,1
71733,2,3,251297,251298,251301,1,4,0
71734,6,3,251303,251303,251306,0,3,2
71735,2,2,251305,251306,251308,1,3,0
71736,3,2,251308,251308,251310,0,2,0
71737,3,1,251311,251311,251312,0,1,1
71738,3,3,251314,251314,251317,0,3,2
71739,2,2,251316,251317,251319,1,3,0
71740,3,1,251319,251319,251320,0,1,0
71741,2,1,251321,251321,251322,0,1,1
71742,6,2,251327,251327,251329,0,2,5
71743,2,1,251329,251329,251330,0,1,0
71744,3,1,251332,251332,251333,0,1,2
71745,2,3,251334,251334,251337,0,3,1
71746,3,2,251337,251337,251339,0,2,0
71747,6,2,251343,251343,251345,0,2,4
71748,6,3,251349,251349,251352,0,3,4
71749,1,3,251350,251352,251355,2,5,0
71750,2,3,251352,251355,251358,3,6,0
71751,3,2,251355,251358,251360,3,5,0
71752,2,2,251357,251360,251362,3,5,0
71753,4,3,251361,251362,251365,1,4,0
71754,3,1,251364,251365,251366,1,2,0
71755,4,2,251368,251368,251370,0,2,2
71756,6,1,251374,251374,251375,0,1,4
71757,6,3,251380,251380,251383,0,3,5
71758,3,1,251383,251383,251384,0,1,0
71759,4,1,251387,251387,251388,0,1,3
71760,1,3,251388,251388,251391,0,3,0
71761,1,3,251389,251391,251394,2,5,0
71762,2,1,251391,251394,251395,3,4,0
71763,6,1,251397,251397,251398,0,1,2
71764,2,2,251399,251399,251401,0,2,1
71765,2,1,251401,251401,251402,0,1,0
71766,4,2,251405,251405,251407,0,2,3
71767,5,3,251410,251410,251413,0,3,3
71768,5,3,251415,251415,251418,0,3,2
71769,6,1,251421,251421,251422,0,1,3
71770,3,2,251424,251424,251426,0,2,2
71771,6,3,251430,251430,251433,0,3,4
71772,3,2,251433,251433,251435,0,2,0
71773,4,1,251437,251437,251438,0,1,2
71774,1,1,251438,251438,251439,0,1,0
71775,1,1,251439,251439,251440,0,1,0
71776,2,1,251441,251441,251442,0,1,1
71777,4,1,251445,251445,251446,0,1,3
71778,3,2,251448,251448,251450,0,2,2
71779,5,2,251453,251453,251455,0,2,3
71780,4,3,251457,251457,251460,0,3,2
71781,5,1,251462,251462,251463,0,1,2
71782,3,2,251465,251465,251467,0,2,2
71783,4,1,251469,251469,251470,0,1,2
71784,1,3,251470,251470,251473,0,3,0
71785,2,2,251472,251473,251475,1,3,0
71786,2,1,251474,251475,251476,1,2,0
71787,6,1,251480,251480,251481,0,1,4
71788,2,2,251482,251482,251484,0,2,1
71789,4,3,251486,251486,251489,0,3,2
71790,4,2,251490,251490,251492,0,2,1
71791,4,2,251494,251494,251496,0,2,2
71792,2,3,251496,251496,251499,0,3,0
71793,3,2,251499,251499,251501,0,2,0
71794,6,3,251505,251505,251508,0,3,4
71795,5,2,251510,251510,251512,0,2,2
71796,3,2,251513,251513,251515,0,2,1
71797,4,2,251517,251517,251519,0,2,2
71798,6,2,251523,251523,251525,0,2,4
71799,6,3,251529,251529,251532,0,3,4
71800,1,3,251530,251532,251535,2,5,0
71801,1,2,251531,251535,251537,4,6,0
71802,1,1,251532,251537,251538,5,6,0
71803,1,1,251533,251538,251539,5,6,0
71804,5,1,251538,251539,251540,1,2,0
71805,1,2,251539,251540,251542,1,3,0
71806,1,1,251540,251542,251543,2,3,0
71807,1,1,251541,251543,251544,2,3,0
71808,3,2,251544,251544,251546,0,2,0
71809,3,2,251547,251547,251549,0,2,1
71810,3,2,251550,251550,251552,0,2,1
71811,2,3,251552,251552,251555,0,3,0
71812,2,1,251554,251555,251556,1,2,0
71813,4,2,251558,251558,251560,0,2,2
71814,6,2,251564,251564,251566,0,2,4
71815,5,3,251569,251569,251572,0,3,3
71816,2,3,251571,251572,251575,1,4,0
71817,6,2,251577,251577,251579,0,2,2
71818,4,3,251581,251581,251584,0,3,2
71819,1,1,251582,251584,251585,2,3,0
71820,6,2,251588,251588,251590,0,2,3
71821,1,3,251589,251590,251593,1,4,0
71822,2,2,251591,251593,251595,2,4,0
71823,3,2,251594,251595,251597,1,3,0
71824,2,3,251596,251597,251600,1,4,0
71825,3,3,251599,251600,251603,1,4,0
71826,2,1,251601,251603,251604,2,3,0
71827,2,2,251603,251604,251606,1,3,0
71828,3,1,251606,251606,251607,0,1,0
71829,5,3,251611,251611,251614,0,3,4
71830,2,3,251613,251614,251617,1,4,0
71831,4,1,251617,251617,251618,0,1,0
71832,5,2,251622,251622,251624,0,2,4
71833,6,1,251628,251628,251629,0,1,4
71834,4,3,251632,251632,251635,0,3,3
71835,2,2,251634,251635,251637,1,3,0
71836,5,1,251639,251639,251640,0,1,2
71837,4,3,251643,251643,251646,0,3,3
71838,5,2,251648,251648,251650,0,2,2
71839,2,1,251650,251650,251651,0,1,0
71840,3,3,251653,251653,251656,0,3,2
71841,1,1,251654,251656,251657,2,3,0
71842,4,3,251658,251658,251661,0,3,1
71843,5,2,251663,251663,251665,0,2,2
71844,5,3,251668,251668,251671,0,3,3
71845,3,1,251671,251671,251672,0,1,0
71846,6,2,251677,251677,251679,0,2,5
71847,6,1,251683,251683,251684,0,1,4
71848,2,3,251685,251685,251688,0,3,1
71849,2,2,251687,251688,251690,1,3,0
71850,5,2,251692,251692,251694,0,2,2
71851,5,3,251697,251697,251700,0,3,3
71852,1,3,251698,251700,251703,2,5,0
71853,2,3,251700,251703,251706,3,6,0
71854,4,1,251704,251706,251707,2,3,0
71855,5,2,251709,251709,251711,0,2,2
71856,5,3,251714,251714,251717,0,3,3
71857,2,2,251716,251717,251719,1,3,0
71858,1,2,251717,251719,251721,2,4,0
71859,3,3,251720,251721,251724,1,4,0
71860,6,3,251726,251726,251729,0,3,2
71861,6,1,251732,251732,251733,0,1,3
71862,1,1,251733,251733,251734,0,1,0
71863,2,3,251735,251735,251738,0,3,1
71864,5,2,251740,251740,251742,0,2,2
71865,4,1,251744,251744,251745,0,1,2
71866,2,3,251746,251746,251749,0,3,1
71867,4,3,251750,251750,251753,0,3,1
71868,6,3,251756,251756,251759,0,3,3
71869,2,3,251758,251759,251762,1,4,0
71870,4,3,251762,251762,251765,0,3,0
71871,2,3,251764,251765,251768,1,4,0
71872,4,2,251768,251768,251770,0,2,0
71873,5,2,251773,251773,251775,0,2,3
71874,2,3,251775,251775,251778,0,3,0
71875,4,1,251779,251779,251780,0,1,1
71876,6,3,251785,251785,251788,0,3,5
71877,5,2,251790,251790,251792,0,2,2
71878,5,3,251795,251795,251798,0,3,3
71879,1,2,251796,251798,251800,2,4,0
71880,2,2,251798,251800,251802,2,4,0
71881,3,3,251801,251802,251805,1,4,0
71882,4,3,251805,251805,251808,0,3,0
71883,3,1,251808,251808,251809,0,1,0
71884,1,3,251809,251809,251812,0,3,0
71885,4,2,251813,251813,251815,0,2,1
71886,6,3,251819,251819,251822,0,3,4
71887,3,3,251822,251822,251825,0,3,0
71888,6,2,251828,251828,251830,0,2,3
71889,2,1,251830,251830,251831,0,1,0
71890,3,1,251833,251833,251834,0,1,2
71891,6,3,251839,251839,251842,0,3,5
71892,5,2,251844,251844,251846,0,2,2
71893,1,2,251845,251846,251848,1,3,0
71894,4,2,251849,251849,251851,0,2,1
71895,4,2,251853,251853,251855,0,2,2
71896,5,2,251858,251858,251860,0,2,3
71897,6,2,251864,251864,251866,0,2,4
71898,1,3,251865,251866,251869,1,4,0
71899,6,3,251871,251871,251874,0,3,2
71900,4,1,251875,251875,251876,0,1,1
71901,5,2,251880,251880,251882,0,2,4
71902,2,2,251882,251882,251884,0,2,0
71903,6,2,251888,251888,251890,0,2,4
71904,2,3,251890,251890,251893,0,3,0
71905,6,3,251896,251896,251899,0,3,3
71906,2,2,251898,251899,251901,1,3,0
71907,1,2,251899,251901,251903,2,4,0
71908,1,2,251900,251903,251905,3,5,0
71909,5,2,251905,251905,251907,0,2,0
71910,2,2,251907,251907,251909,0,2,0
71911,3,3,251910,251910,251913,0,3,1
71912,1,3,251911,251913,251916,2,5,0
71913,3,3,251914,251916,251919,2,5,0
71914,3,3,251917,251919,251922,2,5,0
71915,2,1,251919,251922,251923,3,4,0
71916,3,1,251922,251923,251924,1,2,0
71917,4,3,251926,251926,251929,0,3,2
71918,3,1,251929,251929,251930,0,1,0
71919,6,2,251935,251935,251937,0,2,5
71920,3,2,251938,251938,251940,0,2,1
71921,5,2,251943,251943,251945,0,2,3
71922,1,3,251944,251945,251948,1,4,0
71923,1,1,251945,251948,251949,3,4,0
71924,1,2,251946,251949,251951,3,5,0
71925,1,3,251947,251951,251954,4,7,0
71926,3,1,251950,251954,251955,4,5,0
71927,1,2,251951,251955,251957,4,6,0
71928,4,3,251955,251957,251960,2,5,0
71929,2,3,251957,251960,251963,3,6,0
71930,1,2,251958,251963,251965,5,7,0
71931,1,1,251959,251965,251966,6,7,0
71932,3,2,251962,251966,251968,4,6,0
71933,5,2,251967,251968,251970,1,3,0
71934,1,3,251968,251970,251973,2,5,0
71935,2,3,251970,251973,251976,3,6,0
71936,2,3,251972,251976,251979,4,7,0
71937,3,2,251975,251979,251981,4,6,0
71938,1,1,251976,251981,251982,5,6,0
71939,1,2,251977,251982,251984,5,7,0
71940,1,3,251978,251984,251987,6,9,0
71941,4,1,251982,251987,251988,5,6,0
71942,1,3,251983,251988,251991,5,8,0
71943,2,3,251985,251991,251994,6,9,0
71944,5,1,251990,251994,251995,4,5,0
71945,5,3,251995,251995,251998,0,3,0
71946,6,3,252001,252001,252004,0,3,3
71947,3,2,252004,252004,252006,0,2,0
71948,3,1,252007,252007,252008,0,1,1
71949,3,2,252010,252010,252012,0,2,2
71950,6,1,252016,252016,252017,0,1,4
71951,3,1,252019,252019,252020,0,1,2
71952,3,1,252022,252022,252023,0,1,2
71953,3,3,252025,252025,252028,0,3,2
71954,5,2,252030,252030,252032,0,2,2
71955,3,3,252033,252033,252036,0,3,1
71956,2,1,252035,252036,252037,1,2,0
71957,6,2,252041,252041,252043,0,2,4
71958,4,2,252045,252045,252047,0,2,2
71959,3,1,252048,252048,252049,0,1,1
71960,6,2,252054,252054,252056,0,2,5
71961,5,2,252059,252059,252061,0,2,3
71962,6,1,252065,252065,252066,0,1,4
71963,6,1,252071,252071,252072,0,1,5
71964,3,3,252074,252074,252077,0,3,2
71965,4,2,252078,252078,252080,0,2,1
71966,6,3,252084,252084,252087,0,3,4
71967,4,3,252088,252088,252091,0,3,1
71968,4,2,252092,252092,252094,0,2,1
71969,2,3,252094,252094,252097,0,3,0
71970,4,2,252098,252098,252100,0,2,1
71971,2,1,252100,252100,252101,0,1,0
71972,3,3,252103,252103,252106,0,3,2
71973,1,2,252104,252106,252108,2,4,0
71974,3,1,252107,252108,252109,1,2,0
71975,1,1,252108,252109,252110,1,2,0
71976,2,3,252110,252110,252113,0,3,0
71977,6,1,252116,252116,252117,0,1,3
71978,5,1,252121,252121,252122,0,1,4
71979,3,3,252124,252124,252127,0,3,2
71980,4,2,252128,252128,252130,0,2,1
71981,3,3,252131,252131,252134,0,3,1
71982,3,1,252134,252134,252135,0,1,0
71983,6,2,252140,252140,252142,0,2,5
71984,3,1,252143,252143,252144,0,1,1
71985,6,1,252149,252149,252150,0,1,5
71986,3,2,252152,252152,252154,0,2,2
71987,3,3,252155,252155,252158,0,3,1
71988,1,3,252156,252158,252161,2,5,0
71989,4,3,252160,252161,252164,1,4,0
71990,6,1,252166,252166,252167,0,1,2
71991,2,2,252168,252168,252170,0,2,1
71992,6,1,252174,252174,252175,0,1,4
71993,5,1,252179,252179,252180,0,1,4
71994,4,2,252183,252183,252185,0,2,3
71995,2,3,252185,252185,252188,0,3,0
71996,2,2,252187,252188,252190,1,3,0
71997,5,1,252192,252192,252193,0,1,2
71998,2,3,252194,252194,252197,0,3,1
71999,4,2,252198,252198,252200,0,2,1
72000,2,3,252200,252200,252203,0,3,0
72001,5,1,252205,252205,252206,0,1,2
72002,3,1,252208,252208,252209,0,1,2
72003,6,3,252214,252214,252217,0,3,5
72004,4,1,252218,252218,252219,0,1,1
72005,1,1,252219,252219,252220,0,1,0
72006,2,1,252221,252221,252222,0,1,1
72007,1,1,252222,252222,252223,0,1,0
72008,1,2,252223,252223,252225,0,2,0
72009,5,2,252228,252228,252230,0,2,3
72010,4,3,252232,252232,252235,0,3,2
72011,2,2,252234,252235,252237,1,3,0
72012,3,1,252237,252237,252238,0,1,0
72013,2,2,252239,252239,252241,0,2,1
72014,4,1,252243,252243,252244,0,1,2
72015,2,1,252245,252245,252246,0,1,1
72016,1,3,252246,252246,252249,0,3,0
72017,6,2,252252,252252,252254,0,2,3
72018,6,3,252258,252258,252261,0,3,4
72019,6,3,252264,252264,252267,0,3,3
72020,6,1,252270,252270,252271,0,1,3
72021,2,3,252272,252272,252275,0,3,1
72022,1,3,252273,252275,252278,2,5,0
72023,1,2,252274,252278,252280,4,6,0
72024,4,3,252278,252280,252283,2,5,0
72025,4,1,252282,252283,252284,1,2,0
72026,3,2,252285,252285,252287,0,2,1
72027,1,2,252286,252287,252289,1,3,0
72028,1,3,252287,252289,252292,2,5,0
72029,6,3,252293,252293,252296,0,3,1
72030,6,2,252299,252299,252301,0,2,3
72031,2,3,252301,252301,252304,0,3,0
72032,5,2,252306,252306,252308,0,2,2
72033,3,2,252309,252309,252311,0,2,1
72034,2,3,252311,252311,252314,0,3,0
72035,3,3,252314,252314,252317,0,3,0
72036,6,1,252320,252320,252321,0,1,3
72037,3,2,252323,252323,252325,0,2,2
72038,5,2,252328,252328,252330,0,2,3
72039,1,2,252329,252330,252332,1,3,0
72040,1,2,252330,252332,252334,2,4,0
72041,1,3,252331,252334,252337,3,6,0
72042,5,2,252336,252337,252339,1,3,0
72043,3,3,252339,252339,252342,0,3,0
72044,1,3,252340,252342,252345,2,5,0
72045,2,3,252342,252345,252348,3,6,0
72046,4,1,252346,252348,252349,2,3,0
72047,5,3,252351,252351,252354,0,3,2
72048,5,1,252356,252356,252357,0,1,2
72049,2,3,252358,252358,252361,0,3,1
72050,5,3,252363,252363,252366,0,3,2
72051,4,3,252367,252367,252370,0,3,1
72052,3,1,252370,252370,252371,0,1,0
72053,6,1,252376,252376,252377,0,1,5
72054,2,2,252378,252378,252380,0,2,1
72055,4,3,252382,252382,252385,0,3,2
72056,4,2,252386,252386,252388,0,2,1
72057,2,1,252388,252388,252389,0,1,0
72058,3,2,252391,252391,252393,0,2,2
72059,4,3,252395,252395,252398,0,3,2
72060,1,1,252396,252398,252399,2,3,0
72061,1,2,252397,252399,252401,2,4,0
72062,6,3,252403,252403,252406,0,3,2
72063,6,1,252409,252409,252410,0,1,3
72064,2,2,252411,252411,252413,0,2,1
72065,1,1,252412,252413,252414,1,2,0
72066,3,3,252415,252415,252418,0,3,1
72067,2,2,252417,252418,252420,1,3,0
72068,6,1,252423,252423,252424,0,1,3
72069,3,1,252426,252426,252427,0,1,2
72070,6,3,252432,252432,252435,0,3,5
72071,6,1,252438,252438,252439,0,1,3
72072,1,3,252439,252439,252442,0,3,0
72073,6,3,252445,252445,252448,0,3,3
72074,3,2,252448,252448,252450,0,2,0
72075,1,2,252449,252450,252452,1,3,0
72076,4,1,252453,252453,252454,0,1,1
72077,1,2,252454,252454,252456,0,2,0
72078,2,2,252456,252456,252458,0,2,0
72079,5,2,252461,252461,252463,0,2,3
72080,5,2,252466,252466,252468,0,2,3
72081,2,2,252468,252468,252470,0,2,0
72082,1,1,252469,252470,252471,1,2,0
72083,3,3,252472,252472,252475,0,3,1
72084,5,3,252477,252477,252480,0,3,2
72085,5,2,252482,252482,252484,0,2,2
72086,5,2,252487,252487,252489,0,2,3
72087,2,3,252489,252489,252492,0,3,0
72088,5,2,252494,252494,252496,0,2,2
72089,1,3,252495,252496,252499,1,4,0
72090,1,1,252496,252499,252500,3,4,0
72091,2,3,252498,252500,252503,2,5,0
72092,4,1,252502,252503,252504,1,2,0
72093,3,2,252505,252505,252507,0,2,1
72094,1,2,252506,252507,252509,1,3,0
72095,2,1,252508,252509,252510,1,2,0
72096,4,2,252512,252512,252514,0,2,2
72097,6,1,252518,252518,252519,0,1,4
72098,1,1,252519,252519,252520,0,1,0
72099,5,3,252524,252524,252527,0,3,4
72100,6,1,252530,252530,252531,0,1,3
72101,2,3,252532,252532,252535,0,3,1
72102,2,2,252534,252535,252537,1,3,0
72103,6,1,252540,252540,252541,0,1,3
72104,3,2,252543,252543,252545,0,2,2
72105,2,1,252545,252545,252546,0,1,0
72106,6,3,252551,252551,252554,0,3,5
72107,6,1,252557,252557,252558,0,1,3
72108,4,1,252561,252561,252562,0,1,3
72109,4,1,252565,252565,252566,0,1,3
72110,1,2,252566,252566,252568,0,2,0
72111,4,2,252570,252570,252572,0,2,2
72112,4,3,252574,252574,252577,0,3,2
72113,2,1,252576,252577,252578,1,2,0
72114,2,1,252578,252578,252579,0,1,0
72115,3,3,252581,252581,252584,0,3,2
72116,6,2,252587,252587,252589,0,2,3
72117,5,1,252592,252592,252593,0,1,3
72118,1,2,252593,252593,252595,0,2,0
72119,4,1,252597,252597,252598,0,1,2
72120,3,3,252600,252600,252603,0,3,2
72121,6,3,252606,252606,252609,0,3,3
72122,5,1,252611,252611,252612,0,1,2
72123,5,3,252616,252616,252619,0,3,4
72124,3,3,252619,252619,252622,0,3,0
72125,5,2,252624,252624,252626,0,2,2
72126,2,2,252626,252626,252628,0,2,0
72127,4,2,252630,252630,252632,0,2,2
72128,4,2,252634,252634,252636,0,2,2
72129,6,1,252640,252640,252641,0,1,4
72130,1,2,252641,252641,252643,0,2,0
72131,2,1,252643,252643,252644,0,1,0
72132,5,3,252648,252648,252651,0,3,4
72133,5,3,252653,252653,252656,0,3,2
72134,6,2,252659,252659,252661,0,2,3
72135,1,3,252660,252661,252664,1,4,0
72136,6,2,252666,252666,252668,0,2,2
72137,2,2,252668,252668,252670,0,2,0
72138,6,3,252674,252674,252677,0,3,4
72139,4,1,252678,252678,252679,0,1,1
72140,4,1,252682,252682,252683,0,1,3
72141,2,3,252684,252684,252687,0,3,1
72142,2,3,252686,252687,252690,1,4,0
72143,1,2,252687,252690,252692,3,5,0
72144,4,1,252691,252692,252693,1,2,0
72145,2,1,252693,252693,252694,0,1,0
72146,5,2,252698,252698,252700,0,2,4
72147,5,1,252703,252703,252704,0,1,3
72148,4,1,252707,252707,252708,0,1,3
72149,5,1,252712,252712,252713,0,1,4
72150,5,2,252717,252717,252719,0,2,4
72151,1,3,252718,252719,252722,1,4,0
72152,3,1,252721,252722,252723,1,2,0
72153,5,1,252726,252726,252727,0,1,3
72154,6,1,252732,252732,252733,0,1,5
72155,6,1,252738,252738,252739,0,1,5
72156,5,3,252743,252743,252746,0,3,4
72157,2,2,252745,252746,252748,1,3,0
72158,6,1,252751,252751,252752,0,1,3
72159,4,1,252755,252755,252756,0,1,3
72160,4,3,252759,252759,252762,0,3,3
72161,4,2,252763,252763,252765,0,2,1
72162,5,3,252768,252768,252771,0,3,3
72163,4,2,252772,252772,252774,0,2,1
72164,1,2,252773,252774,252776,1,3,0
72165,3,2,252776,252776,252778,0,2,0
72166,5,2,252781,252781,252783,0,2,3
72167,6,2,252787,252787,252789,0,2,4
72168,5,1,252792,252792,252793,0,1,3
72169,6,1,252798,252798,252799,0,1,5
72170,6,3,252804,252804,252807,0,3,5
72171,5,1,252809,252809,252810,0,1,2
72172,1,2,252810,252810,252812,0,2,0
72173,6,3,252816,252816,252819,0,3,4
72174,2,1,252818,252819,252820,1,2,0
72175,6,1,252824,252824,252825,0,1,4
72176,2,2,252826,252826,252828,0,2,1
72177,2,3,252828,252828,252831,0,3,0
72178,5,3,252833,252833,252836,0,3,2
72179,6,1,252839,252839,252840,0,1,3
72180,4,1,252843,252843,252844,0,1,3
72181,4,1,252847,252847,252848,0,1,3
72182,3,2,252850,252850,252852,0,2,2
72183,6,2,252856,252856,252858,0,2,4
72184,5,3,252861,252861,252864,0,3,3
72185,5,3,252866,252866,252869,0,3,2
72186,3,2,252869,252869,252871,0,2,0
72187,2,2,252871,252871,252873,0,2,0
72188,6,2,252877,252877,252879,0,2,4
72189,1,1,252878,252879,252880,1,2,0
72190,4,3,252882,252882,252885,0,3,2
72191,1,1,252883,252885,252886,2,3,0
72192,6,2,252889,252889,252891,0,2,3
72193,2,3,252891,252891,252894,0,3,0
72194,3,1,252894,252894,252895,0,1,0
72195,4,3,252898,252898,252901,0,3,3
72196,2,2,252900,252901,252903,1,3,0
72197,4,2,252904,252904,252906,0,2,1
72198,5,1,252909,252909,252910,0,1,3
72199,3,3,252912,252912,252915,0,3,2
72200,4,3,252916,252916,252919,0,3,1
72201,5,3,252921,252921,252924,0,3,2
72202,2,2,252923,252924,252926,1,3,0
72203,4,3,252927,252927,252930,0,3,1
72204,2,3,252929,252930,252933,1,4,0
72205,5,2,252934,252934,252936,0,2,1
72206,2,2,252936,252936,252938,0,2,0
72207,1,2,252937,252938,252940,1,3,0
72208,6,2,252943,252943,252945,0,2,3
72209,5,2,252948,252948,252950,0,2,3
72210,6,1,252954,252954,252955,0,1,4
72211,1,3,252955,252955,252958,0,3,0
72212,1,2,252956,252958,252960,2,4,0
72213,2,1,252958,252960,252961,2,3,0
72214,5,1,252963,252963,252964,0,1,2
72215,1,3,252964,252964,252967,0,3,0
72216,5,1,252969,252969,252970,0,1,2
72217,2,3,252971,252971,252974,0,3,1
72218,2,1,252973,252974,252975,1,2,0
72219,5,1,252978,252978,252979,0,1,3
72220,4,1,252982,252982,252983,0,1,3
72221,1,1,252983,252983,252984,0,1,0
72222,1,2,252984,252984,252986,0,2,0
72223,2,2,252986,252986,252988,0,2,0
72224,4,3,252990,252990,252993,0,3,2
72225,3,2,252993,252993,252995,0,2,0
72226,3,1,252996,252996,252997,0,1,1
72227,4,3,253000,253000,253003,0,3,3
72228,3,3,253003,253003,253006,0,3,0
72229,2,2,253005,253006,253008,1,3,0
72230,4,1,253009,253009,253010,0,1,1
72231,3,3,253012,253012,253015,0,3,2
72232,4,3,253016,253016,253019,0,3,1
72233,5,1,253021,253021,253022,0,1,2
72234,6,1,253027,253027,253028,0,1,5
72235,5,1,253032,253032,253033,0,1,4
72236,5,2,253037,253037,253039,0,2,4
72237,3,2,253040,253040,253042,0,2,1
72238,6,3,253046,253046,253049,0,3,4
72239,3,2,253049,253049,253051,0,2,0
72240,6,3,253055,253055,253058,0,3,4
72241,5,2,253060,253060,253062,0,2,2
72242,4,2,253064,253064,253066,0,2,2
72243,6,1,253070,253070,253071,0,1,4
72244,6,1,253076,253076,253077,0,1,5
72245,5,3,253081,253081,253084,0,3,4
72246,2,2,253083,253084,253086,1,3,0
72247,6,2,253089,253089,253091,0,2,3
72248,4,1,253093,253093,253094,0,1,2
72249,5,1,253098,253098,253099,0,1,4
72250,3,2,253101,253101,253103,0,2,2
72251,3,3,253104,253104,253107,0,3,1
72252,1,1,253105,253107,253108,2,3,0
72253,1,2,253106,253108,253110,2,4,0
72254,2,3,253108,253110,253113,2,5,0
72255,5,3,253113,253113,253116,0,3,0
72256,3,2,253116,253116,253118,0,2,0
72257,1,2,253117,253118,253120,1,3,0
72258,3,3,253120,253120,253123,0,3,0
72259,1,1,253121,253123,253124,2,3,0
72260,5,1,253126,253126,253127,0,1,2
72261,6,2,253132,253132,253134,0,2,5
72262,5,3,253137,253137,253140,0,3,3
72263,4,2,253141,253141,253143,0,2,1
72264,3,1,253144,253144,253145,0,1,1
72265,3,1,253147,253147,253148,0,1,2
72266,6,3,253153,253153,253156,0,3,5
72267,6,1,253159,253159,253160,0,1,3
72268,6,1,253165,253165,253166,0,1,5
72269,6,2,253171,253171,253173,0,2,5
72270,3,1,253174,253174,253175,0,1,1
72271,1,1,253175,253175,253176,0,1,0
72272,5,3,253180,253180,253183,0,3,4
72273,3,2,253183,253183,253185,0,2,0
72274,6,3,253189,253189,253192,0,3,4
72275,5,1,253194,253194,253195,0,1,2
72276,2,3,253196,253196,253199,0,3,1
72277,3,1,253199,253199,253200,0,1,0
72278,6,1,253205,253205,253206,0,1,5
72279,1,2,253206,253206,253208,0,2,0
72280,1,1,253207,253208,253209,1,2,0
72281,5,3,253212,253212,253215,0,3,3
72282,4,1,253216,253216,253217,0,1,1
72283,5,2,253221,253221,253223,0,2,4
72284,2,1,253223,253223,253224,0,1,0
72285,2,2,253225,253225,253227,0,2,1
72286,3,3,253228,253228,253231,0,3,1
72287,1,2,253229,253231,253233,2,4,0
72288,3,1,253232,253233,253234,1,2,0
72289,5,1,253237,253237,253238,0,1,3
72290,1,3,253238,253238,253241,0,3,0
72291,4,3,253242,253242,253245,0,3,1
72292,3,2,253245,253245,253247,0,2,0
72293,4,1,253249,253249,253250,0,1,2
72294,1,2,253250,253250,253252,0,2,0
72295,3,2,253253,253253,253255,0,2,1
72296,1,1,253254,253255,253256,1,2,0
72297,1,1,253255,253256,253257,1,2,0
72298,2,3,253257,253257,253260,0,3,0
72299,5,1,253262,253262,253263,0,1,2
72300,4,1,253266,253266,253267,0,1,3
72301,4,1,253270,253270,253271,0,1,3
72302,1,1,253271,253271,253272,0,1,0
72303,3,2,253274,253274,253276,0,2,2
72304,1,2,253275,253276,253278,1,3,0
72305,2,2,253277,253278,253280,1,3,0
72306,2,2,253279,253280,253282,1,3,0
72307,3,3,253282,253282,253285,0,3,0
72308,4,2,253286,253286,253288,0,2,1
72309,1,2,253287,253288,253290,1,3,0
72310,1,1,253288,253290,253291,2,3,0
72311,1,1,253289,253291,253292,2,3,0
72312,3,1,253292,253292,253293,0,1,0
72313,5,2,253297,253297,253299,0,2,4
72314,4,3,253301,253301,253304,0,3,2
72315,2,1,253303,253304,253305,1,2,0
72316,4,2,253307,253307,253309,0,2,2
72317,3,1,253310,253310,253311,0,1,1
72318,6,2,253316,253316,253318,0,2,5
72319,6,1,253322,253322,253323,0,1,4
72320,2,1,253324,253324,253325,0,1,1
72321,1,2,253325,253325,253327,0,2,0
72322,3,2,253328,253328,253330,0,2,1
72323,3,1,253331,253331,253332,0,1,1
72324,4,1,253335,253335,253336,0,1,3
72325,2,1,253337,253337,253338,0,1,1
72326,1,2,253338,253338,253340,0,2,0
72327,3,3,253341,253341,253344,0,3,1
72328,1,1,253342,253344,253345,2,3,0
72329,1,1,253343,253345,253346,2,3,0
72330,4,1,253347,253347,253348,0,1,1
72331,5,1,253352,253352,253353,0,1,4
72332,4,2,253356,253356,253358,0,2,3
72333,5,2,253361,253361,253363,0,2,3
72334,6,3,253367,253367,253370,0,3,4
72335,5,2,253372,253372,253374,0,2,2
72336,2,2,253374,253374,253376,0,2,0
72337,3,2,253377,253377,253379,0,2,1
72338,6,1,253383,253383,253384,0,1,4
72339,3,2,253386,253386,253388,0,2,2
72340,5,3,253391,253391,253394,0,3,3
72341,1,1,253392,253394,253395,2,3,0
72342,6,1,253398,253398,253399,0,1,3
72343,4,1,253402,253402,253403,0,1,3
72344,1,2,253403,253403,253405,0,2,0
72345,5,3,253408,253408,253411,0,3,3
72346,5,2,253413,253413,253415,0,2,2
72347,4,1,253417,253417,253418,0,1,2
72348,6,3,253423,253423,253426,0,3,5
72349,4,3,253427,253427,253430,0,3,1
72350,1,2,253428,253430,253432,2,4,0
72351,4,2,253432,253432,253434,0,2,0
72352,4,3,253436,253436,253439,0,3,2
72353,5,1,253441,253441,253442,0,1,2
72354,4,2,253445,253445,253447,0,2,3
72355,4,2,253449,253449,253451,0,2,2
72356,6,3,253455,253455,253458,0,3,4
72357,3,3,253458,253458,253461,0,3,0
72358,4,1,253462,253462,253463,0,1,1
72359,6,1,253468,253468,253469,0,1,5
72360,3,2,253471,253471,253473,0,2,2
72361,2,2,253473,253473,253475,0,2,0
72362,6,2,253479,253479,253481,0,2,4
72363,2,1,253481,253481,253482,0,1,0
72364,1,3,253482,253482,253485,0,3,0
72365,4,1,253486,253486,253487,0,1,1
72366,1,2,253487,253487,253489,0,2,0
72367,3,3,253490,253490,253493,0,3,1
72368,3,2,253493,253493,253495,0,2,0
72369,1,3,253494,253495,253498,1,4,0
72370,4,2,253498,253498,253500,0,2,0
72371,4,3,253502,253502,253505,0,3,2
72372,2,3,253504,253505,253508,1,4,0
72373,2,2,253506,253508,253510,2,4,0
72374,5,3,253511,253511,253514,0,3,1
72375,3,1,253514,253514,253515,0,1,0
72376,6,3,253520,253520,253523,0,3,5
72377,3,2,253523,253523,253525,0,2,0
72378,6,1,253529,253529,253530,0,1,4
72379,5,3,253534,253534,253537,0,3,4
72380,3,2,253537,253537,253539,0,2,0
72381,2,2,253539,253539,253541,0,2,0
72382,5,2,253544,253544,253546,0,2,3
72383,3,1,253547,253547,253548,0,1,1
72384,6,3,253553,253553,253556,0,3,5
72385,1,2,253554,253556,253558,2,4,0
72386,3,1,253557,253558,253559,1,2,0
72387,1,3,253558,253559,253562,1,4,0
72388,6,1,253564,253564,253565,0,1,2
72389,2,1,253566,253566,253567,0,1,1
72390,6,3,253572,253572,253575,0,3,5
72391,2,2,253574,253575,253577,1,3,0
72392,3,2,253577,253577,253579,0,2,0
72393,3,2,253580,253580,253582,0,2,1
72394,6,3,253586,253586,253589,0,3,4
72395,1,3,253587,253589,253592,2,5,0
72396,4,3,253591,253592,253595,1,4,0
72397,3,3,253594,253595,253598,1,4,0
72398,4,2,253598,253598,253600,0,2,0
72399,2,3,253600,253600,253603,0,3,0
72400,2,2,253602,253603,253605,1,3,0
72401,4,2,253606,253606,253608,0,2,1
72402,5,1,253611,253611,253612,0,1,3
72403,5,1,253616,253616,253617,0,1,4
72404,4,3,253620,253620,253623,0,3,3
72405,1,3,253621,253623,253626,2,5,0
72406,5,2,253626,253626,253628,0,2,0
72407,6,3,253632,253632,253635,0,3,4
72408,6,1,253638,253638,253639,0,1,3
72409,2,2,253640,253640,253642,0,2,1
72410,4,3,253644,253644,253647,0,3,2
72411,2,1,253646,253647,253648,1,2,0
72412,5,1,253651,253651,253652,0,1,3
72413,1,1,253652,253652,253653,0,1,0
72414,3,2,253655,253655,253657,0,2,2
72415,1,2,253656,253657,253659,1,3,0
72416,1,3,253657,253659,253662,2,5,0
72417,6,2,253663,253663,253665,0,2,1
72418,2,2,253665,253665,253667,0,2,0
72419,1,2,253666,253667,253669,1,3,0
72420,5,1,253671,253671,253672,0,1,2
72421,3,1,253674,253674,253675,0,1,2
72422,6,2,253680,253680,253682,0,2,5
72423,6,3,253686,253686,253689,0,3,4
72424,1,1,253687,253689,253690,2,3,0
72425,3,1,253690,253690,253691,0,1,0
72426,4,3,253694,253694,253697,0,3,3
72427,6,1,253700,253700,253701,0,1,3
72428,4,2,253704,253704,253706,0,2,3
72429,4,1,253708,253708,253709,0,1,2
72430,4,1,253712,253712,253713,0,1,3
72431,5,2,253717,253717,253719,0,2,4
72432,1,2,253718,253719,253721,1,3,0
72433,4,1,253722,253722,253723,0,1,1
72434,2,1,253724,253724,253725,0,1,1
72435,4,3,253728,253728,253731,0,3,3
72436,4,1,253732,253732,253733,0,1,1
72437,6,2,253738,253738,253740,0,2,5
72438,6,2,253744,253744,253746,0,2,4
72439,4,2,253748,253748,253750,0,2,2
72440,4,2,253752,253752,253754,0,2,2
72441,6,2,253758,253758,253760,0,2,4
72442,6,1,253764,253764,253765,0,1,4
72443,5,3,253769,253769,253772,0,3,4
72444,5,1,253774,253774,253775,0,1,2
72445,2,1,253776,253776,253777,0,1,1
72446,5,1,253781,253781,253782,0,1,4
72447,6,2,253787,253787,253789,0,2,5
72448,5,2,253792,253792,253794,0,2,3
72449,1,2,253793,253794,253796,1,3,0
72450,5,1,253798,253798,253799,0,1,2
72451,4,2,253802,253802,253804,0,2,3
72452,6,1,253808,253808,253809,0,1,4
72453,2,3,253810,253810,253813,0,3,1
72454,5,3,253815,253815,253818,0,3,2
72455,3,2,253818,253818,253820,0,2,0
72456,2,3,253820,253820,253823,0,3,0
72457,4,1,253824,253824,253825,0,1,1
72458,5,2,253829,253829,253831,0,2,4
72459,5,2,253834,253834,253836,0,2,3
72460,3,2,253837,253837,253839,0,2,1
72461,2,3,253839,253839,253842,0,3,0
72462,6,2,253845,253845,253847,0,2,3
72463,2,3,253847,253847,253850,0,3,0
72464,5,1,253852,253852,253853,0,1,2
72465,3,1,253855,253855,253856,0,1,2
72466,3,1,253858,253858,253859,0,1,2
72467,5,3,253863,253863,253866,0,3,4
72468,5,2,253868,253868,253870,0,2,2
72469,1,3,253869,253870,253873,1,4,0
72470,3,2,253872,253873,253875,1,3,0
72471,3,3,253875,253875,253878,0,3,0
72472,5,1,253880,253880,253881,0,1,2
72473,5,1,253885,253885,253886,0,1,4
72474,1,1,253886,253886,253887,0,1,0
72475,3,3,253889,253889,253892,0,3,2
72476,6,2,253895,253895,253897,0,2,3
72477,1,2,253896,253897,253899,1,3,0
72478,5,1,253901,253901,253902,0,1,2
72479,5,1,253906,253906,253907,0,1,4
72480,3,3,253909,253909,253912,0,3,2
72481,4,1,253913,253913,253914,0,1,1
72482,2,3,253915,253915,253918,0,3,1
72483,6,1,253921,253921,253922,0,1,3
72484,1,1,253922,253922,253923,0,1,0
72485,2,2,253924,253924,253926,0,2,1
72486,4,3,253928,253928,253931,0,3,2
72487,4,1,253932,253932,253933,0,1,1
72488,6,2,253938,253938,253940,0,2,5
72489,2,3,253940,253940,253943,0,3,0
72490,6,1,253946,253946,253947,0,1,3
72491,3,1,253949,253949,253950,0,1,2
72492,6,2,253955,253955,253957,0,2,5
72493,3,2,253958,253958,253960,0,2,1
72494,3,3,253961,253961,253964,0,3,1
72495,4,3,253965,253965,253968,0,3,1
72496,5,1,253970,253970,253971,0,1,2
72497,4,3,253974,253974,253977,0,3,3
72498,1,1,253975,253977,253978,2,3,0
72499,1,2,253976,253978,253980,2,4,0
72500,3,3,253979,253980,253983,1,4,0
72501,4,1,253983,253983,253984,0,1,0
72502,3,3,253986,253986,253989,0,3,2
72503,4,3,253990,253990,253993,0,3,1
72504,1,3,253991,253993,253996,2,5,0
72505,2,2,253993,253996,253998,3,5,0
72506,1,3,253994,253998,254001,4,7,0
72507,4,1,253998,254001,254002,3,4,0
72508,1,3,253999,254002,254005,3,6,0
72509,5,1,254004,254005,254006,1,2,0
72510,6,2,254010,254010,254012,0,2,4
72511,1,3,254011,254012,254015,1,4,0
72512,1,3,254012,254015,254018,3,6,0
72513,6,3,254018,254018,254021,0,3,0
72514,3,2,254021,254021,254023,0,2,0
72515,5,3,254026,254026,254029,0,3,3
72516,2,1,254028,254029,254030,1,2,0
72517,1,2,254029,254030,254032,1,3,0
72518,1,2,254030,254032,254034,2,4,0
72519,2,2,254032,254034,254036,2,4,0
72520,6,3,254038,254038,254041,0,3,2
72521,1,2,254039,254041,254043,2,4,0
72522,1,1,254040,254043,254044,3,4,0
72523,3,1,254043,254044,254045,1,2,0
72524,3,2,254046,254046,254048,0,2,1
72525,1,2,254047,254048,254050,1,3,0
72526,2,1,254049,254050,254051,1,2,0
72527,6,1,254055,254055,254056,0,1,4
72528,3,3,254058,254058,254061,0,3,2
72529,6,1,254064,254064,254065,0,1,3
72530,4,2,254068,254068,254070,0,2,3
72531,6,2,254074,254074,254076,0,2,4
72532,6,3,254080,254080,254083,0,3,4
72533,3,1,254083,254083,254084,0,1,0
72534,2,3,254085,254085,254088,0,3,1
72535,6,1,254091,254091,254092,0,1,3
72536,3,1,254094,254094,254095,0,1,2
72537,3,1,254097,254097,254098,0,1,2
72538,2,1,254099,254099,254100,0,1,1
72539,2,2,254101,254101,254103,0,2,1
72540,3,3,254104,254104,254107,0,3,1
72541,1,3,254105,254107,254110,2,5,0
72542,1,1,254106,254110,254111,4,5,0
72543,2,2,254108,254111,254113,3,5,0
72544,4,1,254112,254113,254114,1,2,0
72545,4,3,254116,254116,254119,0,3,2
72546,6,1,254122,254122,254123,0,1,3
72547,1,2,254123,254123,254125,0,2,0
72548,6,1,254129,254129,254130,0,1,4
72549,3,2,254132,254132,254134,0,2,2
72550,4,1,254136,254136,254137,0,1,2
72551,5,3,254141,254141,254144,0,3,4
72552,2,1,254143,254144,254145,1,2,0
72553,6,2,254149,254149,254151,0,2,4
72554,5,2,254154,254154,254156,0,2,3
72555,5,2,254159,254159,254161,0,2,3
72556,6,1,254165,254165,254166,0,1,4
72557,5,3,254170,254170,254173,0,3,4
72558,1,3,254171,254173,254176,2,5,0
72559,3,1,254174,254176,254177,2,3,0
72560,6,1,254180,254180,254181,0,1,3
72561,3,1,254183,254183,254184,0,1,2
72562,5,3,254188,254188,254191,0,3,4
72563,4,1,254192,254192,254193,0,1,1
72564,6,2,254198,254198,254200,0,2,5
72565,1,2,254199,254200,254202,1,3,0
72566,4,2,254203,254203,254205,0,2,1
72567,5,3,254208,254208,254211,0,3,3
72568,1,3,254209,254211,254214,2,5,0
72569,4,2,254213,254214,254216,1,3,0
72570,5,3,254218,254218,254221,0,3,2
72571,4,3,254222,254222,254225,0,3,1
72572,3,3,254225,254225,254228,0,3,0
72573,1,3,254226,254228,254231,2,5,0
72574,5,3,254231,254231,254234,0,3,0
72575,3,2,254234,254234,254236,0,2,0
72576,3,2,254237,254237,254239,0,2,1
72577,6,3,254243,254243,254246,0,3,4
72578,2,2,254245,254246,254248,1,3,0
72579,6,2,254251,254251,254253,0,2,3
72580,6,3,254257,254257,254260,0,3,4
72581,4,1,254261,254261,254262,0,1,1
72582,4,2,254265,254265,254267,0,2,3
72583,3,3,254268,254268,254271,0,3,1
72584,4,2,254272,254272,254274,0,2,1
72585,3,2,254275,254275,254277,0,2,1
72586,2,1,254277,254277,254278,0,1,0
72587,2,3,254279,254279,254282,0,3,1
72588,1,1,254280,254282,254283,2,3,0
72589,5,1,254285,254285,254286,0,1,2
72590,4,2,254289,254289,254291,0,2,3
72591,3,2,254292,254292,254294,0,2,1
72592,4,1,254296,254296,254297,0,1,2
72593,1,2,254297,254297,254299,0,2,0
72594,3,3,254300,254300,254303,0,3,1
72595,1,2,254301,254303,254305,2,4,0
72596,4,3,254305,254305,254308,0,3,0
72597,4,2,254309,254309,254311,0,2,1
72598,6,2,254315,254315,254317,0,2,4
72599,6,2,254321,254321,254323,0,2,4
72600,4,2,254325,254325,254327,0,2,2
72601,2,3,254327,254327,254330,0,3,0
72602,1,1,254328,254330,254331,2,3,0
72603,4,1,254332,254332,254333,0,1,1
72604,3,1,254335,254335,254336,0,1,2
72605,2,2,254337,254337,254339,0,2,1
72606,5,1,254342,254342,254343,0,1,3
72607,5,2,254347,254347,254349,0,2,4
72608,3,1,254350,254350,254351,0,1,1
72609,6,1,254356,254356,254357,0,1,5
72610,5,2,254361,254361,254363,0,2,4
72611,5,1,254366,254366,254367,0,1,3
72612,1,2,254367,254367,254369,0,2,0
72613,4,1,254371,254371,254372,0,1,2
72614,1,1,254372,254372,254373,0,1,0
72615,2,2,254374,254374,254376,0,2,1
72616,3,2,254377,254377,254379,0,2,1
72617,5,1,254382,254382,254383,0,1,3
72618,6,3,254388,254388,254391,0,3,5
72619,2,3,254390,254391,254394,1,4,0
72620,3,1,254393,254394,254395,1,2,0
72621,5,3,254398,254398,254401,0,3,3
72622,5,1,254403,254403,254404,0,1,2
72623,4,3,254407,254407,254410,0,3,3
72624,5,2,254412,254412,254414,0,2,2
72625,5,1,254417,254417,254418,0,1,3
72626,1,1,254418,254418,254419,0,1,0
72627,2,3,254420,254420,254423,0,3,1
72628,1,1,254421,254423,254424,2,3,0
72629,1,1,254422,254424,254425,2,3,0
72630,5,1,254427,254427,254428,0,1,2
72631,6,3,254433,254433,254436,0,3,5
72632,1,2,254434,254436,254438,2,4,0
72633,6,3,254440,254440,254443,0,3,2
72634,4,1,254444,254444,254445,0,1,1
72635,1,3,254445,254445,254448,0,3,0
72636,5,2,254450,254450,254452,0,2,2
72637,5,2,254455,254455,254457,0,2,3
72638,1,3,254456,254457,254460,1,4,0
72639,3,2,254459,254460,254462,1,3,0
72640,4,3,254463,254463,254466,0,3,1
72641,6,2,254469,254469,254471,0,2,3
72642,3,1,254472,254472,254473,0,1,1
72643,4,2,254476,254476,254478,0,2,3
72644,2,2,254478,254478,254480,0,2,0
72645,4,3,254482,254482,254485,0,3,2
72646,5,3,254487,254487,254490,0,3,2
72647,4,3,254491,254491,254494,0,3,1
72648,6,3,254497,254497,254500,0,3,3
72649,6,2,254503,254503,254505,0,2,3
72650,2,2,254505,254505,254507,0,2,0
72651,6,3,254511,254511,254514,0,3,4
72652,2,1,254513,254514,254515,1,2,0
72653,2,1,254515,254515,254516,0,1,0
72654,3,2,254518,254518,254520,0,2,2
72655,1,1,254519,254520,254521,1,2,0
72656,6,2,254525,254525,254527,0,2,4
72657,3,1,254528,254528,254529,0,1,1
72658,6,3,254534,254534,254537,0,3,5
72659,1,3,254535,254537,254540,2,5,0
72660,3,1,254538,254540,254541,2,3,0
72661,1,3,254539,254541,254544,2,5,0
72662,3,2,254542,254544,254546,2,4,0
72663,6,3,254548,254548,254551,0,3,2
72664,2,1,254550,254551,254552,1,2,0
72665,3,2,254553,254553,254555,0,2,1
72666,4,3,254557,254557,254560,0,3,2
72667,6,3,254563,254563,254566,0,3,3
72668,3,1,254566,254566,254567,0,1,0
72669,1,3,254567,254567,254570,0,3,0
72670,2,2,254569,254570,254572,1,3,0
72671,2,3,254571,254572,254575,1,4,0
72672,6,2,254577,254577,254579,0,2,2
72673,3,3,254580,254580,254583,0,3,1
72674,2,2,254582,254583,254585,1,3,0
72675,6,3,254588,254588,254591,0,3,3
72676,3,1,254591,254591,254592,0,1,0
72677,5,2,254596,254596,254598,0,2,4
72678,4,3,254600,254600,254603,0,3,2
72679,2,1,254602,254603,254604,1,2,0
72680,4,2,254606,254606,254608,0,2,2
72681,5,1,254611,254611,254612,0,1,3
72682,1,1,254612,254612,254613,0,1,0
72683,6,1,254618,254618,254619,0,1,5
72684,2,3,254620,254620,254623,0,3,1
72685,1,2,254621,254623,254625,2,4,0
72686,1,2,254622,254625,254627,3,5,0
72687,5,1,254627,254627,254628,0,1,0
72688,2,2,254629,254629,254631,0,2,1
72689,4,2,254633,254633,254635,0,2,2
72690,6,3,254639,254639,254642,0,3,4
72691,5,2,254644,254644,254646,0,2,2
72692,2,3,254646,254646,254649,0,3,0
72693,4,3,254650,254650,254653,0,3,1
72694,6,1,254656,254656,254657,0,1,3
72695,6,1,254662,254662,254663,0,1,5
72696,4,1,254666,254666,254667,0,1,3
72697,6,2,254672,254672,254674,0,2,5
72698,5,2,254677,254677,254679,0,2,3
72699,6,1,254683,254683,254684,0,1,4
72700,1,2,254684,254684,254686,0,2,0
72701,1,3,254685,254686,254689,1,4,0
72702,4,2,254689,254689,254691,0,2,0
72703,4,1,254693,254693,254694,0,1,2
72704,4,2,254697,254697,254699,0,2,3
72705,5,2,254702,254702,254704,0,2,3
72706,5,2,254707,254707,254709,0,2,3
72707,2,3,254709,254709,254712,0,3,0
72708,6,3,254715,254715,254718,0,3,3
72709,5,3,254720,254720,254723,0,3,2
72710,6,2,254726,254726,254728,0,2,3
72711,5,2,254731,254731,254733,0,2,3
72712,4,2,254735,254735,254737,0,2,2
72713,6,1,254741,254741,254742,0,1,4
72714,1,2,254742,254742,254744,0,2,0
72715,3,1,254745,254745,254746,0,1,1
72716,1,3,254746,254746,254749,0,3,0
72717,6,2,254752,254752,254754,0,2,3
72718,5,2,254757,254757,254759,0,2,3
72719,2,2,254759,254759,254761,0,2,0
72720,3,2,254762,254762,254764,0,2,1
72721,6,2,254768,254768,254770,0,2,4
72722,5,1,254773,254773,254774,0,1,3
72723,2,1,254775,254775,254776,0,1,1
72724,3,3,254778,254778,254781,0,3,2
72725,3,2,254781,254781,254783,0,2,0
72726,3,2,254784,254784,254786,0,2,1
72727,5,2,254789,254789,254791,0,2,3
72728,1,1,254790,254791,254792,1,2,0
72729,1,1,254791,254792,254793,1,2,0
72730,2,2,254793,254793,254795,0,2,0
72731,6,3,254799,254799,254802,0,3,4
72732,1,3,254800,254802,254805,2,5,0
72733,2,3,254802,254805,254808,3,6,0
72734,4,2,254806,254808,254810,2,4,0
72735,3,3,254809,254810,254813,1,4,0
72736,6,2,254815,254815,254817,0,2,2
72737,2,2,254817,254817,254819,0,2,0
72738,5,1,254822,254822,254823,0,1,3
72739,4,2,254826,254826,254828,0,2,3
72740,2,1,254828,254828,254829,0,1,0
72741,4,2,254832,254832,254834,0,2,3
72742,3,2,254835,254835,254837,0,2,1
72743,4,3,254839,254839,254842,0,3,2
72744,4,2,254843,254843,254845,0,2,1
72745,1,1,254844,254845,254846,1,2,0
72746,5,2,254849,254849,254851,0,2,3
72747,5,2,254854,254854,254856,0,2,3
72748,1,3,254855,254856,254859,1,4,0
72749,6,3,254861,254861,254864,0,3,2
72750,5,1,254866,254866,254867,0,1,2
72751,1,2,254867,254867,254869,0,2,0
72752,4,1,254871,254871,254872,0,1,2
72753,2,3,254873,254873,254876,0,3,1
72754,4,2,254877,254877,254879,0,2,1
72755,1,2,254878,254879,254881,1,3,0
72756,4,3,254882,254882,254885,0,3,1
72757,1,3,254883,254885,254888,2,5,0
72758,3,2,254886,254888,254890,2,4,0
72759,2,2,254888,254890,254892,2,4,0
72760,5,3,254893,254893,254896,0,3,1
72761,4,1,254897,254897,254898,0,1,1
72762,3,3,254900,254900,254903,0,3,2
72763,4,1,254904,254904,254905,0,1,1
72764,3,3,254907,254907,254910,0,3,2
72765,1,2,254908,254910,254912,2,4,0
72766,2,1,254910,254912,254913,2,3,0
72767,5,1,254915,254915,254916,0,1,2
72768,1,3,254916,254916,254919,0,3,0
72769,2,3,254918,254919,254922,1,4,0
72770,6,3,254924,254924,254927,0,3,2
72771,1,3,254925,254927,254930,2,5,0
72772,1,2,254926,254930,254932,4,6,0
72773,4,1,254930,254932,254933,2,3,0
72774,1,1,254931,254933,254934,2,3,0
72775,3,2,254934,254934,254936,0,2,0
72776,4,2,254938,254938,254940,0,2,2
72777,1,1,254939,254940,254941,1,2,0
72778,6,3,254945,254945,254948,0,3,4
72779,2,1,254947,254948,254949,1,2,0
72780,4,2,254951,254951,254953,0,2,2
72781,1,2,254952,254953,254955,1,3,0
72782,6,1,254958,254958,254959,0,1,3
72783,2,1,254960,254960,254961,0,1,1
72784,1,3,254961,254961,254964,0,3,0
72785,4,2,254965,254965,254967,0,2,1
72786,3,2,254968,254968,254970,0,2,1
72787,5,3,254973,254973,254976,0,3,3
72788,3,1,254976,254976,254977,0,1,0
72789,1,3,254977,254977,254980,0,3,0
72790,4,3,254981,254981,254984,0,3,1
72791,1,3,254982,254984,254987,2,5,0
72792,1,2,254983,254987,254989,4,6,0
72793,3,2,254986,254989,254991,3,5,0
72794,6,1,254992,254992,254993,0,1,1
72795,6,2,254998,254998,255000,0,2,5
72796,1,1,254999,255000,255001,1,2,0
72797,6,1,255005,255005,255006,0,1,4
72798,4,3,255009,255009,255012,0,3,3
72799,3,3,255012,255012,255015,0,3,0
72800,5,1,255017,255017,255018,0,1,2
72801,5,2,255022,255022,255024,0,2,4
72802,1,3,255023,255024,255027,1,4,0
72803,5,1,255028,255028,255029,0,1,1
72804,5,1,255033,255033,255034,0,1,4
72805,4,3,255037,255037,255040,0,3,3
72806,3,1,255040,255040,255041,0,1,0
72807,1,3,255041,255041,255044,0,3,0
72808,2,2,255043,255044,255046,1,3,0
72809,6,1,255049,255049,255050,0,1,3
72810,5,2,255054,255054,255056,0,2,4
72811,6,2,255060,255060,255062,0,2,4
72812,1,1,255061,255062,255063,1,2,0
72813,6,1,255067,255067,255068,0,1,4
72814,6,1,255073,255073,255074,0,1,5
72815,3,3,255076,255076,255079,0,3,2
72816,3,2,255079,255079,255081,0,2,0
72817,1,1,255080,255081,255082,1,2,0
72818,6,2,255086,255086,255088,0,2,4
72819,3,2,255089,255089,255091,0,2,1
72820,4,3,255093,255093,255096,0,3,2
72821,4,3,255097,255097,255100,0,3,1
72822,4,2,255101,255101,255103,0,2,1
72823,1,3,255102,255103,255106,1,4,0
72824,4,3,255106,255106,255109,0,3,0
72825,4,2,255110,255110,255112,0,2,1
72826,4,3,255114,255114,255117,0,3,2
72827,2,2,255116,255117,255119,1,3,0
72828,2,1,255118,255119,255120,1,2,0
72829,6,1,255124,255124,255125,0,1,4
72830,6,2,255130,255130,255132,0,2,5
72831,4,2,255134,255134,255136,0,2,2
72832,3,1,255137,255137,255138,0,1,1
72833,4,2,255141,255141,255143,0,2,3
72834,1,2,255142,255143,255145,1,3,0
72835,1,1,255143,255145,255146,2,3,0
72836,4,2,255147,255147,255149,0,2,1
72837,1,1,255148,255149,255150,1,2,0
72838,6,1,255154,255154,255155,0,1,4
72839,3,3,255157,255157,255160,0,3,2
72840,6,1,255163,255163,255164,0,1,3
72841,6,2,255169,255169,255171,0,2,5
72842,4,2,255173,255173,255175,0,2,2
72843,5,3,255178,255178,255181,0,3,3
72844,5,1,255183,255183,255184,0,1,2
72845,2,3,255185,255185,255188,0,3,1
72846,4,1,255189,255189,255190,0,1,1
72847,6,2,255195,255195,255197,0,2,5
72848,2,3,255197,255197,255200,0,3,0
72849,4,3,255201,255201,255204,0,3,1
72850,1,1,255202,255204,255205,2,3,0
72851,1,2,255203,255205,255207,2,4,0
72852,5,3,255208,255208,255211,0,3,1
72853,5,2,255213,255213,255215,0,2,2
72854,3,2,255216,255216,255218,0,2,1
72855,4,3,255220,255220,255223,0,3,2
72856,4,2,255224,255224,255226,0,2,1
72857,5,3,255229,255229,255232,0,3,3
72858,5,1,255234,255234,255235,0,1,2
72859,1,3,255235,255235,255238,0,3,0
72860,3,1,255238,255238,255239,0,1,0
72861,4,1,255242,255242,255243,0,1,3
72862,5,1,255247,255247,255248,0,1,4
72863,5,1,255252,255252,255253,0,1,4
72864,1,1,255253,255253,255254,0,1,0
72865,3,3,255256,255256,255259,0,3,2
72866,1,3,255257,255259,255262,2,5,0
72867,1,1,255258,255262,255263,4,5,0
72868,4,1,255262,255263,255264,1,2,0
72869,4,2,255266,255266,255268,0,2,2
72870,5,2,255271,255271,255273,0,2,3
72871,5,3,255276,255276,255279,0,3,3
72872,6,1,255282,255282,255283,0,1,3
72873,3,1,255285,255285,255286,0,1,2
72874,2,1,255287,255287,255288,0,1,1
72875,2,2,255289,255289,255291,0,2,1
72876,2,1,255291,255291,255292,0,1,0
72877,1,2,255292,255292,255294,0,2,0
72878,1,2,255293,255294,255296,1,3,0
72879,4,3,255297,255297,255300,0,3,1
72880,6,3,255303,255303,255306,0,3,3
72881,4,1,255307,255307,255308,0,1,1
72882,2,2,255309,255309,255311,0,2,1
72883,4,3,255313,255313,255316,0,3,2
72884,2,2,255315,255316,255318,1,3,0
72885,2,2,255317,255318,255320,1,3,0
72886,5,1,255322,255322,255323,0,1,2
72887,4,1,255326,255326,255327,0,1,3
72888,6,3,255332,255332,255335,0,3,5
72889,4,3,255336,255336,255339,0,3,1
72890,1,1,255337,255339,255340,2,3,0
72891,4,3,255341,255341,255344,0,3,1
72892,4,3,255345,255345,255348,0,3,1
72893,1,1,255346,255348,255349,2,3,0
72894,4,3,255350,255350,255353,0,3,1
72895,1,2,255351,255353,255355,2,4,0
72896,3,2,255354,255355,255357,1,3,0
72897,2,3,255356,255357,255360,1,4,0
72898,2,3,255358,255360,255363,2,5,0
72899,6,1,255364,255364,255365,0,1,1
72900,4,3,255368,255368,255371,0,3,3
72901,5,2,255373,255373,255375,0,2,2
72902,3,2,255376,255376,255378,0,2,1
72903,5,2,255381,255381,255383,0,2,3
72904,1,2,255382,255383,255385,1,3,0
72905,5,3,255387,255387,255390,0,3,2
72906,3,3,255390,255390,255393,0,3,0
72907,1,1,255391,255393,255394,2,3,0
72908,1,3,255392,255394,255397,2,5,0
72909,3,1,255395,255397,255398,2,3,0
72910,1,2,255396,255398,255400,2,4,0
72911,6,2,255402,255402,255404,0,2,2
72912,2,1,255404,255404,255405,0,1,0
72913,1,2,255405,255405,255407,0,2,0
72914,1,2,255406,255407,255409,1,3,0
72915,1,3,255407,255409,255412,2,5,0
72916,6,3,255413,255413,255416,0,3,1
72917,3,2,255416,255416,255418,0,2,0
72918,4,1,255420,255420,255421,0,1,2
72919,1,1,255421,255421,255422,0,1,0
72920,6,1,255427,255427,255428,0,1,5
72921,2,3,255429,255429,255432,0,3,1
72922,3,1,255432,255432,255433,0,1,0
72923,3,2,255435,255435,255437,0,2,2
72924,6,1,255441,255441,255442,0,1,4
72925,1,1,255442,255442,255443,0,1,0
72926,5,2,255447,255447,255449,0,2,4
72927,6,3,255453,255453,255456,0,3,4
72928,1,1,255454,255456,255457,2,3,0
72929,2,2,255456,255457,255459,1,3,0
72930,5,1,255461,255461,255462,0,1,2
72931,6,2,255467,255467,255469,0,2,5
72932,2,2,255469,255469,255471,0,2,0
72933,4,1,255473,255473,255474,0,1,2
72934,1,1,255474,255474,255475,0,1,0
72935,6,2,255480,255480,255482,0,2,5
72936,4,2,255484,255484,255486,0,2,2
72937,2,2,255486,255486,255488,0,2,0
72938,3,3,255489,255489,255492,0,3,1
72939,1,1,255490,255492,255493,2,3,0
72940,3,1,255493,255493,255494,0,1,0
72941,1,1,255494,255494,255495,0,1,0
72942,2,1,255496,255496,255497,0,1,1
72943,4,2,255500,255500,255502,0,2,3
72944,6,3,255506,255506,255509,0,3,4
72945,5,2,255511,255511,255513,0,2,2
72946,6,1,255517,255517,255518,0,1,4
72947,1,2,255518,255518,255520,0,2,0
72948,5,3,255523,255523,255526,0,3,3
72949,5,1,255528,255528,255529,0,1,2
72950,1,3,255529,255529,255532,0,3,0
72951,5,3,255534,255534,255537,0,3,2
72952,2,3,255536,255537,255540,1,4,0
72953,6,3,255542,255542,255545,0,3,2
72954,1,1,255543,255545,255546,2,3,0
72955,3,1,255546,255546,255547,0,1,0
72956,1,3,255547,255547,255550,0,3,0
72957,1,2,255548,255550,255552,2,4,0
72958,6,1,255554,255554,255555,0,1,2
72959,3,3,255557,255557,255560,0,3,2
72960,1,1,255558,255560,255561,2,3,0
72961,3,1,255561,255561,255562,0,1,0
72962,1,3,255562,255562,255565,0,3,0
72963,3,3,255565,255565,255568,0,3,0
72964,6,1,255571,255571,255572,0,1,3
72965,6,2,255577,255577,255579,0,2,5
72966,3,1,255580,255580,255581,0,1,1
72967,5,1,255585,255585,255586,0,1,4
72968,4,3,255589,255589,255592,0,3,3
72969,1,2,255590,255592,255594,2,4,0
72970,2,1,255592,255594,255595,2,3,0
72971,3,1,255595,255595,255596,0,1,0
72972,5,2,255600,255600,255602,0,2,4
72973,6,2,255606,255606,255608,0,2,4
72974,5,2,255611,255611,255613,0,2,3
72975,6,2,255617,255617,255619,0,2,4
72976,6,3,255623,255623,255626,0,3,4
72977,2,1,255625,255626,255627,1,2,0
72978,3,2,255628,255628,255630,0,2,1
72979,5,3,255633,255633,255636,0,3,3
72980,4,2,255637,255637,255639,0,2,1
72981,5,2,255642,255642,255644,0,2,3
72982,3,3,255645,255645,255648,0,3,1
72983,2,1,255647,255648,255649,1,2,0
72984,3,2,255650,255650,255652,0,2,1
72985,4,3,255654,255654,255657,0,3,2
72986,6,2,255660,255660,255662,0,2,3
72987,3,2,255663,255663,255665,0,2,1
72988,1,3,255664,255665,255668,1,4,0
72989,2,1,255666,255668,255669,2,3,0
72990,4,1,255670,255670,255671,0,1,1
72991,1,3,255671,255671,255674,0,3,0
72992,6,1,255677,255677,255678,0,1,3
72993,6,1,255683,255683,255684,0,1,5
72994,5,2,255688,255688,255690,0,2,4
72995,1,1,255689,255690,255691,1,2,0
72996,5,2,255694,255694,255696,0,2,3
72997,5,2,255699,255699,255701,0,2,3
72998,5,1,255704,255704,255705,0,1,3
72999,2,2,255706,255706,255708,0,2,1
73000,4,1,255710,255710,255711,0,1,2
73001,2,1,255712,255712,255713,0,1,1
73002,6,3,255718,255718,255721,0,3,5
73003,2,3,255720,255721,255724,1,4,0
73004,6,1,255726,255726,255727,0,1,2
73005,5,3,255731,255731,255734,0,3,4
73006,1,3,255732,255734,255737,2,5,0
73007,6,3,255738,255738,255741,0,3,1
73008,4,1,255742,255742,255743,0,1,1
73009,3,3,255745,255745,255748,0,3,2
73010,2,3,255747,255748,255751,1,4,0
73011,5,1,255752,255752,255753,0,1,1
73012,5,3,255757,255757,255760,0,3,4
73013,3,3,255760,255760,255763,0,3,0
73014,5,1,255765,255765,255766,0,1,2
73015,1,2,255766,255766,255768,0,2,0
73016,4,3,255770,255770,255773,0,3,2
73017,2,1,255772,255773,255774,1,2,0
73018,3,3,255775,255775,255778,0,3,1
73019,5,3,255780,255780,255783,0,3,2
73020,3,3,255783,255783,255786,0,3,0
73021,1,3,255784,255786,255789,2,5,0
73022,4,3,255788,255789,255792,1,4,0
73023,3,2,255791,255792,255794,1,3,0
73024,3,3,255794,255794,255797,0,3,0
73025,4,1,255798,255798,255799,0,1,1
73026,2,1,255800,255800,255801,0,1,1
73027,3,1,255803,255803,255804,0,1,2
73028,6,2,255809,255809,255811,0,2,5
73029,1,3,255810,255811,255814,1,4,0
73030,6,1,255816,255816,255817,0,1,2
73031,4,1,255820,255820,255821,0,1,3
73032,3,3,255823,255823,255826,0,3,2
73033,4,1,255827,255827,255828,0,1,1
73034,5,2,255832,255832,255834,0,2,4
73035,1,3,255833,255834,255837,1,4,0
73036,6,3,255839,255839,255842,0,3,2
73037,2,1,255841,255842,255843,1,2,0
73038,3,2,255844,255844,255846,0,2,1
73039,1,2,255845,255846,255848,1,3,0
73040,2,1,255847,255848,255849,1,2,0
73041,5,1,255852,255852,255853,0,1,3
73042,1,2,255853,255853,255855,0,2,0
73043,5,3,255858,255858,255861,0,3,3
73044,4,3,255862,255862,255865,0,3,1
73045,5,1,255867,255867,255868,0,1,2
73046,5,3,255872,255872,255875,0,3,4
73047,1,1,255873,255875,255876,2,3,0
73048,2,2,255875,255876,255878,1,3,0
73049,5,1,255880,255880,255881,0,1,2
73050,1,1,255881,255881,255882,0,1,0
73051,2,2,255883,255883,255885,0,2,1
73052,2,3,255885,255885,255888,0,3,0
73053,1,1,255886,255888,255889,2,3,0
73054,4,2,255890,255890,255892,0,2,1
73055,6,2,255896,255896,255898,0,2,4
73056,1,1,255897,255898,255899,1,2,0
73057,3,1,255900,255900,255901,0,1,1
73058,4,3,255904,255904,255907,0,3,3
73059,2,1,255906,255907,255908,1,2,0
73060,5,3,255911,255911,255914,0,3,3
73061,6,1,255917,255917,255918,0,1,3
73062,6,2,255923,255923,255925,0,2,5
73063,3,1,255926,255926,255927,0,1,1
73064,2,2,255928,255928,255930,0,2,1
73065,2,3,255930,255930,255933,0,3,0
73066,4,1,255934,255934,255935,0,1,1
73067,1,1,255935,255935,255936,0,1,0
73068,2,2,255937,255937,255939,0,2,1
73069,1,2,255938,255939,255941,1,3,0
73070,6,3,255944,255944,255947,0,3,3
73071,3,2,255947,255947,255949,0,2,0
73072,5,2,255952,255952,255954,0,2,3
73073,1,3,255953,255954,255957,1,4,0
73074,1,1,255954,255957,255958,3,4,0
73075,5,1,255959,255959,255960,0,1,1
73076,3,1,255962,255962,255963,0,1,2
73077,3,3,255965,255965,255968,0,3,2
73078,6,1,255971,255971,255972,0,1,3
73079,1,1,255972,255972,255973,0,1,0
73080,1,1,255973,255973,255974,0,1,0
73081,2,1,255975,255975,255976,0,1,1
73082,3,1,255978,255978,255979,0,1,2
73083,1,2,255979,255979,255981,0,2,0
73084,2,1,255981,255981,255982,0,1,0
73085,4,2,255985,255985,255987,0,2,3
73086,4,3,255989,255989,255992,0,3,2
73087,6,1,255995,255995,255996,0,1,3
73088,4,1,255999,255999,256000,0,1,3
73089,1,3,256000,256000,256003,0,3,0
73090,3,2,256003,256003,256005,0,2,0
73091,5,3,256008,256008,256011,0,3,3
73092,2,1,256010,256011,256012,1,2,0
73093,4,2,256014,256014,256016,0,2,2
73094,5,1,256019,256019,256020,0,1,3
73095,2,1,256021,256021,256022,0,1,1
73096,2,3,256023,256023,256026,0,3,1
73097,3,1,256026,256026,256027,0,1,0
73098,3,1,256029,256029,256030,0,1,2
73099,4,3,256033,256033,256036,0,3,3
73100,2,3,256035,256036,256039,1,4,0
73101,3,1,256038,256039,256040,1,2,0
73102,2,1,256040,256040,256041,0,1,0
73103,4,2,256044,256044,256046,0,2,3
73104,1,1,256045,256046,256047,1,2,0
73105,4,2,256049,256049,256051,0,2,2
73106,6,2,256055,256055,256057,0,2,4
73107,5,2,256060,256060,256062,0,2,3
73108,4,2,256064,256064,256066,0,2,2
73109,2,1,256066,256066,256067,0,1,0
73110,6,2,256072,256072,256074,0,2,5
73111,3,3,256075,256075,256078,0,3,1
73112,5,2,256080,256080,256082,0,2,2
73113,4,1,256084,256084,256085,0,1,2
73114,6,3,256090,256090,256093,0,3,5
73115,1,2,256091,256093,256095,2,4,0
73116,2,2,256093,256095,256097,2,4,0
73117,1,2,256094,256097,256099,3,5,0
73118,3,1,256097,256099,256100,2,3,0
73119,1,1,256098,256100,256101,2,3,0
73120,3,1,256101,256101,256102,0,1,0
73121,6,1,256107,256107,256108,0,1,5
73122,2,2,256109,256109,256111,0,2,1
73123,3,3,256112,256112,256115,0,3,1
73124,3,2,256115,256115,256117,0,2,0
73125,3,2,256118,256118,256120,0,2,1
73126,4,1,256122,256122,256123,0,1,2
73127,3,1,256125,256125,256126,0,1,2
73128,5,1,256130,256130,256131,0,1,4
73129,5,2,256135,256135,256137,0,2,4
73130,4,2,256139,256139,256141,0,2,2
73131,4,3,256143,256143,256146,0,3,2
73132,1,3,256144,256146,256149,2,5,0
73133,6,1,256150,256150,256151,0,1,1
73134,6,1,256156,256156,256157,0,1,5
73135,3,3,256159,256159,256162,0,3,2
73136,3,2,256162,256162,256164,0,2,0
73137,4,2,256166,256166,256168,0,2,2
73138,6,2,256172,256172,256174,0,2,4
73139,2,3,256174,256174,256177,0,3,0
73140,6,3,256180,256180,256183,0,3,3
73141,2,3,256182,256183,256186,1,4,0
73142,1,2,256183,256186,256188,3,5,0
73143,5,2,256188,256188,256190,0,2,0
73144,6,3,256194,256194,256197,0,3,4
73145,5,1,256199,256199,256200,0,1,2
73146,6,3,256205,256205,256208,0,3,5
73147,5,1,256210,256210,256211,0,1,2
73148,1,3,256211,256211,256214,0,3,0
73149,3,1,256214,256214,256215,0,1,0
73150,2,2,256216,256216,256218,0,2,1
73151,6,1,256222,256222,256223,0,1,4
73152,5,3,256227,256227,256230,0,3,4
73153,3,1,256230,256230,256231,0,1,0
73154,6,1,256236,256236,256237,0,1,5
73155,1,3,256237,256237,256240,0,3,0
73156,1,2,256238,256240,256242,2,4,0
73157,1,1,256239,256242,256243,3,4,0
73158,6,1,256245,256245,256246,0,1,2
73159,6,2,256251,256251,256253,0,2,5
73160,5,3,256256,256256,256259,0,3,3
73161,4,2,256260,256260,256262,0,2,1
73162,4,1,256264,256264,256265,0,1,2
73163,3,3,256267,256267,256270,0,3,2
73164,1,2,256268,256270,256272,2,4,0
73165,5,2,256273,256273,256275,0,2,1
73166,1,3,256274,256275,256278,1,4,0
73167,6,1,256280,256280,256281,0,1,2
73168,3,1,256283,256283,256284,0,1,2
73169,1,2,256284,256284,256286,0,2,0
73170,4,1,256288,256288,256289,0,1,2
73171,6,1,256294,256294,256295,0,1,5
73172,5,2,256299,256299,256301,0,2,4
73173,6,2,256305,256305,256307,0,2,4
73174,3,1,256308,256308,256309,0,1,1
73175,4,3,256312,256312,256315,0,3,3
73176,4,3,256316,256316,256319,0,3,1
73177,5,2,256321,256321,256323,0,2,2
73178,3,3,256324,256324,256327,0,3,1
73179,1,1,256325,256327,256328,2,3,0
73180,4,1,256329,256329,256330,0,1,1
73181,1,3,256330,256330,256333,0,3,0
73182,1,3,256331,256333,256336,2,5,0
73183,1,2,256332,256336,256338,4,6,0
73184,3,2,256335,256338,256340,3,5,0
73185,4,3,256339,256340,256343,1,4,0
73186,2,3,256341,256343,256346,2,5,0
73187,6,1,256347,256347,256348,0,1,1
73188,1,2,256348,256348,256350,0,2,0
73189,5,2,256353,256353,256355,0,2,3
73190,5,1,256358,256358,256359,0,1,3
73191,1,1,256359,256359,256360,0,1,0
73192,4,3,256363,256363,256366,0,3,3
73193,3,3,256366,256366,256369,0,3,0
73194,3,1,256369,256369,256370,0,1,0
73195,5,3,256374,256374,256377,0,3,4
73196,5,2,256379,256379,256381,0,2,2
73197,5,3,256384,256384,256387,0,3,3
73198,6,1,256390,256390,256391,0,1,3
73199,1,2,256391,256391,256393,0,2,0
73200,3,3,256394,256394,256397,0,3,1
73201,2,2,256396,256397,256399,1,3,0
73202,6,2,256402,256402,256404,0,2,3
73203,6,2,256408,256408,256410,0,2,4
73204,4,2,256412,256412,256414,0,2,2
73205,1,3,256413,256414,256417,1,4,0
73206,5,1,256418,256418,256419,0,1,1
73207,3,2,256421,256421,256423,0,2,2
73208,2,3,256423,256423,256426,0,3,0
73209,2,2,256425,256426,256428,1,3,0
73210,5,2,256430,256430,256432,0,2,2
73211,4,1,256434,256434,256435,0,1,2
73212,2,3,256436,256436,256439,0,3,1
73213,1,2,256437,256439,256441,2,4,0
73214,6,3,256443,256443,256446,0,3,2
73215,6,3,256449,256449,256452,0,3,3
73216,1,3,256450,256452,256455,2,5,0
73217,6,2,256456,256456,256458,0,2,1
73218,1,2,256457,256458,256460,1,3,0
73219,5,1,256462,256462,256463,0,1,2
73220,1,1,256463,256463,256464,0,1,0
73221,4,3,256467,256467,256470,0,3,3
73222,4,1,256471,256471,256472,0,1,1
73223,3,2,256474,256474,256476,0,2,2
73224,3,3,256477,256477,256480,0,3,1
73225,4,2,256481,256481,256483,0,2,1
73226,1,1,256482,256483,256484,1,2,0
73227,2,1,256484,256484,256485,0,1,0
73228,4,3,256488,256488,256491,0,3,3
73229,4,2,256492,256492,256494,0,2,1
73230,5,3,256497,256497,256500,0,3,3
73231,1,3,256498,256500,256503,2,5,0
73232,2,1,256500,256503,256504,3,4,0
73233,3,3,256503,256504,256507,1,4,0
73234,4,2,256507,256507,256509,0,2,0
73235,6,3,256513,256513,256516,0,3,4
73236,4,3,256517,256517,256520,0,3,1
73237,6,2,256523,256523,256525,0,2,3
73238,1,1,256524,256525,256526,1,2,0
73239,3,2,256527,256527,256529,0,2,1
73240,5,1,256532,256532,256533,0,1,3
73241,4,3,256536,256536,256539,0,3,3
73242,5,1,256541,256541,256542,0,1,2
73243,1,2,256542,256542,256544,0,2,0
73244,6,3,256548,256548,256551,0,3,4
73245,6,2,256554,256554,256556,0,2,3
73246,1,3,256555,256556,256559,1,4,0
73247,2,3,256557,256559,256562,2,5,0
73248,2,1,256559,256562,256563,3,4,0
73249,4,3,256563,256563,256566,0,3,0
73250,5,3,256568,256568,256571,0,3,2
73251,2,1,256570,256571,256572,1,2,0
73252,4,2,256574,256574,256576,0,2,2
73253,1,1,256575,256576,256577,1,2,0
73254,4,2,256579,256579,256581,0,2,2
73255,5,2,256584,256584,256586,0,2,3
73256,2,2,256586,256586,256588,0,2,0
73257,2,1,256588,256588,256589,0,1,0
73258,1,2,256589,256589,256591,0,2,0
73259,3,2,256592,256592,256594,0,2,1
73260,5,3,256597,256597,256600,0,3,3
73261,6,1,256603,256603,256604,0,1,3
73262,5,3,256608,256608,256611,0,3,4
73263,6,3,256614,256614,256617,0,3,3
73264,5,2,256619,256619,256621,0,2,2
73265,5,1,256624,256624,256625,0,1,3
73266,2,3,256626,256626,256629,0,3,1
73267,4,1,256630,256630,256631,0,1,1
73268,5,2,256635,256635,256637,0,2,4
73269,2,1,256637,256637,256638,0,1,0
73270,3,3,256640,256640,256643,0,3,2
73271,5,2,256645,256645,256647,0,2,2
73272,1,3,256646,256647,256650,1,4,0
73273,5,2,256651,256651,256653,0,2,1
73274,6,1,256657,256657,256658,0,1,4
73275,2,3,256659,256659,256662,0,3,1
73276,3,3,256662,256662,256665,0,3,0
73277,5,1,256667,256667,256668,0,1,2
73278,6,3,256673,256673,256676,0,3,5
73279,6,1,256679,256679,256680,0,1,3
73280,6,3,256685,256685,256688,0,3,5
73281,2,2,256687,256688,256690,1,3,0
73282,2,2,256689,256690,256692,1,3,0
73283,3,1,256692,256692,256693,0,1,0
73284,2,1,256694,256694,256695,0,1,1
73285,1,2,256695,256695,256697,0,2,0
73286,5,3,256700,256700,256703,0,3,3
73287,5,2,256705,256705,256707,0,2,2
73288,1,3,256706,256707,256710,1,4,0
73289,3,3,256709,256710,256713,1,4,0
73290,6,2,256715,256715,256717,0,2,2
73291,4,3,256719,256719,256722,0,3,2
73292,2,3,256721,256722,256725,1,4,0
73293,3,3,256724,256725,256728,1,4,0
73294,6,1,256730,256730,256731,0,1,2
73295,1,1,256731,256731,256732,0,1,0
73296,2,2,256733,256733,256735,0,2,1
73297,6,3,256739,256739,256742,0,3,4
73298,5,1,256744,256744,256745,0,1,2
73299,2,3,256746,256746,256749,0,3,1
73300,5,3,256751,256751,256754,0,3,2
73301,1,3,256752,256754,256757,2,5,0
73302,4,1,256756,256757,256758,1,2,0
73303,2,2,256758,256758,256760,0,2,0
73304,2,3,256760,256760,256763,0,3,0
73305,2,1,256762,256763,256764,1,2,0
73306,6,1,256768,256768,256769,0,1,4
73307,3,2,256771,256771,256773,0,2,2
73308,6,1,256777,256777,256778,0,1,4
73309,3,1,256780,256780,256781,0,1,2
73310,1,3,256781,256781,256784,0,3,0
73311,5,3,256786,256786,256789,0,3,2
73312,5,3,256791,256791,256794,0,3,2
73313,1,2,256792,256794,256796,2,4,0
73314,5,3,256797,256797,256800,0,3,1
73315,5,3,256802,256802,256805,0,3,2
73316,4,3,256806,256806,256809,0,3,1
73317,5,2,256811,256811,256813,0,2,2
73318,5,3,256816,256816,256819,0,3,3
73319,2,2,256818,256819,256821,1,3,0
73320,3,2,256821,256821,256823,0,2,0
73321,5,2,256826,256826,256828,0,2,3
73322,6,3,256832,256832,256835,0,3,4
73323,3,3,256835,256835,256838,0,3,0
73324,5,2,256840,256840,256842,0,2,2
73325,1,3,256841,256842,256845,1,4,0
73326,5,1,256846,256846,256847,0,1,1
73327,1,1,256847,256847,256848,0,1,0
73328,1,3,256848,256848,256851,0,3,0
73329,2,3,256850,256851,256854,1,4,0
73330,2,2,256852,256854,256856,2,4,0
73331,1,3,256853,256856,256859,3,6,0
73332,2,1,256855,256859,256860,4,5,0
73333,6,1,256861,256861,256862,0,1,1
73334,4,3,256865,256865,256868,0,3,3
73335,2,2,256867,256868,256870,1,3,0
73336,5,2,256872,256872,256874,0,2,2
73337,5,3,256877,256877,256880,0,3,3
73338,5,3,256882,256882,256885,0,3,2
73339,6,1,256888,256888,256889,0,1,3
73340,6,2,256894,256894,256896,0,2,5
73341,3,2,256897,256897,256899,0,2,1
73342,2,1,256899,256899,256900,0,1,0
73343,1,1,256900,256900,256901,0,1,0
73344,4,3,256904,256904,256907,0,3,3
73345,6,2,256910,256910,256912,0,2,3
73346,5,1,256915,256915,256916,0,1,3
73347,3,1,256918,256918,256919,0,1,2
73348,6,1,256924,256924,256925,0,1,5
73349,6,3,256930,256930,256933,0,3,5
73350,5,1,256935,256935,256936,0,1,2
73351,1,1,256936,256936,256937,0,1,0
73352,4,3,256940,256940,256943,0,3,3
73353,4,1,256944,256944,256945,0,1,1
73354,3,1,256947,256947,256948,0,1,2
73355,2,1,256949,256949,256950,0,1,1
73356,4,3,256953,256953,256956,0,3,3
73357,5,2,256958,256958,256960,0,2,2
73358,5,3,256963,256963,256966,0,3,3
73359,3,2,256966,256966,256968,0,2,0
73360,1,2,256967,256968,256970,1,3,0
73361,3,2,256970,256970,256972,0,2,0
73362,2,1,256972,256972,256973,0,1,0
73363,5,2,256977,256977,256979,0,2,4
73364,4,2,256981,256981,256983,0,2,2
73365,1,3,256982,256983,256986,1,4,0
73366,5,3,256987,256987,256990,0,3,1
73367,6,2,256993,256993,256995,0,2,3
73368,2,3,256995,256995,256998,0,3,0
73369,1,1,256996,256998,256999,2,3,0
73370,2,2,256998,256999,257001,1,3,0
73371,2,3,257000,257001,257004,1,4,0
73372,5,2,257005,257005,257007,0,2,1
73373,3,2,257008,257008,257010,0,2,1
73374,5,2,257013,257013,257015,0,2,3
73375,3,1,257016,257016,257017,0,1,1
73376,1,3,257017,257017,257020,0,3,0
73377,5,2,257022,257022,257024,0,2,2
73378,1,1,257023,257024,257025,1,2,0
73379,3,1,257026,257026,257027,0,1,1
73380,4,1,257030,257030,257031,0,1,3
73381,1,2,257031,257031,257033,0,2,0
73382,3,3,257034,257034,257037,0,3,1
73383,4,3,257038,257038,257041,0,3,1
73384,4,2,257042,257042,257044,0,2,1
73385,1,2,257043,257044,257046,1,3,0
73386,2,2,257045,257046,257048,1,3,0
73387,3,2,257048,257048,257050,0,2,0
73388,2,1,257050,257050,257051,0,1,0
73389,4,1,257054,257054,257055,0,1,3
73390,5,2,257059,257059,257061,0,2,4
73391,4,3,257063,257063,257066,0,3,2
73392,6,3,257069,257069,257072,0,3,3
73393,6,3,257075,257075,257078,0,3,3
73394,1,2,257076,257078,257080,2,4,0
73395,3,1,257079,257080,257081,1,2,0
73396,5,3,257084,257084,257087,0,3,3
73397,3,1,257087,257087,257088,0,1,0
73398,1,2,257088,257088,257090,0,2,0
73399,5,2,257093,257093,257095,0,2,3
73400,6,1,257099,257099,257100,0,1,4
73401,4,1,257103,257103,257104,0,1,3
73402,2,1,257105,257105,257106,0,1,1
73403,1,3,257106,257106,257109,0,3,0
73404,4,1,257110,257110,257111,0,1,1
73405,2,3,257112,257112,257115,0,3,1
73406,2,3,257114,257115,257118,1,4,0
73407,3,2,257117,257118,257120,1,3,0
73408,3,1,257120,257120,257121,0,1,0
73409,5,2,257125,257125,257127,0,2,4
73410,3,2,257128,257128,257130,0,2,1
73411,3,1,257131,257131,257132,0,1,1
73412,3,3,257134,257134,257137,0,3,2
73413,4,3,257138,257138,257141,0,3,1
73414,5,2,257143,257143,257145,0,2,2
73415,4,3,257147,257147,257150,0,3,2
73416,6,3,257153,257153,257156,0,3,3
73417,4,1,257157,257157,257158,0,1,1
73418,6,1,257163,257163,257164,0,1,5
73419,3,2,257166,257166,257168,0,2,2
73420,3,2,257169,257169,257171,0,2,1
73421,1,1,257170,257171,257172,1,2,0
73422,2,1,257172,257172,257173,0,1,0
73423,2,3,257174,257174,257177,0,3,1
73424,3,3,257177,257177,257180,0,3,0
73425,3,3,257180,257180,257183,0,3,0
73426,5,1,257185,257185,257186,0,1,2
73427,6,3,257191,257191,257194,0,3,5
73428,2,1,257193,257194,257195,1,2,0
73429,5,3,257198,257198,257201,0,3,3
73430,6,2,257204,257204,257206,0,2,3
73431,1,3,257205,257206,257209,1,4,0
73432,3,1,257208,257209,257210,1,2,0
73433,5,3,257213,257213,257216,0,3,3
73434,1,3,257214,257216,257219,2,5,0
73435,5,3,257219,257219,257222,0,3,0
73436,1,3,257220,257222,257225,2,5,0
73437,1,3,257221,257225,257228,4,7,0
73438,3,1,257224,257228,257229,4,5,0
73439,5,1,257229,257229,257230,0,1,0
73440,3,2,257232,257232,257234,0,2,2
73441,6,3,257238,257238,257241,0,3,4
73442,2,1,257240,257241,257242,1,2,0
73443,4,1,257244,257244,257245,0,1,2
73444,5,2,257249,257249,257251,0,2,4
73445,5,3,257254,257254,257257,0,3,3
73446,3,2,257257,257257,257259,0,2,0
73447,2,1,257259,257259,257260,0,1,0
73448,3,3,257262,257262,257265,0,3,2
73449,6,2,257268,257268,257270,0,2,3
73450,1,3,257269,257270,257273,1,4,0
73451,5,3,257274,257274,257277,0,3,1
73452,6,2,257280,257280,257282,0,2,3
73453,2,1,257282,257282,257283,0,1,0
73454,1,3,257283,257283,257286,0,3,0
73455,5,3,257288,257288,257291,0,3,2
73456,3,3,257291,257291,257294,0,3,0
73457,2,3,257293,257294,257297,1,4,0
73458,4,1,257297,257297,257298,0,1,0
73459,5,3,257302,257302,257305,0,3,4
73460,5,2,257307,257307,257309,0,2,2
73461,6,3,257313,257313,257316,0,3,4
73462,2,2,257315,257316,257318,1,3,0
73463,1,3,257316,257318,257321,2,5,0
73464,3,2,257319,257321,257323,2,4,0
73465,3,2,257322,257323,257325,1,3,0
73466,3,2,257325,257325,257327,0,2,0
73467,2,2,257327,257327,257329,0,2,0
73468,2,1,257329,257329,257330,0,1,0
73469,4,3,257333,257333,257336,0,3,3
73470,3,2,257336,257336,257338,0,2,0
73471,1,3,257337,257338,257341,1,4,0
73472,5,2,257342,257342,257344,0,2,1
73473,1,1,257343,257344,257345,1,2,0
73474,4,2,257347,257347,257349,0,2,2
73475,2,3,257349,257349,257352,0,3,0
73476,4,2,257353,257353,257355,0,2,1
73477,1,2,257354,257355,257357,1,3,0
73478,4,1,257358,257358,257359,0,1,1
73479,2,2,257360,257360,257362,0,2,1
73480,3,2,257363,257363,257365,0,2,1
73481,6,3,257369,257369,257372,0,3,4
73482,4,2,257373,257373,257375,0,2,1
73483,3,1,257376,257376,257377,0,1,1
73484,5,1,257381,257381,257382,0,1,4
73485,1,3,257382,257382,257385,0,3,0
73486,3,3,257385,257385,257388,0,3,0
73487,1,3,257386,257388,257391,2,5,0
73488,5,3,257391,257391,257394,0,3,0
73489,2,3,257393,257394,257397,1,4,0
73490,5,2,257398,257398,257400,0,2,1
73491,3,2,257401,257401,257403,0,2,1
73492,1,1,257402,257403,257404,1,2,0
73493,1,2,257403,257404,257406,1,3,0
73494,4,1,257407,257407,257408,0,1,1
73495,3,1,257410,257410,257411,0,1,2
73496,4,3,257414,257414,257417,0,3,3
73497,3,3,257417,257417,257420,0,3,0
73498,4,3,257421,257421,257424,0,3,1
73499,1,2,257422,257424,257426,2,4,0
73500,6,2,257428,257428,257430,0,2,2
73501,4,1,257432,257432,257433,0,1,2
73502,4,3,257436,257436,257439,0,3,3
73503,2,3,257438,257439,257442,1,4,0
73504,6,1,257444,257444,257445,0,1,2
73505,1,1,257445,257445,257446,0,1,0
73506,6,3,257451,257451,257454,0,3,5
73507,4,1,257455,257455,257456,0,1,1
73508,4,1,257459,257459,257460,0,1,3
73509,5,3,257464,257464,257467,0,3,4
73510,3,1,257467,257467,257468,0,1,0
73511,4,2,257471,257471,257473,0,2,3
73512,6,2,257477,257477,257479,0,2,4
73513,4,1,257481,257481,257482,0,1,2
73514,6,3,257487,257487,257490,0,3,5
73515,4,3,257491,257491,257494,0,3,1
73516,5,3,257496,257496,257499,0,3,2
73517,5,1,257501,257501,257502,0,1,2
73518,6,1,257507,257507,257508,0,1,5
73519,2,1,257509,257509,257510,0,1,1
73520,4,1,257513,257513,257514,0,1,3
73521,2,2,257515,257515,257517,0,2,1
73522,6,2,257521,257521,257523,0,2,4
73523,2,1,257523,257523,257524,0,1,0
73524,5,2,257528,257528,257530,0,2,4
73525,6,3,257534,257534,257537,0,3,4
73526,3,1,257537,257537,257538,0,1,0
73527,3,3,257540,257540,257543,0,3,2
73528,4,2,257544,257544,257546,0,2,1
73529,4,1,257548,257548,257549,0,1,2
73530,5,3,257553,257553,257556,0,3,4
73531,5,2,257558,257558,257560,0,2,2
73532,2,3,257560,257560,257563,0,3,0
73533,5,2,257565,257565,257567,0,2,2
73534,6,2,257571,257571,257573,0,2,4
73535,2,1,257573,257573,257574,0,1,0
73536,5,1,257578,257578,257579,0,1,4
73537,3,1,257581,257581,257582,0,1,2
73538,6,2,257587,257587,257589,0,2,5
73539,4,3,257591,257591,257594,0,3,2
73540,5,1,257596,257596,257597,0,1,2
73541,3,3,257599,257599,257602,0,3,2
73542,2,2,257601,257602,257604,1,3,0
73543,1,1,257602,257604,257605,2,3,0
73544,6,2,257608,257608,257610,0,2,3
73545,6,2,257614,257614,257616,0,2,4
73546,6,2,257620,257620,257622,0,2,4
73547,4,1,257624,257624,257625,0,1,2
73548,3,2,257627,257627,257629,0,2,2
73549,5,3,257632,257632,257635,0,3,3
73550,5,1,257637,257637,257638,0,1,2
73551,2,3,257639,257639,257642,0,3,1
73552,3,3,257642,257642,257645,0,3,0
73553,4,2,257646,257646,257648,0,2,1
73554,2,2,257648,257648,257650,0,2,0
73555,2,1,257650,257650,257651,0,1,0
73556,4,1,257654,257654,257655,0,1,3
73557,2,1,257656,257656,257657,0,1,1
73558,1,1,257657,257657,257658,0,1,0
73559,2,1,257659,257659,257660,0,1,1
73560,2,2,257661,257661,257663,0,2,1
73561,5,3,257666,257666,257669,0,3,3
73562,2,2,257668,257669,257671,1,3,0
73563,5,1,257673,257673,257674,0,1,2
73564,5,2,257678,257678,257680,0,2,4
73565,4,1,257682,257682,257683,0,1,2
73566,2,3,257684,257684,257687,0,3,1
73567,5,1,257689,257689,257690,0,1,2
73568,3,1,257692,257692,257693,0,1,2
73569,3,1,257695,257695,257696,0,1,2
73570,2,1,257697,257697,257698,0,1,1
73571,3,1,257700,257700,257701,0,1,2
73572,4,2,257704,257704,257706,0,2,3
73573,3,3,257707,257707,257710,0,3,1
73574,3,1,257710,257710,257711,0,1,0
73575,3,3,257713,257713,257716,0,3,2
73576,6,3,257719,257719,257722,0,3,3
73577,4,3,257723,257723,257726,0,3,1
73578,2,2,257725,257726,257728,1,3,0
73579,6,2,257731,257731,257733,0,2,3
73580,4,2,257735,257735,257737,0,2,2
73581,3,2,257738,257738,257740,0,2,1
73582,1,2,257739,257740,257742,1,3,0
73583,4,3,257743,257743,257746,0,3,1
73584,1,2,257744,257746,257748,2,4,0
73585,5,2,257749,257749,257751,0,2,1
73586,3,3,257752,257752,257755,0,3,1
73587,3,1,257755,257755,257756,0,1,0
73588,2,2,257757,257757,257759,0,2,1
73589,6,3,257763,257763,257766,0,3,4
73590,6,3,257769,257769,257772,0,3,3
73591,6,2,257775,257775,257777,0,2,3
73592,3,1,257778,257778,257779,0,1,1
73593,2,1,257780,257780,257781,0,1,1
73594,6,1,257786,257786,257787,0,1,5
73595,3,1,257789,257789,257790,0,1,2
73596,3,2,257792,257792,257794,0,2,2
73597,4,2,257796,257796,257798,0,2,2
73598,6,2,257802,257802,257804,0,2,4
73599,4,1,257806,257806,257807,0,1,2
73600,5,3,257811,257811,257814,0,3,4
73601,2,1,257813,257814,257815,1,2,0
73602,6,1,257819,257819,257820,0,1,4
73603,5,3,257824,257824,257827,0,3,4
73604,3,1,257827,257827,257828,0,1,0
73605,6,1,257833,257833,257834,0,1,5
73606,4,1,257837,257837,257838,0,1,3
73607,4,2,257841,257841,257843,0,2,3
73608,1,1,257842,257843,257844,1,2,0
73609,2,1,257844,257844,257845,0,1,0
73610,6,3,257850,257850,257853,0,3,5
73611,6,1,257856,257856,257857,0,1,3
73612,5,3,257861,257861,257864,0,3,4
73613,2,2,257863,257864,257866,1,3,0
73614,2,2,257865,257866,257868,1,3,0
73615,4,1,257869,257869,257870,0,1,1
73616,5,1,257874,257874,257875,0,1,4
73617,2,3,257876,257876,257879,0,3,1
73618,1,3,257877,257879,257882,2,5,0
73619,3,3,257880,257882,257885,2,5,0
73620,3,2,257883,257885,257887,2,4,0
73621,1,2,257884,257887,257889,3,5,0
73622,5,2,257889,257889,257891,0,2,0
73623,5,1,257894,257894,257895,0,1,3
73624,6,3,257900,257900,257903,0,3,5
73625,6,3,257906,257906,257909,0,3,3
73626,4,3,257910,257910,257913,0,3,1
73627,6,3,257916,257916,257919,0,3,3
73628,3,1,257919,257919,257920,0,1,0
73629,5,3,257924,257924,257927,0,3,4
73630,4,3,257928,257928,257931,0,3,1
73631,3,2,257931,257931,257933,0,2,0
73632,5,1,257936,257936,257937,0,1,3
73633,5,2,257941,257941,257943,0,2,4
73634,5,2,257946,257946,257948,0,2,3
73635,6,1,257952,257952,257953,0,1,4
73636,6,1,257958,257958,257959,0,1,5
73637,2,2,257960,257960,257962,0,2,1
73638,3,3,257963,257963,257966,0,3,1
73639,6,3,257969,257969,257972,0,3,3
73640,2,2,257971,257972,257974,1,3,0
73641,1,2,257972,257974,257976,2,4,0
73642,2,1,257974,257976,257977,2,3,0
73643,5,2,257979,257979,257981,0,2,2
73644,1,2,257980,257981,257983,1,3,0
73645,2,3,257982,257983,257986,1,4,0
73646,1,1,257983,257986,257987,3,4,0
73647,1,3,257984,257987,257990,3,6,0
73648,6,1,257990,257990,257991,0,1,0
73649,6,3,257996,257996,257999,0,3,5
73650,6,3,258002,258002,258005,0,3,3
73651,6,1,258008,258008,258009,0,1,3
73652,5,3,258013,258013,258016,0,3,4
73653,2,3,258015,258016,258019,1,4,0
73654,4,3,258019,258019,258022,0,3,0
73655,1,3,258020,258022,258025,2,5,0
73656,4,3,258024,258025,258028,1,4,0
73657,5,2,258029,258029,258031,0,2,1
73658,1,2,258030,258031,258033,1,3,0
73659,2,3,258032,258033,258036,1,4,0
73660,6,3,258038,258038,258041,0,3,2
73661,1,2,258039,258041,258043,2,4,0
73662,3,1,258042,258043,258044,1,2,0
73663,2,2,258044,258044,258046,0,2,0
73664,4,1,258048,258048,258049,0,1,2
73665,2,3,258050,258050,258053,0,3,1
73666,6,2,258056,258056,258058,0,2,3
73667,6,3,258062,258062,258065,0,3,4
73668,1,2,258063,258065,258067,2,4,0
73669,3,1,258066,258067,258068,1,2,0
73670,3,3,258069,258069,258072,0,3,1
73671,4,1,258073,258073,258074,0,1,1
73672,3,3,258076,258076,258079,0,3,2
73673,4,2,258080,258080,258082,0,2,1
73674,5,3,258085,258085,258088,0,3,3
73675,4,3,258089,258089,258092,0,3,1
73676,6,3,258095,258095,258098,0,3,3
73677,6,2,258101,258101,258103,0,2,3
73678,2,2,258103,258103,258105,0,2,0
73679,3,1,258106,258106,258107,0,1,1
73680,5,1,258111,258111,258112,0,1,4
73681,5,1,258116,258116,258117,0,1,4
73682,4,3,258120,258120,258123,0,3,3
73683,5,2,258125,258125,258127,0,2,2
73684,2,3,258127,258127,258130,0,3,0
73685,5,3,258132,258132,258135,0,3,2
73686,1,3,258133,258135,258138,2,5,0
73687,1,3,258134,258138,258141,4,7,0
73688,3,1,258137,258141,258142,4,5,0
73689,4,1,258141,258142,258143,1,2,0
73690,2,2,258143,258143,258145,0,2,0
73691,1,2,258144,258145,258147,1,3,0
73692,6,2,258150,258150,258152,0,2,3
73693,1,2,258151,258152,258154,1,3,0
73694,4,2,258155,258155,258157,0,2,1
73695,2,3,258157,258157,258160,0,3,0
73696,3,3,258160,258160,258163,0,3,0
73697,5,2,258165,258165,258167,0,2,2
73698,2,3,258167,258167,258170,0,3,0
73699,5,2,258172,258172,258174,0,2,2
73700,6,3,258178,258178,258181,0,3,4
73701,2,2,258180,258181,258183,1,3,0
73702,6,2,258186,258186,258188,0,2,3
73703,2,2,258188,258188,258190,0,2,0
73704,1,1,258189,258190,258191,1,2,0
73705,3,2,258192,258192,258194,0,2,1
73706,4,2,258196,258196,258198,0,2,2
73707,2,2,258198,258198,258200,0,2,0
73708,2,2,258200,258200,258202,0,2,0
73709,2,3,258202,258202,258205,0,3,0
73710,6,1,258208,258208,258209,0,1,3
73711,4,1,258212,258212,258213,0,1,3
73712,2,2,258214,258214,258216,0,2,1
73713,2,1,258216,258216,258217,0,1,0
73714,2,1,258218,258218,258219,0,1,1
73715,1,2,258219,258219,258221,0,2,0
73716,4,3,258223,258223,258226,0,3,2
73717,2,2,258225,258226,258228,1,3,0
73718,5,1,258230,258230,258231,0,1,2
73719,3,1,258233,258233,258234,0,1,2
73720,3,1,258236,258236,258237,0,1,2
73721,4,3,258240,258240,258243,0,3,3
73722,4,3,258244,258244,258247,0,3,1
73723,2,1,258246,258247,258248,1,2,0
73724,4,2,258250,258250,258252,0,2,2
73725,6,2,258256,258256,258258,0,2,4
73726,6,2,258262,258262,258264,0,2,4
73727,6,3,258268,258268,258271,0,3,4
73728,1,2,258269,258271,258273,2,4,0
73729,5,1,258274,258274,258275,0,1,1
73730,3,2,258277,258277,258279,0,2,2
73731,3,1,258280,258280,258281,0,1,1
73732,5,1,258285,258285,258286,0,1,4
73733,5,3,258290,258290,258293,0,3,4
73734,3,2,258293,258293,258295,0,2,0
73735,5,2,258298,258298,258300,0,2,3
73736,4,3,258302,258302,258305,0,3,2
73737,1,3,258303,258305,258308,2,5,0
73738,1,3,258304,258308,258311,4,7,0
73739,3,3,258307,258311,258314,4,7,0
73740,2,3,258309,258314,258317,5,8,0
73741,5,1,258314,258317,258318,3,4,0
73742,2,1,258316,258318,258319,2,3,0
73743,5,2,258321,258321,258323,0,2,2
73744,2,3,258323,258323,258326,0,3,0
73745,5,3,258328,258328,258331,0,3,2
73746,2,1,258330,258331,258332,1,2,0
73747,4,2,258334,258334,258336,0,2,2
73748,5,2,258339,258339,258341,0,2,3
73749,1,3,258340,258341,258344,1,4,0
73750,6,3,258346,258346,258349,0,3,2
73751,6,3,258352,258352,258355,0,3,3
73752,3,2,258355,258355,258357,0,2,0
73753,2,3,258357,258357,258360,0,3,0
73754,1,1,258358,258360,258361,2,3,0
73755,1,2,258359,258361,258363,2,4,0
73756,3,3,258362,258363,258366,1,4,0
73757,1,1,258363,258366,258367,3,4,0
73758,5,1,258368,258368,258369,0,1,1
73759,2,3,258370,258370,258373,0,3,1
73760,2,2,258372,258373,258375,1,3,0
73761,2,1,258374,258375,258376,1,2,0
73762,4,2,258378,258378,258380,0,2,2
73763,6,3,258384,258384,258387,0,3,4
73764,4,2,258388,258388,258390,0,2,1
73765,3,3,258391,258391,258394,0,3,1
73766,6,2,258397,258397,258399,0,2,3
73767,4,1,258401,258401,258402,0,1,2
73768,4,2,258405,258405,258407,0,2,3
73769,2,1,258407,258407,258408,0,1,0
73770,3,1,258410,258410,258411,0,1,2
73771,5,3,258415,258415,258418,0,3,4
73772,2,3,258417,258418,258421,1,4,0
73773,2,3,258419,258421,258424,2,5,0
73774,3,2,258422,258424,258426,2,4,0
73775,2,1,258424,258426,258427,2,3,0
73776,4,1,258428,258428,258429,0,1,1
73777,2,3,258430,258430,258433,0,3,1
73778,1,3,258431,258433,258436,2,5,0
73779,5,3,258436,258436,258439,0,3,0
73780,2,2,258438,258439,258441,1,3,0
73781,2,1,258440,258441,258442,1,2,0
73782,1,1,258441,258442,258443,1,2,0
73783,5,3,258446,258446,258449,0,3,3
73784,6,1,258452,258452,258453,0,1,3
73785,2,1,258454,258454,258455,0,1,1
73786,5,2,258459,258459,258461,0,2,4
73787,6,3,258465,258465,258468,0,3,4
73788,6,2,258471,258471,258473,0,2,3
73789,5,2,258476,258476,258478,0,2,3
73790,6,2,258482,258482,258484,0,2,4
73791,2,3,258484,258484,258487,0,3,0
73792,1,2,258485,258487,258489,2,4,0
73793,4,1,258489,258489,258490,0,1,0
73794,5,2,258494,258494,258496,0,2,4
73795,2,1,258496,258496,258497,0,1,0
73796,4,2,258500,258500,258502,0,2,3
73797,1,2,258501,258502,258504,1,3,0
73798,6,3,258507,258507,258510,0,3,3
73799,4,1,258511,258511,258512,0,1,1
73800,6,3,258517,258517,258520,0,3,5
73801,3,3,258520,258520,258523,0,3,0
73802,5,1,258525,258525,258526,0,1,2
73803,1,3,258526,258526,258529,0,3,0
73804,5,2,258531,258531,258533,0,2,2
73805,1,1,258532,258533,258534,1,2,0
73806,1,1,258533,258534,258535,1,2,0
73807,2,1,258535,258535,258536,0,1,0
73808,2,2,258537,258537,258539,0,2,1
73809,1,1,258538,258539,258540,1,2,0
73810,5,1,258543,258543,258544,0,1,3
73811,5,3,258548,258548,258551,0,3,4
73812,5,3,258553,258553,258556,0,3,2
73813,1,1,258554,258556,258557,2,3,0
73814,2,3,258556,258557,258560,1,4,0
73815,2,3,258558,258560,258563,2,5,0
73816,5,3,258563,258563,258566,0,3,0
73817,2,3,258565,258566,258569,1,4,0
73818,5,3,258570,258570,258573,0,3,1
73819,2,3,258572,258573,258576,1,4,0
73820,5,3,258577,258577,258580,0,3,1
73821,6,3,258583,258583,258586,0,3,3
73822,2,1,258585,258586,258587,1,2,0
73823,6,1,258591,258591,258592,0,1,4
73824,1,3,258592,258592,258595,0,3,0
73825,5,3,258597,258597,258600,0,3,2
73826,5,1,258602,258602,258603,0,1,2
73827,1,1,258603,258603,258604,0,1,0
73828,2,1,258605,258605,258606,0,1,1
73829,6,3,258611,258611,258614,0,3,5
73830,6,1,258617,258617,258618,0,1,3
73831,5,2,258622,258622,258624,0,2,4
73832,1,1,258623,258624,258625,1,2,0
73833,1,3,258624,258625,258628,1,4,0
73834,5,3,258629,258629,258632,0,3,1
73835,1,1,258630,258632,258633,2,3,0
73836,3,2,258633,258633,258635,0,2,0
73837,1,1,258634,258635,258636,1,2,0
73838,2,1,258636,258636,258637,0,1,0
73839,6,2,258642,258642,258644,0,2,5
73840,1,1,258643,258644,258645,1,2,0
73841,4,3,258647,258647,258650,0,3,2
73842,2,2,258649,258650,258652,1,3,0
73843,4,3,258653,258653,258656,0,3,1
73844,2,3,258655,258656,258659,1,4,0
73845,4,3,258659,258659,258662,0,3,0
73846,1,1,258660,258662,258663,2,3,0
73847,2,1,258662,258663,258664,1,2,0
73848,6,2,258668,258668,258670,0,2,4
73849,4,2,258672,258672,258674,0,2,2
73850,2,2,258674,258674,258676,0,2,0
73851,2,1,258676,258676,258677,0,1,0
73852,5,3,258681,258681,258684,0,3,4
73853,1,1,258682,258684,258685,2,3,0
73854,5,3,258687,258687,258690,0,3,2
73855,2,2,258689,258690,258692,1,3,0
73856,5,1,258694,258694,258695,0,1,2
73857,6,3,258700,258700,258703,0,3,5
73858,1,3,258701,258703,258706,2,5,0
73859,4,3,258705,258706,258709,1,4,0
73860,1,1,258706,258709,258710,3,4,0
73861,1,1,258707,258710,258711,3,4,0
73862,6,2,258713,258713,258715,0,2,2
73863,4,1,258717,258717,258718,0,1,2
73864,1,2,258718,258718,258720,0,2,0
73865,2,3,258720,258720,258723,0,3,0
73866,1,3,258721,258723,258726,2,5,0
73867,3,1,258724,258726,258727,2,3,0
73868,3,3,258727,258727,258730,0,3,0
73869,3,2,258730,258730,258732,0,2,0
73870,4,2,258734,258734,258736,0,2,2
73871,4,1,258738,258738,258739,0,1,2
73872,2,3,258740,258740,258743,0,3,1
73873,3,2,258743,258743,258745,0,2,0
73874,1,3,258744,258745,258748,1,4,0
73875,4,3,258748,258748,258751,0,3,0
73876,5,2,258753,258753,258755,0,2,2
73877,2,3,258755,258755,258758,0,3,0
73878,1,1,258756,258758,258759,2,3,0
73879,4,1,258760,258760,258761,0,1,1
73880,4,2,258764,258764,258766,0,2,3
73881,5,2,258769,258769,258771,0,2,3
73882,1,1,258770,258771,258772,1,2,0
73883,1,3,258771,258772,258775,1,4,0
73884,6,1,258777,258777,258778,0,1,2
73885,4,1,258781,258781,258782,0,1,3
73886,3,1,258784,258784,258785,0,1,2
73887,5,1,258789,258789,258790,0,1,4
73888,3,3,258792,258792,258795,0,3,2
73889,6,1,258798,258798,258799,0,1,3
73890,2,2,258800,258800,258802,0,2,1
73891,5,2,258805,258805,258807,0,2,3
73892,1,2,258806,258807,258809,1,3,0
73893,6,3,258812,258812,258815,0,3,3
73894,1,3,258813,258815,258818,2,5,0
73895,3,2,258816,258818,258820,2,4,0
73896,3,2,258819,258820,258822,1,3,0
73897,6,3,258825,258825,258828,0,3,3
73898,6,2,258831,258831,258833,0,2,3
73899,5,1,258836,258836,258837,0,1,3
73900,3,2,258839,258839,258841,0,2,2
73901,1,2,258840,258841,258843,1,3,0
73902,1,1,258841,258843,258844,2,3,0
73903,3,3,258844,258844,258847,0,3,0
73904,6,2,258850,258850,258852,0,2,3
73905,1,1,258851,258852,258853,1,2,0
73906,2,2,258853,258853,258855,0,2,0
73907,2,2,258855,258855,258857,0,2,0
73908,2,1,258857,258857,258858,0,1,0
73909,4,3,258861,258861,258864,0,3,3
73910,1,2,258862,258864,258866,2,4,0
73911,2,1,258864,258866,258867,2,3,0
73912,4,3,258868,258868,258871,0,3,1
73913,4,1,258872,258872,258873,0,1,1
73914,6,2,258878,258878,258880,0,2,5
73915,5,2,258883,258883,258885,0,2,3
73916,4,3,258887,258887,258890,0,3,2
73917,6,2,258893,258893,258895,0,2,3
73918,5,1,258898,258898,258899,0,1,3
73919,1,1,258899,258899,258900,0,1,0
73920,2,1,258901,258901,258902,0,1,1
73921,2,2,258903,258903,258905,0,2,1
73922,1,2,258904,258905,258907,1,3,0
73923,2,1,258906,258907,258908,1,2,0
73924,6,2,258912,258912,258914,0,2,4
73925,4,3,258916,258916,258919,0,3,2
73926,3,1,258919,258919,258920,0,1,0
73927,3,1,258922,258922,258923,0,1,2
73928,6,1,258928,258928,258929,0,1,5
73929,4,3,258932,258932,258935,0,3,3
73930,2,2,258934,258935,258937,1,3,0
73931,2,2,258936,258937,258939,1,3,0
73932,6,2,258942,258942,258944,0,2,3
73933,6,2,258948,258948,258950,0,2,4
73934,5,3,258953,258953,258956,0,3,3
73935,1,1,258954,258956,258957,2,3,0
73936,2,3,258956,258957,258960,1,4,0
73937,3,1,258959,258960,258961,1,2,0
73938,1,2,258960,258961,258963,1,3,0
73939,4,2,258964,258964,258966,0,2,1
73940,2,3,258966,258966,258969,0,3,0
73941,6,1,258972,258972,258973,0,1,3
73942,6,3,258978,258978,258981,0,3,5
73943,6,3,258984,258984,258987,0,3,3
73944,5,2,258989,258989,258991,0,2,2
73945,2,1,258991,258991,258992,0,1,0
73946,3,3,258994,258994,258997,0,3,2
73947,6,2,259000,259000,259002,0,2,3
73948,3,1,259003,259003,259004,0,1,1
73949,5,1,259008,259008,259009,0,1,4
73950,4,2,259012,259012,259014,0,2,3
73951,4,2,259016,259016,259018,0,2,2
73952,3,2,259019,259019,259021,0,2,1
73953,4,1,259023,259023,259024,0,1,2
73954,2,1,259025,259025,259026,0,1,1
73955,1,3,259026,259026,259029,0,3,0
73956,1,2,259027,259029,259031,2,4,0
73957,4,3,259031,259031,259034,0,3,0
73958,5,3,259036,259036,259039,0,3,2
73959,3,1,259039,259039,259040,0,1,0
73960,1,2,259040,259040,259042,0,2,0
73961,6,3,259046,259046,259049,0,3,4
73962,5,2,259051,259051,259053,0,2,2
73963,5,2,259056,259056,259058,0,2,3
73964,1,2,259057,259058,259060,1,3,0
73965,3,1,259060,259060,259061,0,1,0
73966,2,1,259062,259062,259063,0,1,1
73967,1,1,259063,259063,259064,0,1,0
73968,2,3,259065,259065,259068,0,3,1
73969,2,3,259067,259068,259071,1,4,0
73970,4,1,259071,259071,259072,0,1,0
73971,4,2,259075,259075,259077,0,2,3
73972,3,2,259078,259078,259080,0,2,1
73973,5,2,259083,259083,259085,0,2,3
73974,5,2,259088,259088,259090,0,2,3
73975,1,2,259089,259090,259092,1,3,0
73976,4,1,259093,259093,259094,0,1,1
73977,1,3,259094,259094,259097,0,3,0
73978,1,2,259095,259097,259099,2,4,0
73979,4,2,259099,259099,259101,0,2,0
73980,1,1,259100,259101,259102,1,2,0
73981,1,3,259101,259102,259105,1,4,0
73982,2,1,259103,259105,259106,2,3,0
73983,4,1,259107,259107,259108,0,1,1
73984,3,1,259110,259110,259111,0,1,2
73985,4,2,259114,259114,259116,0,2,3
73986,6,2,259120,259120,259122,0,2,4
73987,4,3,259124,259124,259127,0,3,2
73988,3,1,259127,259127,259128,0,1,0
73989,6,1,259133,259133,259134,0,1,5
73990,6,1,259139,259139,259140,0,1,5
73991,6,3,259145,259145,259148,0,3,5
73992,2,1,259147,259148,259149,1,2,0
73993,1,2,259148,259149,259151,1,3,0
73994,3,2,259151,259151,259153,0,2,0
73995,5,3,259156,259156,259159,0,3,3
73996,6,1,259162,259162,259163,0,1,3
73997,6,3,259168,259168,259171,0,3,5
73998,6,1,259174,259174,259175,0,1,3
73999,6,3,259180,259180,259183,0,3,5
74000,4,3,259184,259184,259187,0,3,1
74001,2,3,259186,259187,259190,1,4,0
74002,6,1,259192,259192,259193,0,1,2
74003,4,2,259196,259196,259198,0,2,3
74004,2,1,259198,259198,259199,0,1,0
74005,3,2,259201,259201,259203,0,2,2
74006,3,3,259204,259204,259207,0,3,1
74007,2,2,259206,259207,259209,1,3,0
74008,1,3,259207,259209,259212,2,5,0
74009,4,2,259211,259212,259214,1,3,0
74010,1,2,259212,259214,259216,2,4,0
74011,2,1,259214,259216,259217,2,3,0
74012,6,2,259220,259220,259222,0,2,3
74013,2,1,259222,259222,259223,0,1,0
74014,5,2,259227,259227,259229,0,2,4
74015,3,1,259230,259230,259231,0,1,1
74016,6,2,259236,259236,259238,0,2,5
74017,5,3,259241,259241,259244,0,3,3
74018,5,2,259246,259246,259248,0,2,2
74019,2,1,259248,259248,259249,0,1,0
74020,2,3,259250,259250,259253,0,3,1
74021,6,3,259256,259256,259259,0,3,3
74022,1,3,259257,259259,259262,2,5,0
74023,2,3,259259,259262,259265,3,6,0
74024,5,3,259264,259265,259268,1,4,0
74025,1,1,259265,259268,259269,3,4,0
74026,6,3,259271,259271,259274,0,3,2
74027,1,2,259272,259274,259276,2,4,0
74028,1,3,259273,259276,259279,3,6,0
74029,6,3,259279,259279,259282,0,3,0
74030,5,1,259284,259284,259285,0,1,2
74031,4,1,259288,259288,259289,0,1,3
74032,4,1,259292,259292,259293,0,1,3
74033,3,3,259295,259295,259298,0,3,2
74034,1,3,259296,259298,259301,2,5,0
74035,3,3,259299,259301,259304,2,5,0
74036,2,3,259301,259304,259307,3,6,0
74037,4,2,259305,259307,259309,2,4,0
74038,3,3,259308,259309,259312,1,4,0
74039,3,2,259311,259312,259314,1,3,0
74040,4,2,259315,259315,259317,0,2,1
74041,4,3,259319,259319,259322,0,3,2
74042,2,2,259321,259322,259324,1,3,0
74043,5,3,259326,259326,259329,0,3,2
74044,2,3,259328,259329,259332,1,4,0
74045,3,1,259331,259332,259333,1,2,0
74046,4,2,259335,259335,259337,0,2,2
74047,4,3,259339,259339,259342,0,3,2
74048,1,3,259340,259342,259345,2,5,0
74049,5,3,259345,259345,259348,0,3,0
74050,2,2,259347,259348,259350,1,3,0
74051,4,3,259351,259351,259354,0,3,1
74052,4,2,259355,259355,259357,0,2,1
74053,1,2,259356,259357,259359,1,3,0
74054,4,3,259360,259360,259363,0,3,1
74055,1,2,259361,259363,259365,2,4,0
74056,5,2,259366,259366,259368,0,2,1
74057,2,1,259368,259368,259369,0,1,0
74058,3,1,259371,259371,259372,0,1,2
74059,5,2,259376,259376,259378,0,2,4
74060,3,3,259379,259379,259382,0,3,1
74061,2,1,259381,259382,259383,1,2,0
74062,6,3,259387,259387,259390,0,3,4
74063,6,1,259393,259393,259394,0,1,3
74064,2,3,259395,259395,259398,0,3,1
74065,1,2,259396,259398,259400,2,4,0
74066,6,1,259402,259402,259403,0,1,2
74067,5,3,259407,259407,259410,0,3,4
74068,1,3,259408,259410,259413,2,5,0
74069,6,2,259414,259414,259416,0,2,1
74070,6,2,259420,259420,259422,0,2,4
74071,4,2,259424,259424,259426,0,2,2
74072,1,2,259425,259426,259428,1,3,0
74073,6,3,259431,259431,259434,0,3,3
74074,2,3,259433,259434,259437,1,4,0
74075,3,3,259436,259437,259440,1,4,0
74076,3,2,259439,259440,259442,1,3,0
74077,2,3,259441,259442,259445,1,4,0
74078,1,1,259442,259445,259446,3,4,0
74079,2,2,259444,259446,259448,2,4,0
74080,4,2,259448,259448,259450,0,2,0
74081,5,1,259453,259453,259454,0,1,3
74082,1,3,259454,259454,259457,0,3,0
74083,5,1,259459,259459,259460,0,1,2
74084,2,2,259461,259461,259463,0,2,1
74085,3,2,259464,259464,259466,0,2,1
74086,2,1,259466,259466,259467,0,1,0
74087,1,2,259467,259467,259469,0,2,0
74088,1,1,259468,259469,259470,1,2,0
74089,1,1,259469,259470,259471,1,2,0
74090,3,2,259472,259472,259474,0,2,1
74091,3,3,259475,259475,259478,0,3,1
74092,2,1,259477,259478,259479,1,2,0
74093,1,2,259478,259479,259481,1,3,0
74094,4,2,259482,259482,259484,0,2,1
74095,1,1,259483,259484,259485,1,2,0
74096,4,2,259487,259487,259489,0,2,2
74097,4,2,259491,259491,259493,0,2,2
74098,2,2,259493,259493,259495,0,2,0
74099,5,2,259498,259498,259500,0,2,3
74100,3,1,259501,259501,259502,0,1,1
74101,6,2,259507,259507,259509,0,2,5
74102,5,1,259512,259512,259513,0,1,3
74103,2,3,259514,259514,259517,0,3,1
74104,3,1,259517,259517,259518,0,1,0
74105,6,2,259523,259523,259525,0,2,5
74106,2,1,259525,259525,259526,0,1,0
74107,2,2,259527,259527,259529,0,2,1
74108,3,1,259530,259530,259531,0,1,1
74109,5,1,259535,259535,259536,0,1,4
74110,2,2,259537,259537,259539,0,2,1
74111,4,1,259541,259541,259542,0,1,2
74112,5,3,259546,259546,259549,0,3,4
74113,5,2,259551,259551,259553,0,2,2
74114,5,1,259556,259556,259557,0,1,3
74115,5,1,259561,259561,259562,0,1,4
74116,2,2,259563,259563,259565,0,2,1
74117,1,3,259564,259565,259568,1,4,0
74118,6,2,259570,259570,259572,0,2,2
74119,6,1,259576,259576,259577,0,1,4
74120,4,2,259580,259580,259582,0,2,3
74121,4,2,259584,259584,259586,0,2,2
74122,1,2,259585,259586,259588,1,3,0
74123,2,2,259587,259588,259590,1,3,0
74124,5,3,259592,259592,259595,0,3,2
74125,5,2,259597,259597,259599,0,2,2
74126,1,3,259598,259599,259602,1,4,0
74127,6,2,259604,259604,259606,0,2,2
74128,4,1,259608,259608,259609,0,1,2
74129,4,2,259612,259612,259614,0,2,3
74130,4,2,259616,259616,259618,0,2,2
74131,3,1,259619,259619,259620,0,1,1
74132,3,3,259622,259622,259625,0,3,2
74133,5,3,259627,259627,259630,0,3,2
74134,4,1,259631,259631,259632,0,1,1
74135,2,3,259633,259633,259636,0,3,1
74136,6,3,259639,259639,259642,0,3,3
74137,3,1,259642,259642,259643,0,1,0
74138,2,3,259644,259644,259647,0,3,1
74139,1,3,259645,259647,259650,2,5,0
74140,5,2,259650,259650,259652,0,2,0
74141,3,1,259653,259653,259654,0,1,1
74142,2,2,259655,259655,259657,0,2,1
74143,6,2,259661,259661,259663,0,2,4
74144,6,3,259667,259667,259670,0,3,4
74145,4,3,259671,259671,259674,0,3,1
74146,4,1,259675,259675,259676,0,1,1
74147,6,3,259681,259681,259684,0,3,5
74148,2,3,259683,259684,259687,1,4,0
74149,2,3,259685,259687,259690,2,5,0
74150,5,1,259690,259690,259691,0,1,0
74151,3,1,259693,259693,259694,0,1,2
74152,2,1,259695,259695,259696,0,1,1
74153,4,3,259699,259699,259702,0,3,3
74154,6,1,259705,259705,259706,0,1,3
74155,6,2,259711,259711,259713,0,2,5
74156,4,2,259715,259715,259717,0,2,2
74157,2,1,259717,259717,259718,0,1,0
74158,1,3,259718,259718,259721,0,3,0
74159,3,3,259721,259721,259724,0,3,0
74160,3,1,259724,259724,259725,0,1,0
74161,4,3,259728,259728,259731,0,3,3
74162,2,3,259730,259731,259734,1,4,0
74163,1,2,259731,259734,259736,3,5,0
74164,2,1,259733,259736,259737,3,4,0
74165,3,2,259736,259737,259739,1,3,0
74166,3,1,259739,259739,259740,0,1,0
74167,2,2,259741,259741,259743,0,2,1
74168,5,1,259746,259746,259747,0,1,3
74169,3,3,259749,259749,259752,0,3,2
74170,1,3,259750,259752,259755,2,5,0
74171,6,1,259756,259756,259757,0,1,1
74172,6,2,259762,259762,259764,0,2,5
74173,3,2,259765,259765,259767,0,2,1
74174,6,2,259771,259771,259773,0,2,4
74175,1,1,259772,259773,259774,1,2,0
74176,4,1,259776,259776,259777,0,1,2
74177,4,2,259780,259780,259782,0,2,3
74178,4,1,259784,259784,259785,0,1,2
74179,2,2,259786,259786,259788,0,2,1
74180,1,1,259787,259788,259789,1,2,0
74181,3,2,259790,259790,259792,0,2,1
74182,5,3,259795,259795,259798,0,3,3
74183,6,2,259801,259801,259803,0,2,3
74184,3,2,259804,259804,259806,0,2,1
74185,3,1,259807,259807,259808,0,1,1
74186,3,1,259810,259810,259811,0,1,2
74187,1,3,259811,259811,259814,0,3,0
74188,4,3,259815,259815,259818,0,3,1
74189,1,1,259816,259818,259819,2,3,0
74190,2,3,259818,259819,259822,1,4,0
74191,1,3,259819,259822,259825,3,6,0
74192,3,2,259822,259825,259827,3,5,0
74193,4,2,259826,259827,259829,1,3,0
74194,3,1,259829,259829,259830,0,1,0
74195,1,1,259830,259830,259831,0,1,0
74196,4,2,259834,259834,259836,0,2,3
74197,5,2,259839,259839,259841,0,2,3
74198,5,1,259844,259844,259845,0,1,3
74199,2,2,259846,259846,259848,0,2,1
74200,3,3,259849,259849,259852,0,3,1
74201,5,1,259854,259854,259855,0,1,2
74202,6,3,259860,259860,259863,0,3,5
74203,5,2,259865,259865,259867,0,2,2
74204,6,2,259871,259871,259873,0,2,4
74205,6,2,259877,259877,259879,0,2,4
74206,2,1,259879,259879,259880,0,1,0
74207,2,2,259881,259881,259883,0,2,1
74208,2,2,259883,259883,259885,0,2,0
74209,2,3,259885,259885,259888,0,3,0
74210,5,2,259890,259890,259892,0,2,2
74211,6,3,259896,259896,259899,0,3,4
74212,5,2,259901,259901,259903,0,2,2
74213,3,1,259904,259904,259905,0,1,1
74214,6,3,259910,259910,259913,0,3,5
74215,6,2,259916,259916,259918,0,2,3
74216,1,2,259917,259918,259920,1,3,0
74217,5,1,259922,259922,259923,0,1,2
74218,2,3,259924,259924,259927,0,3,1
74219,4,1,259928,259928,259929,0,1,1
74220,4,3,259932,259932,259935,0,3,3
74221,5,3,259937,259937,259940,0,3,2
74222,2,1,259939,259940,259941,1,2,0
74223,6,1,259945,259945,259946,0,1,4
74224,2,1,259947,259947,259948,0,1,1
74225,6,2,259953,259953,259955,0,2,5
74226,3,1,259956,259956,259957,0,1,1
74227,3,1,259959,259959,259960,0,1,2
74228,2,1,259961,259961,259962,0,1,1
74229,1,2,259962,259962,259964,0,2,0
74230,3,3,259965,259965,259968,0,3,1
74231,2,1,259967,259968,259969,1,2,0
74232,5,2,259972,259972,259974,0,2,3
74233,6,3,259978,259978,259981,0,3,4
74234,5,1,259983,259983,259984,0,1,2
74235,2,3,259985,259985,259988,0,3,1
74236,2,2,259987,259988,259990,1,3,0
74237,2,3,259989,259990,259993,1,4,0
74238,5,1,259994,259994,259995,0,1,1
74239,4,1,259998,259998,259999,0,1,3
74240,3,3,260001,260001,260004,0,3,2
74241,6,2,260007,260007,260009,0,2,3
74242,2,3,260009,260009,260012,0,3,0
74243,4,1,260013,260013,260014,0,1,1
74244,6,2,260019,260019,260021,0,2,5
74245,5,3,260024,260024,260027,0,3,3
74246,4,1,260028,260028,260029,0,1,1
74247,6,1,260034,260034,260035,0,1,5
74248,3,1,260037,260037,260038,0,1,2
74249,4,1,260041,260041,260042,0,1,3
74250,3,2,260044,260044,260046,0,2,2
74251,4,3,260048,260048,260051,0,3,2
74252,6,3,260054,260054,260057,0,3,3
74253,3,1,260057,260057,260058,0,1,0
74254,3,2,260060,260060,260062,0,2,2
74255,2,2,260062,260062,260064,0,2,0
74256,5,2,260067,260067,260069,0,2,3
74257,2,1,260069,260069,260070,0,1,0
74258,1,1,260070,260070,260071,0,1,0
74259,5,3,260075,260075,260078,0,3,4
74260,1,3,260076,260078,260081,2,5,0
74261,3,2,260079,260081,260083,2,4,0
74262,5,1,260084,260084,260085,0,1,1
74263,5,1,260089,260089,260090,0,1,4
74264,4,2,260093,260093,260095,0,2,3
74265,1,2,260094,260095,260097,1,3,0
74266,1,3,260095,260097,260100,2,5,0
74267,6,2,260101,260101,260103,0,2,1
74268,6,2,260107,260107,260109,0,2,4
74269,6,1,260113,260113,260114,0,1,4
74270,5,1,260118,260118,260119,0,1,4
74271,1,2,260119,260119,260121,0,2,0
74272,3,1,260122,260122,260123,0,1,1
74273,1,2,260123,260123,260125,0,2,0
74274,6,2,260129,260129,260131,0,2,4
74275,4,3,260133,260133,260136,0,3,2
74276,2,1,260135,260136,260137,1,2,0
74277,6,3,260141,260141,260144,0,3,4
74278,3,2,260144,260144,260146,0,2,0
74279,6,2,260150,260150,260152,0,2,4
74280,5,2,260155,260155,260157,0,2,3
74281,6,2,260161,260161,260163,0,2,4
74282,5,2,260166,260166,260168,0,2,3
74283,6,1,260172,260172,260173,0,1,4
74284,4,3,260176,260176,260179,0,3,3
74285,1,1,260177,260179,260180,2,3,0
74286,4,3,260181,260181,260184,0,3,1
74287,5,1,260186,260186,260187,0,1,2
74288,1,2,260187,260187,260189,0,2,0
74289,4,3,260191,260191,260194,0,3,2
74290,1,2,260192,260194,260196,2,4,0
74291,5,3,260197,260197,260200,0,3,1
74292,4,3,260201,260201,260204,0,3,1
74293,3,2,260204,260204,260206,0,2,0
74294,1,2,260205,260206,260208,1,3,0
74295,4,1,260209,260209,260210,0,1,1
74296,1,3,260210,260210,260213,0,3,0
74297,2,3,260212,260213,260216,1,4,0
74298,6,2,260218,260218,260220,0,2,2
74299,5,1,260223,260223,260224,0,1,3
74300,1,1,260224,260224,260225,0,1,0
74301,1,2,260225,260225,260227,0,2,0
74302,2,2,260227,260227,260229,0,2,0
74303,5,1,260232,260232,260233,0,1,3
74304,2,2,260234,260234,260236,0,2,1
74305,2,3,260236,260236,260239,0,3,0
74306,6,1,260242,260242,260243,0,1,3
74307,6,2,260248,260248,260250,0,2,5
74308,3,3,260251,260251,260254,0,3,1
74309,6,2,260257,260257,260259,0,2,3
74310,6,2,260263,260263,260265,0,2,4
74311,5,3,260268,260268,260271,0,3,3
74312,5,3,260273,260273,260276,0,3,2
74313,3,1,260276,260276,260277,0,1,0
74314,5,2,260281,260281,260283,0,2,4
74315,5,1,260286,260286,260287,0,1,3
74316,5,3,260291,260291,260294,0,3,4
74317,4,3,260295,260295,260298,0,3,1
74318,5,3,260300,260300,260303,0,3,2
74319,5,1,260305,260305,260306,0,1,2
74320,3,1,260308,260308,260309,0,1,2
74321,6,3,260314,260314,260317,0,3,5
74322,4,2,260318,260318,260320,0,2,1
74323,1,3,260319,260320,260323,1,4,0
74324,2,2,260321,260323,260325,2,4,0
74325,2,3,260323,260325,260328,2,5,0
74326,6,3,260329,260329,260332,0,3,1
74327,5,1,260334,260334,260335,0,1,2
74328,6,1,260340,260340,260341,0,1,5
74329,1,2,260341,260341,260343,0,2,0
74330,2,3,260343,260343,260346,0,3,0
74331,5,1,260348,260348,260349,0,1,2
74332,6,1,260354,260354,260355,0,1,5
74333,5,2,260359,260359,260361,0,2,4
74334,3,1,260362,260362,260363,0,1,1
74335,4,3,260366,260366,260369,0,3,3
74336,2,2,260368,260369,260371,1,3,0
74337,6,3,260374,260374,260377,0,3,3
74338,3,2,260377,260377,260379,0,2,0
74339,5,1,260382,260382,260383,0,1,3
74340,6,1,260388,260388,260389,0,1,5
74341,1,3,260389,260389,260392,0,3,0
74342,1,3,260390,260392,260395,2,5,0
74343,4,2,260394,260395,260397,1,3,0
74344,3,3,260397,260397,260400,0,3,0
74345,5,1,260402,260402,260403,0,1,2
74346,2,2,260404,260404,260406,0,2,1
74347,6,2,260410,260410,260412,0,2,4
74348,3,2,260413,260413,260415,0,2,1
74349,2,2,260415,260415,260417,0,2,0
74350,3,2,260418,260418,260420,0,2,1
74351,1,3,260419,260420,260423,1,4,0
74352,3,2,260422,260423,260425,1,3,0
74353,6,2,260428,260428,260430,0,2,3
74354,3,3,260431,260431,260434,0,3,1
74355,6,3,260437,260437,260440,0,3,3
74356,4,3,260441,260441,260444,0,3,1
74357,3,1,260444,260444,260445,0,1,0
74358,1,3,260445,260445,260448,0,3,0
74359,1,1,260446,260448,260449,2,3,0
74360,5,2,260451,260451,260453,0,2,2
74361,1,1,260452,260453,260454,1,2,0
74362,1,3,260453,260454,260457,1,4,0
74363,2,1,260455,260457,260458,2,3,0
74364,1,1,260456,260458,260459,2,3,0
74365,3,3,260459,260459,260462,0,3,0
74366,2,1,260461,260462,260463,1,2,0
74367,3,3,260464,260464,260467,0,3,1
74368,5,3,260469,260469,260472,0,3,2
74369,5,1,260474,260474,260475,0,1,2
74370,3,2,260477,260477,260479,0,2,2
74371,1,1,260478,260479,260480,1,2,0
74372,1,1,260479,260480,260481,1,2,0
74373,5,1,260484,260484,260485,0,1,3
74374,2,3,260486,260486,260489,0,3,1
74375,3,1,260489,260489,260490,0,1,0
74376,3,3,260492,260492,260495,0,3,2
74377,5,1,260497,260497,260498,0,1,2
74378,5,3,260502,260502,260505,0,3,4
74379,2,2,260504,260505,260507,1,3,0
74380,2,2,260506,260507,260509,1,3,0
74381,2,3,260508,260509,260512,1,4,0
74382,2,2,260510,260512,260514,2,4,0
74383,6,2,260516,260516,260518,0,2,2
74384,3,1,260519,260519,260520,0,1,1
74385,5,2,260524,260524,260526,0,2,4
74386,1,1,260525,260526,260527,1,2,0
74387,3,1,260528,260528,260529,0,1,1
74388,2,1,260530,260530,260531,0,1,1
74389,4,2,260534,260534,260536,0,2,3
74390,4,1,260538,260538,260539,0,1,2
74391,5,2,260543,260543,260545,0,2,4
74392,6,1,260549,260549,260550,0,1,4
74393,5,3,260554,260554,260557,0,3,4
74394,4,3,260558,260558,260561,0,3,1
74395,6,1,260564,260564,260565,0,1,3
74396,2,2,260566,260566,260568,0,2,1
74397,2,3,260568,260568,260571,0,3,0
74398,1,2,260569,260571,260573,2,4,0
74399,5,3,260574,260574,260577,0,3,1
74400,1,1,260575,260577,260578,2,3,0
74401,5,2,260580,260580,260582,0,2,2
74402,4,1,260584,260584,260585,0,1,2
74403,4,1,260588,260588,260589,0,1,3
74404,1,1,260589,260589,260590,0,1,0
74405,6,3,260595,260595,260598,0,3,5
74406,6,1,260601,260601,260602,0,1,3
74407,3,2,260604,260604,260606,0,2,2
74408,6,2,260610,260610,260612,0,2,4
74409,3,1,260613,260613,260614,0,1,1
74410,3,3,260616,260616,260619,0,3,2
74411,5,2,260621,260621,260623,0,2,2
74412,1,1,260622,260623,260624,1,2,0
74413,1,3,260623,260624,260627,1,4,0
74414,4,1,260627,260627,260628,0,1,0
74415,6,2,260633,260633,260635,0,2,5
74416,6,1,260639,260639,260640,0,1,4
74417,5,3,260644,260644,260647,0,3,4
74418,2,1,260646,260647,260648,1,2,0
74419,5,1,260651,260651,260652,0,1,3
74420,5,2,260656,260656,260658,0,2,4
74421,4,1,260660,260660,260661,0,1,2
74422,4,1,260664,260664,260665,0,1,3
74423,5,2,260669,260669,260671,0,2,4
74424,3,1,260672,260672,260673,0,1,1
74425,4,3,260676,260676,260679,0,3,3
74426,5,3,260681,260681,260684,0,3,2
74427,1,3,260682,260684,260687,2,5,0
74428,5,2,260687,260687,260689,0,2,0
74429,4,1,260691,260691,260692,0,1,2
74430,3,3,260694,260694,260697,0,3,2
74431,2,2,260696,260697,260699,1,3,0
74432,2,1,260698,260699,260700,1,2,0
74433,3,1,260701,260701,260702,0,1,1
74434,1,3,260702,260702,260705,0,3,0
74435,4,1,260706,260706,260707,0,1,1
74436,6,1,260712,260712,260713,0,1,5
74437,6,2,260718,260718,260720,0,2,5
74438,5,3,260723,260723,260726,0,3,3
74439,2,3,260725,260726,260729,1,4,0
74440,2,2,260727,260729,260731,2,4,0
74441,5,3,260732,260732,260735,0,3,1
74442,6,2,260738,260738,260740,0,2,3
74443,4,3,260742,260742,260745,0,3,2
74444,2,1,260744,260745,260746,1,2,0
74445,2,1,260746,260746,260747,0,1,0
74446,1,2,260747,260747,260749,0,2,0
74447,1,3,260748,260749,260752,1,4,0
74448,6,2,260754,260754,260756,0,2,2
74449,3,1,260757,260757,260758,0,1,1
74450,6,1,260763,260763,260764,0,1,5
74451,5,2,260768,260768,260770,0,2,4
74452,6,1,260774,260774,260775,0,1,4
74453,2,3,260776,260776,260779,0,3,1
74454,2,1,260778,260779,260780,1,2,0
74455,3,2,260781,260781,260783,0,2,1
74456,3,2,260784,260784,260786,0,2,1
74457,2,3,260786,260786,260789,0,3,0
74458,6,3,260792,260792,260795,0,3,3
74459,3,3,260795,260795,260798,0,3,0
74460,2,2,260797,260798,260800,1,3,0
74461,4,3,260801,260801,260804,0,3,1
74462,6,3,260807,260807,260810,0,3,3
74463,6,2,260813,260813,260815,0,2,3
74464,5,1,260818,260818,260819,0,1,3
74465,5,2,260823,260823,260825,0,2,4
74466,4,1,260827,260827,260828,0,1,2
74467,3,1,260830,260830,260831,0,1,2
74468,5,1,260835,260835,260836,0,1,4
74469,5,3,260840,260840,260843,0,3,4
74470,1,3,260841,260843,260846,2,5,0
74471,3,3,260844,260846,260849,2,5,0
74472,5,2,260849,260849,260851,0,2,0
74473,5,2,260854,260854,260856,0,2,3
74474,6,2,260860,260860,260862,0,2,4
74475,4,3,260864,260864,260867,0,3,2
74476,3,3,260867,260867,260870,0,3,0
74477,4,3,260871,260871,260874,0,3,1
74478,6,2,260877,260877,260879,0,2,3
74479,5,1,260882,260882,260883,0,1,3
74480,3,2,260885,260885,260887,0,2,2
74481,2,3,260887,260887,260890,0,3,0
74482,2,3,260889,260890,260893,1,4,0
74483,1,1,260890,260893,260894,3,4,0
74484,6,2,260896,260896,260898,0,2,2
74485,1,1,260897,260898,260899,1,2,0
74486,3,2,260900,260900,260902,0,2,1
74487,1,2,260901,260902,260904,1,3,0
74488,2,1,260903,260904,260905,1,2,0
74489,2,2,260905,260905,260907,0,2,0
74490,2,2,260907,260907,260909,0,2,0
74491,2,3,260909,260909,260912,0,3,0
74492,3,2,260912,260912,260914,0,2,0
74493,6,1,260918,260918,260919,0,1,4
74494,5,2,260923,260923,260925,0,2,4
74495,6,3,260929,260929,260932,0,3,4
74496,5,3,260934,260934,260937,0,3,2
74497,3,2,260937,260937,260939,0,2,0
74498,4,1,260941,260941,260942,0,1,2
74499,3,1,260944,260944,260945,0,1,2
74500,3,1,260947,260947,260948,0,1,2
74501,6,2,260953,260953,260955,0,2,5
74502,2,2,260955,260955,260957,0,2,0
74503,5,1,260960,260960,260961,0,1,3
74504,3,1,260963,260963,260964,0,1,2
74505,6,1,260969,260969,260970,0,1,5
74506,6,2,260975,260975,260977,0,2,5
74507,3,2,260978,260978,260980,0,2,1
74508,5,1,260983,260983,260984,0,1,3
74509,3,1,260986,260986,260987,0,1,2
74510,3,1,260989,260989,260990,0,1,2
74511,4,2,260993,260993,260995,0,2,3
74512,1,2,260994,260995,260997,1,3,0
74513,6,3,261000,261000,261003,0,3,3
74514,5,1,261005,261005,261006,0,1,2
74515,4,1,261009,261009,261010,0,1,3
74516,3,2,261012,261012,261014,0,2,2
74517,6,1,261018,261018,261019,0,1,4
74518,1,2,261019,261019,261021,0,2,0
74519,5,1,261024,261024,261025,0,1,3
74520,1,2,261025,261025,261027,0,2,0
74521,6,3,261031,261031,261034,0,3,4
74522,4,3,261035,261035,261038,0,3,1
74523,3,3,261038,261038,261041,0,3,0
74524,2,3,261040,261041,261044,1,4,0
74525,2,3,261042,261044,261047,2,5,0
74526,2,1,261044,261047,261048,3,4,0
74527,5,3,261049,261049,261052,0,3,1
74528,2,1,261051,261052,261053,1,2,0
74529,3,2,261054,261054,261056,0,2,1
74530,5,1,261059,261059,261060,0,1,3
74531,5,3,261064,261064,261067,0,3,4
74532,4,3,261068,261068,261071,0,3,1
74533,4,1,261072,261072,261073,0,1,1
74534,5,1,261077,261077,261078,0,1,4
74535,3,3,261080,261080,261083,0,3,2
74536,5,3,261085,261085,261088,0,3,2
74537,1,3,261086,261088,261091,2,5,0
74538,1,2,261087,261091,261093,4,6,0
74539,5,1,261092,261093,261094,1,2,0
74540,5,1,261097,261097,261098,0,1,3
74541,1,2,261098,261098,261100,0,2,0
74542,2,2,261100,261100,261102,0,2,0
74543,4,3,261104,261104,261107,0,3,2
74544,3,1,261107,261107,261108,0,1,0
74545,5,1,261112,261112,261113,0,1,4
74546,5,3,261117,261117,261120,0,3,4
74547,2,3,261119,261120,261123,1,4,0
74548,1,1,261120,261123,261124,3,4,0
74549,4,2,261124,261124,261126,0,2,0
74550,6,1,261130,261130,261131,0,1,4
74551,3,2,261133,261133,261135,0,2,2
74552,3,1,261136,261136,261137,0,1,1
74553,6,1,261142,261142,261143,0,1,5
74554,4,2,261146,261146,261148,0,2,3
74555,6,2,261152,261152,261154,0,2,4
74556,1,3,261153,261154,261157,1,4,0
74557,1,2,261154,261157,261159,3,5,0
74558,3,1,261157,261159,261160,2,3,0
74559,5,3,261162,261162,261165,0,3,2
74560,5,2,261167,261167,261169,0,2,2
74561,4,3,261171,261171,261174,0,3,2
74562,6,3,261177,261177,261180,0,3,3
74563,5,3,261182,261182,261185,0,3,2
74564,2,3,261184,261185,261188,1,4,0
74565,3,1,261187,261188,261189,1,2,0
74566,4,3,261191,261191,261194,0,3,2
74567,6,1,261197,261197,261198,0,1,3
74568,1,2,261198,261198,261200,0,2,0
74569,4,1,261202,261202,261203,0,1,2
74570,1,3,261203,261203,261206,0,3,0
74571,3,1,261206,261206,261207,0,1,0
74572,5,2,261211,261211,261213,0,2,4
74573,2,1,261213,261213,261214,0,1,0
74574,4,2,261217,261217,261219,0,2,3
74575,4,2,261221,261221,261223,0,2,2
74576,4,2,261225,261225,261227,0,2,2
74577,3,2,261228,261228,261230,0,2,1
74578,3,1,261231,261231,261232,0,1,1
74579,6,1,261237,261237,261238,0,1,5
74580,6,3,261243,261243,261246,0,3,5
74581,1,1,261244,261246,261247,2,3,0
74582,1,2,261245,261247,261249,2,4,0
74583,6,1,261251,261251,261252,0,1,2
74584,4,3,261255,261255,261258,0,3,3
74585,2,2,261257,261258,261260,1,3,0
74586,3,3,261260,261260,261263,0,3,0
74587,4,1,261264,261264,261265,0,1,1
74588,1,1,261265,261265,261266,0,1,0
74589,1,3,261266,261266,261269,0,3,0
74590,2,1,261268,261269,261270,1,2,0
74591,3,1,261271,261271,261272,0,1,1
74592,2,3,261273,261273,261276,0,3,1
74593,5,1,261278,261278,261279,0,1,2
74594,5,3,261283,261283,261286,0,3,4
74595,3,1,261286,261286,261287,0,1,0
74596,5,1,261291,261291,261292,0,1,4
74597,5,2,261296,261296,261298,0,2,4
74598,2,3,261298,261298,261301,0,3,0
74599,3,2,261301,261301,261303,0,2,0
74600,5,2,261306,261306,261308,0,2,3
74601,4,2,261310,261310,261312,0,2,2
74602,2,3,261312,261312,261315,0,3,0
74603,4,2,261316,261316,261318,0,2,1
74604,3,2,261319,261319,261321,0,2,1
74605,2,1,261321,261321,261322,0,1,0
74606,3,3,261324,261324,261327,0,3,2
74607,1,3,261325,261327,261330,2,5,0
74608,2,2,261327,261330,261332,3,5,0
74609,2,2,261329,261332,261334,3,5,0
74610,1,1,261330,261334,261335,4,5,0
74611,6,1,261336,261336,261337,0,1,1
74612,5,2,261341,261341,261343,0,2,4
74613,2,3,261343,261343,261346,0,3,0
74614,1,1,261344,261346,261347,2,3,0
74615,4,1,261348,261348,261349,0,1,1
74616,2,2,261350,261350,261352,0,2,1
74617,3,1,261353,261353,261354,0,1,1
74618,1,3,261354,261354,261357,0,3,0
74619,6,2,261360,261360,261362,0,2,3
74620,5,1,261365,261365,261366,0,1,3
74621,2,2,261367,261367,261369,0,2,1
74622,2,2,261369,261369,261371,0,2,0
74623,4,2,261373,261373,261375,0,2,2
74624,2,2,261375,261375,261377,0,2,0
74625,4,3,261379,261379,261382,0,3,2
74626,6,3,261385,261385,261388,0,3,3
74627,2,1,261387,261388,261389,1,2,0
74628,3,1,261390,261390,261391,0,1,1
74629,2,1,261392,261392,261393,0,1,1
74630,2,1,261394,261394,261395,0,1,1
74631,3,3,261397,261397,261400,0,3,2
74632,4,2,261401,261401,261403,0,2,1
74633,4,3,261405,261405,261408,0,3,2
74634,5,3,261410,261410,261413,0,3,2
74635,4,2,261414,261414,261416,0,2,1
74636,1,3,261415,261416,261419,1,4,0
74637,2,2,261417,261419,261421,2,4,0
74638,1,2,261418,261421,261423,3,5,0
74639,5,1,261423,261423,261424,0,1,0
74640,3,1,261426,261426,261427,0,1,2
74641,2,3,261428,261428,261431,0,3,1
74642,5,3,261433,261433,261436,0,3,2
74643,1,1,261434,261436,261437,2,3,0
74644,4,1,261438,261438,261439,0,1,1
74645,3,1,261441,261441,261442,0,1,2
74646,4,3,261445,261445,261448,0,3,3
74647,3,2,261448,261448,261450,0,2,0
74648,5,3,261453,261453,261456,0,3,3
74649,5,1,261458,261458,261459,0,1,2
74650,4,3,261462,261462,261465,0,3,3
74651,4,1,261466,261466,261467,0,1,1
74652,4,2,261470,261470,261472,0,2,3
74653,6,2,261476,261476,261478,0,2,4
74654,6,3,261482,261482,261485,0,3,4
74655,6,2,261488,261488,261490,0,2,3
74656,5,1,261493,261493,261494,0,1,3
74657,6,1,261499,261499,261500,0,1,5
74658,1,1,261500,261500,261501,0,1,0
74659,1,2,261501,261501,261503,0,2,0
74660,3,2,261504,261504,261506,0,2,1
74661,2,2,261506,261506,261508,0,2,0
74662,4,1,261510,261510,261511,0,1,2
74663,6,2,261516,261516,261518,0,2,5
74664,2,1,261518,261518,261519,0,1,0
74665,5,3,261523,261523,261526,0,3,4
74666,3,3,261526,261526,261529,0,3,0
74667,4,2,261530,261530,261532,0,2,1
74668,5,2,261535,261535,261537,0,2,3
74669,2,3,261537,261537,261540,0,3,0
74670,4,2,261541,261541,261543,0,2,1
74671,3,2,261544,261544,261546,0,2,1
74672,3,3,261547,261547,261550,0,3,1
74673,1,3,261548,261550,261553,2,5,0
74674,4,3,261552,261553,261556,1,4,0
74675,4,2,261556,261556,261558,0,2,0
74676,6,1,261562,261562,261563,0,1,4
74677,1,2,261563,261563,261565,0,2,0
74678,2,1,261565,261565,261566,0,1,0
74679,3,1,261568,261568,261569,0,1,2
74680,2,2,261570,261570,261572,0,2,1
74681,3,1,261573,261573,261574,0,1,1
74682,2,1,261575,261575,261576,0,1,1
74683,2,3,261577,261577,261580,0,3,1
74684,4,2,261581,261581,261583,0,2,1
74685,2,2,261583,261583,261585,0,2,0
74686,3,2,261586,261586,261588,0,2,1
74687,2,2,261588,261588,261590,0,2,0
74688,5,1,261593,261593,261594,0,1,3
74689,2,2,261595,261595,261597,0,2,1
74690,6,1,261601,261601,261602,0,1,4
74691,3,2,261604,261604,261606,0,2,2
74692,1,3,261605,261606,261609,1,4,0
74693,5,3,261610,261610,261613,0,3,1
74694,1,1,261611,261613,261614,2,3,0
74695,1,2,261612,261614,261616,2,4,0
74696,1,3,261613,261616,261619,3,6,0
74697,5,2,261618,261619,261621,1,3,0
74698,3,1,261621,261621,261622,0,1,0
74699,1,2,261622,261622,261624,0,2,0
74700,1,2,261623,261624,261626,1,3,0
74701,6,1,261629,261629,261630,0,1,3
74702,4,3,261633,261633,261636,0,3,3
74703,3,3,261636,261636,261639,0,3,0
74704,1,3,261637,261639,261642,2,5,0
74705,1,3,261638,261642,261645,4,7,0
74706,4,2,261642,261645,261647,3,5,0
74707,2,3,261644,261647,261650,3,6,0
74708,2,2,261646,261650,261652,4,6,0
74709,1,1,261647,261652,261653,5,6,0
74710,3,3,261650,261653,261656,3,6,0
74711,1,1,261651,261656,261657,5,6,0
74712,2,1,261653,261657,261658,4,5,0
74713,3,2,261656,261658,261660,2,4,0
74714,1,2,261657,261660,261662,3,5,0
74715,5,2,261662,261662,261664,0,2,0
74716,5,1,261667,261667,261668,0,1,3
74717,4,1,261671,261671,261672,0,1,3
74718,4,1,261675,261675,261676,0,1,3
74719,4,1,261679,261679,261680,0,1,3
74720,3,3,261682,261682,261685,0,3,2
74721,4,2,261686,261686,261688,0,2,1
74722,2,3,261688,261688,261691,0,3,0
74723,3,1,261691,261691,261692,0,1,0
74724,1,1,261692,261692,261693,0,1,0
74725,2,3,261694,261694,261697,0,3,1
74726,5,2,261699,261699,261701,0,2,2
74727,2,1,261701,261701,261702,0,1,0
74728,4,2,261705,261705,261707,0,2,3
74729,4,1,261709,261709,261710,0,1,2
74730,3,3,261712,261712,261715,0,3,2
74731,6,1,261718,261718,261719,0,1,3
74732,1,1,261719,261719,261720,0,1,0
74733,5,2,261724,261724,261726,0,2,4
74734,4,1,261728,261728,261729,0,1,2
74735,1,2,261729,261729,261731,0,2,0
74736,3,2,261732,261732,261734,0,2,1
74737,6,1,261738,261738,261739,0,1,4
74738,6,1,261744,261744,261745,0,1,5
74739,2,2,261746,261746,261748,0,2,1
74740,1,3,261747,261748,261751,1,4,0
74741,3,1,261750,261751,261752,1,2,0
74742,5,3,261755,261755,261758,0,3,3
74743,1,1,261756,261758,261759,2,3,0
74744,3,2,261759,261759,261761,0,2,0
74745,5,3,261764,261764,261767,0,3,3
74746,1,2,261765,261767,261769,2,4,0
74747,5,2,261770,261770,261772,0,2,1
74748,2,1,261772,261772,261773,0,1,0
74749,6,3,261778,261778,261781,0,3,5
74750,1,3,261779,261781,261784,2,5,0
74751,1,3,261780,261784,261787,4,7,0
74752,4,2,261784,261787,261789,3,5,0
74753,6,1,261790,261790,261791,0,1,1
74754,2,1,261792,261792,261793,0,1,1
74755,5,1,261797,261797,261798,0,1,4
74756,3,2,261800,261800,261802,0,2,2
74757,1,1,261801,261802,261803,1,2,0
74758,1,3,261802,261803,261806,1,4,0
74759,5,3,261807,261807,261810,0,3,1
74760,3,1,261810,261810,261811,0,1,0
74761,6,3,261816,261816,261819,0,3,5
74762,2,2,261818,261819,261821,1,3,0
74763,3,3,261821,261821,261824,0,3,0
74764,6,1,261827,261827,261828,0,1,3
74765,2,3,261829,261829,261832,0,3,1
74766,3,3,261832,261832,261835,0,3,0
74767,4,1,261836,261836,261837,0,1,1
74768,4,3,261840,261840,261843,0,3,3
74769,4,1,261844,261844,261845,0,1,1
74770,4,1,261848,261848,261849,0,1,3
74771,6,3,261854,261854,261857,0,3,5
74772,1,3,261855,261857,261860,2,5,0
74773,4,3,261859,261860,261863,1,4,0
74774,6,1,261865,261865,261866,0,1,2
74775,1,2,261866,261866,261868,0,2,0
74776,6,2,261872,261872,261874,0,2,4
74777,6,1,261878,261878,261879,0,1,4
74778,6,2,261884,261884,261886,0,2,5
74779,2,3,261886,261886,261889,0,3,0
74780,4,1,261890,261890,261891,0,1,1
74781,5,3,261895,261895,261898,0,3,4
74782,3,2,261898,261898,261900,0,2,0
74783,1,1,261899,261900,261901,1,2,0
74784,2,1,261901,261901,261902,0,1,0
74785,3,2,261904,261904,261906,0,2,2
74786,3,1,261907,261907,261908,0,1,1
74787,1,1,261908,261908,261909,0,1,0
74788,4,1,261912,261912,261913,0,1,3
74789,4,3,261916,261916,261919,0,3,3
74790,3,2,261919,261919,261921,0,2,0
74791,2,1,261921,261921,261922,0,1,0
74792,4,2,261925,261925,261927,0,2,3
74793,4,2,261929,261929,261931,0,2,2
74794,1,1,261930,261931,261932,1,2,0
74795,4,3,261934,261934,261937,0,3,2
74796,5,3,261939,261939,261942,0,3,2
74797,2,1,261941,261942,261943,1,2,0
74798,4,2,261945,261945,261947,0,2,2
74799,3,3,261948,261948,261951,0,3,1
74800,3,1,261951,261951,261952,0,1,0
74801,5,2,261956,261956,261958,0,2,4
74802,5,2,261961,261961,261963,0,2,3
74803,5,1,261966,261966,261967,0,1,3
74804,3,1,261969,261969,261970,0,1,2
74805,4,2,261973,261973,261975,0,2,3
74806,2,2,261975,261975,261977,0,2,0
74807,1,2,261976,261977,261979,1,3,0
74808,2,2,261978,261979,261981,1,3,0
74809,6,2,261984,261984,261986,0,2,3
74810,3,2,261987,261987,261989,0,2,1
74811,2,1,261989,261989,261990,0,1,0
74812,2,2,261991,261991,261993,0,2,1
74813,3,1,261994,261994,261995,0,1,1
74814,6,1,262000,262000,262001,0,1,5
74815,2,2,262002,262002,262004,0,2,1
74816,2,2,262004,262004,262006,0,2,0
74817,6,2,262010,262010,262012,0,2,4
74818,6,1,262016,262016,262017,0,1,4
74819,3,1,262019,262019,262020,0,1,2
74820,4,3,262023,262023,262026,0,3,3
74821,3,2,262026,262026,262028,0,2,0
74822,1,3,262027,262028,262031,1,4,0
74823,3,2,262030,262031,262033,1,3,0
74824,5,3,262035,262035,262038,0,3,2
74825,4,1,262039,262039,262040,0,1,1
74826,5,2,262044,262044,262046,0,2,4
74827,6,3,262050,262050,262053,0,3,4
74828,2,3,262052,262053,262056,1,4,0
74829,6,3,262058,262058,262061,0,3,2
74830,6,1,262064,262064,262065,0,1,3
74831,2,1,262066,262066,262067,0,1,1
74832,6,1,262072,262072,262073,0,1,5
74833,6,3,262078,262078,262081,0,3,5
74834,4,1,262082,262082,262083,0,1,1
74835,1,1,262083,262083,262084,0,1,0
74836,3,3,262086,262086,262089,0,3,2
74837,3,2,262089,262089,262091,0,2,0
74838,1,1,262090,262091,262092,1,2,0
74839,2,3,262092,262092,262095,0,3,0
74840,3,2,262095,262095,262097,0,2,0
74841,4,3,262099,262099,262102,0,3,2
74842,4,1,262103,262103,262104,0,1,1
74843,1,2,262104,262104,262106,0,2,0
74844,2,1,262106,262106,262107,0,1,0
74845,1,1,262107,262107,262108,0,1,0
74846,2,3,262109,262109,262112,0,3,1
74847,4,3,262113,262113,262116,0,3,1
74848,6,1,262119,262119,262120,0,1,3
74849,4,2,262123,262123,262125,0,2,3
74850,5,3,262128,262128,262131,0,3,3
74851,4,2,262132,262132,262134,0,2,1
74852,1,3,262133,262134,262137,1,4,0
74853,6,1,262139,262139,262140,0,1,2
74854,3,2,262142,262142,262144,0,2,2
74855,6,1,262148,262148,262149,0,1,4
74856,2,3,262150,262150,262153,0,3,1
74857,3,1,262153,262153,262154,0,1,0
74858,6,2,262159,262159,262161,0,2,5
74859,4,3,262163,262163,262166,0,3,2
74860,1,1,262164,262166,262167,2,3,0
74861,4,1,262168,262168,262169,0,1,1
74862,3,3,262171,262171,262174,0,3,2
74863,5,3,262176,262176,262179,0,3,2
74864,4,2,262180,262180,262182,0,2,1
74865,2,1,262182,262182,262183,0,1,0
74866,4,2,262186,262186,262188,0,2,3
74867,3,2,262189,262189,262191,0,2,1
74868,1,3,262190,262191,262194,1,4,0
74869,3,1,262193,262194,262195,1,2,0
74870,5,3,262198,262198,262201,0,3,3
74871,5,3,262203,262203,262206,0,3,2
74872,1,3,262204,262206,262209,2,5,0
74873,6,3,262210,262210,262213,0,3,1
74874,4,2,262214,262214,262216,0,2,1
74875,6,2,262220,262220,262222,0,2,4
74876,2,3,262222,262222,262225,0,3,0
74877,1,1,262223,262225,262226,2,3,0
74878,5,1,262228,262228,262229,0,1,2
74879,1,3,262229,262229,262232,0,3,0
74880,5,3,262234,262234,262237,0,3,2
74881,4,1,262238,262238,262239,0,1,1
74882,4,1,262242,262242,262243,0,1,3
74883,1,3,262243,262243,262246,0,3,0
74884,4,2,262247,262247,262249,0,2,1
74885,1,2,262248,262249,262251,1,3,0
74886,1,2,262249,262251,262253,2,4,0
74887,1,2,262250,262253,262255,3,5,0
74888,2,2,262252,262255,262257,3,5,0
74889,3,2,262255,262257,262259,2,4,0
74890,1,2,262256,262259,262261,3,5,0
74891,2,1,262258,262261,262262,3,4,0
74892,5,3,262263,262263,262266,0,3,1
74893,1,1,262264,262266,262267,2,3,0
74894,6,1,262270,262270,262271,0,1,3
74895,6,3,262276,262276,262279,0,3,5
74896,1,1,262277,262279,262280,2,3,0
74897,5,1,262282,262282,262283,0,1,2
74898,4,3,262286,262286,262289,0,3,3
74899,2,2,262288,262289,262291,1,3,0
74900,6,2,262294,262294,262296,0,2,3
74901,3,1,262297,262297,262298,0,1,1
74902,3,1,262300,262300,262301,0,1,2
74903,3,1,262303,262303,262304,0,1,2
74904,1,3,262304,262304,262307,0,3,0
74905,5,2,262309,262309,262311,0,2,2
74906,2,1,262311,262311,262312,0,1,0
74907,4,1,262315,262315,262316,0,1,3
74908,6,2,262321,262321,262323,0,2,5
74909,5,3,262326,262326,262329,0,3,3
74910,4,3,262330,262330,262333,0,3,1
74911,2,1,262332,262333,262334,1,2,0
74912,5,3,262337,262337,262340,0,3,3
74913,5,1,262342,262342,262343,0,1,2
74914,2,2,262344,262344,262346,0,2,1
74915,6,3,262350,262350,262353,0,3,4
74916,6,1,262356,262356,262357,0,1,3
74917,5,3,262361,262361,262364,0,3,4
74918,5,1,262366,262366,262367,0,1,2
74919,5,1,262371,262371,262372,0,1,4
74920,6,1,262377,262377,262378,0,1,5
74921,2,3,262379,262379,262382,0,3,1
74922,5,1,262384,262384,262385,0,1,2
74923,4,1,262388,262388,262389,0,1,3
74924,1,1,262389,262389,262390,0,1,0
74925,1,2,262390,262390,262392,0,2,0
74926,2,3,262392,262392,262395,0,3,0
74927,5,1,262397,262397,262398,0,1,2
74928,6,3,262403,262403,262406,0,3,5
74929,1,3,262404,262406,262409,2,5,0
74930,5,2,262409,262409,262411,0,2,0
74931,1,2,262410,262411,262413,1,3,0
74932,2,3,262412,262413,262416,1,4,0
74933,2,2,262414,262416,262418,2,4,0
74934,1,3,262415,262418,262421,3,6,0
74935,4,1,262419,262421,262422,2,3,0
74936,3,3,262422,262422,262425,0,3,0
74937,6,3,262428,262428,262431,0,3,3
74938,4,2,262432,262432,262434,0,2,1
74939,4,2,262436,262436,262438,0,2,2
74940,1,3,262437,262438,262441,1,4,0
74941,4,3,262441,262441,262444,0,3,0
74942,5,1,262446,262446,262447,0,1,2
74943,3,1,262449,262449,262450,0,1,2
74944,1,3,262450,262450,262453,0,3,0
74945,2,1,262452,262453,262454,1,2,0
74946,1,3,262453,262454,262457,1,4,0
74947,4,1,262457,262457,262458,0,1,0
74948,2,3,262459,262459,262462,0,3,1
74949,5,3,262464,262464,262467,0,3,2
74950,3,2,262467,262467,262469,0,2,0
74951,2,3,262469,262469,262472,0,3,0
74952,4,1,262473,262473,262474,0,1,1
74953,4,2,262477,262477,262479,0,2,3
74954,1,1,262478,262479,262480,1,2,0
74955,6,3,262484,262484,262487,0,3,4
74956,6,1,262490,262490,262491,0,1,3
74957,3,1,262493,262493,262494,0,1,2
74958,3,3,262496,262496,262499,0,3,2
74959,4,1,262500,262500,262501,0,1,1
74960,4,2,262504,262504,262506,0,2,3
74961,5,1,262509,262509,262510,0,1,3
74962,3,2,262512,262512,262514,0,2,2
74963,4,1,262516,262516,262517,0,1,2
74964,5,3,262521,262521,262524,0,3,4
74965,5,1,262526,262526,262527,0,1,2
74966,2,3,262528,262528,262531,0,3,1
74967,1,3,262529,262531,262534,2,5,0
74968,4,1,262533,262534,262535,1,2,0
74969,4,2,262537,262537,262539,0,2,2
74970,3,1,262540,262540,262541,0,1,1
74971,6,3,262546,262546,262549,0,3,5
74972,3,1,262549,262549,262550,0,1,0
74973,2,1,262551,262551,262552,0,1,1
74974,3,2,262554,262554,262556,0,2,2
74975,6,3,262560,262560,262563,0,3,4
74976,6,2,262566,262566,262568,0,2,3
74977,5,3,262571,262571,262574,0,3,3
74978,2,2,262573,262574,262576,1,3,0
74979,4,1,262577,262577,262578,0,1,1
74980,4,2,262581,262581,262583,0,2,3
74981,1,2,262582,262583,262585,1,3,0
74982,3,1,262585,262585,262586,0,1,0
74983,5,2,262590,262590,262592,0,2,4
74984,4,2,262594,262594,262596,0,2,2
74985,2,1,262596,262596,262597,0,1,0
74986,6,3,262602,262602,262605,0,3,5
74987,4,1,262606,262606,262607,0,1,1
74988,4,2,262610,262610,262612,0,2,3
74989,4,2,262614,262614,262616,0,2,2
74990,4,2,262618,262618,262620,0,2,2
74991,4,1,262622,262622,262623,0,1,2
74992,3,2,262625,262625,262627,0,2,2
74993,6,2,262631,262631,262633,0,2,4
74994,2,2,262633,262633,262635,0,2,0
74995,1,2,262634,262635,262637,1,3,0
74996,2,3,262636,262637,262640,1,4,0
74997,1,3,262637,262640,262643,3,6,0
74998,4,2,262641,262643,262645,2,4,0
74999,2,2,262643,262645,262647,2,4,0
75000,2,3,262645,262647,262650,2,5,0
75001,1,3,262646,262650,262653,4,7,0
75002,5,1,262651,262653,262654,2,3,0
75003,2,3,262653,262654,262657,1,4,0
75004,6,2,262659,262659,262661,0,2,2
75005,1,2,262660,262661,262663,1,3,0
75006,6,2,262666,262666,262668,0,2,3
75007,6,2,262672,262672,262674,0,2,4
75008,2,1,262674,262674,262675,0,1,0
75009,2,3,262676,262676,262679,0,3,1
75010,1,1,262677,262679,262680,2,3,0
75011,3,3,262680,262680,262683,0,3,0
75012,4,1,262684,262684,262685,0,1,1
75013,1,3,262685,262685,262688,0,3,0
75014,4,2,262689,262689,262691,0,2,1
75015,4,1,262693,262693,262694,0,1,2
75016,3,2,262696,262696,262698,0,2,2
75017,1,2,262697,262698,262700,1,3,0
75018,2,3,262699,262700,262703,1,4,0
75019,4,3,262703,262703,262706,0,3,0
75020,3,1,262706,262706,262707,0,1,0
75021,6,1,262712,262712,262713,0,1,5
75022,5,1,262717,262717,262718,0,1,4
75023,6,1,262723,262723,262724,0,1,5
75024,2,2,262725,262725,262727,0,2,1
75025,3,1,262728,262728,262729,0,1,1
75026,3,1,262731,262731,262732,0,1,2
75027,5,2,262736,262736,262738,0,2,4
75028,3,3,262739,262739,262742,0,3,1
75029,4,3,262743,262743,262746,0,3,1
75030,2,3,262745,262746,262749,1,4,0
75031,1,2,262746,262749,262751,3,5,0
75032,1,3,262747,262751,262754,4,7,0
75033,5,1,262752,262754,262755,2,3,0
75034,1,2,262753,262755,262757,2,4,0
75035,1,2,262754,262757,262759,3,5,0
75036,2,3,262756,262759,262762,3,6,0
75037,3,2,262759,262762,262764,3,5,0
75038,6,3,262765,262765,262768,0,3,1
75039,4,2,262769,262769,262771,0,2,1
75040,6,3,262775,262775,262778,0,3,4
75041,2,1,262777,262778,262779,1,2,0
75042,3,3,262780,262780,262783,0,3,1
75043,3,3,262783,262783,262786,0,3,0
75044,6,1,262789,262789,262790,0,1,3
75045,6,2,262795,262795,262797,0,2,5
75046,3,1,262798,262798,262799,0,1,1
75047,5,3,262803,262803,262806,0,3,4
75048,4,2,262807,262807,262809,0,2,1
75049,5,1,262812,262812,262813,0,1,3
75050,4,2,262816,262816,262818,0,2,3
75051,3,1,262819,262819,262820,0,1,1
75052,6,2,262825,262825,262827,0,2,5
75053,4,3,262829,262829,262832,0,3,2
75054,3,2,262832,262832,262834,0,2,0
75055,1,1,262833,262834,262835,1,2,0
75056,4,2,262837,262837,262839,0,2,2
75057,6,3,262843,262843,262846,0,3,4
75058,5,1,262848,262848,262849,0,1,2
75059,1,2,262849,262849,262851,0,2,0
75060,6,2,262855,262855,262857,0,2,4
75061,2,1,262857,262857,262858,0,1,0
75062,6,3,262863,262863,262866,0,3,5
75063,5,3,262868,262868,262871,0,3,2
75064,5,3,262873,262873,262876,0,3,2
75065,3,3,262876,262876,262879,0,3,0
75066,2,3,262878,262879,262882,1,4,0
75067,4,3,262882,262882,262885,0,3,0
75068,6,2,262888,262888,262890,0,2,3
75069,5,2,262893,262893,262895,0,2,3
75070,3,2,262896,262896,262898,0,2,1
75071,1,1,262897,262898,262899,1,2,0
75072,6,1,262903,262903,262904,0,1,4
75073,4,2,262907,262907,262909,0,2,3
75074,5,3,262912,262912,262915,0,3,3
75075,2,2,262914,262915,262917,1,3,0
75076,3,1,262917,262917,262918,0,1,0
75077,1,1,262918,262918,262919,0,1,0
75078,4,1,262922,262922,262923,0,1,3
75079,6,3,262928,262928,262931,0,3,5
75080,6,2,262934,262934,262936,0,2,3
75081,4,1,262938,262938,262939,0,1,2
75082,4,2,262942,262942,262944,0,2,3
75083,2,1,262944,262944,262945,0,1,0
75084,5,2,262949,262949,262951,0,2,4
75085,4,3,262953,262953,262956,0,3,2
75086,1,2,262954,262956,262958,2,4,0
75087,5,2,262959,262959,262961,0,2,1
75088,3,1,262962,262962,262963,0,1,1
75089,1,2,262963,262963,262965,0,2,0
75090,4,2,262967,262967,262969,0,2,2
75091,3,1,262970,262970,262971,0,1,1
75092,5,1,262975,262975,262976,0,1,4
75093,1,3,262976,262976,262979,0,3,0
75094,5,1,262981,262981,262982,0,1,2
75095,3,3,262984,262984,262987,0,3,2
75096,2,1,262986,262987,262988,1,2,0
75097,3,1,262989,262989,262990,0,1,1
75098,3,1,262992,262992,262993,0,1,2
75099,3,2,262995,262995,262997,0,2,2
75100,3,1,262998,262998,262999,0,1,1
75101,5,2,263003,263003,263005,0,2,4
75102,1,1,263004,263005,263006,1,2,0
75103,6,1,263010,263010,263011,0,1,4
75104,4,1,263014,263014,263015,0,1,3
75105,6,1,263020,263020,263021,0,1,5
75106,6,3,263026,263026,263029,0,3,5
75107,1,1,263027,263029,263030,2,3,0
75108,3,1,263030,263030,263031,0,1,0
75109,2,3,263032,263032,263035,0,3,1
75110,1,3,263033,263035,263038,2,5,0
75111,3,3,263036,263038,263041,2,5,0
75112,5,3,263041,263041,263044,0,3,0
75113,5,2,263046,263046,263048,0,2,2
75114,3,1,263049,263049,263050,0,1,1
75115,4,2,263053,263053,263055,0,2,3
75116,1,1,263054,263055,263056,1,2,0
75117,3,1,263057,263057,263058,0,1,1
75118,2,1,263059,263059,263060,0,1,1
75119,6,2,263065,263065,263067,0,2,5
75120,2,1,263067,263067,263068,0,1,0
75121,2,3,263069,263069,263072,0,3,1
75122,4,1,263073,263073,263074,0,1,1
75123,1,3,263074,263074,263077,0,3,0
75124,3,3,263077,263077,263080,0,3,0
75125,6,1,263083,263083,263084,0,1,3
75126,3,1,263086,263086,263087,0,1,2
75127,4,1,263090,263090,263091,0,1,3
75128,3,1,263093,263093,263094,0,1,2
75129,4,1,263097,263097,263098,0,1,3
75130,4,3,263101,263101,263104,0,3,3
75131,4,2,263105,263105,263107,0,2,1
75132,2,1,263107,263107,263108,0,1,0
75133,1,2,263108,263108,263110,0,2,0
75134,1,2,263109,263110,263112,1,3,0
75135,5,3,263114,263114,263117,0,3,2
75136,3,3,263117,263117,263120,0,3,0
75137,2,1,263119,263120,263121,1,2,0
75138,3,2,263122,263122,263124,0,2,1
75139,2,3,263124,263124,263127,0,3,0
75140,4,1,263128,263128,263129,0,1,1
75141,6,3,263134,263134,263137,0,3,5
75142,2,3,263136,263137,263140,1,4,0
75143,2,1,263138,263140,263141,2,3,0
75144,3,2,263141,263141,263143,0,2,0
75145,4,1,263145,263145,263146,0,1,2
75146,4,3,263149,263149,263152,0,3,3
75147,6,2,263155,263155,263157,0,2,3
75148,4,3,263159,263159,263162,0,3,2
75149,2,1,263161,263162,263163,1,2,0
75150,1,1,263162,263163,263164,1,2,0
75151,1,3,263163,263164,263167,1,4,0
75152,1,2,263164,263167,263169,3,5,0
75153,4,1,263168,263169,263170,1,2,0
75154,1,2,263169,263170,263172,1,3,0
75155,1,2,263170,263172,263174,2,4,0
75156,1,3,263171,263174,263177,3,6,0
75157,6,3,263177,263177,263180,0,3,0
75158,4,3,263181,263181,263184,0,3,1
75159,3,1,263184,263184,263185,0,1,0
75160,1,1,263185,263185,263186,0,1,0
75161,6,2,263191,263191,263193,0,2,5
75162,4,3,263195,263195,263198,0,3,2
75163,1,3,263196,263198,263201,2,5,0
75164,1,3,263197,263201,263204,4,7,0
75165,1,1,263198,263204,263205,6,7,0
75166,3,1,263201,263205,263206,4,5,0
75167,2,3,263203,263206,263209,3,6,0
75168,6,3,263209,263209,263212,0,3,0
75169,2,2,263211,263212,263214,1,3,0
75170,4,2,263215,263215,263217,0,2,1
75171,3,2,263218,263218,263220,0,2,1
75172,5,2,263223,263223,263225,0,2,3
75173,2,3,263225,263225,263228,0,3,0
75174,2,3,263227,263228,263231,1,4,0
75175,1,2,263228,263231,263233,3,5,0
75176,5,1,263233,263233,263234,0,1,0
75177,4,1,263237,263237,263238,0,1,3
75178,4,3,263241,263241,263244,0,3,3
75179,3,2,263244,263244,263246,0,2,0
75180,4,1,263248,263248,263249,0,1,2
75181,4,3,263252,263252,263255,0,3,3
75182,3,3,263255,263255,263258,0,3,0
75183,3,2,263258,263258,263260,0,2,0
75184,1,1,263259,263260,263261,1,2,0
75185,6,2,263265,263265,263267,0,2,4
75186,2,3,263267,263267,263270,0,3,0
75187,2,3,263269,263270,263273,1,4,0
75188,4,3,263273,263273,263276,0,3,0
75189,4,2,263277,263277,263279,0,2,1
75190,1,1,263278,263279,263280,1,2,0
75191,6,1,263284,263284,263285,0,1,4
75192,2,3,263286,263286,263289,0,3,1
75193,3,1,263289,263289,263290,0,1,0
75194,4,3,263293,263293,263296,0,3,3
75195,2,2,263295,263296,263298,1,3,0
75196,3,2,263298,263298,263300,0,2,0
75197,5,1,263303,263303,263304,0,1,3
75198,5,1,263308,263308,263309,0,1,4
75199,3,1,263311,263311,263312,0,1,2
75200,3,3,263314,263314,263317,0,3,2
75201,6,2,263320,263320,263322,0,2,3
75202,3,2,263323,263323,263325,0,2,1
75203,6,2,263329,263329,263331,0,2,4
75204,6,2,263335,263335,263337,0,2,4
75205,6,2,263341,263341,263343,0,2,4
75206,5,3,263346,263346,263349,0,3,3
75207,4,3,263350,263350,263353,0,3,1
75208,6,2,263356,263356,263358,0,2,3
75209,6,2,263362,263362,263364,0,2,4
75210,4,1,263366,263366,263367,0,1,2
75211,1,1,263367,263367,263368,0,1,0
75212,3,1,263370,263370,263371,0,1,2
75213,5,2,263375,263375,263377,0,2,4
75214,3,1,263378,263378,263379,0,1,1
75215,5,2,263383,263383,263385,0,2,4
75216,3,1,263386,263386,263387,0,1,1
75217,6,1,263392,263392,263393,0,1,5
75218,6,1,263398,263398,263399,0,1,5
75219,3,2,263401,263401,263403,0,2,2
75220,4,1,263405,263405,263406,0,1,2
75221,4,2,263409,263409,263411,0,2,3
75222,4,3,263413,263413,263416,0,3,2
75223,4,2,263417,263417,263419,0,2,1
75224,5,3,263422,263422,263425,0,3,3
75225,3,3,263425,263425,263428,0,3,0
75226,2,3,263427,263428,263431,1,4,0
75227,1,3,263428,263431,263434,3,6,0
75228,4,2,263432,263434,263436,2,4,0
75229,5,1,263437,263437,263438,0,1,1
75230,1,3,263438,263438,263441,0,3,0
75231,3,2,263441,263441,263443,0,2,0
75232,5,2,263446,263446,263448,0,2,3
75233,2,3,263448,263448,263451,0,3,0
75234,5,3,263453,263453,263456,0,3,2
75235,4,2,263457,263457,263459,0,2,1
75236,3,2,263460,263460,263462,0,2,1
75237,6,3,263466,263466,263469,0,3,4
75238,4,2,263470,263470,263472,0,2,1
75239,3,2,263473,263473,263475,0,2,1
75240,4,2,263477,263477,263479,0,2,2
75241,4,1,263481,263481,263482,0,1,2
75242,4,2,263485,263485,263487,0,2,3
75243,1,3,263486,263487,263490,1,4,0
75244,6,2,263492,263492,263494,0,2,2
75245,3,3,263495,263495,263498,0,3,1
75246,4,2,263499,263499,263501,0,2,1
75247,6,2,263505,263505,263507,0,2,4
75248,2,1,263507,263507,263508,0,1,0
75249,2,3,263509,263509,263512,0,3,1
75250,4,2,263513,263513,263515,0,2,1
75251,3,2,263516,263516,263518,0,2,1
75252,1,2,263517,263518,263520,1,3,0
75253,4,2,263521,263521,263523,0,2,1
75254,3,2,263524,263524,263526,0,2,1
75255,4,2,263528,263528,263530,0,2,2
75256,6,2,263534,263534,263536,0,2,4
75257,5,2,263539,263539,263541,0,2,3
75258,2,2,263541,263541,263543,0,2,0
75259,4,3,263545,263545,263548,0,3,2
75260,1,2,263546,263548,263550,2,4,0
75261,1,1,263547,263550,263551,3,4,0
75262,5,3,263552,263552,263555,0,3,1
75263,1,2,263553,263555,263557,2,4,0
75264,3,2,263556,263557,263559,1,3,0
75265,3,3,263559,263559,263562,0,3,0
75266,2,2,263561,263562,263564,1,3,0
75267,1,2,263562,263564,263566,2,4,0
75268,3,2,263565,263566,263568,1,3,0
75269,2,2,263567,263568,263570,1,3,0
75270,1,1,263568,263570,263571,2,3,0
75271,2,1,263570,263571,263572,1,2,0
75272,1,2,263571,263572,263574,1,3,0
75273,4,2,263575,263575,263577,0,2,1
75274,4,2,263579,263579,263581,0,2,2
75275,4,1,263583,263583,263584,0,1,2
75276,4,2,263587,263587,263589,0,2,3
75277,4,1,263591,263591,263592,0,1,2
75278,6,3,263597,263597,263600,0,3,5
75279,3,3,263600,263600,263603,0,3,0
75280,3,1,263603,263603,263604,0,1,0
75281,2,2,263605,263605,263607,0,2,1
75282,2,2,263607,263607,263609,0,2,0
75283,1,2,263608,263609,263611,1,3,0
75284,6,3,263614,263614,263617,0,3,3
75285,5,2,263619,263619,263621,0,2,2
75286,2,1,263621,263621,263622,0,1,0
75287,1,1,263622,263622,263623,0,1,0
75288,2,2,263624,263624,263626,0,2,1
75289,5,1,263629,263629,263630,0,1,3
75290,6,2,263635,263635,263637,0,2,5
75291,3,3,263638,263638,263641,0,3,1
75292,6,3,263644,263644,263647,0,3,3
75293,6,3,263650,263650,263653,0,3,3
75294,6,3,263656,263656,263659,0,3,3
75295,4,2,263660,263660,263662,0,2,1
75296,2,2,263662,263662,263664,0,2,0
75297,6,3,263668,263668,263671,0,3,4
75298,1,1,263669,263671,263672,2,3,0
75299,6,3,263675,263675,263678,0,3,3
75300,6,1,263681,263681,263682,0,1,3
75301,5,1,263686,263686,263687,0,1,4
75302,3,3,263689,263689,263692,0,3,2
75303,2,1,263691,263692,263693,1,2,0
75304,5,1,263696,263696,263697,0,1,3
75305,4,2,263700,263700,263702,0,2,3
75306,1,1,263701,263702,263703,1,2,0
75307,1,1,263702,263703,263704,1,2,0
75308,1,2,263703,263704,263706,1,3,0
75309,5,3,263708,263708,263711,0,3,2
75310,2,1,263710,263711,263712,1,2,0
75311,4,3,263714,263714,263717,0,3,2
75312,3,3,263717,263717,263720,0,3,0
75313,2,1,263719,263720,263721,1,2,0
75314,4,3,263723,263723,263726,0,3,2
75315,1,3,263724,263726,263729,2,5,0
75316,4,2,263728,263729,263731,1,3,0
75317,6,2,263734,263734,263736,0,2,3
75318,4,1,263738,263738,263739,0,1,2
75319,5,1,263743,263743,263744,0,1,4
75320,5,1,263748,263748,263749,0,1,4
75321,5,2,263753,263753,263755,0,2,4
75322,3,1,263756,263756,263757,0,1,1
75323,2,1,263758,263758,263759,0,1,1
75324,6,1,263764,263764,263765,0,1,5
75325,6,2,263770,263770,263772,0,2,5
75326,4,2,263774,263774,263776,0,2,2
75327,3,3,263777,263777,263780,0,3,1
75328,1,1,263778,263780,263781,2,3,0
75329,3,3,263781,263781,263784,0,3,0
75330,6,1,263787,263787,263788,0,1,3
75331,5,1,263792,263792,263793,0,1,4
75332,1,3,263793,263793,263796,0,3,0
75333,5,3,263798,263798,263801,0,3,2
75334,5,3,263803,263803,263806,0,3,2
75335,3,3,263806,263806,263809,0,3,0
75336,4,1,263810,263810,263811,0,1,1
75337,3,2,263813,263813,263815,0,2,2
75338,5,3,263818,263818,263821,0,3,3
75339,3,1,263821,263821,263822,0,1,0
75340,3,3,263824,263824,263827,0,3,2
75341,1,1,263825,263827,263828,2,3,0
75342,5,3,263830,263830,263833,0,3,2
75343,4,1,263834,263834,263835,0,1,1
75344,4,2,263838,263838,263840,0,2,3
75345,3,3,263841,263841,263844,0,3,1
75346,2,3,263843,263844,263847,1,4,0
75347,4,3,263847,263847,263850,0,3,0
75348,4,3,263851,263851,263854,0,3,1
75349,2,2,263853,263854,263856,1,3,0
75350,4,1,263857,263857,263858,0,1,1
75351,2,1,263859,263859,263860,0,1,1
75352,5,3,263864,263864,263867,0,3,4
75353,4,3,263868,263868,263871,0,3,1
75354,1,2,263869,263871,263873,2,4,0
75355,2,2,263871,263873,263875,2,4,0
75356,1,1,263872,263875,263876,3,4,0
75357,4,1,263876,263876,263877,0,1,0
75358,6,1,263882,263882,263883,0,1,5
75359,4,3,263886,263886,263889,0,3,3
75360,5,1,263891,263891,263892,0,1,2
75361,3,2,263894,263894,263896,0,2,2
75362,2,1,263896,263896,263897,0,1,0
75363,6,2,263902,263902,263904,0,2,5
75364,2,1,263904,263904,263905,0,1,0
75365,1,2,263905,263905,263907,0,2,0
75366,5,1,263910,263910,263911,0,1,3
75367,6,2,263916,263916,263918,0,2,5
75368,4,2,263920,263920,263922,0,2,2
75369,2,1,263922,263922,263923,0,1,0
75370,1,1,263923,263923,263924,0,1,0
75371,3,2,263926,263926,263928,0,2,2
75372,4,1,263930,263930,263931,0,1,2
75373,3,2,263933,263933,263935,0,2,2
75374,3,3,263936,263936,263939,0,3,1
75375,3,1,263939,263939,263940,0,1,0
75376,4,3,263943,263943,263946,0,3,3
75377,1,3,263944,263946,263949,2,5,0
75378,1,1,263945,263949,263950,4,5,0
75379,4,2,263949,263950,263952,1,3,0
75380,6,2,263955,263955,263957,0,2,3
75381,1,3,263956,263957,263960,1,4,0
75382,5,3,263961,263961,263964,0,3,1
75383,6,2,263967,263967,263969,0,2,3
75384,6,2,263973,263973,263975,0,2,4
75385,2,1,263975,263975,263976,0,1,0
75386,4,3,263979,263979,263982,0,3,3
75387,2,1,263981,263982,263983,1,2,0
75388,2,2,263983,263983,263985,0,2,0
75389,2,1,263985,263985,263986,0,1,0
75390,5,1,263990,263990,263991,0,1,4
75391,4,3,263994,263994,263997,0,3,3
75392,3,1,263997,263997,263998,0,1,0
75393,1,2,263998,263998,264000,0,2,0
75394,6,3,264004,264004,264007,0,3,4
75395,1,3,264005,264007,264010,2,5,0
75396,3,3,264008,264010,264013,2,5,0
75397,2,2,264010,264013,264015,3,5,0
75398,5,3,264015,264015,264018,0,3,0
75399,3,1,264018,264018,264019,0,1,0
75400,6,2,264024,264024,264026,0,2,5
75401,3,2,264027,264027,264029,0,2,1
75402,4,3,264031,264031,264034,0,3,2
75403,3,1,264034,264034,264035,0,1,0
75404,1,3,264035,264035,264038,0,3,0
75405,4,2,264039,264039,264041,0,2,1
75406,4,3,264043,264043,264046,0,3,2
75407,2,1,264045,264046,264047,1,2,0
75408,3,1,264048,264048,264049,0,1,1
75409,4,1,264052,264052,264053,0,1,3
75410,6,3,264058,264058,264061,0,3,5
75411,4,1,264062,264062,264063,0,1,1
75412,1,2,264063,264063,264065,0,2,0
75413,1,2,264064,264065,264067,1,3,0
75414,6,1,264070,264070,264071,0,1,3
75415,5,1,264075,264075,264076,0,1,4
75416,6,1,264081,264081,264082,0,1,5
75417,6,1,264087,264087,264088,0,1,5
75418,5,2,264092,264092,264094,0,2,4
75419,5,3,264097,264097,264100,0,3,3
75420,1,1,264098,264100,264101,2,3,0
75421,2,2,264100,264101,264103,1,3,0
75422,1,3,264101,264103,264106,2,5,0
75423,1,1,264102,264106,264107,4,5,0
75424,3,3,264105,264107,264110,2,5,0
75425,3,2,264108,264110,264112,2,4,0
75426,1,2,264109,264112,264114,3,5,0
75427,3,3,264112,264114,264117,2,5,0
75428,4,3,264116,264117,264120,1,4,0
75429,2,1,264118,264120,264121,2,3,0
75430,6,1,264124,264124,264125,0,1,3
75431,1,3,264125,264125,264128,0,3,0
75432,3,3,264128,264128,264131,0,3,0
75433,1,1,264129,264131,264132,2,3,0
75434,5,2,264134,264134,264136,0,2,2
75435,6,2,264140,264140,264142,0,2,4
75436,3,3,264143,264143,264146,0,3,1
75437,1,2,264144,264146,264148,2,4,0
75438,3,3,264147,264148,264151,1,4,0
75439,5,2,264152,264152,264154,0,2,1
75440,4,3,264156,264156,264159,0,3,2
75441,6,1,264162,264162,264163,0,1,3
75442,3,2,264165,264165,264167,0,2,2
75443,3,2,264168,264168,264170,0,2,1
75444,1,2,264169,264170,264172,1,3,0
75445,6,2,264175,264175,264177,0,2,3
75446,5,1,264180,264180,264181,0,1,3
75447,4,2,264184,264184,264186,0,2,3
75448,3,3,264187,264187,264190,0,3,1
75449,6,2,264193,264193,264195,0,2,3
75450,6,2,264199,264199,264201,0,2,4
75451,3,3,264202,264202,264205,0,3,1
75452,4,3,264206,264206,264209,0,3,1
75453,4,2,264210,264210,264212,0,2,1
75454,5,2,264215,264215,264217,0,2,3
75455,1,2,264216,264217,264219,1,3,0
75456,1,1,264217,264219,264220,2,3,0
75457,5,3,264222,264222,264225,0,3,2
75458,5,1,264227,264227,264228,0,1,2
75459,1,3,264228,264228,264231,0,3,0
75460,3,2,264231,264231,264233,0,2,0
75461,2,3,264233,264233,264236,0,3,0
75462,6,1,264239,264239,264240,0,1,3
75463,1,1,264240,264240,264241,0,1,0
75464,6,2,264246,264246,264248,0,2,5
75465,4,1,264250,264250,264251,0,1,2
75466,4,3,264254,264254,264257,0,3,3
75467,1,1,264255,264257,264258,2,3,0
75468,1,3,264256,264258,264261,2,5,0
75469,1,1,264257,264261,264262,4,5,0
75470,1,1,264258,264262,264263,4,5,0
75471,6,3,264264,264264,264267,0,3,1
75472,1,1,264265,264267,264268,2,3,0
75473,1,1,264266,264268,264269,2,3,0
75474,3,3,264269,264269,264272,0,3,0
75475,1,2,264270,264272,264274,2,4,0
75476,3,2,264273,264274,264276,1,3,0
75477,6,1,264279,264279,264280,0,1,3
75478,4,1,264283,264283,264284,0,1,3
75479,4,3,264287,264287,264290,0,3,3
75480,5,1,264292,264292,264293,0,1,2
75481,2,3,264294,264294,264297,0,3,1
75482,3,1,264297,264297,264298,0,1,0
75483,3,3,264300,264300,264303,0,3,2
75484,1,1,264301,264303,264304,2,3,0
75485,3,1,264304,264304,264305,0,1,0
75486,1,3,264305,264305,264308,0,3,0
75487,3,2,264308,264308,264310,0,2,0
75488,6,3,264314,264314,264317,0,3,4
75489,4,3,264318,264318,264321,0,3,1
75490,2,1,264320,264321,264322,1,2,0
75491,6,3,264326,264326,264329,0,3,4
75492,4,3,264330,264330,264333,0,3,1
75493,2,3,264332,264333,264336,1,4,0
75494,4,1,264336,264336,264337,0,1,0
75495,3,1,264339,264339,264340,0,1,2
75496,6,2,264345,264345,264347,0,2,5
75497,3,1,264348,264348,264349,0,1,1
75498,2,2,264350,264350,264352,0,2,1
75499,6,3,264356,264356,264359,0,3,4
75500,4,1,264360,264360,264361,0,1,1
75501,1,3,264361,264361,264364,0,3,0
75502,4,1,264365,264365,264366,0,1,1
75503,1,3,264366,264366,264369,0,3,0
75504,6,2,264372,264372,264374,0,2,3
75505,4,2,264376,264376,264378,0,2,2
75506,1,2,264377,264378,264380,1,3,0
75507,6,2,264383,264383,264385,0,2,3
75508,5,2,264388,264388,264390,0,2,3
75509,3,3,264391,264391,264394,0,3,1
75510,5,1,264396,264396,264397,0,1,2
75511,3,1,264399,264399,264400,0,1,2
75512,5,3,264404,264404,264407,0,3,4
75513,4,3,264408,264408,264411,0,3,1
75514,3,2,264411,264411,264413,0,2,0
75515,4,2,264415,264415,264417,0,2,2
75516,5,1,264420,264420,264421,0,1,3
75517,4,2,264424,264424,264426,0,2,3
75518,4,3,264428,264428,264431,0,3,2
75519,2,2,264430,264431,264433,1,3,0
75520,1,1,264431,264433,264434,2,3,0
75521,3,1,264434,264434,264435,0,1,0
75522,1,3,264435,264435,264438,0,3,0
75523,4,2,264439,264439,264441,0,2,1
75524,5,3,264444,264444,264447,0,3,3
75525,1,2,264445,264447,264449,2,4,0
75526,3,2,264448,264449,264451,1,3,0
75527,6,2,264454,264454,264456,0,2,3
75528,4,3,264458,264458,264461,0,3,2
75529,1,1,264459,264461,264462,2,3,0
75530,2,2,264461,264462,264464,1,3,0
75531,5,3,264466,264466,264469,0,3,2
75532,6,2,264472,264472,264474,0,2,3
75533,5,2,264477,264477,264479,0,2,3
75534,1,2,264478,264479,264481,1,3,0
75535,2,1,264480,264481,264482,1,2,0
75536,4,2,264484,264484,264486,0,2,2
75537,1,2,264485,264486,264488,1,3,0
75538,1,2,264486,264488,264490,2,4,0
75539,3,1,264489,264490,264491,1,2,0
75540,5,1,264494,264494,264495,0,1,3
75541,1,1,264495,264495,264496,0,1,0
75542,1,2,264496,264496,264498,0,2,0
75543,5,3,264501,264501,264504,0,3,3
75544,4,2,264505,264505,264507,0,2,1
75545,3,1,264508,264508,264509,0,1,1
75546,1,3,264509,264509,264512,0,3,0
75547,4,3,264513,264513,264516,0,3,1
75548,5,3,264518,264518,264521,0,3,2
75549,4,1,264522,264522,264523,0,1,1
75550,4,3,264526,264526,264529,0,3,3
75551,6,1,264532,264532,264533,0,1,3
75552,1,3,264533,264533,264536,0,3,0
75553,1,1,264534,264536,264537,2,3,0
75554,5,2,264539,264539,264541,0,2,2
75555,6,1,264545,264545,264546,0,1,4
75556,6,3,264551,264551,264554,0,3,5
75557,2,1,264553,264554,264555,1,2,0
75558,2,2,264555,264555,264557,0,2,0
75559,3,2,264558,264558,264560,0,2,1
75560,6,1,264564,264564,264565,0,1,4
75561,6,2,264570,264570,264572,0,2,5
75562,2,2,264572,264572,264574,0,2,0
75563,5,2,264577,264577,264579,0,2,3
75564,6,2,264583,264583,264585,0,2,4
75565,4,1,264587,264587,264588,0,1,2
75566,6,2,264593,264593,264595,0,2,5
75567,2,1,264595,264595,264596,0,1,0
75568,6,1,264601,264601,264602,0,1,5
75569,5,3,264606,264606,264609,0,3,4
75570,6,2,264612,264612,264614,0,2,3
75571,5,2,264617,264617,264619,0,2,3
75572,3,3,264620,264620,264623,0,3,1
75573,4,2,264624,264624,264626,0,2,1
75574,1,3,264625,264626,264629,1,4,0
75575,2,3,264627,264629,264632,2,5,0
75576,4,1,264631,264632,264633,1,2,0
75577,4,1,264635,264635,264636,0,1,2
75578,4,1,264639,264639,264640,0,1,3
75579,4,1,264643,264643,264644,0,1,3
75580,3,1,264646,264646,264647,0,1,2
75581,6,3,264652,264652,264655,0,3,5
75582,1,2,264653,264655,264657,2,4,0
75583,2,2,264655,264657,264659,2,4,0
75584,3,3,264658,264659,264662,1,4,0
75585,2,1,264660,264662,264663,2,3,0
75586,4,3,264664,264664,264667,0,3,1
75587,5,2,264669,264669,264671,0,2,2
75588,1,1,264670,264671,264672,1,2,0
75589,6,2,264676,264676,264678,0,2,4
75590,2,2,264678,264678,264680,0,2,0
75591,4,3,264682,264682,264685,0,3,2
75592,4,2,264686,264686,264688,0,2,1
75593,5,3,264691,264691,264694,0,3,3
75594,4,3,264695,264695,264698,0,3,1
75595,3,1,264698,264698,264699,0,1,0
75596,2,2,264700,264700,264702,0,2,1
75597,4,2,264704,264704,264706,0,2,2
75598,2,1,264706,264706,264707,0,1,0
75599,1,1,264707,264707,264708,0,1,0
75600,2,3,264709,264709,264712,0,3,1
75601,1,2,264710,264712,264714,2,4,0
75602,6,3,264716,264716,264719,0,3,2
75603,6,3,264722,264722,264725,0,3,3
75604,2,1,264724,264725,264726,1,2,0
75605,3,3,264727,264727,264730,0,3,1
75606,5,2,264732,264732,264734,0,2,2
75607,5,1,264737,264737,264738,0,1,3
75608,6,2,264743,264743,264745,0,2,5
75609,5,3,264748,264748,264751,0,3,3
75610,2,3,264750,264751,264754,1,4,0
75611,3,1,264753,264754,264755,1,2,0
75612,3,3,264756,264756,264759,0,3,1
75613,1,3,264757,264759,264762,2,5,0
75614,4,1,264761,264762,264763,1,2,0
75615,2,1,264763,264763,264764,0,1,0
75616,3,3,264766,264766,264769,0,3,2
75617,2,1,264768,264769,264770,1,2,0
75618,2,3,264770,264770,264773,0,3,0
75619,4,1,264774,264774,264775,0,1,1
75620,6,3,264780,264780,264783,0,3,5
75621,5,1,264785,264785,264786,0,1,2
75622,6,2,264791,264791,264793,0,2,5
75623,5,3,264796,264796,264799,0,3,3
75624,3,1,264799,264799,264800,0,1,0
75625,1,1,264800,264800,264801,0,1,0
75626,3,2,264803,264803,264805,0,2,2
75627,3,2,264806,264806,264808,0,2,1
75628,3,2,264809,264809,264811,0,2,1
75629,4,3,264813,264813,264816,0,3,2
75630,1,1,264814,264816,264817,2,3,0
75631,5,2,264819,264819,264821,0,2,2
75632,2,2,264821,264821,264823,0,2,0
75633,1,1,264822,264823,264824,1,2,0
75634,5,2,264827,264827,264829,0,2,3
75635,1,1,264828,264829,264830,1,2,0
75636,3,2,264831,264831,264833,0,2,1
75637,6,2,264837,264837,264839,0,2,4
75638,2,1,264839,264839,264840,0,1,0
75639,6,3,264845,264845,264848,0,3,5
75640,2,3,264847,264848,264851,1,4,0
75641,6,1,264853,264853,264854,0,1,2
75642,3,2,264856,264856,264858,0,2,2
75643,4,1,264860,264860,264861,0,1,2
75644,3,3,264863,264863,264866,0,3,2
75645,6,1,264869,264869,264870,0,1,3
75646,1,2,264870,264870,264872,0,2,0
75647,4,3,264874,264874,264877,0,3,2
75648,5,1,264879,264879,264880,0,1,2
75649,3,2,264882,264882,264884,0,2,2
75650,5,1,264887,264887,264888,0,1,3
75651,1,1,264888,264888,264889,0,1,0
75652,6,3,264894,264894,264897,0,3,5
75653,5,2,264899,264899,264901,0,2,2
75654,3,3,264902,264902,264905,0,3,1
75655,3,2,264905,264905,264907,0,2,0
75656,6,3,264911,264911,264914,0,3,4
75657,1,3,264912,264914,264917,2,5,0
75658,1,1,264913,264917,264918,4,5,0
75659,1,2,264914,264918,264920,4,6,0
75660,1,1,264915,264920,264921,5,6,0
75661,3,1,264918,264921,264922,3,4,0
75662,4,2,264922,264922,264924,0,2,0
75663,5,1,264927,264927,264928,0,1,3
75664,3,2,264930,264930,264932,0,2,2
75665,3,3,264933,264933,264936,0,3,1
75666,2,1,264935,264936,264937,1,2,0
75667,4,2,264939,264939,264941,0,2,2
75668,6,1,264945,264945,264946,0,1,4
75669,2,3,264947,264947,264950,0,3,1
75670,5,3,264952,264952,264955,0,3,2
75671,5,1,264957,264957,264958,0,1,2
75672,1,3,264958,264958,264961,0,3,0
75673,3,3,264961,264961,264964,0,3,0
75674,4,2,264965,264965,264967,0,2,1
75675,1,3,264966,264967,264970,1,4,0
75676,2,2,264968,264970,264972,2,4,0
75677,6,1,264974,264974,264975,0,1,2
75678,5,3,264979,264979,264982,0,3,4
75679,2,2,264981,264982,264984,1,3,0
75680,6,2,264987,264987,264989,0,2,3
75681,5,2,264992,264992,264994,0,2,3
75682,3,1,264995,264995,264996,0,1,1
75683,3,1,264998,264998,264999,0,1,2
75684,1,1,264999,264999,265000,0,1,0
75685,6,1,265005,265005,265006,0,1,5
75686,1,1,265006,265006,265007,0,1,0
75687,4,3,265010,265010,265013,0,3,3
75688,5,3,265015,265015,265018,0,3,2
75689,4,3,265019,265019,265022,0,3,1
75690,3,1,265022,265022,265023,0,1,0
75691,1,1,265023,265023,265024,0,1,0
75692,5,2,265028,265028,265030,0,2,4
75693,5,1,265033,265033,265034,0,1,3
75694,1,2,265034,265034,265036,0,2,0
75695,6,1,265040,265040,265041,0,1,4
75696,6,1,265046,265046,265047,0,1,5
75697,5,2,265051,265051,265053,0,2,4
75698,4,1,265055,265055,265056,0,1,2
75699,6,1,265061,265061,265062,0,1,5
75700,4,2,265065,265065,265067,0,2,3
75701,1,1,265066,265067,265068,1,2,0
75702,4,2,265070,265070,265072,0,2,2
75703,3,3,265073,265073,265076,0,3,1
75704,2,1,265075,265076,265077,1,2,0
75705,1,3,265076,265077,265080,1,4,0
75706,5,1,265081,265081,265082,0,1,1
75707,6,2,265087,265087,265089,0,2,5
75708,5,3,265092,265092,265095,0,3,3
75709,6,2,265098,265098,265100,0,2,3
75710,4,1,265102,265102,265103,0,1,2
75711,2,3,265104,265104,265107,0,3,1
75712,1,1,265105,265107,265108,2,3,0
75713,2,2,265107,265108,265110,1,3,0
75714,4,1,265111,265111,265112,0,1,1
75715,3,1,265114,265114,265115,0,1,2
75716,1,3,265115,265115,265118,0,3,0
75717,6,2,265121,265121,265123,0,2,3
75718,1,1,265122,265123,265124,1,2,0
75719,1,2,265123,265124,265126,1,3,0
75720,2,2,265125,265126,265128,1,3,0
75721,2,3,265127,265128,265131,1,4,0
75722,6,1,265133,265133,265134,0,1,2
75723,1,2,265134,265134,265136,0,2,0
75724,1,1,265135,265136,265137,1,2,0
75725,3,3,265138,265138,265141,0,3,1
75726,4,2,265142,265142,265144,0,2,1
75727,6,1,265148,265148,265149,0,1,4
75728,3,2,265151,265151,265153,0,2,2
75729,1,2,265152,265153,265155,1,3,0
75730,4,2,265156,265156,265158,0,2,1
75731,4,2,265160,265160,265162,0,2,2
75732,2,1,265162,265162,265163,0,1,0
75733,4,1,265166,265166,265167,0,1,3
75734,4,1,265170,265170,265171,0,1,3
75735,2,1,265172,265172,265173,0,1,1
75736,5,3,265177,265177,265180,0,3,4
75737,2,2,265179,265180,265182,1,3,0
75738,4,2,265183,265183,265185,0,2,1
75739,4,3,265187,265187,265190,0,3,2
75740,6,1,265193,265193,265194,0,1,3
75741,4,1,265197,265197,265198,0,1,3
75742,3,2,265200,265200,265202,0,2,2
75743,3,1,265203,265203,265204,0,1,1
75744,6,2,265209,265209,265211,0,2,5
75745,4,3,265213,265213,265216,0,3,2
75746,2,1,265215,265216,265217,1,2,0
75747,4,2,265219,265219,265221,0,2,2
75748,2,3,265221,265221,265224,0,3,0
75749,3,2,265224,265224,265226,0,2,0
75750,3,1,265227,265227,265228,0,1,1
75751,4,3,265231,265231,265234,0,3,3
75752,5,3,265236,265236,265239,0,3,2
75753,6,2,265242,265242,265244,0,2,3
75754,1,2,265243,265244,265246,1,3,0
75755,2,3,265245,265246,265249,1,4,0
75756,3,2,265248,265249,265251,1,3,0
75757,4,1,265252,265252,265253,0,1,1
75758,6,2,265258,265258,265260,0,2,5
75759,2,3,265260,265260,265263,0,3,0
75760,6,1,265266,265266,265267,0,1,3
75761,5,2,265271,265271,265273,0,2,4
75762,5,2,265276,265276,265278,0,2,3
75763,5,1,265281,265281,265282,0,1,3
75764,6,2,265287,265287,265289,0,2,5
75765,6,3,265293,265293,265296,0,3,4
75766,1,1,265294,265296,265297,2,3,0
75767,3,2,265297,265297,265299,0,2,0
75768,6,2,265303,265303,265305,0,2,4
75769,5,2,265308,265308,265310,0,2,3
75770,5,2,265313,265313,265315,0,2,3
75771,5,2,265318,265318,265320,0,2,3
75772,1,2,265319,265320,265322,1,3,0
75773,5,2,265324,265324,265326,0,2,2
75774,2,1,265326,265326,265327,0,1,0
75775,3,1,265329,265329,265330,0,1,2
75776,5,2,265334,265334,265336,0,2,4
75777,2,1,265336,265336,265337,0,1,0
75778,3,3,265339,265339,265342,0,3,2
75779,5,3,265344,265344,265347,0,3,2
75780,6,1,265350,265350,265351,0,1,3
75781,4,2,265354,265354,265356,0,2,3
75782,5,3,265359,265359,265362,0,3,3
75783,3,3,265362,265362,265365,0,3,0
75784,6,3,265368,265368,265371,0,3,3
75785,5,1,265373,265373,265374,0,1,2
75786,4,1,265377,265377,265378,0,1,3
75787,5,3,265382,265382,265385,0,3,4
75788,4,1,265386,265386,265387,0,1,1
75789,2,2,265388,265388,265390,0,2,1
75790,4,1,265392,265392,265393,0,1,2
75791,3,3,265395,265395,265398,0,3,2
75792,5,3,265400,265400,265403,0,3,2
75793,3,3,265403,265403,265406,0,3,0
75794,4,3,265407,265407,265410,0,3,1
75795,1,2,265408,265410,265412,2,4,0
75796,1,2,265409,265412,265414,3,5,0
75797,3,3,265412,265414,265417,2,5,0
75798,3,3,265415,265417,265420,2,5,0
75799,2,1,265417,265420,265421,3,4,0
75800,6,3,265423,265423,265426,0,3,2
75801,6,2,265429,265429,265431,0,2,3
75802,2,2,265431,265431,265433,0,2,0
75803,1,2,265432,265433,265435,1,3,0
75804,1,1,265433,265435,265436,2,3,0
75805,6,1,265439,265439,265440,0,1,3
75806,1,2,265440,265440,265442,0,2,0
75807,2,1,265442,265442,265443,0,1,0
75808,5,3,265447,265447,265450,0,3,4
75809,2,2,265449,265450,265452,1,3,0
75810,4,2,265453,265453,265455,0,2,1
75811,1,3,265454,265455,265458,1,4,0
75812,4,1,265458,265458,265459,0,1,0
75813,1,2,265459,265459,265461,0,2,0
75814,6,1,265465,265465,265466,0,1,4
75815,2,2,265467,265467,265469,0,2,1
75816,3,1,265470,265470,265471,0,1,1
75817,6,2,265476,265476,265478,0,2,5
75818,2,2,265478,265478,265480,0,2,0
75819,1,2,265479,265480,265482,1,3,0
75820,3,3,265482,265482,265485,0,3,0
75821,3,3,265485,265485,265488,0,3,0
75822,3,3,265488,265488,265491,0,3,0
75823,1,2,265489,265491,265493,2,4,0
75824,4,2,265493,265493,265495,0,2,0
75825,6,1,265499,265499,265500,0,1,4
75826,5,3,265504,265504,265507,0,3,4
75827,4,1,265508,265508,265509,0,1,1
75828,6,2,265514,265514,265516,0,2,5
75829,3,2,265517,265517,265519,0,2,1
75830,1,2,265518,265519,265521,1,3,0
75831,6,1,265524,265524,265525,0,1,3
75832,6,2,265530,265530,265532,0,2,5
75833,3,3,265533,265533,265536,0,3,1
75834,6,1,265539,265539,265540,0,1,3
75835,2,3,265541,265541,265544,0,3,1
75836,4,3,265545,265545,265548,0,3,1
75837,5,3,265550,265550,265553,0,3,2
75838,2,2,265552,265553,265555,1,3,0
75839,2,2,265554,265555,265557,1,3,0
75840,3,3,265557,265557,265560,0,3,0
75841,5,1,265562,265562,265563,0,1,2
75842,4,3,265566,265566,265569,0,3,3
75843,1,3,265567,265569,265572,2,5,0
75844,1,1,265568,265572,265573,4,5,0
75845,4,2,265572,265573,265575,1,3,0
75846,4,1,265576,265576,265577,0,1,1
75847,2,3,265578,265578,265581,0,3,1
75848,6,2,265584,265584,265586,0,2,3
75849,5,3,265589,265589,265592,0,3,3
75850,4,3,265593,265593,265596,0,3,1
75851,1,1,265594,265596,265597,2,3,0
75852,1,3,265595,265597,265600,2,5,0
75853,1,1,265596,265600,265601,4,5,0
75854,5,1,265601,265601,265602,0,1,0
75855,5,3,265606,265606,265609,0,3,4
75856,1,1,265607,265609,265610,2,3,0
75857,4,2,265611,265611,265613,0,2,1
75858,4,3,265615,265615,265618,0,3,2
75859,4,2,265619,265619,265621,0,2,1
75860,1,3,265620,265621,265624,1,4,0
75861,4,1,265624,265624,265625,0,1,0
75862,2,1,265626,265626,265627,0,1,1
75863,2,2,265628,265628,265630,0,2,1
75864,4,2,265632,265632,265634,0,2,2
75865,4,2,265636,265636,265638,0,2,2
75866,2,1,265638,265638,265639,0,1,0
75867,1,3,265639,265639,265642,0,3,0
75868,1,3,265640,265642,265645,2,5,0
75869,5,3,265645,265645,265648,0,3,0
75870,1,3,265646,265648,265651,2,5,0
75871,6,2,265652,265652,265654,0,2,1
75872,4,1,265656,265656,265657,0,1,2
75873,5,2,265661,265661,265663,0,2,4
75874,4,2,265665,265665,265667,0,2,2
75875,2,2,265667,265667,265669,0,2,0
75876,1,1,265668,265669,265670,1,2,0
75877,4,2,265672,265672,265674,0,2,2
75878,5,2,265677,265677,265679,0,2,3
75879,1,1,265678,265679,265680,1,2,0
75880,3,2,265681,265681,265683,0,2,1
75881,3,3,265684,265684,265687,0,3,1
75882,4,1,265688,265688,265689,0,1,1
75883,1,1,265689,265689,265690,0,1,0
75884,2,2,265691,265691,265693,0,2,1
75885,3,2,265694,265694,265696,0,2,1
75886,2,3,265696,265696,265699,0,3,0
75887,2,1,265698,265699,265700,1,2,0
75888,5,1,265703,265703,265704,0,1,3
75889,3,1,265706,265706,265707,0,1,2
75890,5,1,265711,265711,265712,0,1,4
75891,5,3,265716,265716,265719,0,3,4
75892,2,3,265718,265719,265722,1,4,0
75893,5,2,265723,265723,265725,0,2,1
75894,3,2,265726,265726,265728,0,2,1
75895,6,2,265732,265732,265734,0,2,4
75896,2,1,265734,265734,265735,0,1,0
75897,6,1,265740,265740,265741,0,1,5
75898,2,2,265742,265742,265744,0,2,1
75899,1,2,265743,265744,265746,1,3,0
75900,6,3,265749,265749,265752,0,3,3
75901,5,1,265754,265754,265755,0,1,2
75902,2,2,265756,265756,265758,0,2,1
75903,2,2,265758,265758,265760,0,2,0
75904,2,2,265760,265760,265762,0,2,0
75905,3,2,265763,265763,265765,0,2,1
75906,5,1,265768,265768,265769,0,1,3
75907,5,2,265773,265773,265775,0,2,4
75908,3,1,265776,265776,265777,0,1,1
75909,3,1,265779,265779,265780,0,1,2
75910,1,3,265780,265780,265783,0,3,0
75911,2,3,265782,265783,265786,1,4,0
75912,1,2,265783,265786,265788,3,5,0
75913,2,3,265785,265788,265791,3,6,0
75914,1,1,265786,265791,265792,5,6,0
75915,5,3,265791,265792,265795,1,4,0
75916,6,2,265797,265797,265799,0,2,2
75917,5,1,265802,265802,265803,0,1,3
75918,4,1,265806,265806,265807,0,1,3
75919,5,1,265811,265811,265812,0,1,4
75920,3,1,265814,265814,265815,0,1,2
75921,2,1,265816,265816,265817,0,1,1
75922,6,1,265822,265822,265823,0,1,5
75923,1,2,265823,265823,265825,0,2,0
75924,2,1,265825,265825,265826,0,1,0
75925,2,2,265827,265827,265829,0,2,1
75926,2,1,265829,265829,265830,0,1,0
75927,3,2,265832,265832,265834,0,2,2
75928,1,2,265833,265834,265836,1,3,0
75929,2,1,265835,265836,265837,1,2,0
75930,2,3,265837,265837,265840,0,3,0
75931,5,1,265842,265842,265843,0,1,2
75932,5,1,265847,265847,265848,0,1,4
75933,6,1,265853,265853,265854,0,1,5
75934,4,1,265857,265857,265858,0,1,3
75935,1,2,265858,265858,265860,0,2,0
75936,6,3,265864,265864,265867,0,3,4
75937,3,2,265867,265867,265869,0,2,0
75938,4,2,265871,265871,265873,0,2,2
75939,3,2,265874,265874,265876,0,2,1
75940,6,1,265880,265880,265881,0,1,4
75941,5,1,265885,265885,265886,0,1,4
75942,5,2,265890,265890,265892,0,2,4
75943,4,2,265894,265894,265896,0,2,2
75944,1,2,265895,265896,265898,1,3,0
75945,6,1,265901,265901,265902,0,1,3
75946,1,1,265902,265902,265903,0,1,0
75947,3,2,265905,265905,265907,0,2,2
75948,1,1,265906,265907,265908,1,2,0
75949,6,3,265912,265912,265915,0,3,4
75950,1,1,265913,265915,265916,2,3,0
75951,1,3,265914,265916,265919,2,5,0
75952,1,1,265915,265919,265920,4,5,0
75953,1,2,265916,265920,265922,4,6,0
75954,3,3,265919,265922,265925,3,6,0
75955,2,2,265921,265925,265927,4,6,0
75956,5,2,265926,265927,265929,1,3,0
75957,1,3,265927,265929,265932,2,5,0
75958,3,2,265930,265932,265934,2,4,0
75959,2,1,265932,265934,265935,2,3,0
75960,6,2,265938,265938,265940,0,2,3
75961,2,2,265940,265940,265942,0,2,0
75962,5,2,265945,265945,265947,0,2,3
75963,5,2,265950,265950,265952,0,2,3
75964,6,3,265956,265956,265959,0,3,4
75965,3,2,265959,265959,265961,0,2,0
75966,2,2,265961,265961,265963,0,2,0
75967,6,2,265967,265967,265969,0,2,4
75968,2,3,265969,265969,265972,0,3,0
75969,3,1,265972,265972,265973,0,1,0
75970,6,1,265978,265978,265979,0,1,5
75971,1,1,265979,265979,265980,0,1,0
75972,5,2,265984,265984,265986,0,2,4
75973,4,3,265988,265988,265991,0,3,2
75974,1,2,265989,265991,265993,2,4,0
75975,3,1,265992,265993,265994,1,2,0
75976,5,1,265997,265997,265998,0,1,3
75977,3,1,266000,266000,266001,0,1,2
75978,2,1,266002,266002,266003,0,1,1
75979,1,2,266003,266003,266005,0,2,0
75980,4,2,266007,266007,266009,0,2,2
75981,4,1,266011,266011,266012,0,1,2
75982,1,1,266012,266012,266013,0,1,0
75983,5,2,266017,266017,266019,0,2,4
75984,2,1,266019,266019,266020,0,1,0
75985,2,3,266021,266021,266024,0,3,1
75986,4,1,266025,266025,266026,0,1,1
75987,2,1,266027,266027,266028,0,1,1
75988,2,2,266029,266029,266031,0,2,1
75989,6,2,266035,266035,266037,0,2,4
75990,3,3,266038,266038,266041,0,3,1
75991,3,1,266041,266041,266042,0,1,0
75992,6,3,266047,266047,266050,0,3,5
75993,3,3,266050,266050,266053,0,3,0
75994,3,3,266053,266053,266056,0,3,0
75995,5,1,266058,266058,266059,0,1,2
75996,5,3,266063,266063,266066,0,3,4
75997,3,2,266066,266066,266068,0,2,0
75998,1,2,266067,266068,266070,1,3,0
75999,4,3,266071,266071,266074,0,3,1
76000,1,1,266072,266074,266075,2,3,0
76001,6,2,266078,266078,266080,0,2,3
76002,5,2,266083,266083,266085,0,2,3
76003,6,1,266089,266089,266090,0,1,4
76004,6,3,266095,266095,266098,0,3,5
76005,6,2,266101,266101,266103,0,2,3
76006,3,3,266104,266104,266107,0,3,1
76007,2,1,266106,266107,266108,1,2,0
76008,6,3,266112,266112,266115,0,3,4
76009,6,3,266118,266118,266121,0,3,3
76010,6,1,266124,266124,266125,0,1,3
76011,2,1,266126,266126,266127,0,1,1
76012,6,1,266132,266132,266133,0,1,5
76013,2,3,266134,266134,266137,0,3,1
76014,1,2,266135,266137,266139,2,4,0
76015,3,3,266138,266139,266142,1,4,0
76016,4,1,266142,266142,266143,0,1,0
76017,5,2,266147,266147,266149,0,2,4
76018,2,3,266149,266149,266152,0,3,0
76019,2,2,266151,266152,266154,1,3,0
76020,1,1,266152,266154,266155,2,3,0
76021,6,1,266158,266158,266159,0,1,3
76022,2,1,266160,266160,266161,0,1,1
76023,6,1,266166,266166,266167,0,1,5
76024,3,3,266169,266169,266172,0,3,2
76025,1,1,266170,266172,266173,2,3,0
76026,6,1,266176,266176,266177,0,1,3
76027,6,3,266182,266182,266185,0,3,5
76028,4,3,266186,266186,266189,0,3,1
76029,1,2,266187,266189,266191,2,4,0
76030,1,3,266188,266191,266194,3,6,0
76031,1,1,266189,266194,266195,5,6,0
76032,6,2,266195,266195,266197,0,2,0
76033,2,1,266197,266197,266198,0,1,0
76034,2,1,266199,266199,266200,0,1,1
76035,6,3,266205,266205,266208,0,3,5
76036,3,3,266208,266208,266211,0,3,0
76037,4,2,266212,266212,266214,0,2,1
76038,5,1,266217,266217,266218,0,1,3
76039,6,1,266223,266223,266224,0,1,5
76040,1,2,266224,266224,266226,0,2,0
76041,4,3,266228,266228,266231,0,3,2
76042,4,3,266232,266232,266235,0,3,1
76043,4,3,266236,266236,266239,0,3,1
76044,1,3,266237,266239,266242,2,5,0
76045,4,3,266241,266242,266245,1,4,0
76046,5,2,266246,266246,266248,0,2,1
76047,6,2,266252,266252,266254,0,2,4
76048,2,3,266254,266254,266257,0,3,0
76049,2,2,266256,266257,266259,1,3,0
76050,6,2,266262,266262,266264,0,2,3
76051,4,1,266266,266266,266267,0,1,2
76052,5,2,266271,266271,266273,0,2,4
76053,2,3,266273,266273,266276,0,3,0
76054,1,2,266274,266276,266278,2,4,0
76055,6,1,266280,266280,266281,0,1,2
76056,2,1,266282,266282,266283,0,1,1
76057,2,3,266284,266284,266287,0,3,1
76058,6,1,266290,266290,266291,0,1,3
76059,3,1,266293,266293,266294,0,1,2
76060,4,1,266297,266297,266298,0,1,3
76061,5,1,266302,266302,266303,0,1,4
76062,1,2,266303,266303,266305,0,2,0
76063,1,1,266304,266305,266306,1,2,0
76064,2,1,266306,266306,266307,0,1,0
76065,4,2,266310,266310,266312,0,2,3
76066,5,1,266315,266315,266316,0,1,3
76067,4,1,266319,266319,266320,0,1,3
76068,5,2,266324,266324,266326,0,2,4
76069,1,3,266325,266326,266329,1,4,0
76070,6,3,266331,266331,266334,0,3,2
76071,5,3,266336,266336,266339,0,3,2
76072,2,2,266338,266339,266341,1,3,0
76073,5,3,266343,266343,266346,0,3,2
76074,6,3,266349,266349,266352,0,3,3
76075,1,1,266350,266352,266353,2,3,0
76076,5,1,266355,266355,266356,0,1,2
76077,1,1,266356,266356,266357,0,1,0
76078,3,1,266359,266359,266360,0,1,2
76079,6,2,266365,266365,266367,0,2,5
76080,4,3,266369,266369,266372,0,3,2
76081,5,2,266374,266374,266376,0,2,2
76082,5,1,266379,266379,266380,0,1,3
76083,1,3,266380,266380,266383,0,3,0
76084,3,2,266383,266383,266385,0,2,0
76085,1,2,266384,266385,266387,1,3,0
76086,3,3,266387,266387,266390,0,3,0
76087,1,3,266388,266390,266393,2,5,0
76088,3,1,266391,266393,266394,2,3,0
76089,6,3,266397,266397,266400,0,3,3
76090,4,3,266401,266401,266404,0,3,1
76091,1,2,266402,266404,266406,2,4,0
76092,4,2,266406,266406,266408,0,2,0
76093,2,1,266408,266408,266409,0,1,0
76094,3,2,266411,266411,266413,0,2,2
76095,1,2,266412,266413,266415,1,3,0
76096,2,3,266414,266415,266418,1,4,0
76097,3,2,266417,266418,266420,1,3,0
76098,3,2,266420,266420,266422,0,2,0
76099,4,3,266424,266424,266427,0,3,2
76100,4,1,266428,266428,266429,0,1,1
76101,2,3,266430,266430,266433,0,3,1
76102,2,3,266432,266433,266436,1,4,0
76103,3,2,266435,266436,266438,1,3,0
76104,2,3,266437,266438,266441,1,4,0
76105,4,2,266441,266441,266443,0,2,0
76106,6,1,266447,266447,266448,0,1,4
76107,1,3,266448,266448,266451,0,3,0
76108,1,2,266449,266451,266453,2,4,0
76109,4,3,266453,266453,266456,0,3,0
76110,1,3,266454,266456,266459,2,5,0
76111,3,2,266457,266459,266461,2,4,0
76112,5,2,266462,266462,266464,0,2,1
76113,2,3,266464,266464,266467,0,3,0
76114,1,2,266465,266467,266469,2,4,0
76115,5,1,266470,266470,266471,0,1,1
76116,2,2,266472,266472,266474,0,2,1
76117,4,3,266476,266476,266479,0,3,2
76118,6,1,266482,266482,266483,0,1,3
76119,5,1,266487,266487,266488,0,1,4
76120,1,2,266488,266488,266490,0,2,0
76121,3,2,266491,266491,266493,0,2,1
76122,1,2,266492,266493,266495,1,3,0
76123,6,3,266498,266498,266501,0,3,3
76124,5,2,266503,266503,266505,0,2,2
76125,3,2,266506,266506,266508,0,2,1
76126,5,2,266511,266511,266513,0,2,3
76127,3,1,266514,266514,266515,0,1,1
76128,2,3,266516,266516,266519,0,3,1
76129,2,2,266518,266519,266521,1,3,0
76130,4,2,266522,266522,266524,0,2,1
76131,1,2,266523,266524,266526,1,3,0
76132,3,2,266526,266526,266528,0,2,0
76133,3,2,266529,266529,266531,0,2,1
76134,6,2,266535,266535,266537,0,2,4
76135,1,1,266536,266537,266538,1,2,0
76136,4,2,266540,266540,266542,0,2,2
76137,6,2,266546,266546,266548,0,2,4
76138,1,1,266547,266548,266549,1,2,0
76139,4,2,266551,266551,266553,0,2,2
76140,3,3,266554,266554,266557,0,3,1
76141,4,3,266558,266558,266561,0,3,1
76142,1,2,266559,266561,266563,2,4,0
76143,4,1,266563,266563,266564,0,1,0
76144,3,1,266566,266566,266567,0,1,2
76145,2,1,266568,266568,266569,0,1,1
76146,1,2,266569,266569,266571,0,2,0
76147,5,1,266574,266574,266575,0,1,3
76148,5,1,266579,266579,266580,0,1,4
76149,4,2,266583,266583,266585,0,2,3
76150,2,2,266585,266585,266587,0,2,0
76151,5,2,266590,266590,266592,0,2,3
76152,6,3,266596,266596,266599,0,3,4
76153,4,2,266600,266600,266602,0,2,1
76154,3,1,266603,266603,266604,0,1,1
76155,1,2,266604,266604,266606,0,2,0
76156,2,1,266606,266606,266607,0,1,0
76157,6,3,266612,266612,266615,0,3,5
76158,3,2,266615,266615,266617,0,2,0
76159,4,3,266619,266619,266622,0,3,2
76160,4,1,266623,266623,266624,0,1,1
76161,4,1,266627,266627,266628,0,1,3
76162,1,3,266628,266628,266631,0,3,0
76163,1,3,266629,266631,266634,2,5,0
76164,5,1,266634,266634,266635,0,1,0
76165,6,3,266640,266640,266643,0,3,5
76166,5,2,266645,266645,266647,0,2,2
76167,3,2,266648,266648,266650,0,2,1
76168,4,3,266652,266652,266655,0,3,2
76169,3,1,266655,266655,266656,0,1,0
76170,3,2,266658,266658,266660,0,2,2
76171,5,3,266663,266663,266666,0,3,3
76172,3,3,266666,266666,266669,0,3,0
76173,4,1,266670,266670,266671,0,1,1
76174,2,2,266672,266672,266674,0,2,1
76175,4,2,266676,266676,266678,0,2,2
76176,2,1,266678,266678,266679,0,1,0
76177,5,2,266683,266683,266685,0,2,4
76178,3,1,266686,266686,266687,0,1,1
76179,5,1,266691,266691,266692,0,1,4
76180,1,3,266692,266692,266695,0,3,0
76181,6,1,266698,266698,266699,0,1,3
76182,3,1,266701,266701,266702,0,1,2
76183,6,2,266707,266707,266709,0,2,5
76184,4,2,266711,266711,266713,0,2,2
76185,5,3,266716,266716,266719,0,3,3
76186,4,1,266720,266720,266721,0,1,1
76187,5,3,266725,266725,266728,0,3,4
76188,6,3,266731,266731,266734,0,3,3
76189,2,1,266733,266734,266735,1,2,0
76190,5,3,266738,266738,266741,0,3,3
76191,1,1,266739,266741,266742,2,3,0
76192,5,3,266744,266744,266747,0,3,2
76193,1,2,266745,266747,266749,2,4,0
76194,1,1,266746,266749,266750,3,4,0
76195,6,1,266752,266752,266753,0,1,2
76196,2,1,266754,266754,266755,0,1,1
76197,5,1,266759,266759,266760,0,1,4
76198,2,3,266761,266761,266764,0,3,1
76199,4,2,266765,266765,266767,0,2,1
76200,4,3,266769,266769,266772,0,3,2
76201,1,2,266770,266772,266774,2,4,0
76202,2,1,266772,266774,266775,2,3,0
76203,3,2,266775,266775,266777,0,2,0
76204,4,3,266779,266779,266782,0,3,2
76205,2,2,266781,266782,266784,1,3,0
76206,2,2,266783,266784,266786,1,3,0
76207,1,3,266784,266786,266789,2,5,0
76208,2,2,266786,266789,266791,3,5,0
76209,4,2,266790,266791,266793,1,3,0
76210,2,1,266792,266793,266794,1,2,0
76211,2,1,266794,266794,266795,0,1,0
76212,6,2,266800,266800,266802,0,2,5
76213,2,1,266802,266802,266803,0,1,0
76214,1,3,266803,266803,266806,0,3,0
76215,2,3,266805,266806,266809,1,4,0
76216,1,3,266806,266809,266812,3,6,0
76217,1,2,266807,266812,266814,5,7,0
76218,4,3,266811,266814,266817,3,6,0
76219,1,3,266812,266817,266820,5,8,0
76220,3,3,266815,266820,266823,5,8,0
76221,2,2,266817,266823,266825,6,8,0
76222,1,3,266818,266825,266828,7,10,0
76223,1,2,266819,266828,266830,9,11,0
76224,4,2,266823,266830,266832,7,9,0
76225,2,2,266825,266832,266834,7,9,0
76226,3,3,266828,266834,266837,6,9,0
76227,1,2,266829,266837,266839,8,10,0
76228,4,2,266833,266839,266841,6,8,0
76229,1,2,266834,266841,266843,7,9,0
76230,6,2,266840,266843,266845,3,5,0
76231,1,2,266841,266845,266847,4,6,0
76232,2,2,266843,266847,266849,4,6,0
76233,1,2,266844,266849,266851,5,7,0
76234,1,3,266845,266851,266854,6,9,0
76235,1,1,266846,266854,266855,8,9,0
76236,1,3,266847,266855,266858,8,11,0
76237,6,2,266853,266858,266860,5,7,0
76238,1,2,266854,266860,266862,6,8,0
76239,3,2,266857,266862,266864,5,7,0
76240,4,2,266861,266864,266866,3,5,0
76241,6,2,266867,266867,266869,0,2,1
76242,5,1,266872,266872,266873,0,1,3
76243,1,3,266873,266873,266876,0,3,0
76244,1,2,266874,266876,266878,2,4,0
76245,2,1,266876,266878,266879,2,3,0
76246,4,1,266880,266880,266881,0,1,1
76247,6,2,266886,266886,266888,0,2,5
76248,4,3,266890,266890,266893,0,3,2
76249,4,3,266894,266894,266897,0,3,1
76250,1,3,266895,266897,266900,2,5,0
76251,6,1,266901,266901,266902,0,1,1
76252,1,3,266902,266902,266905,0,3,0
76253,3,2,266905,266905,266907,0,2,0
76254,6,2,266911,266911,266913,0,2,4
76255,4,2,266915,266915,266917,0,2,2
76256,2,2,266917,266917,266919,0,2,0
76257,4,2,266921,266921,266923,0,2,2
76258,6,3,266927,266927,266930,0,3,4
76259,1,1,266928,266930,266931,2,3,0
76260,5,1,266933,266933,266934,0,1,2
76261,5,2,266938,266938,266940,0,2,4
76262,5,3,266943,266943,266946,0,3,3
76263,1,1,266944,266946,266947,2,3,0
76264,3,3,266947,266947,266950,0,3,0
76265,5,1,266952,266952,266953,0,1,2
76266,2,3,266954,266954,266957,0,3,1
76267,1,1,266955,266957,266958,2,3,0
76268,2,2,266957,266958,266960,1,3,0
76269,4,3,266961,266961,266964,0,3,1
76270,5,1,266966,266966,266967,0,1,2
76271,3,3,266969,266969,266972,0,3,2
76272,6,2,266975,266975,266977,0,2,3
76273,4,2,266979,266979,266981,0,2,2
76274,2,1,266981,266981,266982,0,1,0
76275,3,1,266984,266984,266985,0,1,2
76276,1,3,266985,266985,266988,0,3,0
76277,4,1,266989,266989,266990,0,1,1
76278,2,1,266991,266991,266992,0,1,1
76279,1,3,266992,266992,266995,0,3,0
76280,4,3,266996,266996,266999,0,3,1
76281,4,3,267000,267000,267003,0,3,1
76282,3,2,267003,267003,267005,0,2,0
76283,1,3,267004,267005,267008,1,4,0
76284,3,1,267007,267008,267009,1,2,0
76285,5,2,267012,267012,267014,0,2,3
76286,2,1,267014,267014,267015,0,1,0
76287,3,2,267017,267017,267019,0,2,2
76288,6,2,267023,267023,267025,0,2,4
76289,4,3,267027,267027,267030,0,3,2
76290,5,2,267032,267032,267034,0,2,2
76291,6,3,267038,267038,267041,0,3,4
76292,3,2,267041,267041,267043,0,2,0
76293,5,2,267046,267046,267048,0,2,3
76294,5,3,267051,267051,267054,0,3,3
76295,3,3,267054,267054,267057,0,3,0
76296,5,2,267059,267059,267061,0,2,2
76297,4,2,267063,267063,267065,0,2,2
76298,4,1,267067,267067,267068,0,1,2
76299,2,1,267069,267069,267070,0,1,1
76300,6,2,267075,267075,267077,0,2,5
76301,4,3,267079,267079,267082,0,3,2
76302,5,3,267084,267084,267087,0,3,2
76303,5,2,267089,267089,267091,0,2,2
76304,6,3,267095,267095,267098,0,3,4
76305,5,1,267100,267100,267101,0,1,2
76306,4,2,267104,267104,267106,0,2,3
76307,3,2,267107,267107,267109,0,2,1
76308,2,3,267109,267109,267112,0,3,0
76309,5,2,267114,267114,267116,0,2,2
76310,6,3,267120,267120,267123,0,3,4
76311,1,2,267121,267123,267125,2,4,0
76312,2,3,267123,267125,267128,2,5,0
76313,5,1,267128,267128,267129,0,1,0
76314,6,1,267134,267134,267135,0,1,5
76315,3,1,267137,267137,267138,0,1,2
76316,4,3,267141,267141,267144,0,3,3
76317,4,3,267145,267145,267148,0,3,1
76318,3,3,267148,267148,267151,0,3,0
76319,2,2,267150,267151,267153,1,3,0
76320,1,2,267151,267153,267155,2,4,0
76321,6,1,267157,267157,267158,0,1,2
76322,5,2,267162,267162,267164,0,2,4
76323,5,2,267167,267167,267169,0,2,3
76324,4,2,267171,267171,267173,0,2,2
76325,1,3,267172,267173,267176,1,4,0
76326,1,1,267173,267176,267177,3,4,0
76327,5,1,267178,267178,267179,0,1,1
76328,4,2,267182,267182,267184,0,2,3
76329,2,3,267184,267184,267187,0,3,0
76330,6,2,267190,267190,267192,0,2,3
76331,1,2,267191,267192,267194,1,3,0
76332,3,2,267194,267194,267196,0,2,0
76333,1,2,267195,267196,267198,1,3,0
76334,5,1,267200,267200,267201,0,1,2
76335,6,1,267206,267206,267207,0,1,5
76336,3,3,267209,267209,267212,0,3,2
76337,1,2,267210,267212,267214,2,4,0
76338,2,2,267212,267214,267216,2,4,0
76339,5,2,267217,267217,267219,0,2,1
76340,1,3,267218,267219,267222,1,4,0
76341,6,2,267224,267224,267226,0,2,2
76342,1,3,267225,267226,267229,1,4,0
76343,3,1,267228,267229,267230,1,2,0
76344,6,2,267234,267234,267236,0,2,4
76345,2,2,267236,267236,267238,0,2,0
76346,3,1,267239,267239,267240,0,1,1
76347,5,2,267244,267244,267246,0,2,4
76348,4,1,267248,267248,267249,0,1,2
76349,3,1,267251,267251,267252,0,1,2
76350,3,3,267254,267254,267257,0,3,2
76351,4,2,267258,267258,267260,0,2,1
76352,3,2,267261,267261,267263,0,2,1
76353,2,2,267263,267263,267265,0,2,0
76354,4,1,267267,267267,267268,0,1,2
76355,2,3,267269,267269,267272,0,3,1
76356,6,2,267275,267275,267277,0,2,3
76357,6,2,267281,267281,267283,0,2,4
76358,3,3,267284,267284,267287,0,3,1
76359,6,3,267290,267290,267293,0,3,3
76360,3,1,267293,267293,267294,0,1,0
76361,3,3,267296,267296,267299,0,3,2
76362,5,1,267301,267301,267302,0,1,2
76363,4,2,267305,267305,267307,0,2,3
76364,6,3,267311,267311,267314,0,3,4
76365,1,1,267312,267314,267315,2,3,0
76366,4,3,267316,267316,267319,0,3,1
76367,2,2,267318,267319,267321,1,3,0
76368,4,1,267322,267322,267323,0,1,1
76369,1,1,267323,267323,267324,0,1,0
76370,3,2,267326,267326,267328,0,2,2
76371,3,3,267329,267329,267332,0,3,1
76372,4,3,267333,267333,267336,0,3,1
76373,5,1,267338,267338,267339,0,1,2
76374,6,2,267344,267344,267346,0,2,5
76375,3,1,267347,267347,267348,0,1,1
76376,1,2,267348,267348,267350,0,2,0
76377,1,2,267349,267350,267352,1,3,0
76378,4,1,267353,267353,267354,0,1,1
76379,1,1,267354,267354,267355,0,1,0
76380,6,2,267360,267360,267362,0,2,5
76381,3,1,267363,267363,267364,0,1,1
76382,1,1,267364,267364,267365,0,1,0
76383,6,3,267370,267370,267373,0,3,5
76384,1,2,267371,267373,267375,2,4,0
76385,1,2,267372,267375,267377,3,5,0
76386,6,2,267378,267378,267380,0,2,1
76387,1,1,267379,267380,267381,1,2,0
76388,5,1,267384,267384,267385,0,1,3
76389,2,2,267386,267386,267388,0,2,1
76390,4,1,267390,267390,267391,0,1,2
76391,4,3,267394,267394,267397,0,3,3
76392,1,1,267395,267397,267398,2,3,0
76393,5,2,267400,267400,267402,0,2,2
76394,5,1,267405,267405,267406,0,1,3
76395,4,2,267409,267409,267411,0,2,3
76396,2,2,267411,267411,267413,0,2,0
76397,2,2,267413,267413,267415,0,2,0
76398,6,1,267419,267419,267420,0,1,4
76399,2,1,267421,267421,267422,0,1,1
76400,3,1,267424,267424,267425,0,1,2
76401,1,1,267425,267425,267426,0,1,0
76402,6,1,267431,267431,267432,0,1,5
76403,5,2,267436,267436,267438,0,2,4
76404,6,2,267442,267442,267444,0,2,4
76405,2,3,267444,267444,267447,0,3,0
76406,5,2,267449,267449,267451,0,2,2
76407,6,2,267455,267455,267457,0,2,4
76408,1,2,267456,267457,267459,1,3,0
76409,5,1,267461,267461,267462,0,1,2
76410,4,3,267465,267465,267468,0,3,3
76411,5,3,267470,267470,267473,0,3,2
76412,2,2,267472,267473,267475,1,3,0
76413,6,1,267478,267478,267479,0,1,3
76414,3,1,267481,267481,267482,0,1,2
76415,4,2,267485,267485,267487,0,2,3
76416,5,3,267490,267490,267493,0,3,3
76417,6,3,267496,267496,267499,0,3,3
76418,2,2,267498,267499,267501,1,3,0
76419,5,1,267503,267503,267504,0,1,2
76420,5,1,267508,267508,267509,0,1,4
76421,6,3,267514,267514,267517,0,3,5
76422,1,2,267515,267517,267519,2,4,0
76423,1,1,267516,267519,267520,3,4,0
76424,6,2,267522,267522,267524,0,2,2
76425,6,2,267528,267528,267530,0,2,4
76426,1,2,267529,267530,267532,1,3,0
76427,2,3,267531,267532,267535,1,4,0
76428,4,3,267535,267535,267538,0,3,0
76429,2,3,267537,267538,267541,1,4,0
76430,4,3,267541,267541,267544,0,3,0
76431,3,1,267544,267544,267545,0,1,0
76432,5,3,267549,267549,267552,0,3,4
76433,5,1,267554,267554,267555,0,1,2
76434,6,3,267560,267560,267563,0,3,5
76435,3,1,267563,267563,267564,0,1,0
76436,2,1,267565,267565,267566,0,1,1
76437,4,2,267569,267569,267571,0,2,3
76438,1,3,267570,267571,267574,1,4,0
76439,3,2,267573,267574,267576,1,3,0
76440,4,1,267577,267577,267578,0,1,1
76441,6,1,267583,267583,267584,0,1,5
76442,4,1,267587,267587,267588,0,1,3
76443,2,2,267589,267589,267591,0,2,1
76444,5,1,267594,267594,267595,0,1,3
76445,2,2,267596,267596,267598,0,2,1
76446,5,1,267601,267601,267602,0,1,3
76447,6,3,267607,267607,267610,0,3,5
76448,3,3,267610,267610,267613,0,3,0
76449,5,1,267615,267615,267616,0,1,2
76450,6,2,267621,267621,267623,0,2,5
76451,6,1,267627,267627,267628,0,1,4
76452,1,3,267628,267628,267631,0,3,0
76453,4,1,267632,267632,267633,0,1,1
76454,4,3,267636,267636,267639,0,3,3
76455,5,2,267641,267641,267643,0,2,2
76456,2,2,267643,267643,267645,0,2,0
76457,6,1,267649,267649,267650,0,1,4
76458,5,2,267654,267654,267656,0,2,4
76459,5,3,267659,267659,267662,0,3,3
76460,6,2,267665,267665,267667,0,2,3
76461,1,2,267666,267667,267669,1,3,0
76462,5,1,267671,267671,267672,0,1,2
76463,4,1,267675,267675,267676,0,1,3
76464,2,1,267677,267677,267678,0,1,1
76465,6,2,267683,267683,267685,0,2,5
76466,1,1,267684,267685,267686,1,2,0
76467,3,3,267687,267687,267690,0,3,1
76468,2,1,267689,267690,267691,1,2,0
76469,4,1,267693,267693,267694,0,1,2
76470,6,2,267699,267699,267701,0,2,5
76471,4,2,267703,267703,267705,0,2,2
76472,4,3,267707,267707,267710,0,3,2
76473,3,3,267710,267710,267713,0,3,0
76474,5,2,267715,267715,267717,0,2,2
76475,5,1,267720,267720,267721,0,1,3
76476,3,3,267723,267723,267726,0,3,2
76477,4,2,267727,267727,267729,0,2,1
76478,5,1,267732,267732,267733,0,1,3
76479,1,3,267733,267733,267736,0,3,0
76480,1,3,267734,267736,267739,2,5,0
76481,5,1,267739,267739,267740,0,1,0
76482,3,3,267742,267742,267745,0,3,2
76483,1,2,267743,267745,267747,2,4,0
76484,2,3,267745,267747,267750,2,5,0
76485,6,3,267751,267751,267754,0,3,1
76486,5,3,267756,267756,267759,0,3,2
76487,4,3,267760,267760,267763,0,3,1
76488,5,2,267765,267765,267767,0,2,2
76489,2,3,267767,267767,267770,0,3,0
76490,6,3,267773,267773,267776,0,3,3
76491,2,3,267775,267776,267779,1,4,0
76492,4,3,267779,267779,267782,0,3,0
76493,2,2,267781,267782,267784,1,3,0
76494,2,3,267783,267784,267787,1,4,0
76495,6,1,267789,267789,267790,0,1,2
76496,2,1,267791,267791,267792,0,1,1
76497,5,3,267796,267796,267799,0,3,4
76498,2,2,267798,267799,267801,1,3,0
76499,2,3,267800,267801,267804,1,4,0
76500,5,1,267805,267805,267806,0,1,1
76501,2,1,267807,267807,267808,0,1,1
76502,2,3,267809,267809,267812,0,3,1
76503,2,1,267811,267812,267813,1,2,0
76504,4,1,267815,267815,267816,0,1,2
76505,3,1,267818,267818,267819,0,1,2
76506,4,3,267822,267822,267825,0,3,3
76507,6,1,267828,267828,267829,0,1,3
76508,3,1,267831,267831,267832,0,1,2
76509,4,1,267835,267835,267836,0,1,3
76510,3,2,267838,267838,267840,0,2,2
76511,3,1,267841,267841,267842,0,1,1
76512,2,1,267843,267843,267844,0,1,1
76513,5,3,267848,267848,267851,0,3,4
76514,1,3,267849,267851,267854,2,5,0
76515,6,1,267855,267855,267856,0,1,1
76516,4,1,267859,267859,267860,0,1,3
76517,4,3,267863,267863,267866,0,3,3
76518,2,1,267865,267866,267867,1,2,0
76519,3,2,267868,267868,267870,0,2,1
76520,6,1,267874,267874,267875,0,1,4
76521,5,2,267879,267879,267881,0,2,4
76522,2,1,267881,267881,267882,0,1,0
76523,5,3,267886,267886,267889,0,3,4
76524,4,2,267890,267890,267892,0,2,1
76525,3,1,267893,267893,267894,0,1,1
76526,4,2,267897,267897,267899,0,2,3
76527,2,1,267899,267899,267900,0,1,0
76528,5,1,267904,267904,267905,0,1,4
76529,1,3,267905,267905,267908,0,3,0
76530,4,3,267909,267909,267912,0,3,1
76531,2,3,267911,267912,267915,1,4,0
76532,5,3,267916,267916,267919,0,3,1
76533,3,3,267919,267919,267922,0,3,0
76534,4,2,267923,267923,267925,0,2,1
76535,5,1,267928,267928,267929,0,1,3
76536,6,3,267934,267934,267937,0,3,5
76537,1,3,267935,267937,267940,2,5,0
76538,1,3,267936,267940,267943,4,7,0
76539,2,3,267938,267943,267946,5,8,0
76540,1,1,267939,267946,267947,7,8,0
76541,3,3,267942,267947,267950,5,8,0
76542,2,3,267944,267950,267953,6,9,0
76543,3,1,267947,267953,267954,6,7,0
76544,3,3,267950,267954,267957,4,7,0
76545,5,3,267955,267957,267960,2,5,0
76546,6,2,267961,267961,267963,0,2,1
76547,6,1,267967,267967,267968,0,1,4
76548,1,3,267968,267968,267971,0,3,0
76549,6,1,267974,267974,267975,0,1,3
76550,6,1,267980,267980,267981,0,1,5
76551,5,1,267985,267985,267986,0,1,4
76552,4,1,267989,267989,267990,0,1,3
76553,1,3,267990,267990,267993,0,3,0
76554,2,3,267992,267993,267996,1,4,0
76555,3,1,267995,267996,267997,1,2,0
76556,4,1,267999,267999,268000,0,1,2
76557,6,2,268005,268005,268007,0,2,5
76558,2,1,268007,268007,268008,0,1,0
76559,1,2,268008,268008,268010,0,2,0
76560,4,3,268012,268012,268015,0,3,2
76561,2,1,268014,268015,268016,1,2,0
76562,5,3,268019,268019,268022,0,3,3
76563,3,3,268022,268022,268025,0,3,0
76564,1,3,268023,268025,268028,2,5,0
76565,1,3,268024,268028,268031,4,7,0
76566,4,1,268028,268031,268032,3,4,0
76567,6,1,268034,268034,268035,0,1,2
76568,3,3,268037,268037,268040,0,3,2
76569,2,1,268039,268040,268041,1,2,0
76570,3,1,268042,268042,268043,0,1,1
76571,5,3,268047,268047,268050,0,3,4
76572,5,2,268052,268052,268054,0,2,2
76573,2,2,268054,268054,268056,0,2,0
76574,2,2,268056,268056,268058,0,2,0
76575,6,2,268062,268062,268064,0,2,4
76576,3,1,268065,268065,268066,0,1,1
76577,1,2,268066,268066,268068,0,2,0
76578,6,2,268072,268072,268074,0,2,4
76579,3,1,268075,268075,268076,0,1,1
76580,4,1,268079,268079,268080,0,1,3
76581,5,2,268084,268084,268086,0,2,4
76582,3,3,268087,268087,268090,0,3,1
76583,4,3,268091,268091,268094,0,3,1
76584,6,1,268097,268097,268098,0,1,3
76585,3,1,268100,268100,268101,0,1,2
76586,6,1,268106,268106,268107,0,1,5
76587,2,1,268108,268108,268109,0,1,1
76588,5,3,268113,268113,268116,0,3,4
76589,3,1,268116,268116,268117,0,1,0
76590,5,2,268121,268121,268123,0,2,4
76591,6,1,268127,268127,268128,0,1,4
76592,5,1,268132,268132,268133,0,1,4
76593,2,1,268134,268134,268135,0,1,1
76594,3,1,268137,268137,268138,0,1,2
76595,3,1,268140,268140,268141,0,1,2
76596,1,3,268141,268141,268144,0,3,0
76597,2,1,268143,268144,268145,1,2,0
76598,4,3,268147,268147,268150,0,3,2
76599,6,3,268153,268153,268156,0,3,3
76600,5,3,268158,268158,268161,0,3,2
76601,1,1,268159,268161,268162,2,3,0
76602,6,3,268165,268165,268168,0,3,3
76603,1,2,268166,268168,268170,2,4,0
76604,6,1,268172,268172,268173,0,1,2
76605,3,3,268175,268175,268178,0,3,2
76606,1,3,268176,268178,268181,2,5,0
76607,4,3,268180,268181,268184,1,4,0
76608,4,2,268184,268184,268186,0,2,0
76609,4,3,268188,268188,268191,0,3,2
76610,3,2,268191,268191,268193,0,2,0
76611,1,3,268192,268193,268196,1,4,0
76612,1,2,268193,268196,268198,3,5,0
76613,3,1,268196,268198,268199,2,3,0
76614,1,3,268197,268199,268202,2,5,0
76615,4,1,268201,268202,268203,1,2,0
76616,1,3,268202,268203,268206,1,4,0
76617,4,1,268206,268206,268207,0,1,0
76618,3,1,268209,268209,268210,0,1,2
76619,1,2,268210,268210,268212,0,2,0
76620,2,3,268212,268212,268215,0,3,0
76621,5,3,268217,268217,268220,0,3,2
76622,6,2,268223,268223,268225,0,2,3
76623,4,2,268227,268227,268229,0,2,2
76624,6,2,268233,268233,268235,0,2,4
76625,6,1,268239,268239,268240,0,1,4
76626,5,1,268244,268244,268245,0,1,4
76627,6,3,268250,268250,268253,0,3,5
76628,5,2,268255,268255,268257,0,2,2
76629,2,1,268257,268257,268258,0,1,0
76630,3,1,268260,268260,268261,0,1,2
76631,4,1,268264,268264,268265,0,1,3
76632,6,1,268270,268270,268271,0,1,5
76633,1,2,268271,268271,268273,0,2,0
76634,4,3,268275,268275,268278,0,3,2
76635,3,1,268278,268278,268279,0,1,0
76636,5,1,268283,268283,268284,0,1,4
76637,3,3,268286,268286,268289,0,3,2
76638,2,1,268288,268289,268290,1,2,0
76639,5,3,268293,268293,268296,0,3,3
76640,1,3,268294,268296,268299,2,5,0
76641,5,3,268299,268299,268302,0,3,0
76642,4,2,268303,268303,268305,0,2,1
76643,6,2,268309,268309,268311,0,2,4
76644,1,2,268310,268311,268313,1,3,0
76645,4,1,268314,268314,268315,0,1,1
76646,3,2,268317,268317,268319,0,2,2
76647,1,1,268318,268319,268320,1,2,0
76648,1,3,268319,268320,268323,1,4,0
76649,3,3,268322,268323,268326,1,4,0
76650,5,1,268327,268327,268328,0,1,1
76651,4,3,268331,268331,268334,0,3,3
76652,3,1,268334,268334,268335,0,1,0
76653,6,2,268340,268340,268342,0,2,5
76654,5,1,268345,268345,268346,0,1,3
76655,2,3,268347,268347,268350,0,3,1
76656,2,3,268349,268350,268353,1,4,0
76657,5,2,268354,268354,268356,0,2,1
76658,5,2,268359,268359,268361,0,2,3
76659,3,3,268362,268362,268365,0,3,1
76660,5,2,268367,268367,268369,0,2,2
76661,5,2,268372,268372,268374,0,2,3
76662,5,2,268377,268377,268379,0,2,3
76663,5,3,268382,268382,268385,0,3,3
76664,3,2,268385,268385,268387,0,2,0
76665,5,1,268390,268390,268391,0,1,3
76666,2,3,268392,268392,268395,0,3,1
76667,6,2,268398,268398,268400,0,2,3
76668,6,3,268404,268404,268407,0,3,4
76669,6,3,268410,268410,268413,0,3,3
76670,6,1,268416,268416,268417,0,1,3
76671,3,3,268419,268419,268422,0,3,2
76672,1,3,268420,268422,268425,2,5,0
76673,2,1,268422,268425,268426,3,4,0
76674,2,3,268424,268426,268429,2,5,0
76675,2,2,268426,268429,268431,3,5,0
76676,1,3,268427,268431,268434,4,7,0
76677,3,3,268430,268434,268437,4,7,0
76678,2,3,268432,268437,268440,5,8,0
76679,3,2,268435,268440,268442,5,7,0
76680,2,1,268437,268442,268443,5,6,0
76681,2,1,268439,268443,268444,4,5,0
76682,2,3,268441,268444,268447,3,6,0
76683,1,1,268442,268447,268448,5,6,0
76684,6,1,268448,268448,268449,0,1,0
76685,4,3,268452,268452,268455,0,3,3
76686,2,1,268454,268455,268456,1,2,0
76687,3,2,268457,268457,268459,0,2,1
76688,2,1,268459,268459,268460,0,1,0
76689,6,3,268465,268465,268468,0,3,5
76690,1,2,268466,268468,268470,2,4,0
76691,2,2,268468,268470,268472,2,4,0
76692,5,2,268473,268473,268475,0,2,1
76693,1,3,268474,268475,268478,1,4,0
76694,5,3,268479,268479,268482,0,3,1
76695,6,2,268485,268485,268487,0,2,3
76696,5,1,268490,268490,268491,0,1,3
76697,2,2,268492,268492,268494,0,2,1
76698,5,3,268497,268497,268500,0,3,3
76699,1,1,268498,268500,268501,2,3,0
76700,2,2,268500,268501,268503,1,3,0
76701,4,1,268504,268504,268505,0,1,1
76702,6,3,268510,268510,268513,0,3,5
76703,2,3,268512,268513,268516,1,4,0
76704,5,2,268517,268517,268519,0,2,1
76705,2,2,268519,268519,268521,0,2,0
76706,6,3,268525,268525,268528,0,3,4
76707,1,1,268526,268528,268529,2,3,0
76708,4,2,268530,268530,268532,0,2,1
76709,1,3,268531,268532,268535,1,4,0
76710,2,3,268533,268535,268538,2,5,0
76711,3,2,268536,268538,268540,2,4,0
76712,4,1,268540,268540,268541,0,1,0
76713,3,1,268543,268543,268544,0,1,2
76714,6,1,268549,268549,268550,0,1,5
76715,4,1,268553,268553,268554,0,1,3
76716,3,2,268556,268556,268558,0,2,2
76717,4,3,268560,268560,268563,0,3,2
76718,2,1,268562,268563,268564,1,2,0
76719,4,1,268566,268566,268567,0,1,2
76720,3,1,268569,268569,268570,0,1,2
76721,4,2,268573,268573,268575,0,2,3
76722,2,3,268575,268575,268578,0,3,0
76723,1,2,268576,268578,268580,2,4,0
76724,1,3,268577,268580,268583,3,6,0
76725,6,1,268583,268583,268584,0,1,0
76726,6,2,268589,268589,268591,0,2,5
76727,5,2,268594,268594,268596,0,2,3
76728,6,1,268600,268600,268601,0,1,4
76729,3,2,268603,268603,268605,0,2,2
76730,2,1,268605,268605,268606,0,1,0
76731,2,1,268607,268607,268608,0,1,1
76732,4,3,268611,268611,268614,0,3,3
76733,4,1,268615,268615,268616,0,1,1
76734,6,2,268621,268621,268623,0,2,5
76735,3,1,268624,268624,268625,0,1,1
76736,3,1,268627,268627,268628,0,1,2
76737,2,2,268629,268629,268631,0,2,1
76738,5,1,268634,268634,268635,0,1,3
76739,3,2,268637,268637,268639,0,2,2
76740,4,1,268641,268641,268642,0,1,2
76741,5,3,268646,268646,268649,0,3,4
76742,5,1,268651,268651,268652,0,1,2
76743,1,3,268652,268652,268655,0,3,0
76744,2,3,268654,268655,268658,1,4,0
76745,3,1,268657,268658,268659,1,2,0
76746,1,3,268658,268659,268662,1,4,0
76747,1,3,268659,268662,268665,3,6,0
76748,6,1,268665,268665,268666,0,1,0
76749,5,3,268670,268670,268673,0,3,4
76750,3,2,268673,268673,268675,0,2,0
76751,5,2,268678,268678,268680,0,2,3
76752,1,1,268679,268680,268681,1,2,0
76753,4,2,268683,268683,268685,0,2,2
76754,5,1,268688,268688,268689,0,1,3
76755,3,3,268691,268691,268694,0,3,2
76756,6,3,268697,268697,268700,0,3,3
76757,6,1,268703,268703,268704,0,1,3
76758,4,1,268707,268707,268708,0,1,3
76759,5,1,268712,268712,268713,0,1,4
76760,4,1,268716,268716,268717,0,1,3
76761,6,2,268722,268722,268724,0,2,5
76762,4,3,268726,268726,268729,0,3,2
76763,5,1,268731,268731,268732,0,1,2
76764,5,3,268736,268736,268739,0,3,4
76765,4,1,268740,268740,268741,0,1,1
76766,1,1,268741,268741,268742,0,1,0
76767,1,2,268742,268742,268744,0,2,0
76768,1,3,268743,268744,268747,1,4,0
76769,3,3,268746,268747,268750,1,4,0
76770,6,3,268752,268752,268755,0,3,2
76771,1,1,268753,268755,268756,2,3,0
76772,6,3,268759,268759,268762,0,3,3
76773,4,2,268763,268763,268765,0,2,1
76774,2,2,268765,268765,268767,0,2,0
76775,3,3,268768,268768,268771,0,3,1
76776,2,3,268770,268771,268774,1,4,0
76777,5,3,268775,268775,268778,0,3,1
76778,4,3,268779,268779,268782,0,3,1
76779,1,3,268780,268782,268785,2,5,0
76780,5,1,268785,268785,268786,0,1,0
76781,3,1,268788,268788,268789,0,1,2
76782,1,1,268789,268789,268790,0,1,0
76783,4,3,268793,268793,268796,0,3,3
76784,5,1,268798,268798,268799,0,1,2
76785,2,3,268800,268800,268803,0,3,1
76786,5,1,268805,268805,268806,0,1,2
76787,2,2,268807,268807,268809,0,2,1
76788,3,2,268810,268810,268812,0,2,1
76789,4,2,268814,268814,268816,0,2,2
76790,6,3,268820,268820,268823,0,3,4
76791,1,1,268821,268823,268824,2,3,0
76792,2,3,268823,268824,268827,1,4,0
76793,6,1,268829,268829,268830,0,1,2
76794,1,3,268830,268830,268833,0,3,0
76795,2,2,268832,268833,268835,1,3,0
76796,2,1,268834,268835,268836,1,2,0
76797,2,1,268836,268836,268837,0,1,0
76798,5,1,268841,268841,268842,0,1,4
76799,1,3,268842,268842,268845,0,3,0
76800,4,1,268846,268846,268847,0,1,1
76801,2,2,268848,268848,268850,0,2,1
76802,2,3,268850,268850,268853,0,3,0
76803,5,1,268855,268855,268856,0,1,2
76804,2,1,268857,268857,268858,0,1,1
76805,6,3,268863,268863,268866,0,3,5
76806,5,3,268868,268868,268871,0,3,2
76807,2,2,268870,268871,268873,1,3,0
76808,5,3,268875,268875,268878,0,3,2
76809,6,1,268881,268881,268882,0,1,3
76810,6,2,268887,268887,268889,0,2,5
76811,3,1,268890,268890,268891,0,1,1
76812,4,2,268894,268894,268896,0,2,3
76813,4,2,268898,268898,268900,0,2,2
76814,2,2,268900,268900,268902,0,2,0
76815,4,1,268904,268904,268905,0,1,2
76816,6,1,268910,268910,268911,0,1,5
76817,1,2,268911,268911,268913,0,2,0
76818,2,1,268913,268913,268914,0,1,0
76819,5,1,268918,268918,268919,0,1,4
76820,1,3,268919,268919,268922,0,3,0
76821,5,3,268924,268924,268927,0,3,2
76822,6,2,268930,268930,268932,0,2,3
76823,2,3,268932,268932,268935,0,3,0
76824,2,2,268934,268935,268937,1,3,0
76825,2,2,268936,268937,268939,1,3,0
76826,4,3,268940,268940,268943,0,3,1
76827,5,1,268945,268945,268946,0,1,2
76828,2,1,268947,268947,268948,0,1,1
76829,5,1,268952,268952,268953,0,1,4
76830,6,3,268958,268958,268961,0,3,5
76831,5,1,268963,268963,268964,0,1,2
76832,5,3,268968,268968,268971,0,3,4
76833,2,1,268970,268971,268972,1,2,0
76834,5,1,268975,268975,268976,0,1,3
76835,3,2,268978,268978,268980,0,2,2
76836,6,2,268984,268984,268986,0,2,4
76837,6,1,268990,268990,268991,0,1,4
76838,6,1,268996,268996,268997,0,1,5
76839,3,3,268999,268999,269002,0,3,2
76840,5,3,269004,269004,269007,0,3,2
76841,4,3,269008,269008,269011,0,3,1
76842,2,2,269010,269011,269013,1,3,0
76843,4,2,269014,269014,269016,0,2,1
76844,1,3,269015,269016,269019,1,4,0
76845,5,1,269020,269020,269021,0,1,1
76846,2,2,269022,269022,269024,0,2,1
76847,2,1,269024,269024,269025,0,1,0
76848,5,1,269029,269029,269030,0,1,4
76849,4,2,269033,269033,269035,0,2,3
76850,4,3,269037,269037,269040,0,3,2
76851,1,1,269038,269040,269041,2,3,0
76852,1,1,269039,269041,269042,2,3,0
76853,2,1,269041,269042,269043,1,2,0
76854,4,2,269045,269045,269047,0,2,2
76855,2,3,269047,269047,269050,0,3,0
76856,5,3,269052,269052,269055,0,3,2
76857,2,1,269054,269055,269056,1,2,0
76858,1,2,269055,269056,269058,1,3,0
76859,3,3,269058,269058,269061,0,3,0
76860,2,1,269060,269061,269062,1,2,0
76861,3,3,269063,269063,269066,0,3,1
76862,3,3,269066,269066,269069,0,3,0
76863,6,1,269072,269072,269073,0,1,3
76864,5,1,269077,269077,269078,0,1,4
76865,1,3,269078,269078,269081,0,3,0
76866,2,1,269080,269081,269082,1,2,0
76867,1,2,269081,269082,269084,1,3,0
76868,4,1,269085,269085,269086,0,1,1
76869,2,3,269087,269087,269090,0,3,1
76870,1,3,269088,269090,269093,2,5,0
76871,6,3,269094,269094,269097,0,3,1
76872,4,1,269098,269098,269099,0,1,1
76873,6,1,269104,269104,269105,0,1,5
76874,1,2,269105,269105,269107,0,2,0
76875,1,1,269106,269107,269108,1,2,0
76876,4,1,269110,269110,269111,0,1,2
76877,5,1,269115,269115,269116,0,1,4
76878,4,2,269119,269119,269121,0,2,3
76879,5,2,269124,269124,269126,0,2,3
76880,5,1,269129,269129,269130,0,1,3
76881,1,3,269130,269130,269133,0,3,0
76882,2,2,269132,269133,269135,1,3,0
76883,6,1,269138,269138,269139,0,1,3
76884,6,2,269144,269144,269146,0,2,5
76885,2,3,269146,269146,269149,0,3,0
76886,3,1,269149,269149,269150,0,1,0
76887,4,2,269153,269153,269155,0,2,3
76888,4,1,269157,269157,269158,0,1,2
76889,5,1,269162,269162,269163,0,1,4
76890,3,1,269165,269165,269166,0,1,2
76891,5,1,269170,269170,269171,0,1,4
76892,2,2,269172,269172,269174,0,2,1
76893,3,3,269175,269175,269178,0,3,1
76894,6,2,269181,269181,269183,0,2,3
76895,6,3,269187,269187,269190,0,3,4
76896,2,3,269189,269190,269193,1,4,0
76897,2,1,269191,269193,269194,2,3,0
76898,4,3,269195,269195,269198,0,3,1
76899,6,1,269201,269201,269202,0,1,3
76900,3,3,269204,269204,269207,0,3,2
76901,1,2,269205,269207,269209,2,4,0
76902,2,2,269207,269209,269211,2,4,0
76903,3,3,269210,269211,269214,1,4,0
76904,6,3,269216,269216,269219,0,3,2
76905,5,3,269221,269221,269224,0,3,2
76906,4,3,269225,269225,269228,0,3,1
76907,5,3,269230,269230,269233,0,3,2
76908,1,3,269231,269233,269236,2,5,0
76909,5,2,269236,269236,269238,0,2,0
76910,4,1,269240,269240,269241,0,1,2
76911,3,2,269243,269243,269245,0,2,2
76912,2,1,269245,269245,269246,0,1,0
76913,3,1,269248,269248,269249,0,1,2
76914,5,3,269253,269253,269256,0,3,4
76915,5,3,269258,269258,269261,0,3,2
76916,3,1,269261,269261,269262,0,1,0
76917,6,2,269267,269267,269269,0,2,5
76918,2,3,269269,269269,269272,0,3,0
76919,1,2,269270,269272,269274,2,4,0
76920,4,1,269274,269274,269275,0,1,0
76921,4,3,269278,269278,269281,0,3,3
76922,3,3,269281,269281,269284,0,3,0
76923,3,3,269284,269284,269287,0,3,0
76924,3,3,269287,269287,269290,0,3,0
76925,5,3,269292,269292,269295,0,3,2
76926,1,3,269293,269295,269298,2,5,0
76927,3,1,269296,269298,269299,2,3,0
76928,1,2,269297,269299,269301,2,4,0
76929,5,1,269302,269302,269303,0,1,1
76930,2,2,269304,269304,269306,0,2,1
76931,4,3,269308,269308,269311,0,3,2
76932,3,3,269311,269311,269314,0,3,0
76933,4,1,269315,269315,269316,0,1,1
76934,6,3,269321,269321,269324,0,3,5
76935,1,2,269322,269324,269326,2,4,0
76936,6,2,269328,269328,269330,0,2,2
76937,4,2,269332,269332,269334,0,2,2
76938,6,3,269338,269338,269341,0,3,4
76939,5,3,269343,269343,269346,0,3,2
76940,1,2,269344,269346,269348,2,4,0
76941,2,2,269346,269348,269350,2,4,0
76942,6,3,269352,269352,269355,0,3,2
76943,4,2,269356,269356,269358,0,2,1
76944,5,3,269361,269361,269364,0,3,3
76945,4,2,269365,269365,269367,0,2,1
76946,2,3,269367,269367,269370,0,3,0
76947,2,2,269369,269370,269372,1,3,0
76948,5,2,269374,269374,269376,0,2,2
76949,5,2,269379,269379,269381,0,2,3
76950,4,2,269383,269383,269385,0,2,2
76951,5,2,269388,269388,269390,0,2,3
76952,6,3,269394,269394,269397,0,3,4
76953,5,3,269399,269399,269402,0,3,2
76954,5,2,269404,269404,269406,0,2,2
76955,2,2,269406,269406,269408,0,2,0
76956,6,1,269412,269412,269413,0,1,4
76957,6,1,269418,269418,269419,0,1,5
76958,1,2,269419,269419,269421,0,2,0
76959,6,1,269425,269425,269426,0,1,4
76960,4,2,269429,269429,269431,0,2,3
76961,1,2,269430,269431,269433,1,3,0
76962,2,2,269432,269433,269435,1,3,0
76963,1,1,269433,269435,269436,2,3,0
76964,1,3,269434,269436,269439,2,5,0
76965,2,1,269436,269439,269440,3,4,0
76966,3,1,269439,269440,269441,1,2,0
76967,2,1,269441,269441,269442,0,1,0
76968,3,3,269444,269444,269447,0,3,2
76969,5,2,269449,269449,269451,0,2,2
76970,1,2,269450,269451,269453,1,3,0
76971,1,3,269451,269453,269456,2,5,0
76972,2,3,269453,269456,269459,3,6,0
76973,5,3,269458,269459,269462,1,4,0
76974,4,1,269462,269462,269463,0,1,0
76975,3,1,269465,269465,269466,0,1,2
76976,6,2,269471,269471,269473,0,2,5
76977,3,2,269474,269474,269476,0,2,1
76978,4,2,269478,269478,269480,0,2,2
76979,1,2,269479,269480,269482,1,3,0
76980,1,2,269480,269482,269484,2,4,0
76981,4,2,269484,269484,269486,0,2,0
76982,6,2,269490,269490,269492,0,2,4
76983,4,1,269494,269494,269495,0,1,2
76984,2,2,269496,269496,269498,0,2,1
76985,1,2,269497,269498,269500,1,3,0
76986,2,1,269499,269500,269501,1,2,0
76987,5,3,269504,269504,269507,0,3,3
76988,2,3,269506,269507,269510,1,4,0
76989,4,3,269510,269510,269513,0,3,0
76990,2,1,269512,269513,269514,1,2,0
76991,5,2,269517,269517,269519,0,2,3
76992,1,2,269518,269519,269521,1,3,0
76993,2,2,269520,269521,269523,1,3,0
76994,4,1,269524,269524,269525,0,1,1
76995,3,3,269527,269527,269530,0,3,2
76996,3,3,269530,269530,269533,0,3,0
76997,4,1,269534,269534,269535,0,1,1
76998,1,2,269535,269535,269537,0,2,0
76999,4,2,269539,269539,269541,0,2,2
77000,1,2,269540,269541,269543,1,3,0
77001,5,3,269545,269545,269548,0,3,2
77002,2,3,269547,269548,269551,1,4,0
77003,3,3,269550,269551,269554,1,4,0
77004,4,2,269554,269554,269556,0,2,0
77005,1,1,269555,269556,269557,1,2,0
77006,2,3,269557,269557,269560,0,3,0
77007,4,2,269561,269561,269563,0,2,1
77008,6,3,269567,269567,269570,0,3,4
77009,3,2,269570,269570,269572,0,2,0
77010,5,2,269575,269575,269577,0,2,3
77011,4,2,269579,269579,269581,0,2,2
77012,4,1,269583,269583,269584,0,1,2
77013,1,1,269584,269584,269585,0,1,0
77014,6,3,269590,269590,269593,0,3,5
77015,6,3,269596,269596,269599,0,3,3
77016,6,3,269602,269602,269605,0,3,3
77017,2,2,269604,269605,269607,1,3,0
77018,4,3,269608,269608,269611,0,3,1
77019,2,2,269610,269611,269613,1,3,0
77020,4,3,269614,269614,269617,0,3,1
77021,3,3,269617,269617,269620,0,3,0
77022,5,1,269622,269622,269623,0,1,2
77023,2,2,269624,269624,269626,0,2,1
77024,2,1,269626,269626,269627,0,1,0
77025,5,1,269631,269631,269632,0,1,4
77026,3,1,269634,269634,269635,0,1,2
77027,2,1,269636,269636,269637,0,1,1
77028,2,1,269638,269638,269639,0,1,1
77029,3,2,269641,269641,269643,0,2,2
77030,1,1,269642,269643,269644,1,2,0
77031,3,1,269645,269645,269646,0,1,1
77032,6,1,269651,269651,269652,0,1,5
77033,4,3,269655,269655,269658,0,3,3
77034,6,1,269661,269661,269662,0,1,3
77035,4,1,269665,269665,269666,0,1,3
77036,3,2,269668,269668,269670,0,2,2
77037,1,1,269669,269670,269671,1,2,0
77038,5,2,269674,269674,269676,0,2,3
77039,3,2,269677,269677,269679,0,2,1
77040,1,3,269678,269679,269682,1,4,0
77041,5,3,269683,269683,269686,0,3,1
77042,1,2,269684,269686,269688,2,4,0
77043,4,3,269688,269688,269691,0,3,0
77044,3,2,269691,269691,269693,0,2,0
77045,3,2,269694,269694,269696,0,2,1
77046,6,2,269700,269700,269702,0,2,4
77047,1,2,269701,269702,269704,1,3,0
77048,1,3,269702,269704,269707,2,5,0
77049,3,1,269705,269707,269708,2,3,0
77050,3,2,269708,269708,269710,0,2,0
77051,1,1,269709,269710,269711,1,2,0
77052,6,1,269715,269715,269716,0,1,4
77053,5,3,269720,269720,269723,0,3,4
77054,6,1,269726,269726,269727,0,1,3
77055,3,3,269729,269729,269732,0,3,2
77056,1,1,269730,269732,269733,2,3,0
77057,3,2,269733,269733,269735,0,2,0
77058,1,2,269734,269735,269737,1,3,0
77059,1,3,269735,269737,269740,2,5,0
77060,6,1,269741,269741,269742,0,1,1
77061,5,2,269746,269746,269748,0,2,4
77062,6,1,269752,269752,269753,0,1,4
77063,4,1,269756,269756,269757,0,1,3
77064,3,2,269759,269759,269761,0,2,2
77065,4,1,269763,269763,269764,0,1,2
77066,1,1,269764,269764,269765,0,1,0
77067,5,1,269769,269769,269770,0,1,4
77068,6,3,269775,269775,269778,0,3,5
77069,4,1,269779,269779,269780,0,1,1
77070,2,1,269781,269781,269782,0,1,1
77071,3,3,269784,269784,269787,0,3,2
77072,5,3,269789,269789,269792,0,3,2
77073,6,2,269795,269795,269797,0,2,3
77074,5,3,269800,269800,269803,0,3,3
77075,3,1,269803,269803,269804,0,1,0
77076,1,2,269804,269804,269806,0,2,0
77077,4,2,269808,269808,269810,0,2,2
77078,5,2,269813,269813,269815,0,2,3
77079,5,3,269818,269818,269821,0,3,3
77080,4,2,269822,269822,269824,0,2,1
77081,2,2,269824,269824,269826,0,2,0
77082,6,1,269830,269830,269831,0,1,4
77083,6,2,269836,269836,269838,0,2,5
77084,4,2,269840,269840,269842,0,2,2
77085,2,2,269842,269842,269844,0,2,0
77086,1,2,269843,269844,269846,1,3,0
77087,4,1,269847,269847,269848,0,1,1
77088,3,3,269850,269850,269853,0,3,2
77089,2,2,269852,269853,269855,1,3,0
77090,4,1,269856,269856,269857,0,1,1
77091,5,2,269861,269861,269863,0,2,4
77092,3,3,269864,269864,269867,0,3,1
77093,2,2,269866,269867,269869,1,3,0
77094,2,2,269868,269869,269871,1,3,0
77095,6,1,269874,269874,269875,0,1,3
77096,5,3,269879,269879,269882,0,3,4
77097,3,2,269882,269882,269884,0,2,0
77098,4,2,269886,269886,269888,0,2,2
77099,5,1,269891,269891,269892,0,1,3
77100,2,2,269893,269893,269895,0,2,1
77101,6,1,269899,269899,269900,0,1,4
77102,3,3,269902,269902,269905,0,3,2
77103,4,1,269906,269906,269907,0,1,1
77104,6,1,269912,269912,269913,0,1,5
77105,2,3,269914,269914,269917,0,3,1
77106,3,1,269917,269917,269918,0,1,0
77107,3,1,269920,269920,269921,0,1,2
77108,3,1,269923,269923,269924,0,1,2
77109,2,2,269925,269925,269927,0,2,1
77110,4,2,269929,269929,269931,0,2,2
77111,2,3,269931,269931,269934,0,3,0
77112,2,2,269933,269934,269936,1,3,0
77113,6,1,269939,269939,269940,0,1,3
77114,1,3,269940,269940,269943,0,3,0
77115,5,1,269945,269945,269946,0,1,2
77116,4,3,269949,269949,269952,0,3,3
77117,3,1,269952,269952,269953,0,1,0
77118,4,1,269956,269956,269957,0,1,3
77119,1,2,269957,269957,269959,0,2,0
77120,5,2,269962,269962,269964,0,2,3
77121,2,3,269964,269964,269967,0,3,0
77122,2,2,269966,269967,269969,1,3,0
77123,2,1,269968,269969,269970,1,2,0
77124,3,3,269971,269971,269974,0,3,1
77125,2,3,269973,269974,269977,1,4,0
77126,2,2,269975,269977,269979,2,4,0
77127,3,2,269978,269979,269981,1,3,0
77128,5,1,269983,269983,269984,0,1,2
77129,6,1,269989,269989,269990,0,1,5
77130,4,2,269993,269993,269995,0,2,3
77131,4,3,269997,269997,270000,0,3,2
77132,2,2,269999,270000,270002,1,3,0
77133,2,3,270001,270002,270005,1,4,0
77134,1,1,270002,270005,270006,3,4,0
77135,4,1,270006,270006,270007,0,1,0
77136,4,1,270010,270010,270011,0,1,3
77137,6,2,270016,270016,270018,0,2,5
77138,3,1,270019,270019,270020,0,1,1
77139,3,3,270022,270022,270025,0,3,2
77140,1,3,270023,270025,270028,2,5,0
77141,5,1,270028,270028,270029,0,1,0
77142,1,2,270029,270029,270031,0,2,0
77143,5,2,270034,270034,270036,0,2,3
77144,4,2,270038,270038,270040,0,2,2
77145,4,3,270042,270042,270045,0,3,2
77146,4,3,270046,270046,270049,0,3,1
77147,5,1,270051,270051,270052,0,1,2
77148,2,3,270053,270053,270056,0,3,1
77149,5,2,270058,270058,270060,0,2,2
77150,6,1,270064,270064,270065,0,1,4
77151,5,3,270069,270069,270072,0,3,4
77152,4,2,270073,270073,270075,0,2,1
77153,5,2,270078,270078,270080,0,2,3
77154,2,2,270080,270080,270082,0,2,0
77155,4,1,270084,270084,270085,0,1,2
77156,1,3,270085,270085,270088,0,3,0
77157,5,3,270090,270090,270093,0,3,2
77158,1,2,270091,270093,270095,2,4,0
77159,1,2,270092,270095,270097,3,5,0
77160,5,2,270097,270097,270099,0,2,0
77161,6,2,270103,270103,270105,0,2,4
77162,6,1,270109,270109,270110,0,1,4
77163,2,2,270111,270111,270113,0,2,1
77164,2,3,270113,270113,270116,0,3,0
77165,5,2,270118,270118,270120,0,2,2
77166,1,3,270119,270120,270123,1,4,0
77167,1,1,270120,270123,270124,3,4,0
77168,6,2,270126,270126,270128,0,2,2
77169,3,2,270129,270129,270131,0,2,1
77170,6,1,270135,270135,270136,0,1,4
77171,2,3,270137,270137,270140,0,3,1
77172,4,1,270141,270141,270142,0,1,1
77173,1,1,270142,270142,270143,0,1,0
77174,4,2,270146,270146,270148,0,2,3
77175,5,3,270151,270151,270154,0,3,3
77176,3,2,270154,270154,270156,0,2,0
77177,4,3,270158,270158,270161,0,3,2
77178,5,3,270163,270163,270166,0,3,2
77179,2,2,270165,270166,270168,1,3,0
77180,1,2,270166,270168,270170,2,4,0
77181,3,2,270169,270170,270172,1,3,0
77182,4,2,270173,270173,270175,0,2,1
77183,4,2,270177,270177,270179,0,2,2
77184,1,1,270178,270179,270180,1,2,0
77185,2,3,270180,270180,270183,0,3,0
77186,4,2,270184,270184,270186,0,2,1
77187,1,2,270185,270186,270188,1,3,0
77188,2,1,270187,270188,270189,1,2,0
77189,3,1,270190,270190,270191,0,1,1
77190,1,1,270191,270191,270192,0,1,0
77191,4,3,270195,270195,270198,0,3,3
77192,1,1,270196,270198,270199,2,3,0
77193,2,2,270198,270199,270201,1,3,0
77194,2,3,270200,270201,270204,1,4,0
77195,4,2,270204,270204,270206,0,2,0
77196,6,2,270210,270210,270212,0,2,4
77197,2,3,270212,270212,270215,0,3,0
77198,6,3,270218,270218,270221,0,3,3
77199,1,2,270219,270221,270223,2,4,0
77200,6,1,270225,270225,270226,0,1,2
77201,5,2,270230,270230,270232,0,2,4
77202,6,2,270236,270236,270238,0,2,4
77203,4,3,270240,270240,270243,0,3,2
77204,5,1,270245,270245,270246,0,1,2
77205,6,2,270251,270251,270253,0,2,5
77206,4,1,270255,270255,270256,0,1,2
77207,1,1,270256,270256,270257,0,1,0
77208,6,2,270262,270262,270264,0,2,5
77209,2,3,270264,270264,270267,0,3,0
77210,6,3,270270,270270,270273,0,3,3
77211,2,3,270272,270273,270276,1,4,0
77212,3,3,270275,270276,270279,1,4,0
77213,5,1,270280,270280,270281,0,1,1
77214,4,1,270284,270284,270285,0,1,3
77215,4,1,270288,270288,270289,0,1,3
77216,2,2,270290,270290,270292,0,2,1
77217,2,2,270292,270292,270294,0,2,0
77218,4,1,270296,270296,270297,0,1,2
77219,4,3,270300,270300,270303,0,3,3
77220,3,3,270303,270303,270306,0,3,0
77221,4,1,270307,270307,270308,0,1,1
77222,1,2,270308,270308,270310,0,2,0
77223,4,3,270312,270312,270315,0,3,2
77224,5,1,270317,270317,270318,0,1,2
77225,3,1,270320,270320,270321,0,1,2
77226,2,1,270322,270322,270323,0,1,1
77227,5,2,270327,270327,270329,0,2,4
77228,6,3,270333,270333,270336,0,3,4
77229,5,3,270338,270338,270341,0,3,2
77230,6,3,270344,270344,270347,0,3,3
77231,1,2,270345,270347,270349,2,4,0
77232,2,1,270347,270349,270350,2,3,0
77233,6,1,270353,270353,270354,0,1,3
77234,1,2,270354,270354,270356,0,2,0
77235,3,1,270357,270357,270358,0,1,1
77236,2,2,270359,270359,270361,0,2,1
77237,1,3,270360,270361,270364,1,4,0
77238,1,2,270361,270364,270366,3,5,0
77239,3,3,270364,270366,270369,2,5,0
77240,3,2,270367,270369,270371,2,4,0
77241,6,1,270373,270373,270374,0,1,2
77242,6,3,270379,270379,270382,0,3,5
77243,2,2,270381,270382,270384,1,3,0
77244,3,1,270384,270384,270385,0,1,0
77245,3,3,270387,270387,270390,0,3,2
77246,3,3,270390,270390,270393,0,3,0
77247,1,3,270391,270393,270396,2,5,0
77248,6,2,270397,270397,270399,0,2,1
77249,5,2,270402,270402,270404,0,2,3
77250,6,2,270408,270408,270410,0,2,4
77251,6,2,270414,270414,270416,0,2,4
77252,6,2,270420,270420,270422,0,2,4
77253,4,1,270424,270424,270425,0,1,2
77254,4,3,270428,270428,270431,0,3,3
77255,6,1,270434,270434,270435,0,1,3
77256,4,2,270438,270438,270440,0,2,3
77257,3,3,270441,270441,270444,0,3,1
77258,1,3,270442,270444,270447,2,5,0
77259,3,2,270445,270447,270449,2,4,0
77260,2,3,270447,270449,270452,2,5,0
77261,4,3,270451,270452,270455,1,4,0
77262,6,1,270457,270457,270458,0,1,2
77263,6,3,270463,270463,270466,0,3,5
77264,4,2,270467,270467,270469,0,2,1
77265,5,3,270472,270472,270475,0,3,3
77266,5,3,270477,270477,270480,0,3,2
77267,1,2,270478,270480,270482,2,4,0
77268,2,3,270480,270482,270485,2,5,0
77269,4,2,270484,270485,270487,1,3,0
77270,2,3,270486,270487,270490,1,4,0
77271,1,2,270487,270490,270492,3,5,0
77272,2,3,270489,270492,270495,3,6,0
77273,4,2,270493,270495,270497,2,4,0
77274,2,1,270495,270497,270498,2,3,0
77275,5,1,270500,270500,270501,0,1,2
77276,2,3,270502,270502,270505,0,3,1
77277,4,1,270506,270506,270507,0,1,1
77278,6,2,270512,270512,270514,0,2,5
77279,5,2,270517,270517,270519,0,2,3
77280,6,3,270523,270523,270526,0,3,4
77281,3,1,270526,270526,270527,0,1,0
77282,3,1,270529,270529,270530,0,1,2
77283,3,3,270532,270532,270535,0,3,2
77284,6,1,270538,270538,270539,0,1,3
77285,2,1,270540,270540,270541,0,1,1
77286,3,1,270543,270543,270544,0,1,2
77287,1,1,270544,270544,270545,0,1,0
77288,4,3,270548,270548,270551,0,3,3
77289,1,2,270549,270551,270553,2,4,0
77290,5,2,270554,270554,270556,0,2,1
77291,4,1,270558,270558,270559,0,1,2
77292,2,2,270560,270560,270562,0,2,1
77293,3,2,270563,270563,270565,0,2,1
77294,3,2,270566,270566,270568,0,2,1
77295,4,1,270570,270570,270571,0,1,2
77296,5,2,270575,270575,270577,0,2,4
77297,6,1,270581,270581,270582,0,1,4
77298,3,2,270584,270584,270586,0,2,2
77299,3,2,270587,270587,270589,0,2,1
77300,1,3,270588,270589,270592,1,4,0
77301,3,2,270591,270592,270594,1,3,0
77302,3,3,270594,270594,270597,0,3,0
77303,4,2,270598,270598,270600,0,2,1
77304,1,3,270599,270600,270603,1,4,0
77305,4,2,270603,270603,270605,0,2,0
77306,1,2,270604,270605,270607,1,3,0
77307,5,1,270609,270609,270610,0,1,2
77308,6,3,270615,270615,270618,0,3,5
77309,1,1,270616,270618,270619,2,3,0
77310,3,1,270619,270619,270620,0,1,0
77311,6,2,270625,270625,270627,0,2,5
77312,3,2,270628,270628,270630,0,2,1
77313,5,2,270633,270633,270635,0,2,3
77314,4,2,270637,270637,270639,0,2,2
77315,1,3,270638,270639,270642,1,4,0
77316,4,1,270642,270642,270643,0,1,0
77317,1,3,270643,270643,270646,0,3,0
77318,1,2,270644,270646,270648,2,4,0
77319,5,3,270649,270649,270652,0,3,1
77320,5,2,270654,270654,270656,0,2,2
77321,1,1,270655,270656,270657,1,2,0
77322,2,1,270657,270657,270658,0,1,0
77323,4,3,270661,270661,270664,0,3,3
77324,4,3,270665,270665,270668,0,3,1
77325,6,2,270671,270671,270673,0,2,3
77326,4,3,270675,270675,270678,0,3,2
77327,4,2,270679,270679,270681,0,2,1
77328,1,1,270680,270681,270682,1,2,0
77329,4,1,270684,270684,270685,0,1,2
77330,1,2,270685,270685,270687,0,2,0
77331,3,2,270688,270688,270690,0,2,1
77332,5,2,270693,270693,270695,0,2,3
77333,3,3,270696,270696,270699,0,3,1
77334,5,3,270701,270701,270704,0,3,2
77335,3,3,270704,270704,270707,0,3,0
77336,4,2,270708,270708,270710,0,2,1
77337,5,2,270713,270713,270715,0,2,3
77338,6,3,270719,270719,270722,0,3,4
77339,1,3,270720,270722,270725,2,5,0
77340,4,3,270724,270725,270728,1,4,0
77341,1,2,270725,270728,270730,3,5,0
77342,2,2,270727,270730,270732,3,5,0
77343,1,2,270728,270732,270734,4,6,0
77344,1,1,270729,270734,270735,5,6,0
77345,1,2,270730,270735,270737,5,7,0
77346,5,3,270735,270737,270740,2,5,0
77347,3,2,270738,270740,270742,2,4,0
77348,1,3,270739,270742,270745,3,6,0
77349,6,1,270745,270745,270746,0,1,0
77350,2,2,270747,270747,270749,0,2,1
77351,2,3,270749,270749,270752,0,3,0
77352,1,3,270750,270752,270755,2,5,0
77353,6,3,270756,270756,270759,0,3,1
77354,1,1,270757,270759,270760,2,3,0
77355,3,1,270760,270760,270761,0,1,0
77356,2,1,270762,270762,270763,0,1,1
77357,2,1,270764,270764,270765,0,1,1
77358,6,3,270770,270770,270773,0,3,5
77359,6,1,270776,270776,270777,0,1,3
77360,6,3,270782,270782,270785,0,3,5
77361,5,3,270787,270787,270790,0,3,2
77362,6,1,270793,270793,270794,0,1,3
77363,3,3,270796,270796,270799,0,3,2
77364,4,1,270800,270800,270801,0,1,1
77365,4,2,270804,270804,270806,0,2,3
77366,5,3,270809,270809,270812,0,3,3
77367,1,1,270810,270812,270813,2,3,0
77368,2,2,270812,270813,270815,1,3,0
77369,1,2,270813,270815,270817,2,4,0
77370,2,2,270815,270817,270819,2,4,0
77371,4,3,270819,270819,270822,0,3,0
77372,5,1,270824,270824,270825,0,1,2
77373,6,1,270830,270830,270831,0,1,5
77374,1,3,270831,270831,270834,0,3,0
77375,5,3,270836,270836,270839,0,3,2
77376,6,3,270842,270842,270845,0,3,3
77377,4,1,270846,270846,270847,0,1,1
77378,3,2,270849,270849,270851,0,2,2
77379,1,3,270850,270851,270854,1,4,0
77380,1,2,270851,270854,270856,3,5,0
77381,4,3,270855,270856,270859,1,4,0
77382,5,3,270860,270860,270863,0,3,1
77383,5,1,270865,270865,270866,0,1,2
77384,6,2,270871,270871,270873,0,2,5
77385,1,2,270872,270873,270875,1,3,0
77386,2,3,270874,270875,270878,1,4,0
77387,6,1,270880,270880,270881,0,1,2
77388,3,3,270883,270883,270886,0,3,2
77389,5,3,270888,270888,270891,0,3,2
77390,6,3,270894,270894,270897,0,3,3
77391,2,2,270896,270897,270899,1,3,0
77392,2,1,270898,270899,270900,1,2,0
77393,1,2,270899,270900,270902,1,3,0
77394,6,1,270905,270905,270906,0,1,3
77395,6,1,270911,270911,270912,0,1,5
77396,4,2,270915,270915,270917,0,2,3
77397,1,1,270916,270917,270918,1,2,0
77398,5,2,270921,270921,270923,0,2,3
77399,4,2,270925,270925,270927,0,2,2
77400,1,1,270926,270927,270928,1,2,0
77401,6,3,270932,270932,270935,0,3,4
77402,3,2,270935,270935,270937,0,2,0
77403,6,1,270941,270941,270942,0,1,4
77404,2,3,270943,270943,270946,0,3,1
77405,4,3,270947,270947,270950,0,3,1
77406,4,2,270951,270951,270953,0,2,1
77407,2,3,270953,270953,270956,0,3,0
77408,6,3,270959,270959,270962,0,3,3
77409,2,3,270961,270962,270965,1,4,0
77410,6,2,270967,270967,270969,0,2,2
77411,1,3,270968,270969,270972,1,4,0
77412,3,3,270971,270972,270975,1,4,0
77413,4,3,270975,270975,270978,0,3,0
77414,4,1,270979,270979,270980,0,1,1
77415,1,2,270980,270980,270982,0,2,0
77416,1,1,270981,270982,270983,1,2,0
77417,2,3,270983,270983,270986,0,3,0
77418,1,2,270984,270986,270988,2,4,0
77419,2,2,270986,270988,270990,2,4,0
77420,6,2,270992,270992,270994,0,2,2
77421,2,3,270994,270994,270997,0,3,0
77422,6,3,271000,271000,271003,0,3,3
77423,1,2,271001,271003,271005,2,4,0
77424,6,2,271007,271007,271009,0,2,2
77425,4,2,271011,271011,271013,0,2,2
77426,2,2,271013,271013,271015,0,2,0
77427,3,3,271016,271016,271019,0,3,1
77428,5,2,271021,271021,271023,0,2,2
77429,6,2,271027,271027,271029,0,2,4
77430,4,1,271031,271031,271032,0,1,2
77431,2,3,271033,271033,271036,0,3,1
77432,6,1,271039,271039,271040,0,1,3
77433,1,3,271040,271040,271043,0,3,0
77434,2,1,271042,271043,271044,1,2,0
77435,5,2,271047,271047,271049,0,2,3
77436,6,3,271053,271053,271056,0,3,4
77437,5,1,271058,271058,271059,0,1,2
77438,4,1,271062,271062,271063,0,1,3
77439,2,3,271064,271064,271067,0,3,1
77440,4,1,271068,271068,271069,0,1,1
77441,3,2,271071,271071,271073,0,2,2
77442,4,2,271075,271075,271077,0,2,2
77443,4,2,271079,271079,271081,0,2,2
77444,6,3,271085,271085,271088,0,3,4
77445,2,2,271087,271088,271090,1,3,0
77446,3,3,271090,271090,271093,0,3,0
77447,1,1,271091,271093,271094,2,3,0
77448,4,2,271095,271095,271097,0,2,1
77449,4,1,271099,271099,271100,0,1,2
77450,3,2,271102,271102,271104,0,2,2
77451,2,3,271104,271104,271107,0,3,0
77452,6,1,271110,271110,271111,0,1,3
77453,3,2,271113,271113,271115,0,2,2
77454,6,1,271119,271119,271120,0,1,4
77455,6,3,271125,271125,271128,0,3,5
77456,4,3,271129,271129,271132,0,3,1
77457,3,2,271132,271132,271134,0,2,0
77458,1,3,271133,271134,271137,1,4,0
77459,6,3,271139,271139,271142,0,3,2
77460,6,1,271145,271145,271146,0,1,3
77461,6,1,271151,271151,271152,0,1,5
77462,3,1,271154,271154,271155,0,1,2
77463,1,2,271155,271155,271157,0,2,0
77464,3,1,271158,271158,271159,0,1,1
77465,5,2,271163,271163,271165,0,2,4
77466,2,1,271165,271165,271166,0,1,0
77467,1,3,271166,271166,271169,0,3,0
77468,6,1,271172,271172,271173,0,1,3
77469,6,1,271178,271178,271179,0,1,5
77470,1,2,271179,271179,271181,0,2,0
77471,6,2,271185,271185,271187,0,2,4
77472,2,3,271187,271187,271190,0,3,0
77473,1,3,271188,271190,271193,2,5,0
77474,1,1,271189,271193,271194,4,5,0
77475,2,3,271191,271194,271197,3,6,0
77476,4,1,271195,271197,271198,2,3,0
77477,1,3,271196,271198,271201,2,5,0
77478,1,3,271197,271201,271204,4,7,0
77479,5,1,271202,271204,271205,2,3,0
77480,6,1,271208,271208,271209,0,1,3
77481,5,3,271213,271213,271216,0,3,4
77482,3,2,271216,271216,271218,0,2,0
77483,3,2,271219,271219,271221,0,2,1
77484,3,3,271222,271222,271225,0,3,1
77485,1,3,271223,271225,271228,2,5,0
77486,2,3,271225,271228,271231,3,6,0
77487,6,3,271231,271231,271234,0,3,0
77488,4,2,271235,271235,271237,0,2,1
77489,4,2,271239,271239,271241,0,2,2
77490,6,3,271245,271245,271248,0,3,4
77491,2,3,271247,271248,271251,1,4,0
77492,2,2,271249,271251,271253,2,4,0
77493,5,1,271254,271254,271255,0,1,1
77494,4,1,271258,271258,271259,0,1,3
77495,2,2,271260,271260,271262,0,2,1
77496,2,1,271262,271262,271263,0,1,0
77497,6,1,271268,271268,271269,0,1,5
77498,5,3,271273,271273,271276,0,3,4
77499,3,3,271276,271276,271279,0,3,0
77500,3,3,271279,271279,271282,0,3,0
77501,4,3,271283,271283,271286,0,3,1
77502,1,3,271284,271286,271289,2,5,0
77503,2,1,271286,271289,271290,3,4,0
77504,1,2,271287,271290,271292,3,5,0
77505,4,1,271291,271292,271293,1,2,0
77506,3,1,271294,271294,271295,0,1,1
77507,3,1,271297,271297,271298,0,1,2
77508,1,1,271298,271298,271299,0,1,0
77509,6,1,271304,271304,271305,0,1,5
77510,2,1,271306,271306,271307,0,1,1
77511,6,3,271312,271312,271315,0,3,5
77512,6,2,271318,271318,271320,0,2,3
77513,3,3,271321,271321,271324,0,3,1
77514,2,1,271323,271324,271325,1,2,0
77515,1,2,271324,271325,271327,1,3,0
77516,6,3,271330,271330,271333,0,3,3
77517,5,2,271335,271335,271337,0,2,2
77518,4,1,271339,271339,271340,0,1,2
77519,4,3,271343,271343,271346,0,3,3
77520,1,3,271344,271346,271349,2,5,0
77521,4,2,271348,271349,271351,1,3,0
77522,5,1,271353,271353,271354,0,1,2
77523,4,2,271357,271357,271359,0,2,3
77524,4,3,271361,271361,271364,0,3,2
77525,4,2,271365,271365,271367,0,2,1
77526,5,2,271370,271370,271372,0,2,3
77527,1,1,271371,271372,271373,1,2,0
77528,2,1,271373,271373,271374,0,1,0
77529,6,3,271379,271379,271382,0,3,5
77530,4,1,271383,271383,271384,0,1,1
77531,2,3,271385,271385,271388,0,3,1
77532,3,3,271388,271388,271391,0,3,0
77533,2,3,271390,271391,271394,1,4,0
77534,3,3,271393,271394,271397,1,4,0
77535,6,1,271399,271399,271400,0,1,2
77536,2,3,271401,271401,271404,0,3,1
77537,6,3,271407,271407,271410,0,3,3
77538,6,3,271413,271413,271416,0,3,3
77539,3,1,271416,271416,271417,0,1,0
77540,5,1,271421,271421,271422,0,1,4
77541,4,2,271425,271425,271427,0,2,3
77542,1,2,271426,271427,271429,1,3,0
77543,3,1,271429,271429,271430,0,1,0
77544,2,1,271431,271431,271432,0,1,1
77545,4,3,271435,271435,271438,0,3,3
77546,2,1,271437,271438,271439,1,2,0
77547,5,2,271442,271442,271444,0,2,3
77548,3,1,271445,271445,271446,0,1,1
77549,3,3,271448,271448,271451,0,3,2
77550,1,1,271449,271451,271452,2,3,0
77551,5,3,271454,271454,271457,0,3,2
77552,5,3,271459,271459,271462,0,3,2
77553,3,2,271462,271462,271464,0,2,0
77554,6,1,271468,271468,271469,0,1,4
77555,2,2,271470,271470,271472,0,2,1
77556,5,1,271475,271475,271476,0,1,3
77557,6,1,271481,271481,271482,0,1,5
77558,5,1,271486,271486,271487,0,1,4
77559,4,2,271490,271490,271492,0,2,3
77560,3,3,271493,271493,271496,0,3,1
77561,2,1,271495,271496,271497,1,2,0
77562,2,3,271497,271497,271500,0,3,0
77563,4,2,271501,271501,271503,0,2,1
77564,6,2,271507,271507,271509,0,2,4
77565,5,2,271512,271512,271514,0,2,3
77566,4,1,271516,271516,271517,0,1,2
77567,1,1,271517,271517,271518,0,1,0
77568,1,2,271518,271518,271520,0,2,0
77569,3,2,271521,271521,271523,0,2,1
77570,3,2,271524,271524,271526,0,2,1
77571,2,2,271526,271526,271528,0,2,0
77572,5,2,271531,271531,271533,0,2,3
77573,4,3,271535,271535,271538,0,3,2
77574,3,2,271538,271538,271540,0,2,0
77575,5,1,271543,271543,271544,0,1,3
77576,6,1,271549,271549,271550,0,1,5
77577,1,1,271550,271550,271551,0,1,0
77578,3,1,271553,271553,271554,0,1,2
77579,5,1,271558,271558,271559,0,1,4
77580,5,1,271563,271563,271564,0,1,4
77581,3,1,271566,271566,271567,0,1,2
77582,2,1,271568,271568,271569,0,1,1
77583,1,1,271569,271569,271570,0,1,0
77584,4,3,271573,271573,271576,0,3,3
77585,1,2,271574,271576,271578,2,4,0
77586,5,2,271579,271579,271581,0,2,1
77587,2,1,271581,271581,271582,0,1,0
77588,4,3,271585,271585,271588,0,3,3
77589,1,2,271586,271588,271590,2,4,0
77590,3,2,271589,271590,271592,1,3,0
77591,2,2,271591,271592,271594,1,3,0
77592,6,3,271597,271597,271600,0,3,3
77593,2,3,271599,271600,271603,1,4,0
77594,5,1,271604,271604,271605,0,1,1
77595,3,2,271607,271607,271609,0,2,2
77596,4,2,271611,271611,271613,0,2,2
77597,5,2,271616,271616,271618,0,2,3
77598,4,1,271620,271620,271621,0,1,2
77599,2,3,271622,271622,271625,0,3,1
77600,5,3,271627,271627,271630,0,3,2
77601,5,1,271632,271632,271633,0,1,2
77602,6,2,271638,271638,271640,0,2,5
77603,3,2,271641,271641,271643,0,2,1
77604,3,2,271644,271644,271646,0,2,1
77605,4,3,271648,271648,271651,0,3,2
77606,3,1,271651,271651,271652,0,1,0
77607,3,2,271654,271654,271656,0,2,2
77608,4,1,271658,271658,271659,0,1,2
77609,3,3,271661,271661,271664,0,3,2
77610,5,2,271666,271666,271668,0,2,2
77611,3,2,271669,271669,271671,0,2,1
77612,4,1,271673,271673,271674,0,1,2
77613,6,1,271679,271679,271680,0,1,5
77614,4,2,271683,271683,271685,0,2,3
77615,4,3,271687,271687,271690,0,3,2
77616,5,3,271692,271692,271695,0,3,2
77617,6,2,271698,271698,271700,0,2,3
77618,2,3,271700,271700,271703,0,3,0
77619,2,3,271702,271703,271706,1,4,0
77620,4,2,271706,271706,271708,0,2,0
77621,6,2,271712,271712,271714,0,2,4
77622,4,2,271716,271716,271718,0,2,2
77623,5,2,271721,271721,271723,0,2,3
77624,6,3,271727,271727,271730,0,3,4
77625,5,3,271732,271732,271735,0,3,2
77626,3,1,271735,271735,271736,0,1,0
77627,2,2,271737,271737,271739,0,2,1
77628,1,3,271738,271739,271742,1,4,0
77629,3,1,271741,271742,271743,1,2,0
77630,4,2,271745,271745,271747,0,2,2
77631,5,1,271750,271750,271751,0,1,3
77632,5,2,271755,271755,271757,0,2,4
77633,1,3,271756,271757,271760,1,4,0
77634,6,2,271762,271762,271764,0,2,2
77635,4,1,271766,271766,271767,0,1,2
77636,1,2,271767,271767,271769,0,2,0
77637,4,3,271771,271771,271774,0,3,2
77638,2,3,271773,271774,271777,1,4,0
77639,1,3,271774,271777,271780,3,6,0
77640,4,3,271778,271780,271783,2,5,0
77641,3,1,271781,271783,271784,2,3,0
77642,6,2,271787,271787,271789,0,2,3
77643,6,1,271793,271793,271794,0,1,4
77644,6,3,271799,271799,271802,0,3,5
77645,3,2,271802,271802,271804,0,2,0
77646,4,2,271806,271806,271808,0,2,2
77647,2,1,271808,271808,271809,0,1,0
77648,2,2,271810,271810,271812,0,2,1
77649,4,3,271814,271814,271817,0,3,2
77650,6,3,271820,271820,271823,0,3,3
77651,6,1,271826,271826,271827,0,1,3
77652,1,3,271827,271827,271830,0,3,0
77653,3,3,271830,271830,271833,0,3,0
77654,6,3,271836,271836,271839,0,3,3
77655,3,3,271839,271839,271842,0,3,0
77656,4,3,271843,271843,271846,0,3,1
77657,1,3,271844,271846,271849,2,5,0
77658,3,3,271847,271849,271852,2,5,0
77659,6,2,271853,271853,271855,0,2,1
77660,4,3,271857,271857,271860,0,3,2
77661,3,3,271860,271860,271863,0,3,0
77662,2,3,271862,271863,271866,1,4,0
77663,1,1,271863,271866,271867,3,4,0
77664,6,2,271869,271869,271871,0,2,2
77665,6,3,271875,271875,271878,0,3,4
77666,4,1,271879,271879,271880,0,1,1
77667,2,1,271881,271881,271882,0,1,1
77668,2,3,271883,271883,271886,0,3,1
77669,4,2,271887,271887,271889,0,2,1
77670,5,1,271892,271892,271893,0,1,3
77671,3,1,271895,271895,271896,0,1,2
77672,3,1,271898,271898,271899,0,1,2
77673,3,2,271901,271901,271903,0,2,2
77674,1,2,271902,271903,271905,1,3,0
77675,5,1,271907,271907,271908,0,1,2
77676,3,3,271910,271910,271913,0,3,2
77677,3,1,271913,271913,271914,0,1,0
77678,2,1,271915,271915,271916,0,1,1
77679,5,3,271920,271920,271923,0,3,4
77680,2,3,271922,271923,271926,1,4,0
77681,4,1,271926,271926,271927,0,1,0
77682,4,1,271930,271930,271931,0,1,3
77683,2,2,271932,271932,271934,0,2,1
77684,5,1,271937,271937,271938,0,1,3
77685,5,2,271942,271942,271944,0,2,4
77686,5,1,271947,271947,271948,0,1,3
77687,4,2,271951,271951,271953,0,2,3
77688,4,3,271955,271955,271958,0,3,2
77689,3,3,271958,271958,271961,0,3,0
77690,2,1,271960,271961,271962,1,2,0
77691,3,3,271963,271963,271966,0,3,1
77692,2,1,271965,271966,271967,1,2,0
77693,4,2,271969,271969,271971,0,2,2
77694,2,1,271971,271971,271972,0,1,0
77695,5,1,271976,271976,271977,0,1,4
77696,4,1,271980,271980,271981,0,1,3
77697,2,3,271982,271982,271985,0,3,1
77698,6,2,271988,271988,271990,0,2,3
77699,6,3,271994,271994,271997,0,3,4
77700,5,2,271999,271999,272001,0,2,2
77701,6,2,272005,272005,272007,0,2,4
77702,6,3,272011,272011,272014,0,3,4
77703,4,2,272015,272015,272017,0,2,1
77704,1,3,272016,272017,272020,1,4,0
77705,4,1,272020,272020,272021,0,1,0
77706,5,1,272025,272025,272026,0,1,4
77707,2,3,272027,272027,272030,0,3,1
77708,4,1,272031,272031,272032,0,1,1
77709,1,2,272032,272032,272034,0,2,0
77710,5,2,272037,272037,272039,0,2,3
77711,6,1,272043,272043,272044,0,1,4
77712,3,3,272046,272046,272049,0,3,2
77713,5,2,272051,272051,272053,0,2,2
77714,1,1,272052,272053,272054,1,2,0
77715,1,2,272053,272054,272056,1,3,0
77716,2,2,272055,272056,272058,1,3,0
77717,1,2,272056,272058,272060,2,4,0
77718,2,3,272058,272060,272063,2,5,0
77719,3,1,272061,272063,272064,2,3,0
77720,3,2,272064,272064,272066,0,2,0
77721,5,3,272069,272069,272072,0,3,3
77722,3,3,272072,272072,272075,0,3,0
77723,4,2,272076,272076,272078,0,2,1
77724,3,2,272079,272079,272081,0,2,1
77725,6,2,272085,272085,272087,0,2,4
77726,5,2,272090,272090,272092,0,2,3
77727,1,2,272091,272092,272094,1,3,0
77728,4,1,272095,272095,272096,0,1,1
77729,3,2,272098,272098,272100,0,2,2
77730,3,2,272101,272101,272103,0,2,1
77731,1,3,272102,272103,272106,1,4,0
77732,6,3,272108,272108,272111,0,3,2
77733,3,2,272111,272111,272113,0,2,0
77734,5,1,272116,272116,272117,0,1,3
77735,1,2,272117,272117,272119,0,2,0
77736,4,3,272121,272121,272124,0,3,2
77737,6,2,272127,272127,272129,0,2,3
77738,2,1,272129,272129,272130,0,1,0
77739,6,2,272135,272135,272137,0,2,5
77740,5,2,272140,272140,272142,0,2,3
77741,2,3,272142,272142,272145,0,3,0
77742,1,2,272143,272145,272147,2,4,0
77743,6,1,272149,272149,272150,0,1,2
77744,4,2,272153,272153,272155,0,2,3
77745,2,1,272155,272155,272156,0,1,0
77746,3,3,272158,272158,272161,0,3,2
77747,3,1,272161,272161,272162,0,1,0
77748,6,3,272167,272167,272170,0,3,5
77749,3,3,272170,272170,272173,0,3,0
77750,5,3,272175,272175,272178,0,3,2
77751,4,2,272179,272179,272181,0,2,1
77752,1,2,272180,272181,272183,1,3,0
77753,6,1,272186,272186,272187,0,1,3
77754,1,3,272187,272187,272190,0,3,0
77755,2,2,272189,272190,272192,1,3,0
77756,3,1,272192,272192,272193,0,1,0
77757,5,3,272197,272197,272200,0,3,4
77758,3,2,272200,272200,272202,0,2,0
77759,1,3,272201,272202,272205,1,4,0
77760,4,2,272205,272205,272207,0,2,0
77761,4,2,272209,272209,272211,0,2,2
77762,2,3,272211,272211,272214,0,3,0
77763,4,3,272215,272215,272218,0,3,1
77764,3,2,272218,272218,272220,0,2,0
77765,1,2,272219,272220,272222,1,3,0
77766,4,3,272223,272223,272226,0,3,1
77767,2,3,272225,272226,272229,1,4,0
77768,3,3,272228,272229,272232,1,4,0
77769,1,3,272229,272232,272235,3,6,0
77770,5,1,272234,272235,272236,1,2,0
77771,4,2,272238,272238,272240,0,2,2
77772,4,3,272242,272242,272245,0,3,2
77773,2,2,272244,272245,272247,1,3,0
77774,4,1,272248,272248,272249,0,1,1
77775,3,3,272251,272251,272254,0,3,2
77776,3,3,272254,272254,272257,0,3,0
77777,4,1,272258,272258,272259,0,1,1
77778,2,3,272260,272260,272263,0,3,1
77779,3,3,272263,272263,272266,0,3,0
77780,2,2,272265,272266,272268,1,3,0
77781,4,1,272269,272269,272270,0,1,1
77782,2,3,272271,272271,272274,0,3,1
77783,5,1,272276,272276,272277,0,1,2
77784,3,1,272279,272279,272280,0,1,2
77785,3,3,272282,272282,272285,0,3,2
77786,4,2,272286,272286,272288,0,2,1
77787,1,3,272287,272288,272291,1,4,0
77788,1,3,272288,272291,272294,3,6,0
77789,3,3,272291,272294,272297,3,6,0
77790,1,3,272292,272297,272300,5,8,0
77791,1,1,272293,272300,272301,7,8,0
77792,6,1,272299,272301,272302,2,3,0
77793,2,2,272301,272302,272304,1,3,0
77794,5,1,272306,272306,272307,0,1,2
77795,1,1,272307,272307,272308,0,1,0
77796,6,2,272313,272313,272315,0,2,5
77797,2,2,272315,272315,272317,0,2,0
77798,4,2,272319,272319,272321,0,2,2
77799,2,3,272321,272321,272324,0,3,0
77800,5,2,272326,272326,272328,0,2,2
77801,1,2,272327,272328,272330,1,3,0
77802,6,1,272333,272333,272334,0,1,3
77803,2,3,272335,272335,272338,0,3,1
77804,1,3,272336,272338,272341,2,5,0
77805,5,1,272341,272341,272342,0,1,0
77806,6,1,272347,272347,272348,0,1,5
77807,5,2,272352,272352,272354,0,2,4
77808,4,1,272356,272356,272357,0,1,2
77809,5,1,272361,272361,272362,0,1,4
77810,2,2,272363,272363,272365,0,2,1
77811,2,2,272365,272365,272367,0,2,0
77812,5,1,272370,272370,272371,0,1,3
77813,4,3,272374,272374,272377,0,3,3
77814,6,1,272380,272380,272381,0,1,3
77815,2,3,272382,272382,272385,0,3,1
77816,2,2,272384,272385,272387,1,3,0
77817,6,1,272390,272390,272391,0,1,3
77818,4,3,272394,272394,272397,0,3,3
77819,1,2,272395,272397,272399,2,4,0
77820,3,1,272398,272399,272400,1,2,0
77821,3,1,272401,272401,272402,0,1,1
77822,3,3,272404,272404,272407,0,3,2
77823,1,3,272405,272407,272410,2,5,0
77824,2,2,272407,272410,272412,3,5,0
77825,6,2,272413,272413,272415,0,2,1
77826,4,2,272417,272417,272419,0,2,2
77827,4,2,272421,272421,272423,0,2,2
77828,4,1,272425,272425,272426,0,1,2
77829,5,2,272430,272430,272432,0,2,4
77830,3,3,272433,272433,272436,0,3,1
77831,6,1,272439,272439,272440,0,1,3
77832,6,1,272445,272445,272446,0,1,5
77833,6,2,272451,272451,272453,0,2,5
77834,5,3,272456,272456,272459,0,3,3
77835,6,2,272462,272462,272464,0,2,3
77836,1,1,272463,272464,272465,1,2,0
77837,5,3,272468,272468,272471,0,3,3
77838,4,3,272472,272472,272475,0,3,1
77839,2,1,272474,272475,272476,1,2,0
77840,5,1,272479,272479,272480,0,1,3
77841,2,2,272481,272481,272483,0,2,1
77842,2,1,272483,272483,272484,0,1,0
77843,2,1,272485,272485,272486,0,1,1
77844,2,2,272487,272487,272489,0,2,1
77845,6,3,272493,272493,272496,0,3,4
77846,5,1,272498,272498,272499,0,1,2
77847,3,3,272501,272501,272504,0,3,2
77848,6,1,272507,272507,272508,0,1,3
77849,2,3,272509,272509,272512,0,3,1
77850,1,3,272510,272512,272515,2,5,0
77851,3,1,272513,272515,272516,2,3,0
77852,3,2,272516,272516,272518,0,2,0
77853,3,2,272519,272519,272521,0,2,1
77854,3,3,272522,272522,272525,0,3,1
77855,3,1,272525,272525,272526,0,1,0
77856,1,2,272526,272526,272528,0,2,0
77857,6,3,272532,272532,272535,0,3,4
77858,6,2,272538,272538,272540,0,2,3
77859,6,1,272544,272544,272545,0,1,4
77860,1,3,272545,272545,272548,0,3,0
77861,3,2,272548,272548,272550,0,2,0
77862,5,2,272553,272553,272555,0,2,3
77863,4,3,272557,272557,272560,0,3,2
77864,2,2,272559,272560,272562,1,3,0
77865,1,1,272560,272562,272563,2,3,0
77866,4,1,272564,272564,272565,0,1,1
77867,2,3,272566,272566,272569,0,3,1
77868,6,2,272572,272572,272574,0,2,3
77869,6,3,272578,272578,272581,0,3,4
77870,3,1,272581,272581,272582,0,1,0
77871,6,2,272587,272587,272589,0,2,5
77872,6,1,272593,272593,272594,0,1,4
77873,2,2,272595,272595,272597,0,2,1
77874,3,2,272598,272598,272600,0,2,1
77875,1,1,272599,272600,272601,1,2,0
77876,2,1,272601,272601,272602,0,1,0
77877,3,2,272604,272604,272606,0,2,2
77878,6,3,272610,272610,272613,0,3,4
77879,6,1,272616,272616,272617,0,1,3
77880,6,3,272622,272622,272625,0,3,5
77881,4,1,272626,272626,272627,0,1,1
77882,5,2,272631,272631,272633,0,2,4
77883,4,1,272635,272635,272636,0,1,2
77884,3,3,272638,272638,272641,0,3,2
77885,4,2,272642,272642,272644,0,2,1
77886,4,3,272646,272646,272649,0,3,2
77887,3,2,272649,272649,272651,0,2,0
77888,2,3,272651,272651,272654,0,3,0
77889,4,2,272655,272655,272657,0,2,1
77890,5,2,272660,272660,272662,0,2,3
77891,3,1,272663,272663,272664,0,1,1
77892,2,1,272665,272665,272666,0,1,1
77893,3,3,272668,272668,272671,0,3,2
77894,6,1,272674,272674,272675,0,1,3
77895,6,2,272680,272680,272682,0,2,5
77896,4,3,272684,272684,272687,0,3,2
77897,3,3,272687,272687,272690,0,3,0
77898,4,3,272691,272691,272694,0,3,1
77899,6,3,272697,272697,272700,0,3,3
77900,6,1,272703,272703,272704,0,1,3
77901,4,2,272707,272707,272709,0,2,3
77902,1,2,272708,272709,272711,1,3,0
77903,4,1,272712,272712,272713,0,1,1
77904,6,3,272718,272718,272721,0,3,5
77905,2,1,272720,272721,272722,1,2,0
77906,5,2,272725,272725,272727,0,2,3
77907,1,1,272726,272727,272728,1,2,0
77908,3,3,272729,272729,272732,0,3,1
77909,2,1,272731,272732,272733,1,2,0
77910,4,3,272735,272735,272738,0,3,2
77911,5,1,272740,272740,272741,0,1,2
77912,2,1,272742,272742,272743,0,1,1
77913,2,3,272744,272744,272747,0,3,1
77914,5,3,272749,272749,272752,0,3,2
77915,6,2,272755,272755,272757,0,2,3
77916,4,2,272759,272759,272761,0,2,2
77917,1,2,272760,272761,272763,1,3,0
77918,5,3,272765,272765,272768,0,3,2
77919,6,3,272771,272771,272774,0,3,3
77920,6,1,272777,272777,272778,0,1,3
77921,1,2,272778,272778,272780,0,2,0
77922,4,3,272782,272782,272785,0,3,2
77923,2,3,272784,272785,272788,1,4,0
77924,2,1,272786,272788,272789,2,3,0
77925,2,3,272788,272789,272792,1,4,0
77926,3,2,272791,272792,272794,1,3,0
77927,4,2,272795,272795,272797,0,2,1
77928,1,2,272796,272797,272799,1,3,0
77929,2,2,272798,272799,272801,1,3,0
77930,3,2,272801,272801,272803,0,2,0
77931,2,2,272803,272803,272805,0,2,0
77932,6,3,272809,272809,272812,0,3,4
77933,3,3,272812,272812,272815,0,3,0
77934,2,3,272814,272815,272818,1,4,0
77935,2,1,272816,272818,272819,2,3,0
77936,3,3,272819,272819,272822,0,3,0
77937,1,2,272820,272822,272824,2,4,0
77938,2,3,272822,272824,272827,2,5,0
77939,2,2,272824,272827,272829,3,5,0
77940,6,3,272830,272830,272833,0,3,1
77941,1,3,272831,272833,272836,2,5,0
77942,1,1,272832,272836,272837,4,5,0
77943,6,2,272838,272838,272840,0,2,1
77944,1,1,272839,272840,272841,1,2,0
77945,4,3,272843,272843,272846,0,3,2
77946,3,3,272846,272846,272849,0,3,0
77947,5,1,272851,272851,272852,0,1,2
77948,2,1,272853,272853,272854,0,1,1
77949,6,1,272859,272859,272860,0,1,5
77950,1,2,272860,272860,272862,0,2,0
77951,5,1,272865,272865,272866,0,1,3
77952,6,2,272871,272871,272873,0,2,5
77953,3,2,272874,272874,272876,0,2,1
77954,5,2,272879,272879,272881,0,2,3
77955,5,1,272884,272884,272885,0,1,3
77956,1,1,272885,272885,272886,0,1,0
77957,4,2,272889,272889,272891,0,2,3
77958,4,3,272893,272893,272896,0,3,2
77959,4,1,272897,272897,272898,0,1,1
77960,5,3,272902,272902,272905,0,3,4
77961,6,3,272908,272908,272911,0,3,3
77962,4,3,272912,272912,272915,0,3,1
77963,2,1,272914,272915,272916,1,2,0
77964,2,3,272916,272916,272919,0,3,0
77965,4,1,272920,272920,272921,0,1,1
77966,1,3,272921,272921,272924,0,3,0
77967,6,2,272927,272927,272929,0,2,3
77968,4,3,272931,272931,272934,0,3,2
77969,5,2,272936,272936,272938,0,2,2
77970,6,1,272942,272942,272943,0,1,4
77971,1,2,272943,272943,272945,0,2,0
77972,1,3,272944,272945,272948,1,4,0
77973,4,3,272948,272948,272951,0,3,0
77974,4,3,272952,272952,272955,0,3,1
77975,4,2,272956,272956,272958,0,2,1
77976,3,2,272959,272959,272961,0,2,1
77977,6,1,272965,272965,272966,0,1,4
77978,6,3,272971,272971,272974,0,3,5
77979,1,1,272972,272974,272975,2,3,0
77980,4,3,272976,272976,272979,0,3,1
77981,4,2,272980,272980,272982,0,2,1
77982,4,2,272984,272984,272986,0,2,2
77983,2,2,272986,272986,272988,0,2,0
77984,5,3,272991,272991,272994,0,3,3
77985,3,3,272994,272994,272997,0,3,0
77986,5,3,272999,272999,273002,0,3,2
77987,4,2,273003,273003,273005,0,2,1
77988,1,3,273004,273005,273008,1,4,0
77989,3,1,273007,273008,273009,1,2,0
77990,1,3,273008,273009,273012,1,4,0
77991,6,2,273014,273014,273016,0,2,2
77992,2,2,273016,273016,273018,0,2,0
77993,4,2,273020,273020,273022,0,2,2
77994,2,1,273022,273022,273023,0,1,0
77995,4,3,273026,273026,273029,0,3,3
77996,1,2,273027,273029,273031,2,4,0
77997,5,3,273032,273032,273035,0,3,1
77998,5,1,273037,273037,273038,0,1,2
77999,6,2,273043,273043,273045,0,2,5
78000,3,2,273046,273046,273048,0,2,1
78001,5,1,273051,273051,273052,0,1,3
78002,2,1,273053,273053,273054,0,1,1
78003,5,1,273058,273058,273059,0,1,4
78004,3,3,273061,273061,273064,0,3,2
78005,5,1,273066,273066,273067,0,1,2
78006,2,3,273068,273068,273071,0,3,1
78007,5,3,273073,273073,273076,0,3,2
78008,4,3,273077,273077,273080,0,3,1
78009,5,3,273082,273082,273085,0,3,2
78010,1,2,273083,273085,273087,2,4,0
78011,1,2,273084,273087,273089,3,5,0
78012,1,3,273085,273089,273092,4,7,0
78013,6,1,273091,273092,273093,1,2,0
78014,5,1,273096,273096,273097,0,1,3
78015,6,2,273102,273102,273104,0,2,5
78016,3,2,273105,273105,273107,0,2,1
78017,3,2,273108,273108,273110,0,2,1
78018,2,2,273110,273110,273112,0,2,0
78019,5,1,273115,273115,273116,0,1,3
78020,6,2,273121,273121,273123,0,2,5
78021,4,1,273125,273125,273126,0,1,2
78022,4,3,273129,273129,273132,0,3,3
78023,6,3,273135,273135,273138,0,3,3
78024,3,1,273138,273138,273139,0,1,0
78025,6,3,273144,273144,273147,0,3,5
78026,6,1,273150,273150,273151,0,1,3
78027,4,1,273154,273154,273155,0,1,3
78028,4,2,273158,273158,273160,0,2,3
78029,5,2,273163,273163,273165,0,2,3
78030,3,2,273166,273166,273168,0,2,1
78031,1,2,273167,273168,273170,1,3,0
78032,6,1,273173,273173,273174,0,1,3
78033,2,3,273175,273175,273178,0,3,1
78034,4,2,273179,273179,273181,0,2,1
78035,6,1,273185,273185,273186,0,1,4
78036,4,2,273189,273189,273191,0,2,3
78037,3,2,273192,273192,273194,0,2,1
78038,5,1,273197,273197,273198,0,1,3
78039,6,1,273203,273203,273204,0,1,5
78040,3,3,273206,273206,273209,0,3,2
78041,5,3,273211,273211,273214,0,3,2
78042,3,2,273214,273214,273216,0,2,0
78043,5,3,273219,273219,273222,0,3,3
78044,5,2,273224,273224,273226,0,2,2
78045,5,1,273229,273229,273230,0,1,3
78046,4,3,273233,273233,273236,0,3,3
78047,6,2,273239,273239,273241,0,2,3
78048,5,3,273244,273244,273247,0,3,3
78049,2,3,273246,273247,273250,1,4,0
78050,3,2,273249,273250,273252,1,3,0
78051,1,2,273250,273252,273254,2,4,0
78052,4,2,273254,273254,273256,0,2,0
78053,3,2,273257,273257,273259,0,2,1
78054,6,1,273263,273263,273264,0,1,4
78055,3,1,273266,273266,273267,0,1,2
78056,3,2,273269,273269,273271,0,2,2
78057,4,1,273273,273273,273274,0,1,2
78058,2,2,273275,273275,273277,0,2,1
78059,3,2,273278,273278,273280,0,2,1
78060,4,1,273282,273282,273283,0,1,2
78061,3,2,273285,273285,273287,0,2,2
78062,2,3,273287,273287,273290,0,3,0
78063,6,3,273293,273293,273296,0,3,3
78064,4,3,273297,273297,273300,0,3,1
78065,1,3,273298,273300,273303,2,5,0
78066,4,1,273302,273303,273304,1,2,0
78067,1,2,273303,273304,273306,1,3,0
78068,4,2,273307,273307,273309,0,2,1
78069,6,3,273313,273313,273316,0,3,4
78070,6,3,273319,273319,273322,0,3,3
78071,5,1,273324,273324,273325,0,1,2
78072,1,3,273325,273325,273328,0,3,0
78073,3,2,273328,273328,273330,0,2,0
78074,6,1,273334,273334,273335,0,1,4
78075,2,2,273336,273336,273338,0,2,1
78076,1,3,273337,273338,273341,1,4,0
78077,3,2,273340,273341,273343,1,3,0
78078,2,3,273342,273343,273346,1,4,0
78079,4,2,273346,273346,273348,0,2,0
78080,4,1,273350,273350,273351,0,1,2
78081,4,3,273354,273354,273357,0,3,3
78082,3,3,273357,273357,273360,0,3,0
78083,5,3,273362,273362,273365,0,3,2
78084,3,1,273365,273365,273366,0,1,0
78085,6,1,273371,273371,273372,0,1,5
78086,2,3,273373,273373,273376,0,3,1
78087,1,1,273374,273376,273377,2,3,0
78088,6,1,273380,273380,273381,0,1,3
78089,1,2,273381,273381,273383,0,2,0
78090,2,3,273383,273383,273386,0,3,0
78091,4,3,273387,273387,273390,0,3,1
78092,4,2,273391,273391,273393,0,2,1
78093,2,3,273393,273393,273396,0,3,0
78094,3,2,273396,273396,273398,0,2,0
78095,2,1,273398,273398,273399,0,1,0
78096,2,2,273400,273400,273402,0,2,1
78097,4,2,273404,273404,273406,0,2,2
78098,1,3,273405,273406,273409,1,4,0
78099,4,3,273409,273409,273412,0,3,0
78100,5,2,273414,273414,273416,0,2,2
78101,1,2,273415,273416,273418,1,3,0
78102,3,2,273418,273418,273420,0,2,0
78103,3,3,273421,273421,273424,0,3,1
78104,1,2,273422,273424,273426,2,4,0
78105,6,3,273428,273428,273431,0,3,2
78106,6,3,273434,273434,273437,0,3,3
78107,3,2,273437,273437,273439,0,2,0
78108,6,2,273443,273443,273445,0,2,4
78109,2,2,273445,273445,273447,0,2,0
78110,6,2,273451,273451,273453,0,2,4
78111,5,3,273456,273456,273459,0,3,3
78112,3,2,273459,273459,273461,0,2,0
78113,1,2,273460,273461,273463,1,3,0
78114,5,2,273465,273465,273467,0,2,2
78115,2,3,273467,273467,273470,0,3,0
78116,4,1,273471,273471,273472,0,1,1
78117,4,2,273475,273475,273477,0,2,3
78118,3,2,273478,273478,273480,0,2,1
78119,2,3,273480,273480,273483,0,3,0
78120,2,1,273482,273483,273484,1,2,0
78121,1,3,273483,273484,273487,1,4,0
78122,3,1,273486,273487,273488,1,2,0
78123,2,2,273488,273488,273490,0,2,0
78124,3,1,273491,273491,273492,0,1,1
78125,2,3,273493,273493,273496,0,3,1
78126,3,3,273496,273496,273499,0,3,0
78127,3,1,273499,273499,273500,0,1,0
78128,1,2,273500,273500,273502,0,2,0
78129,1,2,273501,273502,273504,1,3,0
78130,3,1,273504,273504,273505,0,1,0
78131,5,2,273509,273509,273511,0,2,4
78132,6,3,273515,273515,273518,0,3,4
78133,1,3,273516,273518,273521,2,5,0
78134,3,3,273519,273521,273524,2,5,0
78135,2,2,273521,273524,273526,3,5,0
78136,6,3,273527,273527,273530,0,3,1
78137,5,2,273532,273532,273534,0,2,2
78138,5,1,273537,273537,273538,0,1,3
78139,6,1,273543,273543,273544,0,1,5
78140,5,2,273548,273548,273550,0,2,4
78141,2,1,273550,273550,273551,0,1,0
78142,4,2,273554,273554,273556,0,2,3
78143,4,2,273558,273558,273560,0,2,2
78144,4,2,273562,273562,273564,0,2,2
78145,2,2,273564,273564,273566,0,2,0
78146,5,3,273569,273569,273572,0,3,3
78147,3,3,273572,273572,273575,0,3,0
78148,1,2,273573,273575,273577,2,4,0
78149,1,1,273574,273577,273578,3,4,0
78150,1,1,273575,273578,273579,3,4,0
78151,5,1,273580,273580,273581,0,1,1
78152,6,2,273586,273586,273588,0,2,5
78153,1,2,273587,273588,273590,1,3,0
78154,1,2,273588,273590,273592,2,4,0
78155,4,3,273592,273592,273595,0,3,0
78156,3,1,273595,273595,273596,0,1,0
78157,6,2,273601,273601,273603,0,2,5
78158,1,3,273602,273603,273606,1,4,0
78159,5,1,273607,273607,273608,0,1,1
78160,5,2,273612,273612,273614,0,2,4
78161,4,3,273616,273616,273619,0,3,2
78162,4,3,273620,273620,273623,0,3,1
78163,6,1,273626,273626,273627,0,1,3
78164,5,2,273631,273631,273633,0,2,4
78165,5,1,273636,273636,273637,0,1,3
78166,3,3,273639,273639,273642,0,3,2
78167,2,1,273641,273642,273643,1,2,0
78168,5,1,273646,273646,273647,0,1,3
78169,4,2,273650,273650,273652,0,2,3
78170,3,1,273653,273653,273654,0,1,1
78171,6,3,273659,273659,273662,0,3,5
78172,2,1,273661,273662,273663,1,2,0
78173,5,1,273666,273666,273667,0,1,3
78174,2,1,273668,273668,273669,0,1,1
78175,3,1,273671,273671,273672,0,1,2
78176,2,3,273673,273673,273676,0,3,1
78177,6,1,273679,273679,273680,0,1,3
78178,3,3,273682,273682,273685,0,3,2
78179,2,1,273684,273685,273686,1,2,0
78180,5,3,273689,273689,273692,0,3,3
78181,5,3,273694,273694,273697,0,3,2
78182,6,2,273700,273700,273702,0,2,3
78183,3,3,273703,273703,273706,0,3,1
78184,4,2,273707,273707,273709,0,2,1
78185,5,3,273712,273712,273715,0,3,3
78186,3,3,273715,273715,273718,0,3,0
78187,5,1,273720,273720,273721,0,1,2
78188,5,3,273725,273725,273728,0,3,4
78189,3,2,273728,273728,273730,0,2,0
78190,5,2,273733,273733,273735,0,2,3
78191,3,2,273736,273736,273738,0,2,1
78192,5,1,273741,273741,273742,0,1,3
78193,3,2,273744,273744,273746,0,2,2
78194,4,2,273748,273748,273750,0,2,2
78195,1,2,273749,273750,273752,1,3,0
78196,5,2,273754,273754,273756,0,2,2
78197,6,2,273760,273760,273762,0,2,4
78198,2,3,273762,273762,273765,0,3,0
78199,3,3,273765,273765,273768,0,3,0
78200,5,3,273770,273770,273773,0,3,2
78201,1,2,273771,273773,273775,2,4,0
78202,4,1,273775,273775,273776,0,1,0
78203,3,3,273778,273778,273781,0,3,2
78204,2,1,273780,273781,273782,1,2,0
78205,2,2,273782,273782,273784,0,2,0
78206,5,2,273787,273787,273789,0,2,3
78207,6,3,273793,273793,273796,0,3,4
78208,3,1,273796,273796,273797,0,1,0
78209,5,3,273801,273801,273804,0,3,4
78210,4,2,273805,273805,273807,0,2,1
78211,4,2,273809,273809,273811,0,2,2
78212,3,3,273812,273812,273815,0,3,1
78213,3,2,273815,273815,273817,0,2,0
78214,4,2,273819,273819,273821,0,2,2
78215,3,3,273822,273822,273825,0,3,1
78216,5,1,273827,273827,273828,0,1,2
78217,5,3,273832,273832,273835,0,3,4
78218,3,3,273835,273835,273838,0,3,0
78219,3,3,273838,273838,273841,0,3,0
78220,3,2,273841,273841,273843,0,2,0
78221,4,3,273845,273845,273848,0,3,2
78222,6,1,273851,273851,273852,0,1,3
78223,5,2,273856,273856,273858,0,2,4
78224,2,1,273858,273858,273859,0,1,0
78225,6,3,273864,273864,273867,0,3,5
78226,3,1,273867,273867,273868,0,1,0
78227,1,1,273868,273868,273869,0,1,0
78228,4,2,273872,273872,273874,0,2,3
78229,2,2,273874,273874,273876,0,2,0
78230,2,1,273876,273876,273877,0,1,0
78231,3,3,273879,273879,273882,0,3,2
78232,3,3,273882,273882,273885,0,3,0
78233,2,3,273884,273885,273888,1,4,0
78234,6,1,273890,273890,273891,0,1,2
78235,3,2,273893,273893,273895,0,2,2
78236,1,3,273894,273895,273898,1,4,0
78237,5,1,273899,273899,273900,0,1,1
78238,1,2,273900,273900,273902,0,2,0
78239,4,2,273904,273904,273906,0,2,2
78240,1,3,273905,273906,273909,1,4,0
78241,5,3,273910,273910,273913,0,3,1
78242,3,1,273913,273913,273914,0,1,0
78243,3,1,273916,273916,273917,0,1,2
78244,5,1,273921,273921,273922,0,1,4
78245,3,3,273924,273924,273927,0,3,2
78246,4,3,273928,273928,273931,0,3,1
78247,1,3,273929,273931,273934,2,5,0
78248,2,2,273931,273934,273936,3,5,0
78249,5,1,273936,273936,273937,0,1,0
78250,5,1,273941,273941,273942,0,1,4
78251,5,2,273946,273946,273948,0,2,4
78252,4,3,273950,273950,273953,0,3,2
78253,1,3,273951,273953,273956,2,5,0
78254,2,1,273953,273956,273957,3,4,0
78255,1,3,273954,273957,273960,3,6,0
78256,6,3,273960,273960,273963,0,3,0
78257,6,2,273966,273966,273968,0,2,3
78258,5,3,273971,273971,273974,0,3,3
78259,2,1,273973,273974,273975,1,2,0
78260,2,1,273975,273975,273976,0,1,0
78261,5,3,273980,273980,273983,0,3,4
78262,5,2,273985,273985,273987,0,2,2
78263,1,1,273986,273987,273988,1,2,0
78264,4,1,273990,273990,273991,0,1,2
78265,1,1,273991,273991,273992,0,1,0
78266,6,3,273997,273997,274000,0,3,5
78267,1,3,273998,274000,274003,2,5,0
78268,1,3,273999,274003,274006,4,7,0
78269,5,3,274004,274006,274009,2,5,0
78270,5,2,274009,274009,274011,0,2,0
78271,4,1,274013,274013,274014,0,1,2
78272,1,3,274014,274014,274017,0,3,0
78273,4,2,274018,274018,274020,0,2,1
78274,5,2,274023,274023,274025,0,2,3
78275,5,3,274028,274028,274031,0,3,3
78276,2,2,274030,274031,274033,1,3,0
78277,1,1,274031,274033,274034,2,3,0
78278,5,3,274036,274036,274039,0,3,2
78279,6,2,274042,274042,274044,0,2,3
78280,3,2,274045,274045,274047,0,2,1
78281,3,2,274048,274048,274050,0,2,1
78282,2,3,274050,274050,274053,0,3,0
78283,4,2,274054,274054,274056,0,2,1
78284,5,1,274059,274059,274060,0,1,3
78285,5,2,274064,274064,274066,0,2,4
78286,3,2,274067,274067,274069,0,2,1
78287,5,1,274072,274072,274073,0,1,3
78288,1,3,274073,274073,274076,0,3,0
78289,4,2,274077,274077,274079,0,2,1
78290,6,2,274083,274083,274085,0,2,4
78291,5,3,274088,274088,274091,0,3,3
78292,3,1,274091,274091,274092,0,1,0
78293,1,1,274092,274092,274093,0,1,0
78294,3,3,274095,274095,274098,0,3,2
78295,4,2,274099,274099,274101,0,2,1
78296,3,2,274102,274102,274104,0,2,1
78297,4,2,274106,274106,274108,0,2,2
78298,2,3,274108,274108,274111,0,3,0
78299,1,1,274109,274111,274112,2,3,0
78300,4,3,274113,274113,274116,0,3,1
78301,3,1,274116,274116,274117,0,1,0
78302,2,2,274118,274118,274120,0,2,1
78303,5,2,274123,274123,274125,0,2,3
78304,6,1,274129,274129,274130,0,1,4
78305,5,1,274134,274134,274135,0,1,4
78306,2,1,274136,274136,274137,0,1,1
78307,2,2,274138,274138,274140,0,2,1
78308,5,2,274143,274143,274145,0,2,3
78309,5,2,274148,274148,274150,0,2,3
78310,4,3,274152,274152,274155,0,3,2
78311,5,1,274157,274157,274158,0,1,2
78312,2,3,274159,274159,274162,0,3,1
78313,1,2,274160,274162,274164,2,4,0
78314,2,2,274162,274164,274166,2,4,0
78315,4,1,274166,274166,274167,0,1,0
78316,4,3,274170,274170,274173,0,3,3
78317,2,2,274172,274173,274175,1,3,0
78318,6,1,274178,274178,274179,0,1,3
78319,4,3,274182,274182,274185,0,3,3
78320,1,2,274183,274185,274187,2,4,0
78321,2,3,274185,274187,274190,2,5,0
78322,6,1,274191,274191,274192,0,1,1
78323,1,1,274192,274192,274193,0,1,0
78324,4,2,274196,274196,274198,0,2,3
78325,6,1,274202,274202,274203,0,1,4
78326,2,1,274204,274204,274205,0,1,1
78327,1,1,274205,274205,274206,0,1,0
78328,3,2,274208,274208,274210,0,2,2
78329,1,3,274209,274210,274213,1,4,0
78330,6,2,274215,274215,274217,0,2,2
78331,5,1,274220,274220,274221,0,1,3
78332,5,3,274225,274225,274228,0,3,4
78333,1,3,274226,274228,274231,2,5,0
78334,1,2,274227,274231,274233,4,6,0
78335,4,2,274231,274233,274235,2,4,0
78336,4,2,274235,274235,274237,0,2,0
78337,3,2,274238,274238,274240,0,2,1
78338,4,2,274242,274242,274244,0,2,2
78339,3,1,274245,274245,274246,0,1,1
78340,5,1,274250,274250,274251,0,1,4
78341,3,2,274253,274253,274255,0,2,2
78342,6,3,274259,274259,274262,0,3,4
78343,4,1,274263,274263,274264,0,1,1
78344,3,2,274266,274266,274268,0,2,2
78345,2,2,274268,274268,274270,0,2,0
78346,3,2,274271,274271,274273,0,2,1
78347,6,3,274277,274277,274280,0,3,4
78348,6,3,274283,274283,274286,0,3,3
78349,2,1,274285,274286,274287,1,2,0
78350,6,1,274291,274291,274292,0,1,4
78351,5,1,274296,274296,274297,0,1,4
78352,6,1,274302,274302,274303,0,1,5
78353,1,2,274303,274303,274305,0,2,0
78354,3,2,274306,274306,274308,0,2,1
78355,3,3,274309,274309,274312,0,3,1
78356,5,1,274314,274314,274315,0,1,2
78357,6,3,274320,274320,274323,0,3,5
78358,6,2,274326,274326,274328,0,2,3
78359,2,1,274328,274328,274329,0,1,0
78360,3,1,274331,274331,274332,0,1,2
78361,2,1,274333,274333,274334,0,1,1
78362,5,3,274338,274338,274341,0,3,4
78363,1,3,274339,274341,274344,2,5,0
78364,3,1,274342,274344,274345,2,3,0
78365,6,1,274348,274348,274349,0,1,3
78366,1,2,274349,274349,274351,0,2,0
78367,3,1,274352,274352,274353,0,1,1
78368,6,3,274358,274358,274361,0,3,5
78369,6,2,274364,274364,274366,0,2,3
78370,6,3,274370,274370,274373,0,3,4
78371,6,2,274376,274376,274378,0,2,3
78372,3,3,274379,274379,274382,0,3,1
78373,3,2,274382,274382,274384,0,2,0
78374,5,3,274387,274387,274390,0,3,3
78375,1,1,274388,274390,274391,2,3,0
78376,6,3,274394,274394,274397,0,3,3
78377,2,1,274396,274397,274398,1,2,0
78378,6,3,274402,274402,274405,0,3,4
78379,3,2,274405,274405,274407,0,2,0
78380,3,3,274408,274408,274411,0,3,1
78381,1,3,274409,274411,274414,2,5,0
78382,3,1,274412,274414,274415,2,3,0
78383,3,1,274415,274415,274416,0,1,0
78384,4,1,274419,274419,274420,0,1,3
78385,6,3,274425,274425,274428,0,3,5
78386,4,2,274429,274429,274431,0,2,1
78387,3,1,274432,274432,274433,0,1,1
78388,6,2,274438,274438,274440,0,2,5
78389,4,1,274442,274442,274443,0,1,2
78390,1,1,274443,274443,274444,0,1,0
78391,5,2,274448,274448,274450,0,2,4
78392,4,1,274452,274452,274453,0,1,2
78393,2,2,274454,274454,274456,0,2,1
78394,4,3,274458,274458,274461,0,3,2
78395,6,2,274464,274464,274466,0,2,3
78396,5,3,274469,274469,274472,0,3,3
78397,1,2,274470,274472,274474,2,4,0
78398,4,3,274474,274474,274477,0,3,0
78399,1,3,274475,274477,274480,2,5,0
78400,1,1,274476,274480,274481,4,5,0
78401,5,1,274481,274481,274482,0,1,0
78402,1,3,274482,274482,274485,0,3,0
78403,6,2,274488,274488,274490,0,2,3
78404,6,2,274494,274494,274496,0,2,4
78405,2,1,274496,274496,274497,0,1,0
78406,3,1,274499,274499,274500,0,1,2
78407,4,2,274503,274503,274505,0,2,3
78408,4,1,274507,274507,274508,0,1,2
78409,4,3,274511,274511,274514,0,3,3
78410,4,2,274515,274515,274517,0,2,1
78411,3,2,274518,274518,274520,0,2,1
78412,3,2,274521,274521,274523,0,2,1
78413,2,1,274523,274523,274524,0,1,0
78414,4,1,274527,274527,274528,0,1,3
78415,5,2,274532,274532,274534,0,2,4
78416,5,3,274537,274537,274540,0,3,3
78417,4,2,274541,274541,274543,0,2,1
78418,5,3,274546,274546,274549,0,3,3
78419,4,3,274550,274550,274553,0,3,1
78420,1,3,274551,274553,274556,2,5,0
78421,1,3,274552,274556,274559,4,7,0
78422,5,1,274557,274559,274560,2,3,0
78423,3,1,274560,274560,274561,0,1,0
78424,5,3,274565,274565,274568,0,3,4
78425,1,3,274566,274568,274571,2,5,0
78426,5,3,274571,274571,274574,0,3,0
78427,6,2,274577,274577,274579,0,2,3
78428,4,3,274581,274581,274584,0,3,2
78429,3,2,274584,274584,274586,0,2,0
78430,3,2,274587,274587,274589,0,2,1
78431,4,2,274591,274591,274593,0,2,2
78432,5,2,274596,274596,274598,0,2,3
78433,6,2,274602,274602,274604,0,2,4
78434,6,3,274608,274608,274611,0,3,4
78435,1,3,274609,274611,274614,2,5,0
78436,1,3,274610,274614,274617,4,7,0
78437,5,3,274615,274617,274620,2,5,0
78438,3,3,274618,274620,274623,2,5,0
78439,5,3,274623,274623,274626,0,3,0
78440,5,1,274628,274628,274629,0,1,2
78441,1,1,274629,274629,274630,0,1,0
78442,1,3,274630,274630,274633,0,3,0
78443,6,3,274636,274636,274639,0,3,3
78444,1,2,274637,274639,274641,2,4,0
78445,2,1,274639,274641,274642,2,3,0
78446,2,1,274641,274642,274643,1,2,0
78447,6,3,274647,274647,274650,0,3,4
78448,5,3,274652,274652,274655,0,3,2
78449,3,3,274655,274655,274658,0,3,0
78450,3,1,274658,274658,274659,0,1,0
78451,1,3,274659,274659,274662,0,3,0
78452,4,2,274663,274663,274665,0,2,1
78453,6,3,274669,274669,274672,0,3,4
78454,1,3,274670,274672,274675,2,5,0
78455,4,3,274674,274675,274678,1,4,0
78456,2,3,274676,274678,274681,2,5,0
78457,4,1,274680,274681,274682,1,2,0
78458,4,2,274684,274684,274686,0,2,2
78459,2,1,274686,274686,274687,0,1,0
78460,4,3,274690,274690,274693,0,3,3
78461,4,2,274694,274694,274696,0,2,1
78462,5,1,274699,274699,274700,0,1,3
78463,1,1,274700,274700,274701,0,1,0
78464,1,1,274701,274701,274702,0,1,0
78465,3,1,274704,274704,274705,0,1,2
78466,1,1,274705,274705,274706,0,1,0
78467,1,3,274706,274706,274709,0,3,0
78468,4,3,274710,274710,274713,0,3,1
78469,1,2,274711,274713,274715,2,4,0
78470,2,2,274713,274715,274717,2,4,0
78471,1,2,274714,274717,274719,3,5,0
78472,5,1,274719,274719,274720,0,1,0
78473,6,3,274725,274725,274728,0,3,5
78474,6,1,274731,274731,274732,0,1,3
78475,4,2,274735,274735,274737,0,2,3
78476,4,1,274739,274739,274740,0,1,2
78477,6,1,274745,274745,274746,0,1,5
78478,3,1,274748,274748,274749,0,1,2
78479,6,2,274754,274754,274756,0,2,5
78480,6,2,274760,274760,274762,0,2,4
78481,1,2,274761,274762,274764,1,3,0
78482,6,3,274767,274767,274770,0,3,3
78483,4,3,274771,274771,274774,0,3,1
78484,2,3,274773,274774,274777,1,4,0
78485,3,3,274776,274777,274780,1,4,0
78486,1,1,274777,274780,274781,3,4,0
78487,6,3,274783,274783,274786,0,3,2
78488,4,3,274787,274787,274790,0,3,1
78489,3,1,274790,274790,274791,0,1,0
78490,2,3,274792,274792,274795,0,3,1
78491,1,3,274793,274795,274798,2,5,0
78492,4,3,274797,274798,274801,1,4,0
78493,3,3,274800,274801,274804,1,4,0
78494,4,3,274804,274804,274807,0,3,0
78495,3,1,274807,274807,274808,0,1,0
78496,5,3,274812,274812,274815,0,3,4
78497,5,3,274817,274817,274820,0,3,2
78498,6,2,274823,274823,274825,0,2,3
78499,4,2,274827,274827,274829,0,2,2
78500,5,3,274832,274832,274835,0,3,3
78501,2,1,274834,274835,274836,1,2,0
78502,5,3,274839,274839,274842,0,3,3
78503,1,2,274840,274842,274844,2,4,0
78504,3,3,274843,274844,274847,1,4,0
78505,5,1,274848,274848,274849,0,1,1
78506,2,2,274850,274850,274852,0,2,1
78507,4,3,274854,274854,274857,0,3,2
78508,1,1,274855,274857,274858,2,3,0
78509,4,1,274859,274859,274860,0,1,1
78510,5,2,274864,274864,274866,0,2,4
78511,3,2,274867,274867,274869,0,2,1
78512,5,1,274872,274872,274873,0,1,3
78513,4,1,274876,274876,274877,0,1,3
78514,5,3,274881,274881,274884,0,3,4
78515,5,3,274886,274886,274889,0,3,2
78516,2,1,274888,274889,274890,1,2,0
78517,5,2,274893,274893,274895,0,2,3
78518,6,3,274899,274899,274902,0,3,4
78519,3,1,274902,274902,274903,0,1,0
78520,3,1,274905,274905,274906,0,1,2
78521,6,3,274911,274911,274914,0,3,5
78522,3,2,274914,274914,274916,0,2,0
78523,1,3,274915,274916,274919,1,4,0
78524,4,3,274919,274919,274922,0,3,0
78525,3,2,274922,274922,274924,0,2,0
78526,4,2,274926,274926,274928,0,2,2
78527,1,3,274927,274928,274931,1,4,0
78528,6,3,274933,274933,274936,0,3,2
78529,2,3,274935,274936,274939,1,4,0
78530,4,2,274939,274939,274941,0,2,0
78531,2,1,274941,274941,274942,0,1,0
78532,2,2,274943,274943,274945,0,2,1
78533,3,2,274946,274946,274948,0,2,1
78534,5,2,274951,274951,274953,0,2,3
78535,1,1,274952,274953,274954,1,2,0
78536,2,1,274954,274954,274955,0,1,0
78537,5,1,274959,274959,274960,0,1,4
78538,1,1,274960,274960,274961,0,1,0
78539,2,1,274962,274962,274963,0,1,1
78540,2,1,274964,274964,274965,0,1,1
78541,5,1,274969,274969,274970,0,1,4
78542,4,1,274973,274973,274974,0,1,3
78543,6,3,274979,274979,274982,0,3,5
78544,4,2,274983,274983,274985,0,2,1
78545,1,2,274984,274985,274987,1,3,0
78546,5,2,274989,274989,274991,0,2,2
78547,4,3,274993,274993,274996,0,3,2
78548,2,3,274995,274996,274999,1,4,0
78549,1,1,274996,274999,275000,3,4,0
78550,1,3,274997,275000,275003,3,6,0
78551,4,3,275001,275003,275006,2,5,0
78552,1,1,275002,275006,275007,4,5,0
78553,5,3,275007,275007,275010,0,3,0
78554,1,3,275008,275010,275013,2,5,0
78555,2,3,275010,275013,275016,3,6,0
78556,6,1,275016,275016,275017,0,1,0
78557,5,1,275021,275021,275022,0,1,4
78558,6,1,275027,275027,275028,0,1,5
78559,5,2,275032,275032,275034,0,2,4
78560,6,1,275038,275038,275039,0,1,4
78561,3,3,275041,275041,275044,0,3,2
78562,5,2,275046,275046,275048,0,2,2
78563,2,3,275048,275048,275051,0,3,0
78564,5,1,275053,275053,275054,0,1,2
78565,2,1,275055,275055,275056,0,1,1
78566,4,1,275059,275059,275060,0,1,3
78567,5,2,275064,275064,275066,0,2,4
78568,4,3,275068,275068,275071,0,3,2
78569,5,2,275073,275073,275075,0,2,2
78570,6,3,275079,275079,275082,0,3,4
78571,4,2,275083,275083,275085,0,2,1
78572,4,1,275087,275087,275088,0,1,2
78573,5,2,275092,275092,275094,0,2,4
78574,2,1,275094,275094,275095,0,1,0
78575,1,2,275095,275095,275097,0,2,0
78576,3,1,275098,275098,275099,0,1,1
78577,3,3,275101,275101,275104,0,3,2
78578,1,3,275102,275104,275107,2,5,0
78579,6,3,275108,275108,275111,0,3,1
78580,2,2,275110,275111,275113,1,3,0
78581,3,2,275113,275113,275115,0,2,0
78582,1,1,275114,275115,275116,1,2,0
78583,5,3,275119,275119,275122,0,3,3
78584,2,1,275121,275122,275123,1,2,0
78585,4,1,275125,275125,275126,0,1,2
78586,4,1,275129,275129,275130,0,1,3
78587,5,1,275134,275134,275135,0,1,4
78588,4,2,275138,275138,275140,0,2,3
78589,4,2,275142,275142,275144,0,2,2
78590,5,1,275147,275147,275148,0,1,3
78591,6,1,275153,275153,275154,0,1,5
78592,1,2,275154,275154,275156,0,2,0
78593,3,2,275157,275157,275159,0,2,1
78594,3,2,275160,275160,275162,0,2,1
78595,2,3,275162,275162,275165,0,3,0
78596,3,1,275165,275165,275166,0,1,0
78597,5,1,275170,275170,275171,0,1,4
78598,2,1,275172,275172,275173,0,1,1
78599,6,2,275178,275178,275180,0,2,5
78600,1,3,275179,275180,275183,1,4,0
78601,3,1,275182,275183,275184,1,2,0
78602,1,2,275183,275184,275186,1,3,0
78603,2,2,275185,275186,275188,1,3,0
78604,6,2,275191,275191,275193,0,2,3
78605,2,1,275193,275193,275194,0,1,0
78606,1,1,275194,275194,275195,0,1,0
78607,3,1,275197,275197,275198,0,1,2
78608,6,1,275203,275203,275204,0,1,5
78609,2,2,275205,275205,275207,0,2,1
78610,4,2,275209,275209,275211,0,2,2
78611,4,1,275213,275213,275214,0,1,2
78612,6,3,275219,275219,275222,0,3,5
78613,6,3,275225,275225,275228,0,3,3
78614,2,2,275227,275228,275230,1,3,0
78615,4,2,275231,275231,275233,0,2,1
78616,6,3,275237,275237,275240,0,3,4
78617,5,1,275242,275242,275243,0,1,2
78618,6,3,275248,275248,275251,0,3,5
78619,1,1,275249,275251,275252,2,3,0
78620,1,1,275250,275252,275253,2,3,0
78621,6,2,275256,275256,275258,0,2,3
78622,6,1,275262,275262,275263,0,1,4
78623,4,1,275266,275266,275267,0,1,3
78624,5,3,275271,275271,275274,0,3,4
78625,1,3,275272,275274,275277,2,5,0
78626,3,2,275275,275277,275279,2,4,0
78627,6,1,275281,275281,275282,0,1,2
78628,3,2,275284,275284,275286,0,2,2
78629,4,2,275288,275288,275290,0,2,2
78630,1,2,275289,275290,275292,1,3,0
78631,1,1,275290,275292,275293,2,3,0
78632,4,2,275294,275294,275296,0,2,1
78633,3,2,275297,275297,275299,0,2,1
78634,2,2,275299,275299,275301,0,2,0
78635,3,2,275302,275302,275304,0,2,1
78636,2,1,275304,275304,275305,0,1,0
78637,1,1,275305,275305,275306,0,1,0
78638,2,1,275307,275307,275308,0,1,1
78639,2,3,275309,275309,275312,0,3,1
78640,4,3,275313,275313,275316,0,3,1
78641,4,2,275317,275317,275319,0,2,1
78642,6,2,275323,275323,275325,0,2,4
78643,5,1,275328,275328,275329,0,1,3
78644,3,3,275331,275331,275334,0,3,2
78645,2,3,275333,275334,275337,1,4,0
78646,6,3,275339,275339,275342,0,3,2
78647,5,1,275344,275344,275345,0,1,2
78648,5,1,275349,275349,275350,0,1,4
78649,3,3,275352,275352,275355,0,3,2
78650,4,1,275356,275356,275357,0,1,1
78651,4,3,275360,275360,275363,0,3,3
78652,3,1,275363,275363,275364,0,1,0
78653,2,3,275365,275365,275368,0,3,1
78654,4,3,275369,275369,275372,0,3,1
78655,6,2,275375,275375,275377,0,2,3
78656,6,1,275381,275381,275382,0,1,4
78657,6,1,275387,275387,275388,0,1,5
78658,5,2,275392,275392,275394,0,2,4
78659,6,2,275398,275398,275400,0,2,4
78660,6,1,275404,275404,275405,0,1,4
78661,5,1,275409,275409,275410,0,1,4
78662,4,3,275413,275413,275416,0,3,3
78663,1,2,275414,275416,275418,2,4,0
78664,3,2,275417,275418,275420,1,3,0
78665,2,2,275419,275420,275422,1,3,0
78666,2,1,275421,275422,275423,1,2,0
78667,2,3,275423,275423,275426,0,3,0
78668,5,1,275428,275428,275429,0,1,2
78669,1,1,275429,275429,275430,0,1,0
78670,3,3,275432,275432,275435,0,3,2
78671,2,2,275434,275435,275437,1,3,0
78672,3,1,275437,275437,275438,0,1,0
78673,3,2,275440,275440,275442,0,2,2
78674,3,2,275443,275443,275445,0,2,1
78675,1,1,275444,275445,275446,1,2,0
78676,2,1,275446,275446,275447,0,1,0
78677,5,3,275451,275451,275454,0,3,4
78678,6,1,275457,275457,275458,0,1,3
78679,5,3,275462,275462,275465,0,3,4
78680,4,3,275466,275466,275469,0,3,1
78681,1,2,275467,275469,275471,2,4,0
78682,2,2,275469,275471,275473,2,4,0
78683,4,3,275473,275473,275476,0,3,0
78684,2,2,275475,275476,275478,1,3,0
78685,5,3,275480,275480,275483,0,3,2
78686,6,2,275486,275486,275488,0,2,3
78687,3,1,275489,275489,275490,0,1,1
78688,3,3,275492,275492,275495,0,3,2
78689,2,3,275494,275495,275498,1,4,0
78690,6,2,275500,275500,275502,0,2,2
78691,2,2,275502,275502,275504,0,2,0
78692,3,3,275505,275505,275508,0,3,1
78693,5,2,275510,275510,275512,0,2,2
78694,1,3,275511,275512,275515,1,4,0
78695,1,3,275512,275515,275518,3,6,0
78696,5,1,275517,275518,275519,1,2,0
78697,6,3,275523,275523,275526,0,3,4
78698,1,2,275524,275526,275528,2,4,0
78699,2,2,275526,275528,275530,2,4,0
78700,6,3,275532,275532,275535,0,3,2
78701,3,2,275535,275535,275537,0,2,0
78702,6,2,275541,275541,275543,0,2,4
78703,5,3,275546,275546,275549,0,3,3
78704,6,3,275552,275552,275555,0,3,3
78705,5,3,275557,275557,275560,0,3,2
78706,5,2,275562,275562,275564,0,2,2
78707,1,1,275563,275564,275565,1,2,0
78708,5,3,275568,275568,275571,0,3,3
78709,3,1,275571,275571,275572,0,1,0
78710,4,3,275575,275575,275578,0,3,3
78711,3,1,275578,275578,275579,0,1,0
78712,3,1,275581,275581,275582,0,1,2
78713,1,1,275582,275582,275583,0,1,0
78714,6,2,275588,275588,275590,0,2,5
78715,6,3,275594,275594,275597,0,3,4
78716,1,2,275595,275597,275599,2,4,0
78717,4,3,275599,275599,275602,0,3,0
78718,4,3,275603,275603,275606,0,3,1
78719,2,3,275605,275606,275609,1,4,0
78720,6,3,275611,275611,275614,0,3,2
78721,5,3,275616,275616,275619,0,3,2
78722,3,1,275619,275619,275620,0,1,0
78723,2,2,275621,275621,275623,0,2,1
78724,1,3,275622,275623,275626,1,4,0
78725,5,1,275627,275627,275628,0,1,1
78726,2,1,275629,275629,275630,0,1,1
78727,3,2,275632,275632,275634,0,2,2
78728,4,2,275636,275636,275638,0,2,2
78729,5,3,275641,275641,275644,0,3,3
78730,2,1,275643,275644,275645,1,2,0
78731,2,1,275645,275645,275646,0,1,0
78732,5,2,275650,275650,275652,0,2,4
78733,3,3,275653,275653,275656,0,3,1
78734,5,3,275658,275658,275661,0,3,2
78735,2,2,275660,275661,275663,1,3,0
78736,3,1,275663,275663,275664,0,1,0
78737,2,3,275665,275665,275668,0,3,1
78738,3,1,275668,275668,275669,0,1,0
78739,4,1,275672,275672,275673,0,1,3
78740,2,3,275674,275674,275677,0,3,1
78741,2,3,275676,275677,275680,1,4,0
78742,3,1,275679,275680,275681,1,2,0
78743,3,3,275682,275682,275685,0,3,1
78744,4,1,275686,275686,275687,0,1,1
78745,6,2,275692,275692,275694,0,2,5
78746,4,1,275696,275696,275697,0,1,2
78747,6,1,275702,275702,275703,0,1,5
78748,2,2,275704,275704,275706,0,2,1
78749,5,2,275709,275709,275711,0,2,3
78750,4,2,275713,275713,275715,0,2,2
78751,6,1,275719,275719,275720,0,1,4
78752,5,2,275724,275724,275726,0,2,4
78753,2,1,275726,275726,275727,0,1,0
78754,2,1,275728,275728,275729,0,1,1
78755,2,3,275730,275730,275733,0,3,1
78756,3,2,275733,275733,275735,0,2,0
78757,6,2,275739,275739,275741,0,2,4
78758,4,3,275743,275743,275746,0,3,2
78759,6,1,275749,275749,275750,0,1,3
78760,1,2,275750,275750,275752,0,2,0
78761,6,2,275756,275756,275758,0,2,4
78762,5,3,275761,275761,275764,0,3,3
78763,2,3,275763,275764,275767,1,4,0
78764,5,3,275768,275768,275771,0,3,1
78765,4,3,275772,275772,275775,0,3,1
78766,4,3,275776,275776,275779,0,3,1
78767,6,2,275782,275782,275784,0,2,3
78768,5,1,275787,275787,275788,0,1,3
78769,5,1,275792,275792,275793,0,1,4
78770,4,1,275796,275796,275797,0,1,3
78771,3,3,275799,275799,275802,0,3,2
78772,3,3,275802,275802,275805,0,3,0
78773,5,2,275807,275807,275809,0,2,2
78774,3,2,275810,275810,275812,0,2,1
78775,4,2,275814,275814,275816,0,2,2
78776,6,2,275820,275820,275822,0,2,4
78777,1,1,275821,275822,275823,1,2,0
78778,5,3,275826,275826,275829,0,3,3
78779,6,3,275832,275832,275835,0,3,3
78780,6,2,275838,275838,275840,0,2,3
78781,4,2,275842,275842,275844,0,2,2
78782,3,1,275845,275845,275846,0,1,1
78783,2,3,275847,275847,275850,0,3,1
78784,2,1,275849,275850,275851,1,2,0
78785,2,1,275851,275851,275852,0,1,0
78786,3,2,275854,275854,275856,0,2,2
78787,4,2,275858,275858,275860,0,2,2
78788,6,2,275864,275864,275866,0,2,4
78789,4,2,275868,275868,275870,0,2,2
78790,1,2,275869,275870,275872,1,3,0
78791,3,1,275872,275872,275873,0,1,0
78792,3,1,275875,275875,275876,0,1,2
78793,3,1,275878,275878,275879,0,1,2
78794,5,3,275883,275883,275886,0,3,4
78795,3,2,275886,275886,275888,0,2,0
78796,5,1,275891,275891,275892,0,1,3
78797,1,3,275892,275892,275895,0,3,0
78798,4,3,275896,275896,275899,0,3,1
78799,4,2,275900,275900,275902,0,2,1
78800,2,2,275902,275902,275904,0,2,0
78801,5,2,275907,275907,275909,0,2,3
78802,3,3,275910,275910,275913,0,3,1
78803,2,2,275912,275913,275915,1,3,0
78804,4,1,275916,275916,275917,0,1,1
78805,3,1,275919,275919,275920,0,1,2
78806,2,3,275921,275921,275924,0,3,1
78807,2,1,275923,275924,275925,1,2,0
78808,4,3,275927,275927,275930,0,3,2
78809,3,3,275930,275930,275933,0,3,0
78810,6,1,275936,275936,275937,0,1,3
78811,5,3,275941,275941,275944,0,3,4
78812,4,1,275945,275945,275946,0,1,1
78813,2,2,275947,275947,275949,0,2,1
78814,5,3,275952,275952,275955,0,3,3
78815,5,2,275957,275957,275959,0,2,2
78816,6,1,275963,275963,275964,0,1,4
78817,4,1,275967,275967,275968,0,1,3
78818,3,1,275970,275970,275971,0,1,2
78819,1,1,275971,275971,275972,0,1,0
78820,6,2,275977,275977,275979,0,2,5
78821,1,3,275978,275979,275982,1,4,0
78822,6,2,275984,275984,275986,0,2,2
78823,5,1,275989,275989,275990,0,1,3
78824,5,2,275994,275994,275996,0,2,4
78825,2,2,275996,275996,275998,0,2,0
78826,1,2,275997,275998,276000,1,3,0
78827,6,3,276003,276003,276006,0,3,3
78828,6,2,276009,276009,276011,0,2,3
78829,6,2,276015,276015,276017,0,2,4
78830,5,3,276020,276020,276023,0,3,3
78831,3,3,276023,276023,276026,0,3,0
78832,3,3,276026,276026,276029,0,3,0
78833,4,2,276030,276030,276032,0,2,1
78834,1,3,276031,276032,276035,1,4,0
78835,3,3,276034,276035,276038,1,4,0
78836,6,2,276040,276040,276042,0,2,2
78837,6,2,276046,276046,276048,0,2,4
78838,2,1,276048,276048,276049,0,1,0
78839,6,3,276054,276054,276057,0,3,5
78840,4,2,276058,276058,276060,0,2,1
78841,6,1,276064,276064,276065,0,1,4
78842,3,1,276067,276067,276068,0,1,2
78843,4,3,276071,276071,276074,0,3,3
78844,6,3,276077,276077,276080,0,3,3
78845,6,3,276083,276083,276086,0,3,3
78846,1,3,276084,276086,276089,2,5,0
78847,1,3,276085,276089,276092,4,7,0
78848,3,2,276088,276092,276094,4,6,0
78849,5,1,276093,276094,276095,1,2,0
78850,1,2,276094,276095,276097,1,3,0
78851,4,1,276098,276098,276099,0,1,1
78852,3,3,276101,276101,276104,0,3,2
78853,3,3,276104,276104,276107,0,3,0
78854,6,3,276110,276110,276113,0,3,3
78855,6,1,276116,276116,276117,0,1,3
78856,3,3,276119,276119,276122,0,3,2
78857,2,2,276121,276122,276124,1,3,0
78858,6,3,276127,276127,276130,0,3,3
78859,6,2,276133,276133,276135,0,2,3
78860,5,1,276138,276138,276139,0,1,3
78861,5,2,276143,276143,276145,0,2,4
78862,1,2,276144,276145,276147,1,3,0
78863,3,3,276147,276147,276150,0,3,0
78864,1,1,276148,276150,276151,2,3,0
78865,5,2,276153,276153,276155,0,2,2
78866,6,3,276159,276159,276162,0,3,4
78867,3,1,276162,276162,276163,0,1,0
78868,4,2,276166,276166,276168,0,2,3
78869,5,3,276171,276171,276174,0,3,3
78870,2,1,276173,276174,276175,1,2,0
78871,5,2,276178,276178,276180,0,2,3
78872,4,1,276182,276182,276183,0,1,2
78873,4,1,276186,276186,276187,0,1,3
78874,3,1,276189,276189,276190,0,1,2
78875,4,1,276193,276193,276194,0,1,3
78876,6,3,276199,276199,276202,0,3,5
78877,1,1,276200,276202,276203,2,3,0
78878,2,2,276202,276203,276205,1,3,0
78879,3,3,276205,276205,276208,0,3,0
78880,1,2,276206,276208,276210,2,4,0
78881,1,1,276207,276210,276211,3,4,0
78882,3,1,276210,276211,276212,1,2,0
78883,1,1,276211,276212,276213,1,2,0
78884,3,2,276214,276214,276216,0,2,1
78885,6,2,276220,276220,276222,0,2,4
78886,3,1,276223,276223,276224,0,1,1
78887,5,3,276228,276228,276231,0,3,4
78888,5,3,276233,276233,276236,0,3,2
78889,2,1,276235,276236,276237,1,2,0
78890,4,2,276239,276239,276241,0,2,2
78891,5,3,276244,276244,276247,0,3,3
78892,6,2,276250,276250,276252,0,2,3
78893,3,2,276253,276253,276255,0,2,1
78894,6,2,276259,276259,276261,0,2,4
78895,3,1,276262,276262,276263,0,1,1
78896,6,3,276268,276268,276271,0,3,5
78897,5,2,276273,276273,276275,0,2,2
78898,1,3,276274,276275,276278,1,4,0
78899,5,1,276279,276279,276280,0,1,1
78900,5,3,276284,276284,276287,0,3,4
78901,2,3,276286,276287,276290,1,4,0
78902,2,2,276288,276290,276292,2,4,0
78903,3,3,276291,276292,276295,1,4,0
78904,3,2,276294,276295,276297,1,3,0
78905,4,1,276298,276298,276299,0,1,1
78906,1,2,276299,276299,276301,0,2,0
78907,3,2,276302,276302,276304,0,2,1
78908,1,1,276303,276304,276305,1,2,0
78909,3,1,276306,276306,276307,0,1,1
78910,6,2,276312,276312,276314,0,2,5
78911,3,1,276315,276315,276316,0,1,1
78912,6,2,276321,276321,276323,0,2,5
78913,6,2,276327,276327,276329,0,2,4
78914,6,2,276333,276333,276335,0,2,4
78915,4,1,276337,276337,276338,0,1,2
78916,4,3,276341,276341,276344,0,3,3
78917,1,1,276342,276344,276345,2,3,0
78918,1,1,276343,276345,276346,2,3,0
78919,4,2,276347,276347,276349,0,2,1
78920,3,2,276350,276350,276352,0,2,1
78921,1,3,276351,276352,276355,1,4,0
78922,6,3,276357,276357,276360,0,3,2
78923,6,3,276363,276363,276366,0,3,3
78924,4,3,276367,276367,276370,0,3,1
78925,2,3,276369,276370,276373,1,4,0
78926,5,3,276374,276374,276377,0,3,1
78927,1,3,276375,276377,276380,2,5,0
78928,5,2,276380,276380,276382,0,2,0
78929,2,2,276382,276382,276384,0,2,0
78930,5,3,276387,276387,276390,0,3,3
78931,6,1,276393,276393,276394,0,1,3
78932,3,1,276396,276396,276397,0,1,2
78933,1,2,276397,276397,276399,0,2,0
78934,6,2,276403,276403,276405,0,2,4
78935,2,2,276405,276405,276407,0,2,0
78936,5,2,276410,276410,276412,0,2,3
78937,6,1,276416,276416,276417,0,1,4
78938,4,2,276420,276420,276422,0,2,3
78939,6,3,276426,276426,276429,0,3,4
78940,1,2,276427,276429,276431,2,4,0
78941,2,1,276429,276431,276432,2,3,0
78942,5,2,276434,276434,276436,0,2,2
78943,5,3,276439,276439,276442,0,3,3
78944,6,1,276445,276445,276446,0,1,3
78945,3,3,276448,276448,276451,0,3,2
78946,2,2,276450,276451,276453,1,3,0
78947,5,3,276455,276455,276458,0,3,2
78948,3,2,276458,276458,276460,0,2,0
78949,4,3,276462,276462,276465,0,3,2
78950,3,3,276465,276465,276468,0,3,0
78951,6,1,276471,276471,276472,0,1,3
78952,4,1,276475,276475,276476,0,1,3
78953,5,1,276480,276480,276481,0,1,4
78954,2,3,276482,276482,276485,0,3,1
78955,3,3,276485,276485,276488,0,3,0
78956,3,1,276488,276488,276489,0,1,0
78957,6,1,276494,276494,276495,0,1,5
78958,5,3,276499,276499,276502,0,3,4
78959,1,1,276500,276502,276503,2,3,0
78960,2,1,276502,276503,276504,1,2,0
78961,3,1,276505,276505,276506,0,1,1
78962,6,2,276511,276511,276513,0,2,5
78963,5,3,276516,276516,276519,0,3,3
78964,4,2,276520,276520,276522,0,2,1
78965,6,3,276526,276526,276529,0,3,4
78966,4,1,276530,276530,276531,0,1,1
78967,3,2,276533,276533,276535,0,2,2
78968,4,1,276537,276537,276538,0,1,2
78969,1,2,276538,276538,276540,0,2,0
78970,6,1,276544,276544,276545,0,1,4
78971,1,3,276545,276545,276548,0,3,0
78972,4,1,276549,276549,276550,0,1,1
78973,2,3,276551,276551,276554,0,3,1
78974,1,2,276552,276554,276556,2,4,0
78975,4,1,276556,276556,276557,0,1,0
78976,1,1,276557,276557,276558,0,1,0
78977,5,2,276562,276562,276564,0,2,4
78978,6,2,276568,276568,276570,0,2,4
78979,3,2,276571,276571,276573,0,2,1
78980,5,1,276576,276576,276577,0,1,3
78981,3,3,276579,276579,276582,0,3,2
78982,3,2,276582,276582,276584,0,2,0
78983,1,3,276583,276584,276587,1,4,0
78984,5,3,276588,276588,276591,0,3,1
78985,1,2,276589,276591,276593,2,4,0
78986,2,1,276591,276593,276594,2,3,0
78987,1,1,276592,276594,276595,2,3,0
78988,3,3,276595,276595,276598,0,3,0
78989,1,2,276596,276598,276600,2,4,0
78990,4,3,276600,276600,276603,0,3,0
78991,2,3,276602,276603,276606,1,4,0
78992,5,1,276607,276607,276608,0,1,1
78993,6,2,276613,276613,276615,0,2,5
78994,1,3,276614,276615,276618,1,4,0
78995,4,1,276618,276618,276619,0,1,0
78996,3,2,276621,276621,276623,0,2,2
78997,1,2,276622,276623,276625,1,3,0
78998,6,1,276628,276628,276629,0,1,3
78999,5,1,276633,276633,276634,0,1,4
79000,6,2,276639,276639,276641,0,2,5
79001,3,2,276642,276642,276644,0,2,1
79002,3,3,276645,276645,276648,0,3,1
79003,6,1,276651,276651,276652,0,1,3
79004,6,2,276657,276657,276659,0,2,5
79005,6,3,276663,276663,276666,0,3,4
79006,6,1,276669,276669,276670,0,1,3
79007,4,1,276673,276673,276674,0,1,3
79008,3,3,276676,276676,276679,0,3,2
79009,5,2,276681,276681,276683,0,2,2
79010,6,3,276687,276687,276690,0,3,4
79011,1,1,276688,276690,276691,2,3,0
79012,2,1,276690,276691,276692,1,2,0
79013,3,3,276693,276693,276696,0,3,1
79014,6,1,276699,276699,276700,0,1,3
79015,6,3,276705,276705,276708,0,3,5
79016,2,3,276707,276708,276711,1,4,0
79017,1,1,276708,276711,276712,3,4,0
79018,5,1,276713,276713,276714,0,1,1
79019,1,2,276714,276714,276716,0,2,0
79020,2,3,276716,276716,276719,0,3,0
79021,6,1,276722,276722,276723,0,1,3
79022,2,3,276724,276724,276727,0,3,1
79023,6,2,276730,276730,276732,0,2,3
79024,4,1,276734,276734,276735,0,1,2
79025,2,3,276736,276736,276739,0,3,1
79026,5,1,276741,276741,276742,0,1,2
79027,5,3,276746,276746,276749,0,3,4
79028,5,3,276751,276751,276754,0,3,2
79029,5,3,276756,276756,276759,0,3,2
79030,3,3,276759,276759,276762,0,3,0
79031,5,3,276764,276764,276767,0,3,2
79032,4,3,276768,276768,276771,0,3,1
79033,5,2,276773,276773,276775,0,2,2
79034,1,1,276774,276775,276776,1,2,0
79035,1,1,276775,276776,276777,1,2,0
79036,2,1,276777,276777,276778,0,1,0
79037,4,2,276781,276781,276783,0,2,3
79038,6,2,276787,276787,276789,0,2,4
79039,4,2,276791,276791,276793,0,2,2
79040,2,3,276793,276793,276796,0,3,0
79041,1,3,276794,276796,276799,2,5,0
79042,4,3,276798,276799,276802,1,4,0
79043,4,3,276802,276802,276805,0,3,0
79044,1,2,276803,276805,276807,2,4,0
79045,6,1,276809,276809,276810,0,1,2
79046,2,1,276811,276811,276812,0,1,1
79047,4,1,276815,276815,276816,0,1,3
79048,2,1,276817,276817,276818,0,1,1
79049,2,1,276819,276819,276820,0,1,1
79050,2,1,276821,276821,276822,0,1,1
79051,5,3,276826,276826,276829,0,3,4
79052,1,2,276827,276829,276831,2,4,0
79053,1,3,276828,276831,276834,3,6,0
79054,5,1,276833,276834,276835,1,2,0
79055,2,3,276835,276835,276838,0,3,0
79056,2,3,276837,276838,276841,1,4,0
79057,6,2,276843,276843,276845,0,2,2
79058,4,2,276847,276847,276849,0,2,2
79059,2,2,276849,276849,276851,0,2,0
79060,3,2,276852,276852,276854,0,2,1
79061,4,2,276856,276856,276858,0,2,2
79062,3,2,276859,276859,276861,0,2,1
79063,4,1,276863,276863,276864,0,1,2
79064,2,3,276865,276865,276868,0,3,1
79065,2,3,276867,276868,276871,1,4,0
79066,5,1,276872,276872,276873,0,1,1
79067,5,3,276877,276877,276880,0,3,4
79068,4,1,276881,276881,276882,0,1,1
79069,4,3,276885,276885,276888,0,3,3
79070,2,1,276887,276888,276889,1,2,0
79071,5,1,276892,276892,276893,0,1,3
79072,3,1,276895,276895,276896,0,1,2
79073,4,3,276899,276899,276902,0,3,3
79074,1,1,276900,276902,276903,2,3,0
79075,6,2,276906,276906,276908,0,2,3
79076,3,2,276909,276909,276911,0,2,1
79077,3,1,276912,276912,276913,0,1,1
79078,1,1,276913,276913,276914,0,1,0
79079,3,1,276916,276916,276917,0,1,2
79080,6,3,276922,276922,276925,0,3,5
79081,4,2,276926,276926,276928,0,2,1
79082,4,1,276930,276930,276931,0,1,2
79083,5,2,276935,276935,276937,0,2,4
79084,4,3,276939,276939,276942,0,3,2
79085,5,2,276944,276944,276946,0,2,2
79086,6,2,276950,276950,276952,0,2,4
79087,5,3,276955,276955,276958,0,3,3
79088,1,3,276956,276958,276961,2,5,0
79089,6,2,276962,276962,276964,0,2,1
79090,1,1,276963,276964,276965,1,2,0
79091,2,1,276965,276965,276966,0,1,0
79092,1,2,276966,276966,276968,0,2,0
79093,4,2,276970,276970,276972,0,2,2
79094,1,1,276971,276972,276973,1,2,0
79095,1,3,276972,276973,276976,1,4,0
79096,3,2,276975,276976,276978,1,3,0
79097,3,2,276978,276978,276980,0,2,0
79098,5,3,276983,276983,276986,0,3,3
79099,4,1,276987,276987,276988,0,1,1
79100,5,1,276992,276992,276993,0,1,4
79101,5,1,276997,276997,276998,0,1,4
79102,5,1,277002,277002,277003,0,1,4
79103,5,1,277007,277007,277008,0,1,4
79104,5,2,277012,277012,277014,0,2,4
79105,4,1,277016,277016,277017,0,1,2
79106,2,2,277018,277018,277020,0,2,1
79107,3,1,277021,277021,277022,0,1,1
79108,3,2,277024,277024,277026,0,2,2
79109,4,2,277028,277028,277030,0,2,2
79110,5,2,277033,277033,277035,0,2,3
79111,6,3,277039,277039,277042,0,3,4
79112,1,1,277040,277042,277043,2,3,0
79113,2,2,277042,277043,277045,1,3,0
79114,3,1,277045,277045,277046,0,1,0
79115,5,3,277050,277050,277053,0,3,4
79116,5,1,277055,277055,277056,0,1,2
79117,1,3,277056,277056,277059,0,3,0
79118,6,2,277062,277062,277064,0,2,3
79119,4,1,277066,277066,277067,0,1,2
79120,5,2,277071,277071,277073,0,2,4
79121,5,2,277076,277076,277078,0,2,3
79122,3,2,277079,277079,277081,0,2,1
79123,3,1,277082,277082,277083,0,1,1
79124,1,1,277083,277083,277084,0,1,0
79125,6,3,277089,277089,277092,0,3,5
79126,3,1,277092,277092,277093,0,1,0
79127,4,3,277096,277096,277099,0,3,3
79128,6,2,277102,277102,277104,0,2,3
79129,1,1,277103,277104,277105,1,2,0
79130,1,2,277104,277105,277107,1,3,0
79131,3,1,277107,277107,277108,0,1,0
79132,4,1,277111,277111,277112,0,1,3
79133,4,2,277115,277115,277117,0,2,3
79134,3,2,277118,277118,277120,0,2,1
79135,4,1,277122,277122,277123,0,1,2
79136,1,1,277123,277123,277124,0,1,0
79137,1,3,277124,277124,277127,0,3,0
79138,3,3,277127,277127,277130,0,3,0
79139,1,3,277128,277130,277133,2,5,0
79140,2,2,277130,277133,277135,3,5,0
79141,4,3,277134,277135,277138,1,4,0
79142,6,1,277140,277140,277141,0,1,2
79143,4,2,277144,277144,277146,0,2,3
79144,2,1,277146,277146,277147,0,1,0
79145,3,2,277149,277149,277151,0,2,2
79146,4,3,277153,277153,277156,0,3,2
79147,6,3,277159,277159,277162,0,3,3
79148,5,3,277164,277164,277167,0,3,2
79149,6,1,277170,277170,277171,0,1,3
79150,2,1,277172,277172,277173,0,1,1
79151,6,1,277178,277178,277179,0,1,5
79152,4,2,277182,277182,277184,0,2,3
79153,3,2,277185,277185,277187,0,2,1
79154,6,1,277191,277191,277192,0,1,4
79155,1,1,277192,277192,277193,0,1,0
79156,5,2,277197,277197,277199,0,2,4
79157,6,3,277203,277203,277206,0,3,4
79158,1,2,277204,277206,277208,2,4,0
79159,3,1,277207,277208,277209,1,2,0
79160,6,3,277213,277213,277216,0,3,4
79161,2,1,277215,277216,277217,1,2,0
79162,3,1,277218,277218,277219,0,1,1
79163,3,3,277221,277221,277224,0,3,2
79164,1,1,277222,277224,277225,2,3,0
79165,3,3,277225,277225,277228,0,3,0
79166,2,3,277227,277228,277231,1,4,0
79167,4,3,277231,277231,277234,0,3,0
79168,3,2,277234,277234,277236,0,2,0
79169,6,1,277240,277240,277241,0,1,4
79170,1,2,277241,277241,277243,0,2,0
79171,5,3,277246,277246,277249,0,3,3
79172,5,2,277251,277251,277253,0,2,2
79173,6,1,277257,277257,277258,0,1,4
79174,3,2,277260,277260,277262,0,2,2
79175,5,2,277265,277265,277267,0,2,3
79176,6,1,277271,277271,277272,0,1,4
79177,6,2,277277,277277,277279,0,2,5
79178,3,2,277280,277280,277282,0,2,1
79179,3,2,277283,277283,277285,0,2,1
79180,2,2,277285,277285,277287,0,2,0
79181,1,1,277286,277287,277288,1,2,0
79182,5,3,277291,277291,277294,0,3,3
79183,5,1,277296,277296,277297,0,1,2
79184,2,2,277298,277298,277300,0,2,1
79185,2,3,277300,277300,277303,0,3,0
79186,6,2,277306,277306,277308,0,2,3
79187,6,1,277312,277312,277313,0,1,4
79188,5,1,277317,277317,277318,0,1,4
79189,5,1,277322,277322,277323,0,1,4
79190,4,3,277326,277326,277329,0,3,3
79191,6,2,277332,277332,277334,0,2,3
79192,2,3,277334,277334,277337,0,3,0
79193,6,1,277340,277340,277341,0,1,3
79194,1,3,277341,277341,277344,0,3,0
79195,2,1,277343,277344,277345,1,2,0
79196,5,2,277348,277348,277350,0,2,3
79197,5,3,277353,277353,277356,0,3,3
79198,6,3,277359,277359,277362,0,3,3
79199,5,3,277364,277364,277367,0,3,2
79200,3,3,277367,277367,277370,0,3,0
79201,2,3,277369,277370,277373,1,4,0
79202,4,2,277373,277373,277375,0,2,0
79203,1,2,277374,277375,277377,1,3,0
79204,6,2,277380,277380,277382,0,2,3
79205,6,2,277386,277386,277388,0,2,4
79206,6,1,277392,277392,277393,0,1,4
79207,4,2,277396,277396,277398,0,2,3
79208,2,2,277398,277398,277400,0,2,0
79209,4,1,277402,277402,277403,0,1,2
79210,1,1,277403,277403,277404,0,1,0
79211,3,1,277406,277406,277407,0,1,2
79212,3,3,277409,277409,277412,0,3,2
79213,4,2,277413,277413,277415,0,2,1
79214,4,3,277417,277417,277420,0,3,2
79215,5,2,277422,277422,277424,0,2,2
79216,6,2,277428,277428,277430,0,2,4
79217,5,1,277433,277433,277434,0,1,3
79218,3,3,277436,277436,277439,0,3,2
79219,1,2,277437,277439,277441,2,4,0
79220,2,2,277439,277441,277443,2,4,0
79221,6,3,277445,277445,277448,0,3,2
79222,6,2,277451,277451,277453,0,2,3
79223,2,1,277453,277453,277454,0,1,0
79224,3,1,277456,277456,277457,0,1,2
79225,5,3,277461,277461,277464,0,3,4
79226,4,1,277465,277465,277466,0,1,1
79227,4,2,277469,277469,277471,0,2,3
79228,5,3,277474,277474,277477,0,3,3
79229,3,3,277477,277477,277480,0,3,0
79230,2,2,277479,277480,277482,1,3,0
79231,4,1,277483,277483,277484,0,1,1
79232,1,2,277484,277484,277486,0,2,0
79233,6,2,277490,277490,277492,0,2,4
79234,3,1,277493,277493,277494,0,1,1
79235,2,1,277495,277495,277496,0,1,1
79236,1,2,277496,277496,277498,0,2,0
79237,1,2,277497,277498,277500,1,3,0
79238,1,3,277498,277500,277503,2,5,0
79239,4,3,277502,277503,277506,1,4,0
79240,4,3,277506,277506,277509,0,3,0
79241,5,3,277511,277511,277514,0,3,2
79242,6,2,277517,277517,277519,0,2,3
79243,5,1,277522,277522,277523,0,1,3
79244,3,2,277525,277525,277527,0,2,2
79245,6,2,277531,277531,277533,0,2,4
79246,3,3,277534,277534,277537,0,3,1
79247,1,3,277535,277537,277540,2,5,0
79248,1,3,277536,277540,277543,4,7,0
79249,3,1,277539,277543,277544,4,5,0
79250,1,2,277540,277544,277546,4,6,0
79251,6,2,277546,277546,277548,0,2,0
79252,1,3,277547,277548,277551,1,4,0
79253,1,1,277548,277551,277552,3,4,0
79254,1,3,277549,277552,277555,3,6,0
79255,1,1,277550,277555,277556,5,6,0
79256,1,2,277551,277556,277558,5,7,0
79257,6,3,277557,277558,277561,1,4,0
79258,6,3,277563,277563,277566,0,3,2
79259,4,3,277567,277567,277570,0,3,1
79260,6,2,277573,277573,277575,0,2,3
79261,5,3,277578,277578,277581,0,3,3
79262,4,2,277582,277582,277584,0,2,1
79263,1,2,277583,277584,277586,1,3,0
79264,2,1,277585,277586,277587,1,2,0
79265,3,2,277588,277588,277590,0,2,1
79266,2,3,277590,277590,277593,0,3,0
79267,4,3,277594,277594,277597,0,3,1
79268,1,1,277595,277597,277598,2,3,0
79269,4,2,277599,277599,277601,0,2,1
79270,6,3,277605,277605,277608,0,3,4
79271,5,1,277610,277610,277611,0,1,2
79272,3,2,277613,277613,277615,0,2,2
79273,4,2,277617,277617,277619,0,2,2
79274,6,3,277623,277623,277626,0,3,4
79275,2,2,277625,277626,277628,1,3,0
79276,1,3,277626,277628,277631,2,5,0
79277,3,3,277629,277631,277634,2,5,0
79278,4,3,277633,277634,277637,1,4,0
79279,6,3,277639,277639,277642,0,3,2
79280,1,3,277640,277642,277645,2,5,0
79281,4,2,277644,277645,277647,1,3,0
79282,3,2,277647,277647,277649,0,2,0
79283,2,3,277649,277649,277652,0,3,0
79284,3,2,277652,277652,277654,0,2,0
79285,2,3,277654,277654,277657,0,3,0
79286,6,3,277660,277660,277663,0,3,3
79287,2,3,277662,277663,277666,1,4,0
79288,4,2,277666,277666,277668,0,2,0
79289,6,3,277672,277672,277675,0,3,4
79290,4,3,277676,277676,277679,0,3,1
79291,1,2,277677,277679,277681,2,4,0
79292,5,2,277682,277682,277684,0,2,1
79293,5,3,277687,277687,277690,0,3,3
79294,1,3,277688,277690,277693,2,5,0
79295,5,3,277693,277693,277696,0,3,0
79296,3,1,277696,277696,277697,0,1,0
79297,4,1,277700,277700,277701,0,1,3
79298,3,3,277703,277703,277706,0,3,2
79299,5,1,277708,277708,277709,0,1,2
79300,1,1,277709,277709,277710,0,1,0
79301,6,1,277715,277715,277716,0,1,5
79302,3,1,277718,277718,277719,0,1,2
79303,6,1,277724,277724,277725,0,1,5
79304,1,3,277725,277725,277728,0,3,0
79305,3,2,277728,277728,277730,0,2,0
79306,4,3,277732,277732,277735,0,3,2
79307,2,3,277734,277735,277738,1,4,0
79308,4,2,277738,277738,277740,0,2,0
79309,5,3,277743,277743,277746,0,3,3
79310,2,3,277745,277746,277749,1,4,0
79311,1,2,277746,277749,277751,3,5,0
79312,2,1,277748,277751,277752,3,4,0
79313,4,3,277752,277752,277755,0,3,0
79314,1,2,277753,277755,277757,2,4,0
79315,5,2,277758,277758,277760,0,2,1
79316,4,2,277762,277762,277764,0,2,2
79317,5,2,277767,277767,277769,0,2,3
79318,5,1,277772,277772,277773,0,1,3
79319,6,3,277778,277778,277781,0,3,5
79320,1,2,277779,277781,277783,2,4,0
79321,4,2,277783,277783,277785,0,2,0
79322,3,2,277786,277786,277788,0,2,1
79323,3,1,277789,277789,277790,0,1,1
79324,5,2,277794,277794,277796,0,2,4
79325,3,3,277797,277797,277800,0,3,1
79326,4,3,277801,277801,277804,0,3,1
79327,2,1,277803,277804,277805,1,2,0
79328,2,1,277805,277805,277806,0,1,0
79329,4,2,277809,277809,277811,0,2,3
79330,2,3,277811,277811,277814,0,3,0
79331,3,3,277814,277814,277817,0,3,0
79332,5,2,277819,277819,277821,0,2,2
79333,5,2,277824,277824,277826,0,2,3
79334,2,1,277826,277826,277827,0,1,0
79335,1,3,277827,277827,277830,0,3,0
79336,5,3,277832,277832,277835,0,3,2
79337,1,2,277833,277835,277837,2,4,0
79338,2,1,277835,277837,277838,2,3,0
79339,5,3,277840,277840,277843,0,3,2
79340,1,3,277841,277843,277846,2,5,0
79341,6,3,277847,277847,277850,0,3,1
79342,3,1,277850,277850,277851,0,1,0
79343,3,3,277853,277853,277856,0,3,2
79344,3,3,277856,277856,277859,0,3,0
79345,1,3,277857,277859,277862,2,5,0
79346,1,2,277858,277862,277864,4,6,0
79347,2,2,277860,277864,277866,4,6,0
79348,4,2,277864,277866,277868,2,4,0
79349,2,3,277866,277868,277871,2,5,0
79350,6,2,277872,277872,277874,0,2,1
79351,2,2,277874,277874,277876,0,2,0
79352,4,1,277878,277878,277879,0,1,2
79353,5,2,277883,277883,277885,0,2,4
79354,3,3,277886,277886,277889,0,3,1
79355,2,2,277888,277889,277891,1,3,0
79356,4,2,277892,277892,277894,0,2,1
79357,6,3,277898,277898,277901,0,3,4
79358,3,2,277901,277901,277903,0,2,0
79359,6,3,277907,277907,277910,0,3,4
79360,6,1,277913,277913,277914,0,1,3
79361,5,1,277918,277918,277919,0,1,4
79362,3,3,277921,277921,277924,0,3,2
79363,6,3,277927,277927,277930,0,3,3
79364,6,1,277933,277933,277934,0,1,3
79365,3,2,277936,277936,277938,0,2,2
79366,4,3,277940,277940,277943,0,3,2
79367,2,2,277942,277943,277945,1,3,0
79368,4,1,277946,277946,277947,0,1,1
79369,2,3,277948,277948,277951,0,3,1
79370,2,2,277950,277951,277953,1,3,0
79371,2,1,277952,277953,277954,1,2,0
79372,5,2,277957,277957,277959,0,2,3
79373,1,1,277958,277959,277960,1,2,0
79374,2,1,277960,277960,277961,0,1,0
79375,5,2,277965,277965,277967,0,2,4
79376,2,3,277967,277967,277970,0,3,0
79377,6,3,277973,277973,277976,0,3,3
79378,3,3,277976,277976,277979,0,3,0
79379,2,3,277978,277979,277982,1,4,0
79380,2,2,277980,277982,277984,2,4,0
79381,5,3,277985,277985,277988,0,3,1
79382,6,3,277991,277991,277994,0,3,3
79383,4,3,277995,277995,277998,0,3,1
79384,5,2,278000,278000,278002,0,2,2
79385,5,2,278005,278005,278007,0,2,3
79386,3,1,278008,278008,278009,0,1,1
79387,6,2,278014,278014,278016,0,2,5
79388,1,3,278015,278016,278019,1,4,0
79389,5,1,278020,278020,278021,0,1,1
79390,4,2,278024,278024,278026,0,2,3
79391,4,3,278028,278028,278031,0,3,2
79392,5,1,278033,278033,278034,0,1,2
79393,6,2,278039,278039,278041,0,2,5
79394,1,1,278040,278041,278042,1,2,0
79395,2,2,278042,278042,278044,0,2,0
79396,5,3,278047,278047,278050,0,3,3
79397,2,1,278049,278050,278051,1,2,0
79398,1,3,278050,278051,278054,1,4,0
79399,4,1,278054,278054,278055,0,1,0
79400,2,3,278056,278056,278059,0,3,1
79401,2,3,278058,278059,278062,1,4,0
79402,2,3,278060,278062,278065,2,5,0
79403,5,2,278065,278065,278067,0,2,0
79404,5,1,278070,278070,278071,0,1,3
79405,3,2,278073,278073,278075,0,2,2
79406,5,1,278078,278078,278079,0,1,3
79407,2,2,278080,278080,278082,0,2,1
79408,3,2,278083,278083,278085,0,2,1
79409,4,1,278087,278087,278088,0,1,2
79410,6,3,278093,278093,278096,0,3,5
79411,4,3,278097,278097,278100,0,3,1
79412,2,1,278099,278100,278101,1,2,0
79413,2,3,278101,278101,278104,0,3,0
79414,1,1,278102,278104,278105,2,3,0
79415,6,1,278108,278108,278109,0,1,3
79416,1,3,278109,278109,278112,0,3,0
79417,1,2,278110,278112,278114,2,4,0
79418,4,1,278114,278114,278115,0,1,0
79419,5,3,278119,278119,278122,0,3,4
79420,2,1,278121,278122,278123,1,2,0
79421,1,2,278122,278123,278125,1,3,0
79422,4,3,278126,278126,278129,0,3,1
79423,4,3,278130,278130,278133,0,3,1
79424,3,1,278133,278133,278134,0,1,0
79425,3,1,278136,278136,278137,0,1,2
79426,4,2,278140,278140,278142,0,2,3
79427,1,1,278141,278142,278143,1,2,0
79428,4,3,278145,278145,278148,0,3,2
79429,6,2,278151,278151,278153,0,2,3
79430,5,2,278156,278156,278158,0,2,3
79431,6,2,278162,278162,278164,0,2,4
79432,5,1,278167,278167,278168,0,1,3
79433,4,1,278171,278171,278172,0,1,3
79434,2,2,278173,278173,278175,0,2,1
79435,4,2,278177,278177,278179,0,2,2
79436,3,2,278180,278180,278182,0,2,1
79437,3,1,278183,278183,278184,0,1,1
79438,6,2,278189,278189,278191,0,2,5
79439,3,1,278192,278192,278193,0,1,1
79440,3,2,278195,278195,278197,0,2,2
79441,2,3,278197,278197,278200,0,3,0
79442,1,1,278198,278200,278201,2,3,0
79443,2,1,278200,278201,278202,1,2,0
79444,4,2,278204,278204,278206,0,2,2
79445,5,3,278209,278209,278212,0,3,3
79446,2,2,278211,278212,278214,1,3,0
79447,3,3,278214,278214,278217,0,3,0
79448,3,2,278217,278217,278219,0,2,0
79449,4,1,278221,278221,278222,0,1,2
79450,4,1,278225,278225,278226,0,1,3
79451,1,3,278226,278226,278229,0,3,0
79452,1,1,278227,278229,278230,2,3,0
79453,4,1,278231,278231,278232,0,1,1
79454,4,3,278235,278235,278238,0,3,3
79455,6,3,278241,278241,278244,0,3,3
79456,5,3,278246,278246,278249,0,3,2
79457,6,2,278252,278252,278254,0,2,3
79458,1,1,278253,278254,278255,1,2,0
79459,4,2,278257,278257,278259,0,2,2
79460,6,1,278263,278263,278264,0,1,4
79461,2,2,278265,278265,278267,0,2,1
79462,2,3,278267,278267,278270,0,3,0
79463,1,3,278268,278270,278273,2,5,0
79464,6,3,278274,278274,278277,0,3,1
79465,6,1,278280,278280,278281,0,1,3
79466,1,3,278281,278281,278284,0,3,0
79467,4,1,278285,278285,278286,0,1,1
79468,6,3,278291,278291,278294,0,3,5
79469,6,3,278297,278297,278300,0,3,3
79470,5,2,278302,278302,278304,0,2,2
79471,6,1,278308,278308,278309,0,1,4
79472,5,1,278313,278313,278314,0,1,4
79473,3,1,278316,278316,278317,0,1,2
79474,6,2,278322,278322,278324,0,2,5
79475,1,3,278323,278324,278327,1,4,0
79476,4,3,278327,278327,278330,0,3,0
79477,5,3,278332,278332,278335,0,3,2
79478,1,2,278333,278335,278337,2,4,0
79479,1,3,278334,278337,278340,3,6,0
79480,5,1,278339,278340,278341,1,2,0
79481,3,2,278342,278342,278344,0,2,1
79482,3,1,278345,278345,278346,0,1,1
79483,6,2,278351,278351,278353,0,2,5
79484,2,1,278353,278353,278354,0,1,0
79485,2,2,278355,278355,278357,0,2,1
79486,2,1,278357,278357,278358,0,1,0
79487,1,2,278358,278358,278360,0,2,0
79488,6,3,278364,278364,278367,0,3,4
79489,5,2,278369,278369,278371,0,2,2
79490,2,3,278371,278371,278374,0,3,0
79491,1,1,278372,278374,278375,2,3,0
79492,6,2,278378,278378,278380,0,2,3
79493,6,3,278384,278384,278387,0,3,4
79494,3,1,278387,278387,278388,0,1,0
79495,5,1,278392,278392,278393,0,1,4
79496,5,3,278397,278397,278400,0,3,4
79497,4,2,278401,278401,278403,0,2,1
79498,2,1,278403,278403,278404,0,1,0
79499,5,3,278408,278408,278411,0,3,4
79500,4,3,278412,278412,278415,0,3,1
79501,6,2,278418,278418,278420,0,2,3
79502,4,3,278422,278422,278425,0,3,2
79503,6,1,278428,278428,278429,0,1,3
79504,3,1,278431,278431,278432,0,1,2
79505,5,1,278436,278436,278437,0,1,4
79506,5,2,278441,278441,278443,0,2,4
79507,1,1,278442,278443,278444,1,2,0
79508,1,1,278443,278444,278445,1,2,0
79509,2,3,278445,278445,278448,0,3,0
79510,4,2,278449,278449,278451,0,2,1
79511,1,3,278450,278451,278454,1,4,0
79512,5,3,278455,278455,278458,0,3,1
79513,1,3,278456,278458,278461,2,5,0
79514,1,3,278457,278461,278464,4,7,0
79515,5,2,278462,278464,278466,2,4,0
79516,6,2,278468,278468,278470,0,2,2
79517,4,2,278472,278472,278474,0,2,2
79518,5,3,278477,278477,278480,0,3,3
79519,6,3,278483,278483,278486,0,3,3
79520,2,1,278485,278486,278487,1,2,0
79521,6,2,278491,278491,278493,0,2,4
79522,3,3,278494,278494,278497,0,3,1
79523,5,3,278499,278499,278502,0,3,2
79524,2,1,278501,278502,278503,1,2,0
79525,6,3,278507,278507,278510,0,3,4
79526,1,3,278508,278510,278513,2,5,0
79527,4,1,278512,278513,278514,1,2,0
79528,1,1,278513,278514,278515,1,2,0
79529,5,2,278518,278518,278520,0,2,3
79530,3,3,278521,278521,278524,0,3,1
79531,1,1,278522,278524,278525,2,3,0
79532,1,1,278523,278525,278526,2,3,0
79533,6,2,278529,278529,278531,0,2,3
79534,4,3,278533,278533,278536,0,3,2
79535,1,2,278534,278536,278538,2,4,0
79536,6,3,278540,278540,278543,0,3,2
79537,3,1,278543,278543,278544,0,1,0
79538,3,1,278546,278546,278547,0,1,2
79539,5,1,278551,278551,278552,0,1,4
79540,5,2,278556,278556,278558,0,2,4
79541,3,2,278559,278559,278561,0,2,1
79542,3,1,278562,278562,278563,0,1,1
79543,6,1,278568,278568,278569,0,1,5
79544,6,1,278574,278574,278575,0,1,5
79545,1,3,278575,278575,278578,0,3,0
79546,1,1,278576,278578,278579,2,3,0
79547,5,2,278581,278581,278583,0,2,2
79548,3,3,278584,278584,278587,0,3,1
79549,3,1,278587,278587,278588,0,1,0
79550,6,1,278593,278593,278594,0,1,5
79551,4,1,278597,278597,278598,0,1,3
79552,3,1,278600,278600,278601,0,1,2
79553,4,3,278604,278604,278607,0,3,3
79554,4,1,278608,278608,278609,0,1,1
79555,6,2,278614,278614,278616,0,2,5
79556,6,1,278620,278620,278621,0,1,4
79557,1,1,278621,278621,278622,0,1,0
79558,2,1,278623,278623,278624,0,1,1
79559,6,2,278629,278629,278631,0,2,5
79560,3,2,278632,278632,278634,0,2,1
79561,5,3,278637,278637,278640,0,3,3
79562,2,3,278639,278640,278643,1,4,0
79563,6,2,278645,278645,278647,0,2,2
79564,1,3,278646,278647,278650,1,4,0
79565,6,2,278652,278652,278654,0,2,2
79566,6,3,278658,278658,278661,0,3,4
79567,5,2,278663,278663,278665,0,2,2
79568,3,2,278666,278666,278668,0,2,1
79569,3,1,278669,278669,278670,0,1,1
79570,2,3,278671,278671,278674,0,3,1
79571,3,1,278674,278674,278675,0,1,0
79572,5,3,278679,278679,278682,0,3,4
79573,1,1,278680,278682,278683,2,3,0
79574,3,3,278683,278683,278686,0,3,0
79575,3,3,278686,278686,278689,0,3,0
79576,1,2,278687,278689,278691,2,4,0
79577,2,3,278689,278691,278694,2,5,0
79578,4,1,278693,278694,278695,1,2,0
79579,3,1,278696,278696,278697,0,1,1
79580,6,1,278702,278702,278703,0,1,5
79581,4,2,278706,278706,278708,0,2,3
79582,6,3,278712,278712,278715,0,3,4
79583,4,1,278716,278716,278717,0,1,1
79584,5,2,278721,278721,278723,0,2,4
79585,1,1,278722,278723,278724,1,2,0
79586,6,1,278728,278728,278729,0,1,4
79587,3,2,278731,278731,278733,0,2,2
79588,4,3,278735,278735,278738,0,3,2
79589,5,2,278740,278740,278742,0,2,2
79590,4,2,278744,278744,278746,0,2,2
79591,4,2,278748,278748,278750,0,2,2
79592,4,2,278752,278752,278754,0,2,2
79593,2,2,278754,278754,278756,0,2,0
79594,1,2,278755,278756,278758,1,3,0
79595,3,2,278758,278758,278760,0,2,0
79596,6,3,278764,278764,278767,0,3,4
79597,1,3,278765,278767,278770,2,5,0
79598,5,3,278770,278770,278773,0,3,0
79599,1,2,278771,278773,278775,2,4,0
79600,4,1,278775,278775,278776,0,1,0
79601,2,3,278777,278777,278780,0,3,1
79602,6,3,278783,278783,278786,0,3,3
79603,1,1,278784,278786,278787,2,3,0
79604,3,3,278787,278787,278790,0,3,0
79605,6,2,278793,278793,278795,0,2,3
79606,6,2,278799,278799,278801,0,2,4
79607,1,1,278800,278801,278802,1,2,0
79608,5,3,278805,278805,278808,0,3,3
79609,2,2,278807,278808,278810,1,3,0
79610,1,1,278808,278810,278811,2,3,0
79611,5,2,278813,278813,278815,0,2,2
79612,2,1,278815,278815,278816,0,1,0
79613,6,3,278821,278821,278824,0,3,5
79614,3,1,278824,278824,278825,0,1,0
79615,6,2,278830,278830,278832,0,2,5
79616,6,1,278836,278836,278837,0,1,4
79617,5,3,278841,278841,278844,0,3,4
79618,1,3,278842,278844,278847,2,5,0
79619,5,2,278847,278847,278849,0,2,0
79620,3,3,278850,278850,278853,0,3,1
79621,1,2,278851,278853,278855,2,4,0
79622,1,2,278852,278855,278857,3,5,0
79623,4,3,278856,278857,278860,1,4,0
79624,3,3,278859,278860,278863,1,4,0
79625,3,2,278862,278863,278865,1,3,0
79626,1,2,278863,278865,278867,2,4,0
79627,4,2,278867,278867,278869,0,2,0
79628,6,2,278873,278873,278875,0,2,4
79629,4,2,278877,278877,278879,0,2,2
79630,2,1,278879,278879,278880,0,1,0
79631,4,2,278883,278883,278885,0,2,3
79632,5,3,278888,278888,278891,0,3,3
79633,4,1,278892,278892,278893,0,1,1
79634,5,2,278897,278897,278899,0,2,4
79635,5,3,278902,278902,278905,0,3,3
79636,4,1,278906,278906,278907,0,1,1
79637,5,3,278911,278911,278914,0,3,4
79638,2,3,278913,278914,278917,1,4,0
79639,5,2,278918,278918,278920,0,2,1
79640,2,1,278920,278920,278921,0,1,0
79641,6,3,278926,278926,278929,0,3,5
79642,2,1,278928,278929,278930,1,2,0
79643,1,2,278929,278930,278932,1,3,0
79644,2,3,278931,278932,278935,1,4,0
79645,1,2,278932,278935,278937,3,5,0
79646,5,2,278937,278937,278939,0,2,0
79647,4,1,278941,278941,278942,0,1,2
79648,2,1,278943,278943,278944,0,1,1
79649,2,1,278945,278945,278946,0,1,1
79650,1,3,278946,278946,278949,0,3,0
79651,4,2,278950,278950,278952,0,2,1
79652,3,2,278953,278953,278955,0,2,1
79653,4,1,278957,278957,278958,0,1,2
79654,6,1,278963,278963,278964,0,1,5
79655,3,3,278966,278966,278969,0,3,2
79656,3,1,278969,278969,278970,0,1,0
79657,3,2,278972,278972,278974,0,2,2
79658,5,2,278977,278977,278979,0,2,3
79659,2,1,278979,278979,278980,0,1,0
79660,3,1,278982,278982,278983,0,1,2
79661,2,3,278984,278984,278987,0,3,1
79662,4,1,278988,278988,278989,0,1,1
79663,3,1,278991,278991,278992,0,1,2
79664,5,1,278996,278996,278997,0,1,4
79665,2,3,278998,278998,279001,0,3,1
79666,6,1,279004,279004,279005,0,1,3
79667,3,3,279007,279007,279010,0,3,2
79668,4,2,279011,279011,279013,0,2,1
79669,5,1,279016,279016,279017,0,1,3
79670,3,1,279019,279019,279020,0,1,2
79671,3,1,279022,279022,279023,0,1,2
79672,1,1,279023,279023,279024,0,1,0
79673,4,1,279027,279027,279028,0,1,3
79674,2,2,279029,279029,279031,0,2,1
79675,3,3,279032,279032,279035,0,3,1
79676,5,3,279037,279037,279040,0,3,2
79677,6,3,279043,279043,279046,0,3,3
79678,3,2,279046,279046,279048,0,2,0
79679,5,2,279051,279051,279053,0,2,3
79680,1,2,279052,279053,279055,1,3,0
79681,3,3,279055,279055,279058,0,3,0
79682,2,2,279057,279058,279060,1,3,0
79683,3,3,279060,279060,279063,0,3,0
79684,5,3,279065,279065,279068,0,3,2
79685,5,2,279070,279070,279072,0,2,2
79686,2,1,279072,279072,279073,0,1,0
79687,6,2,279078,279078,279080,0,2,5
79688,2,3,279080,279080,279083,0,3,0
79689,2,1,279082,279083,279084,1,2,0
79690,3,3,279085,279085,279088,0,3,1
79691,6,2,279091,279091,279093,0,2,3
79692,4,1,279095,279095,279096,0,1,2
79693,3,2,279098,279098,279100,0,2,2
79694,5,1,279103,279103,279104,0,1,3
79695,3,3,279106,279106,279109,0,3,2
79696,4,3,279110,279110,279113,0,3,1
79697,2,3,279112,279113,279116,1,4,0
79698,3,2,279115,279116,279118,1,3,0
79699,6,1,279121,279121,279122,0,1,3
79700,3,3,279124,279124,279127,0,3,2
79701,6,1,279130,279130,279131,0,1,3
79702,2,1,279132,279132,279133,0,1,1
79703,3,2,279135,279135,279137,0,2,2
79704,5,1,279140,279140,279141,0,1,3
79705,2,3,279142,279142,279145,0,3,1
79706,6,1,279148,279148,279149,0,1,3
79707,4,1,279152,279152,279153,0,1,3
79708,5,1,279157,279157,279158,0,1,4
79709,1,1,279158,279158,279159,0,1,0
79710,3,2,279161,279161,279163,0,2,2
79711,6,1,279167,279167,279168,0,1,4
79712,5,2,279172,279172,279174,0,2,4
79713,2,3,279174,279174,279177,0,3,0
79714,4,3,279178,279178,279181,0,3,1
79715,6,1,279184,279184,279185,0,1,3
79716,1,3,279185,279185,279188,0,3,0
79717,6,2,279191,279191,279193,0,2,3
79718,1,1,279192,279193,279194,1,2,0
79719,2,2,279194,279194,279196,0,2,0
79720,1,3,279195,279196,279199,1,4,0
79721,4,2,279199,279199,279201,0,2,0
79722,4,3,279203,279203,279206,0,3,2
79723,3,2,279206,279206,279208,0,2,0
79724,5,3,279211,279211,279214,0,3,3
79725,6,1,279217,279217,279218,0,1,3
79726,1,1,279218,279218,279219,0,1,0
79727,1,2,279219,279219,279221,0,2,0
79728,1,1,279220,279221,279222,1,2,0
79729,1,2,279221,279222,279224,1,3,0
79730,5,3,279226,279226,279229,0,3,2
79731,3,2,279229,279229,279231,0,2,0
79732,5,3,279234,279234,279237,0,3,3
79733,6,2,279240,279240,279242,0,2,3
79734,5,2,279245,279245,279247,0,2,3
79735,1,1,279246,279247,279248,1,2,0
79736,1,2,279247,279248,279250,1,3,0
79737,2,1,279249,279250,279251,1,2,0
79738,5,3,279254,279254,279257,0,3,3
79739,1,3,279255,279257,279260,2,5,0
79740,2,2,279257,279260,279262,3,5,0
79741,2,1,279259,279262,279263,3,4,0
79742,5,1,279264,279264,279265,0,1,1
79743,5,1,279269,279269,279270,0,1,4
79744,1,2,279270,279270,279272,0,2,0
79745,2,1,279272,279272,279273,0,1,0
79746,1,2,279273,279273,279275,0,2,0
79747,4,1,279277,279277,279278,0,1,2
79748,2,1,279279,279279,279280,0,1,1
79749,5,1,279284,279284,279285,0,1,4
79750,6,2,279290,279290,279292,0,2,5
79751,2,3,279292,279292,279295,0,3,0
79752,6,3,279298,279298,279301,0,3,3
79753,3,3,279301,279301,279304,0,3,0
79754,6,3,279307,279307,279310,0,3,3
79755,1,1,279308,279310,279311,2,3,0
79756,3,3,279311,279311,279314,0,3,0
79757,6,2,279317,279317,279319,0,2,3
79758,5,1,279322,279322,279323,0,1,3
79759,6,2,279328,279328,279330,0,2,5
79760,1,1,279329,279330,279331,1,2,0
79761,6,2,279335,279335,279337,0,2,4
79762,1,3,279336,279337,279340,1,4,0
79763,2,2,279338,279340,279342,2,4,0
79764,5,2,279343,279343,279345,0,2,1
79765,5,2,279348,279348,279350,0,2,3
79766,1,3,279349,279350,279353,1,4,0
79767,4,1,279353,279353,279354,0,1,0
79768,3,2,279356,279356,279358,0,2,2
79769,5,3,279361,279361,279364,0,3,3
79770,3,1,279364,279364,279365,0,1,0
79771,3,2,279367,279367,279369,0,2,2
79772,5,2,279372,279372,279374,0,2,3
79773,6,3,279378,279378,279381,0,3,4
79774,2,3,279380,279381,279384,1,4,0
79775,5,3,279385,279385,279388,0,3,1
79776,1,1,279386,279388,279389,2,3,0
79777,2,2,279388,279389,279391,1,3,0
79778,2,1,279390,279391,279392,1,2,0
79779,5,3,279395,279395,279398,0,3,3
79780,3,3,279398,279398,279401,0,3,0
79781,5,2,279403,279403,279405,0,2,2
79782,2,3,279405,279405,279408,0,3,0
79783,4,3,279409,279409,279412,0,3,1
79784,2,2,279411,279412,279414,1,3,0
79785,6,2,279417,279417,279419,0,2,3
79786,1,1,279418,279419,279420,1,2,0
79787,3,3,279421,279421,279424,0,3,1
79788,5,3,279426,279426,279429,0,3,2
79789,5,2,279431,279431,279433,0,2,2
79790,5,3,279436,279436,279439,0,3,3
79791,2,3,279438,279439,279442,1,4,0
79792,3,2,279441,279442,279444,1,3,0
79793,2,3,279443,279444,279447,1,4,0
79794,3,3,279446,279447,279450,1,4,0
79795,1,1,279447,279450,279451,3,4,0
79796,2,3,279449,279451,279454,2,5,0
79797,5,3,279454,279454,279457,0,3,0
79798,4,3,279458,279458,279461,0,3,1
79799,3,3,279461,279461,279464,0,3,0
79800,2,2,279463,279464,279466,1,3,0
79801,2,2,279465,279466,279468,1,3,0
79802,6,1,279471,279471,279472,0,1,3
79803,1,1,279472,279472,279473,0,1,0
79804,5,1,279477,279477,279478,0,1,4
79805,4,1,279481,279481,279482,0,1,3
79806,4,2,279485,279485,279487,0,2,3
79807,6,2,279491,279491,279493,0,2,4
79808,5,3,279496,279496,279499,0,3,3
79809,2,1,279498,279499,279500,1,2,0
79810,5,1,279503,279503,279504,0,1,3
79811,5,3,279508,279508,279511,0,3,4
79812,5,2,279513,279513,279515,0,2,2
79813,5,3,279518,279518,279521,0,3,3
79814,2,1,279520,279521,279522,1,2,0
79815,4,3,279524,279524,279527,0,3,2
79816,2,2,279526,279527,279529,1,3,0
79817,5,1,279531,279531,279532,0,1,2
79818,4,2,279535,279535,279537,0,2,3
79819,1,1,279536,279537,279538,1,2,0
79820,5,1,279541,279541,279542,0,1,3
79821,5,2,279546,279546,279548,0,2,4
79822,6,3,279552,279552,279555,0,3,4
79823,2,1,279554,279555,279556,1,2,0
79824,1,2,279555,279556,279558,1,3,0
79825,3,3,279558,279558,279561,0,3,0
79826,5,2,279563,279563,279565,0,2,2
79827,1,3,279564,279565,279568,1,4,0
79828,3,3,279567,279568,279571,1,4,0
79829,4,3,279571,279571,279574,0,3,0
79830,1,2,279572,279574,279576,2,4,0
79831,3,1,279575,279576,279577,1,2,0
79832,5,1,279580,279580,279581,0,1,3
79833,6,2,279586,279586,279588,0,2,5
79834,1,1,279587,279588,279589,1,2,0
79835,5,3,279592,279592,279595,0,3,3
79836,1,1,279593,279595,279596,2,3,0
79837,6,2,279599,279599,279601,0,2,3
79838,4,3,279603,279603,279606,0,3,2
79839,1,2,279604,279606,279608,2,4,0
79840,1,1,279605,279608,279609,3,4,0
79841,3,2,279608,279609,279611,1,3,0
79842,3,1,279611,279611,279612,0,1,0
79843,4,1,279615,279615,279616,0,1,3
79844,4,3,279619,279619,279622,0,3,3
79845,6,3,279625,279625,279628,0,3,3
79846,5,2,279630,279630,279632,0,2,2
79847,6,1,279636,279636,279637,0,1,4
79848,2,1,279638,279638,279639,0,1,1
79849,2,1,279640,279640,279641,0,1,1
79850,6,1,279646,279646,279647,0,1,5
79851,4,1,279650,279650,279651,0,1,3
79852,1,1,279651,279651,279652,0,1,0
79853,3,3,279654,279654,279657,0,3,2
79854,3,3,279657,279657,279660,0,3,0
79855,3,3,279660,279660,279663,0,3,0
79856,4,3,279664,279664,279667,0,3,1
79857,6,2,279670,279670,279672,0,2,3
79858,6,2,279676,279676,279678,0,2,4
79859,2,2,279678,279678,279680,0,2,0
79860,5,3,279683,279683,279686,0,3,3
79861,5,1,279688,279688,279689,0,1,2
79862,3,2,279691,279691,279693,0,2,2
79863,5,2,279696,279696,279698,0,2,3
79864,5,1,279701,279701,279702,0,1,3
79865,3,2,279704,279704,279706,0,2,2
79866,6,1,279710,279710,279711,0,1,4
79867,5,1,279715,279715,279716,0,1,4
79868,3,3,279718,279718,279721,0,3,2
79869,2,3,279720,279721,279724,1,4,0
79870,4,2,279724,279724,279726,0,2,0
79871,3,2,279727,279727,279729,0,2,1
79872,5,1,279732,279732,279733,0,1,3
79873,5,3,279737,279737,279740,0,3,4
79874,3,2,279740,279740,279742,0,2,0
79875,6,2,279746,279746,279748,0,2,4
79876,5,2,279751,279751,279753,0,2,3
79877,4,2,279755,279755,279757,0,2,2
79878,1,1,279756,279757,279758,1,2,0
79879,4,1,279760,279760,279761,0,1,2
79880,6,2,279766,279766,279768,0,2,5
79881,4,2,279770,279770,279772,0,2,2
79882,2,3,279772,279772,279775,0,3,0
79883,3,2,279775,279775,279777,0,2,0
79884,1,3,279776,279777,279780,1,4,0
79885,4,2,279780,279780,279782,0,2,0
79886,6,1,279786,279786,279787,0,1,4
79887,3,1,279789,279789,279790,0,1,2
79888,6,1,279795,279795,279796,0,1,5
79889,4,2,279799,279799,279801,0,2,3
79890,3,3,279802,279802,279805,0,3,1
79891,4,3,279806,279806,279809,0,3,1
79892,3,1,279809,279809,279810,0,1,0
79893,4,1,279813,279813,279814,0,1,3
79894,3,1,279816,279816,279817,0,1,2
79895,3,1,279819,279819,279820,0,1,2
79896,2,3,279821,279821,279824,0,3,1
79897,1,3,279822,279824,279827,2,5,0
79898,5,2,279827,279827,279829,0,2,0
79899,6,2,279833,279833,279835,0,2,4
79900,5,1,279838,279838,279839,0,1,3
79901,2,3,279840,279840,279843,0,3,1
79902,2,1,279842,279843,279844,1,2,0
79903,3,2,279845,279845,279847,0,2,1
79904,6,2,279851,279851,279853,0,2,4
79905,1,2,279852,279853,279855,1,3,0
79906,6,3,279858,279858,279861,0,3,3
79907,3,1,279861,279861,279862,0,1,0
79908,5,2,279866,279866,279868,0,2,4
79909,4,1,279870,279870,279871,0,1,2
79910,1,3,279871,279871,279874,0,3,0
79911,4,2,279875,279875,279877,0,2,1
79912,1,2,279876,279877,279879,1,3,0
79913,1,3,279877,279879,279882,2,5,0
79914,6,3,279883,279883,279886,0,3,1
79915,5,3,279888,279888,279891,0,3,2
79916,2,3,279890,279891,279894,1,4,0
79917,5,1,279895,279895,279896,0,1,1
79918,2,2,279897,279897,279899,0,2,1
79919,3,3,279900,279900,279903,0,3,1
79920,6,1,279906,279906,279907,0,1,3
79921,1,1,279907,279907,279908,0,1,0
79922,6,2,279913,279913,279915,0,2,5
79923,3,2,279916,279916,279918,0,2,1
79924,3,3,279919,279919,279922,0,3,1
79925,2,1,279921,279922,279923,1,2,0
79926,1,1,279922,279923,279924,1,2,0
79927,6,1,279928,279928,279929,0,1,4
79928,2,1,279930,279930,279931,0,1,1
79929,3,3,279933,279933,279936,0,3,2
79930,5,1,279938,279938,279939,0,1,2
79931,3,1,279941,279941,279942,0,1,2
79932,2,3,279943,279943,279946,0,3,1
79933,6,3,279949,279949,279952,0,3,3
79934,5,3,279954,279954,279957,0,3,2
79935,4,3,279958,279958,279961,0,3,1
79936,5,1,279963,279963,279964,0,1,2
79937,5,1,279968,279968,279969,0,1,4
79938,5,2,279973,279973,279975,0,2,4
79939,3,1,279976,279976,279977,0,1,1
79940,1,1,279977,279977,279978,0,1,0
79941,3,3,279980,279980,279983,0,3,2
79942,6,1,279986,279986,279987,0,1,3
79943,4,2,279990,279990,279992,0,2,3
79944,1,3,279991,279992,279995,1,4,0
79945,1,1,279992,279995,279996,3,4,0
79946,5,2,279997,279997,279999,0,2,1
79947,2,1,279999,279999,280000,0,1,0
79948,5,2,280004,280004,280006,0,2,4
79949,6,2,280010,280010,280012,0,2,4
79950,1,2,280011,280012,280014,1,3,0
79951,6,3,280017,280017,280020,0,3,3
79952,3,1,280020,280020,280021,0,1,0
79953,4,1,280024,280024,280025,0,1,3
79954,5,2,280029,280029,280031,0,2,4
79955,5,2,280034,280034,280036,0,2,3
79956,5,2,280039,280039,280041,0,2,3
79957,2,3,280041,280041,280044,0,3,0
79958,6,3,280047,280047,280050,0,3,3
79959,5,2,280052,280052,280054,0,2,2
79960,4,3,280056,280056,280059,0,3,2
79961,6,1,280062,280062,280063,0,1,3
79962,5,3,280067,280067,280070,0,3,4
79963,2,1,280069,280070,280071,1,2,0
79964,2,1,280071,280071,280072,0,1,0
79965,6,2,280077,280077,280079,0,2,5
79966,6,2,280083,280083,280085,0,2,4
79967,6,3,280089,280089,280092,0,3,4
79968,4,2,280093,280093,280095,0,2,1
79969,2,1,280095,280095,280096,0,1,0
79970,4,1,280099,280099,280100,0,1,3
79971,4,2,280103,280103,280105,0,2,3
79972,2,1,280105,280105,280106,0,1,0
79973,3,2,280108,280108,280110,0,2,2
79974,2,2,280110,280110,280112,0,2,0
79975,2,3,280112,280112,280115,0,3,0
79976,6,3,280118,280118,280121,0,3,3
79977,6,1,280124,280124,280125,0,1,3
79978,3,3,280127,280127,280130,0,3,2
79979,4,3,280131,280131,280134,0,3,1
79980,5,1,280136,280136,280137,0,1,2
79981,3,1,280139,280139,280140,0,1,2
79982,4,3,280143,280143,280146,0,3,3
79983,5,2,280148,280148,280150,0,2,2
79984,4,2,280152,280152,280154,0,2,2
79985,3,1,280155,280155,280156,0,1,1
79986,5,2,280160,280160,280162,0,2,4
79987,2,1,280162,280162,280163,0,1,0
79988,2,2,280164,280164,280166,0,2,1
79989,5,2,280169,280169,280171,0,2,3
79990,5,3,280174,280174,280177,0,3,3
79991,1,3,280175,280177,280180,2,5,0
79992,4,1,280179,280180,280181,1,2,0
79993,5,1,280184,280184,280185,0,1,3
79994,5,3,280189,280189,280192,0,3,4
79995,2,2,280191,280192,280194,1,3,0
79996,3,2,280194,280194,280196,0,2,0
79997,3,3,280197,280197,280200,0,3,1
79998,4,3,280201,280201,280204,0,3,1
79999,5,2,280206,280206,280208,0,2,2
80000,2,1,280208,280208,280209,0,1,0
80001,2,2,280210,280210,280212,0,2,1
80002,4,3,280214,280214,280217,0,3,2
80003,2,2,280216,280217,280219,1,3,0
80004,4,3,280220,280220,280223,0,3,1
80005,3,2,280223,280223,280225,0,2,0
80006,2,1,280225,280225,280226,0,1,0
80007,6,1,280231,280231,280232,0,1,5
80008,1,3,280232,280232,280235,0,3,0
80009,3,3,280235,280235,280238,0,3,0
80010,5,1,280240,280240,280241,0,1,2
80011,3,1,280243,280243,280244,0,1,2
80012,6,1,280249,280249,280250,0,1,5
80013,2,2,280251,280251,280253,0,2,1
80014,3,1,280254,280254,280255,0,1,1
80015,2,2,280256,280256,280258,0,2,1
80016,1,2,280257,280258,280260,1,3,0
80017,3,2,280260,280260,280262,0,2,0
80018,6,3,280266,280266,280269,0,3,4
80019,6,2,280272,280272,280274,0,2,3
80020,5,3,280277,280277,280280,0,3,3
80021,3,2,280280,280280,280282,0,2,0
80022,5,2,280285,280285,280287,0,2,3
80023,1,2,280286,280287,280289,1,3,0
80024,5,1,280291,280291,280292,0,1,2
80025,2,2,280293,280293,280295,0,2,1
80026,4,2,280297,280297,280299,0,2,2
80027,1,3,280298,280299,280302,1,4,0
80028,6,2,280304,280304,280306,0,2,2
80029,6,1,280310,280310,280311,0,1,4
80030,2,1,280312,280312,280313,0,1,1
80031,6,1,280318,280318,280319,0,1,5
80032,5,1,280323,280323,280324,0,1,4
80033,2,2,280325,280325,280327,0,2,1
80034,1,3,280326,280327,280330,1,4,0
80035,5,3,280331,280331,280334,0,3,1
80036,2,2,280333,280334,280336,1,3,0
80037,1,1,280334,280336,280337,2,3,0
80038,5,3,280339,280339,280342,0,3,2
80039,2,2,280341,280342,280344,1,3,0
80040,4,3,280345,280345,280348,0,3,1
80041,5,2,280350,280350,280352,0,2,2
80042,2,3,280352,280352,280355,0,3,0
80043,4,3,280356,280356,280359,0,3,1
80044,4,2,280360,280360,280362,0,2,1
80045,4,3,280364,280364,280367,0,3,2
80046,4,3,280368,280368,280371,0,3,1
80047,5,2,280373,280373,280375,0,2,2
80048,5,2,280378,280378,280380,0,2,3
80049,3,3,280381,280381,280384,0,3,1
80050,6,1,280387,280387,280388,0,1,3
80051,4,2,280391,280391,280393,0,2,3
80052,5,1,280396,280396,280397,0,1,3
80053,4,3,280400,280400,280403,0,3,3
80054,3,2,280403,280403,280405,0,2,0
80055,5,3,280408,280408,280411,0,3,3
80056,5,2,280413,280413,280415,0,2,2
80057,2,2,280415,280415,280417,0,2,0
80058,5,3,280420,280420,280423,0,3,3
80059,6,2,280426,280426,280428,0,2,3
80060,3,2,280429,280429,280431,0,2,1
80061,5,1,280434,280434,280435,0,1,3
80062,5,3,280439,280439,280442,0,3,4
80063,4,3,280443,280443,280446,0,3,1
80064,2,2,280445,280446,280448,1,3,0
80065,2,3,280447,280448,280451,1,4,0
80066,3,1,280450,280451,280452,1,2,0
80067,3,1,280453,280453,280454,0,1,1
80068,2,3,280455,280455,280458,0,3,1
80069,1,1,280456,280458,280459,2,3,0
80070,4,3,280460,280460,280463,0,3,1
80071,6,1,280466,280466,280467,0,1,3
80072,1,2,280467,280467,280469,0,2,0
80073,5,2,280472,280472,280474,0,2,3
80074,4,3,280476,280476,280479,0,3,2
80075,4,2,280480,280480,280482,0,2,1
80076,4,3,280484,280484,280487,0,3,2
80077,6,3,280490,280490,280493,0,3,3
80078,5,1,280495,280495,280496,0,1,2
80079,3,3,280498,280498,280501,0,3,2
80080,2,1,280500,280501,280502,1,2,0
80081,1,2,280501,280502,280504,1,3,0
80082,1,1,280502,280504,280505,2,3,0
80083,5,2,280507,280507,280509,0,2,2
80084,6,3,280513,280513,280516,0,3,4
80085,4,2,280517,280517,280519,0,2,1
80086,5,3,280522,280522,280525,0,3,3
80087,3,1,280525,280525,280526,0,1,0
80088,1,1,280526,280526,280527,0,1,0
80089,2,2,280528,280528,280530,0,2,1
80090,3,3,280531,280531,280534,0,3,1
80091,5,3,280536,280536,280539,0,3,2
80092,5,2,280541,280541,280543,0,2,2
80093,2,2,280543,280543,280545,0,2,0
80094,2,1,280545,280545,280546,0,1,0
80095,4,2,280549,280549,280551,0,2,3
80096,4,2,280553,280553,280555,0,2,2
80097,5,1,280558,280558,280559,0,1,3
80098,3,1,280561,280561,280562,0,1,2
80099,5,1,280566,280566,280567,0,1,4
80100,1,2,280567,280567,280569,0,2,0
80101,5,1,280572,280572,280573,0,1,3
80102,4,2,280576,280576,280578,0,2,3
80103,4,2,280580,280580,280582,0,2,2
80104,4,3,280584,280584,280587,0,3,2
80105,6,2,280590,280590,280592,0,2,3
80106,1,2,280591,280592,280594,1,3,0
80107,4,1,280595,280595,280596,0,1,1
80108,1,1,280596,280596,280597,0,1,0
80109,3,2,280599,280599,280601,0,2,2
80110,6,3,280605,280605,280608,0,3,4
80111,2,1,280607,280608,280609,1,2,0
80112,5,1,280612,280612,280613,0,1,3
80113,3,1,280615,280615,280616,0,1,2
80114,6,2,280621,280621,280623,0,2,5
80115,5,3,280626,280626,280629,0,3,3
80116,2,1,280628,280629,280630,1,2,0
80117,5,2,280633,280633,280635,0,2,3
80118,5,3,280638,280638,280641,0,3,3
80119,4,2,280642,280642,280644,0,2,1
80120,5,3,280647,280647,280650,0,3,3
80121,2,1,280649,280650,280651,1,2,0
80122,2,3,280651,280651,280654,0,3,0
80123,3,1,280654,280654,280655,0,1,0
80124,1,2,280655,280655,280657,0,2,0
80125,3,3,280658,280658,280661,0,3,1
80126,3,2,280661,280661,280663,0,2,0
80127,1,2,280662,280663,280665,1,3,0
80128,5,3,280667,280667,280670,0,3,2
80129,4,3,280671,280671,280674,0,3,1
80130,4,3,280675,280675,280678,0,3,1
80131,3,3,280678,280678,280681,0,3,0
80132,3,1,280681,280681,280682,0,1,0
80133,4,3,280685,280685,280688,0,3,3
80134,4,3,280689,280689,280692,0,3,1
80135,6,3,280695,280695,280698,0,3,3
80136,5,2,280700,280700,280702,0,2,2
80137,3,1,280703,280703,280704,0,1,1
80138,1,1,280704,280704,280705,0,1,0
80139,4,2,280708,280708,280710,0,2,3
80140,4,3,280712,280712,280715,0,3,2
80141,5,2,280717,280717,280719,0,2,2
80142,2,1,280719,280719,280720,0,1,0
80143,2,2,280721,280721,280723,0,2,1
80144,1,3,280722,280723,280726,1,4,0
80145,2,2,280724,280726,280728,2,4,0
80146,1,3,280725,280728,280731,3,6,0
80147,1,1,280726,280731,280732,5,6,0
80148,6,2,280732,280732,280734,0,2,0
80149,4,2,280736,280736,280738,0,2,2
80150,3,2,280739,280739,280741,0,2,1
80151,2,1,280741,280741,280742,0,1,0
80152,4,1,280745,280745,280746,0,1,3
80153,5,1,280750,280750,280751,0,1,4
80154,4,2,280754,280754,280756,0,2,3
80155,5,3,280759,280759,280762,0,3,3
80156,2,3,280761,280762,280765,1,4,0
80157,6,2,280767,280767,280769,0,2,2
80158,6,3,280773,280773,280776,0,3,4
80159,2,2,280775,280776,280778,1,3,0
80160,6,3,280781,280781,280784,0,3,3
80161,2,2,280783,280784,280786,1,3,0
80162,1,1,280784,280786,280787,2,3,0
80163,1,2,280785,280787,280789,2,4,0
80164,4,1,280789,280789,280790,0,1,0
80165,6,3,280795,280795,280798,0,3,5
80166,2,3,280797,280798,280801,1,4,0
80167,3,2,280800,280801,280803,1,3,0
80168,2,2,280802,280803,280805,1,3,0
80169,3,3,280805,280805,280808,0,3,0
80170,3,2,280808,280808,280810,0,2,0
80171,2,3,280810,280810,280813,0,3,0
80172,6,3,280816,280816,280819,0,3,3
80173,1,3,280817,280819,280822,2,5,0
80174,3,3,280820,280822,280825,2,5,0
80175,6,3,280826,280826,280829,0,3,1
80176,5,3,280831,280831,280834,0,3,2
80177,4,1,280835,280835,280836,0,1,1
80178,1,3,280836,280836,280839,0,3,0
80179,4,2,280840,280840,280842,0,2,1
80180,5,3,280845,280845,280848,0,3,3
80181,6,1,280851,280851,280852,0,1,3
80182,5,2,280856,280856,280858,0,2,4
80183,3,1,280859,280859,280860,0,1,1
80184,2,3,280861,280861,280864,0,3,1
80185,5,1,280866,280866,280867,0,1,2
80186,5,1,280871,280871,280872,0,1,4
80187,6,1,280877,280877,280878,0,1,5
80188,4,2,280881,280881,280883,0,2,3
80189,2,1,280883,280883,280884,0,1,0
80190,1,3,280884,280884,280887,0,3,0
80191,3,3,280887,280887,280890,0,3,0
80192,5,3,280892,280892,280895,0,3,2
80193,2,2,280894,280895,280897,1,3,0
80194,4,1,280898,280898,280899,0,1,1
80195,6,2,280904,280904,280906,0,2,5
80196,5,2,280909,280909,280911,0,2,3
80197,6,2,280915,280915,280917,0,2,4
80198,6,1,280921,280921,280922,0,1,4
80199,6,2,280927,280927,280929,0,2,5
80200,6,1,280933,280933,280934,0,1,4
80201,6,2,280939,280939,280941,0,2,5
80202,6,2,280945,280945,280947,0,2,4
80203,6,2,280951,280951,280953,0,2,4
80204,1,3,280952,280953,280956,1,4,0
80205,4,3,280956,280956,280959,0,3,0
80206,5,2,280961,280961,280963,0,2,2
80207,2,1,280963,280963,280964,0,1,0
80208,6,2,280969,280969,280971,0,2,5
80209,4,1,280973,280973,280974,0,1,2
80210,6,2,280979,280979,280981,0,2,5
80211,3,2,280982,280982,280984,0,2,1
80212,1,3,280983,280984,280987,1,4,0
80213,1,2,280984,280987,280989,3,5,0
80214,2,1,280986,280989,280990,3,4,0
80215,6,3,280992,280992,280995,0,3,2
80216,1,1,280993,280995,280996,2,3,0
80217,4,2,280997,280997,280999,0,2,1
80218,5,2,281002,281002,281004,0,2,3
80219,1,1,281003,281004,281005,1,2,0
80220,6,1,281009,281009,281010,0,1,4
80221,3,2,281012,281012,281014,0,2,2
80222,5,2,281017,281017,281019,0,2,3
80223,6,3,281023,281023,281026,0,3,4
80224,1,2,281024,281026,281028,2,4,0
80225,2,3,281026,281028,281031,2,5,0
80226,1,1,281027,281031,281032,4,5,0
80227,6,1,281033,281033,281034,0,1,1
80228,4,3,281037,281037,281040,0,3,3
80229,1,2,281038,281040,281042,2,4,0
80230,1,3,281039,281042,281045,3,6,0
80231,6,2,281045,281045,281047,0,2,0
80232,5,2,281050,281050,281052,0,2,3
80233,2,3,281052,281052,281055,0,3,0
80234,5,2,281057,281057,281059,0,2,2
80235,1,2,281058,281059,281061,1,3,0
80236,6,1,281064,281064,281065,0,1,3
80237,1,2,281065,281065,281067,0,2,0
80238,2,3,281067,281067,281070,0,3,0
80239,4,1,281071,281071,281072,0,1,1
80240,4,1,281075,281075,281076,0,1,3
80241,1,1,281076,281076,281077,0,1,0
80242,2,2,281078,281078,281080,0,2,1
80243,4,3,281082,281082,281085,0,3,2
80244,2,1,281084,281085,281086,1,2,0
80245,6,1,281090,281090,281091,0,1,4
80246,1,3,281091,281091,281094,0,3,0
80247,4,3,281095,281095,281098,0,3,1
80248,3,1,281098,281098,281099,0,1,0
80249,2,1,281100,281100,281101,0,1,1
80250,1,3,281101,281101,281104,0,3,0
80251,1,3,281102,281104,281107,2,5,0
80252,1,3,281103,281107,281110,4,7,0
80253,5,3,281108,281110,281113,2,5,0
80254,3,3,281111,281113,281116,2,5,0
80255,5,1,281116,281116,281117,0,1,0
80256,4,2,281120,281120,281122,0,2,3
80257,5,2,281125,281125,281127,0,2,3
80258,4,2,281129,281129,281131,0,2,2
80259,5,1,281134,281134,281135,0,1,3
80260,3,3,281137,281137,281140,0,3,2
80261,4,2,281141,281141,281143,0,2,1
80262,3,2,281144,281144,281146,0,2,1
80263,3,3,281147,281147,281150,0,3,1
80264,1,1,281148,281150,281151,2,3,0
80265,5,2,281153,281153,281155,0,2,2
80266,2,3,281155,281155,281158,0,3,0
80267,2,3,281157,281158,281161,1,4,0
80268,1,2,281158,281161,281163,3,5,0
80269,4,3,281162,281163,281166,1,4,0
80270,6,1,281168,281168,281169,0,1,2
80271,4,3,281172,281172,281175,0,3,3
80272,2,3,281174,281175,281178,1,4,0
80273,3,1,281177,281178,281179,1,2,0
80274,3,1,281180,281180,281181,0,1,1
80275,5,3,281185,281185,281188,0,3,4
80276,3,1,281188,281188,281189,0,1,0
80277,4,2,281192,281192,281194,0,2,3
80278,5,2,281197,281197,281199,0,2,3
80279,4,3,281201,281201,281204,0,3,2
80280,3,1,281204,281204,281205,0,1,0
80281,1,2,281205,281205,281207,0,2,0
80282,3,2,281208,281208,281210,0,2,1
80283,5,3,281213,281213,281216,0,3,3
80284,3,1,281216,281216,281217,0,1,0
80285,3,1,281219,281219,281220,0,1,2
80286,2,2,281221,281221,281223,0,2,1
80287,1,1,281222,281223,281224,1,2,0
80288,6,3,281228,281228,281231,0,3,4
80289,4,1,281232,281232,281233,0,1,1
80290,5,1,281237,281237,281238,0,1,4
80291,1,3,281238,281238,281241,0,3,0
80292,6,2,281244,281244,281246,0,2,3
80293,6,3,281250,281250,281253,0,3,4
80294,5,2,281255,281255,281257,0,2,2
80295,1,3,281256,281257,281260,1,4,0
80296,5,3,281261,281261,281264,0,3,1
80297,3,2,281264,281264,281266,0,2,0
80298,6,1,281270,281270,281271,0,1,4
80299,1,1,281271,281271,281272,0,1,0
80300,1,3,281272,281272,281275,0,3,0
80301,3,1,281275,281275,281276,0,1,0
80302,4,3,281279,281279,281282,0,3,3
80303,1,2,281280,281282,281284,2,4,0
80304,5,3,281285,281285,281288,0,3,1
80305,5,1,281290,281290,281291,0,1,2
80306,2,2,281292,281292,281294,0,2,1
80307,6,1,281298,281298,281299,0,1,4
80308,3,1,281301,281301,281302,0,1,2
80309,1,3,281302,281302,281305,0,3,0
80310,2,3,281304,281305,281308,1,4,0
80311,5,2,281309,281309,281311,0,2,1
80312,4,1,281313,281313,281314,0,1,2
80313,5,2,281318,281318,281320,0,2,4
80314,6,2,281324,281324,281326,0,2,4
80315,4,3,281328,281328,281331,0,3,2
80316,1,1,281329,281331,281332,2,3,0
80317,1,2,281330,281332,281334,2,4,0
80318,2,1,281332,281334,281335,2,3,0
80319,2,3,281334,281335,281338,1,4,0
80320,4,1,281338,281338,281339,0,1,0
80321,3,1,281341,281341,281342,0,1,2
80322,5,1,281346,281346,281347,0,1,4
80323,4,2,281350,281350,281352,0,2,3
80324,5,1,281355,281355,281356,0,1,3
80325,5,2,281360,281360,281362,0,2,4
80326,2,2,281362,281362,281364,0,2,0
80327,6,1,281368,281368,281369,0,1,4
80328,6,1,281374,281374,281375,0,1,5
80329,4,3,281378,281378,281381,0,3,3
80330,4,1,281382,281382,281383,0,1,1
80331,4,3,281386,281386,281389,0,3,3
80332,6,3,281392,281392,281395,0,3,3
80333,4,2,281396,281396,281398,0,2,1
80334,1,1,281397,281398,281399,1,2,0
80335,3,1,281400,281400,281401,0,1,1
80336,1,2,281401,281401,281403,0,2,0
80337,2,1,281403,281403,281404,0,1,0
80338,5,3,281408,281408,281411,0,3,4
80339,5,3,281413,281413,281416,0,3,2
80340,3,2,281416,281416,281418,0,2,0
80341,6,3,281422,281422,281425,0,3,4
80342,6,2,281428,281428,281430,0,2,3
80343,2,3,281430,281430,281433,0,3,0
80344,4,1,281434,281434,281435,0,1,1
80345,5,2,281439,281439,281441,0,2,4
80346,2,2,281441,281441,281443,0,2,0
80347,2,3,281443,281443,281446,0,3,0
80348,6,2,281449,281449,281451,0,2,3
80349,3,1,281452,281452,281453,0,1,1
80350,2,3,281454,281454,281457,0,3,1
80351,2,2,281456,281457,281459,1,3,0
80352,6,2,281462,281462,281464,0,2,3
80353,5,1,281467,281467,281468,0,1,3
80354,3,3,281470,281470,281473,0,3,2
80355,3,2,281473,281473,281475,0,2,0
80356,6,2,281479,281479,281481,0,2,4
80357,1,2,281480,281481,281483,1,3,0
80358,4,1,281484,281484,281485,0,1,1
80359,6,2,281490,281490,281492,0,2,5
80360,4,2,281494,281494,281496,0,2,2
80361,5,1,281499,281499,281500,0,1,3
80362,5,1,281504,281504,281505,0,1,4
80363,5,1,281509,281509,281510,0,1,4
80364,1,1,281510,281510,281511,0,1,0
80365,6,1,281516,281516,281517,0,1,5
80366,6,1,281522,281522,281523,0,1,5
80367,6,1,281528,281528,281529,0,1,5
80368,2,3,281530,281530,281533,0,3,1
80369,1,3,281531,281533,281536,2,5,0
80370,5,2,281536,281536,281538,0,2,0
80371,6,3,281542,281542,281545,0,3,4
80372,3,1,281545,281545,281546,0,1,0
80373,2,2,281547,281547,281549,0,2,1
80374,4,3,281551,281551,281554,0,3,2
80375,6,1,281557,281557,281558,0,1,3
80376,6,3,281563,281563,281566,0,3,5
80377,1,3,281564,281566,281569,2,5,0
80378,2,2,281566,281569,281571,3,5,0
80379,5,1,281571,281571,281572,0,1,0
80380,1,2,281572,281572,281574,0,2,0
80381,2,3,281574,281574,281577,0,3,0
80382,3,2,281577,281577,281579,0,2,0
80383,2,1,281579,281579,281580,0,1,0
80384,5,3,281584,281584,281587,0,3,4
80385,2,3,281586,281587,281590,1,4,0
80386,5,3,281591,281591,281594,0,3,1
80387,2,1,281593,281594,281595,1,2,0
80388,6,1,281599,281599,281600,0,1,4
80389,4,2,281603,281603,281605,0,2,3
80390,1,2,281604,281605,281607,1,3,0
80391,2,2,281606,281607,281609,1,3,0
80392,3,3,281609,281609,281612,0,3,0
80393,6,3,281615,281615,281618,0,3,3
80394,4,2,281619,281619,281621,0,2,1
80395,3,1,281622,281622,281623,0,1,1
80396,3,2,281625,281625,281627,0,2,2
80397,3,3,281628,281628,281631,0,3,1
80398,1,1,281629,281631,281632,2,3,0
80399,6,1,281635,281635,281636,0,1,3
80400,6,2,281641,281641,281643,0,2,5
80401,6,3,281647,281647,281650,0,3,4
80402,3,1,281650,281650,281651,0,1,0
80403,5,2,281655,281655,281657,0,2,4
80404,2,3,281657,281657,281660,0,3,0
80405,4,3,281661,281661,281664,0,3,1
80406,3,1,281664,281664,281665,0,1,0
80407,3,2,281667,281667,281669,0,2,2
80408,2,3,281669,281669,281672,0,3,0
80409,4,2,281673,281673,281675,0,2,1
80410,2,3,281675,281675,281678,0,3,0
80411,6,2,281681,281681,281683,0,2,3
80412,1,2,281682,281683,281685,1,3,0
80413,1,3,281683,281685,281688,2,5,0
80414,6,3,281689,281689,281692,0,3,1
80415,4,2,281693,281693,281695,0,2,1
80416,3,1,281696,281696,281697,0,1,1
80417,4,1,281700,281700,281701,0,1,3
80418,1,2,281701,281701,281703,0,2,0
80419,5,3,281706,281706,281709,0,3,3
80420,4,3,281710,281710,281713,0,3,1
80421,5,3,281715,281715,281718,0,3,2
80422,6,2,281721,281721,281723,0,2,3
80423,6,3,281727,281727,281730,0,3,4
80424,2,2,281729,281730,281732,1,3,0
80425,6,3,281735,281735,281738,0,3,3
80426,2,1,281737,281738,281739,1,2,0
80427,6,1,281743,281743,281744,0,1,4
80428,1,1,281744,281744,281745,0,1,0
80429,4,3,281748,281748,281751,0,3,3
80430,2,2,281750,281751,281753,1,3,0
80431,3,1,281753,281753,281754,0,1,0
80432,3,1,281756,281756,281757,0,1,2
80433,2,2,281758,281758,281760,0,2,1
80434,3,3,281761,281761,281764,0,3,1
80435,4,3,281765,281765,281768,0,3,1
80436,6,3,281771,281771,281774,0,3,3
80437,5,2,281776,281776,281778,0,2,2
80438,2,2,281778,281778,281780,0,2,0
80439,3,3,281781,281781,281784,0,3,1
80440,5,1,281786,281786,281787,0,1,2
80441,3,1,281789,281789,281790,0,1,2
80442,4,3,281793,281793,281796,0,3,3
80443,1,3,281794,281796,281799,2,5,0
80444,2,3,281796,281799,281802,3,6,0
80445,4,1,281800,281802,281803,2,3,0
80446,3,2,281803,281803,281805,0,2,0
80447,3,2,281806,281806,281808,0,2,1
80448,4,2,281810,281810,281812,0,2,2
80449,3,2,281813,281813,281815,0,2,1
80450,6,3,281819,281819,281822,0,3,4
80451,5,3,281824,281824,281827,0,3,2
80452,3,2,281827,281827,281829,0,2,0
80453,3,1,281830,281830,281831,0,1,1
80454,4,3,281834,281834,281837,0,3,3
80455,3,1,281837,281837,281838,0,1,0
80456,3,1,281840,281840,281841,0,1,2
80457,4,3,281844,281844,281847,0,3,3
80458,6,1,281850,281850,281851,0,1,3
80459,2,2,281852,281852,281854,0,2,1
80460,6,3,281858,281858,281861,0,3,4
80461,5,1,281863,281863,281864,0,1,2
80462,3,1,281866,281866,281867,0,1,2
80463,5,1,281871,281871,281872,0,1,4
80464,4,3,281875,281875,281878,0,3,3
80465,1,2,281876,281878,281880,2,4,0
80466,5,3,281881,281881,281884,0,3,1
80467,6,2,281887,281887,281889,0,2,3
80468,4,2,281891,281891,281893,0,2,2
80469,1,2,281892,281893,281895,1,3,0
80470,5,2,281897,281897,281899,0,2,2
80471,2,3,281899,281899,281902,0,3,0
80472,5,3,281904,281904,281907,0,3,2
80473,6,1,281910,281910,281911,0,1,3
80474,5,2,281915,281915,281917,0,2,4
80475,2,2,281917,281917,281919,0,2,0
80476,3,2,281920,281920,281922,0,2,1
80477,6,1,281926,281926,281927,0,1,4
80478,4,3,281930,281930,281933,0,3,3
80479,3,2,281933,281933,281935,0,2,0
80480,1,2,281934,281935,281937,1,3,0
80481,4,1,281938,281938,281939,0,1,1
80482,2,2,281940,281940,281942,0,2,1
80483,6,1,281946,281946,281947,0,1,4
80484,5,3,281951,281951,281954,0,3,4
80485,6,2,281957,281957,281959,0,2,3
80486,4,3,281961,281961,281964,0,3,2
80487,4,1,281965,281965,281966,0,1,1
80488,5,1,281970,281970,281971,0,1,4
80489,1,1,281971,281971,281972,0,1,0
80490,5,3,281976,281976,281979,0,3,4
80491,1,3,281977,281979,281982,2,5,0
80492,4,3,281981,281982,281985,1,4,0
80493,1,3,281982,281985,281988,3,6,0
80494,2,1,281984,281988,281989,4,5,0
80495,5,2,281989,281989,281991,0,2,0
80496,3,1,281992,281992,281993,0,1,1
80497,2,2,281994,281994,281996,0,2,1
80498,1,3,281995,281996,281999,1,4,0
80499,4,3,281999,281999,282002,0,3,0
80500,6,2,282005,282005,282007,0,2,3
80501,1,2,282006,282007,282009,1,3,0
80502,4,2,282010,282010,282012,0,2,1
80503,5,3,282015,282015,282018,0,3,3
80504,1,3,282016,282018,282021,2,5,0
80505,6,2,282022,282022,282024,0,2,1
80506,6,2,282028,282028,282030,0,2,4
80507,2,2,282030,282030,282032,0,2,0
80508,5,1,282035,282035,282036,0,1,3
80509,6,1,282041,282041,282042,0,1,5
80510,3,1,282044,282044,282045,0,1,2
80511,2,3,282046,282046,282049,0,3,1
80512,4,3,282050,282050,282053,0,3,1
80513,4,1,282054,282054,282055,0,1,1
80514,1,3,282055,282055,282058,0,3,0
80515,3,2,282058,282058,282060,0,2,0
80516,2,2,282060,282060,282062,0,2,0
80517,3,1,282063,282063,282064,0,1,1
80518,5,1,282068,282068,282069,0,1,4
80519,1,2,282069,282069,282071,0,2,0
80520,3,3,282072,282072,282075,0,3,1
80521,4,1,282076,282076,282077,0,1,1
80522,2,2,282078,282078,282080,0,2,1
80523,2,3,282080,282080,282083,0,3,0
80524,2,1,282082,282083,282084,1,2,0
80525,2,3,282084,282084,282087,0,3,0
80526,6,3,282090,282090,282093,0,3,3
80527,6,3,282096,282096,282099,0,3,3
80528,2,3,282098,282099,282102,1,4,0
80529,1,1,282099,282102,282103,3,4,0
80530,4,2,282103,282103,282105,0,2,0
80531,4,1,282107,282107,282108,0,1,2
80532,4,2,282111,282111,282113,0,2,3
80533,2,1,282113,282113,282114,0,1,0
80534,6,2,282119,282119,282121,0,2,5
80535,4,3,282123,282123,282126,0,3,2
80536,1,2,282124,282126,282128,2,4,0
80537,6,3,282130,282130,282133,0,3,2
80538,5,1,282135,282135,282136,0,1,2
80539,1,1,282136,282136,282137,0,1,0
80540,4,3,282140,282140,282143,0,3,3
80541,3,3,282143,282143,282146,0,3,0
80542,6,1,282149,282149,282150,0,1,3
80543,6,3,282155,282155,282158,0,3,5
80544,6,1,282161,282161,282162,0,1,3
80545,1,3,282162,282162,282165,0,3,0
80546,5,3,282167,282167,282170,0,3,2
80547,4,2,282171,282171,282173,0,2,1
80548,1,2,282172,282173,282175,1,3,0
80549,2,1,282174,282175,282176,1,2,0
80550,1,2,282175,282176,282178,1,3,0
80551,3,2,282178,282178,282180,0,2,0
80552,5,2,282183,282183,282185,0,2,3
80553,6,2,282189,282189,282191,0,2,4
80554,6,1,282195,282195,282196,0,1,4
80555,4,3,282199,282199,282202,0,3,3
80556,6,3,282205,282205,282208,0,3,3
80557,2,2,282207,282208,282210,1,3,0
80558,5,2,282212,282212,282214,0,2,2
80559,1,3,282213,282214,282217,1,4,0
80560,2,2,282215,282217,282219,2,4,0
80561,5,3,282220,282220,282223,0,3,1
80562,3,2,282223,282223,282225,0,2,0
80563,1,2,282224,282225,282227,1,3,0
80564,6,1,282230,282230,282231,0,1,3
80565,6,2,282236,282236,282238,0,2,5
80566,4,2,282240,282240,282242,0,2,2
80567,5,1,282245,282245,282246,0,1,3
80568,4,1,282249,282249,282250,0,1,3
80569,4,1,282253,282253,282254,0,1,3
80570,1,3,282254,282254,282257,0,3,0
80571,2,2,282256,282257,282259,1,3,0
80572,5,2,282261,282261,282263,0,2,2
80573,2,2,282263,282263,282265,0,2,0
80574,1,2,282264,282265,282267,1,3,0
80575,1,1,282265,282267,282268,2,3,0
80576,1,3,282266,282268,282271,2,5,0
80577,5,1,282271,282271,282272,0,1,0
80578,1,1,282272,282272,282273,0,1,0
80579,4,3,282276,282276,282279,0,3,3
80580,1,1,282277,282279,282280,2,3,0
80581,2,2,282279,282280,282282,1,3,0
80582,4,2,282283,282283,282285,0,2,1
80583,6,2,282289,282289,282291,0,2,4
80584,4,3,282293,282293,282296,0,3,2
80585,3,3,282296,282296,282299,0,3,0
80586,2,2,282298,282299,282301,1,3,0
80587,1,2,282299,282301,282303,2,4,0
80588,4,1,282303,282303,282304,0,1,0
80589,4,1,282307,282307,282308,0,1,3
80590,5,1,282312,282312,282313,0,1,4
80591,3,2,282315,282315,282317,0,2,2
80592,2,1,282317,282317,282318,0,1,0
80593,3,2,282320,282320,282322,0,2,2
80594,1,1,282321,282322,282323,1,2,0
80595,1,1,282322,282323,282324,1,2,0
80596,1,3,282323,282324,282327,1,4,0
80597,5,1,282328,282328,282329,0,1,1
80598,1,1,282329,282329,282330,0,1,0
80599,4,2,282333,282333,282335,0,2,3
80600,4,1,282337,282337,282338,0,1,2
80601,5,2,282342,282342,282344,0,2,4
80602,1,2,282343,282344,282346,1,3,0
80603,1,1,282344,282346,282347,2,3,0
80604,2,2,282346,282347,282349,1,3,0
80605,4,2,282350,282350,282352,0,2,1
80606,5,3,282355,282355,282358,0,3,3
80607,1,3,282356,282358,282361,2,5,0
80608,4,1,282360,282361,282362,1,2,0
80609,5,2,282365,282365,282367,0,2,3
80610,5,2,282370,282370,282372,0,2,3
80611,2,1,282372,282372,282373,0,1,0
80612,3,1,282375,282375,282376,0,1,2
80613,5,1,282380,282380,282381,0,1,4
80614,1,1,282381,282381,282382,0,1,0
80615,5,3,282386,282386,282389,0,3,4
80616,2,2,282388,282389,282391,1,3,0
80617,2,1,282390,282391,282392,1,2,0
80618,5,2,282395,282395,282397,0,2,3
80619,4,3,282399,282399,282402,0,3,2
80620,4,2,282403,282403,282405,0,2,1
80621,1,2,282404,282405,282407,1,3,0
80622,4,3,282408,282408,282411,0,3,1
80623,3,3,282411,282411,282414,0,3,0
80624,2,1,282413,282414,282415,1,2,0
80625,6,2,282419,282419,282421,0,2,4
80626,5,1,282424,282424,282425,0,1,3
80627,4,2,282428,282428,282430,0,2,3
80628,4,3,282432,282432,282435,0,3,2
80629,4,1,282436,282436,282437,0,1,1
80630,2,2,282438,282438,282440,0,2,1
80631,3,3,282441,282441,282444,0,3,1
80632,3,2,282444,282444,282446,0,2,0
80633,5,2,282449,282449,282451,0,2,3
80634,6,3,282455,282455,282458,0,3,4
80635,5,2,282460,282460,282462,0,2,2
80636,3,3,282463,282463,282466,0,3,1
80637,2,2,282465,282466,282468,1,3,0
80638,4,2,282469,282469,282471,0,2,1
80639,3,3,282472,282472,282475,0,3,1
80640,2,2,282474,282475,282477,1,3,0
80641,4,1,282478,282478,282479,0,1,1
80642,3,2,282481,282481,282483,0,2,2
80643,3,3,282484,282484,282487,0,3,1
80644,6,2,282490,282490,282492,0,2,3
80645,6,1,282496,282496,282497,0,1,4
80646,4,3,282500,282500,282503,0,3,3
80647,2,1,282502,282503,282504,1,2,0
80648,6,1,282508,282508,282509,0,1,4
80649,4,1,282512,282512,282513,0,1,3
80650,3,1,282515,282515,282516,0,1,2
80651,4,1,282519,282519,282520,0,1,3
80652,6,2,282525,282525,282527,0,2,5
80653,4,3,282529,282529,282532,0,3,2
80654,4,3,282533,282533,282536,0,3,1
80655,3,2,282536,282536,282538,0,2,0
80656,6,3,282542,282542,282545,0,3,4
80657,6,3,282548,282548,282551,0,3,3
80658,5,2,282553,282553,282555,0,2,2
80659,1,3,282554,282555,282558,1,4,0
80660,5,1,282559,282559,282560,0,1,1
80661,4,2,282563,282563,282565,0,2,3
80662,4,3,282567,282567,282570,0,3,2
80663,2,1,282569,282570,282571,1,2,0
80664,3,3,282572,282572,282575,0,3,1
80665,1,3,282573,282575,282578,2,5,0
80666,2,1,282575,282578,282579,3,4,0
80667,4,1,282579,282579,282580,0,1,0
80668,2,1,282581,282581,282582,0,1,1
80669,4,1,282585,282585,282586,0,1,3
80670,6,3,282591,282591,282594,0,3,5
80671,5,3,282596,282596,282599,0,3,2
80672,4,1,282600,282600,282601,0,1,1
80673,1,3,282601,282601,282604,0,3,0
80674,3,1,282604,282604,282605,0,1,0
80675,3,2,282607,282607,282609,0,2,2
80676,5,3,282612,282612,282615,0,3,3
80677,4,3,282616,282616,282619,0,3,1
80678,3,1,282619,282619,282620,0,1,0
80679,3,3,282622,282622,282625,0,3,2
80680,5,3,282627,282627,282630,0,3,2
80681,1,3,282628,282630,282633,2,5,0
80682,2,1,282630,282633,282634,3,4,0
80683,6,2,282636,282636,282638,0,2,2
80684,2,2,282638,282638,282640,0,2,0
80685,2,2,282640,282640,282642,0,2,0
80686,4,1,282644,282644,282645,0,1,2
80687,6,1,282650,282650,282651,0,1,5
80688,1,2,282651,282651,282653,0,2,0
80689,2,1,282653,282653,282654,0,1,0
80690,2,3,282655,282655,282658,0,3,1
80691,1,2,282656,282658,282660,2,4,0
80692,6,1,282662,282662,282663,0,1,2
80693,4,3,282666,282666,282669,0,3,3
80694,3,2,282669,282669,282671,0,2,0
80695,4,3,282673,282673,282676,0,3,2
80696,6,1,282679,282679,282680,0,1,3
80697,2,2,282681,282681,282683,0,2,1
80698,6,2,282687,282687,282689,0,2,4
80699,6,3,282693,282693,282696,0,3,4
80700,5,2,282698,282698,282700,0,2,2
80701,3,3,282701,282701,282704,0,3,1
80702,1,2,282702,282704,282706,2,4,0
80703,5,3,282707,282707,282710,0,3,1
80704,2,2,282709,282710,282712,1,3,0
80705,3,3,282712,282712,282715,0,3,0
80706,2,3,282714,282715,282718,1,4,0
80707,2,3,282716,282718,282721,2,5,0
80708,2,1,282718,282721,282722,3,4,0
80709,1,2,282719,282722,282724,3,5,0
80710,6,1,282725,282725,282726,0,1,1
80711,2,2,282727,282727,282729,0,2,1
80712,4,3,282731,282731,282734,0,3,2
80713,6,1,282737,282737,282738,0,1,3
80714,5,3,282742,282742,282745,0,3,4
80715,4,2,282746,282746,282748,0,2,1
80716,6,2,282752,282752,282754,0,2,4
80717,6,2,282758,282758,282760,0,2,4
80718,1,2,282759,282760,282762,1,3,0
80719,5,1,282764,282764,282765,0,1,2
80720,4,1,282768,282768,282769,0,1,3
80721,2,2,282770,282770,282772,0,2,1
80722,1,2,282771,282772,282774,1,3,0
80723,5,2,282776,282776,282778,0,2,2
80724,1,3,282777,282778,282781,1,4,0
80725,4,1,282781,282781,282782,0,1,0
80726,2,3,282783,282783,282786,0,3,1
80727,6,2,282789,282789,282791,0,2,3
80728,6,2,282795,282795,282797,0,2,4
80729,4,2,282799,282799,282801,0,2,2
80730,4,2,282803,282803,282805,0,2,2
80731,6,2,282809,282809,282811,0,2,4
80732,4,2,282813,282813,282815,0,2,2
80733,3,2,282816,282816,282818,0,2,1
80734,5,3,282821,282821,282824,0,3,3
80735,2,1,282823,282824,282825,1,2,0
80736,4,3,282827,282827,282830,0,3,2
80737,3,2,282830,282830,282832,0,2,0
80738,4,3,282834,282834,282837,0,3,2
80739,6,1,282840,282840,282841,0,1,3
80740,4,3,282844,282844,282847,0,3,3
80741,4,1,282848,282848,282849,0,1,1
80742,3,3,282851,282851,282854,0,3,2
80743,3,1,282854,282854,282855,0,1,0
80744,6,3,282860,282860,282863,0,3,5
80745,6,3,282866,282866,282869,0,3,3
80746,6,3,282872,282872,282875,0,3,3
80747,2,2,282874,282875,282877,1,3,0
80748,1,1,282875,282877,282878,2,3,0
80749,5,3,282880,282880,282883,0,3,2
80750,4,2,282884,282884,282886,0,2,1
80751,2,3,282886,282886,282889,0,3,0
80752,4,2,282890,282890,282892,0,2,1
80753,4,2,282894,282894,282896,0,2,2
80754,6,2,282900,282900,282902,0,2,4
80755,2,1,282902,282902,282903,0,1,0
80756,6,3,282908,282908,282911,0,3,5
80757,2,1,282910,282911,282912,1,2,0
80758,4,2,282914,282914,282916,0,2,2
80759,3,2,282917,282917,282919,0,2,1
80760,4,3,282921,282921,282924,0,3,2
80761,4,3,282925,282925,282928,0,3,1
80762,3,3,282928,282928,282931,0,3,0
80763,1,1,282929,282931,282932,2,3,0
80764,5,3,282934,282934,282937,0,3,2
80765,5,1,282939,282939,282940,0,1,2
80766,6,1,282945,282945,282946,0,1,5
80767,4,2,282949,282949,282951,0,2,3
80768,6,3,282955,282955,282958,0,3,4
80769,5,1,282960,282960,282961,0,1,2
80770,1,1,282961,282961,282962,0,1,0
80771,2,2,282963,282963,282965,0,2,1
80772,4,2,282967,282967,282969,0,2,2
80773,1,2,282968,282969,282971,1,3,0
80774,4,1,282972,282972,282973,0,1,1
80775,1,1,282973,282973,282974,0,1,0
80776,1,1,282974,282974,282975,0,1,0
80777,4,2,282978,282978,282980,0,2,3
80778,1,1,282979,282980,282981,1,2,0
80779,2,2,282981,282981,282983,0,2,0
80780,3,1,282984,282984,282985,0,1,1
80781,2,3,282986,282986,282989,0,3,1
80782,6,1,282992,282992,282993,0,1,3
80783,5,1,282997,282997,282998,0,1,4
80784,2,1,282999,282999,283000,0,1,1
80785,3,2,283002,283002,283004,0,2,2
80786,1,3,283003,283004,283007,1,4,0
80787,6,3,283009,283009,283012,0,3,2
80788,5,2,283014,283014,283016,0,2,2
80789,2,2,283016,283016,283018,0,2,0
80790,1,3,283017,283018,283021,1,4,0
80791,3,1,283020,283021,283022,1,2,0
80792,4,2,283024,283024,283026,0,2,2
80793,4,2,283028,283028,283030,0,2,2
80794,3,3,283031,283031,283034,0,3,1
80795,1,3,283032,283034,283037,2,5,0
80796,3,3,283035,283037,283040,2,5,0
80797,4,3,283039,283040,283043,1,4,0
80798,1,2,283040,283043,283045,3,5,0
80799,1,3,283041,283045,283048,4,7,0
80800,5,2,283046,283048,283050,2,4,0
80801,6,1,283052,283052,283053,0,1,2
80802,6,1,283058,283058,283059,0,1,5
80803,2,1,283060,283060,283061,0,1,1
80804,2,3,283062,283062,283065,0,3,1
80805,4,3,283066,283066,283069,0,3,1
80806,3,3,283069,283069,283072,0,3,0
80807,6,1,283075,283075,283076,0,1,3
80808,4,2,283079,283079,283081,0,2,3
80809,3,3,283082,283082,283085,0,3,1
80810,1,1,283083,283085,283086,2,3,0
80811,4,1,283087,283087,283088,0,1,1
80812,5,1,283092,283092,283093,0,1,4
80813,4,3,283096,283096,283099,0,3,3
80814,2,3,283098,283099,283102,1,4,0
80815,5,2,283103,283103,283105,0,2,1
80816,1,2,283104,283105,283107,1,3,0
80817,6,1,283110,283110,283111,0,1,3
80818,5,2,283115,283115,283117,0,2,4
80819,3,2,283118,283118,283120,0,2,1
80820,5,1,283123,283123,283124,0,1,3
80821,1,1,283124,283124,283125,0,1,0
80822,2,1,283126,283126,283127,0,1,1
80823,6,3,283132,283132,283135,0,3,5
80824,1,2,283133,283135,283137,2,4,0
80825,2,1,283135,283137,283138,2,3,0
80826,3,3,283138,283138,283141,0,3,0
80827,5,2,283143,283143,283145,0,2,2
80828,1,2,283144,283145,283147,1,3,0
80829,6,3,283150,283150,283153,0,3,3
80830,3,3,283153,283153,283156,0,3,0
80831,4,3,283157,283157,283160,0,3,1
80832,2,2,283159,283160,283162,1,3,0
80833,4,3,283163,283163,283166,0,3,1
80834,4,3,283167,283167,283170,0,3,1
80835,1,1,283168,283170,283171,2,3,0
80836,1,3,283169,283171,283174,2,5,0
80837,6,2,283175,283175,283177,0,2,1
80838,1,3,283176,283177,283180,1,4,0
80839,4,3,283180,283180,283183,0,3,0
80840,5,2,283185,283185,283187,0,2,2
80841,1,3,283186,283187,283190,1,4,0
80842,5,3,283191,283191,283194,0,3,1
80843,5,1,283196,283196,283197,0,1,2
80844,3,2,283199,283199,283201,0,2,2
80845,6,3,283205,283205,283208,0,3,4
80846,4,2,283209,283209,283211,0,2,1
80847,3,3,283212,283212,283215,0,3,1
80848,5,1,283217,283217,283218,0,1,2
80849,6,3,283223,283223,283226,0,3,5
80850,5,1,283228,283228,283229,0,1,2
80851,4,1,283232,283232,283233,0,1,3
80852,3,3,283235,283235,283238,0,3,2
80853,1,2,283236,283238,283240,2,4,0
80854,4,3,283240,283240,283243,0,3,0
80855,6,3,283246,283246,283249,0,3,3
80856,5,2,283251,283251,283253,0,2,2
80857,5,3,283256,283256,283259,0,3,3
80858,4,3,283260,283260,283263,0,3,1
80859,4,2,283264,283264,283266,0,2,1
80860,1,2,283265,283266,283268,1,3,0
80861,1,2,283266,283268,283270,2,4,0
80862,1,2,283267,283270,283272,3,5,0
80863,6,1,283273,283273,283274,0,1,1
80864,3,2,283276,283276,283278,0,2,2
80865,5,1,283281,283281,283282,0,1,3
80866,2,1,283283,283283,283284,0,1,1
80867,2,3,283285,283285,283288,0,3,1
80868,3,3,283288,283288,283291,0,3,0
80869,4,3,283292,283292,283295,0,3,1
80870,6,2,283298,283298,283300,0,2,3
80871,5,1,283303,283303,283304,0,1,3
80872,5,2,283308,283308,283310,0,2,4
80873,2,1,283310,283310,283311,0,1,0
80874,5,2,283315,283315,283317,0,2,4
80875,6,2,283321,283321,283323,0,2,4
80876,2,2,283323,283323,283325,0,2,0
80877,1,3,283324,283325,283328,1,4,0
80878,6,3,283330,283330,283333,0,3,2
80879,1,1,283331,283333,283334,2,3,0
80880,3,3,283334,283334,283337,0,3,0
80881,5,3,283339,283339,283342,0,3,2
80882,4,3,283343,283343,283346,0,3,1
80883,2,2,283345,283346,283348,1,3,0
80884,2,2,283347,283348,283350,1,3,0
80885,4,1,283351,283351,283352,0,1,1
80886,4,1,283355,283355,283356,0,1,3
80887,3,2,283358,283358,283360,0,2,2
80888,4,3,283362,283362,283365,0,3,2
80889,6,2,283368,283368,283370,0,2,3
80890,3,1,283371,283371,283372,0,1,1
80891,1,2,283372,283372,283374,0,2,0
80892,2,2,283374,283374,283376,0,2,0
80893,1,1,283375,283376,283377,1,2,0
80894,3,1,283378,283378,283379,0,1,1
80895,2,1,283380,283380,283381,0,1,1
80896,5,2,283385,283385,283387,0,2,4
80897,4,1,283389,283389,283390,0,1,2
80898,1,2,283390,283390,283392,0,2,0
80899,4,2,283394,283394,283396,0,2,2
80900,2,1,283396,283396,283397,0,1,0
80901,2,1,283398,283398,283399,0,1,1
80902,6,2,283404,283404,283406,0,2,5
80903,1,3,283405,283406,283409,1,4,0
80904,1,1,283406,283409,283410,3,4,0
80905,5,2,283411,283411,283413,0,2,1
80906,2,2,283413,283413,283415,0,2,0
80907,5,1,283418,283418,283419,0,1,3
80908,6,3,283424,283424,283427,0,3,5
80909,4,1,283428,283428,283429,0,1,1
80910,5,1,283433,283433,283434,0,1,4
80911,4,2,283437,283437,283439,0,2,3
80912,2,2,283439,283439,283441,0,2,0
80913,2,3,283441,283441,283444,0,3,0
80914,3,1,283444,283444,283445,0,1,0
80915,2,1,283446,283446,283447,0,1,1
80916,6,2,283452,283452,283454,0,2,5
80917,6,2,283458,283458,283460,0,2,4
80918,1,2,283459,283460,283462,1,3,0
80919,2,1,283461,283462,283463,1,2,0
80920,1,1,283462,283463,283464,1,2,0
80921,4,2,283466,283466,283468,0,2,2
80922,6,2,283472,283472,283474,0,2,4
80923,4,3,283476,283476,283479,0,3,2
80924,2,3,283478,283479,283482,1,4,0
80925,6,2,283484,283484,283486,0,2,2
80926,1,1,283485,283486,283487,1,2,0
80927,1,3,283486,283487,283490,1,4,0
80928,5,1,283491,283491,283492,0,1,1
80929,1,2,283492,283492,283494,0,2,0
80930,2,2,283494,283494,283496,0,2,0
80931,6,3,283500,283500,283503,0,3,4
80932,5,2,283505,283505,283507,0,2,2
80933,2,3,283507,283507,283510,0,3,0
80934,2,2,283509,283510,283512,1,3,0
80935,6,2,283515,283515,283517,0,2,3
80936,4,1,283519,283519,283520,0,1,2
80937,3,1,283522,283522,283523,0,1,2
80938,3,2,283525,283525,283527,0,2,2
80939,4,1,283529,283529,283530,0,1,2
80940,1,1,283530,283530,283531,0,1,0
80941,2,1,283532,283532,283533,0,1,1
80942,3,1,283535,283535,283536,0,1,2
80943,2,1,283537,283537,283538,0,1,1
80944,5,3,283542,283542,283545,0,3,4
80945,4,1,283546,283546,283547,0,1,1
80946,1,2,283547,283547,283549,0,2,0
80947,6,3,283553,283553,283556,0,3,4
80948,3,3,283556,283556,283559,0,3,0
80949,6,1,283562,283562,283563,0,1,3
80950,1,2,283563,283563,283565,0,2,0
80951,6,3,283569,283569,283572,0,3,4
80952,3,3,283572,283572,283575,0,3,0
80953,5,1,283577,283577,283578,0,1,2
80954,5,2,283582,283582,283584,0,2,4
80955,5,3,283587,283587,283590,0,3,3
80956,4,1,283591,283591,283592,0,1,1
80957,2,1,283593,283593,283594,0,1,1
80958,5,3,283598,283598,283601,0,3,4
80959,1,3,283599,283601,283604,2,5,0
80960,6,1,283605,283605,283606,0,1,1
80961,4,3,283609,283609,283612,0,3,3
80962,6,1,283615,283615,283616,0,1,3
80963,4,1,283619,283619,283620,0,1,3
80964,6,2,283625,283625,283627,0,2,5
80965,1,3,283626,283627,283630,1,4,0
80966,5,1,283631,283631,283632,0,1,1
80967,6,2,283637,283637,283639,0,2,5
80968,6,3,283643,283643,283646,0,3,4
80969,4,1,283647,283647,283648,0,1,1
80970,3,3,283650,283650,283653,0,3,2
80971,4,2,283654,283654,283656,0,2,1
80972,6,1,283660,283660,283661,0,1,4
80973,2,3,283662,283662,283665,0,3,1
80974,1,2,283663,283665,283667,2,4,0
80975,4,1,283667,283667,283668,0,1,0
80976,5,3,283672,283672,283675,0,3,4
80977,1,3,283673,283675,283678,2,5,0
80978,4,2,283677,283678,283680,1,3,0
80979,4,1,283681,283681,283682,0,1,1
80980,4,3,283685,283685,283688,0,3,3
80981,6,2,283691,283691,283693,0,2,3
80982,1,3,283692,283693,283696,1,4,0
80983,5,3,283697,283697,283700,0,3,1
80984,3,2,283700,283700,283702,0,2,0
80985,5,2,283705,283705,283707,0,2,3
80986,6,1,283711,283711,283712,0,1,4
80987,1,2,283712,283712,283714,0,2,0
80988,1,3,283713,283714,283717,1,4,0
80989,6,3,283719,283719,283722,0,3,2
80990,2,1,283721,283722,283723,1,2,0
80991,5,2,283726,283726,283728,0,2,3
80992,1,1,283727,283728,283729,1,2,0
80993,2,3,283729,283729,283732,0,3,0
80994,5,3,283734,283734,283737,0,3,2
80995,2,1,283736,283737,283738,1,2,0
80996,1,2,283737,283738,283740,1,3,0
80997,5,2,283742,283742,283744,0,2,2
80998,5,2,283747,283747,283749,0,2,3
80999,3,2,283750,283750,283752,0,2,1
81000,5,1,283755,283755,283756,0,1,3
81001,3,3,283758,283758,283761,0,3,2
81002,3,1,283761,283761,283762,0,1,0
81003,1,3,283762,283762,283765,0,3,0
81004,1,1,283763,283765,283766,2,3,0
81005,1,1,283764,283766,283767,2,3,0
81006,4,1,283768,283768,283769,0,1,1
81007,1,1,283769,283769,283770,0,1,0
81008,3,1,283772,283772,283773,0,1,2
81009,6,3,283778,283778,283781,0,3,5
81010,6,3,283784,283784,283787,0,3,3
81011,6,2,283790,283790,283792,0,2,3
81012,6,2,283796,283796,283798,0,2,4
81013,1,3,283797,283798,283801,1,4,0
81014,2,1,283799,283801,283802,2,3,0
81015,6,2,283805,283805,283807,0,2,3
81016,3,1,283808,283808,283809,0,1,1
81017,6,1,283814,283814,283815,0,1,5
81018,2,3,283816,283816,283819,0,3,1
81019,6,3,283822,283822,283825,0,3,3
81020,4,1,283826,283826,283827,0,1,1
81021,4,1,283830,283830,283831,0,1,3
81022,2,2,283832,283832,283834,0,2,1
81023,6,1,283838,283838,283839,0,1,4
81024,2,2,283840,283840,283842,0,2,1
81025,1,3,283841,283842,283845,1,4,0
81026,2,1,283843,283845,283846,2,3,0
81027,3,1,283846,283846,283847,0,1,0
81028,5,2,283851,283851,283853,0,2,4
81029,4,1,283855,283855,283856,0,1,2
81030,1,2,283856,283856,283858,0,2,0
81031,5,3,283861,283861,283864,0,3,3
81032,3,3,283864,283864,283867,0,3,0
81033,2,3,283866,283867,283870,1,4,0
81034,2,2,283868,283870,283872,2,4,0
81035,5,1,283873,283873,283874,0,1,1
81036,1,1,283874,283874,283875,0,1,0
81037,3,3,283877,283877,283880,0,3,2
81038,3,2,283880,283880,283882,0,2,0
81039,4,2,283884,283884,283886,0,2,2
81040,6,2,283890,283890,283892,0,2,4
81041,6,3,283896,283896,283899,0,3,4
81042,5,3,283901,283901,283904,0,3,2
81043,3,1,283904,283904,283905,0,1,0
81044,4,2,283908,283908,283910,0,2,3
81045,1,1,283909,283910,283911,1,2,0
81046,3,2,283912,283912,283914,0,2,1
81047,2,3,283914,283914,283917,0,3,0
81048,4,3,283918,283918,283921,0,3,1
81049,2,3,283920,283921,283924,1,4,0
81050,3,3,283923,283924,283927,1,4,0
81051,2,3,283925,283927,283930,2,5,0
81052,6,2,283931,283931,283933,0,2,1
81053,4,3,283935,283935,283938,0,3,2
81054,2,2,283937,283938,283940,1,3,0
81055,6,3,283943,283943,283946,0,3,3
81056,4,1,283947,283947,283948,0,1,1
81057,5,3,283952,283952,283955,0,3,4
81058,1,3,283953,283955,283958,2,5,0
81059,4,2,283957,283958,283960,1,3,0
81060,3,2,283960,283960,283962,0,2,0
81061,1,2,283961,283962,283964,1,3,0
81062,6,1,283967,283967,283968,0,1,3
81063,1,2,283968,283968,283970,0,2,0
81064,5,1,283973,283973,283974,0,1,3
81065,6,2,283979,283979,283981,0,2,5
81066,4,1,283983,283983,283984,0,1,2
81067,3,3,283986,283986,283989,0,3,2
81068,2,3,283988,283989,283992,1,4,0
81069,1,3,283989,283992,283995,3,6,0
81070,6,2,283995,283995,283997,0,2,0
81071,5,1,284000,284000,284001,0,1,3
81072,1,1,284001,284001,284002,0,1,0
81073,2,3,284003,284003,284006,0,3,1
81074,1,2,284004,284006,284008,2,4,0
81075,4,3,284008,284008,284011,0,3,0
81076,1,1,284009,284011,284012,2,3,0
81077,1,1,284010,284012,284013,2,3,0
81078,5,2,284015,284015,284017,0,2,2
81079,4,2,284019,284019,284021,0,2,2
81080,2,2,284021,284021,284023,0,2,0
81081,5,1,284026,284026,284027,0,1,3
81082,3,1,284029,284029,284030,0,1,2
81083,3,2,284032,284032,284034,0,2,2
81084,5,1,284037,284037,284038,0,1,3
81085,2,1,284039,284039,284040,0,1,1
81086,5,3,284044,284044,284047,0,3,4
81087,6,2,284050,284050,284052,0,2,3
81088,5,3,284055,284055,284058,0,3,3
81089,4,1,284059,284059,284060,0,1,1
81090,6,2,284065,284065,284067,0,2,5
81091,1,1,284066,284067,284068,1,2,0
81092,2,3,284068,284068,284071,0,3,0
81093,1,3,284069,284071,284074,2,5,0
81094,2,3,284071,284074,284077,3,6,0
81095,3,1,284074,284077,284078,3,4,0
81096,5,2,284079,284079,284081,0,2,1
81097,1,1,284080,284081,284082,1,2,0
81098,3,1,284083,284083,284084,0,1,1
81099,2,1,284085,284085,284086,0,1,1
81100,4,1,284089,284089,284090,0,1,3
81101,2,3,284091,284091,284094,0,3,1
81102,4,1,284095,284095,284096,0,1,1
81103,2,3,284097,284097,284100,0,3,1
81104,5,2,284102,284102,284104,0,2,2
81105,6,2,284108,284108,284110,0,2,4
81106,4,3,284112,284112,284115,0,3,2
81107,4,3,284116,284116,284119,0,3,1
81108,1,1,284117,284119,284120,2,3,0
81109,2,3,284119,284120,284123,1,4,0
81110,4,1,284123,284123,284124,0,1,0
81111,4,2,284127,284127,284129,0,2,3
81112,2,1,284129,284129,284130,0,1,0
81113,2,2,284131,284131,284133,0,2,1
81114,6,2,284137,284137,284139,0,2,4
81115,2,2,284139,284139,284141,0,2,0
81116,5,2,284144,284144,284146,0,2,3
81117,6,3,284150,284150,284153,0,3,4
81118,2,1,284152,284153,284154,1,2,0
81119,3,1,284155,284155,284156,0,1,1
81120,2,2,284157,284157,284159,0,2,1
81121,6,1,284163,284163,284164,0,1,4
81122,4,3,284167,284167,284170,0,3,3
81123,2,3,284169,284170,284173,1,4,0
81124,2,2,284171,284173,284175,2,4,0
81125,4,1,284175,284175,284176,0,1,0
81126,2,1,284177,284177,284178,0,1,1
81127,6,2,284183,284183,284185,0,2,5
81128,4,1,284187,284187,284188,0,1,2
81129,2,2,284189,284189,284191,0,2,1
81130,1,3,284190,284191,284194,1,4,0
81131,1,1,284191,284194,284195,3,4,0
81132,3,2,284194,284195,284197,1,3,0
81133,6,3,284200,284200,284203,0,3,3
81134,4,3,284204,284204,284207,0,3,1
81135,6,3,284210,284210,284213,0,3,3
81136,5,1,284215,284215,284216,0,1,2
81137,6,3,284221,284221,284224,0,3,5
81138,4,1,284225,284225,284226,0,1,1
81139,4,2,284229,284229,284231,0,2,3
81140,4,3,284233,284233,284236,0,3,2
81141,5,2,284238,284238,284240,0,2,2
81142,5,1,284243,284243,284244,0,1,3
81143,3,3,284246,284246,284249,0,3,2
81144,3,1,284249,284249,284250,0,1,0
81145,1,1,284250,284250,284251,0,1,0
81146,4,3,284254,284254,284257,0,3,3
81147,5,1,284259,284259,284260,0,1,2
81148,3,2,284262,284262,284264,0,2,2
81149,3,2,284265,284265,284267,0,2,1
81150,4,1,284269,284269,284270,0,1,2
81151,6,1,284275,284275,284276,0,1,5
81152,6,2,284281,284281,284283,0,2,5
81153,6,2,284287,284287,284289,0,2,4
81154,2,2,284289,284289,284291,0,2,0
81155,4,1,284293,284293,284294,0,1,2
81156,1,3,284294,284294,284297,0,3,0
81157,2,2,284296,284297,284299,1,3,0
81158,6,3,284302,284302,284305,0,3,3
81159,6,1,284308,284308,284309,0,1,3
81160,5,2,284313,284313,284315,0,2,4
81161,3,3,284316,284316,284319,0,3,1
81162,4,1,284320,284320,284321,0,1,1
81163,2,1,284322,284322,284323,0,1,1
81164,4,3,284326,284326,284329,0,3,3
81165,5,1,284331,284331,284332,0,1,2
81166,2,3,284333,284333,284336,0,3,1
81167,3,3,284336,284336,284339,0,3,0
81168,2,2,284338,284339,284341,1,3,0
81169,5,3,284343,284343,284346,0,3,2
81170,3,1,284346,284346,284347,0,1,0
81171,2,1,284348,284348,284349,0,1,1
81172,4,2,284352,284352,284354,0,2,3
81173,5,3,284357,284357,284360,0,3,3
81174,5,3,284362,284362,284365,0,3,2
81175,1,2,284363,284365,284367,2,4,0
81176,6,1,284369,284369,284370,0,1,2
81177,6,1,284375,284375,284376,0,1,5
81178,5,3,284380,284380,284383,0,3,4
81179,4,2,284384,284384,284386,0,2,1
81180,5,2,284389,284389,284391,0,2,3
81181,2,2,284391,284391,284393,0,2,0
81182,3,3,284394,284394,284397,0,3,1
81183,5,1,284399,284399,284400,0,1,2
81184,6,1,284405,284405,284406,0,1,5
81185,6,1,284411,284411,284412,0,1,5
81186,5,3,284416,284416,284419,0,3,4
81187,2,3,284418,284419,284422,1,4,0
81188,6,2,284424,284424,284426,0,2,2
81189,3,3,284427,284427,284430,0,3,1
81190,6,3,284433,284433,284436,0,3,3
81191,5,1,284438,284438,284439,0,1,2
81192,5,1,284443,284443,284444,0,1,4
81193,1,2,284444,284444,284446,0,2,0
81194,4,1,284448,284448,284449,0,1,2
81195,1,2,284449,284449,284451,0,2,0
81196,1,2,284450,284451,284453,1,3,0
81197,4,1,284454,284454,284455,0,1,1
81198,1,3,284455,284455,284458,0,3,0
81199,4,2,284459,284459,284461,0,2,1
81200,3,2,284462,284462,284464,0,2,1
81201,2,2,284464,284464,284466,0,2,0
81202,6,1,284470,284470,284471,0,1,4
81203,6,1,284476,284476,284477,0,1,5
81204,3,2,284479,284479,284481,0,2,2
81205,4,1,284483,284483,284484,0,1,2
81206,6,2,284489,284489,284491,0,2,5
81207,6,2,284495,284495,284497,0,2,4
81208,5,3,284500,284500,284503,0,3,3
81209,6,1,284506,284506,284507,0,1,3
81210,4,2,284510,284510,284512,0,2,3
81211,6,1,284516,284516,284517,0,1,4
81212,3,2,284519,284519,284521,0,2,2
81213,5,1,284524,284524,284525,0,1,3
81214,5,2,284529,284529,284531,0,2,4
81215,4,3,284533,284533,284536,0,3,2
81216,4,2,284537,284537,284539,0,2,1
81217,3,1,284540,284540,284541,0,1,1
81218,1,1,284541,284541,284542,0,1,0
81219,2,1,284543,284543,284544,0,1,1
81220,5,2,284548,284548,284550,0,2,4
81221,5,2,284553,284553,284555,0,2,3
81222,4,3,284557,284557,284560,0,3,2
81223,5,3,284562,284562,284565,0,3,2
81224,4,3,284566,284566,284569,0,3,1
81225,6,2,284572,284572,284574,0,2,3
81226,6,3,284578,284578,284581,0,3,4
81227,3,2,284581,284581,284583,0,2,0
81228,6,1,284587,284587,284588,0,1,4
81229,6,1,284593,284593,284594,0,1,5
81230,1,2,284594,284594,284596,0,2,0
81231,5,3,284599,284599,284602,0,3,3
81232,5,3,284604,284604,284607,0,3,2
81233,2,3,284606,284607,284610,1,4,0
81234,5,2,284611,284611,284613,0,2,1
81235,5,2,284616,284616,284618,0,2,3
81236,5,3,284621,284621,284624,0,3,3
81237,4,2,284625,284625,284627,0,2,1
81238,1,2,284626,284627,284629,1,3,0
81239,4,3,284630,284630,284633,0,3,1
81240,3,2,284633,284633,284635,0,2,0
81241,4,1,284637,284637,284638,0,1,2
81242,4,1,284641,284641,284642,0,1,3
81243,1,1,284642,284642,284643,0,1,0
81244,3,3,284645,284645,284648,0,3,2
81245,6,3,284651,284651,284654,0,3,3
81246,4,2,284655,284655,284657,0,2,1
81247,5,2,284660,284660,284662,0,2,3
81248,3,2,284663,284663,284665,0,2,1
81249,4,1,284667,284667,284668,0,1,2
81250,1,3,284668,284668,284671,0,3,0
81251,3,1,284671,284671,284672,0,1,0
81252,4,3,284675,284675,284678,0,3,3
81253,5,3,284680,284680,284683,0,3,2
81254,4,3,284684,284684,284687,0,3,1
81255,3,2,284687,284687,284689,0,2,0
81256,3,2,284690,284690,284692,0,2,1
81257,4,1,284694,284694,284695,0,1,2
81258,3,1,284697,284697,284698,0,1,2
81259,1,2,284698,284698,284700,0,2,0
81260,2,3,284700,284700,284703,0,3,0
81261,4,1,284704,284704,284705,0,1,1
81262,6,2,284710,284710,284712,0,2,5
81263,6,3,284716,284716,284719,0,3,4
81264,4,2,284720,284720,284722,0,2,1
81265,2,2,284722,284722,284724,0,2,0
81266,6,2,284728,284728,284730,0,2,4
81267,2,3,284730,284730,284733,0,3,0
81268,1,3,284731,284733,284736,2,5,0
81269,3,3,284734,284736,284739,2,5,0
81270,2,2,284736,284739,284741,3,5,0
81271,1,1,284737,284741,284742,4,5,0
81272,4,1,284741,284742,284743,1,2,0
81273,1,2,284742,284743,284745,1,3,0
81274,5,3,284747,284747,284750,0,3,2
81275,5,2,284752,284752,284754,0,2,2
81276,2,3,284754,284754,284757,0,3,0
81277,1,3,284755,284757,284760,2,5,0
81278,4,3,284759,284760,284763,1,4,0
81279,4,1,284763,284763,284764,0,1,0
81280,6,2,284769,284769,284771,0,2,5
81281,4,1,284773,284773,284774,0,1,2
81282,4,2,284777,284777,284779,0,2,3
81283,2,2,284779,284779,284781,0,2,0
81284,5,1,284784,284784,284785,0,1,3
81285,6,1,284790,284790,284791,0,1,5
81286,2,3,284792,284792,284795,0,3,1
81287,3,3,284795,284795,284798,0,3,0
81288,4,2,284799,284799,284801,0,2,1
81289,4,3,284803,284803,284806,0,3,2
81290,2,1,284805,284806,284807,1,2,0
81291,4,1,284809,284809,284810,0,1,2
81292,2,1,284811,284811,284812,0,1,1
81293,2,2,284813,284813,284815,0,2,1
81294,3,2,284816,284816,284818,0,2,1
81295,1,1,284817,284818,284819,1,2,0
81296,6,1,284823,284823,284824,0,1,4
81297,2,2,284825,284825,284827,0,2,1
81298,5,3,284830,284830,284833,0,3,3
81299,5,2,284835,284835,284837,0,2,2
81300,2,2,284837,284837,284839,0,2,0
81301,4,3,284841,284841,284844,0,3,2
81302,3,1,284844,284844,284845,0,1,0
81303,6,1,284850,284850,284851,0,1,5
81304,1,2,284851,284851,284853,0,2,0
81305,6,2,284857,284857,284859,0,2,4
81306,6,3,284863,284863,284866,0,3,4
81307,1,3,284864,284866,284869,2,5,0
81308,5,2,284869,284869,284871,0,2,0
81309,1,3,284870,284871,284874,1,4,0
81310,2,1,284872,284874,284875,2,3,0
81311,3,2,284875,284875,284877,0,2,0
81312,2,2,284877,284877,284879,0,2,0
81313,2,1,284879,284879,284880,0,1,0
81314,1,3,284880,284880,284883,0,3,0
81315,1,2,284881,284883,284885,2,4,0
81316,3,2,284884,284885,284887,1,3,0
81317,1,1,284885,284887,284888,2,3,0
81318,5,2,284890,284890,284892,0,2,2
81319,4,1,284894,284894,284895,0,1,2
81320,3,2,284897,284897,284899,0,2,2
81321,6,1,284903,284903,284904,0,1,4
81322,5,3,284908,284908,284911,0,3,4
81323,6,3,284914,284914,284917,0,3,3
81324,1,2,284915,284917,284919,2,4,0
81325,4,1,284919,284919,284920,0,1,0
81326,3,3,284922,284922,284925,0,3,2
81327,3,2,284925,284925,284927,0,2,0
81328,6,2,284931,284931,284933,0,2,4
81329,1,3,284932,284933,284936,1,4,0
81330,4,1,284936,284936,284937,0,1,0
81331,1,2,284937,284937,284939,0,2,0
81332,5,1,284942,284942,284943,0,1,3
81333,3,3,284945,284945,284948,0,3,2
81334,3,2,284948,284948,284950,0,2,0
81335,4,3,284952,284952,284955,0,3,2
81336,3,1,284955,284955,284956,0,1,0
81337,4,1,284959,284959,284960,0,1,3
81338,5,3,284964,284964,284967,0,3,4
81339,3,3,284967,284967,284970,0,3,0
81340,1,3,284968,284970,284973,2,5,0
81341,1,2,284969,284973,284975,4,6,0
81342,1,1,284970,284975,284976,5,6,0
81343,2,2,284972,284976,284978,4,6,0
81344,6,1,284978,284978,284979,0,1,0
81345,5,2,284983,284983,284985,0,2,4
81346,6,3,284989,284989,284992,0,3,4
81347,6,3,284995,284995,284998,0,3,3
81348,6,2,285001,285001,285003,0,2,3
81349,3,2,285004,285004,285006,0,2,1
81350,3,3,285007,285007,285010,0,3,1
81351,6,3,285013,285013,285016,0,3,3
81352,3,1,285016,285016,285017,0,1,0
81353,1,1,285017,285017,285018,0,1,0
81354,6,3,285023,285023,285026,0,3,5
81355,3,1,285026,285026,285027,0,1,0
81356,2,1,285028,285028,285029,0,1,1
81357,5,3,285033,285033,285036,0,3,4
81358,6,3,285039,285039,285042,0,3,3
81359,3,3,285042,285042,285045,0,3,0
81360,3,3,285045,285045,285048,0,3,0
81361,6,2,285051,285051,285053,0,2,3
81362,6,3,285057,285057,285060,0,3,4
81363,3,3,285060,285060,285063,0,3,0
81364,2,2,285062,285063,285065,1,3,0
81365,4,1,285066,285066,285067,0,1,1
81366,1,3,285067,285067,285070,0,3,0
81367,2,1,285069,285070,285071,1,2,0
81368,1,3,285070,285071,285074,1,4,0
81369,1,2,285071,285074,285076,3,5,0
81370,6,1,285077,285077,285078,0,1,1
81371,1,3,285078,285078,285081,0,3,0
81372,2,2,285080,285081,285083,1,3,0
81373,1,3,285081,285083,285086,2,5,0
81374,5,2,285086,285086,285088,0,2,0
81375,6,3,285092,285092,285095,0,3,4
81376,6,2,285098,285098,285100,0,2,3
81377,3,1,285101,285101,285102,0,1,1
81378,6,1,285107,285107,285108,0,1,5
81379,5,3,285112,285112,285115,0,3,4
81380,1,2,285113,285115,285117,2,4,0
81381,5,3,285118,285118,285121,0,3,1
81382,2,1,285120,285121,285122,1,2,0
81383,5,3,285125,285125,285128,0,3,3
81384,3,3,285128,285128,285131,0,3,0
81385,6,2,285134,285134,285136,0,2,3
81386,4,2,285138,285138,285140,0,2,2
81387,4,2,285142,285142,285144,0,2,2
81388,4,3,285146,285146,285149,0,3,2
81389,1,3,285147,285149,285152,2,5,0
81390,2,2,285149,285152,285154,3,5,0
81391,6,2,285155,285155,285157,0,2,1
81392,2,2,285157,285157,285159,0,2,0
81393,5,1,285162,285162,285163,0,1,3
81394,2,2,285164,285164,285166,0,2,1
81395,4,3,285168,285168,285171,0,3,2
81396,2,3,285170,285171,285174,1,4,0
81397,2,1,285172,285174,285175,2,3,0
81398,3,2,285175,285175,285177,0,2,0
81399,5,1,285180,285180,285181,0,1,3
81400,4,1,285184,285184,285185,0,1,3
81401,6,2,285190,285190,285192,0,2,5
81402,1,3,285191,285192,285195,1,4,0
81403,4,1,285195,285195,285196,0,1,0
81404,2,3,285197,285197,285200,0,3,1
81405,3,3,285200,285200,285203,0,3,0
81406,3,1,285203,285203,285204,0,1,0
81407,5,3,285208,285208,285211,0,3,4
81408,5,3,285213,285213,285216,0,3,2
81409,2,2,285215,285216,285218,1,3,0
81410,1,2,285216,285218,285220,2,4,0
81411,4,2,285220,285220,285222,0,2,0
81412,4,3,285224,285224,285227,0,3,2
81413,3,1,285227,285227,285228,0,1,0
81414,6,3,285233,285233,285236,0,3,5
81415,4,3,285237,285237,285240,0,3,1
81416,4,3,285241,285241,285244,0,3,1
81417,1,2,285242,285244,285246,2,4,0
81418,2,3,285244,285246,285249,2,5,0
81419,6,3,285250,285250,285253,0,3,1
81420,3,1,285253,285253,285254,0,1,0
81421,2,2,285255,285255,285257,0,2,1
81422,4,3,285259,285259,285262,0,3,2
81423,6,1,285265,285265,285266,0,1,3
81424,3,1,285268,285268,285269,0,1,2
81425,3,1,285271,285271,285272,0,1,2
81426,2,3,285273,285273,285276,0,3,1
81427,3,3,285276,285276,285279,0,3,0
81428,5,3,285281,285281,285284,0,3,2
81429,3,3,285284,285284,285287,0,3,0
81430,3,3,285287,285287,285290,0,3,0
81431,2,1,285289,285290,285291,1,2,0
81432,2,3,285291,285291,285294,0,3,0
81433,1,1,285292,285294,285295,2,3,0
81434,2,3,285294,285295,285298,1,4,0
81435,3,3,285297,285298,285301,1,4,0
81436,5,2,285302,285302,285304,0,2,1
81437,4,1,285306,285306,285307,0,1,2
81438,5,2,285311,285311,285313,0,2,4
81439,5,1,285316,285316,285317,0,1,3
81440,6,1,285322,285322,285323,0,1,5
81441,3,1,285325,285325,285326,0,1,2
81442,1,2,285326,285326,285328,0,2,0
81443,4,3,285330,285330,285333,0,3,2
81444,4,2,285334,285334,285336,0,2,1
81445,5,1,285339,285339,285340,0,1,3
81446,4,2,285343,285343,285345,0,2,3
81447,5,1,285348,285348,285349,0,1,3
81448,1,3,285349,285349,285352,0,3,0
81449,2,2,285351,285352,285354,1,3,0
81450,6,2,285357,285357,285359,0,2,3
81451,4,3,285361,285361,285364,0,3,2
81452,5,3,285366,285366,285369,0,3,2
81453,1,2,285367,285369,285371,2,4,0
81454,6,2,285373,285373,285375,0,2,2
81455,2,1,285375,285375,285376,0,1,0
81456,4,2,285379,285379,285381,0,2,3
81457,2,3,285381,285381,285384,0,3,0
81458,1,1,285382,285384,285385,2,3,0
81459,2,1,285384,285385,285386,1,2,0
81460,2,3,285386,285386,285389,0,3,0
81461,5,3,285391,285391,285394,0,3,2
81462,6,2,285397,285397,285399,0,2,3
81463,2,2,285399,285399,285401,0,2,0
81464,1,1,285400,285401,285402,1,2,0
81465,3,1,285403,285403,285404,0,1,1
81466,6,2,285409,285409,285411,0,2,5
81467,4,3,285413,285413,285416,0,3,2
81468,5,2,285418,285418,285420,0,2,2
81469,1,1,285419,285420,285421,1,2,0
81470,2,1,285421,285421,285422,0,1,0
81471,1,1,285422,285422,285423,0,1,0
81472,2,3,285424,285424,285427,0,3,1
81473,3,3,285427,285427,285430,0,3,0
81474,4,1,285431,285431,285432,0,1,1
81475,6,2,285437,285437,285439,0,2,5
81476,4,3,285441,285441,285444,0,3,2
81477,4,2,285445,285445,285447,0,2,1
81478,4,3,285449,285449,285452,0,3,2
81479,6,1,285455,285455,285456,0,1,3
81480,4,3,285459,285459,285462,0,3,3
81481,2,2,285461,285462,285464,1,3,0
81482,4,3,285465,285465,285468,0,3,1
81483,4,3,285469,285469,285472,0,3,1
81484,5,3,285474,285474,285477,0,3,2
81485,4,1,285478,285478,285479,0,1,1
81486,2,3,285480,285480,285483,0,3,1
81487,4,1,285484,285484,285485,0,1,1
81488,2,1,285486,285486,285487,0,1,1
81489,3,3,285489,285489,285492,0,3,2
81490,1,2,285490,285492,285494,2,4,0
81491,3,3,285493,285494,285497,1,4,0
81492,6,1,285499,285499,285500,0,1,2
81493,3,1,285502,285502,285503,0,1,2
81494,3,2,285505,285505,285507,0,2,2
81495,6,1,285511,285511,285512,0,1,4
81496,5,1,285516,285516,285517,0,1,4
81497,6,1,285522,285522,285523,0,1,5
81498,3,2,285525,285525,285527,0,2,2
81499,1,1,285526,285527,285528,1,2,0
81500,2,3,285528,285528,285531,0,3,0
81501,5,2,285533,285533,285535,0,2,2
81502,2,3,285535,285535,285538,0,3,0
81503,1,2,285536,285538,285540,2,4,0
81504,2,2,285538,285540,285542,2,4,0
81505,2,2,285540,285542,285544,2,4,0
81506,2,1,285542,285544,285545,2,3,0
81507,1,2,285543,285545,285547,2,4,0
81508,4,2,285547,285547,285549,0,2,0
81509,3,3,285550,285550,285553,0,3,1
81510,2,1,285552,285553,285554,1,2,0
81511,4,2,285556,285556,285558,0,2,2
81512,1,3,285557,285558,285561,1,4,0
81513,3,3,285560,285561,285564,1,4,0
81514,1,1,285561,285564,285565,3,4,0
81515,2,2,285563,285565,285567,2,4,0
81516,4,2,285567,285567,285569,0,2,0
81517,6,3,285573,285573,285576,0,3,4
81518,2,1,285575,285576,285577,1,2,0
81519,2,2,285577,285577,285579,0,2,0
81520,2,2,285579,285579,285581,0,2,0
81521,3,2,285582,285582,285584,0,2,1
81522,4,3,285586,285586,285589,0,3,2
81523,6,3,285592,285592,285595,0,3,3
81524,5,2,285597,285597,285599,0,2,2
81525,1,2,285598,285599,285601,1,3,0
81526,6,1,285604,285604,285605,0,1,3
81527,3,2,285607,285607,285609,0,2,2
81528,6,1,285613,285613,285614,0,1,4
81529,4,2,285617,285617,285619,0,2,3
81530,4,3,285621,285621,285624,0,3,2
81531,5,1,285626,285626,285627,0,1,2
81532,4,1,285630,285630,285631,0,1,3
81533,2,1,285632,285632,285633,0,1,1
81534,3,1,285635,285635,285636,0,1,2
81535,4,1,285639,285639,285640,0,1,3
81536,3,2,285642,285642,285644,0,2,2
81537,2,1,285644,285644,285645,0,1,0
81538,6,2,285650,285650,285652,0,2,5
81539,1,3,285651,285652,285655,1,4,0
81540,1,3,285652,285655,285658,3,6,0
81541,5,3,285657,285658,285661,1,4,0
81542,4,3,285661,285661,285664,0,3,0
81543,2,3,285663,285664,285667,1,4,0
81544,1,1,285664,285667,285668,3,4,0
81545,4,1,285668,285668,285669,0,1,0
81546,6,2,285674,285674,285676,0,2,5
81547,5,3,285679,285679,285682,0,3,3
81548,5,1,285684,285684,285685,0,1,2
81549,2,1,285686,285686,285687,0,1,1
81550,1,3,285687,285687,285690,0,3,0
81551,5,1,285692,285692,285693,0,1,2
81552,4,1,285696,285696,285697,0,1,3
81553,4,1,285700,285700,285701,0,1,3
81554,6,3,285706,285706,285709,0,3,5
81555,6,1,285712,285712,285713,0,1,3
81556,6,1,285718,285718,285719,0,1,5
81557,4,1,285722,285722,285723,0,1,3
81558,3,3,285725,285725,285728,0,3,2
81559,2,2,285727,285728,285730,1,3,0
81560,5,2,285732,285732,285734,0,2,2
81561,3,1,285735,285735,285736,0,1,1
81562,1,2,285736,285736,285738,0,2,0
81563,1,3,285737,285738,285741,1,4,0
81564,4,3,285741,285741,285744,0,3,0
81565,2,2,285743,285744,285746,1,3,0
81566,4,2,285747,285747,285749,0,2,1
81567,1,3,285748,285749,285752,1,4,0
81568,5,2,285753,285753,285755,0,2,1
81569,4,2,285757,285757,285759,0,2,2
81570,1,2,285758,285759,285761,1,3,0
81571,4,1,285762,285762,285763,0,1,1
81572,6,1,285768,285768,285769,0,1,5
81573,3,3,285771,285771,285774,0,3,2
81574,5,2,285776,285776,285778,0,2,2
81575,1,3,285777,285778,285781,1,4,0
81576,1,1,285778,285781,285782,3,4,0
81577,3,2,285781,285782,285784,1,3,0
81578,6,1,285787,285787,285788,0,1,3
81579,1,3,285788,285788,285791,0,3,0
81580,4,3,285792,285792,285795,0,3,1
81581,6,3,285798,285798,285801,0,3,3
81582,1,1,285799,285801,285802,2,3,0
81583,4,2,285803,285803,285805,0,2,1
81584,5,1,285808,285808,285809,0,1,3
81585,2,1,285810,285810,285811,0,1,1
81586,5,3,285815,285815,285818,0,3,4
81587,3,1,285818,285818,285819,0,1,0
81588,6,3,285824,285824,285827,0,3,5
81589,2,3,285826,285827,285830,1,4,0
81590,3,3,285829,285830,285833,1,4,0
81591,3,2,285832,285833,285835,1,3,0
81592,4,1,285836,285836,285837,0,1,1
81593,6,1,285842,285842,285843,0,1,5
81594,1,1,285843,285843,285844,0,1,0
81595,3,3,285846,285846,285849,0,3,2
81596,6,3,285852,285852,285855,0,3,3
81597,2,2,285854,285855,285857,1,3,0
81598,5,3,285859,285859,285862,0,3,2
81599,2,3,285861,285862,285865,1,4,0
81600,4,3,285865,285865,285868,0,3,0
81601,5,3,285870,285870,285873,0,3,2
81602,4,3,285874,285874,285877,0,3,1
81603,3,1,285877,285877,285878,0,1,0
81604,6,2,285883,285883,285885,0,2,5
81605,3,2,285886,285886,285888,0,2,1
81606,6,1,285892,285892,285893,0,1,4
81607,5,3,285897,285897,285900,0,3,4
81608,5,1,285902,285902,285903,0,1,2
81609,5,3,285907,285907,285910,0,3,4
81610,5,1,285912,285912,285913,0,1,2
81611,2,1,285914,285914,285915,0,1,1
81612,4,2,285918,285918,285920,0,2,3
81613,1,3,285919,285920,285923,1,4,0
81614,4,3,285923,285923,285926,0,3,0
81615,6,3,285929,285929,285932,0,3,3
81616,4,1,285933,285933,285934,0,1,1
81617,3,3,285936,285936,285939,0,3,2
81618,2,3,285938,285939,285942,1,4,0
81619,3,1,285941,285942,285943,1,2,0
81620,5,1,285946,285946,285947,0,1,3
81621,4,1,285950,285950,285951,0,1,3
81622,4,1,285954,285954,285955,0,1,3
81623,4,1,285958,285958,285959,0,1,3
81624,1,3,285959,285959,285962,0,3,0
81625,5,3,285964,285964,285967,0,3,2
81626,2,1,285966,285967,285968,1,2,0
81627,3,3,285969,285969,285972,0,3,1
81628,6,3,285975,285975,285978,0,3,3
81629,4,1,285979,285979,285980,0,1,1
81630,1,2,285980,285980,285982,0,2,0
81631,3,1,285983,285983,285984,0,1,1
81632,1,3,285984,285984,285987,0,3,0
81633,3,1,285987,285987,285988,0,1,0
81634,1,1,285988,285988,285989,0,1,0
81635,3,2,285991,285991,285993,0,2,2
81636,3,1,285994,285994,285995,0,1,1
81637,5,3,285999,285999,286002,0,3,4
81638,5,3,286004,286004,286007,0,3,2
81639,6,2,286010,286010,286012,0,2,3
81640,5,2,286015,286015,286017,0,2,3
81641,1,2,286016,286017,286019,1,3,0
81642,5,3,286021,286021,286024,0,3,2
81643,4,2,286025,286025,286027,0,2,1
81644,3,1,286028,286028,286029,0,1,1
81645,5,2,286033,286033,286035,0,2,4
81646,3,3,286036,286036,286039,0,3,1
81647,5,1,286041,286041,286042,0,1,2
81648,5,3,286046,286046,286049,0,3,4
81649,6,2,286052,286052,286054,0,2,3
81650,5,2,286057,286057,286059,0,2,3
81651,1,3,286058,286059,286062,1,4,0
81652,6,2,286064,286064,286066,0,2,2
81653,5,1,286069,286069,286070,0,1,3
81654,6,1,286075,286075,286076,0,1,5
81655,6,3,286081,286081,286084,0,3,5
81656,3,1,286084,286084,286085,0,1,0
81657,6,2,286090,286090,286092,0,2,5
81658,5,1,286095,286095,286096,0,1,3
81659,4,3,286099,286099,286102,0,3,3
81660,5,2,286104,286104,286106,0,2,2
81661,6,2,286110,286110,286112,0,2,4
81662,4,3,286114,286114,286117,0,3,2
81663,3,2,286117,286117,286119,0,2,0
81664,1,1,286118,286119,286120,1,2,0
81665,6,3,286124,286124,286127,0,3,4
81666,5,1,286129,286129,286130,0,1,2
81667,4,1,286133,286133,286134,0,1,3
81668,5,1,286138,286138,286139,0,1,4
81669,3,3,286141,286141,286144,0,3,2
81670,1,3,286142,286144,286147,2,5,0
81671,6,3,286148,286148,286151,0,3,1
81672,5,2,286153,286153,286155,0,2,2
81673,3,3,286156,286156,286159,0,3,1
81674,1,1,286157,286159,286160,2,3,0
81675,2,1,286159,286160,286161,1,2,0
81676,6,3,286165,286165,286168,0,3,4
81677,1,3,286166,286168,286171,2,5,0
81678,6,1,286172,286172,286173,0,1,1
81679,6,2,286178,286178,286180,0,2,5
81680,1,1,286179,286180,286181,1,2,0
81681,5,2,286184,286184,286186,0,2,3
81682,6,1,286190,286190,286191,0,1,4
81683,5,1,286195,286195,286196,0,1,4
81684,4,2,286199,286199,286201,0,2,3
81685,6,1,286205,286205,286206,0,1,4
81686,3,1,286208,286208,286209,0,1,2
81687,2,1,286210,286210,286211,0,1,1
81688,6,3,286216,286216,286219,0,3,5
81689,3,3,286219,286219,286222,0,3,0
81690,4,1,286223,286223,286224,0,1,1
81691,6,2,286229,286229,286231,0,2,5
81692,6,1,286235,286235,286236,0,1,4
81693,5,1,286240,286240,286241,0,1,4
81694,4,2,286244,286244,286246,0,2,3
81695,4,2,286248,286248,286250,0,2,2
81696,1,2,286249,286250,286252,1,3,0
81697,4,2,286253,286253,286255,0,2,1
81698,6,2,286259,286259,286261,0,2,4
81699,4,1,286263,286263,286264,0,1,2
81700,4,2,286267,286267,286269,0,2,3
81701,5,1,286272,286272,286273,0,1,3
81702,5,3,286277,286277,286280,0,3,4
81703,6,2,286283,286283,286285,0,2,3
81704,3,3,286286,286286,286289,0,3,1
81705,6,2,286292,286292,286294,0,2,3
81706,1,2,286293,286294,286296,1,3,0
81707,4,2,286297,286297,286299,0,2,1
81708,5,3,286302,286302,286305,0,3,3
81709,6,3,286308,286308,286311,0,3,3
81710,2,1,286310,286311,286312,1,2,0
81711,3,2,286313,286313,286315,0,2,1
81712,5,3,286318,286318,286321,0,3,3
81713,5,1,286323,286323,286324,0,1,2
81714,5,3,286328,286328,286331,0,3,4
81715,6,3,286334,286334,286337,0,3,3
81716,5,2,286339,286339,286341,0,2,2
81717,4,1,286343,286343,286344,0,1,2
81718,1,2,286344,286344,286346,0,2,0
81719,4,1,286348,286348,286349,0,1,2
81720,1,2,286349,286349,286351,0,2,0
81721,2,2,286351,286351,286353,0,2,0
81722,2,3,286353,286353,286356,0,3,0
81723,3,1,286356,286356,286357,0,1,0
81724,6,3,286362,286362,286365,0,3,5
81725,5,3,286367,286367,286370,0,3,2
81726,3,3,286370,286370,286373,0,3,0
81727,3,1,286373,286373,286374,0,1,0
81728,6,3,286379,286379,286382,0,3,5
81729,2,3,286381,286382,286385,1,4,0
81730,5,2,286386,286386,286388,0,2,1
81731,1,1,286387,286388,286389,1,2,0
81732,3,3,286390,286390,286393,0,3,1
81733,1,1,286391,286393,286394,2,3,0
81734,6,3,286397,286397,286400,0,3,3
81735,4,2,286401,286401,286403,0,2,1
81736,5,1,286406,286406,286407,0,1,3
81737,4,2,286410,286410,286412,0,2,3
81738,4,3,286414,286414,286417,0,3,2
81739,4,1,286418,286418,286419,0,1,1
81740,1,3,286419,286419,286422,0,3,0
81741,2,2,286421,286422,286424,1,3,0
81742,4,2,286425,286425,286427,0,2,1
81743,2,2,286427,286427,286429,0,2,0
81744,2,2,286429,286429,286431,0,2,0
81745,6,1,286435,286435,286436,0,1,4
81746,1,1,286436,286436,286437,0,1,0
81747,1,2,286437,286437,286439,0,2,0
81748,6,3,286443,286443,286446,0,3,4
81749,3,1,286446,286446,286447,0,1,0
81750,3,1,286449,286449,286450,0,1,2
81751,2,1,286451,286451,286452,0,1,1
81752,2,2,286453,286453,286455,0,2,1
81753,5,2,286458,286458,286460,0,2,3
81754,1,1,286459,286460,286461,1,2,0
81755,5,3,286464,286464,286467,0,3,3
81756,5,3,286469,286469,286472,0,3,2
81757,5,3,286474,286474,286477,0,3,2
81758,2,1,286476,286477,286478,1,2,0
81759,3,2,286479,286479,286481,0,2,1
81760,4,1,286483,286483,286484,0,1,2
81761,2,1,286485,286485,286486,0,1,1
81762,4,1,286489,286489,286490,0,1,3
81763,2,1,286491,286491,286492,0,1,1
81764,2,3,286493,286493,286496,0,3,1
81765,4,1,286497,286497,286498,0,1,1
81766,1,3,286498,286498,286501,0,3,0
81767,2,1,286500,286501,286502,1,2,0
81768,5,2,286505,286505,286507,0,2,3
81769,5,3,286510,286510,286513,0,3,3
81770,2,1,286512,286513,286514,1,2,0
81771,6,2,286518,286518,286520,0,2,4
81772,4,1,286522,286522,286523,0,1,2
81773,5,2,286527,286527,286529,0,2,4
81774,5,2,286532,286532,286534,0,2,3
81775,1,1,286533,286534,286535,1,2,0
81776,2,2,286535,286535,286537,0,2,0
81777,2,1,286537,286537,286538,0,1,0
81778,1,2,286538,286538,286540,0,2,0
81779,2,3,286540,286540,286543,0,3,0
81780,4,1,286544,286544,286545,0,1,1
81781,5,1,286549,286549,286550,0,1,4
81782,5,3,286554,286554,286557,0,3,4
81783,6,1,286560,286560,286561,0,1,3
81784,6,3,286566,286566,286569,0,3,5
81785,5,1,286571,286571,286572,0,1,2
81786,1,2,286572,286572,286574,0,2,0
81787,3,1,286575,286575,286576,0,1,1
81788,4,2,286579,286579,286581,0,2,3
81789,4,3,286583,286583,286586,0,3,2
81790,2,3,286585,286586,286589,1,4,0
81791,3,1,286588,286589,286590,1,2,0
81792,2,3,286590,286590,286593,0,3,0
81793,5,1,286595,286595,286596,0,1,2
81794,1,3,286596,286596,286599,0,3,0
81795,2,1,286598,286599,286600,1,2,0
81796,2,1,286600,286600,286601,0,1,0
81797,1,3,286601,286601,286604,0,3,0
81798,6,3,286607,286607,286610,0,3,3
81799,6,3,286613,286613,286616,0,3,3
81800,6,1,286619,286619,286620,0,1,3
81801,4,1,286623,286623,286624,0,1,3
81802,2,2,286625,286625,286627,0,2,1
81803,5,2,286630,286630,286632,0,2,3
81804,3,3,286633,286633,286636,0,3,1
81805,2,1,286635,286636,286637,1,2,0
81806,6,1,286641,286641,286642,0,1,4
81807,3,2,286644,286644,286646,0,2,2
81808,3,3,286647,286647,286650,0,3,1
81809,3,2,286650,286650,286652,0,2,0
81810,3,1,286653,286653,286654,0,1,1
81811,5,3,286658,286658,286661,0,3,4
81812,5,1,286663,286663,286664,0,1,2
81813,1,1,286664,286664,286665,0,1,0
81814,3,2,286667,286667,286669,0,2,2
81815,3,2,286670,286670,286672,0,2,1
81816,6,3,286676,286676,286679,0,3,4
81817,3,2,286679,286679,286681,0,2,0
81818,1,3,286680,286681,286684,1,4,0
81819,6,3,286686,286686,286689,0,3,2
81820,4,3,286690,286690,286693,0,3,1
81821,5,3,286695,286695,286698,0,3,2
81822,6,1,286701,286701,286702,0,1,3
81823,3,3,286704,286704,286707,0,3,2
81824,6,2,286710,286710,286712,0,2,3
81825,6,3,286716,286716,286719,0,3,4
81826,3,3,286719,286719,286722,0,3,0
81827,5,1,286724,286724,286725,0,1,2
81828,3,1,286727,286727,286728,0,1,2
81829,4,3,286731,286731,286734,0,3,3
81830,4,2,286735,286735,286737,0,2,1
81831,3,1,286738,286738,286739,0,1,1
81832,2,1,286740,286740,286741,0,1,1
81833,6,1,286746,286746,286747,0,1,5
81834,5,1,286751,286751,286752,0,1,4
81835,6,2,286757,286757,286759,0,2,5
81836,2,2,286759,286759,286761,0,2,0
81837,1,2,286760,286761,286763,1,3,0
81838,5,2,286765,286765,286767,0,2,2
81839,6,1,286771,286771,286772,0,1,4
81840,5,1,286776,286776,286777,0,1,4
81841,2,2,286778,286778,286780,0,2,1
81842,6,2,286784,286784,286786,0,2,4
81843,1,3,286785,286786,286789,1,4,0
81844,1,2,286786,286789,286791,3,5,0
81845,2,2,286788,286791,286793,3,5,0
81846,1,3,286789,286793,286796,4,7,0
81847,5,2,286794,286796,286798,2,4,0
81848,3,3,286797,286798,286801,1,4,0
81849,4,3,286801,286801,286804,0,3,0
81850,6,3,286807,286807,286810,0,3,3
81851,4,1,286811,286811,286812,0,1,1
81852,2,2,286813,286813,286815,0,2,1
81853,2,2,286815,286815,286817,0,2,0
81854,3,1,286818,286818,286819,0,1,1
81855,1,2,286819,286819,286821,0,2,0
81856,3,3,286822,286822,286825,0,3,1
81857,3,3,286825,286825,286828,0,3,0
81858,6,2,286831,286831,286833,0,2,3
81859,1,2,286832,286833,286835,1,3,0
81860,2,3,286834,286835,286838,1,4,0
81861,4,1,286838,286838,286839,0,1,0
81862,5,2,286843,286843,286845,0,2,4
81863,1,1,286844,286845,286846,1,2,0
81864,5,3,286849,286849,286852,0,3,3
81865,3,2,286852,286852,286854,0,2,0
81866,4,3,286856,286856,286859,0,3,2
81867,3,1,286859,286859,286860,0,1,0
81868,1,1,286860,286860,286861,0,1,0
81869,4,1,286864,286864,286865,0,1,3
81870,1,3,286865,286865,286868,0,3,0
81871,4,2,286869,286869,286871,0,2,1
81872,4,2,286873,286873,286875,0,2,2
81873,5,2,286878,286878,286880,0,2,3
81874,2,3,286880,286880,286883,0,3,0
81875,5,2,286885,286885,286887,0,2,2
81876,2,3,286887,286887,286890,0,3,0
81877,4,3,286891,286891,286894,0,3,1
81878,1,3,286892,286894,286897,2,5,0
81879,6,1,286898,286898,286899,0,1,1
81880,1,2,286899,286899,286901,0,2,0
81881,3,3,286902,286902,286905,0,3,1
81882,5,3,286907,286907,286910,0,3,2
81883,6,1,286913,286913,286914,0,1,3
81884,2,3,286915,286915,286918,0,3,1
81885,5,1,286920,286920,286921,0,1,2
81886,6,1,286926,286926,286927,0,1,5
81887,2,2,286928,286928,286930,0,2,1
81888,3,2,286931,286931,286933,0,2,1
81889,4,2,286935,286935,286937,0,2,2
81890,3,3,286938,286938,286941,0,3,1
81891,1,2,286939,286941,286943,2,4,0
81892,1,1,286940,286943,286944,3,4,0
81893,1,1,286941,286944,286945,3,4,0
81894,1,1,286942,286945,286946,3,4,0
81895,4,3,286946,286946,286949,0,3,0
81896,3,2,286949,286949,286951,0,2,0
81897,1,2,286950,286951,286953,1,3,0
81898,2,3,286952,286953,286956,1,4,0
81899,5,3,286957,286957,286960,0,3,1
81900,1,1,286958,286960,286961,2,3,0
81901,6,2,286964,286964,286966,0,2,3
81902,5,3,286969,286969,286972,0,3,3
81903,1,1,286970,286972,286973,2,3,0
81904,5,3,286975,286975,286978,0,3,2
81905,4,3,286979,286979,286982,0,3,1
81906,3,3,286982,286982,286985,0,3,0
81907,1,3,286983,286985,286988,2,5,0
81908,4,3,286987,286988,286991,1,4,0
81909,6,1,286993,286993,286994,0,1,2
81910,6,3,286999,286999,287002,0,3,5
81911,6,3,287005,287005,287008,0,3,3
81912,5,1,287010,287010,287011,0,1,2
81913,2,1,287012,287012,287013,0,1,1
81914,1,1,287013,287013,287014,0,1,0
81915,4,3,287017,287017,287020,0,3,3
81916,6,3,287023,287023,287026,0,3,3
81917,6,3,287029,287029,287032,0,3,3
81918,1,2,287030,287032,287034,2,4,0
81919,5,2,287035,287035,287037,0,2,1
81920,3,1,287038,287038,287039,0,1,1
81921,5,2,287043,287043,287045,0,2,4
81922,4,3,287047,287047,287050,0,3,2
81923,4,3,287051,287051,287054,0,3,1
81924,2,2,287053,287054,287056,1,3,0
81925,1,3,287054,287056,287059,2,5,0
81926,4,1,287058,287059,287060,1,2,0
81927,5,3,287063,287063,287066,0,3,3
81928,2,3,287065,287066,287069,1,4,0
81929,4,3,287069,287069,287072,0,3,0
81930,2,1,287071,287072,287073,1,2,0
81931,4,2,287075,287075,287077,0,2,2
81932,4,1,287079,287079,287080,0,1,2
81933,1,2,287080,287080,287082,0,2,0
81934,2,2,287082,287082,287084,0,2,0
81935,2,1,287084,287084,287085,0,1,0
81936,3,3,287087,287087,287090,0,3,2
81937,5,3,287092,287092,287095,0,3,2
81938,3,3,287095,287095,287098,0,3,0
81939,6,1,287101,287101,287102,0,1,3
81940,5,2,287106,287106,287108,0,2,4
81941,3,2,287109,287109,287111,0,2,1
81942,5,2,287114,287114,287116,0,2,3
81943,5,1,287119,287119,287120,0,1,3
81944,5,3,287124,287124,287127,0,3,4
81945,2,1,287126,287127,287128,1,2,0
81946,6,1,287132,287132,287133,0,1,4
81947,3,3,287135,287135,287138,0,3,2
81948,4,3,287139,287139,287142,0,3,1
81949,1,2,287140,287142,287144,2,4,0
81950,4,2,287144,287144,287146,0,2,0
81951,6,2,287150,287150,287152,0,2,4
81952,1,1,287151,287152,287153,1,2,0
81953,6,1,287157,287157,287158,0,1,4
81954,3,3,287160,287160,287163,0,3,2
81955,5,3,287165,287165,287168,0,3,2
81956,6,3,287171,287171,287174,0,3,3
81957,6,1,287177,287177,287178,0,1,3
81958,2,2,287179,287179,287181,0,2,1
81959,5,1,287184,287184,287185,0,1,3
81960,1,1,287185,287185,287186,0,1,0
81961,1,1,287186,287186,287187,0,1,0
81962,4,2,287190,287190,287192,0,2,3
81963,3,2,287193,287193,287195,0,2,1
81964,1,1,287194,287195,287196,1,2,0
81965,1,1,287195,287196,287197,1,2,0
81966,3,2,287198,287198,287200,0,2,1
81967,5,2,287203,287203,287205,0,2,3
81968,2,2,287205,287205,287207,0,2,0
81969,2,1,287207,287207,287208,0,1,0
81970,3,2,287210,287210,287212,0,2,2
81971,1,1,287211,287212,287213,1,2,0
81972,4,3,287215,287215,287218,0,3,2
81973,1,1,287216,287218,287219,2,3,0
81974,1,3,287217,287219,287222,2,5,0
81975,1,1,287218,287222,287223,4,5,0
81976,4,3,287222,287223,287226,1,4,0
81977,1,2,287223,287226,287228,3,5,0
81978,3,3,287226,287228,287231,2,5,0
81979,6,3,287232,287232,287235,0,3,1
81980,3,3,287235,287235,287238,0,3,0
81981,4,1,287239,287239,287240,0,1,1
81982,5,3,287244,287244,287247,0,3,4
81983,2,1,287246,287247,287248,1,2,0
81984,3,3,287249,287249,287252,0,3,1
81985,6,3,287255,287255,287258,0,3,3
81986,4,3,287259,287259,287262,0,3,1
81987,3,3,287262,287262,287265,0,3,0
81988,5,2,287267,287267,287269,0,2,2
81989,6,2,287273,287273,287275,0,2,4
81990,5,3,287278,287278,287281,0,3,3
81991,1,2,287279,287281,287283,2,4,0
81992,6,1,287285,287285,287286,0,1,2
81993,5,3,287290,287290,287293,0,3,4
81994,5,2,287295,287295,287297,0,2,2
81995,2,3,287297,287297,287300,0,3,0
81996,6,1,287303,287303,287304,0,1,3
81997,3,1,287306,287306,287307,0,1,2
81998,3,3,287309,287309,287312,0,3,2
81999,6,3,287315,287315,287318,0,3,3
82000,6,1,287321,287321,287322,0,1,3
82001,4,2,287325,287325,287327,0,2,3
82002,2,3,287327,287327,287330,0,3,0
82003,5,2,287332,287332,287334,0,2,2
82004,3,3,287335,287335,287338,0,3,1
82005,3,3,287338,287338,287341,0,3,0
82006,4,2,287342,287342,287344,0,2,1
82007,3,1,287345,287345,287346,0,1,1
82008,4,3,287349,287349,287352,0,3,3
82009,4,3,287353,287353,287356,0,3,1
82010,2,3,287355,287356,287359,1,4,0
82011,6,1,287361,287361,287362,0,1,2
82012,1,2,287362,287362,287364,0,2,0
82013,1,3,287363,287364,287367,1,4,0
82014,6,3,287369,287369,287372,0,3,2
82015,6,3,287375,287375,287378,0,3,3
82016,3,3,287378,287378,287381,0,3,0
82017,4,1,287382,287382,287383,0,1,1
82018,1,2,287383,287383,287385,0,2,0
82019,4,2,287387,287387,287389,0,2,2
82020,5,1,287392,287392,287393,0,1,3
82021,3,1,287395,287395,287396,0,1,2
82022,5,2,287400,287400,287402,0,2,4
82023,4,2,287404,287404,287406,0,2,2
82024,5,1,287409,287409,287410,0,1,3
82025,6,1,287415,287415,287416,0,1,5
82026,3,3,287418,287418,287421,0,3,2
82027,6,2,287424,287424,287426,0,2,3
82028,3,1,287427,287427,287428,0,1,1
82029,6,1,287433,287433,287434,0,1,5
82030,5,1,287438,287438,287439,0,1,4
82031,3,2,287441,287441,287443,0,2,2
82032,6,1,287447,287447,287448,0,1,4
82033,2,1,287449,287449,287450,0,1,1
82034,5,3,287454,287454,287457,0,3,4
82035,5,1,287459,287459,287460,0,1,2
82036,4,3,287463,287463,287466,0,3,3
82037,4,1,287467,287467,287468,0,1,1
82038,6,1,287473,287473,287474,0,1,5
82039,1,1,287474,287474,287475,0,1,0
82040,3,3,287477,287477,287480,0,3,2
82041,1,3,287478,287480,287483,2,5,0
82042,4,3,287482,287483,287486,1,4,0
82043,3,3,287485,287486,287489,1,4,0
82044,1,1,287486,287489,287490,3,4,0
82045,2,1,287488,287490,287491,2,3,0
82046,6,1,287494,287494,287495,0,1,3
82047,6,1,287500,287500,287501,0,1,5
82048,1,3,287501,287501,287504,0,3,0
82049,4,3,287505,287505,287508,0,3,1
82050,6,3,287511,287511,287514,0,3,3
82051,5,1,287516,287516,287517,0,1,2
82052,6,3,287522,287522,287525,0,3,5
82053,1,3,287523,287525,287528,2,5,0
82054,6,2,287529,287529,287531,0,2,1
82055,3,2,287532,287532,287534,0,2,1
82056,1,3,287533,287534,287537,1,4,0
82057,4,3,287537,287537,287540,0,3,0
82058,6,2,287543,287543,287545,0,2,3
82059,6,2,287549,287549,287551,0,2,4
82060,3,3,287552,287552,287555,0,3,1
82061,6,2,287558,287558,287560,0,2,3
82062,2,3,287560,287560,287563,0,3,0
82063,4,2,287564,287564,287566,0,2,1
82064,5,3,287569,287569,287572,0,3,3
82065,1,1,287570,287572,287573,2,3,0
82066,2,3,287572,287573,287576,1,4,0
82067,5,1,287577,287577,287578,0,1,1
82068,2,3,287579,287579,287582,0,3,1
82069,1,2,287580,287582,287584,2,4,0
82070,2,3,287582,287584,287587,2,5,0
82071,3,1,287585,287587,287588,2,3,0
82072,1,2,287586,287588,287590,2,4,0
82073,1,1,287587,287590,287591,3,4,0
82074,5,1,287592,287592,287593,0,1,1
82075,2,3,287594,287594,287597,0,3,1
82076,3,2,287597,287597,287599,0,2,0
82077,2,3,287599,287599,287602,0,3,0
82078,5,1,287604,287604,287605,0,1,2
82079,2,2,287606,287606,287608,0,2,1
82080,5,1,287611,287611,287612,0,1,3
82081,5,3,287616,287616,287619,0,3,4
82082,2,1,287618,287619,287620,1,2,0
82083,6,2,287624,287624,287626,0,2,4
82084,5,1,287629,287629,287630,0,1,3
82085,4,2,287633,287633,287635,0,2,3
82086,5,1,287638,287638,287639,0,1,3
82087,4,2,287642,287642,287644,0,2,3
82088,5,2,287647,287647,287649,0,2,3
82089,5,1,287652,287652,287653,0,1,3
82090,5,1,287657,287657,287658,0,1,4
82091,3,2,287660,287660,287662,0,2,2
82092,3,2,287663,287663,287665,0,2,1
82093,2,3,287665,287665,287668,0,3,0
82094,2,2,287667,287668,287670,1,3,0
82095,2,2,287669,287670,287672,1,3,0
82096,3,1,287672,287672,287673,0,1,0
82097,6,3,287678,287678,287681,0,3,5
82098,6,1,287684,287684,287685,0,1,3
82099,3,3,287687,287687,287690,0,3,2
82100,6,2,287693,287693,287695,0,2,3
82101,5,1,287698,287698,287699,0,1,3
82102,6,3,287704,287704,287707,0,3,5
82103,6,1,287710,287710,287711,0,1,3
82104,6,2,287716,287716,287718,0,2,5
82105,3,2,287719,287719,287721,0,2,1
82106,4,2,287723,287723,287725,0,2,2
82107,5,3,287728,287728,287731,0,3,3
82108,3,1,287731,287731,287732,0,1,0
82109,6,2,287737,287737,287739,0,2,5
82110,6,2,287743,287743,287745,0,2,4
82111,3,2,287746,287746,287748,0,2,1
82112,4,2,287750,287750,287752,0,2,2
82113,6,1,287756,287756,287757,0,1,4
82114,2,3,287758,287758,287761,0,3,1
82115,3,3,287761,287761,287764,0,3,0
82116,4,1,287765,287765,287766,0,1,1
82117,1,3,287766,287766,287769,0,3,0
82118,2,1,287768,287769,287770,1,2,0
82119,6,2,287774,287774,287776,0,2,4
82120,6,1,287780,287780,287781,0,1,4
82121,2,2,287782,287782,287784,0,2,1
82122,5,3,287787,287787,287790,0,3,3
82123,6,3,287793,287793,287796,0,3,3
82124,6,2,287799,287799,287801,0,2,3
82125,2,2,287801,287801,287803,0,2,0
82126,6,3,287807,287807,287810,0,3,4
82127,1,2,287808,287810,287812,2,4,0
82128,4,2,287812,287812,287814,0,2,0
82129,6,2,287818,287818,287820,0,2,4
82130,1,3,287819,287820,287823,1,4,0
82131,4,1,287823,287823,287824,0,1,0
82132,5,1,287828,287828,287829,0,1,4
82133,6,1,287834,287834,287835,0,1,5
82134,2,1,287836,287836,287837,0,1,1
82135,1,1,287837,287837,287838,0,1,0
82136,1,3,287838,287838,287841,0,3,0
82137,4,3,287842,287842,287845,0,3,1
82138,4,1,287846,287846,287847,0,1,1
82139,6,2,287852,287852,287854,0,2,5
82140,5,1,287857,287857,287858,0,1,3
82141,5,1,287862,287862,287863,0,1,4
82142,4,3,287866,287866,287869,0,3,3
82143,1,1,287867,287869,287870,2,3,0
82144,4,2,287871,287871,287873,0,2,1
82145,2,1,287873,287873,287874,0,1,0
82146,1,3,287874,287874,287877,0,3,0
82147,5,2,287879,287879,287881,0,2,2
82148,1,1,287880,287881,287882,1,2,0
82149,4,2,287884,287884,287886,0,2,2
82150,1,2,287885,287886,287888,1,3,0
82151,5,1,287890,287890,287891,0,1,2
82152,1,3,287891,287891,287894,0,3,0
82153,1,3,287892,287894,287897,2,5,0
82154,6,1,287898,287898,287899,0,1,1
82155,5,2,287903,287903,287905,0,2,4
82156,2,2,287905,287905,287907,0,2,0
82157,5,2,287910,287910,287912,0,2,3
82158,2,2,287912,287912,287914,0,2,0
82159,3,2,287915,287915,287917,0,2,1
82160,1,2,287916,287917,287919,1,3,0
82161,3,3,287919,287919,287922,0,3,0
82162,6,2,287925,287925,287927,0,2,3
82163,5,1,287930,287930,287931,0,1,3
82164,3,2,287933,287933,287935,0,2,2
82165,2,2,287935,287935,287937,0,2,0
82166,4,2,287939,287939,287941,0,2,2
82167,3,3,287942,287942,287945,0,3,1
82168,2,1,287944,287945,287946,1,2,0
82169,2,2,287946,287946,287948,0,2,0
82170,6,1,287952,287952,287953,0,1,4
82171,5,2,287957,287957,287959,0,2,4
82172,6,2,287963,287963,287965,0,2,4
82173,5,3,287968,287968,287971,0,3,3
82174,6,2,287974,287974,287976,0,2,3
82175,4,1,287978,287978,287979,0,1,2
82176,1,2,287979,287979,287981,0,2,0
82177,2,1,287981,287981,287982,0,1,0
82178,6,3,287987,287987,287990,0,3,5
82179,4,1,287991,287991,287992,0,1,1
82180,3,1,287994,287994,287995,0,1,2
82181,5,2,287999,287999,288001,0,2,4
82182,5,2,288004,288004,288006,0,2,3
82183,6,2,288010,288010,288012,0,2,4
82184,4,1,288014,288014,288015,0,1,2
82185,6,2,288020,288020,288022,0,2,5
82186,1,2,288021,288022,288024,1,3,0
82187,3,1,288024,288024,288025,0,1,0
82188,2,1,288026,288026,288027,0,1,1
82189,3,1,288029,288029,288030,0,1,2
82190,5,2,288034,288034,288036,0,2,4
82191,5,2,288039,288039,288041,0,2,3
82192,1,2,288040,288041,288043,1,3,0
82193,2,2,288042,288043,288045,1,3,0
82194,6,1,288048,288048,288049,0,1,3
82195,4,3,288052,288052,288055,0,3,3
82196,2,1,288054,288055,288056,1,2,0
82197,4,1,288058,288058,288059,0,1,2
82198,5,1,288063,288063,288064,0,1,4
82199,6,1,288069,288069,288070,0,1,5
82200,4,1,288073,288073,288074,0,1,3
82201,1,3,288074,288074,288077,0,3,0
82202,5,3,288079,288079,288082,0,3,2
82203,2,3,288081,288082,288085,1,4,0
82204,3,3,288084,288085,288088,1,4,0
82205,5,3,288089,288089,288092,0,3,1
82206,4,3,288093,288093,288096,0,3,1
82207,5,2,288098,288098,288100,0,2,2
82208,3,1,288101,288101,288102,0,1,1
82209,6,2,288107,288107,288109,0,2,5
82210,1,2,288108,288109,288111,1,3,0
82211,2,2,288110,288111,288113,1,3,0
82212,2,2,288112,288113,288115,1,3,0
82213,1,2,288113,288115,288117,2,4,0
82214,3,1,288116,288117,288118,1,2,0
82215,3,3,288119,288119,288122,0,3,1
82216,1,2,288120,288122,288124,2,4,0
82217,2,1,288122,288124,288125,2,3,0
82218,1,2,288123,288125,288127,2,4,0
82219,4,1,288127,288127,288128,0,1,0
82220,5,3,288132,288132,288135,0,3,4
82221,4,1,288136,288136,288137,0,1,1
82222,6,3,288142,288142,288145,0,3,5
82223,5,2,288147,288147,288149,0,2,2
82224,6,1,288153,288153,288154,0,1,4
82225,2,3,288155,288155,288158,0,3,1
82226,3,2,288158,288158,288160,0,2,0
82227,1,3,288159,288160,288163,1,4,0
82228,1,3,288160,288163,288166,3,6,0
82229,5,3,288165,288166,288169,1,4,0
82230,5,1,288170,288170,288171,0,1,1
82231,3,2,288173,288173,288175,0,2,2
82232,5,3,288178,288178,288181,0,3,3
82233,6,3,288184,288184,288187,0,3,3
82234,1,2,288185,288187,288189,2,4,0
82235,1,3,288186,288189,288192,3,6,0
82236,2,3,288188,288192,288195,4,7,0
82237,2,2,288190,288195,288197,5,7,0
82238,4,3,288194,288197,288200,3,6,0
82239,6,3,288200,288200,288203,0,3,0
82240,2,1,288202,288203,288204,1,2,0
82241,4,2,288206,288206,288208,0,2,2
82242,3,3,288209,288209,288212,0,3,1
82243,6,3,288215,288215,288218,0,3,3
82244,6,1,288221,288221,288222,0,1,3
82245,5,1,288226,288226,288227,0,1,4
82246,6,3,288232,288232,288235,0,3,5
82247,3,1,288235,288235,288236,0,1,0
82248,1,2,288236,288236,288238,0,2,0
82249,1,3,288237,288238,288241,1,4,0
82250,3,3,288240,288241,288244,1,4,0
82251,5,3,288245,288245,288248,0,3,1
82252,6,3,288251,288251,288254,0,3,3
82253,2,2,288253,288254,288256,1,3,0
82254,4,1,288257,288257,288258,0,1,1
82255,2,2,288259,288259,288261,0,2,1
82256,3,2,288262,288262,288264,0,2,1
82257,1,1,288263,288264,288265,1,2,0
82258,4,3,288267,288267,288270,0,3,2
82259,4,2,288271,288271,288273,0,2,1
82260,4,1,288275,288275,288276,0,1,2
82261,3,1,288278,288278,288279,0,1,2
82262,5,2,288283,288283,288285,0,2,4
82263,5,1,288288,288288,288289,0,1,3
82264,5,1,288293,288293,288294,0,1,4
82265,3,2,288296,288296,288298,0,2,2
82266,4,1,288300,288300,288301,0,1,2
82267,6,2,288306,288306,288308,0,2,5
82268,5,1,288311,288311,288312,0,1,3
82269,6,3,288317,288317,288320,0,3,5
82270,3,2,288320,288320,288322,0,2,0
82271,6,2,288326,288326,288328,0,2,4
82272,3,3,288329,288329,288332,0,3,1
82273,1,3,288330,288332,288335,2,5,0
82274,6,1,288336,288336,288337,0,1,1
82275,5,2,288341,288341,288343,0,2,4
82276,4,2,288345,288345,288347,0,2,2
82277,4,1,288349,288349,288350,0,1,2
82278,3,1,288352,288352,288353,0,1,2
82279,1,2,288353,288353,288355,0,2,0
82280,6,2,288359,288359,288361,0,2,4
82281,6,1,288365,288365,288366,0,1,4
82282,2,3,288367,288367,288370,0,3,1
82283,1,1,288368,288370,288371,2,3,0
82284,2,2,288370,288371,288373,1,3,0
82285,1,3,288371,288373,288376,2,5,0
82286,1,2,288372,288376,288378,4,6,0
82287,3,1,288375,288378,288379,3,4,0
82288,5,1,288380,288380,288381,0,1,1
82289,6,3,288386,288386,288389,0,3,5
82290,1,1,288387,288389,288390,2,3,0
82291,6,3,288393,288393,288396,0,3,3
82292,4,2,288397,288397,288399,0,2,1
82293,1,3,288398,288399,288402,1,4,0
82294,3,2,288401,288402,288404,1,3,0
82295,3,2,288404,288404,288406,0,2,0
82296,5,1,288409,288409,288410,0,1,3
82297,5,2,288414,288414,288416,0,2,4
82298,6,1,288420,288420,288421,0,1,4
82299,6,3,288426,288426,288429,0,3,5
82300,3,1,288429,288429,288430,0,1,0
82301,5,2,288434,288434,288436,0,2,4
82302,3,3,288437,288437,288440,0,3,1
82303,2,1,288439,288440,288441,1,2,0
82304,2,3,288441,288441,288444,0,3,0
82305,1,2,288442,288444,288446,2,4,0
82306,6,3,288448,288448,288451,0,3,2
82307,1,1,288449,288451,288452,2,3,0
82308,4,1,288453,288453,288454,0,1,1
82309,3,1,288456,288456,288457,0,1,2
82310,4,1,288460,288460,288461,0,1,3
82311,3,2,288463,288463,288465,0,2,2
82312,3,3,288466,288466,288469,0,3,1
82313,6,3,288472,288472,288475,0,3,3
82314,5,1,288477,288477,288478,0,1,2
82315,1,3,288478,288478,288481,0,3,0
82316,6,1,288484,288484,288485,0,1,3
82317,2,1,288486,288486,288487,0,1,1
82318,1,1,288487,288487,288488,0,1,0
82319,3,3,288490,288490,288493,0,3,2
82320,5,2,288495,288495,288497,0,2,2
82321,6,3,288501,288501,288504,0,3,4
82322,3,2,288504,288504,288506,0,2,0
82323,6,1,288510,288510,288511,0,1,4
82324,2,2,288512,288512,288514,0,2,1
82325,4,2,288516,288516,288518,0,2,2
82326,2,2,288518,288518,288520,0,2,0
82327,6,3,288524,288524,288527,0,3,4
82328,3,1,288527,288527,288528,0,1,0
82329,1,3,288528,288528,288531,0,3,0
82330,3,1,288531,288531,288532,0,1,0
82331,1,3,288532,288532,288535,0,3,0
82332,6,1,288538,288538,288539,0,1,3
82333,1,3,288539,288539,288542,0,3,0
82334,6,2,288545,288545,288547,0,2,3
82335,3,2,288548,288548,288550,0,2,1
82336,1,1,288549,288550,288551,1,2,0
82337,3,3,288552,288552,288555,0,3,1
82338,5,2,288557,288557,288559,0,2,2
82339,6,1,288563,288563,288564,0,1,4
82340,5,1,288568,288568,288569,0,1,4
82341,4,3,288572,288572,288575,0,3,3
82342,1,2,288573,288575,288577,2,4,0
82343,5,2,288578,288578,288580,0,2,1
82344,1,1,288579,288580,288581,1,2,0
82345,5,1,288584,288584,288585,0,1,3
82346,4,2,288588,288588,288590,0,2,3
82347,1,3,288589,288590,288593,1,4,0
82348,2,2,288591,288593,288595,2,4,0
82349,5,3,288596,288596,288599,0,3,1
82350,2,3,288598,288599,288602,1,4,0
82351,5,1,288603,288603,288604,0,1,1
82352,4,3,288607,288607,288610,0,3,3
82353,2,3,288609,288610,288613,1,4,0
82354,2,3,288611,288613,288616,2,5,0
82355,4,1,288615,288616,288617,1,2,0
82356,2,2,288617,288617,288619,0,2,0
82357,4,2,288621,288621,288623,0,2,2
82358,5,3,288626,288626,288629,0,3,3
82359,6,2,288632,288632,288634,0,2,3
82360,4,2,288636,288636,288638,0,2,2
82361,2,1,288638,288638,288639,0,1,0
82362,1,3,288639,288639,288642,0,3,0
82363,2,1,288641,288642,288643,1,2,0
82364,6,2,288647,288647,288649,0,2,4
82365,4,2,288651,288651,288653,0,2,2
82366,1,2,288652,288653,288655,1,3,0
82367,4,1,288656,288656,288657,0,1,1
82368,1,3,288657,288657,288660,0,3,0
82369,3,2,288660,288660,288662,0,2,0
82370,1,3,288661,288662,288665,1,4,0
82371,3,2,288664,288665,288667,1,3,0
82372,6,1,288670,288670,288671,0,1,3
82373,3,1,288673,288673,288674,0,1,2
82374,2,2,288675,288675,288677,0,2,1
82375,4,1,288679,288679,288680,0,1,2
82376,6,3,288685,288685,288688,0,3,5
82377,1,1,288686,288688,288689,2,3,0
82378,2,3,288688,288689,288692,1,4,0
82379,3,1,288691,288692,288693,1,2,0
82380,6,1,288697,288697,288698,0,1,4
82381,1,1,288698,288698,288699,0,1,0
82382,1,1,288699,288699,288700,0,1,0
82383,4,2,288703,288703,288705,0,2,3
82384,1,3,288704,288705,288708,1,4,0
82385,1,3,288705,288708,288711,3,6,0
82386,6,2,288711,288711,288713,0,2,0
82387,5,2,288716,288716,288718,0,2,3
82388,1,2,288717,288718,288720,1,3,0
82389,2,1,288719,288720,288721,1,2,0
82390,3,2,288722,288722,288724,0,2,1
82391,5,1,288727,288727,288728,0,1,3
82392,1,2,288728,288728,288730,0,2,0
82393,4,1,288732,288732,288733,0,1,2
82394,6,2,288738,288738,288740,0,2,5
82395,1,3,288739,288740,288743,1,4,0
82396,3,1,288742,288743,288744,1,2,0
82397,4,1,288746,288746,288747,0,1,2
82398,6,1,288752,288752,288753,0,1,5
82399,6,3,288758,288758,288761,0,3,5
82400,2,1,288760,288761,288762,1,2,0
82401,1,3,288761,288762,288765,1,4,0
82402,3,1,288764,288765,288766,1,2,0
82403,4,1,288768,288768,288769,0,1,2
82404,5,3,288773,288773,288776,0,3,4
82405,3,1,288776,288776,288777,0,1,0
82406,6,2,288782,288782,288784,0,2,5
82407,6,1,288788,288788,288789,0,1,4
82408,1,2,288789,288789,288791,0,2,0
82409,3,3,288792,288792,288795,0,3,1
82410,5,2,288797,288797,288799,0,2,2
82411,3,3,288800,288800,288803,0,3,1
82412,3,1,288803,288803,288804,0,1,0
82413,2,3,288805,288805,288808,0,3,1
82414,3,2,288808,288808,288810,0,2,0
82415,6,2,288814,288814,288816,0,2,4
82416,5,3,288819,288819,288822,0,3,3
82417,3,2,288822,288822,288824,0,2,0
82418,4,1,288826,288826,288827,0,1,2
82419,6,2,288832,288832,288834,0,2,5
82420,4,2,288836,288836,288838,0,2,2
82421,6,1,288842,288842,288843,0,1,4
82422,1,2,288843,288843,288845,0,2,0
82423,3,1,288846,288846,288847,0,1,1
82424,5,1,288851,288851,288852,0,1,4
82425,1,1,288852,288852,288853,0,1,0
82426,2,2,288854,288854,288856,0,2,1
82427,2,1,288856,288856,288857,0,1,0
82428,5,3,288861,288861,288864,0,3,4
82429,3,1,288864,288864,288865,0,1,0
82430,1,2,288865,288865,288867,0,2,0
82431,2,2,288867,288867,288869,0,2,0
82432,3,3,288870,288870,288873,0,3,1
82433,1,1,288871,288873,288874,2,3,0
82434,3,2,288874,288874,288876,0,2,0
82435,2,1,288876,288876,288877,0,1,0
82436,1,3,288877,288877,288880,0,3,0
82437,5,2,288882,288882,288884,0,2,2
82438,6,3,288888,288888,288891,0,3,4
82439,4,1,288892,288892,288893,0,1,1
82440,5,3,288897,288897,288900,0,3,4
82441,3,3,288900,288900,288903,0,3,0
82442,3,1,288903,288903,288904,0,1,0
82443,1,1,288904,288904,288905,0,1,0
82444,1,1,288905,288905,288906,0,1,0
82445,6,2,288911,288911,288913,0,2,5
82446,5,2,288916,288916,288918,0,2,3
82447,5,1,288921,288921,288922,0,1,3
82448,5,2,288926,288926,288928,0,2,4
82449,5,2,288931,288931,288933,0,2,3
82450,4,2,288935,288935,288937,0,2,2
82451,1,1,288936,288937,288938,1,2,0
82452,1,3,288937,288938,288941,1,4,0
82453,1,2,288938,288941,288943,3,5,0
82454,6,3,288944,288944,288947,0,3,1
82455,2,3,288946,288947,288950,1,4,0
82456,1,3,288947,288950,288953,3,6,0
82457,3,3,288950,288953,288956,3,6,0
82458,3,3,288953,288956,288959,3,6,0
82459,3,2,288956,288959,288961,3,5,0
82460,6,3,288962,288962,288965,0,3,1
82461,2,3,288964,288965,288968,1,4,0
82462,1,1,288965,288968,288969,3,4,0
82463,2,2,288967,288969,288971,2,4,0
82464,1,3,288968,288971,288974,3,6,0
82465,6,3,288974,288974,288977,0,3,0
82466,5,2,288979,288979,288981,0,2,2
82467,6,2,288985,288985,288987,0,2,4
82468,1,2,288986,288987,288989,1,3,0
82469,3,1,288989,288989,288990,0,1,0
82470,4,3,288993,288993,288996,0,3,3
82471,1,2,288994,288996,288998,2,4,0
82472,6,2,289000,289000,289002,0,2,2
82473,1,2,289001,289002,289004,1,3,0
82474,3,1,289004,289004,289005,0,1,0
82475,6,3,289010,289010,289013,0,3,5
82476,5,2,289015,289015,289017,0,2,2
82477,3,1,289018,289018,289019,0,1,1
82478,1,3,289019,289019,289022,0,3,0
82479,4,3,289023,289023,289026,0,3,1
82480,5,3,289028,289028,289031,0,3,2
82481,6,2,289034,289034,289036,0,2,3
82482,4,3,289038,289038,289041,0,3,2
82483,6,2,289044,289044,289046,0,2,3
82484,4,2,289048,289048,289050,0,2,2
82485,5,1,289053,289053,289054,0,1,3
82486,1,2,289054,289054,289056,0,2,0
82487,1,2,289055,289056,289058,1,3,0
82488,3,1,289058,289058,289059,0,1,0
82489,3,1,289061,289061,289062,0,1,2
82490,6,2,289067,289067,289069,0,2,5
82491,5,2,289072,289072,289074,0,2,3
82492,6,3,289078,289078,289081,0,3,4
82493,4,1,289082,289082,289083,0,1,1
82494,2,1,289084,289084,289085,0,1,1
82495,2,1,289086,289086,289087,0,1,1
82496,2,3,289088,289088,289091,0,3,1
82497,1,1,289089,289091,289092,2,3,0
82498,4,3,289093,289093,289096,0,3,1
82499,2,1,289095,289096,289097,1,2,0
82500,5,3,289100,289100,289103,0,3,3
82501,5,2,289105,289105,289107,0,2,2
82502,3,3,289108,289108,289111,0,3,1
82503,6,2,289114,289114,289116,0,2,3
82504,2,3,289116,289116,289119,0,3,0
82505,1,2,289117,289119,289121,2,4,0
82506,5,2,289122,289122,289124,0,2,1
82507,2,2,289124,289124,289126,0,2,0
82508,3,3,289127,289127,289130,0,3,1
82509,2,3,289129,289130,289133,1,4,0
82510,4,2,289133,289133,289135,0,2,0
82511,3,3,289136,289136,289139,0,3,1
82512,1,1,289137,289139,289140,2,3,0
82513,1,1,289138,289140,289141,2,3,0
82514,6,3,289144,289144,289147,0,3,3
82515,6,3,289150,289150,289153,0,3,3
82516,4,1,289154,289154,289155,0,1,1
82517,3,3,289157,289157,289160,0,3,2
82518,6,1,289163,289163,289164,0,1,3
82519,4,2,289167,289167,289169,0,2,3
82520,1,1,289168,289169,289170,1,2,0
82521,4,3,289172,289172,289175,0,3,2
82522,4,2,289176,289176,289178,0,2,1
82523,5,1,289181,289181,289182,0,1,3
82524,4,1,289185,289185,289186,0,1,3
82525,6,2,289191,289191,289193,0,2,5
82526,6,1,289197,289197,289198,0,1,4
82527,4,3,289201,289201,289204,0,3,3
82528,3,1,289204,289204,289205,0,1,0
82529,5,3,289209,289209,289212,0,3,4
82530,4,1,289213,289213,289214,0,1,1
82531,3,1,289216,289216,289217,0,1,2
82532,1,2,289217,289217,289219,0,2,0
82533,2,3,289219,289219,289222,0,3,0
82534,1,2,289220,289222,289224,2,4,0
82535,4,1,289224,289224,289225,0,1,0
82536,6,1,289230,289230,289231,0,1,5
82537,2,3,289232,289232,289235,0,3,1
82538,5,2,289237,289237,289239,0,2,2
82539,2,1,289239,289239,289240,0,1,0
82540,3,2,289242,289242,289244,0,2,2
82541,6,3,289248,289248,289251,0,3,4
82542,6,2,289254,289254,289256,0,2,3
82543,2,2,289256,289256,289258,0,2,0
82544,6,3,289262,289262,289265,0,3,4
82545,1,2,289263,289265,289267,2,4,0
82546,6,1,289269,289269,289270,0,1,2
82547,3,3,289272,289272,289275,0,3,2
82548,3,2,289275,289275,289277,0,2,0
82549,6,3,289281,289281,289284,0,3,4
82550,6,2,289287,289287,289289,0,2,3
82551,3,1,289290,289290,289291,0,1,1
82552,1,2,289291,289291,289293,0,2,0
82553,6,1,289297,289297,289298,0,1,4
82554,4,3,289301,289301,289304,0,3,3
82555,3,2,289304,289304,289306,0,2,0
82556,4,2,289308,289308,289310,0,2,2
82557,1,1,289309,289310,289311,1,2,0
82558,4,3,289313,289313,289316,0,3,2
82559,2,1,289315,289316,289317,1,2,0
82560,1,3,289316,289317,289320,1,4,0
82561,2,3,289318,289320,289323,2,5,0
82562,4,1,289322,289323,289324,1,2,0
82563,4,2,289326,289326,289328,0,2,2
82564,6,1,289332,289332,289333,0,1,4
82565,4,1,289336,289336,289337,0,1,3
82566,3,3,289339,289339,289342,0,3,2
82567,2,2,289341,289342,289344,1,3,0
82568,5,3,289346,289346,289349,0,3,2
82569,4,2,289350,289350,289352,0,2,1
82570,4,2,289354,289354,289356,0,2,2
82571,4,2,289358,289358,289360,0,2,2
82572,6,1,289364,289364,289365,0,1,4
82573,6,3,289370,289370,289373,0,3,5
82574,1,2,289371,289373,289375,2,4,0
82575,2,2,289373,289375,289377,2,4,0
82576,3,1,289376,289377,289378,1,2,0
82577,4,1,289380,289380,289381,0,1,2
82578,5,2,289385,289385,289387,0,2,4
82579,4,1,289389,289389,289390,0,1,2
82580,2,1,289391,289391,289392,0,1,1
82581,5,3,289396,289396,289399,0,3,4
82582,6,1,289402,289402,289403,0,1,3
82583,6,3,289408,289408,289411,0,3,5
82584,1,3,289409,289411,289414,2,5,0
82585,6,3,289415,289415,289418,0,3,1
82586,2,3,289417,289418,289421,1,4,0
82587,1,3,289418,289421,289424,3,6,0
82588,4,1,289422,289424,289425,2,3,0
82589,5,3,289427,289427,289430,0,3,2
82590,6,1,289433,289433,289434,0,1,3
82591,5,1,289438,289438,289439,0,1,4
82592,5,1,289443,289443,289444,0,1,4
82593,2,3,289445,289445,289448,0,3,1
82594,4,1,289449,289449,289450,0,1,1
82595,6,3,289455,289455,289458,0,3,5
82596,6,2,289461,289461,289463,0,2,3
82597,5,3,289466,289466,289469,0,3,3
82598,5,2,289471,289471,289473,0,2,2
82599,4,3,289475,289475,289478,0,3,2
82600,6,2,289481,289481,289483,0,2,3
82601,5,3,289486,289486,289489,0,3,3
82602,4,3,289490,289490,289493,0,3,1
82603,3,3,289493,289493,289496,0,3,0
82604,2,1,289495,289496,289497,1,2,0
82605,6,3,289501,289501,289504,0,3,4
82606,5,1,289506,289506,289507,0,1,2
82607,1,3,289507,289507,289510,0,3,0
82608,5,1,289512,289512,289513,0,1,2
82609,1,2,289513,289513,289515,0,2,0
82610,4,3,289517,289517,289520,0,3,2
82611,6,1,289523,289523,289524,0,1,3
82612,5,3,289528,289528,289531,0,3,4
82613,2,1,289530,289531,289532,1,2,0
82614,4,3,289534,289534,289537,0,3,2
82615,5,1,289539,289539,289540,0,1,2
82616,1,3,289540,289540,289543,0,3,0
82617,1,2,289541,289543,289545,2,4,0
82618,1,3,289542,289545,289548,3,6,0
82619,6,1,289548,289548,289549,0,1,0
82620,6,2,289554,289554,289556,0,2,5
82621,6,1,289560,289560,289561,0,1,4
82622,2,2,289562,289562,289564,0,2,1
82623,5,3,289567,289567,289570,0,3,3
82624,2,1,289569,289570,289571,1,2,0
82625,2,2,289571,289571,289573,0,2,0
82626,5,1,289576,289576,289577,0,1,3
82627,5,1,289581,289581,289582,0,1,4
82628,4,1,289585,289585,289586,0,1,3
82629,2,3,289587,289587,289590,0,3,1
82630,2,2,289589,289590,289592,1,3,0
82631,1,1,289590,289592,289593,2,3,0
82632,6,2,289596,289596,289598,0,2,3
82633,2,3,289598,289598,289601,0,3,0
82634,2,1,289600,289601,289602,1,2,0
82635,3,3,289603,289603,289606,0,3,1
82636,6,2,289609,289609,289611,0,2,3
82637,5,1,289614,289614,289615,0,1,3
82638,1,1,289615,289615,289616,0,1,0
82639,1,1,289616,289616,289617,0,1,0
82640,6,3,289622,289622,289625,0,3,5
82641,6,1,289628,289628,289629,0,1,3
82642,4,1,289632,289632,289633,0,1,3
82643,6,2,289638,289638,289640,0,2,5
82644,5,3,289643,289643,289646,0,3,3
82645,4,2,289647,289647,289649,0,2,1
82646,5,1,289652,289652,289653,0,1,3
82647,5,3,289657,289657,289660,0,3,4
82648,6,1,289663,289663,289664,0,1,3
82649,6,1,289669,289669,289670,0,1,5
82650,3,1,289672,289672,289673,0,1,2
82651,4,1,289676,289676,289677,0,1,3
82652,1,3,289677,289677,289680,0,3,0
82653,2,3,289679,289680,289683,1,4,0
82654,5,2,289684,289684,289686,0,2,1
82655,4,1,289688,289688,289689,0,1,2
82656,4,2,289692,289692,289694,0,2,3
82657,4,1,289696,289696,289697,0,1,2
82658,6,3,289702,289702,289705,0,3,5
82659,4,3,289706,289706,289709,0,3,1
82660,1,1,289707,289709,289710,2,3,0
82661,4,2,289711,289711,289713,0,2,1
82662,5,2,289716,289716,289718,0,2,3
82663,4,1,289720,289720,289721,0,1,2
82664,1,1,289721,289721,289722,0,1,0
82665,2,1,289723,289723,289724,0,1,1
82666,3,1,289726,289726,289727,0,1,2
82667,1,2,289727,289727,289729,0,2,0
82668,3,2,289730,289730,289732,0,2,1
82669,6,1,289736,289736,289737,0,1,4
82670,1,3,289737,289737,289740,0,3,0
82671,1,3,289738,289740,289743,2,5,0
82672,1,1,289739,289743,289744,4,5,0
82673,3,3,289742,289744,289747,2,5,0
82674,1,2,289743,289747,289749,4,6,0
82675,2,3,289745,289749,289752,4,7,0
82676,1,1,289746,289752,289753,6,7,0
82677,2,3,289748,289753,289756,5,8,0
82678,4,3,289752,289756,289759,4,7,0
82679,1,3,289753,289759,289762,6,9,0
82680,4,2,289757,289762,289764,5,7,0
82681,5,1,289762,289764,289765,2,3,0
82682,4,3,289766,289766,289769,0,3,1
82683,5,2,289771,289771,289773,0,2,2
82684,4,1,289775,289775,289776,0,1,2
82685,4,2,289779,289779,289781,0,2,3
82686,5,2,289784,289784,289786,0,2,3
82687,1,3,289785,289786,289789,1,4,0
82688,4,2,289789,289789,289791,0,2,0
82689,2,1,289791,289791,289792,0,1,0
82690,4,3,289795,289795,289798,0,3,3
82691,1,2,289796,289798,289800,2,4,0
82692,1,1,289797,289800,289801,3,4,0
82693,2,2,289799,289801,289803,2,4,0
82694,6,1,289805,289805,289806,0,1,2
82695,5,3,289810,289810,289813,0,3,4
82696,6,2,289816,289816,289818,0,2,3
82697,2,3,289818,289818,289821,0,3,0
82698,1,1,289819,289821,289822,2,3,0
82699,5,2,289824,289824,289826,0,2,2
82700,1,2,289825,289826,289828,1,3,0
82701,2,2,289827,289828,289830,1,3,0
82702,2,1,289829,289830,289831,1,2,0
82703,5,3,289834,289834,289837,0,3,3
82704,1,1,289835,289837,289838,2,3,0
82705,5,1,289840,289840,289841,0,1,2
82706,1,1,289841,289841,289842,0,1,0
82707,4,3,289845,289845,289848,0,3,3
82708,5,2,289850,289850,289852,0,2,2
82709,2,1,289852,289852,289853,0,1,0
82710,1,2,289853,289853,289855,0,2,0
82711,2,1,289855,289855,289856,0,1,0
82712,6,1,289861,289861,289862,0,1,5
82713,5,3,289866,289866,289869,0,3,4
82714,3,1,289869,289869,289870,0,1,0
82715,3,3,289872,289872,289875,0,3,2
82716,6,2,289878,289878,289880,0,2,3
82717,1,3,289879,289880,289883,1,4,0
82718,2,1,289881,289883,289884,2,3,0
82719,2,3,289883,289884,289887,1,4,0
82720,6,1,289889,289889,289890,0,1,2
82721,2,2,289891,289891,289893,0,2,1
82722,4,1,289895,289895,289896,0,1,2
82723,3,2,289898,289898,289900,0,2,2
82724,6,3,289904,289904,289907,0,3,4
82725,2,2,289906,289907,289909,1,3,0
82726,3,1,289909,289909,289910,0,1,0
82727,4,3,289913,289913,289916,0,3,3
82728,2,2,289915,289916,289918,1,3,0
82729,4,1,289919,289919,289920,0,1,1
82730,5,3,289924,289924,289927,0,3,4
82731,3,1,289927,289927,289928,0,1,0
82732,1,1,289928,289928,289929,0,1,0
82733,4,1,289932,289932,289933,0,1,3
82734,3,3,289935,289935,289938,0,3,2
82735,4,2,289939,289939,289941,0,2,1
82736,3,1,289942,289942,289943,0,1,1
82737,3,2,289945,289945,289947,0,2,2
82738,6,3,289951,289951,289954,0,3,4
82739,5,3,289956,289956,289959,0,3,2
82740,4,3,289960,289960,289963,0,3,1
82741,1,1,289961,289963,289964,2,3,0
82742,1,1,289962,289964,289965,2,3,0
82743,3,3,289965,289965,289968,0,3,0
82744,2,3,289967,289968,289971,1,4,0
82745,5,1,289972,289972,289973,0,1,1
82746,1,2,289973,289973,289975,0,2,0
82747,3,1,289976,289976,289977,0,1,1
82748,4,2,289980,289980,289982,0,2,3
82749,3,1,289983,289983,289984,0,1,1
82750,2,2,289985,289985,289987,0,2,1
82751,3,1,289988,289988,289989,0,1,1
82752,4,2,289992,289992,289994,0,2,3
82753,6,3,289998,289998,290001,0,3,4
82754,2,1,290000,290001,290002,1,2,0
82755,6,1,290006,290006,290007,0,1,4
82756,1,3,290007,290007,290010,0,3,0
82757,1,2,290008,290010,290012,2,4,0
82758,3,3,290011,290012,290015,1,4,0
82759,5,2,290016,290016,290018,0,2,1
82760,4,2,290020,290020,290022,0,2,2
82761,5,1,290025,290025,290026,0,1,3
82762,4,3,290029,290029,290032,0,3,3
82763,4,3,290033,290033,290036,0,3,1
82764,2,3,290035,290036,290039,1,4,0
82765,6,3,290041,290041,290044,0,3,2
82766,1,3,290042,290044,290047,2,5,0
82767,2,3,290044,290047,290050,3,6,0
82768,1,1,290045,290050,290051,5,6,0
82769,5,2,290050,290051,290053,1,3,0
82770,1,1,290051,290053,290054,2,3,0
82771,4,3,290055,290055,290058,0,3,1
82772,4,1,290059,290059,290060,0,1,1
82773,5,3,290064,290064,290067,0,3,4
82774,4,1,290068,290068,290069,0,1,1
82775,4,2,290072,290072,290074,0,2,3
82776,6,3,290078,290078,290081,0,3,4
82777,1,1,290079,290081,290082,2,3,0
82778,6,2,290085,290085,290087,0,2,3
82779,2,1,290087,290087,290088,0,1,0
82780,4,3,290091,290091,290094,0,3,3
82781,2,1,290093,290094,290095,1,2,0
82782,6,3,290099,290099,290102,0,3,4
82783,4,3,290103,290103,290106,0,3,1
82784,6,3,290109,290109,290112,0,3,3
82785,2,1,290111,290112,290113,1,2,0
82786,2,3,290113,290113,290116,0,3,0
82787,5,2,290118,290118,290120,0,2,2
82788,2,3,290120,290120,290123,0,3,0
82789,3,2,290123,290123,290125,0,2,0
82790,6,3,290129,290129,290132,0,3,4
82791,2,2,290131,290132,290134,1,3,0
82792,5,2,290136,290136,290138,0,2,2
82793,6,3,290142,290142,290145,0,3,4
82794,6,3,290148,290148,290151,0,3,3
82795,2,1,290150,290151,290152,1,2,0
82796,2,1,290152,290152,290153,0,1,0
82797,3,1,290155,290155,290156,0,1,2
82798,3,1,290158,290158,290159,0,1,2
82799,2,1,290160,290160,290161,0,1,1
82800,1,2,290161,290161,290163,0,2,0
82801,3,1,290164,290164,290165,0,1,1
82802,3,1,290167,290167,290168,0,1,2
82803,1,2,290168,290168,290170,0,2,0
82804,5,1,290173,290173,290174,0,1,3
82805,5,3,290178,290178,290181,0,3,4
82806,2,2,290180,290181,290183,1,3,0
82807,2,1,290182,290183,290184,1,2,0
82808,5,2,290187,290187,290189,0,2,3
82809,5,1,290192,290192,290193,0,1,3
82810,1,3,290193,290193,290196,0,3,0
82811,6,3,290199,290199,290202,0,3,3
82812,2,2,290201,290202,290204,1,3,0
82813,2,2,290203,290204,290206,1,3,0
82814,1,3,290204,290206,290209,2,5,0
82815,3,1,290207,290209,290210,2,3,0
82816,2,3,290209,290210,290213,1,4,0
82817,3,1,290212,290213,290214,1,2,0
82818,5,1,290217,290217,290218,0,1,3
82819,3,3,290220,290220,290223,0,3,2
82820,6,2,290226,290226,290228,0,2,3
82821,6,3,290232,290232,290235,0,3,4
82822,2,1,290234,290235,290236,1,2,0
82823,2,1,290236,290236,290237,0,1,0
82824,4,2,290240,290240,290242,0,2,3
82825,2,3,290242,290242,290245,0,3,0
82826,3,3,290245,290245,290248,0,3,0
82827,1,2,290246,290248,290250,2,4,0
82828,2,1,290248,290250,290251,2,3,0
82829,5,2,290253,290253,290255,0,2,2
82830,6,1,290259,290259,290260,0,1,4
82831,3,1,290262,290262,290263,0,1,2
82832,3,1,290265,290265,290266,0,1,2
82833,6,2,290271,290271,290273,0,2,5
82834,4,2,290275,290275,290277,0,2,2
82835,5,1,290280,290280,290281,0,1,3
82836,5,1,290285,290285,290286,0,1,4
82837,4,3,290289,290289,290292,0,3,3
82838,4,1,290293,290293,290294,0,1,1
82839,2,2,290295,290295,290297,0,2,1
82840,1,1,290296,290297,290298,1,2,0
82841,5,2,290301,290301,290303,0,2,3
82842,5,3,290306,290306,290309,0,3,3
82843,3,2,290309,290309,290311,0,2,0
82844,4,2,290313,290313,290315,0,2,2
82845,2,2,290315,290315,290317,0,2,0
82846,2,3,290317,290317,290320,0,3,0
82847,3,2,290320,290320,290322,0,2,0
82848,2,2,290322,290322,290324,0,2,0
82849,4,2,290326,290326,290328,0,2,2
82850,4,2,290330,290330,290332,0,2,2
82851,1,3,290331,290332,290335,1,4,0
82852,6,3,290337,290337,290340,0,3,2
82853,6,2,290343,290343,290345,0,2,3
82854,2,3,290345,290345,290348,0,3,0
82855,4,2,290349,290349,290351,0,2,1
82856,4,1,290353,290353,290354,0,1,2
82857,5,1,290358,290358,290359,0,1,4
82858,1,3,290359,290359,290362,0,3,0
82859,5,1,290364,290364,290365,0,1,2
82860,2,2,290366,290366,290368,0,2,1
82861,3,3,290369,290369,290372,0,3,1
82862,3,3,290372,290372,290375,0,3,0
82863,2,3,290374,290375,290378,1,4,0
82864,4,2,290378,290378,290380,0,2,0
82865,5,2,290383,290383,290385,0,2,3
82866,4,1,290387,290387,290388,0,1,2
82867,2,1,290389,290389,290390,0,1,1
82868,6,2,290395,290395,290397,0,2,5
82869,4,3,290399,290399,290402,0,3,2
82870,2,3,290401,290402,290405,1,4,0
82871,3,1,290404,290405,290406,1,2,0
82872,4,2,290408,290408,290410,0,2,2
82873,5,2,290413,290413,290415,0,2,3
82874,3,3,290416,290416,290419,0,3,1
82875,5,2,290421,290421,290423,0,2,2
82876,4,1,290425,290425,290426,0,1,2
82877,6,1,290431,290431,290432,0,1,5
82878,3,3,290434,290434,290437,0,3,2
82879,4,2,290438,290438,290440,0,2,1
82880,1,3,290439,290440,290443,1,4,0
82881,6,1,290445,290445,290446,0,1,2
82882,1,3,290446,290446,290449,0,3,0
82883,3,3,290449,290449,290452,0,3,0
82884,5,3,290454,290454,290457,0,3,2
82885,2,1,290456,290457,290458,1,2,0
82886,4,1,290460,290460,290461,0,1,2
82887,4,3,290464,290464,290467,0,3,3
82888,6,1,290470,290470,290471,0,1,3
82889,5,1,290475,290475,290476,0,1,4
82890,1,2,290476,290476,290478,0,2,0
82891,2,3,290478,290478,290481,0,3,0
82892,4,1,290482,290482,290483,0,1,1
82893,3,3,290485,290485,290488,0,3,2
82894,6,3,290491,290491,290494,0,3,3
82895,3,1,290494,290494,290495,0,1,0
82896,6,1,290500,290500,290501,0,1,5
82897,6,2,290506,290506,290508,0,2,5
82898,3,3,290509,290509,290512,0,3,1
82899,2,2,290511,290512,290514,1,3,0
82900,6,1,290517,290517,290518,0,1,3
82901,3,1,290520,290520,290521,0,1,2
82902,6,3,290526,290526,290529,0,3,5
82903,4,3,290530,290530,290533,0,3,1
82904,3,2,290533,290533,290535,0,2,0
82905,3,2,290536,290536,290538,0,2,1
82906,3,1,290539,290539,290540,0,1,1
82907,5,1,290544,290544,290545,0,1,4
82908,5,2,290549,290549,290551,0,2,4
82909,4,3,290553,290553,290556,0,3,2
82910,5,2,290558,290558,290560,0,2,2
82911,6,1,290564,290564,290565,0,1,4
82912,3,3,290567,290567,290570,0,3,2
82913,5,3,290572,290572,290575,0,3,2
82914,2,1,290574,290575,290576,1,2,0
82915,5,2,290579,290579,290581,0,2,3
82916,4,1,290583,290583,290584,0,1,2
82917,4,2,290587,290587,290589,0,2,3
82918,6,2,290593,290593,290595,0,2,4
82919,5,3,290598,290598,290601,0,3,3
82920,2,3,290600,290601,290604,1,4,0
82921,2,1,290602,290604,290605,2,3,0
82922,3,2,290605,290605,290607,0,2,0
82923,5,1,290610,290610,290611,0,1,3
82924,5,2,290615,290615,290617,0,2,4
82925,6,2,290621,290621,290623,0,2,4
82926,4,1,290625,290625,290626,0,1,2
82927,3,1,290628,290628,290629,0,1,2
82928,4,1,290632,290632,290633,0,1,3
82929,2,3,290634,290634,290637,0,3,1
82930,3,2,290637,290637,290639,0,2,0
82931,6,3,290643,290643,290646,0,3,4
82932,6,2,290649,290649,290651,0,2,3
82933,3,1,290652,290652,290653,0,1,1
82934,3,2,290655,290655,290657,0,2,2
82935,5,1,290660,290660,290661,0,1,3
82936,3,3,290663,290663,290666,0,3,2
82937,6,2,290669,290669,290671,0,2,3
82938,2,3,290671,290671,290674,0,3,0
82939,2,3,290673,290674,290677,1,4,0
82940,3,3,290676,290677,290680,1,4,0
82941,6,3,290682,290682,290685,0,3,2
82942,2,2,290684,290685,290687,1,3,0
82943,3,1,290687,290687,290688,0,1,0
82944,6,2,290693,290693,290695,0,2,5
82945,3,3,290696,290696,290699,0,3,1
82946,2,2,290698,290699,290701,1,3,0
82947,2,1,290700,290701,290702,1,2,0
82948,1,1,290701,290702,290703,1,2,0
82949,5,3,290706,290706,290709,0,3,3
82950,4,1,290710,290710,290711,0,1,1
82951,6,3,290716,290716,290719,0,3,5
82952,1,2,290717,290719,290721,2,4,0
82953,2,1,290719,290721,290722,2,3,0
82954,6,1,290725,290725,290726,0,1,3
82955,4,3,290729,290729,290732,0,3,3
82956,5,1,290734,290734,290735,0,1,2
82957,4,2,290738,290738,290740,0,2,3
82958,4,2,290742,290742,290744,0,2,2
82959,4,3,290746,290746,290749,0,3,2
82960,6,1,290752,290752,290753,0,1,3
82961,2,2,290754,290754,290756,0,2,1
82962,6,2,290760,290760,290762,0,2,4
82963,5,1,290765,290765,290766,0,1,3
82964,5,3,290770,290770,290773,0,3,4
82965,2,1,290772,290773,290774,1,2,0
82966,6,2,290778,290778,290780,0,2,4
82967,4,1,290782,290782,290783,0,1,2
82968,1,3,290783,290783,290786,0,3,0
82969,3,3,290786,290786,290789,0,3,0
82970,4,1,290790,290790,290791,0,1,1
82971,5,1,290795,290795,290796,0,1,4
82972,5,3,290800,290800,290803,0,3,4
82973,1,2,290801,290803,290805,2,4,0
82974,5,1,290806,290806,290807,0,1,1
82975,5,2,290811,290811,290813,0,2,4
82976,1,1,290812,290813,290814,1,2,0
82977,3,1,290815,290815,290816,0,1,1
82978,2,1,290817,290817,290818,0,1,1
82979,6,2,290823,290823,290825,0,2,5
82980,3,3,290826,290826,290829,0,3,1
82981,4,3,290830,290830,290833,0,3,1
82982,6,3,290836,290836,290839,0,3,3
82983,4,3,290840,290840,290843,0,3,1
82984,4,1,290844,290844,290845,0,1,1
82985,3,2,290847,290847,290849,0,2,2
82986,4,2,290851,290851,290853,0,2,2
82987,5,3,290856,290856,290859,0,3,3
82988,1,3,290857,290859,290862,2,5,0
82989,3,1,290860,290862,290863,2,3,0
82990,1,3,290861,290863,290866,2,5,0
82991,3,2,290864,290866,290868,2,4,0
82992,4,3,290868,290868,290871,0,3,0
82993,2,3,290870,290871,290874,1,4,0
82994,3,2,290873,290874,290876,1,3,0
82995,3,1,290876,290876,290877,0,1,0
82996,1,1,290877,290877,290878,0,1,0
82997,2,3,290879,290879,290882,0,3,1
82998,6,2,290885,290885,290887,0,2,3
82999,5,2,290890,290890,290892,0,2,3
83000,3,1,290893,290893,290894,0,1,1
83001,3,1,290896,290896,290897,0,1,2
83002,2,3,290898,290898,290901,0,3,1
83003,4,2,290902,290902,290904,0,2,1
83004,3,2,290905,290905,290907,0,2,1
83005,5,2,290910,290910,290912,0,2,3
83006,1,2,290911,290912,290914,1,3,0
83007,3,1,290914,290914,290915,0,1,0
83008,4,3,290918,290918,290921,0,3,3
83009,3,3,290921,290921,290924,0,3,0
83010,5,1,290926,290926,290927,0,1,2
83011,5,3,290931,290931,290934,0,3,4
83012,2,1,290933,290934,290935,1,2,0
83013,3,3,290936,290936,290939,0,3,1
83014,3,1,290939,290939,290940,0,1,0
83015,6,1,290945,290945,290946,0,1,5
83016,3,1,290948,290948,290949,0,1,2
83017,4,2,290952,290952,290954,0,2,3
83018,2,3,290954,290954,290957,0,3,0
83019,2,2,290956,290957,290959,1,3,0
83020,4,2,290960,290960,290962,0,2,1
83021,4,1,290964,290964,290965,0,1,2
83022,4,2,290968,290968,290970,0,2,3
83023,5,3,290973,290973,290976,0,3,3
83024,4,1,290977,290977,290978,0,1,1
83025,3,2,290980,290980,290982,0,2,2
83026,6,3,290986,290986,290989,0,3,4
83027,6,2,290992,290992,290994,0,2,3
83028,4,1,290996,290996,290997,0,1,2
83029,4,1,291000,291000,291001,0,1,3
83030,1,1,291001,291001,291002,0,1,0
83031,3,3,291004,291004,291007,0,3,2
83032,5,3,291009,291009,291012,0,3,2
83033,2,2,291011,291012,291014,1,3,0
83034,1,3,291012,291014,291017,2,5,0
83035,5,2,291017,291017,291019,0,2,0
83036,3,2,291020,291020,291022,0,2,1
83037,3,3,291023,291023,291026,0,3,1
83038,4,3,291027,291027,291030,0,3,1
83039,1,3,291028,291030,291033,2,5,0
83040,6,3,291034,291034,291037,0,3,1
83041,5,2,291039,291039,291041,0,2,2
83042,2,3,291041,291041,291044,0,3,0
83043,3,3,291044,291044,291047,0,3,0
83044,5,1,291049,291049,291050,0,1,2
83045,3,2,291052,291052,291054,0,2,2
83046,2,2,291054,291054,291056,0,2,0
83047,2,2,291056,291056,291058,0,2,0
83048,2,3,291058,291058,291061,0,3,0
83049,4,1,291062,291062,291063,0,1,1
83050,4,3,291066,291066,291069,0,3,3
83051,2,3,291068,291069,291072,1,4,0
83052,3,3,291071,291072,291075,1,4,0
83053,1,1,291072,291075,291076,3,4,0
83054,4,3,291076,291076,291079,0,3,0
83055,5,3,291081,291081,291084,0,3,2
83056,1,2,291082,291084,291086,2,4,0
83057,4,1,291086,291086,291087,0,1,0
83058,5,3,291091,291091,291094,0,3,4
83059,1,3,291092,291094,291097,2,5,0
83060,1,3,291093,291097,291100,4,7,0
83061,5,3,291098,291100,291103,2,5,0
83062,3,1,291101,291103,291104,2,3,0
83063,5,1,291106,291106,291107,0,1,2
83064,6,2,291112,291112,291114,0,2,5
83065,2,3,291114,291114,291117,0,3,0
83066,4,2,291118,291118,291120,0,2,1
83067,5,2,291123,291123,291125,0,2,3
83068,3,2,291126,291126,291128,0,2,1
83069,2,3,291128,291128,291131,0,3,0
83070,2,3,291130,291131,291134,1,4,0
83071,5,2,291135,291135,291137,0,2,1
83072,6,2,291141,291141,291143,0,2,4
83073,6,3,291147,291147,291150,0,3,4
83074,4,1,291151,291151,291152,0,1,1
83075,6,2,291157,291157,291159,0,2,5
83076,4,3,291161,291161,291164,0,3,2
83077,2,3,291163,291164,291167,1,4,0
83078,4,2,291167,291167,291169,0,2,0
83079,3,2,291170,291170,291172,0,2,1
83080,6,2,291176,291176,291178,0,2,4
83081,1,1,291177,291178,291179,1,2,0
83082,5,3,291182,291182,291185,0,3,3
83083,6,1,291188,291188,291189,0,1,3
83084,4,3,291192,291192,291195,0,3,3
83085,6,1,291198,291198,291199,0,1,3
83086,6,1,291204,291204,291205,0,1,5
83087,2,1,291206,291206,291207,0,1,1
83088,3,2,291209,291209,291211,0,2,2
83089,2,1,291211,291211,291212,0,1,0
83090,5,1,291216,291216,291217,0,1,4
83091,4,3,291220,291220,291223,0,3,3
83092,2,2,291222,291223,291225,1,3,0
83093,4,3,291226,291226,291229,0,3,1
83094,6,3,291232,291232,291235,0,3,3
83095,5,2,291237,291237,291239,0,2,2
83096,6,3,291243,291243,291246,0,3,4
83097,1,2,291244,291246,291248,2,4,0
83098,4,2,291248,291248,291250,0,2,0
83099,1,1,291249,291250,291251,1,2,0
83100,2,2,291251,291251,291253,0,2,0
83101,3,1,291254,291254,291255,0,1,1
83102,1,3,291255,291255,291258,0,3,0
83103,2,1,291257,291258,291259,1,2,0
83104,2,2,291259,291259,291261,0,2,0
83105,6,2,291265,291265,291267,0,2,4
83106,6,2,291271,291271,291273,0,2,4
83107,6,3,291277,291277,291280,0,3,4
83108,5,3,291282,291282,291285,0,3,2
83109,5,3,291287,291287,291290,0,3,2
83110,1,3,291288,291290,291293,2,5,0
83111,4,1,291292,291293,291294,1,2,0
83112,6,2,291298,291298,291300,0,2,4
83113,6,3,291304,291304,291307,0,3,4
83114,1,1,291305,291307,291308,2,3,0
83115,5,1,291310,291310,291311,0,1,2
83116,5,2,291315,291315,291317,0,2,4
83117,6,3,291321,291321,291324,0,3,4
83118,5,2,291326,291326,291328,0,2,2
83119,2,3,291328,291328,291331,0,3,0
83120,1,2,291329,291331,291333,2,4,0
83121,5,2,291334,291334,291336,0,2,1
83122,5,3,291339,291339,291342,0,3,3
83123,3,3,291342,291342,291345,0,3,0
83124,2,3,291344,291345,291348,1,4,0
83125,1,3,291345,291348,291351,3,6,0
83126,4,2,291349,291351,291353,2,4,0
83127,6,2,291355,291355,291357,0,2,2
83128,3,3,291358,291358,291361,0,3,1
83129,3,2,291361,291361,291363,0,2,0
83130,1,2,291362,291363,291365,1,3,0
83131,5,2,291367,291367,291369,0,2,2
83132,2,2,291369,291369,291371,0,2,0
83133,4,1,291373,291373,291374,0,1,2
83134,4,2,291377,291377,291379,0,2,3
83135,4,3,291381,291381,291384,0,3,2
83136,3,1,291384,291384,291385,0,1,0
83137,2,2,291386,291386,291388,0,2,1
83138,4,2,291390,291390,291392,0,2,2
83139,3,2,291393,291393,291395,0,2,1
83140,6,3,291399,291399,291402,0,3,4
83141,2,3,291401,291402,291405,1,4,0
83142,2,3,291403,291405,291408,2,5,0
83143,6,2,291409,291409,291411,0,2,1
83144,6,1,291415,291415,291416,0,1,4
83145,6,3,291421,291421,291424,0,3,5
83146,1,2,291422,291424,291426,2,4,0
83147,5,3,291427,291427,291430,0,3,1
83148,1,1,291428,291430,291431,2,3,0
83149,3,2,291431,291431,291433,0,2,0
83150,3,3,291434,291434,291437,0,3,1
83151,3,1,291437,291437,291438,0,1,0
83152,6,1,291443,291443,291444,0,1,5
83153,3,1,291446,291446,291447,0,1,2
83154,3,1,291449,291449,291450,0,1,2
83155,4,3,291453,291453,291456,0,3,3
83156,2,1,291455,291456,291457,1,2,0
83157,5,2,291460,291460,291462,0,2,3
83158,5,2,291465,291465,291467,0,2,3
83159,2,1,291467,291467,291468,0,1,0
83160,3,2,291470,291470,291472,0,2,2
83161,3,3,291473,291473,291476,0,3,1
83162,4,2,291477,291477,291479,0,2,1
83163,3,1,291480,291480,291481,0,1,1
83164,3,2,291483,291483,291485,0,2,2
83165,4,3,291487,291487,291490,0,3,2
83166,4,2,291491,291491,291493,0,2,1
83167,4,2,291495,291495,291497,0,2,2
83168,1,1,291496,291497,291498,1,2,0
83169,2,3,291498,291498,291501,0,3,0
83170,4,3,291502,291502,291505,0,3,1
83171,6,1,291508,291508,291509,0,1,3
83172,1,3,291509,291509,291512,0,3,0
83173,3,1,291512,291512,291513,0,1,0
83174,2,3,291514,291514,291517,0,3,1
83175,3,2,291517,291517,291519,0,2,0
83176,5,2,291522,291522,291524,0,2,3
83177,6,2,291528,291528,291530,0,2,4
83178,5,1,291533,291533,291534,0,1,3
83179,6,1,291539,291539,291540,0,1,5
83180,2,2,291541,291541,291543,0,2,1
83181,1,2,291542,291543,291545,1,3,0
83182,3,3,291545,291545,291548,0,3,0
83183,2,3,291547,291548,291551,1,4,0
83184,2,1,291549,291551,291552,2,3,0
83185,1,1,291550,291552,291553,2,3,0
83186,1,2,291551,291553,291555,2,4,0
83187,3,2,291554,291555,291557,1,3,0
83188,4,3,291558,291558,291561,0,3,1
83189,6,2,291564,291564,291566,0,2,3
83190,2,1,291566,291566,291567,0,1,0
83191,2,1,291568,291568,291569,0,1,1
83192,6,3,291574,291574,291577,0,3,5
83193,5,2,291579,291579,291581,0,2,2
83194,1,3,291580,291581,291584,1,4,0
83195,6,3,291586,291586,291589,0,3,2
83196,1,3,291587,291589,291592,2,5,0
83197,5,2,291592,291592,291594,0,2,0
83198,6,1,291598,291598,291599,0,1,4
83199,1,1,291599,291599,291600,0,1,0
83200,3,1,291602,291602,291603,0,1,2
83201,1,2,291603,291603,291605,0,2,0
83202,6,3,291609,291609,291612,0,3,4
83203,1,3,291610,291612,291615,2,5,0
83204,3,2,291613,291615,291617,2,4,0
83205,6,3,291619,291619,291622,0,3,2
83206,2,2,291621,291622,291624,1,3,0
83207,1,2,291622,291624,291626,2,4,0
83208,5,1,291627,291627,291628,0,1,1
83209,2,3,291629,291629,291632,0,3,1
83210,6,3,291635,291635,291638,0,3,3
83211,5,2,291640,291640,291642,0,2,2
83212,4,3,291644,291644,291647,0,3,2
83213,6,3,291650,291650,291653,0,3,3
83214,4,2,291654,291654,291656,0,2,1
83215,3,2,291657,291657,291659,0,2,1
83216,3,2,291660,291660,291662,0,2,1
83217,3,3,291663,291663,291666,0,3,1
83218,2,1,291665,291666,291667,1,2,0
83219,3,2,291668,291668,291670,0,2,1
83220,3,1,291671,291671,291672,0,1,1
83221,2,2,291673,291673,291675,0,2,1
83222,2,1,291675,291675,291676,0,1,0
83223,1,3,291676,291676,291679,0,3,0
83224,3,3,291679,291679,291682,0,3,0
83225,2,2,291681,291682,291684,1,3,0
83226,4,2,291685,291685,291687,0,2,1
83227,1,3,291686,291687,291690,1,4,0
83228,1,3,291687,291690,291693,3,6,0
83229,4,1,291691,291693,291694,2,3,0
83230,1,3,291692,291694,291697,2,5,0
83231,4,2,291696,291697,291699,1,3,0
83232,1,3,291697,291699,291702,2,5,0
83233,2,2,291699,291702,291704,3,5,0
83234,3,1,291702,291704,291705,2,3,0
83235,4,1,291706,291706,291707,0,1,1
83236,2,2,291708,291708,291710,0,2,1
83237,1,1,291709,291710,291711,1,2,0
83238,6,1,291715,291715,291716,0,1,4
83239,6,1,291721,291721,291722,0,1,5
83240,3,2,291724,291724,291726,0,2,2
83241,6,2,291730,291730,291732,0,2,4
83242,5,3,291735,291735,291738,0,3,3
83243,5,3,291740,291740,291743,0,3,2
83244,5,2,291745,291745,291747,0,2,2
83245,5,2,291750,291750,291752,0,2,3
83246,4,2,291754,291754,291756,0,2,2
83247,6,3,291760,291760,291763,0,3,4
83248,2,3,291762,291763,291766,1,4,0
83249,4,1,291766,291766,291767,0,1,0
83250,6,3,291772,291772,291775,0,3,5
83251,2,2,291774,291775,291777,1,3,0
83252,2,2,291776,291777,291779,1,3,0
83253,1,2,291777,291779,291781,2,4,0
83254,6,3,291783,291783,291786,0,3,2
83255,1,1,291784,291786,291787,2,3,0
83256,2,1,291786,291787,291788,1,2,0
83257,5,1,291791,291791,291792,0,1,3
83258,5,1,291796,291796,291797,0,1,4
83259,5,2,291801,291801,291803,0,2,4
83260,4,1,291805,291805,291806,0,1,2
83261,3,2,291808,291808,291810,0,2,2
83262,4,3,291812,291812,291815,0,3,2
83263,6,1,291818,291818,291819,0,1,3
83264,1,2,291819,291819,291821,0,2,0
83265,4,2,291823,291823,291825,0,2,2
83266,4,2,291827,291827,291829,0,2,2
83267,3,1,291830,291830,291831,0,1,1
83268,3,2,291833,291833,291835,0,2,2
83269,4,1,291837,291837,291838,0,1,2
83270,2,1,291839,291839,291840,0,1,1
83271,6,3,291845,291845,291848,0,3,5
83272,3,3,291848,291848,291851,0,3,0
83273,4,1,291852,291852,291853,0,1,1
83274,2,2,291854,291854,291856,0,2,1
83275,3,1,291857,291857,291858,0,1,1
83276,4,1,291861,291861,291862,0,1,3
83277,4,1,291865,291865,291866,0,1,3
83278,4,3,291869,291869,291872,0,3,3
83279,2,3,291871,291872,291875,1,4,0
83280,2,3,291873,291875,291878,2,5,0
83281,1,1,291874,291878,291879,4,5,0
83282,4,2,291878,291879,291881,1,3,0
83283,3,3,291881,291881,291884,0,3,0
83284,4,2,291885,291885,291887,0,2,1
83285,5,3,291890,291890,291893,0,3,3
83286,5,2,291895,291895,291897,0,2,2
83287,4,2,291899,291899,291901,0,2,2
83288,6,3,291905,291905,291908,0,3,4
83289,2,1,291907,291908,291909,1,2,0
83290,2,2,291909,291909,291911,0,2,0
83291,6,2,291915,291915,291917,0,2,4
83292,5,1,291920,291920,291921,0,1,3
83293,6,3,291926,291926,291929,0,3,5
83294,6,3,291932,291932,291935,0,3,3
83295,5,3,291937,291937,291940,0,3,2
83296,1,2,291938,291940,291942,2,4,0
83297,2,2,291940,291942,291944,2,4,0
83298,3,2,291943,291944,291946,1,3,0
83299,3,2,291946,291946,291948,0,2,0
83300,4,3,291950,291950,291953,0,3,2
83301,1,3,291951,291953,291956,2,5,0
83302,1,2,291952,291956,291958,4,6,0
83303,5,2,291957,291958,291960,1,3,0
83304,6,1,291963,291963,291964,0,1,3
83305,2,3,291965,291965,291968,0,3,1
83306,4,2,291969,291969,291971,0,2,1
83307,4,2,291973,291973,291975,0,2,2
83308,2,2,291975,291975,291977,0,2,0
83309,4,3,291979,291979,291982,0,3,2
83310,2,3,291981,291982,291985,1,4,0
83311,1,3,291982,291985,291988,3,6,0
83312,5,3,291987,291988,291991,1,4,0
83313,5,1,291992,291992,291993,0,1,1
83314,1,3,291993,291993,291996,0,3,0
83315,5,2,291998,291998,292000,0,2,2
83316,2,2,292000,292000,292002,0,2,0
83317,6,1,292006,292006,292007,0,1,4
83318,2,3,292008,292008,292011,0,3,1
83319,6,2,292014,292014,292016,0,2,3
83320,1,2,292015,292016,292018,1,3,0
83321,6,3,292021,292021,292024,0,3,3
83322,1,2,292022,292024,292026,2,4,0
83323,5,2,292027,292027,292029,0,2,1
83324,6,1,292033,292033,292034,0,1,4
83325,6,1,292039,292039,292040,0,1,5
83326,5,1,292044,292044,292045,0,1,4
83327,3,3,292047,292047,292050,0,3,2
83328,1,2,292048,292050,292052,2,4,0
83329,3,2,292051,292052,292054,1,3,0
83330,5,1,292056,292056,292057,0,1,2
83331,1,1,292057,292057,292058,0,1,0
83332,4,3,292061,292061,292064,0,3,3
83333,5,2,292066,292066,292068,0,2,2
83334,4,1,292070,292070,292071,0,1,2
83335,5,3,292075,292075,292078,0,3,4
83336,5,1,292080,292080,292081,0,1,2
83337,4,2,292084,292084,292086,0,2,3
83338,3,1,292087,292087,292088,0,1,1
83339,6,3,292093,292093,292096,0,3,5
83340,5,2,292098,292098,292100,0,2,2
83341,1,1,292099,292100,292101,1,2,0
83342,6,3,292105,292105,292108,0,3,4
83343,1,2,292106,292108,292110,2,4,0
83344,1,1,292107,292110,292111,3,4,0
83345,2,1,292109,292111,292112,2,3,0
83346,3,3,292112,292112,292115,0,3,0
83347,3,3,292115,292115,292118,0,3,0
83348,2,2,292117,292118,292120,1,3,0
83349,6,3,292123,292123,292126,0,3,3
83350,6,3,292129,292129,292132,0,3,3
83351,4,1,292133,292133,292134,0,1,1
83352,3,3,292136,292136,292139,0,3,2
83353,2,2,292138,292139,292141,1,3,0
83354,1,2,292139,292141,292143,2,4,0
83355,5,3,292144,292144,292147,0,3,1
83356,2,1,292146,292147,292148,1,2,0
83357,2,3,292148,292148,292151,0,3,0
83358,5,3,292153,292153,292156,0,3,2
83359,1,1,292154,292156,292157,2,3,0
83360,4,2,292158,292158,292160,0,2,1
83361,5,3,292163,292163,292166,0,3,3
83362,6,2,292169,292169,292171,0,2,3
83363,1,2,292170,292171,292173,1,3,0
83364,6,1,292176,292176,292177,0,1,3
83365,2,2,292178,292178,292180,0,2,1
83366,1,3,292179,292180,292183,1,4,0
83367,5,2,292184,292184,292186,0,2,1
83368,2,2,292186,292186,292188,0,2,0
83369,3,2,292189,292189,292191,0,2,1
83370,4,2,292193,292193,292195,0,2,2
83371,6,1,292199,292199,292200,0,1,4
83372,1,3,292200,292200,292203,0,3,0
83373,6,2,292206,292206,292208,0,2,3
83374,5,2,292211,292211,292213,0,2,3
83375,6,1,292217,292217,292218,0,1,4
83376,5,3,292222,292222,292225,0,3,4
83377,4,1,292226,292226,292227,0,1,1
83378,6,1,292232,292232,292233,0,1,5
83379,2,3,292234,292234,292237,0,3,1
83380,6,1,292240,292240,292241,0,1,3
83381,2,3,292242,292242,292245,0,3,1
83382,6,2,292248,292248,292250,0,2,3
83383,6,1,292254,292254,292255,0,1,4
83384,4,2,292258,292258,292260,0,2,3
83385,6,1,292264,292264,292265,0,1,4
83386,3,1,292267,292267,292268,0,1,2
83387,1,1,292268,292268,292269,0,1,0
83388,3,3,292271,292271,292274,0,3,2
83389,2,3,292273,292274,292277,1,4,0
83390,6,2,292279,292279,292281,0,2,2
83391,3,1,292282,292282,292283,0,1,1
83392,6,2,292288,292288,292290,0,2,5
83393,6,2,292294,292294,292296,0,2,4
83394,5,3,292299,292299,292302,0,3,3
83395,1,2,292300,292302,292304,2,4,0
83396,4,1,292304,292304,292305,0,1,0
83397,5,1,292309,292309,292310,0,1,4
83398,6,1,292315,292315,292316,0,1,5
83399,2,3,292317,292317,292320,0,3,1
83400,4,3,292321,292321,292324,0,3,1
83401,2,1,292323,292324,292325,1,2,0
83402,4,2,292327,292327,292329,0,2,2
83403,4,2,292331,292331,292333,0,2,2
83404,6,3,292337,292337,292340,0,3,4
83405,2,3,292339,292340,292343,1,4,0
83406,2,2,292341,292343,292345,2,4,0
83407,6,3,292347,292347,292350,0,3,2
83408,3,2,292350,292350,292352,0,2,0
83409,5,2,292355,292355,292357,0,2,3
83410,1,3,292356,292357,292360,1,4,0
83411,1,1,292357,292360,292361,3,4,0
83412,3,2,292360,292361,292363,1,3,0
83413,4,1,292364,292364,292365,0,1,1
83414,1,3,292365,292365,292368,0,3,0
83415,6,2,292371,292371,292373,0,2,3
83416,6,1,292377,292377,292378,0,1,4
83417,4,1,292381,292381,292382,0,1,3
83418,1,2,292382,292382,292384,0,2,0
83419,5,3,292387,292387,292390,0,3,3
83420,1,2,292388,292390,292392,2,4,0
83421,5,2,292393,292393,292395,0,2,1
83422,4,3,292397,292397,292400,0,3,2
83423,1,3,292398,292400,292403,2,5,0
83424,6,1,292404,292404,292405,0,1,1
83425,1,2,292405,292405,292407,0,2,0
83426,6,1,292411,292411,292412,0,1,4
83427,2,3,292413,292413,292416,0,3,1
83428,4,3,292417,292417,292420,0,3,1
83429,2,1,292419,292420,292421,1,2,0
83430,3,2,292422,292422,292424,0,2,1
83431,3,1,292425,292425,292426,0,1,1
83432,6,3,292431,292431,292434,0,3,5
83433,6,1,292437,292437,292438,0,1,3
83434,4,3,292441,292441,292444,0,3,3
83435,2,1,292443,292444,292445,1,2,0
83436,1,1,292444,292445,292446,1,2,0
83437,2,1,292446,292446,292447,0,1,0
83438,3,1,292449,292449,292450,0,1,2
83439,2,3,292451,292451,292454,0,3,1
83440,4,1,292455,292455,292456,0,1,1
83441,1,2,292456,292456,292458,0,2,0
83442,5,2,292461,292461,292463,0,2,3
83443,2,1,292463,292463,292464,0,1,0
83444,4,2,292467,292467,292469,0,2,3
83445,4,3,292471,292471,292474,0,3,2
83446,3,2,292474,292474,292476,0,2,0
83447,4,3,292478,292478,292481,0,3,2
83448,1,1,292479,292481,292482,2,3,0
83449,1,2,292480,292482,292484,2,4,0
83450,5,3,292485,292485,292488,0,3,1
83451,2,3,292487,292488,292491,1,4,0
83452,6,2,292493,292493,292495,0,2,2
83453,6,1,292499,292499,292500,0,1,4
83454,5,1,292504,292504,292505,0,1,4
83455,6,3,292510,292510,292513,0,3,5
83456,1,2,292511,292513,292515,2,4,0
83457,5,2,292516,292516,292518,0,2,1
83458,1,2,292517,292518,292520,1,3,0
83459,1,3,292518,292520,292523,2,5,0
83460,2,1,292520,292523,292524,3,4,0
83461,5,2,292525,292525,292527,0,2,1
83462,6,1,292531,292531,292532,0,1,4
83463,6,3,292537,292537,292540,0,3,5
83464,5,3,292542,292542,292545,0,3,2
83465,4,3,292546,292546,292549,0,3,1
83466,4,2,292550,292550,292552,0,2,1
83467,5,1,292555,292555,292556,0,1,3
83468,3,2,292558,292558,292560,0,2,2
83469,1,1,292559,292560,292561,1,2,0
83470,2,2,292561,292561,292563,0,2,0
83471,6,3,292567,292567,292570,0,3,4
83472,2,2,292569,292570,292572,1,3,0
83473,3,1,292572,292572,292573,0,1,0
83474,3,3,292575,292575,292578,0,3,2
83475,3,3,292578,292578,292581,0,3,0
83476,6,2,292584,292584,292586,0,2,3
83477,1,3,292585,292586,292589,1,4,0
83478,6,1,292591,292591,292592,0,1,2
83479,5,2,292596,292596,292598,0,2,4
83480,6,1,292602,292602,292603,0,1,4
83481,1,2,292603,292603,292605,0,2,0
83482,3,1,292606,292606,292607,0,1,1
83483,3,1,292609,292609,292610,0,1,2
83484,2,3,292611,292611,292614,0,3,1
83485,6,2,292617,292617,292619,0,2,3
83486,2,2,292619,292619,292621,0,2,0
83487,4,3,292623,292623,292626,0,3,2
83488,3,1,292626,292626,292627,0,1,0
83489,3,2,292629,292629,292631,0,2,2
83490,2,1,292631,292631,292632,0,1,0
83491,3,1,292634,292634,292635,0,1,2
83492,2,2,292636,292636,292638,0,2,1
83493,6,1,292642,292642,292643,0,1,4
83494,4,3,292646,292646,292649,0,3,3
83495,2,2,292648,292649,292651,1,3,0
83496,4,3,292652,292652,292655,0,3,1
83497,4,3,292656,292656,292659,0,3,1
83498,6,1,292662,292662,292663,0,1,3
83499,4,3,292666,292666,292669,0,3,3
83500,6,3,292672,292672,292675,0,3,3
83501,6,1,292678,292678,292679,0,1,3
83502,3,3,292681,292681,292684,0,3,2
83503,5,3,292686,292686,292689,0,3,2
83504,1,3,292687,292689,292692,2,5,0
83505,1,2,292688,292692,292694,4,6,0
83506,4,3,292692,292694,292697,2,5,0
83507,6,1,292698,292698,292699,0,1,1
83508,5,3,292703,292703,292706,0,3,4
83509,5,3,292708,292708,292711,0,3,2
83510,3,1,292711,292711,292712,0,1,0
83511,2,2,292713,292713,292715,0,2,1
83512,5,3,292718,292718,292721,0,3,3
83513,5,1,292723,292723,292724,0,1,2
83514,4,3,292727,292727,292730,0,3,3
83515,1,3,292728,292730,292733,2,5,0
83516,4,2,292732,292733,292735,1,3,0
83517,2,3,292734,292735,292738,1,4,0
83518,4,1,292738,292738,292739,0,1,0
83519,2,3,292740,292740,292743,0,3,1
83520,3,2,292743,292743,292745,0,2,0
83521,3,1,292746,292746,292747,0,1,1
83522,2,3,292748,292748,292751,0,3,1
83523,1,3,292749,292751,292754,2,5,0
83524,5,1,292754,292754,292755,0,1,0
83525,6,2,292760,292760,292762,0,2,5
83526,2,2,292762,292762,292764,0,2,0
83527,2,2,292764,292764,292766,0,2,0
83528,1,3,292765,292766,292769,1,4,0
83529,4,1,292769,292769,292770,0,1,0
83530,5,1,292774,292774,292775,0,1,4
83531,1,1,292775,292775,292776,0,1,0
83532,4,1,292779,292779,292780,0,1,3
83533,5,3,292784,292784,292787,0,3,4
83534,5,3,292789,292789,292792,0,3,2
83535,6,1,292795,292795,292796,0,1,3
83536,1,2,292796,292796,292798,0,2,0
83537,2,2,292798,292798,292800,0,2,0
83538,1,1,292799,292800,292801,1,2,0
83539,6,3,292805,292805,292808,0,3,4
83540,5,1,292810,292810,292811,0,1,2
83541,4,3,292814,292814,292817,0,3,3
83542,5,3,292819,292819,292822,0,3,2
83543,5,3,292824,292824,292827,0,3,2
83544,3,1,292827,292827,292828,0,1,0
83545,3,2,292830,292830,292832,0,2,2
83546,6,1,292836,292836,292837,0,1,4
83547,1,2,292837,292837,292839,0,2,0
83548,3,2,292840,292840,292842,0,2,1
83549,5,1,292845,292845,292846,0,1,3
83550,2,1,292847,292847,292848,0,1,1
83551,2,3,292849,292849,292852,0,3,1
83552,3,1,292852,292852,292853,0,1,0
83553,1,2,292853,292853,292855,0,2,0
83554,4,3,292857,292857,292860,0,3,2
83555,1,1,292858,292860,292861,2,3,0
83556,6,3,292864,292864,292867,0,3,3
83557,4,3,292868,292868,292871,0,3,1
83558,5,1,292873,292873,292874,0,1,2
83559,3,3,292876,292876,292879,0,3,2
83560,5,3,292881,292881,292884,0,3,2
83561,6,2,292887,292887,292889,0,2,3
83562,1,2,292888,292889,292891,1,3,0
83563,2,1,292890,292891,292892,1,2,0
83564,3,2,292893,292893,292895,0,2,1
83565,2,3,292895,292895,292898,0,3,0
83566,3,1,292898,292898,292899,0,1,0
83567,2,2,292900,292900,292902,0,2,1
83568,3,1,292903,292903,292904,0,1,1
83569,6,1,292909,292909,292910,0,1,5
83570,5,1,292914,292914,292915,0,1,4
83571,6,3,292920,292920,292923,0,3,5
83572,1,2,292921,292923,292925,2,4,0
83573,6,3,292927,292927,292930,0,3,2
83574,1,2,292928,292930,292932,2,4,0
83575,6,1,292934,292934,292935,0,1,2
83576,2,3,292936,292936,292939,0,3,1
83577,5,2,292941,292941,292943,0,2,2
83578,4,2,292945,292945,292947,0,2,2
83579,2,3,292947,292947,292950,0,3,0
83580,3,1,292950,292950,292951,0,1,0
83581,2,1,292952,292952,292953,0,1,1
83582,6,1,292958,292958,292959,0,1,5
83583,2,2,292960,292960,292962,0,2,1
83584,1,1,292961,292962,292963,1,2,0
83585,4,1,292965,292965,292966,0,1,2
83586,4,1,292969,292969,292970,0,1,3
83587,1,2,292970,292970,292972,0,2,0
83588,2,2,292972,292972,292974,0,2,0
83589,5,1,292977,292977,292978,0,1,3
83590,5,3,292982,292982,292985,0,3,4
83591,4,1,292986,292986,292987,0,1,1
83592,2,1,292988,292988,292989,0,1,1
83593,4,2,292992,292992,292994,0,2,3
83594,3,3,292995,292995,292998,0,3,1
83595,4,2,292999,292999,293001,0,2,1
83596,3,1,293002,293002,293003,0,1,1
83597,2,1,293004,293004,293005,0,1,1
83598,6,1,293010,293010,293011,0,1,5
83599,1,3,293011,293011,293014,0,3,0
83600,2,2,293013,293014,293016,1,3,0
83601,2,2,293015,293016,293018,1,3,0
83602,5,2,293020,293020,293022,0,2,2
83603,2,3,293022,293022,293025,0,3,0
83604,6,2,293028,293028,293030,0,2,3
83605,5,1,293033,293033,293034,0,1,3
83606,4,1,293037,293037,293038,0,1,3
83607,5,2,293042,293042,293044,0,2,4
83608,1,2,293043,293044,293046,1,3,0
83609,1,3,293044,293046,293049,2,5,0
83610,1,1,293045,293049,293050,4,5,0
83611,4,3,293049,293050,293053,1,4,0
83612,2,3,293051,293053,293056,2,5,0
83613,1,3,293052,293056,293059,4,7,0
83614,6,2,293058,293059,293061,1,3,0
83615,3,2,293061,293061,293063,0,2,0
83616,2,1,293063,293063,293064,0,1,0
83617,3,3,293066,293066,293069,0,3,2
83618,4,2,293070,293070,293072,0,2,1
83619,4,2,293074,293074,293076,0,2,2
83620,6,2,293080,293080,293082,0,2,4
83621,2,2,293082,293082,293084,0,2,0
83622,4,3,293086,293086,293089,0,3,2
83623,3,3,293089,293089,293092,0,3,0
83624,6,1,293095,293095,293096,0,1,3
83625,1,2,293096,293096,293098,0,2,0
83626,1,1,293097,293098,293099,1,2,0
83627,4,3,293101,293101,293104,0,3,2
83628,5,2,293106,293106,293108,0,2,2
83629,1,1,293107,293108,293109,1,2,0
83630,5,1,293112,293112,293113,0,1,3
83631,3,3,293115,293115,293118,0,3,2
83632,2,2,293117,293118,293120,1,3,0
83633,6,3,293123,293123,293126,0,3,3
83634,5,2,293128,293128,293130,0,2,2
83635,4,1,293132,293132,293133,0,1,2
83636,1,1,293133,293133,293134,0,1,0
83637,4,2,293137,293137,293139,0,2,3
83638,6,1,293143,293143,293144,0,1,4
83639,5,2,293148,293148,293150,0,2,4
83640,1,3,293149,293150,293153,1,4,0
83641,1,1,293150,293153,293154,3,4,0
83642,5,3,293155,293155,293158,0,3,1
83643,3,3,293158,293158,293161,0,3,0
83644,1,1,293159,293161,293162,2,3,0
83645,1,3,293160,293162,293165,2,5,0
83646,6,1,293166,293166,293167,0,1,1
83647,6,1,293172,293172,293173,0,1,5
83648,1,1,293173,293173,293174,0,1,0
83649,1,2,293174,293174,293176,0,2,0
83650,1,1,293175,293176,293177,1,2,0
83651,3,3,293178,293178,293181,0,3,1
83652,6,2,293184,293184,293186,0,2,3
83653,6,2,293190,293190,293192,0,2,4
83654,1,1,293191,293192,293193,1,2,0
83655,3,3,293194,293194,293197,0,3,1
83656,6,3,293200,293200,293203,0,3,3
83657,6,2,293206,293206,293208,0,2,3
83658,6,1,293212,293212,293213,0,1,4
83659,3,3,293215,293215,293218,0,3,2
83660,1,3,293216,293218,293221,2,5,0
83661,6,3,293222,293222,293225,0,3,1
83662,2,1,293224,293225,293226,1,2,0
83663,6,1,293230,293230,293231,0,1,4
83664,6,2,293236,293236,293238,0,2,5
83665,4,3,293240,293240,293243,0,3,2
83666,1,3,293241,293243,293246,2,5,0
83667,4,1,293245,293246,293247,1,2,0
83668,4,2,293249,293249,293251,0,2,2
83669,5,1,293254,293254,293255,0,1,3
83670,6,3,293260,293260,293263,0,3,5
83671,6,3,293266,293266,293269,0,3,3
83672,2,1,293268,293269,293270,1,2,0
83673,2,3,293270,293270,293273,0,3,0
83674,3,3,293273,293273,293276,0,3,0
83675,4,3,293277,293277,293280,0,3,1
83676,2,2,293279,293280,293282,1,3,0
83677,6,2,293285,293285,293287,0,2,3
83678,5,1,293290,293290,293291,0,1,3
83679,2,2,293292,293292,293294,0,2,1
83680,5,1,293297,293297,293298,0,1,3
83681,3,3,293300,293300,293303,0,3,2
83682,5,1,293305,293305,293306,0,1,2
83683,2,1,293307,293307,293308,0,1,1
83684,1,1,293308,293308,293309,0,1,0
83685,4,2,293312,293312,293314,0,2,3
83686,6,3,293318,293318,293321,0,3,4
83687,6,3,293324,293324,293327,0,3,3
83688,3,2,293327,293327,293329,0,2,0
83689,6,2,293333,293333,293335,0,2,4
83690,6,2,293339,293339,293341,0,2,4
83691,4,2,293343,293343,293345,0,2,2
83692,3,3,293346,293346,293349,0,3,1
83693,3,1,293349,293349,293350,0,1,0
83694,1,2,293350,293350,293352,0,2,0
83695,5,3,293355,293355,293358,0,3,3
83696,3,3,293358,293358,293361,0,3,0
83697,3,1,293361,293361,293362,0,1,0
83698,3,3,293364,293364,293367,0,3,2
83699,6,2,293370,293370,293372,0,2,3
83700,3,1,293373,293373,293374,0,1,1
83701,2,2,293375,293375,293377,0,2,1
83702,2,1,293377,293377,293378,0,1,0
83703,3,3,293380,293380,293383,0,3,2
83704,2,1,293382,293383,293384,1,2,0
83705,1,2,293383,293384,293386,1,3,0
83706,1,2,293384,293386,293388,2,4,0
83707,4,3,293388,293388,293391,0,3,0
83708,3,1,293391,293391,293392,0,1,0
83709,6,2,293397,293397,293399,0,2,5
83710,4,2,293401,293401,293403,0,2,2
83711,1,3,293402,293403,293406,1,4,0
83712,1,1,293403,293406,293407,3,4,0
83713,4,2,293407,293407,293409,0,2,0
83714,5,3,293412,293412,293415,0,3,3
83715,3,1,293415,293415,293416,0,1,0
83716,3,2,293418,293418,293420,0,2,2
83717,6,2,293424,293424,293426,0,2,4
83718,6,2,293430,293430,293432,0,2,4
83719,4,3,293434,293434,293437,0,3,2
83720,6,1,293440,293440,293441,0,1,3
83721,1,2,293441,293441,293443,0,2,0
83722,6,3,293447,293447,293450,0,3,4
83723,3,1,293450,293450,293451,0,1,0
83724,5,1,293455,293455,293456,0,1,4
83725,3,2,293458,293458,293460,0,2,2
83726,1,1,293459,293460,293461,1,2,0
83727,4,3,293463,293463,293466,0,3,2
83728,6,3,293469,293469,293472,0,3,3
83729,3,1,293472,293472,293473,0,1,0
83730,1,3,293473,293473,293476,0,3,0
83731,6,1,293479,293479,293480,0,1,3
83732,4,2,293483,293483,293485,0,2,3
83733,3,1,293486,293486,293487,0,1,1
83734,1,1,293487,293487,293488,0,1,0
83735,3,3,293490,293490,293493,0,3,2
83736,3,2,293493,293493,293495,0,2,0
83737,3,3,293496,293496,293499,0,3,1
83738,6,1,293502,293502,293503,0,1,3
83739,6,2,293508,293508,293510,0,2,5
83740,5,3,293513,293513,293516,0,3,3
83741,1,3,293514,293516,293519,2,5,0
83742,2,1,293516,293519,293520,3,4,0
83743,1,3,293517,293520,293523,3,6,0
83744,3,2,293520,293523,293525,3,5,0
83745,2,1,293522,293525,293526,3,4,0
83746,3,3,293525,293526,293529,1,4,0
83747,6,3,293531,293531,293534,0,3,2
83748,5,3,293536,293536,293539,0,3,2
83749,4,3,293540,293540,293543,0,3,1
83750,6,1,293546,293546,293547,0,1,3
83751,3,2,293549,293549,293551,0,2,2
83752,2,1,293551,293551,293552,0,1,0
83753,1,1,293552,293552,293553,0,1,0
83754,5,2,293557,293557,293559,0,2,4
83755,1,2,293558,293559,293561,1,3,0
83756,6,2,293564,293564,293566,0,2,3
83757,1,2,293565,293566,293568,1,3,0
83758,3,1,293568,293568,293569,0,1,0
83759,5,3,293573,293573,293576,0,3,4
83760,4,3,293577,293577,293580,0,3,1
83761,5,2,293582,293582,293584,0,2,2
83762,3,2,293585,293585,293587,0,2,1
83763,4,1,293589,293589,293590,0,1,2
83764,6,2,293595,293595,293597,0,2,5
83765,3,1,293598,293598,293599,0,1,1
83766,1,1,293599,293599,293600,0,1,0
83767,4,3,293603,293603,293606,0,3,3
83768,6,3,293609,293609,293612,0,3,3
83769,1,2,293610,293612,293614,2,4,0
83770,2,3,293612,293614,293617,2,5,0
83771,4,2,293616,293617,293619,1,3,0
83772,4,3,293620,293620,293623,0,3,1
83773,3,2,293623,293623,293625,0,2,0
83774,4,2,293627,293627,293629,0,2,2
83775,5,3,293632,293632,293635,0,3,3
83776,3,3,293635,293635,293638,0,3,0
83777,5,2,293640,293640,293642,0,2,2
83778,1,3,293641,293642,293645,1,4,0
83779,5,2,293646,293646,293648,0,2,1
83780,4,1,293650,293650,293651,0,1,2
83781,2,1,293652,293652,293653,0,1,1
83782,2,1,293654,293654,293655,0,1,1
83783,1,3,293655,293655,293658,0,3,0
83784,6,2,293661,293661,293663,0,2,3
83785,4,3,293665,293665,293668,0,3,2
83786,2,3,293667,293668,293671,1,4,0
83787,6,1,293673,293673,293674,0,1,2
83788,4,3,293677,293677,293680,0,3,3
83789,1,2,293678,293680,293682,2,4,0
83790,6,3,293684,293684,293687,0,3,2
83791,6,1,293690,293690,293691,0,1,3
83792,5,1,293695,293695,293696,0,1,4
83793,1,2,293696,293696,293698,0,2,0
83794,2,1,293698,293698,293699,0,1,0
83795,4,1,293702,293702,293703,0,1,3
83796,2,3,293704,293704,293707,0,3,1
83797,6,2,293710,293710,293712,0,2,3
83798,6,1,293716,293716,293717,0,1,4
83799,4,3,293720,293720,293723,0,3,3
83800,4,1,293724,293724,293725,0,1,1
83801,2,3,293726,293726,293729,0,3,1
83802,1,1,293727,293729,293730,2,3,0
83803,2,3,293729,293730,293733,1,4,0
83804,3,3,293732,293733,293736,1,4,0
83805,1,2,293733,293736,293738,3,5,0
83806,6,3,293739,293739,293742,0,3,1
83807,4,1,293743,293743,293744,0,1,1
83808,5,2,293748,293748,293750,0,2,4
83809,2,1,293750,293750,293751,0,1,0
83810,3,3,293753,293753,293756,0,3,2
83811,3,3,293756,293756,293759,0,3,0
83812,3,1,293759,293759,293760,0,1,0
83813,4,1,293763,293763,293764,0,1,3
83814,1,3,293764,293764,293767,0,3,0
83815,3,3,293767,293767,293770,0,3,0
83816,4,1,293771,293771,293772,0,1,1
83817,6,2,293777,293777,293779,0,2,5
83818,5,1,293782,293782,293783,0,1,3
83819,4,1,293786,293786,293787,0,1,3
83820,5,2,293791,293791,293793,0,2,4
83821,5,3,293796,293796,293799,0,3,3
83822,5,1,293801,293801,293802,0,1,2
83823,1,3,293802,293802,293805,0,3,0
83824,3,1,293805,293805,293806,0,1,0
83825,6,2,293811,293811,293813,0,2,5
83826,3,2,293814,293814,293816,0,2,1
83827,2,3,293816,293816,293819,0,3,0
83828,2,3,293818,293819,293822,1,4,0
83829,3,2,293821,293822,293824,1,3,0
83830,6,3,293827,293827,293830,0,3,3
83831,4,2,293831,293831,293833,0,2,1
83832,6,3,293837,293837,293840,0,3,4
83833,3,2,293840,293840,293842,0,2,0
83834,6,1,293846,293846,293847,0,1,4
83835,5,2,293851,293851,293853,0,2,4
83836,2,1,293853,293853,293854,0,1,0
83837,4,1,293857,293857,293858,0,1,3
83838,2,1,293859,293859,293860,0,1,1
83839,6,3,293865,293865,293868,0,3,5
83840,5,3,293870,293870,293873,0,3,2
83841,3,2,293873,293873,293875,0,2,0
83842,3,2,293876,293876,293878,0,2,1
83843,6,1,293882,293882,293883,0,1,4
83844,3,1,293885,293885,293886,0,1,2
83845,1,3,293886,293886,293889,0,3,0
83846,3,3,293889,293889,293892,0,3,0
83847,2,1,293891,293892,293893,1,2,0
83848,5,3,293896,293896,293899,0,3,3
83849,1,3,293897,293899,293902,2,5,0
83850,3,2,293900,293902,293904,2,4,0
83851,3,1,293903,293904,293905,1,2,0
83852,6,2,293909,293909,293911,0,2,4
83853,4,2,293913,293913,293915,0,2,2
83854,6,3,293919,293919,293922,0,3,4
83855,4,2,293923,293923,293925,0,2,1
83856,3,1,293926,293926,293927,0,1,1
83857,2,3,293928,293928,293931,0,3,1
83858,6,2,293934,293934,293936,0,2,3
83859,4,3,293938,293938,293941,0,3,2
83860,2,1,293940,293941,293942,1,2,0
83861,3,1,293943,293943,293944,0,1,1
83862,5,3,293948,293948,293951,0,3,4
83863,4,3,293952,293952,293955,0,3,1
83864,5,3,293957,293957,293960,0,3,2
83865,4,3,293961,293961,293964,0,3,1
83866,4,2,293965,293965,293967,0,2,1
83867,4,1,293969,293969,293970,0,1,2
83868,6,1,293975,293975,293976,0,1,5
83869,6,1,293981,293981,293982,0,1,5
83870,3,1,293984,293984,293985,0,1,2
83871,4,3,293988,293988,293991,0,3,3
83872,2,2,293990,293991,293993,1,3,0
83873,3,1,293993,293993,293994,0,1,0
83874,5,3,293998,293998,294001,0,3,4
83875,3,3,294001,294001,294004,0,3,0
83876,5,3,294006,294006,294009,0,3,2
83877,6,2,294012,294012,294014,0,2,3
83878,3,2,294015,294015,294017,0,2,1
83879,2,2,294017,294017,294019,0,2,0
83880,6,3,294023,294023,294026,0,3,4
83881,1,3,294024,294026,294029,2,5,0
83882,4,2,294028,294029,294031,1,3,0
83883,6,3,294034,294034,294037,0,3,3
83884,3,2,294037,294037,294039,0,2,0
83885,4,1,294041,294041,294042,0,1,2
83886,2,1,294043,294043,294044,0,1,1
83887,5,2,294048,294048,294050,0,2,4
83888,2,3,294050,294050,294053,0,3,0
83889,4,1,294054,294054,294055,0,1,1
83890,4,1,294058,294058,294059,0,1,3
83891,3,1,294061,294061,294062,0,1,2
83892,5,1,294066,294066,294067,0,1,4
83893,4,2,294070,294070,294072,0,2,3
83894,2,1,294072,294072,294073,0,1,0
83895,4,3,294076,294076,294079,0,3,3
83896,6,2,294082,294082,294084,0,2,3
83897,2,3,294084,294084,294087,0,3,0
83898,6,3,294090,294090,294093,0,3,3
83899,4,1,294094,294094,294095,0,1,1
83900,4,3,294098,294098,294101,0,3,3
83901,6,1,294104,294104,294105,0,1,3
83902,1,2,294105,294105,294107,0,2,0
83903,2,1,294107,294107,294108,0,1,0
83904,1,3,294108,294108,294111,0,3,0
83905,4,2,294112,294112,294114,0,2,1
83906,2,1,294114,294114,294115,0,1,0
83907,4,1,294118,294118,294119,0,1,3
83908,1,2,294119,294119,294121,0,2,0
83909,1,3,294120,294121,294124,1,4,0
83910,2,1,294122,294124,294125,2,3,0
83911,2,3,294124,294125,294128,1,4,0
83912,1,2,294125,294128,294130,3,5,0
83913,3,3,294128,294130,294133,2,5,0
83914,3,3,294131,294133,294136,2,5,0
83915,1,1,294132,294136,294137,4,5,0
83916,3,2,294135,294137,294139,2,4,0
83917,1,2,294136,294139,294141,3,5,0
83918,6,3,294142,294142,294145,0,3,1
83919,1,2,294143,294145,294147,2,4,0
83920,6,3,294149,294149,294152,0,3,2
83921,2,2,294151,294152,294154,1,3,0
83922,2,3,294153,294154,294157,1,4,0
83923,2,1,294155,294157,294158,2,3,0
83924,2,3,294157,294158,294161,1,4,0
83925,3,1,294160,294161,294162,1,2,0
83926,4,3,294164,294164,294167,0,3,2
83927,5,1,294169,294169,294170,0,1,2
83928,5,3,294174,294174,294177,0,3,4
83929,5,1,294179,294179,294180,0,1,2
83930,4,1,294183,294183,294184,0,1,3
83931,6,1,294189,294189,294190,0,1,5
83932,6,3,294195,294195,294198,0,3,5
83933,1,3,294196,294198,294201,2,5,0
83934,4,1,294200,294201,294202,1,2,0
83935,5,3,294205,294205,294208,0,3,3
83936,5,2,294210,294210,294212,0,2,2
83937,4,2,294214,294214,294216,0,2,2
83938,5,2,294219,294219,294221,0,2,3
83939,3,2,294222,294222,294224,0,2,1
83940,5,3,294227,294227,294230,0,3,3
83941,4,2,294231,294231,294233,0,2,1
83942,3,1,294234,294234,294235,0,1,1
83943,5,3,294239,294239,294242,0,3,4
83944,2,2,294241,294242,294244,1,3,0
83945,4,1,294245,294245,294246,0,1,1
83946,1,3,294246,294246,294249,0,3,0
83947,6,1,294252,294252,294253,0,1,3
83948,1,2,294253,294253,294255,0,2,0
83949,6,3,294259,294259,294262,0,3,4
83950,6,1,294265,294265,294266,0,1,3
83951,5,3,294270,294270,294273,0,3,4
83952,3,3,294273,294273,294276,0,3,0
83953,3,1,294276,294276,294277,0,1,0
83954,5,1,294281,294281,294282,0,1,4
83955,2,2,294283,294283,294285,0,2,1
83956,1,2,294284,294285,294287,1,3,0
83957,2,2,294286,294287,294289,1,3,0
83958,3,3,294289,294289,294292,0,3,0
83959,5,3,294294,294294,294297,0,3,2
83960,5,1,294299,294299,294300,0,1,2
83961,4,1,294303,294303,294304,0,1,3
83962,3,3,294306,294306,294309,0,3,2
83963,3,2,294309,294309,294311,0,2,0
83964,2,2,294311,294311,294313,0,2,0
83965,5,1,294316,294316,294317,0,1,3
83966,5,1,294321,294321,294322,0,1,4
83967,5,3,294326,294326,294329,0,3,4
83968,3,1,294329,294329,294330,0,1,0
83969,5,3,294334,294334,294337,0,3,4
83970,4,3,294338,294338,294341,0,3,1
83971,1,1,294339,294341,294342,2,3,0
83972,6,2,294345,294345,294347,0,2,3
83973,3,1,294348,294348,294349,0,1,1
83974,5,1,294353,294353,294354,0,1,4
83975,4,3,294357,294357,294360,0,3,3
83976,2,1,294359,294360,294361,1,2,0
83977,6,3,294365,294365,294368,0,3,4
83978,2,3,294367,294368,294371,1,4,0
83979,5,3,294372,294372,294375,0,3,1
83980,3,1,294375,294375,294376,0,1,0
83981,1,2,294376,294376,294378,0,2,0
83982,5,1,294381,294381,294382,0,1,3
83983,2,2,294383,294383,294385,0,2,1
83984,5,3,294388,294388,294391,0,3,3
83985,5,2,294393,294393,294395,0,2,2
83986,5,3,294398,294398,294401,0,3,3
83987,5,3,294403,294403,294406,0,3,2
83988,5,1,294408,294408,294409,0,1,2
83989,6,3,294414,294414,294417,0,3,5
83990,4,3,294418,294418,294421,0,3,1
83991,1,2,294419,294421,294423,2,4,0
83992,4,3,294423,294423,294426,0,3,0
83993,4,1,294427,294427,294428,0,1,1
83994,5,1,294432,294432,294433,0,1,4
83995,1,1,294433,294433,294434,0,1,0
83996,4,3,294437,294437,294440,0,3,3
83997,4,2,294441,294441,294443,0,2,1
83998,1,3,294442,294443,294446,1,4,0
83999,2,2,294444,294446,294448,2,4,0
84000,2,1,294446,294448,294449,2,3,0
84001,3,2,294449,294449,294451,0,2,0
84002,6,3,294455,294455,294458,0,3,4
84003,1,1,294456,294458,294459,2,3,0
84004,5,1,294461,294461,294462,0,1,2
84005,4,3,294465,294465,294468,0,3,3
84006,6,1,294471,294471,294472,0,1,3
84007,1,3,294472,294472,294475,0,3,0
84008,4,3,294476,294476,294479,0,3,1
84009,4,3,294480,294480,294483,0,3,1
84010,6,1,294486,294486,294487,0,1,3
84011,2,2,294488,294488,294490,0,2,1
84012,2,1,294490,294490,294491,0,1,0
84013,1,2,294491,294491,294493,0,2,0
84014,2,3,294493,294493,294496,0,3,0
84015,2,2,294495,294496,294498,1,3,0
84016,2,3,294497,294498,294501,1,4,0
84017,4,1,294501,294501,294502,0,1,0
84018,1,3,294502,294502,294505,0,3,0
84019,1,3,294503,294505,294508,2,5,0
84020,1,1,294504,294508,294509,4,5,0
84021,5,1,294509,294509,294510,0,1,0
84022,3,1,294512,294512,294513,0,1,2
84023,2,3,294514,294514,294517,0,3,1
84024,2,3,294516,294517,294520,1,4,0
84025,6,1,294522,294522,294523,0,1,2
84026,1,3,294523,294523,294526,0,3,0
84027,6,3,294529,294529,294532,0,3,3
84028,3,2,294532,294532,294534,0,2,0
84029,4,2,294536,294536,294538,0,2,2
84030,1,1,294537,294538,294539,1,2,0
84031,4,1,294541,294541,294542,0,1,2
84032,6,2,294547,294547,294549,0,2,5
84033,2,3,294549,294549,294552,0,3,0
84034,1,3,294550,294552,294555,2,5,0
84035,4,2,294554,294555,294557,1,3,0
84036,6,2,294560,294560,294562,0,2,3
84037,3,3,294563,294563,294566,0,3,1
84038,3,1,294566,294566,294567,0,1,0
84039,4,1,294570,294570,294571,0,1,3
84040,5,1,294575,294575,294576,0,1,4
84041,6,1,294581,294581,294582,0,1,5
84042,3,3,294584,294584,294587,0,3,2
84043,2,3,294586,294587,294590,1,4,0
84044,2,2,294588,294590,294592,2,4,0
84045,2,3,294590,294592,294595,2,5,0
84046,4,3,294594,294595,294598,1,4,0
84047,1,3,294595,294598,294601,3,6,0
84048,1,3,294596,294601,294604,5,8,0
84049,4,2,294600,294604,294606,4,6,0
84050,1,2,294601,294606,294608,5,7,0
84051,3,2,294604,294608,294610,4,6,0
84052,4,3,294608,294610,294613,2,5,0
84053,4,1,294612,294613,294614,1,2,0
84054,5,2,294617,294617,294619,0,2,3
84055,4,1,294621,294621,294622,0,1,2
84056,5,1,294626,294626,294627,0,1,4
84057,6,1,294632,294632,294633,0,1,5
84058,4,2,294636,294636,294638,0,2,3
84059,4,3,294640,294640,294643,0,3,2
84060,4,2,294644,294644,294646,0,2,1
84061,3,1,294647,294647,294648,0,1,1
84062,1,2,294648,294648,294650,0,2,0
84063,6,2,294654,294654,294656,0,2,4
84064,4,2,294658,294658,294660,0,2,2
84065,6,2,294664,294664,294666,0,2,4
84066,4,2,294668,294668,294670,0,2,2
84067,3,2,294671,294671,294673,0,2,1
84068,2,2,294673,294673,294675,0,2,0
84069,4,1,294677,294677,294678,0,1,2
84070,1,1,294678,294678,294679,0,1,0
84071,6,3,294684,294684,294687,0,3,5
84072,1,1,294685,294687,294688,2,3,0
84073,1,1,294686,294688,294689,2,3,0
84074,2,3,294688,294689,294692,1,4,0
84075,6,1,294694,294694,294695,0,1,2
84076,1,2,294695,294695,294697,0,2,0
84077,4,2,294699,294699,294701,0,2,2
84078,5,3,294704,294704,294707,0,3,3
84079,1,1,294705,294707,294708,2,3,0
84080,6,2,294711,294711,294713,0,2,3
84081,3,2,294714,294714,294716,0,2,1
84082,5,3,294719,294719,294722,0,3,3
84083,3,1,294722,294722,294723,0,1,0
84084,2,1,294724,294724,294725,0,1,1
84085,2,1,294726,294726,294727,0,1,1
84086,3,2,294729,294729,294731,0,2,2
84087,4,1,294733,294733,294734,0,1,2
84088,1,1,294734,294734,294735,0,1,0
84089,6,2,294740,294740,294742,0,2,5
84090,5,2,294745,294745,294747,0,2,3
84091,2,3,294747,294747,294750,0,3,0
84092,5,1,294752,294752,294753,0,1,2
84093,2,2,294754,294754,294756,0,2,1
84094,5,1,294759,294759,294760,0,1,3
84095,5,2,294764,294764,294766,0,2,4
84096,2,2,294766,294766,294768,0,2,0
84097,6,3,294772,294772,294775,0,3,4
84098,3,2,294775,294775,294777,0,2,0
84099,2,2,294777,294777,294779,0,2,0
84100,3,2,294780,294780,294782,0,2,1
84101,6,2,294786,294786,294788,0,2,4
84102,5,3,294791,294791,294794,0,3,3
84103,5,1,294796,294796,294797,0,1,2
84104,2,3,294798,294798,294801,0,3,1
84105,4,1,294802,294802,294803,0,1,1
84106,4,3,294806,294806,294809,0,3,3
84107,6,3,294812,294812,294815,0,3,3
84108,5,3,294817,294817,294820,0,3,2
84109,3,3,294820,294820,294823,0,3,0
84110,4,3,294824,294824,294827,0,3,1
84111,2,2,294826,294827,294829,1,3,0
84112,3,3,294829,294829,294832,0,3,0
84113,1,2,294830,294832,294834,2,4,0
84114,5,3,294835,294835,294838,0,3,1
84115,2,2,294837,294838,294840,1,3,0
84116,4,2,294841,294841,294843,0,2,1
84117,3,2,294844,294844,294846,0,2,1
84118,2,1,294846,294846,294847,0,1,0
84119,6,1,294852,294852,294853,0,1,5
84120,1,3,294853,294853,294856,0,3,0
84121,5,1,294858,294858,294859,0,1,2
84122,2,1,294860,294860,294861,0,1,1
84123,1,2,294861,294861,294863,0,2,0
84124,6,3,294867,294867,294870,0,3,4
84125,3,1,294870,294870,294871,0,1,0
84126,6,3,294876,294876,294879,0,3,5
84127,3,2,294879,294879,294881,0,2,0
84128,5,2,294884,294884,294886,0,2,3
84129,1,3,294885,294886,294889,1,4,0
84130,5,3,294890,294890,294893,0,3,1
84131,3,2,294893,294893,294895,0,2,0
84132,6,3,294899,294899,294902,0,3,4
84133,1,1,294900,294902,294903,2,3,0
84134,1,3,294901,294903,294906,2,5,0
84135,2,1,294903,294906,294907,3,4,0
84136,6,1,294909,294909,294910,0,1,2
84137,1,1,294910,294910,294911,0,1,0
84138,5,1,294915,294915,294916,0,1,4
84139,5,3,294920,294920,294923,0,3,4
84140,2,3,294922,294923,294926,1,4,0
84141,4,1,294926,294926,294927,0,1,0
84142,6,2,294932,294932,294934,0,2,5
84143,4,2,294936,294936,294938,0,2,2
84144,1,1,294937,294938,294939,1,2,0
84145,4,3,294941,294941,294944,0,3,2
84146,4,3,294945,294945,294948,0,3,1
84147,6,2,294951,294951,294953,0,2,3
84148,1,3,294952,294953,294956,1,4,0
84149,5,1,294957,294957,294958,0,1,1
84150,4,3,294961,294961,294964,0,3,3
84151,6,3,294967,294967,294970,0,3,3
84152,2,2,294969,294970,294972,1,3,0
84153,1,3,294970,294972,294975,2,5,0
84154,4,1,294974,294975,294976,1,2,0
84155,3,1,294977,294977,294978,0,1,1
84156,2,3,294979,294979,294982,0,3,1
84157,5,3,294984,294984,294987,0,3,2
84158,1,3,294985,294987,294990,2,5,0
84159,4,2,294989,294990,294992,1,3,0
84160,6,2,294995,294995,294997,0,2,3
84161,4,2,294999,294999,295001,0,2,2
84162,1,1,295000,295001,295002,1,2,0
84163,3,1,295003,295003,295004,0,1,1
84164,5,3,295008,295008,295011,0,3,4
84165,6,2,295014,295014,295016,0,2,3
84166,4,3,295018,295018,295021,0,3,2
84167,1,3,295019,295021,295024,2,5,0
84168,3,2,295022,295024,295026,2,4,0
84169,1,3,295023,295026,295029,3,6,0
84170,4,2,295027,295029,295031,2,4,0
84171,2,2,295029,295031,295033,2,4,0
84172,1,3,295030,295033,295036,3,6,0
84173,2,2,295032,295036,295038,4,6,0
84174,1,1,295033,295038,295039,5,6,0
84175,5,3,295038,295039,295042,1,4,0
84176,1,2,295039,295042,295044,3,5,0
84177,4,2,295043,295044,295046,1,3,0
84178,4,1,295047,295047,295048,0,1,1
84179,5,1,295052,295052,295053,0,1,4
84180,2,1,295054,295054,295055,0,1,1
84181,2,3,295056,295056,295059,0,3,1
84182,6,3,295062,295062,295065,0,3,3
84183,5,1,295067,295067,295068,0,1,2
84184,3,3,295070,295070,295073,0,3,2
84185,1,3,295071,295073,295076,2,5,0
84186,1,1,295072,295076,295077,4,5,0
84187,6,1,295078,295078,295079,0,1,1
84188,4,1,295082,295082,295083,0,1,3
84189,1,2,295083,295083,295085,0,2,0
84190,2,2,295085,295085,295087,0,2,0
84191,4,3,295089,295089,295092,0,3,2
84192,1,2,295090,295092,295094,2,4,0
84193,5,3,295095,295095,295098,0,3,1
84194,3,3,295098,295098,295101,0,3,0
84195,2,1,295100,295101,295102,1,2,0
84196,5,3,295105,295105,295108,0,3,3
84197,4,3,295109,295109,295112,0,3,1
84198,6,3,295115,295115,295118,0,3,3
84199,1,2,295116,295118,295120,2,4,0
84200,6,1,295122,295122,295123,0,1,2
84201,4,1,295126,295126,295127,0,1,3
84202,4,3,295130,295130,295133,0,3,3
84203,2,1,295132,295133,295134,1,2,0
84204,1,2,295133,295134,295136,1,3,0
84205,5,3,295138,295138,295141,0,3,2
84206,4,3,295142,295142,295145,0,3,1
84207,1,1,295143,295145,295146,2,3,0
84208,3,3,295146,295146,295149,0,3,0
84209,1,2,295147,295149,295151,2,4,0
84210,2,1,295149,295151,295152,2,3,0
84211,2,1,295151,295152,295153,1,2,0
84212,6,3,295157,295157,295160,0,3,4
84213,2,2,295159,295160,295162,1,3,0
84214,4,3,295163,295163,295166,0,3,1
84215,4,1,295167,295167,295168,0,1,1
84216,6,1,295173,295173,295174,0,1,5
84217,6,2,295179,295179,295181,0,2,5
84218,5,2,295184,295184,295186,0,2,3
84219,5,2,295189,295189,295191,0,2,3
84220,1,2,295190,295191,295193,1,3,0
84221,6,1,295196,295196,295197,0,1,3
84222,3,3,295199,295199,295202,0,3,2
84223,1,3,295200,295202,295205,2,5,0
84224,1,2,295201,295205,295207,4,6,0
84225,2,3,295203,295207,295210,4,7,0
84226,3,2,295206,295210,295212,4,6,0
84227,5,2,295211,295212,295214,1,3,0
84228,1,3,295212,295214,295217,2,5,0
84229,6,1,295218,295218,295219,0,1,1
84230,4,1,295222,295222,295223,0,1,3
84231,6,3,295228,295228,295231,0,3,5
84232,3,1,295231,295231,295232,0,1,0
84233,2,1,295233,295233,295234,0,1,1
84234,3,2,295236,295236,295238,0,2,2
84235,4,3,295240,295240,295243,0,3,2
84236,2,2,295242,295243,295245,1,3,0
84237,5,3,295247,295247,295250,0,3,2
84238,4,3,295251,295251,295254,0,3,1
84239,4,3,295255,295255,295258,0,3,1
84240,1,3,295256,295258,295261,2,5,0
84241,4,1,295260,295261,295262,1,2,0
84242,5,3,295265,295265,295268,0,3,3
84243,6,2,295271,295271,295273,0,2,3
84244,6,1,295277,295277,295278,0,1,4
84245,5,1,295282,295282,295283,0,1,4
84246,5,1,295287,295287,295288,0,1,4
84247,1,1,295288,295288,295289,0,1,0
84248,4,2,295292,295292,295294,0,2,3
84249,6,1,295298,295298,295299,0,1,4
84250,4,3,295302,295302,295305,0,3,3
84251,2,1,295304,295305,295306,1,2,0
84252,4,3,295308,295308,295311,0,3,2
84253,3,2,295311,295311,295313,0,2,0
84254,2,3,295313,295313,295316,0,3,0
84255,6,1,295319,295319,295320,0,1,3
84256,6,1,295325,295325,295326,0,1,5
84257,4,3,295329,295329,295332,0,3,3
84258,6,3,295335,295335,295338,0,3,3
84259,5,1,295340,295340,295341,0,1,2
84260,2,3,295342,295342,295345,0,3,1
84261,3,1,295345,295345,295346,0,1,0
84262,6,2,295351,295351,295353,0,2,5
84263,4,1,295355,295355,295356,0,1,2
84264,6,2,295361,295361,295363,0,2,5
84265,4,2,295365,295365,295367,0,2,2
84266,5,2,295370,295370,295372,0,2,3
84267,4,2,295374,295374,295376,0,2,2
84268,6,3,295380,295380,295383,0,3,4
84269,5,3,295385,295385,295388,0,3,2
84270,1,3,295386,295388,295391,2,5,0
84271,3,2,295389,295391,295393,2,4,0
84272,2,3,295391,295393,295396,2,5,0
84273,4,2,295395,295396,295398,1,3,0
84274,4,1,295399,295399,295400,0,1,1
84275,3,2,295402,295402,295404,0,2,2
84276,2,2,295404,295404,295406,0,2,0
84277,5,1,295409,295409,295410,0,1,3
84278,4,1,295413,295413,295414,0,1,3
84279,3,1,295416,295416,295417,0,1,2
84280,1,3,295417,295417,295420,0,3,0
84281,6,3,295423,295423,295426,0,3,3
84282,2,1,295425,295426,295427,1,2,0
84283,1,3,295426,295427,295430,1,4,0
84284,1,3,295427,295430,295433,3,6,0
84285,4,1,295431,295433,295434,2,3,0
84286,6,2,295437,295437,295439,0,2,3
84287,4,2,295441,295441,295443,0,2,2
84288,3,3,295444,295444,295447,0,3,1
84289,1,3,295445,295447,295450,2,5,0
84290,2,2,295447,295450,295452,3,5,0
84291,5,3,295452,295452,295455,0,3,0
84292,3,1,295455,295455,295456,0,1,0
84293,5,1,295460,295460,295461,0,1,4
84294,1,2,295461,295461,295463,0,2,0
84295,6,3,295467,295467,295470,0,3,4
84296,3,3,295470,295470,295473,0,3,0
84297,6,2,295476,295476,295478,0,2,3
84298,5,2,295481,295481,295483,0,2,3
84299,1,3,295482,295483,295486,1,4,0
84300,1,1,295483,295486,295487,3,4,0
84301,1,2,295484,295487,295489,3,5,0
84302,3,1,295487,295489,295490,2,3,0
84303,5,1,295492,295492,295493,0,1,2
84304,3,3,295495,295495,295498,0,3,2
84305,4,2,295499,295499,295501,0,2,1
84306,1,1,295500,295501,295502,1,2,0
84307,6,1,295506,295506,295507,0,1,4
84308,6,2,295512,295512,295514,0,2,5
84309,5,2,295517,295517,295519,0,2,3
84310,4,2,295521,295521,295523,0,2,2
84311,4,1,295525,295525,295526,0,1,2
84312,4,2,295529,295529,295531,0,2,3
84313,3,2,295532,295532,295534,0,2,1
84314,6,3,295538,295538,295541,0,3,4
84315,6,1,295544,295544,295545,0,1,3
84316,4,1,295548,295548,295549,0,1,3
84317,1,1,295549,295549,295550,0,1,0
84318,6,3,295555,295555,295558,0,3,5
84319,2,2,295557,295558,295560,1,3,0
84320,3,3,295560,295560,295563,0,3,0
84321,4,1,295564,295564,295565,0,1,1
84322,5,1,295569,295569,295570,0,1,4
84323,5,3,295574,295574,295577,0,3,4
84324,5,3,295579,295579,295582,0,3,2
84325,6,1,295585,295585,295586,0,1,3
84326,3,3,295588,295588,295591,0,3,2
84327,4,2,295592,295592,295594,0,2,1
84328,1,3,295593,295594,295597,1,4,0
84329,4,2,295597,295597,295599,0,2,0
84330,2,2,295599,295599,295601,0,2,0
84331,5,1,295604,295604,295605,0,1,3
84332,2,3,295606,295606,295609,0,3,1
84333,2,3,295608,295609,295612,1,4,0
84334,6,2,295614,295614,295616,0,2,2
84335,5,2,295619,295619,295621,0,2,3
84336,1,3,295620,295621,295624,1,4,0
84337,4,1,295624,295624,295625,0,1,0
84338,1,1,295625,295625,295626,0,1,0
84339,2,1,295627,295627,295628,0,1,1
84340,6,2,295633,295633,295635,0,2,5
84341,3,2,295636,295636,295638,0,2,1
84342,2,2,295638,295638,295640,0,2,0
84343,1,1,295639,295640,295641,1,2,0
84344,4,3,295643,295643,295646,0,3,2
84345,1,3,295644,295646,295649,2,5,0
84346,2,3,295646,295649,295652,3,6,0
84347,5,1,295651,295652,295653,1,2,0
84348,1,3,295652,295653,295656,1,4,0
84349,1,2,295653,295656,295658,3,5,0
84350,4,2,295657,295658,295660,1,3,0
84351,2,1,295659,295660,295661,1,2,0
84352,5,1,295664,295664,295665,0,1,3
84353,4,3,295668,295668,295671,0,3,3
84354,2,2,295670,295671,295673,1,3,0
84355,2,3,295672,295673,295676,1,4,0
84356,2,3,295674,295676,295679,2,5,0
84357,4,2,295678,295679,295681,1,3,0
84358,6,1,295684,295684,295685,0,1,3
84359,5,3,295689,295689,295692,0,3,4
84360,5,1,295694,295694,295695,0,1,2
84361,4,3,295698,295698,295701,0,3,3
84362,1,2,295699,295701,295703,2,4,0
84363,1,2,295700,295703,295705,3,5,0
84364,6,2,295706,295706,295708,0,2,1
84365,3,2,295709,295709,295711,0,2,1
84366,3,1,295712,295712,295713,0,1,1
84367,4,3,295716,295716,295719,0,3,3
84368,1,3,295717,295719,295722,2,5,0
84369,1,3,295718,295722,295725,4,7,0
84370,1,1,295719,295725,295726,6,7,0
84371,5,1,295724,295726,295727,2,3,0
84372,6,1,295730,295730,295731,0,1,3
84373,3,2,295733,295733,295735,0,2,2
84374,6,3,295739,295739,295742,0,3,4
84375,3,1,295742,295742,295743,0,1,0
84376,4,1,295746,295746,295747,0,1,3
84377,2,2,295748,295748,295750,0,2,1
84378,1,2,295749,295750,295752,1,3,0
84379,3,2,295752,295752,295754,0,2,0
84380,6,1,295758,295758,295759,0,1,4
84381,6,1,295764,295764,295765,0,1,5
84382,2,2,295766,295766,295768,0,2,1
84383,2,3,295768,295768,295771,0,3,0
84384,1,3,295769,295771,295774,2,5,0
84385,5,2,295774,295774,295776,0,2,0
84386,2,3,295776,295776,295779,0,3,0
84387,5,2,295781,295781,295783,0,2,2
84388,1,1,295782,295783,295784,1,2,0
84389,5,3,295787,295787,295790,0,3,3
84390,4,3,295791,295791,295794,0,3,1
84391,1,2,295792,295794,295796,2,4,0
84392,6,3,295798,295798,295801,0,3,2
84393,4,1,295802,295802,295803,0,1,1
84394,6,1,295808,295808,295809,0,1,5
84395,1,1,295809,295809,295810,0,1,0
84396,2,3,295811,295811,295814,0,3,1
84397,2,2,295813,295814,295816,1,3,0
84398,3,2,295816,295816,295818,0,2,0
84399,4,1,295820,295820,295821,0,1,2
84400,1,2,295821,295821,295823,0,2,0
84401,2,3,295823,295823,295826,0,3,0
84402,4,2,295827,295827,295829,0,2,1
84403,6,3,295833,295833,295836,0,3,4
84404,2,3,295835,295836,295839,1,4,0
84405,6,2,295841,295841,295843,0,2,2
84406,1,2,295842,295843,295845,1,3,0
84407,5,1,295847,295847,295848,0,1,2
84408,3,1,295850,295850,295851,0,1,2
84409,1,1,295851,295851,295852,0,1,0
84410,1,3,295852,295852,295855,0,3,0
84411,3,2,295855,295855,295857,0,2,0
84412,4,1,295859,295859,295860,0,1,2
84413,6,3,295865,295865,295868,0,3,5
84414,5,2,295870,295870,295872,0,2,2
84415,1,3,295871,295872,295875,1,4,0
84416,3,1,295874,295875,295876,1,2,0
84417,5,1,295879,295879,295880,0,1,3
84418,5,2,295884,295884,295886,0,2,4
84419,3,3,295887,295887,295890,0,3,1
84420,2,2,295889,295890,295892,1,3,0
84421,4,1,295893,295893,295894,0,1,1
84422,1,1,295894,295894,295895,0,1,0
84423,1,3,295895,295895,295898,0,3,0
84424,3,3,295898,295898,295901,0,3,0
84425,2,1,295900,295901,295902,1,2,0
84426,4,1,295904,295904,295905,0,1,2
84427,6,1,295910,295910,295911,0,1,5
84428,1,3,295911,295911,295914,0,3,0
84429,6,1,295917,295917,295918,0,1,3
84430,2,1,295919,295919,295920,0,1,1
84431,1,2,295920,295920,295922,0,2,0
84432,5,3,295925,295925,295928,0,3,3
84433,1,3,295926,295928,295931,2,5,0
84434,4,1,295930,295931,295932,1,2,0
84435,2,2,295932,295932,295934,0,2,0
84436,1,1,295933,295934,295935,1,2,0
84437,1,2,295934,295935,295937,1,3,0
84438,2,1,295936,295937,295938,1,2,0
84439,4,1,295940,295940,295941,0,1,2
84440,4,3,295944,295944,295947,0,3,3
84441,1,3,295945,295947,295950,2,5,0
84442,1,2,295946,295950,295952,4,6,0
84443,1,2,295947,295952,295954,5,7,0
84444,3,3,295950,295954,295957,4,7,0
84445,2,2,295952,295957,295959,5,7,0
84446,2,1,295954,295959,295960,5,6,0
84447,2,3,295956,295960,295963,4,7,0
84448,4,1,295960,295963,295964,3,4,0
84449,2,3,295962,295964,295967,2,5,0
84450,6,2,295968,295968,295970,0,2,1
84451,1,3,295969,295970,295973,1,4,0
84452,6,2,295975,295975,295977,0,2,2
84453,6,2,295981,295981,295983,0,2,4
84454,6,1,295987,295987,295988,0,1,4
84455,1,1,295988,295988,295989,0,1,0
84456,1,1,295989,295989,295990,0,1,0
84457,5,1,295994,295994,295995,0,1,4
84458,1,1,295995,295995,295996,0,1,0
84459,2,3,295997,295997,296000,0,3,1
84460,5,1,296002,296002,296003,0,1,2
84461,3,3,296005,296005,296008,0,3,2
84462,2,2,296007,296008,296010,1,3,0
84463,5,2,296012,296012,296014,0,2,2
84464,6,2,296018,296018,296020,0,2,4
84465,2,3,296020,296020,296023,0,3,0
84466,2,3,296022,296023,296026,1,4,0
84467,4,2,296026,296026,296028,0,2,0
84468,3,2,296029,296029,296031,0,2,1
84469,2,2,296031,296031,296033,0,2,0
84470,1,2,296032,296033,296035,1,3,0
84471,4,3,296036,296036,296039,0,3,1
84472,2,3,296038,296039,296042,1,4,0
84473,5,1,296043,296043,296044,0,1,1
84474,6,2,296049,296049,296051,0,2,5
84475,1,3,296050,296051,296054,1,4,0
84476,2,3,296052,296054,296057,2,5,0
84477,6,2,296058,296058,296060,0,2,1
84478,5,3,296063,296063,296066,0,3,3
84479,5,2,296068,296068,296070,0,2,2
84480,5,3,296073,296073,296076,0,3,3
84481,4,2,296077,296077,296079,0,2,1
84482,5,2,296082,296082,296084,0,2,3
84483,3,1,296085,296085,296086,0,1,1
84484,4,1,296089,296089,296090,0,1,3
84485,6,3,296095,296095,296098,0,3,5
84486,4,3,296099,296099,296102,0,3,1
84487,6,3,296105,296105,296108,0,3,3
84488,4,2,296109,296109,296111,0,2,1
84489,1,1,296110,296111,296112,1,2,0
84490,1,1,296111,296112,296113,1,2,0
84491,4,2,296115,296115,296117,0,2,2
84492,1,2,296116,296117,296119,1,3,0
84493,5,3,296121,296121,296124,0,3,2
84494,4,1,296125,296125,296126,0,1,1
84495,5,1,296130,296130,296131,0,1,4
84496,6,3,296136,296136,296139,0,3,5
84497,3,2,296139,296139,296141,0,2,0
84498,6,1,296145,296145,296146,0,1,4
84499,1,3,296146,296146,296149,0,3,0
84500,3,2,296149,296149,296151,0,2,0
84501,6,3,296155,296155,296158,0,3,4
84502,6,1,296161,296161,296162,0,1,3
84503,3,2,296164,296164,296166,0,2,2
84504,6,3,296170,296170,296173,0,3,4
84505,6,1,296176,296176,296177,0,1,3
84506,6,1,296182,296182,296183,0,1,5
84507,1,2,296183,296183,296185,0,2,0
84508,3,3,296186,296186,296189,0,3,1
84509,6,1,296192,296192,296193,0,1,3
84510,2,1,296194,296194,296195,0,1,1
84511,6,2,296200,296200,296202,0,2,5
84512,2,3,296202,296202,296205,0,3,0
84513,6,3,296208,296208,296211,0,3,3
84514,4,3,296212,296212,296215,0,3,1
84515,6,2,296218,296218,296220,0,2,3
84516,3,1,296221,296221,296222,0,1,1
84517,2,2,296223,296223,296225,0,2,1
84518,6,1,296229,296229,296230,0,1,4
84519,3,2,296232,296232,296234,0,2,2
84520,1,2,296233,296234,296236,1,3,0
84521,1,2,296234,296236,296238,2,4,0
84522,2,2,296236,296238,296240,2,4,0
84523,5,2,296241,296241,296243,0,2,1
84524,6,3,296247,296247,296250,0,3,4
84525,2,2,296249,296250,296252,1,3,0
84526,6,1,296255,296255,296256,0,1,3
84527,6,3,296261,296261,296264,0,3,5
84528,5,3,296266,296266,296269,0,3,2
84529,5,2,296271,296271,296273,0,2,2
84530,3,2,296274,296274,296276,0,2,1
84531,4,1,296278,296278,296279,0,1,2
84532,4,3,296282,296282,296285,0,3,3
84533,4,1,296286,296286,296287,0,1,1
84534,3,1,296289,296289,296290,0,1,2
84535,2,1,296291,296291,296292,0,1,1
84536,2,1,296293,296293,296294,0,1,1
84537,2,2,296295,296295,296297,0,2,1
84538,5,2,296300,296300,296302,0,2,3
84539,4,3,296304,296304,296307,0,3,2
84540,1,3,296305,296307,296310,2,5,0
84541,4,3,296309,296310,296313,1,4,0
84542,4,3,296313,296313,296316,0,3,0
84543,3,3,296316,296316,296319,0,3,0
84544,1,2,296317,296319,296321,2,4,0
84545,4,3,296321,296321,296324,0,3,0
84546,1,2,296322,296324,296326,2,4,0
84547,1,2,296323,296326,296328,3,5,0
84548,5,1,296328,296328,296329,0,1,0
84549,4,3,296332,296332,296335,0,3,3
84550,6,3,296338,296338,296341,0,3,3
84551,2,3,296340,296341,296344,1,4,0
84552,2,3,296342,296344,296347,2,5,0
84553,5,1,296347,296347,296348,0,1,0
84554,4,2,296351,296351,296353,0,2,3
84555,2,3,296353,296353,296356,0,3,0
84556,3,1,296356,296356,296357,0,1,0
84557,2,2,296358,296358,296360,0,2,1
84558,4,3,296362,296362,296365,0,3,2
84559,4,3,296366,296366,296369,0,3,1
84560,6,2,296372,296372,296374,0,2,3
84561,6,1,296378,296378,296379,0,1,4
84562,1,3,296379,296379,296382,0,3,0
84563,6,3,296385,296385,296388,0,3,3
84564,3,1,296388,296388,296389,0,1,0
84565,3,1,296391,296391,296392,0,1,2
84566,6,1,296397,296397,296398,0,1,5
84567,4,2,296401,296401,296403,0,2,3
84568,5,1,296406,296406,296407,0,1,3
84569,5,3,296411,296411,296414,0,3,4
84570,5,3,296416,296416,296419,0,3,2
84571,3,2,296419,296419,296421,0,2,0
84572,3,3,296422,296422,296425,0,3,1
84573,1,1,296423,296425,296426,2,3,0
84574,1,2,296424,296426,296428,2,4,0
84575,6,3,296430,296430,296433,0,3,2
84576,1,2,296431,296433,296435,2,4,0
84577,3,2,296434,296435,296437,1,3,0
84578,3,1,296437,296437,296438,0,1,0
84579,5,1,296442,296442,296443,0,1,4
84580,4,3,296446,296446,296449,0,3,3
84581,2,1,296448,296449,296450,1,2,0
84582,2,1,296450,296450,296451,0,1,0
84583,3,1,296453,296453,296454,0,1,2
84584,6,3,296459,296459,296462,0,3,5
84585,1,1,296460,296462,296463,2,3,0
84586,2,3,296462,296463,296466,1,4,0
84587,4,2,296466,296466,296468,0,2,0
84588,6,3,296472,296472,296475,0,3,4
84589,4,3,296476,296476,296479,0,3,1
84590,4,3,296480,296480,296483,0,3,1
84591,2,1,296482,296483,296484,1,2,0
84592,6,3,296488,296488,296491,0,3,4
84593,1,3,296489,296491,296494,2,5,0
84594,5,3,296494,296494,296497,0,3,0
84595,4,3,296498,296498,296501,0,3,1
84596,2,2,296500,296501,296503,1,3,0
84597,2,3,296502,296503,296506,1,4,0
84598,1,1,296503,296506,296507,3,4,0
84599,2,2,296505,296507,296509,2,4,0
84600,5,2,296510,296510,296512,0,2,1
84601,5,1,296515,296515,296516,0,1,3
84602,4,3,296519,296519,296522,0,3,3
84603,1,2,296520,296522,296524,2,4,0
84604,6,3,296526,296526,296529,0,3,2
84605,5,1,296531,296531,296532,0,1,2
84606,1,3,296532,296532,296535,0,3,0
84607,3,3,296535,296535,296538,0,3,0
84608,6,1,296541,296541,296542,0,1,3
84609,2,3,296543,296543,296546,0,3,1
84610,2,2,296545,296546,296548,1,3,0
84611,4,2,296549,296549,296551,0,2,1
84612,6,2,296555,296555,296557,0,2,4
84613,1,2,296556,296557,296559,1,3,0
84614,6,1,296562,296562,296563,0,1,3
84615,4,1,296566,296566,296567,0,1,3
84616,4,2,296570,296570,296572,0,2,3
84617,5,2,296575,296575,296577,0,2,3
84618,6,1,296581,296581,296582,0,1,4
84619,6,3,296587,296587,296590,0,3,5
84620,3,3,296590,296590,296593,0,3,0
84621,4,3,296594,296594,296597,0,3,1
84622,6,2,296600,296600,296602,0,2,3
84623,6,3,296606,296606,296609,0,3,4
84624,5,1,296611,296611,296612,0,1,2
84625,6,1,296617,296617,296618,0,1,5
84626,6,1,296623,296623,296624,0,1,5
84627,6,1,296629,296629,296630,0,1,5
84628,3,3,296632,296632,296635,0,3,2
84629,6,2,296638,296638,296640,0,2,3
84630,5,1,296643,296643,296644,0,1,3
84631,5,3,296648,296648,296651,0,3,4
84632,4,3,296652,296652,296655,0,3,1
84633,5,3,296657,296657,296660,0,3,2
84634,1,2,296658,296660,296662,2,4,0
84635,4,3,296662,296662,296665,0,3,0
84636,1,1,296663,296665,296666,2,3,0
84637,3,3,296666,296666,296669,0,3,0
84638,4,2,296670,296670,296672,0,2,1
84639,4,3,296674,296674,296677,0,3,2
84640,4,1,296678,296678,296679,0,1,1
84641,2,2,296680,296680,296682,0,2,1
84642,2,1,296682,296682,296683,0,1,0
84643,6,3,296688,296688,296691,0,3,5
84644,2,1,296690,296691,296692,1,2,0
84645,4,3,296694,296694,296697,0,3,2
84646,1,1,296695,296697,296698,2,3,0
84647,3,3,296698,296698,296701,0,3,0
84648,4,1,296702,296702,296703,0,1,1
84649,2,2,296704,296704,296706,0,2,1
84650,6,1,296710,296710,296711,0,1,4
84651,5,3,296715,296715,296718,0,3,4
84652,1,2,296716,296718,296720,2,4,0
84653,6,2,296722,296722,296724,0,2,2
84654,5,3,296727,296727,296730,0,3,3
84655,2,1,296729,296730,296731,1,2,0
84656,1,3,296730,296731,296734,1,4,0
84657,5,2,296735,296735,296737,0,2,1
84658,3,2,296738,296738,296740,0,2,1
84659,5,2,296743,296743,296745,0,2,3
84660,1,2,296744,296745,296747,1,3,0
84661,6,2,296750,296750,296752,0,2,3
84662,3,2,296753,296753,296755,0,2,1
84663,4,2,296757,296757,296759,0,2,2
84664,6,2,296763,296763,296765,0,2,4
84665,6,1,296769,296769,296770,0,1,4
84666,5,1,296774,296774,296775,0,1,4
84667,6,1,296780,296780,296781,0,1,5
84668,5,1,296785,296785,296786,0,1,4
84669,3,2,296788,296788,296790,0,2,2
84670,5,3,296793,296793,296796,0,3,3
84671,3,1,296796,296796,296797,0,1,0
84672,1,2,296797,296797,296799,0,2,0
84673,6,2,296803,296803,296805,0,2,4
84674,1,2,296804,296805,296807,1,3,0
84675,3,3,296807,296807,296810,0,3,0
84676,4,3,296811,296811,296814,0,3,1
84677,4,2,296815,296815,296817,0,2,1
84678,1,2,296816,296817,296819,1,3,0
84679,3,2,296819,296819,296821,0,2,0
84680,6,3,296825,296825,296828,0,3,4
84681,2,3,296827,296828,296831,1,4,0
84682,2,3,296829,296831,296834,2,5,0
84683,1,2,296830,296834,296836,4,6,0
84684,4,1,296834,296836,296837,2,3,0
84685,1,1,296835,296837,296838,2,3,0
84686,2,1,296837,296838,296839,1,2,0
84687,5,2,296842,296842,296844,0,2,3
84688,1,2,296843,296844,296846,1,3,0
84689,6,3,296849,296849,296852,0,3,3
84690,2,3,296851,296852,296855,1,4,0
84691,1,3,296852,296855,296858,3,6,0
84692,4,2,296856,296858,296860,2,4,0
84693,5,2,296861,296861,296863,0,2,1
84694,5,2,296866,296866,296868,0,2,3
84695,2,3,296868,296868,296871,0,3,0
84696,3,1,296871,296871,296872,0,1,0
84697,5,3,296876,296876,296879,0,3,4
84698,6,3,296882,296882,296885,0,3,3
84699,5,2,296887,296887,296889,0,2,2
84700,4,3,296891,296891,296894,0,3,2
84701,5,1,296896,296896,296897,0,1,2
84702,3,1,296899,296899,296900,0,1,2
84703,1,1,296900,296900,296901,0,1,0
84704,3,2,296903,296903,296905,0,2,2
84705,6,1,296909,296909,296910,0,1,4
84706,6,2,296915,296915,296917,0,2,5
84707,3,3,296918,296918,296921,0,3,1
84708,5,2,296923,296923,296925,0,2,2
84709,1,2,296924,296925,296927,1,3,0
84710,2,2,296926,296927,296929,1,3,0
84711,5,3,296931,296931,296934,0,3,2
84712,1,2,296932,296934,296936,2,4,0
84713,6,1,296938,296938,296939,0,1,2
84714,4,1,296942,296942,296943,0,1,3
84715,4,1,296946,296946,296947,0,1,3
84716,2,2,296948,296948,296950,0,2,1
84717,5,1,296953,296953,296954,0,1,3
84718,5,2,296958,296958,296960,0,2,4
84719,5,1,296963,296963,296964,0,1,3
84720,6,1,296969,296969,296970,0,1,5
84721,3,2,296972,296972,296974,0,2,2
84722,6,1,296978,296978,296979,0,1,4
84723,6,1,296984,296984,296985,0,1,5
84724,6,3,296990,296990,296993,0,3,5
84725,5,2,296995,296995,296997,0,2,2
84726,5,3,297000,297000,297003,0,3,3
84727,6,2,297006,297006,297008,0,2,3
84728,4,3,297010,297010,297013,0,3,2
84729,2,1,297012,297013,297014,1,2,0
84730,2,3,297014,297014,297017,0,3,0
84731,6,2,297020,297020,297022,0,2,3
84732,5,1,297025,297025,297026,0,1,3
84733,1,3,297026,297026,297029,0,3,0
84734,6,3,297032,297032,297035,0,3,3
84735,5,2,297037,297037,297039,0,2,2
84736,4,1,297041,297041,297042,0,1,2
84737,2,2,297043,297043,297045,0,2,1
84738,2,2,297045,297045,297047,0,2,0
84739,1,3,297046,297047,297050,1,4,0
84740,5,3,297051,297051,297054,0,3,1
84741,5,3,297056,297056,297059,0,3,2
84742,4,3,297060,297060,297063,0,3,1
84743,3,2,297063,297063,297065,0,2,0
84744,5,3,297068,297068,297071,0,3,3
84745,1,3,297069,297071,297074,2,5,0
84746,6,1,297075,297075,297076,0,1,1
84747,5,3,297080,297080,297083,0,3,4
84748,1,2,297081,297083,297085,2,4,0
84749,3,3,297084,297085,297088,1,4,0
84750,6,2,297090,297090,297092,0,2,2
84751,2,1,297092,297092,297093,0,1,0
84752,3,2,297095,297095,297097,0,2,2
84753,2,2,297097,297097,297099,0,2,0
84754,2,3,297099,297099,297102,0,3,0
84755,5,2,297104,297104,297106,0,2,2
84756,1,1,297105,297106,297107,1,2,0
84757,4,3,297109,297109,297112,0,3,2
84758,2,1,297111,297112,297113,1,2,0
84759,2,3,297113,297113,297116,0,3,0
84760,2,2,297115,297116,297118,1,3,0
84761,5,2,297120,297120,297122,0,2,2
84762,5,2,297125,297125,297127,0,2,3
84763,6,3,297131,297131,297134,0,3,4
84764,1,2,297132,297134,297136,2,4,0
84765,6,1,297138,297138,297139,0,1,2
84766,3,2,297141,297141,297143,0,2,2
84767,3,3,297144,297144,297147,0,3,1
84768,2,1,297146,297147,297148,1,2,0
84769,4,2,297150,297150,297152,0,2,2
84770,5,1,297155,297155,297156,0,1,3
84771,4,3,297159,297159,297162,0,3,3
84772,3,3,297162,297162,297165,0,3,0
84773,6,2,297168,297168,297170,0,2,3
84774,3,1,297171,297171,297172,0,1,1
84775,6,2,297177,297177,297179,0,2,5
84776,2,3,297179,297179,297182,0,3,0
84777,2,1,297181,297182,297183,1,2,0
84778,6,3,297187,297187,297190,0,3,4
84779,3,3,297190,297190,297193,0,3,0
84780,6,1,297196,297196,297197,0,1,3
84781,6,1,297202,297202,297203,0,1,5
84782,2,2,297204,297204,297206,0,2,1
84783,4,2,297208,297208,297210,0,2,2
84784,6,3,297214,297214,297217,0,3,4
84785,2,2,297216,297217,297219,1,3,0
84786,5,1,297221,297221,297222,0,1,2
84787,5,2,297226,297226,297228,0,2,4
84788,6,3,297232,297232,297235,0,3,4
84789,1,3,297233,297235,297238,2,5,0
84790,5,1,297238,297238,297239,0,1,0
84791,2,1,297240,297240,297241,0,1,1
84792,1,2,297241,297241,297243,0,2,0
84793,3,3,297244,297244,297247,0,3,1
84794,2,3,297246,297247,297250,1,4,0
84795,6,1,297252,297252,297253,0,1,2
84796,4,2,297256,297256,297258,0,2,3
84797,3,3,297259,297259,297262,0,3,1
84798,6,3,297265,297265,297268,0,3,3
84799,4,1,297269,297269,297270,0,1,1
84800,4,1,297273,297273,297274,0,1,3
84801,1,3,297274,297274,297277,0,3,0
84802,5,1,297279,297279,297280,0,1,2
84803,3,1,297282,297282,297283,0,1,2
84804,5,3,297287,297287,297290,0,3,4
84805,4,3,297291,297291,297294,0,3,1
84806,2,3,297293,297294,297297,1,4,0
84807,6,1,297299,297299,297300,0,1,2
84808,5,3,297304,297304,297307,0,3,4
84809,2,3,297306,297307,297310,1,4,0
84810,2,1,297308,297310,297311,2,3,0
84811,1,3,297309,297311,297314,2,5,0
84812,5,1,297314,297314,297315,0,1,0
84813,5,2,297319,297319,297321,0,2,4
84814,6,1,297325,297325,297326,0,1,4
84815,2,3,297327,297327,297330,0,3,1
84816,3,3,297330,297330,297333,0,3,0
84817,5,2,297335,297335,297337,0,2,2
84818,5,2,297340,297340,297342,0,2,3
84819,1,2,297341,297342,297344,1,3,0
84820,6,3,297347,297347,297350,0,3,3
84821,1,1,297348,297350,297351,2,3,0
84822,2,3,297350,297351,297354,1,4,0
84823,3,3,297353,297354,297357,1,4,0
84824,5,1,297358,297358,297359,0,1,1
84825,4,1,297362,297362,297363,0,1,3
84826,3,1,297365,297365,297366,0,1,2
84827,4,2,297369,297369,297371,0,2,3
84828,3,3,297372,297372,297375,0,3,1
84829,6,1,297378,297378,297379,0,1,3
84830,6,3,297384,297384,297387,0,3,5
84831,2,2,297386,297387,297389,1,3,0
84832,2,1,297388,297389,297390,1,2,0
84833,1,3,297389,297390,297393,1,4,0
84834,6,3,297395,297395,297398,0,3,2
84835,2,2,297397,297398,297400,1,3,0
84836,4,2,297401,297401,297403,0,2,1
84837,5,2,297406,297406,297408,0,2,3
84838,3,3,297409,297409,297412,0,3,1
84839,3,3,297412,297412,297415,0,3,0
84840,5,1,297417,297417,297418,0,1,2
84841,5,2,297422,297422,297424,0,2,4
84842,1,3,297423,297424,297427,1,4,0
84843,4,3,297427,297427,297430,0,3,0
84844,4,3,297431,297431,297434,0,3,1
84845,2,1,297433,297434,297435,1,2,0
84846,4,2,297437,297437,297439,0,2,2
84847,6,3,297443,297443,297446,0,3,4
84848,2,2,297445,297446,297448,1,3,0
84849,5,1,297450,297450,297451,0,1,2
84850,1,2,297451,297451,297453,0,2,0
84851,2,2,297453,297453,297455,0,2,0
84852,4,3,297457,297457,297460,0,3,2
84853,1,3,297458,297460,297463,2,5,0
84854,1,2,297459,297463,297465,4,6,0
84855,1,2,297460,297465,297467,5,7,0
84856,6,1,297466,297467,297468,1,2,0
84857,1,3,297467,297468,297471,1,4,0
84858,3,1,297470,297471,297472,1,2,0
84859,1,1,297471,297472,297473,1,2,0
84860,4,2,297475,297475,297477,0,2,2
84861,3,2,297478,297478,297480,0,2,1
84862,5,2,297483,297483,297485,0,2,3
84863,1,1,297484,297485,297486,1,2,0
84864,6,3,297490,297490,297493,0,3,4
84865,1,2,297491,297493,297495,2,4,0
84866,6,2,297497,297497,297499,0,2,2
84867,6,1,297503,297503,297504,0,1,4
84868,4,1,297507,297507,297508,0,1,3
84869,6,3,297513,297513,297516,0,3,5
84870,6,2,297519,297519,297521,0,2,3
84871,6,3,297525,297525,297528,0,3,4
84872,6,1,297531,297531,297532,0,1,3
84873,6,2,297537,297537,297539,0,2,5
84874,4,2,297541,297541,297543,0,2,2
84875,3,2,297544,297544,297546,0,2,1
84876,6,2,297550,297550,297552,0,2,4
84877,2,2,297552,297552,297554,0,2,0
84878,2,3,297554,297554,297557,0,3,0
84879,5,1,297559,297559,297560,0,1,2
84880,2,1,297561,297561,297562,0,1,1
84881,5,3,297566,297566,297569,0,3,4
84882,6,1,297572,297572,297573,0,1,3
84883,6,1,297578,297578,297579,0,1,5
84884,4,3,297582,297582,297585,0,3,3
84885,5,3,297587,297587,297590,0,3,2
84886,4,3,297591,297591,297594,0,3,1
84887,3,2,297594,297594,297596,0,2,0
84888,2,3,297596,297596,297599,0,3,0
84889,3,1,297599,297599,297600,0,1,0
84890,2,3,297601,297601,297604,0,3,1
84891,2,1,297603,297604,297605,1,2,0
84892,1,2,297604,297605,297607,1,3,0
84893,6,3,297610,297610,297613,0,3,3
84894,3,2,297613,297613,297615,0,2,0
84895,3,3,297616,297616,297619,0,3,1
84896,6,1,297622,297622,297623,0,1,3
84897,5,1,297627,297627,297628,0,1,4
84898,1,2,297628,297628,297630,0,2,0
84899,2,3,297630,297630,297633,0,3,0
84900,1,1,297631,297633,297634,2,3,0
84901,5,1,297636,297636,297637,0,1,2
84902,2,2,297638,297638,297640,0,2,1
84903,6,2,297644,297644,297646,0,2,4
84904,2,1,297646,297646,297647,0,1,0
84905,4,2,297650,297650,297652,0,2,3
84906,4,3,297654,297654,297657,0,3,2
84907,6,1,297660,297660,297661,0,1,3
84908,1,3,297661,297661,297664,0,3,0
84909,4,1,297665,297665,297666,0,1,1
84910,4,2,297669,297669,297671,0,2,3
84911,4,1,297673,297673,297674,0,1,2
84912,4,1,297677,297677,297678,0,1,3
84913,2,1,297679,297679,297680,0,1,1
84914,5,2,297684,297684,297686,0,2,4
84915,6,2,297690,297690,297692,0,2,4
84916,4,1,297694,297694,297695,0,1,2
84917,2,1,297696,297696,297697,0,1,1
84918,1,3,297697,297697,297700,0,3,0
84919,3,3,297700,297700,297703,0,3,0
84920,4,2,297704,297704,297706,0,2,1
84921,6,2,297710,297710,297712,0,2,4
84922,3,3,297713,297713,297716,0,3,1
84923,5,3,297718,297718,297721,0,3,2
84924,1,2,297719,297721,297723,2,4,0
84925,5,3,297724,297724,297727,0,3,1
84926,1,2,297725,297727,297729,2,4,0
84927,1,3,297726,297729,297732,3,6,0
84928,3,1,297729,297732,297733,3,4,0
84929,4,3,297733,297733,297736,0,3,0
84930,6,2,297739,297739,297741,0,2,3
84931,1,2,297740,297741,297743,1,3,0
84932,5,2,297745,297745,297747,0,2,2
84933,6,3,297751,297751,297754,0,3,4
84934,5,3,297756,297756,297759,0,3,2
84935,3,3,297759,297759,297762,0,3,0
84936,6,3,297765,297765,297768,0,3,3
84937,1,1,297766,297768,297769,2,3,0
84938,2,2,297768,297769,297771,1,3,0
84939,6,3,297774,297774,297777,0,3,3
84940,1,2,297775,297777,297779,2,4,0
84941,3,1,297778,297779,297780,1,2,0
84942,1,1,297779,297780,297781,1,2,0
84943,5,2,297784,297784,297786,0,2,3
84944,1,1,297785,297786,297787,1,2,0
84945,5,3,297790,297790,297793,0,3,3
84946,1,2,297791,297793,297795,2,4,0
84947,2,2,297793,297795,297797,2,4,0
84948,4,1,297797,297797,297798,0,1,0
84949,2,3,297799,297799,297802,0,3,1
84950,1,1,297800,297802,297803,2,3,0
84951,4,1,297804,297804,297805,0,1,1
84952,3,1,297807,297807,297808,0,1,2
84953,2,2,297809,297809,297811,0,2,1
84954,1,2,297810,297811,297813,1,3,0
84955,1,2,297811,297813,297815,2,4,0
84956,3,2,297814,297815,297817,1,3,0
84957,2,2,297816,297817,297819,1,3,0
84958,1,1,297817,297819,297820,2,3,0
84959,4,3,297821,297821,297824,0,3,1
84960,3,2,297824,297824,297826,0,2,0
84961,5,2,297829,297829,297831,0,2,3
84962,5,2,297834,297834,297836,0,2,3
84963,3,2,297837,297837,297839,0,2,1
84964,2,3,297839,297839,297842,0,3,0
84965,2,2,297841,297842,297844,1,3,0
84966,1,3,297842,297844,297847,2,5,0
84967,2,3,297844,297847,297850,3,6,0
84968,1,2,297845,297850,297852,5,7,0
84969,4,2,297849,297852,297854,3,5,0
84970,3,3,297852,297854,297857,2,5,0
84971,4,2,297856,297857,297859,1,3,0
84972,3,3,297859,297859,297862,0,3,0
84973,6,3,297865,297865,297868,0,3,3
84974,4,3,297869,297869,297872,0,3,1
84975,4,3,297873,297873,297876,0,3,1
84976,2,3,297875,297876,297879,1,4,0
84977,5,1,297880,297880,297881,0,1,1
84978,6,3,297886,297886,297889,0,3,5
84979,3,3,297889,297889,297892,0,3,0
84980,5,3,297894,297894,297897,0,3,2
84981,5,3,297899,297899,297902,0,3,2
84982,5,2,297904,297904,297906,0,2,2
84983,6,3,297910,297910,297913,0,3,4
84984,4,1,297914,297914,297915,0,1,1
84985,3,1,297917,297917,297918,0,1,2
84986,5,1,297922,297922,297923,0,1,4
84987,4,3,297926,297926,297929,0,3,3
84988,3,1,297929,297929,297930,0,1,0
84989,4,3,297933,297933,297936,0,3,3
84990,5,1,297938,297938,297939,0,1,2
84991,2,3,297940,297940,297943,0,3,1
84992,1,3,297941,297943,297946,2,5,0
84993,2,3,297943,297946,297949,3,6,0
84994,6,1,297949,297949,297950,0,1,0
84995,4,1,297953,297953,297954,0,1,3
84996,4,2,297957,297957,297959,0,2,3
84997,6,3,297963,297963,297966,0,3,4
84998,5,3,297968,297968,297971,0,3,2
84999,3,1,297971,297971,297972,0,1,0
85000,6,2,297977,297977,297979,0,2,5
85001,1,3,297978,297979,297982,1,4,0
85002,2,1,297980,297982,297983,2,3,0
85003,5,2,297985,297985,297987,0,2,2
85004,5,3,297990,297990,297993,0,3,3
85005,1,1,297991,297993,297994,2,3,0
85006,3,3,297994,297994,297997,0,3,0
85007,3,2,297997,297997,297999,0,2,0
85008,1,2,297998,297999,298001,1,3,0
85009,4,1,298002,298002,298003,0,1,1
85010,4,3,298006,298006,298009,0,3,3
85011,5,1,298011,298011,298012,0,1,2
85012,5,2,298016,298016,298018,0,2,4
85013,2,2,298018,298018,298020,0,2,0
85014,5,1,298023,298023,298024,0,1,3
85015,1,3,298024,298024,298027,0,3,0
85016,6,3,298030,298030,298033,0,3,3
85017,3,1,298033,298033,298034,0,1,0
85018,4,3,298037,298037,298040,0,3,3
85019,2,2,298039,298040,298042,1,3,0
85020,1,2,298040,298042,298044,2,4,0
85021,3,1,298043,298044,298045,1,2,0
85022,6,1,298049,298049,298050,0,1,4
85023,5,1,298054,298054,298055,0,1,4
85024,2,1,298056,298056,298057,0,1,1
85025,6,2,298062,298062,298064,0,2,5
85026,1,1,298063,298064,298065,1,2,0
85027,1,3,298064,298065,298068,1,4,0
85028,2,2,298066,298068,298070,2,4,0
85029,4,2,298070,298070,298072,0,2,0
85030,1,3,298071,298072,298075,1,4,0
85031,4,1,298075,298075,298076,0,1,0
85032,6,1,298081,298081,298082,0,1,5
85033,5,3,298086,298086,298089,0,3,4
85034,1,1,298087,298089,298090,2,3,0
85035,5,3,298092,298092,298095,0,3,2
85036,3,3,298095,298095,298098,0,3,0
85037,4,3,298099,298099,298102,0,3,1
85038,3,1,298102,298102,298103,0,1,0
85039,3,1,298105,298105,298106,0,1,2
85040,3,2,298108,298108,298110,0,2,2
85041,4,3,298112,298112,298115,0,3,2
85042,1,3,298113,298115,298118,2,5,0
85043,4,2,298117,298118,298120,1,3,0
85044,2,3,298119,298120,298123,1,4,0
85045,6,2,298125,298125,298127,0,2,2
85046,6,2,298131,298131,298133,0,2,4
85047,5,2,298136,298136,298138,0,2,3
85048,4,1,298140,298140,298141,0,1,2
85049,3,1,298143,298143,298144,0,1,2
85050,5,3,298148,298148,298151,0,3,4
85051,2,3,298150,298151,298154,1,4,0
85052,2,1,298152,298154,298155,2,3,0
85053,4,2,298156,298156,298158,0,2,1
85054,4,2,298160,298160,298162,0,2,2
85055,6,1,298166,298166,298167,0,1,4
85056,3,3,298169,298169,298172,0,3,2
85057,3,1,298172,298172,298173,0,1,0
85058,6,3,298178,298178,298181,0,3,5
85059,6,1,298184,298184,298185,0,1,3
85060,6,1,298190,298190,298191,0,1,5
85061,2,1,298192,298192,298193,0,1,1
85062,2,1,298194,298194,298195,0,1,1
85063,3,2,298197,298197,298199,0,2,2
85064,3,1,298200,298200,298201,0,1,1
85065,1,1,298201,298201,298202,0,1,0
85066,3,3,298204,298204,298207,0,3,2
85067,6,1,298210,298210,298211,0,1,3
85068,2,3,298212,298212,298215,0,3,1
85069,2,3,298214,298215,298218,1,4,0
85070,5,3,298219,298219,298222,0,3,1
85071,2,3,298221,298222,298225,1,4,0
85072,1,2,298222,298225,298227,3,5,0
85073,5,2,298227,298227,298229,0,2,0
85074,1,1,298228,298229,298230,1,2,0
85075,5,2,298233,298233,298235,0,2,3
85076,2,1,298235,298235,298236,0,1,0
85077,1,2,298236,298236,298238,0,2,0
85078,3,3,298239,298239,298242,0,3,1
85079,4,3,298243,298243,298246,0,3,1
85080,6,2,298249,298249,298251,0,2,3
85081,6,2,298255,298255,298257,0,2,4
85082,5,1,298260,298260,298261,0,1,3
85083,5,1,298265,298265,298266,0,1,4
85084,2,2,298267,298267,298269,0,2,1
85085,1,3,298268,298269,298272,1,4,0
85086,1,3,298269,298272,298275,3,6,0
85087,1,1,298270,298275,298276,5,6,0
85088,1,3,298271,298276,298279,5,8,0
85089,3,3,298274,298279,298282,5,8,0
85090,2,3,298276,298282,298285,6,9,0
85091,1,1,298277,298285,298286,8,9,0
85092,1,3,298278,298286,298289,8,11,0
85093,4,2,298282,298289,298291,7,9,0
85094,2,1,298284,298291,298292,7,8,0
85095,6,3,298290,298292,298295,2,5,0
85096,6,3,298296,298296,298299,0,3,1
85097,5,2,298301,298301,298303,0,2,2
85098,5,2,298306,298306,298308,0,2,3
85099,3,2,298309,298309,298311,0,2,1
85100,3,3,298312,298312,298315,0,3,1
85101,4,3,298316,298316,298319,0,3,1
85102,2,1,298318,298319,298320,1,2,0
85103,1,3,298319,298320,298323,1,4,0
85104,5,1,298324,298324,298325,0,1,1
85105,1,3,298325,298325,298328,0,3,0
85106,3,2,298328,298328,298330,0,2,0
85107,2,2,298330,298330,298332,0,2,0
85108,3,1,298333,298333,298334,0,1,1
85109,5,3,298338,298338,298341,0,3,4
85110,6,2,298344,298344,298346,0,2,3
85111,1,2,298345,298346,298348,1,3,0
85112,1,1,298346,298348,298349,2,3,0
85113,2,1,298348,298349,298350,1,2,0
85114,1,2,298349,298350,298352,1,3,0
85115,4,3,298353,298353,298356,0,3,1
85116,5,1,298358,298358,298359,0,1,2
85117,3,1,298361,298361,298362,0,1,2
85118,6,3,298367,298367,298370,0,3,5
85119,1,2,298368,298370,298372,2,4,0
85120,1,2,298369,298372,298374,3,5,0
85121,1,2,298370,298374,298376,4,6,0
85122,3,3,298373,298376,298379,3,6,0
85123,2,3,298375,298379,298382,4,7,0
85124,6,2,298381,298382,298384,1,3,0
85125,3,1,298384,298384,298385,0,1,0
85126,4,1,298388,298388,298389,0,1,3
85127,1,1,298389,298389,298390,0,1,0
85128,2,3,298391,298391,298394,0,3,1
85129,2,2,298393,298394,298396,1,3,0
85130,3,3,298396,298396,298399,0,3,0
85131,5,2,298401,298401,298403,0,2,2
85132,3,3,298404,298404,298407,0,3,1
85133,3,3,298407,298407,298410,0,3,0
85134,1,3,298408,298410,298413,2,5,0
85135,1,1,298409,298413,298414,4,5,0
85136,4,2,298413,298414,298416,1,3,0
85137,6,1,298419,298419,298420,0,1,3
85138,1,3,298420,298420,298423,0,3,0
85139,2,3,298422,298423,298426,1,4,0
85140,3,2,298425,298426,298428,1,3,0
85141,6,2,298431,298431,298433,0,2,3
85142,2,2,298433,298433,298435,0,2,0
85143,4,1,298437,298437,298438,0,1,2
85144,4,2,298441,298441,298443,0,2,3
85145,3,3,298444,298444,298447,0,3,1
85146,5,1,298449,298449,298450,0,1,2
85147,6,3,298455,298455,298458,0,3,5
85148,1,3,298456,298458,298461,2,5,0
85149,4,3,298460,298461,298464,1,4,0
85150,3,2,298463,298464,298466,1,3,0
85151,6,3,298469,298469,298472,0,3,3
85152,4,1,298473,298473,298474,0,1,1
85153,1,3,298474,298474,298477,0,3,0
85154,2,3,298476,298477,298480,1,4,0
85155,1,3,298477,298480,298483,3,6,0
85156,1,3,298478,298483,298486,5,8,0
85157,2,2,298480,298486,298488,6,8,0
85158,1,2,298481,298488,298490,7,9,0
85159,5,3,298486,298490,298493,4,7,0
85160,4,1,298490,298493,298494,3,4,0
85161,6,1,298496,298496,298497,0,1,2
85162,5,2,298501,298501,298503,0,2,4
85163,6,1,298507,298507,298508,0,1,4
85164,1,1,298508,298508,298509,0,1,0
85165,2,3,298510,298510,298513,0,3,1
85166,3,1,298513,298513,298514,0,1,0
85167,5,2,298518,298518,298520,0,2,4
85168,2,1,298520,298520,298521,0,1,0
85169,1,2,298521,298521,298523,0,2,0
85170,6,1,298527,298527,298528,0,1,4
85171,6,3,298533,298533,298536,0,3,5
85172,1,1,298534,298536,298537,2,3,0
85173,6,3,298540,298540,298543,0,3,3
85174,1,3,298541,298543,298546,2,5,0
85175,1,3,298542,298546,298549,4,7,0
85176,6,1,298548,298549,298550,1,2,0
85177,6,3,298554,298554,298557,0,3,4
85178,3,3,298557,298557,298560,0,3,0
85179,5,3,298562,298562,298565,0,3,2
85180,2,2,298564,298565,298567,1,3,0
85181,2,1,298566,298567,298568,1,2,0
85182,1,3,298567,298568,298571,1,4,0
85183,2,1,298569,298571,298572,2,3,0
85184,3,1,298572,298572,298573,0,1,0
85185,4,1,298576,298576,298577,0,1,3
85186,2,3,298578,298578,298581,0,3,1
85187,6,3,298584,298584,298587,0,3,3
85188,3,2,298587,298587,298589,0,2,0
85189,5,1,298592,298592,298593,0,1,3
85190,2,2,298594,298594,298596,0,2,1
85191,6,3,298600,298600,298603,0,3,4
85192,3,2,298603,298603,298605,0,2,0
85193,4,2,298607,298607,298609,0,2,2
85194,1,2,298608,298609,298611,1,3,0
85195,2,3,298610,298611,298614,1,4,0
85196,5,2,298615,298615,298617,0,2,1
85197,1,1,298616,298617,298618,1,2,0
85198,4,3,298620,298620,298623,0,3,2
85199,1,1,298621,298623,298624,2,3,0
85200,4,3,298625,298625,298628,0,3,1
85201,5,1,298630,298630,298631,0,1,2
85202,3,3,298633,298633,298636,0,3,2
85203,5,2,298638,298638,298640,0,2,2
85204,3,1,298641,298641,298642,0,1,1
85205,3,2,298644,298644,298646,0,2,2
85206,6,1,298650,298650,298651,0,1,4
85207,5,1,298655,298655,298656,0,1,4
85208,3,2,298658,298658,298660,0,2,2
85209,3,2,298661,298661,298663,0,2,1
85210,3,1,298664,298664,298665,0,1,1
85211,1,1,298665,298665,298666,0,1,0
85212,2,1,298667,298667,298668,0,1,1
85213,5,3,298672,298672,298675,0,3,4
85214,6,2,298678,298678,298680,0,2,3
85215,1,1,298679,298680,298681,1,2,0
85216,3,1,298682,298682,298683,0,1,1
85217,6,3,298688,298688,298691,0,3,5
85218,5,2,298693,298693,298695,0,2,2
85219,2,2,298695,298695,298697,0,2,0
85220,3,3,298698,298698,298701,0,3,1
85221,1,1,298699,298701,298702,2,3,0
85222,3,1,298702,298702,298703,0,1,0
85223,6,1,298708,298708,298709,0,1,5
85224,6,2,298714,298714,298716,0,2,5
85225,5,3,298719,298719,298722,0,3,3
85226,2,2,298721,298722,298724,1,3,0
85227,4,2,298725,298725,298727,0,2,1
85228,4,1,298729,298729,298730,0,1,2
85229,6,2,298735,298735,298737,0,2,5
85230,1,1,298736,298737,298738,1,2,0
85231,6,1,298742,298742,298743,0,1,4
85232,4,1,298746,298746,298747,0,1,3
85233,5,3,298751,298751,298754,0,3,4
85234,1,1,298752,298754,298755,2,3,0
85235,6,1,298758,298758,298759,0,1,3
85236,6,3,298764,298764,298767,0,3,5
85237,4,2,298768,298768,298770,0,2,1
85238,5,3,298773,298773,298776,0,3,3
85239,6,2,298779,298779,298781,0,2,3
85240,4,1,298783,298783,298784,0,1,2
85241,5,3,298788,298788,298791,0,3,4
85242,5,3,298793,298793,298796,0,3,2
85243,5,3,298798,298798,298801,0,3,2
85244,5,3,298803,298803,298806,0,3,2
85245,6,2,298809,298809,298811,0,2,3
85246,2,2,298811,298811,298813,0,2,0
85247,2,2,298813,298813,298815,0,2,0
85248,3,2,298816,298816,298818,0,2,1
85249,1,1,298817,298818,298819,1,2,0
85250,5,2,298822,298822,298824,0,2,3
85251,3,2,298825,298825,298827,0,2,1
85252,3,1,298828,298828,298829,0,1,1
85253,3,3,298831,298831,298834,0,3,2
85254,5,3,298836,298836,298839,0,3,2
85255,2,3,298838,298839,298842,1,4,0
85256,3,2,298841,298842,298844,1,3,0
85257,5,3,298846,298846,298849,0,3,2
85258,2,3,298848,298849,298852,1,4,0
85259,3,1,298851,298852,298853,1,2,0
85260,1,2,298852,298853,298855,1,3,0
85261,5,2,298857,298857,298859,0,2,2
85262,6,3,298863,298863,298866,0,3,4
85263,3,3,298866,298866,298869,0,3,0
85264,4,2,298870,298870,298872,0,2,1
85265,5,2,298875,298875,298877,0,2,3
85266,2,1,298877,298877,298878,0,1,0
85267,2,2,298879,298879,298881,0,2,1
85268,2,1,298881,298881,298882,0,1,0
85269,5,3,298886,298886,298889,0,3,4
85270,2,2,298888,298889,298891,1,3,0
85271,1,3,298889,298891,298894,2,5,0
85272,2,3,298891,298894,298897,3,6,0
85273,3,3,298894,298897,298900,3,6,0
85274,4,1,298898,298900,298901,2,3,0
85275,1,3,298899,298901,298904,2,5,0
85276,4,1,298903,298904,298905,1,2,0
85277,6,1,298909,298909,298910,0,1,4
85278,4,2,298913,298913,298915,0,2,3
85279,4,2,298917,298917,298919,0,2,2
85280,2,2,298919,298919,298921,0,2,0
85281,4,1,298923,298923,298924,0,1,2
85282,5,1,298928,298928,298929,0,1,4
85283,1,2,298929,298929,298931,0,2,0
85284,5,3,298934,298934,298937,0,3,3
85285,4,1,298938,298938,298939,0,1,1
85286,1,2,298939,298939,298941,0,2,0
85287,3,1,298942,298942,298943,0,1,1
85288,2,3,298944,298944,298947,0,3,1
85289,3,3,298947,298947,298950,0,3,0
85290,5,3,298952,298952,298955,0,3,2
85291,6,2,298958,298958,298960,0,2,3
85292,5,1,298963,298963,298964,0,1,3
85293,4,2,298967,298967,298969,0,2,3
85294,6,2,298973,298973,298975,0,2,4
85295,4,1,298977,298977,298978,0,1,2
85296,4,1,298981,298981,298982,0,1,3
85297,2,1,298983,298983,298984,0,1,1
85298,6,3,298989,298989,298992,0,3,5
85299,5,1,298994,298994,298995,0,1,2
85300,4,1,298998,298998,298999,0,1,3
85301,3,1,299001,299001,299002,0,1,2
85302,1,1,299002,299002,299003,0,1,0
85303,2,3,299004,299004,299007,0,3,1
85304,3,2,299007,299007,299009,0,2,0
85305,4,2,299011,299011,299013,0,2,2
85306,1,2,299012,299013,299015,1,3,0
85307,6,3,299018,299018,299021,0,3,3
85308,3,3,299021,299021,299024,0,3,0
85309,5,3,299026,299026,299029,0,3,2
85310,6,3,299032,299032,299035,0,3,3
85311,5,3,299037,299037,299040,0,3,2
85312,4,3,299041,299041,299044,0,3,1
85313,3,1,299044,299044,299045,0,1,0
85314,5,1,299049,299049,299050,0,1,4
85315,3,1,299052,299052,299053,0,1,2
85316,5,3,299057,299057,299060,0,3,4
85317,3,2,299060,299060,299062,0,2,0
85318,2,1,299062,299062,299063,0,1,0
85319,1,3,299063,299063,299066,0,3,0
85320,2,1,299065,299066,299067,1,2,0
85321,5,1,299070,299070,299071,0,1,3
85322,6,2,299076,299076,299078,0,2,5
85323,3,2,299079,299079,299081,0,2,1
85324,4,3,299083,299083,299086,0,3,2
85325,6,3,299089,299089,299092,0,3,3
85326,6,1,299095,299095,299096,0,1,3
85327,5,2,299100,299100,299102,0,2,4
85328,3,2,299103,299103,299105,0,2,1
85329,5,3,299108,299108,299111,0,3,3
85330,3,3,299111,299111,299114,0,3,0
85331,4,3,299115,299115,299118,0,3,1
85332,6,3,299121,299121,299124,0,3,3
85333,6,3,299127,299127,299130,0,3,3
85334,1,2,299128,299130,299132,2,4,0
85335,4,3,299132,299132,299135,0,3,0
85336,6,2,299138,299138,299140,0,2,3
85337,6,2,299144,299144,299146,0,2,4
85338,6,2,299150,299150,299152,0,2,4
85339,3,2,299153,299153,299155,0,2,1
85340,5,1,299158,299158,299159,0,1,3
85341,3,3,299161,299161,299164,0,3,2
85342,5,1,299166,299166,299167,0,1,2
85343,3,3,299169,299169,299172,0,3,2
85344,1,1,299170,299172,299173,2,3,0
85345,5,2,299175,299175,299177,0,2,2
85346,4,3,299179,299179,299182,0,3,2
85347,1,3,299180,299182,299185,2,5,0
85348,1,2,299181,299185,299187,4,6,0
85349,6,2,299187,299187,299189,0,2,0
85350,2,2,299189,299189,299191,0,2,0
85351,6,3,299195,299195,299198,0,3,4
85352,6,1,299201,299201,299202,0,1,3
85353,3,2,299204,299204,299206,0,2,2
85354,4,2,299208,299208,299210,0,2,2
85355,3,3,299211,299211,299214,0,3,1
85356,6,1,299217,299217,299218,0,1,3
85357,1,1,299218,299218,299219,0,1,0
85358,4,3,299222,299222,299225,0,3,3
85359,5,1,299227,299227,299228,0,1,2
85360,1,1,299228,299228,299229,0,1,0
85361,1,2,299229,299229,299231,0,2,0
85362,4,2,299233,299233,299235,0,2,2
85363,4,3,299237,299237,299240,0,3,2
85364,4,3,299241,299241,299244,0,3,1
85365,4,2,299245,299245,299247,0,2,1
85366,4,1,299249,299249,299250,0,1,2
85367,2,2,299251,299251,299253,0,2,1
85368,3,2,299254,299254,299256,0,2,1
85369,3,3,299257,299257,299260,0,3,1
85370,6,1,299263,299263,299264,0,1,3
85371,6,3,299269,299269,299272,0,3,5
85372,2,2,299271,299272,299274,1,3,0
85373,1,3,299272,299274,299277,2,5,0
85374,5,3,299277,299277,299280,0,3,0
85375,3,2,299280,299280,299282,0,2,0
85376,6,1,299286,299286,299287,0,1,4
85377,4,1,299290,299290,299291,0,1,3
85378,1,3,299291,299291,299294,0,3,0
85379,3,1,299294,299294,299295,0,1,0
85380,6,1,299300,299300,299301,0,1,5
85381,3,2,299303,299303,299305,0,2,2
85382,2,1,299305,299305,299306,0,1,0
85383,4,3,299309,299309,299312,0,3,3
85384,1,1,299310,299312,299313,2,3,0
85385,3,1,299313,299313,299314,0,1,0
85386,2,1,299315,299315,299316,0,1,1
85387,3,1,299318,299318,299319,0,1,2
85388,1,3,299319,299319,299322,0,3,0
85389,5,1,299324,299324,299325,0,1,2
85390,5,1,299329,299329,299330,0,1,4
85391,4,2,299333,299333,299335,0,2,3
85392,2,1,299335,299335,299336,0,1,0
85393,5,2,299340,299340,299342,0,2,4
85394,1,2,299341,299342,299344,1,3,0
85395,2,2,299343,299344,299346,1,3,0
85396,4,3,299347,299347,299350,0,3,1
85397,6,1,299353,299353,299354,0,1,3
85398,2,3,299355,299355,299358,0,3,1
85399,5,1,299360,299360,299361,0,1,2
85400,3,3,299363,299363,299366,0,3,2
85401,6,2,299369,299369,299371,0,2,3
85402,1,3,299370,299371,299374,1,4,0
85403,6,3,299376,299376,299379,0,3,2
85404,5,2,299381,299381,299383,0,2,2
85405,3,1,299384,299384,299385,0,1,1
85406,6,1,299390,299390,299391,0,1,5
85407,5,2,299395,299395,299397,0,2,4
85408,1,2,299396,299397,299399,1,3,0
85409,6,1,299402,299402,299403,0,1,3
85410,6,3,299408,299408,299411,0,3,5
85411,6,2,299414,299414,299416,0,2,3
85412,3,1,299417,299417,299418,0,1,1
85413,6,1,299423,299423,299424,0,1,5
85414,1,1,299424,299424,299425,0,1,0
85415,5,2,299429,299429,299431,0,2,4
85416,1,3,299430,299431,299434,1,4,0
85417,5,1,299435,299435,299436,0,1,1
85418,6,1,299441,299441,299442,0,1,5
85419,4,1,299445,299445,299446,0,1,3
85420,3,2,299448,299448,299450,0,2,2
85421,6,1,299454,299454,299455,0,1,4
85422,3,3,299457,299457,299460,0,3,2
85423,1,2,299458,299460,299462,2,4,0
85424,2,1,299460,299462,299463,2,3,0
85425,2,3,299462,299463,299466,1,4,0
85426,1,2,299463,299466,299468,3,5,0
85427,2,2,299465,299468,299470,3,5,0
85428,2,3,299467,299470,299473,3,6,0
85429,2,3,299469,299473,299476,4,7,0
85430,6,1,299475,299476,299477,1,2,0
85431,5,3,299480,299480,299483,0,3,3
85432,4,2,299484,299484,299486,0,2,1
85433,1,2,299485,299486,299488,1,3,0
85434,2,1,299487,299488,299489,1,2,0
85435,6,1,299493,299493,299494,0,1,4
85436,1,1,299494,299494,299495,0,1,0
85437,6,1,299500,299500,299501,0,1,5
85438,1,3,299501,299501,299504,0,3,0
85439,1,2,299502,299504,299506,2,4,0
85440,2,2,299504,299506,299508,2,4,0
85441,5,3,299509,299509,299512,0,3,1
85442,1,1,299510,299512,299513,2,3,0
85443,5,1,299515,299515,299516,0,1,2
85444,2,1,299517,299517,299518,0,1,1
85445,6,2,299523,299523,299525,0,2,5
85446,1,2,299524,299525,299527,1,3,0
85447,3,1,299527,299527,299528,0,1,0
85448,5,1,299532,299532,299533,0,1,4
85449,6,1,299538,299538,299539,0,1,5
85450,5,1,299543,299543,299544,0,1,4
85451,4,2,299547,299547,299549,0,2,3
85452,4,3,299551,299551,299554,0,3,2
85453,4,3,299555,299555,299558,0,3,1
85454,1,3,299556,299558,299561,2,5,0
85455,5,1,299561,299561,299562,0,1,0
85456,3,3,299564,299564,299567,0,3,2
85457,2,3,299566,299567,299570,1,4,0
85458,3,1,299569,299570,299571,1,2,0
85459,4,1,299573,299573,299574,0,1,2
85460,4,1,299577,299577,299578,0,1,3
85461,4,3,299581,299581,299584,0,3,3
85462,3,1,299584,299584,299585,0,1,0
85463,6,2,299590,299590,299592,0,2,5
85464,4,1,299594,299594,299595,0,1,2
85465,1,3,299595,299595,299598,0,3,0
85466,5,3,299600,299600,299603,0,3,2
85467,2,2,299602,299603,299605,1,3,0
85468,6,1,299608,299608,299609,0,1,3
85469,4,1,299612,299612,299613,0,1,3
85470,6,2,299618,299618,299620,0,2,5
85471,2,2,299620,299620,299622,0,2,0
85472,4,3,299624,299624,299627,0,3,2
85473,2,3,299626,299627,299630,1,4,0
85474,1,1,299627,299630,299631,3,4,0
85475,5,3,299632,299632,299635,0,3,1
85476,4,3,299636,299636,299639,0,3,1
85477,3,1,299639,299639,299640,0,1,0
85478,4,2,299643,299643,299645,0,2,3
85479,5,1,299648,299648,299649,0,1,3
85480,4,2,299652,299652,299654,0,2,3
85481,4,2,299656,299656,299658,0,2,2
85482,1,2,299657,299658,299660,1,3,0
85483,5,3,299662,299662,299665,0,3,2
85484,4,3,299666,299666,299669,0,3,1
85485,3,1,299669,299669,299670,0,1,0
85486,6,2,299675,299675,299677,0,2,5
85487,6,3,299681,299681,299684,0,3,4
85488,5,2,299686,299686,299688,0,2,2
85489,5,2,299691,299691,299693,0,2,3
85490,4,2,299695,299695,299697,0,2,2
85491,3,2,299698,299698,299700,0,2,1
85492,3,3,299701,299701,299704,0,3,1
85493,4,3,299705,299705,299708,0,3,1
85494,3,1,299708,299708,299709,0,1,0
85495,1,2,299709,299709,299711,0,2,0
85496,1,2,299710,299711,299713,1,3,0
85497,5,1,299715,299715,299716,0,1,2
85498,5,2,299720,299720,299722,0,2,4
85499,6,2,299726,299726,299728,0,2,4
85500,3,2,299729,299729,299731,0,2,1
85501,4,1,299733,299733,299734,0,1,2
85502,4,2,299737,299737,299739,0,2,3
85503,1,2,299738,299739,299741,1,3,0
85504,1,1,299739,299741,299742,2,3,0
85505,3,1,299742,299742,299743,0,1,0
85506,5,2,299747,299747,299749,0,2,4
85507,4,1,299751,299751,299752,0,1,2
85508,2,3,299753,299753,299756,0,3,1
85509,3,2,299756,299756,299758,0,2,0
85510,4,2,299760,299760,299762,0,2,2
85511,4,3,299764,299764,299767,0,3,2
85512,5,1,299769,299769,299770,0,1,2
85513,1,2,299770,299770,299772,0,2,0
85514,1,1,299771,299772,299773,1,2,0
85515,4,3,299775,299775,299778,0,3,2
85516,5,1,299780,299780,299781,0,1,2
85517,5,3,299785,299785,299788,0,3,4
85518,5,3,299790,299790,299793,0,3,2
85519,4,3,299794,299794,299797,0,3,1
85520,1,3,299795,299797,299800,2,5,0
85521,6,3,299801,299801,299804,0,3,1
85522,5,3,299806,299806,299809,0,3,2
85523,3,2,299809,299809,299811,0,2,0
85524,1,3,299810,299811,299814,1,4,0
85525,5,1,299815,299815,299816,0,1,1
85526,4,1,299819,299819,299820,0,1,3
85527,1,3,299820,299820,299823,0,3,0
85528,5,1,299825,299825,299826,0,1,2
85529,2,2,299827,299827,299829,0,2,1
85530,1,1,299828,299829,299830,1,2,0
85531,1,3,299829,299830,299833,1,4,0
85532,5,3,299834,299834,299837,0,3,1
85533,4,2,299838,299838,299840,0,2,1
85534,4,1,299842,299842,299843,0,1,2
85535,3,2,299845,299845,299847,0,2,2
85536,2,1,299847,299847,299848,0,1,0
85537,3,3,299850,299850,299853,0,3,2
85538,1,2,299851,299853,299855,2,4,0
85539,1,1,299852,299855,299856,3,4,0
85540,1,3,299853,299856,299859,3,6,0
85541,2,2,299855,299859,299861,4,6,0
85542,5,1,299860,299861,299862,1,2,0
85543,1,2,299861,299862,299864,1,3,0
85544,2,3,299863,299864,299867,1,4,0
85545,1,2,299864,299867,299869,3,5,0
85546,3,2,299867,299869,299871,2,4,0
85547,5,3,299872,299872,299875,0,3,1
85548,2,1,299874,299875,299876,1,2,0
85549,4,1,299878,299878,299879,0,1,2
85550,6,2,299884,299884,299886,0,2,5
85551,5,2,299889,299889,299891,0,2,3
85552,2,3,299891,299891,299894,0,3,0
85553,4,1,299895,299895,299896,0,1,1
85554,6,3,299901,299901,299904,0,3,5
85555,4,3,299905,299905,299908,0,3,1
85556,4,2,299909,299909,299911,0,2,1
85557,3,3,299912,299912,299915,0,3,1
85558,6,3,299918,299918,299921,0,3,3
85559,1,2,299919,299921,299923,2,4,0
85560,3,1,299922,299923,299924,1,2,0
85561,1,1,299923,299924,299925,1,2,0
85562,2,1,299925,299925,299926,0,1,0
85563,4,3,299929,299929,299932,0,3,3
85564,6,2,299935,299935,299937,0,2,3
85565,5,1,299940,299940,299941,0,1,3
85566,5,3,299945,299945,299948,0,3,4
85567,6,2,299951,299951,299953,0,2,3
85568,6,2,299957,299957,299959,0,2,4
85569,2,1,299959,299959,299960,0,1,0
85570,6,2,299965,299965,299967,0,2,5
85571,4,1,299969,299969,299970,0,1,2
85572,5,1,299974,299974,299975,0,1,4
85573,6,1,299980,299980,299981,0,1,5
85574,3,3,299983,299983,299986,0,3,2
85575,5,3,299988,299988,299991,0,3,2
85576,3,1,299991,299991,299992,0,1,0
85577,5,3,299996,299996,299999,0,3,4
85578,6,3,300002,300002,300005,0,3,3
85579,6,2,300008,300008,300010,0,2,3
85580,6,3,300014,300014,300017,0,3,4
85581,1,2,300015,300017,300019,2,4,0
85582,5,2,300020,300020,300022,0,2,1
85583,3,2,300023,300023,300025,0,2,1
85584,5,1,300028,300028,300029,0,1,3
85585,2,2,300030,300030,300032,0,2,1
85586,3,1,300033,300033,300034,0,1,1
85587,3,3,300036,300036,300039,0,3,2
85588,1,1,300037,300039,300040,2,3,0
85589,3,2,300040,300040,300042,0,2,0
85590,1,1,300041,300042,300043,1,2,0
85591,1,1,300042,300043,300044,1,2,0
85592,6,2,300048,300048,300050,0,2,4
85593,2,1,300050,300050,300051,0,1,0
85594,2,1,300052,300052,300053,0,1,1
85595,6,1,300058,300058,300059,0,1,5
85596,3,2,300061,300061,300063,0,2,2
85597,5,3,300066,300066,300069,0,3,3
85598,2,1,300068,300069,300070,1,2,0
85599,5,2,300073,300073,300075,0,2,3
85600,5,2,300078,300078,300080,0,2,3
85601,4,1,300082,300082,300083,0,1,2
85602,5,2,300087,300087,300089,0,2,4
85603,6,2,300093,300093,300095,0,2,4
85604,3,3,300096,300096,300099,0,3,1
85605,3,3,300099,300099,300102,0,3,0
85606,3,3,300102,300102,300105,0,3,0
85607,1,3,300103,300105,300108,2,5,0
85608,2,3,300105,300108,300111,3,6,0
85609,1,3,300106,300111,300114,5,8,0
85610,4,3,300110,300114,300117,4,7,0
85611,1,3,300111,300117,300120,6,9,0
85612,6,3,300117,300120,300123,3,6,0
85613,4,3,300121,300123,300126,2,5,0
85614,5,2,300126,300126,300128,0,2,0
85615,1,2,300127,300128,300130,1,3,0
85616,6,2,300133,300133,300135,0,2,3
85617,6,1,300139,300139,300140,0,1,4
85618,2,3,300141,300141,300144,0,3,1
85619,1,3,300142,300144,300147,2,5,0
85620,4,2,300146,300147,300149,1,3,0
85621,1,1,300147,300149,300150,2,3,0
85622,6,2,300153,300153,300155,0,2,3
85623,2,2,300155,300155,300157,0,2,0
85624,4,2,300159,300159,300161,0,2,2
85625,2,1,300161,300161,300162,0,1,0
85626,1,2,300162,300162,300164,0,2,0
85627,2,3,300164,300164,300167,0,3,0
85628,5,3,300169,300169,300172,0,3,2
85629,3,1,300172,300172,300173,0,1,0
85630,4,1,300176,300176,300177,0,1,3
85631,4,3,300180,300180,300183,0,3,3
85632,2,3,300182,300183,300186,1,4,0
85633,2,2,300184,300186,300188,2,4,0
85634,2,2,300186,300188,300190,2,4,0
85635,4,1,300190,300190,300191,0,1,0
85636,2,2,300192,300192,300194,0,2,1
85637,2,1,300194,300194,300195,0,1,0
85638,1,3,300195,300195,300198,0,3,0
85639,3,1,300198,300198,300199,0,1,0
85640,2,3,300200,300200,300203,0,3,1
85641,5,3,300205,300205,300208,0,3,2
85642,6,1,300211,300211,300212,0,1,3
85643,3,2,300214,300214,300216,0,2,2
85644,6,1,300220,300220,300221,0,1,4
85645,5,2,300225,300225,300227,0,2,4
85646,2,3,300227,300227,300230,0,3,0
85647,6,2,300233,300233,300235,0,2,3
85648,1,1,300234,300235,300236,1,2,0
85649,4,3,300238,300238,300241,0,3,2
85650,2,2,300240,300241,300243,1,3,0
85651,1,2,300241,300243,300245,2,4,0
85652,1,2,300242,300245,300247,3,5,0
85653,6,2,300248,300248,300250,0,2,1
85654,2,2,300250,300250,300252,0,2,0
85655,4,1,300254,300254,300255,0,1,2
85656,1,1,300255,300255,300256,0,1,0
85657,6,2,300261,300261,300263,0,2,5
85658,6,2,300267,300267,300269,0,2,4
85659,2,2,300269,300269,300271,0,2,0
85660,4,1,300273,300273,300274,0,1,2
85661,1,2,300274,300274,300276,0,2,0
85662,5,2,300279,300279,300281,0,2,3
85663,5,3,300284,300284,300287,0,3,3
85664,6,3,300290,300290,300293,0,3,3
85665,2,3,300292,300293,300296,1,4,0
85666,2,1,300294,300296,300297,2,3,0
85667,3,1,300297,300297,300298,0,1,0
85668,2,1,300299,300299,300300,0,1,1
85669,6,1,300305,300305,300306,0,1,5
85670,2,2,300307,300307,300309,0,2,1
85671,5,2,300312,300312,300314,0,2,3
85672,4,3,300316,300316,300319,0,3,2
85673,1,1,300317,300319,300320,2,3,0
85674,6,3,300323,300323,300326,0,3,3
85675,3,3,300326,300326,300329,0,3,0
85676,2,1,300328,300329,300330,1,2,0
85677,2,1,300330,300330,300331,0,1,0
85678,3,2,300333,300333,300335,0,2,2
85679,6,2,300339,300339,300341,0,2,4
85680,1,2,300340,300341,300343,1,3,0
85681,1,2,300341,300343,300345,2,4,0
85682,5,2,300346,300346,300348,0,2,1
85683,2,1,300348,300348,300349,0,1,0
85684,4,3,300352,300352,300355,0,3,3
85685,6,1,300358,300358,300359,0,1,3
85686,5,3,300363,300363,300366,0,3,4
85687,6,2,300369,300369,300371,0,2,3
85688,4,3,300373,300373,300376,0,3,2
85689,1,2,300374,300376,300378,2,4,0
85690,4,2,300378,300378,300380,0,2,0
85691,4,3,300382,300382,300385,0,3,2
85692,1,1,300383,300385,300386,2,3,0
85693,2,2,300385,300386,300388,1,3,0
85694,6,1,300391,300391,300392,0,1,3
85695,2,1,300393,300393,300394,0,1,1
85696,6,2,300399,300399,300401,0,2,5
85697,1,3,300400,300401,300404,1,4,0
85698,3,2,300403,300404,300406,1,3,0
85699,5,3,300408,300408,300411,0,3,2
85700,4,3,300412,300412,300415,0,3,1
85701,4,3,300416,300416,300419,0,3,1
85702,4,3,300420,300420,300423,0,3,1
85703,1,2,300421,300423,300425,2,4,0
85704,1,2,300422,300425,300427,3,5,0
85705,4,1,300426,300427,300428,1,2,0
85706,4,1,300430,300430,300431,0,1,2
85707,2,3,300432,300432,300435,0,3,1
85708,5,2,300437,300437,300439,0,2,2
85709,5,2,300442,300442,300444,0,2,3
85710,3,1,300445,300445,300446,0,1,1
85711,6,2,300451,300451,300453,0,2,5
85712,4,3,300455,300455,300458,0,3,2
85713,5,3,300460,300460,300463,0,3,2
85714,1,2,300461,300463,300465,2,4,0
85715,1,1,300462,300465,300466,3,4,0
85716,6,2,300468,300468,300470,0,2,2
85717,3,2,300471,300471,300473,0,2,1
85718,4,2,300475,300475,300477,0,2,2
85719,2,1,300477,300477,300478,0,1,0
85720,1,2,300478,300478,300480,0,2,0
85721,1,1,300479,300480,300481,1,2,0
85722,3,3,300482,300482,300485,0,3,1
85723,4,1,300486,300486,300487,0,1,1
85724,6,1,300492,300492,300493,0,1,5
85725,4,2,300496,300496,300498,0,2,3
85726,1,1,300497,300498,300499,1,2,0
85727,4,3,300501,300501,300504,0,3,2
85728,2,2,300503,300504,300506,1,3,0
85729,4,1,300507,300507,300508,0,1,1
85730,3,1,300510,300510,300511,0,1,2
85731,4,2,300514,300514,300516,0,2,3
85732,5,3,300519,300519,300522,0,3,3
85733,6,1,300525,300525,300526,0,1,3
85734,6,2,300531,300531,300533,0,2,5
85735,6,1,300537,300537,300538,0,1,4
85736,3,3,300540,300540,300543,0,3,2
85737,2,2,300542,300543,300545,1,3,0
85738,6,3,300548,300548,300551,0,3,3
85739,1,3,300549,300551,300554,2,5,0
85740,1,2,300550,300554,300556,4,6,0
85741,2,2,300552,300556,300558,4,6,0
85742,6,1,300558,300558,300559,0,1,0
85743,5,3,300563,300563,300566,0,3,4
85744,1,2,300564,300566,300568,2,4,0
85745,3,3,300567,300568,300571,1,4,0
85746,1,2,300568,300571,300573,3,5,0
85747,2,2,300570,300573,300575,3,5,0
85748,6,1,300576,300576,300577,0,1,1
85749,5,3,300581,300581,300584,0,3,4
85750,3,1,300584,300584,300585,0,1,0
85751,1,3,300585,300585,300588,0,3,0
85752,4,1,300589,300589,300590,0,1,1
85753,4,1,300593,300593,300594,0,1,3
85754,5,2,300598,300598,300600,0,2,4
85755,6,3,300604,300604,300607,0,3,4
85756,1,2,300605,300607,300609,2,4,0
85757,1,1,300606,300609,300610,3,4,0
85758,2,1,300608,300610,300611,2,3,0
85759,6,3,300614,300614,300617,0,3,3
85760,3,2,300617,300617,300619,0,2,0
85761,1,3,300618,300619,300622,1,4,0
85762,2,2,300620,300622,300624,2,4,0
85763,5,1,300625,300625,300626,0,1,1
85764,1,3,300626,300626,300629,0,3,0
85765,1,3,300627,300629,300632,2,5,0
85766,5,2,300632,300632,300634,0,2,0
85767,1,2,300633,300634,300636,1,3,0
85768,6,3,300639,300639,300642,0,3,3
85769,2,3,300641,300642,300645,1,4,0
85770,6,2,300647,300647,300649,0,2,2
85771,5,3,300652,300652,300655,0,3,3
85772,1,2,300653,300655,300657,2,4,0
85773,3,3,300656,300657,300660,1,4,0
85774,6,2,300662,300662,300664,0,2,2
85775,6,3,300668,300668,300671,0,3,4
85776,2,2,300670,300671,300673,1,3,0
85777,2,2,300672,300673,300675,1,3,0
85778,2,2,300674,300675,300677,1,3,0
85779,1,2,300675,300677,300679,2,4,0
85780,4,1,300679,300679,300680,0,1,0
85781,3,1,300682,300682,300683,0,1,2
85782,2,3,300684,300684,300687,0,3,1
85783,4,1,300688,300688,300689,0,1,1
85784,3,3,300691,300691,300694,0,3,2
85785,1,1,300692,300694,300695,2,3,0
85786,1,2,300693,300695,300697,2,4,0
85787,6,2,300699,300699,300701,0,2,2
85788,5,2,300704,300704,300706,0,2,3
85789,1,1,300705,300706,300707,1,2,0
85790,6,3,300711,300711,300714,0,3,4
85791,1,2,300712,300714,300716,2,4,0
85792,3,1,300715,300716,300717,1,2,0
85793,2,1,300717,300717,300718,0,1,0
85794,6,1,300723,300723,300724,0,1,5
85795,3,3,300726,300726,300729,0,3,2
85796,2,3,300728,300729,300732,1,4,0
85797,3,2,300731,300732,300734,1,3,0
85798,4,2,300735,300735,300737,0,2,1
85799,5,3,300740,300740,300743,0,3,3
85800,3,3,300743,300743,300746,0,3,0
85801,1,1,300744,300746,300747,2,3,0
85802,4,3,300748,300748,300751,0,3,1
85803,6,3,300754,300754,300757,0,3,3
85804,5,1,300759,300759,300760,0,1,2
85805,1,1,300760,300760,300761,0,1,0
85806,4,2,300764,300764,300766,0,2,3
85807,3,1,300767,300767,300768,0,1,1
85808,6,1,300773,300773,300774,0,1,5
85809,6,3,300779,300779,300782,0,3,5
85810,3,3,300782,300782,300785,0,3,0
85811,6,1,300788,300788,300789,0,1,3
85812,4,2,300792,300792,300794,0,2,3
85813,6,1,300798,300798,300799,0,1,4
85814,5,3,300803,300803,300806,0,3,4
85815,6,1,300809,300809,300810,0,1,3
85816,4,3,300813,300813,300816,0,3,3
85817,5,1,300818,300818,300819,0,1,2
85818,1,1,300819,300819,300820,0,1,0
85819,5,3,300824,300824,300827,0,3,4
85820,6,3,300830,300830,300833,0,3,3
85821,4,1,300834,300834,300835,0,1,1
85822,2,3,300836,300836,300839,0,3,1
85823,2,2,300838,300839,300841,1,3,0
85824,4,1,300842,300842,300843,0,1,1
85825,5,2,300847,300847,300849,0,2,4
85826,1,3,300848,300849,300852,1,4,0
85827,1,1,300849,300852,300853,3,4,0
85828,3,3,300852,300853,300856,1,4,0
85829,6,3,300858,300858,300861,0,3,2
85830,6,1,300864,300864,300865,0,1,3
85831,1,2,300865,300865,300867,0,2,0
85832,4,3,300869,300869,300872,0,3,2
85833,3,2,300872,300872,300874,0,2,0
85834,5,1,300877,300877,300878,0,1,3
85835,4,1,300881,300881,300882,0,1,3
85836,4,3,300885,300885,300888,0,3,3
85837,6,1,300891,300891,300892,0,1,3
85838,6,3,300897,300897,300900,0,3,5
85839,5,1,300902,300902,300903,0,1,2
85840,5,1,300907,300907,300908,0,1,4
85841,3,3,300910,300910,300913,0,3,2
85842,5,3,300915,300915,300918,0,3,2
85843,6,3,300921,300921,300924,0,3,3
85844,3,3,300924,300924,300927,0,3,0
85845,1,2,300925,300927,300929,2,4,0
85846,4,2,300929,300929,300931,0,2,0
85847,2,3,300931,300931,300934,0,3,0
85848,3,2,300934,300934,300936,0,2,0
85849,5,1,300939,300939,300940,0,1,3
85850,6,1,300945,300945,300946,0,1,5
85851,2,1,300947,300947,300948,0,1,1
85852,3,3,300950,300950,300953,0,3,2
85853,1,3,300951,300953,300956,2,5,0
85854,5,3,300956,300956,300959,0,3,0
85855,4,1,300960,300960,300961,0,1,1
85856,3,2,300963,300963,300965,0,2,2
85857,2,2,300965,300965,300967,0,2,0
85858,1,2,300966,300967,300969,1,3,0
85859,2,3,300968,300969,300972,1,4,0
85860,4,1,300972,300972,300973,0,1,0
85861,2,3,300974,300974,300977,0,3,1
85862,2,1,300976,300977,300978,1,2,0
85863,6,1,300982,300982,300983,0,1,4
85864,5,1,300987,300987,300988,0,1,4
85865,1,2,300988,300988,300990,0,2,0
85866,2,3,300990,300990,300993,0,3,0
85867,6,1,300996,300996,300997,0,1,3
85868,6,2,301002,301002,301004,0,2,5
85869,4,2,301006,301006,301008,0,2,2
85870,5,2,301011,301011,301013,0,2,3
85871,5,2,301016,301016,301018,0,2,3
85872,3,2,301019,301019,301021,0,2,1
85873,2,2,301021,301021,301023,0,2,0
85874,5,1,301026,301026,301027,0,1,3
85875,1,1,301027,301027,301028,0,1,0
85876,4,2,301031,301031,301033,0,2,3
85877,4,2,301035,301035,301037,0,2,2
85878,6,1,301041,301041,301042,0,1,4
85879,1,1,301042,301042,301043,0,1,0
85880,4,1,301046,301046,301047,0,1,3
85881,5,1,301051,301051,301052,0,1,4
85882,3,3,301054,301054,301057,0,3,2
85883,6,2,301060,301060,301062,0,2,3
85884,4,2,301064,301064,301066,0,2,2
85885,3,3,301067,301067,301070,0,3,1
85886,5,2,301072,301072,301074,0,2,2
85887,5,1,301077,301077,301078,0,1,3
85888,3,3,301080,301080,301083,0,3,2
85889,4,1,301084,301084,301085,0,1,1
85890,4,2,301088,301088,301090,0,2,3
85891,5,1,301093,301093,301094,0,1,3
85892,1,1,301094,301094,301095,0,1,0
85893,6,3,301100,301100,301103,0,3,5
85894,4,3,301104,301104,301107,0,3,1
85895,1,3,301105,301107,301110,2,5,0
85896,3,3,301108,301110,301113,2,5,0
85897,2,1,301110,301113,301114,3,4,0
85898,4,2,301114,301114,301116,0,2,0
85899,2,3,301116,301116,301119,0,3,0
85900,4,1,301120,301120,301121,0,1,1
85901,1,1,301121,301121,301122,0,1,0
85902,1,1,301122,301122,301123,0,1,0
85903,3,1,301125,301125,301126,0,1,2
85904,1,3,301126,301126,301129,0,3,0
85905,5,3,301131,301131,301134,0,3,2
85906,2,3,301133,301134,301137,1,4,0
85907,6,1,301139,301139,301140,0,1,2
85908,5,3,301144,301144,301147,0,3,4
85909,3,3,301147,301147,301150,0,3,0
85910,6,2,301153,301153,301155,0,2,3
85911,5,2,301158,301158,301160,0,2,3
85912,1,3,301159,301160,301163,1,4,0
85913,6,1,301165,301165,301166,0,1,2
85914,5,3,301170,301170,301173,0,3,4
85915,3,3,301173,301173,301176,0,3,0
85916,6,1,301179,301179,301180,0,1,3
85917,2,2,301181,301181,301183,0,2,1
85918,6,2,301187,301187,301189,0,2,4
85919,5,2,301192,301192,301194,0,2,3
85920,5,1,301197,301197,301198,0,1,3
85921,3,3,301200,301200,301203,0,3,2
85922,6,1,301206,301206,301207,0,1,3
85923,5,2,301211,301211,301213,0,2,4
85924,3,3,301214,301214,301217,0,3,1
85925,6,1,301220,301220,301221,0,1,3
85926,5,1,301225,301225,301226,0,1,4
85927,2,2,301227,301227,301229,0,2,1
85928,3,3,301230,301230,301233,0,3,1
85929,3,2,301233,301233,301235,0,2,0
85930,4,1,301237,301237,301238,0,1,2
85931,3,3,301240,301240,301243,0,3,2
85932,2,1,301242,301243,301244,1,2,0
85933,3,3,301245,301245,301248,0,3,1
85934,4,2,301249,301249,301251,0,2,1
85935,6,1,301255,301255,301256,0,1,4
85936,2,2,301257,301257,301259,0,2,1
85937,6,3,301263,301263,301266,0,3,4
85938,1,2,301264,301266,301268,2,4,0
85939,4,2,301268,301268,301270,0,2,0
85940,6,1,301274,301274,301275,0,1,4
85941,4,1,301278,301278,301279,0,1,3
85942,4,3,301282,301282,301285,0,3,3
85943,5,2,301287,301287,301289,0,2,2
85944,4,3,301291,301291,301294,0,3,2
85945,3,3,301294,301294,301297,0,3,0
85946,3,3,301297,301297,301300,0,3,0
85947,6,1,301303,301303,301304,0,1,3
85948,6,1,301309,301309,301310,0,1,5
85949,5,2,301314,301314,301316,0,2,4
85950,3,2,301317,301317,301319,0,2,1
85951,4,3,301321,301321,301324,0,3,2
85952,3,1,301324,301324,301325,0,1,0
85953,6,3,301330,301330,301333,0,3,5
85954,1,2,301331,301333,301335,2,4,0
85955,3,1,301334,301335,301336,1,2,0
85956,3,3,301337,301337,301340,0,3,1
85957,2,2,301339,301340,301342,1,3,0
85958,3,3,301342,301342,301345,0,3,0
85959,4,1,301346,301346,301347,0,1,1
85960,2,1,301348,301348,301349,0,1,1
85961,5,3,301353,301353,301356,0,3,4
85962,1,1,301354,301356,301357,2,3,0
85963,5,3,301359,301359,301362,0,3,2
85964,3,2,301362,301362,301364,0,2,0
85965,5,1,301367,301367,301368,0,1,3
85966,6,1,301373,301373,301374,0,1,5
85967,2,1,301375,301375,301376,0,1,1
85968,4,3,301379,301379,301382,0,3,3
85969,2,2,301381,301382,301384,1,3,0
85970,3,2,301384,301384,301386,0,2,0
85971,4,2,301388,301388,301390,0,2,2
85972,3,1,301391,301391,301392,0,1,1
85973,2,2,301393,301393,301395,0,2,1
85974,4,3,301397,301397,301400,0,3,2
85975,3,3,301400,301400,301403,0,3,0
85976,6,1,301406,301406,301407,0,1,3
85977,4,2,301410,301410,301412,0,2,3
85978,2,2,301412,301412,301414,0,2,0
85979,4,1,301416,301416,301417,0,1,2
85980,5,2,301421,301421,301423,0,2,4
85981,6,2,301427,301427,301429,0,2,4
85982,1,3,301428,301429,301432,1,4,0
85983,6,1,301434,301434,301435,0,1,2
85984,2,2,301436,301436,301438,0,2,1
85985,5,2,301441,301441,301443,0,2,3
85986,4,1,301445,301445,301446,0,1,2
85987,4,1,301449,301449,301450,0,1,3
85988,1,2,301450,301450,301452,0,2,0
85989,2,3,301452,301452,301455,0,3,0
85990,1,2,301453,301455,301457,2,4,0
85991,3,2,301456,301457,301459,1,3,0
85992,1,3,301457,301459,301462,2,5,0
85993,5,2,301462,301462,301464,0,2,0
85994,4,1,301466,301466,301467,0,1,2
85995,6,2,301472,301472,301474,0,2,5
85996,3,2,301475,301475,301477,0,2,1
85997,1,3,301476,301477,301480,1,4,0
85998,5,1,301481,301481,301482,0,1,1
85999,6,2,301487,301487,301489,0,2,5
86000,5,1,301492,301492,301493,0,1,3
86001,3,2,301495,301495,301497,0,2,2
86002,3,3,301498,301498,301501,0,3,1
86003,6,3,301504,301504,301507,0,3,3
86004,3,2,301507,301507,301509,0,2,0
86005,5,1,301512,301512,301513,0,1,3
86006,3,3,301515,301515,301518,0,3,2
86007,3,3,301518,301518,301521,0,3,0
86008,3,1,301521,301521,301522,0,1,0
86009,5,3,301526,301526,301529,0,3,4
86010,6,2,301532,301532,301534,0,2,3
86011,4,2,301536,301536,301538,0,2,2
86012,3,2,301539,301539,301541,0,2,1
86013,6,2,301545,301545,301547,0,2,4
86014,2,2,301547,301547,301549,0,2,0
86015,2,1,301549,301549,301550,0,1,0
86016,4,1,301553,301553,301554,0,1,3
86017,2,2,301555,301555,301557,0,2,1
86018,5,3,301560,301560,301563,0,3,3
86019,2,2,301562,301563,301565,1,3,0
86020,6,3,301568,301568,301571,0,3,3
86021,4,2,301572,301572,301574,0,2,1
86022,5,1,301577,301577,301578,0,1,3
86023,4,3,301581,301581,301584,0,3,3
86024,4,1,301585,301585,301586,0,1,1
86025,5,2,301590,301590,301592,0,2,4
86026,1,3,301591,301592,301595,1,4,0
86027,6,1,301597,301597,301598,0,1,2
86028,3,2,301600,301600,301602,0,2,2
86029,1,2,301601,301602,301604,1,3,0
86030,5,3,301606,301606,301609,0,3,2
86031,2,3,301608,301609,301612,1,4,0
86032,1,2,301609,301612,301614,3,5,0
86033,4,2,301613,301614,301616,1,3,0
86034,3,3,301616,301616,301619,0,3,0
86035,4,1,301620,301620,301621,0,1,1
86036,4,2,301624,301624,301626,0,2,3
86037,1,2,301625,301626,301628,1,3,0
86038,3,1,301628,301628,301629,0,1,0
86039,2,3,301630,301630,301633,0,3,1
86040,4,1,301634,301634,301635,0,1,1
86041,5,3,301639,301639,301642,0,3,4
86042,5,1,301644,301644,301645,0,1,2
86043,6,1,301650,301650,301651,0,1,5
86044,5,3,301655,301655,301658,0,3,4
86045,4,2,301659,301659,301661,0,2,1
86046,2,1,301661,301661,301662,0,1,0
86047,3,2,301664,301664,301666,0,2,2
86048,2,1,301666,301666,301667,0,1,0
86049,4,3,301670,301670,301673,0,3,3
86050,5,2,301675,301675,301677,0,2,2
86051,1,3,301676,301677,301680,1,4,0
86052,2,2,301678,301680,301682,2,4,0
86053,5,3,301683,301683,301686,0,3,1
86054,2,1,301685,301686,301687,1,2,0
86055,2,1,301687,301687,301688,0,1,0
86056,3,2,301690,301690,301692,0,2,2
86057,5,2,301695,301695,301697,0,2,3
86058,3,3,301698,301698,301701,0,3,1
86059,2,2,301700,301701,301703,1,3,0
86060,1,3,301701,301703,301706,2,5,0
86061,6,2,301707,301707,301709,0,2,1
86062,2,1,301709,301709,301710,0,1,0
86063,3,1,301712,301712,301713,0,1,2
86064,3,1,301715,301715,301716,0,1,2
86065,3,1,301718,301718,301719,0,1,2
86066,2,1,301720,301720,301721,0,1,1
86067,6,1,301726,301726,301727,0,1,5
86068,4,3,301730,301730,301733,0,3,3
86069,3,1,301733,301733,301734,0,1,0
86070,6,1,301739,301739,301740,0,1,5
86071,2,1,301741,301741,301742,0,1,1
86072,6,3,301747,301747,301750,0,3,5
86073,6,2,301753,301753,301755,0,2,3
86074,4,1,301757,301757,301758,0,1,2
86075,4,3,301761,301761,301764,0,3,3
86076,3,2,301764,301764,301766,0,2,0
86077,1,2,301765,301766,301768,1,3,0
86078,4,3,301769,301769,301772,0,3,1
86079,3,3,301772,301772,301775,0,3,0
86080,4,3,301776,301776,301779,0,3,1
86081,4,1,301780,301780,301781,0,1,1
86082,1,2,301781,301781,301783,0,2,0
86083,2,3,301783,301783,301786,0,3,0
86084,4,1,301787,301787,301788,0,1,1
86085,5,3,301792,301792,301795,0,3,4
86086,5,2,301797,301797,301799,0,2,2
86087,1,1,301798,301799,301800,1,2,0
86088,2,3,301800,301800,301803,0,3,0
86089,4,3,301804,301804,301807,0,3,1
86090,6,2,301810,301810,301812,0,2,3
86091,6,3,301816,301816,301819,0,3,4
86092,1,1,301817,301819,301820,2,3,0
86093,1,2,301818,301820,301822,2,4,0
86094,5,2,301823,301823,301825,0,2,1
86095,1,2,301824,301825,301827,1,3,0
86096,6,3,301830,301830,301833,0,3,3
86097,2,1,301832,301833,301834,1,2,0
86098,1,3,301833,301834,301837,1,4,0
86099,5,2,301838,301838,301840,0,2,1
86100,5,3,301843,301843,301846,0,3,3
86101,5,2,301848,301848,301850,0,2,2
86102,1,3,301849,301850,301853,1,4,0
86103,6,1,301855,301855,301856,0,1,2
86104,3,2,301858,301858,301860,0,2,2
86105,5,2,301863,301863,301865,0,2,3
86106,2,3,301865,301865,301868,0,3,0
86107,6,2,301871,301871,301873,0,2,3
86108,1,3,301872,301873,301876,1,4,0
86109,6,3,301878,301878,301881,0,3,2
86110,6,2,301884,301884,301886,0,2,3
86111,6,3,301890,301890,301893,0,3,4
86112,5,1,301895,301895,301896,0,1,2
86113,3,3,301898,301898,301901,0,3,2
86114,2,3,301900,301901,301904,1,4,0
86115,4,1,301904,301904,301905,0,1,0
86116,6,2,301910,301910,301912,0,2,5
86117,6,1,301916,301916,301917,0,1,4
86118,2,3,301918,301918,301921,0,3,1
86119,6,3,301924,301924,301927,0,3,3
86120,1,1,301925,301927,301928,2,3,0
86121,5,3,301930,301930,301933,0,3,2
86122,3,2,301933,301933,301935,0,2,0
86123,5,3,301938,301938,301941,0,3,3
86124,5,2,301943,301943,301945,0,2,2
86125,1,1,301944,301945,301946,1,2,0
86126,6,1,301950,301950,301951,0,1,4
86127,3,1,301953,301953,301954,0,1,2
86128,2,1,301955,301955,301956,0,1,1
86129,5,1,301960,301960,301961,0,1,4
86130,4,2,301964,301964,301966,0,2,3
86131,5,1,301969,301969,301970,0,1,3
86132,3,3,301972,301972,301975,0,3,2
86133,1,3,301973,301975,301978,2,5,0
86134,6,1,301979,301979,301980,0,1,1
86135,1,3,301980,301980,301983,0,3,0
86136,2,3,301982,301983,301986,1,4,0
86137,4,1,301986,301986,301987,0,1,0
86138,5,2,301991,301991,301993,0,2,4
86139,5,2,301996,301996,301998,0,2,3
86140,3,1,301999,301999,302000,0,1,1
86141,5,3,302004,302004,302007,0,3,4
86142,3,2,302007,302007,302009,0,2,0
86143,3,3,302010,302010,302013,0,3,1
86144,6,2,302016,302016,302018,0,2,3
86145,4,3,302020,302020,302023,0,3,2
86146,3,2,302023,302023,302025,0,2,0
86147,5,3,302028,302028,302031,0,3,3
86148,5,3,302033,302033,302036,0,3,2
86149,5,3,302038,302038,302041,0,3,2
86150,4,1,302042,302042,302043,0,1,1
86151,5,1,302047,302047,302048,0,1,4
86152,4,3,302051,302051,302054,0,3,3
86153,5,1,302056,302056,302057,0,1,2
86154,3,2,302059,302059,302061,0,2,2
86155,1,2,302060,302061,302063,1,3,0
86156,2,2,302062,302063,302065,1,3,0
86157,1,2,302063,302065,302067,2,4,0
86158,4,3,302067,302067,302070,0,3,0
86159,6,1,302073,302073,302074,0,1,3
86160,4,3,302077,302077,302080,0,3,3
86161,4,3,302081,302081,302084,0,3,1
86162,5,3,302086,302086,302089,0,3,2
86163,3,3,302089,302089,302092,0,3,0
86164,2,1,302091,302092,302093,1,2,0
86165,1,1,302092,302093,302094,1,2,0
86166,5,1,302097,302097,302098,0,1,3
86167,2,1,302099,302099,302100,0,1,1
86168,6,2,302105,302105,302107,0,2,5
86169,4,3,302109,302109,302112,0,3,2
86170,4,3,302113,302113,302116,0,3,1
86171,2,2,302115,302116,302118,1,3,0
86172,6,1,302121,302121,302122,0,1,3
86173,5,3,302126,302126,302129,0,3,4
86174,1,2,302127,302129,302131,2,4,0
86175,6,3,302133,302133,302136,0,3,2
86176,4,1,302137,302137,302138,0,1,1
86177,6,2,302143,302143,302145,0,2,5
86178,4,1,302147,302147,302148,0,1,2
86179,2,1,302149,302149,302150,0,1,1
86180,5,3,302154,302154,302157,0,3,4
86181,2,2,302156,302157,302159,1,3,0
86182,2,3,302158,302159,302162,1,4,0
86183,4,3,302162,302162,302165,0,3,0
86184,4,1,302166,302166,302167,0,1,1
86185,3,2,302169,302169,302171,0,2,2
86186,2,3,302171,302171,302174,0,3,0
86187,1,1,302172,302174,302175,2,3,0
86188,2,3,302174,302175,302178,1,4,0
86189,2,1,302176,302178,302179,2,3,0
86190,4,3,302180,302180,302183,0,3,1
86191,4,1,302184,302184,302185,0,1,1
86192,3,1,302187,302187,302188,0,1,2
86193,4,3,302191,302191,302194,0,3,3
86194,4,1,302195,302195,302196,0,1,1
86195,2,3,302197,302197,302200,0,3,1
86196,5,3,302202,302202,302205,0,3,2
86197,3,1,302205,302205,302206,0,1,0
86198,6,1,302211,302211,302212,0,1,5
86199,3,3,302214,302214,302217,0,3,2
86200,4,1,302218,302218,302219,0,1,1
86201,1,1,302219,302219,302220,0,1,0
86202,1,3,302220,302220,302223,0,3,0
86203,6,3,302226,302226,302229,0,3,3
86204,5,1,302231,302231,302232,0,1,2
86205,4,1,302235,302235,302236,0,1,3
86206,6,3,302241,302241,302244,0,3,5
86207,2,2,302243,302244,302246,1,3,0
86208,4,2,302247,302247,302249,0,2,1
86209,5,3,302252,302252,302255,0,3,3
86210,3,2,302255,302255,302257,0,2,0
86211,5,2,302260,302260,302262,0,2,3
86212,1,1,302261,302262,302263,1,2,0
86213,5,1,302266,302266,302267,0,1,3
86214,4,1,302270,302270,302271,0,1,3
86215,3,2,302273,302273,302275,0,2,2
86216,6,2,302279,302279,302281,0,2,4
86217,3,1,302282,302282,302283,0,1,1
86218,3,3,302285,302285,302288,0,3,2
86219,5,2,302290,302290,302292,0,2,2
86220,2,3,302292,302292,302295,0,3,0
86221,6,2,302298,302298,302300,0,2,3
86222,3,1,302301,302301,302302,0,1,1
86223,6,3,302307,302307,302310,0,3,5
86224,5,2,302312,302312,302314,0,2,2
86225,2,2,302314,302314,302316,0,2,0
86226,5,2,302319,302319,302321,0,2,3
86227,1,1,302320,302321,302322,1,2,0
86228,5,1,302325,302325,302326,0,1,3
86229,2,1,302327,302327,302328,0,1,1
86230,3,3,302330,302330,302333,0,3,2
86231,4,2,302334,302334,302336,0,2,1
86232,2,3,302336,302336,302339,0,3,0
86233,3,3,302339,302339,302342,0,3,0
86234,5,1,302344,302344,302345,0,1,2
86235,6,3,302350,302350,302353,0,3,5
86236,1,1,302351,302353,302354,2,3,0
86237,4,3,302355,302355,302358,0,3,1
86238,5,1,302360,302360,302361,0,1,2
86239,3,3,302363,302363,302366,0,3,2
86240,5,3,302368,302368,302371,0,3,2
86241,2,1,302370,302371,302372,1,2,0
86242,5,3,302375,302375,302378,0,3,3
86243,5,3,302380,302380,302383,0,3,2
86244,6,1,302386,302386,302387,0,1,3
86245,2,2,302388,302388,302390,0,2,1
86246,2,3,302390,302390,302393,0,3,0
86247,3,1,302393,302393,302394,0,1,0
86248,6,3,302399,302399,302402,0,3,5
86249,3,3,302402,302402,302405,0,3,0
86250,2,3,302404,302405,302408,1,4,0
86251,4,2,302408,302408,302410,0,2,0
86252,4,1,302412,302412,302413,0,1,2
86253,3,2,302415,302415,302417,0,2,2
86254,6,1,302421,302421,302422,0,1,4
86255,5,3,302426,302426,302429,0,3,4
86256,5,2,302431,302431,302433,0,2,2
86257,2,1,302433,302433,302434,0,1,0
86258,5,2,302438,302438,302440,0,2,4
86259,1,2,302439,302440,302442,1,3,0
86260,4,2,302443,302443,302445,0,2,1
86261,2,2,302445,302445,302447,0,2,0
86262,4,2,302449,302449,302451,0,2,2
86263,4,3,302453,302453,302456,0,3,2
86264,3,1,302456,302456,302457,0,1,0
86265,4,2,302460,302460,302462,0,2,3
86266,3,3,302463,302463,302466,0,3,1
86267,4,1,302467,302467,302468,0,1,1
86268,5,1,302472,302472,302473,0,1,4
86269,1,2,302473,302473,302475,0,2,0
86270,5,2,302478,302478,302480,0,2,3
86271,1,1,302479,302480,302481,1,2,0
86272,4,1,302483,302483,302484,0,1,2
86273,1,2,302484,302484,302486,0,2,0
86274,1,2,302485,302486,302488,1,3,0
86275,4,2,302489,302489,302491,0,2,1
86276,6,1,302495,302495,302496,0,1,4
86277,4,1,302499,302499,302500,0,1,3
86278,6,2,302505,302505,302507,0,2,5
86279,4,1,302509,302509,302510,0,1,2
86280,4,3,302513,302513,302516,0,3,3
86281,6,3,302519,302519,302522,0,3,3
86282,4,1,302523,302523,302524,0,1,1
86283,6,3,302529,302529,302532,0,3,5
86284,1,3,302530,302532,302535,2,5,0
86285,3,3,302533,302535,302538,2,5,0
86286,1,3,302534,302538,302541,4,7,0
86287,1,2,302535,302541,302543,6,8,0
86288,4,1,302539,302543,302544,4,5,0
86289,6,2,302545,302545,302547,0,2,1
86290,4,3,302549,302549,302552,0,3,2
86291,3,1,302552,302552,302553,0,1,0
86292,3,3,302555,302555,302558,0,3,2
86293,6,1,302561,302561,302562,0,1,3
86294,6,3,302567,302567,302570,0,3,5
86295,6,2,302573,302573,302575,0,2,3
86296,4,3,302577,302577,302580,0,3,2
86297,5,1,302582,302582,302583,0,1,2
86298,2,3,302584,302584,302587,0,3,1
86299,2,3,302586,302587,302590,1,4,0
86300,1,2,302587,302590,302592,3,5,0
86301,5,2,302592,302592,302594,0,2,0
86302,1,3,302593,302594,302597,1,4,0
86303,6,3,302599,302599,302602,0,3,2
86304,3,2,302602,302602,302604,0,2,0
86305,2,2,302604,302604,302606,0,2,0
86306,6,2,302610,302610,302612,0,2,4
86307,1,2,302611,302612,302614,1,3,0
86308,1,1,302612,302614,302615,2,3,0
86309,6,2,302618,302618,302620,0,2,3
86310,5,3,302623,302623,302626,0,3,3
86311,1,1,302624,302626,302627,2,3,0
86312,6,1,302630,302630,302631,0,1,3
86313,5,3,302635,302635,302638,0,3,4
86314,5,1,302640,302640,302641,0,1,2
86315,5,3,302645,302645,302648,0,3,4
86316,1,1,302646,302648,302649,2,3,0
86317,4,2,302650,302650,302652,0,2,1
86318,1,3,302651,302652,302655,1,4,0
86319,3,2,302654,302655,302657,1,3,0
86320,5,2,302659,302659,302661,0,2,2
86321,4,1,302663,302663,302664,0,1,2
86322,1,3,302664,302664,302667,0,3,0
86323,1,1,302665,302667,302668,2,3,0
86324,6,1,302671,302671,302672,0,1,3
86325,6,3,302677,302677,302680,0,3,5
86326,3,1,302680,302680,302681,0,1,0
86327,5,1,302685,302685,302686,0,1,4
86328,5,2,302690,302690,302692,0,2,4
86329,1,3,302691,302692,302695,1,4,0
86330,1,1,302692,302695,302696,3,4,0
86331,6,2,302698,302698,302700,0,2,2
86332,2,3,302700,302700,302703,0,3,0
86333,6,3,302706,302706,302709,0,3,3
86334,4,2,302710,302710,302712,0,2,1
86335,6,2,302716,302716,302718,0,2,4
86336,4,2,302720,302720,302722,0,2,2
86337,2,3,302722,302722,302725,0,3,0
86338,1,3,302723,302725,302728,2,5,0
86339,3,3,302726,302728,302731,2,5,0
86340,2,1,302728,302731,302732,3,4,0
86341,6,1,302734,302734,302735,0,1,2
86342,4,3,302738,302738,302741,0,3,3
86343,3,3,302741,302741,302744,0,3,0
86344,1,3,302742,302744,302747,2,5,0
86345,5,2,302747,302747,302749,0,2,0
86346,2,1,302749,302749,302750,0,1,0
86347,5,3,302754,302754,302757,0,3,4
86348,5,2,302759,302759,302761,0,2,2
86349,6,2,302765,302765,302767,0,2,4
86350,2,3,302767,302767,302770,0,3,0
86351,4,3,302771,302771,302774,0,3,1
86352,5,2,302776,302776,302778,0,2,2
86353,3,1,302779,302779,302780,0,1,1
86354,6,2,302785,302785,302787,0,2,5
86355,3,1,302788,302788,302789,0,1,1
86356,1,3,302789,302789,302792,0,3,0
86357,4,2,302793,302793,302795,0,2,1
86358,4,3,302797,302797,302800,0,3,2
86359,1,2,302798,302800,302802,2,4,0
86360,5,2,302803,302803,302805,0,2,1
86361,1,2,302804,302805,302807,1,3,0
86362,1,1,302805,302807,302808,2,3,0
86363,3,3,302808,302808,302811,0,3,0
86364,1,3,302809,302811,302814,2,5,0
86365,6,2,302815,302815,302817,0,2,1
86366,5,3,302820,302820,302823,0,3,3
86367,4,3,302824,302824,302827,0,3,1
86368,2,1,302826,302827,302828,1,2,0
86369,3,3,302829,302829,302832,0,3,1
86370,6,3,302835,302835,302838,0,3,3
86371,4,1,302839,302839,302840,0,1,1
86372,5,3,302844,302844,302847,0,3,4
86373,4,2,302848,302848,302850,0,2,1
86374,3,2,302851,302851,302853,0,2,1
86375,5,1,302856,302856,302857,0,1,3
86376,4,3,302860,302860,302863,0,3,3
86377,6,1,302866,302866,302867,0,1,3
86378,2,1,302868,302868,302869,0,1,1
86379,3,1,302871,302871,302872,0,1,2
86380,5,1,302876,302876,302877,0,1,4
86381,2,2,302878,302878,302880,0,2,1
86382,3,2,302881,302881,302883,0,2,1
86383,1,3,302882,302883,302886,1,4,0
86384,1,2,302883,302886,302888,3,5,0
86385,2,1,302885,302888,302889,3,4,0
86386,5,3,302890,302890,302893,0,3,1
86387,6,3,302896,302896,302899,0,3,3
86388,1,3,302897,302899,302902,2,5,0
86389,6,3,302903,302903,302906,0,3,1
86390,3,1,302906,302906,302907,0,1,0
86391,5,3,302911,302911,302914,0,3,4
86392,5,3,302916,302916,302919,0,3,2
86393,5,3,302921,302921,302924,0,3,2
86394,4,1,302925,302925,302926,0,1,1
86395,3,1,302928,302928,302929,0,1,2
86396,2,1,302930,302930,302931,0,1,1
86397,5,2,302935,302935,302937,0,2,4
86398,3,3,302938,302938,302941,0,3,1
86399,4,3,302942,302942,302945,0,3,1
86400,5,1,302947,302947,302948,0,1,2
86401,4,2,302951,302951,302953,0,2,3
86402,2,3,302953,302953,302956,0,3,0
86403,6,2,302959,302959,302961,0,2,3
86404,4,2,302963,302963,302965,0,2,2
86405,6,3,302969,302969,302972,0,3,4
86406,6,2,302975,302975,302977,0,2,3
86407,5,2,302980,302980,302982,0,2,3
86408,5,2,302985,302985,302987,0,2,3
86409,1,1,302986,302987,302988,1,2,0
86410,3,2,302989,302989,302991,0,2,1
86411,4,2,302993,302993,302995,0,2,2
86412,6,1,302999,302999,303000,0,1,4
86413,4,2,303003,303003,303005,0,2,3
86414,4,2,303007,303007,303009,0,2,2
86415,1,1,303008,303009,303010,1,2,0
86416,6,2,303014,303014,303016,0,2,4
86417,2,2,303016,303016,303018,0,2,0
86418,2,3,303018,303018,303021,0,3,0
86419,5,2,303023,303023,303025,0,2,2
86420,3,2,303026,303026,303028,0,2,1
86421,1,2,303027,303028,303030,1,3,0
86422,6,3,303033,303033,303036,0,3,3
86423,6,3,303039,303039,303042,0,3,3
86424,6,3,303045,303045,303048,0,3,3
86425,3,2,303048,303048,303050,0,2,0
86426,1,2,303049,303050,303052,1,3,0
86427,3,3,303052,303052,303055,0,3,0
86428,1,2,303053,303055,303057,2,4,0
86429,3,1,303056,303057,303058,1,2,0
86430,5,2,303061,303061,303063,0,2,3
86431,2,2,303063,303063,303065,0,2,0
86432,2,3,303065,303065,303068,0,3,0
86433,6,1,303071,303071,303072,0,1,3
86434,2,3,303073,303073,303076,0,3,1
86435,6,2,303079,303079,303081,0,2,3
86436,3,2,303082,303082,303084,0,2,1
86437,4,2,303086,303086,303088,0,2,2
86438,6,1,303092,303092,303093,0,1,4
86439,2,3,303094,303094,303097,0,3,1
86440,5,1,303099,303099,303100,0,1,2
86441,3,3,303102,303102,303105,0,3,2
86442,6,3,303108,303108,303111,0,3,3
86443,2,1,303110,303111,303112,1,2,0
86444,6,1,303116,303116,303117,0,1,4
86445,5,3,303121,303121,303124,0,3,4
86446,3,3,303124,303124,303127,0,3,0
86447,5,2,303129,303129,303131,0,2,2
86448,1,3,303130,303131,303134,1,4,0
86449,5,1,303135,303135,303136,0,1,1
86450,6,1,303141,303141,303142,0,1,5
86451,3,2,303144,303144,303146,0,2,2
86452,4,1,303148,303148,303149,0,1,2
86453,2,2,303150,303150,303152,0,2,1
86454,2,3,303152,303152,303155,0,3,0
86455,6,2,303158,303158,303160,0,2,3
86456,1,1,303159,303160,303161,1,2,0
86457,6,3,303165,303165,303168,0,3,4
86458,3,2,303168,303168,303170,0,2,0
86459,1,1,303169,303170,303171,1,2,0
86460,2,1,303171,303171,303172,0,1,0
86461,4,1,303175,303175,303176,0,1,3
86462,6,3,303181,303181,303184,0,3,5
86463,1,3,303182,303184,303187,2,5,0
86464,5,2,303187,303187,303189,0,2,0
86465,1,1,303188,303189,303190,1,2,0
86466,4,3,303192,303192,303195,0,3,2
86467,3,2,303195,303195,303197,0,2,0
86468,4,2,303199,303199,303201,0,2,2
86469,6,2,303205,303205,303207,0,2,4
86470,2,1,303207,303207,303208,0,1,0
86471,1,3,303208,303208,303211,0,3,0
86472,3,3,303211,303211,303214,0,3,0
86473,5,2,303216,303216,303218,0,2,2
86474,2,3,303218,303218,303221,0,3,0
86475,2,2,303220,303221,303223,1,3,0
86476,3,2,303223,303223,303225,0,2,0
86477,3,1,303226,303226,303227,0,1,1
86478,1,1,303227,303227,303228,0,1,0
86479,1,1,303228,303228,303229,0,1,0
86480,4,2,303232,303232,303234,0,2,3
86481,3,1,303235,303235,303236,0,1,1
86482,6,2,303241,303241,303243,0,2,5
86483,4,1,303245,303245,303246,0,1,2
86484,5,2,303250,303250,303252,0,2,4
86485,4,2,303254,303254,303256,0,2,2
86486,3,3,303257,303257,303260,0,3,1
86487,2,3,303259,303260,303263,1,4,0
86488,4,2,303263,303263,303265,0,2,0
86489,2,1,303265,303265,303266,0,1,0
86490,1,2,303266,303266,303268,0,2,0
86491,4,1,303270,303270,303271,0,1,2
86492,2,1,303272,303272,303273,0,1,1
86493,1,1,303273,303273,303274,0,1,0
86494,5,2,303278,303278,303280,0,2,4
86495,6,3,303284,303284,303287,0,3,4
86496,2,3,303286,303287,303290,1,4,0
86497,2,2,303288,303290,303292,2,4,0
86498,4,1,303292,303292,303293,0,1,0
86499,2,1,303294,303294,303295,0,1,1
86500,4,1,303298,303298,303299,0,1,3
86501,3,2,303301,303301,303303,0,2,2
86502,3,2,303304,303304,303306,0,2,1
86503,2,2,303306,303306,303308,0,2,0
86504,3,2,303309,303309,303311,0,2,1
86505,1,1,303310,303311,303312,1,2,0
86506,5,2,303315,303315,303317,0,2,3
86507,5,2,303320,303320,303322,0,2,3
86508,5,1,303325,303325,303326,0,1,3
86509,3,1,303328,303328,303329,0,1,2
86510,2,1,303330,303330,303331,0,1,1
86511,4,3,303334,303334,303337,0,3,3
86512,4,2,303338,303338,303340,0,2,1
86513,4,3,303342,303342,303345,0,3,2
86514,5,1,303347,303347,303348,0,1,2
86515,4,2,303351,303351,303353,0,2,3
86516,6,3,303357,303357,303360,0,3,4
86517,6,1,303363,303363,303364,0,1,3
86518,6,2,303369,303369,303371,0,2,5
86519,4,1,303373,303373,303374,0,1,2
86520,1,1,303374,303374,303375,0,1,0
86521,6,1,303380,303380,303381,0,1,5
86522,3,3,303383,303383,303386,0,3,2
86523,5,1,303388,303388,303389,0,1,2
86524,1,1,303389,303389,303390,0,1,0
86525,5,1,303394,303394,303395,0,1,4
86526,3,3,303397,303397,303400,0,3,2
86527,2,3,303399,303400,303403,1,4,0
86528,5,3,303404,303404,303407,0,3,1
86529,6,2,303410,303410,303412,0,2,3
86530,5,1,303415,303415,303416,0,1,3
86531,6,1,303421,303421,303422,0,1,5
86532,5,2,303426,303426,303428,0,2,4
86533,1,3,303427,303428,303431,1,4,0
86534,2,2,303429,303431,303433,2,4,0
86535,4,3,303433,303433,303436,0,3,0
86536,1,3,303434,303436,303439,2,5,0
86537,6,3,303440,303440,303443,0,3,1
86538,6,3,303446,303446,303449,0,3,3
86539,4,3,303450,303450,303453,0,3,1
86540,4,1,303454,303454,303455,0,1,1
86541,6,3,303460,303460,303463,0,3,5
86542,3,3,303463,303463,303466,0,3,0
86543,6,1,303469,303469,303470,0,1,3
86544,2,1,303471,303471,303472,0,1,1
86545,5,2,303476,303476,303478,0,2,4
86546,3,1,303479,303479,303480,0,1,1
86547,6,1,303485,303485,303486,0,1,5
86548,1,3,303486,303486,303489,0,3,0
86549,5,2,303491,303491,303493,0,2,2
86550,6,3,303497,303497,303500,0,3,4
86551,1,2,303498,303500,303502,2,4,0
86552,3,1,303501,303502,303503,1,2,0
86553,3,1,303504,303504,303505,0,1,1
86554,3,2,303507,303507,303509,0,2,2
86555,5,3,303512,303512,303515,0,3,3
86556,6,1,303518,303518,303519,0,1,3
86557,2,2,303520,303520,303522,0,2,1
86558,5,1,303525,303525,303526,0,1,3
86559,4,2,303529,303529,303531,0,2,3
86560,2,3,303531,303531,303534,0,3,0
86561,6,2,303537,303537,303539,0,2,3
86562,1,1,303538,303539,303540,1,2,0
86563,3,1,303541,303541,303542,0,1,1
86564,5,3,303546,303546,303549,0,3,4
86565,2,1,303548,303549,303550,1,2,0
86566,5,2,303553,303553,303555,0,2,3
86567,5,2,303558,303558,303560,0,2,3
86568,6,1,303564,303564,303565,0,1,4
86569,2,2,303566,303566,303568,0,2,1
86570,5,3,303571,303571,303574,0,3,3
86571,3,2,303574,303574,303576,0,2,0
86572,1,2,303575,303576,303578,1,3,0
86573,1,2,303576,303578,303580,2,4,0
86574,5,1,303581,303581,303582,0,1,1
86575,4,1,303585,303585,303586,0,1,3
86576,1,1,303586,303586,303587,0,1,0
86577,6,3,303592,303592,303595,0,3,5
86578,6,3,303598,303598,303601,0,3,3
86579,4,1,303602,303602,303603,0,1,1
86580,6,1,303608,303608,303609,0,1,5
86581,3,3,303611,303611,303614,0,3,2
86582,1,1,303612,303614,303615,2,3,0
86583,5,1,303617,303617,303618,0,1,2
86584,6,1,303623,303623,303624,0,1,5
86585,5,1,303628,303628,303629,0,1,4
86586,1,3,303629,303629,303632,0,3,0
86587,3,3,303632,303632,303635,0,3,0
86588,2,2,303634,303635,303637,1,3,0
86589,5,1,303639,303639,303640,0,1,2
86590,6,3,303645,303645,303648,0,3,5
86591,5,3,303650,303650,303653,0,3,2
86592,2,1,303652,303653,303654,1,2,0
86593,5,3,303657,303657,303660,0,3,3
86594,5,3,303662,303662,303665,0,3,2
86595,5,1,303667,303667,303668,0,1,2
86596,5,3,303672,303672,303675,0,3,4
86597,6,2,303678,303678,303680,0,2,3
86598,6,1,303684,303684,303685,0,1,4
86599,2,3,303686,303686,303689,0,3,1
86600,4,3,303690,303690,303693,0,3,1
86601,5,1,303695,303695,303696,0,1,2
86602,5,3,303700,303700,303703,0,3,4
86603,4,2,303704,303704,303706,0,2,1
86604,6,2,303710,303710,303712,0,2,4
86605,5,2,303715,303715,303717,0,2,3
86606,2,3,303717,303717,303720,0,3,0
86607,6,2,303723,303723,303725,0,2,3
86608,2,2,303725,303725,303727,0,2,0
86609,3,1,303728,303728,303729,0,1,1
86610,6,1,303734,303734,303735,0,1,5
86611,6,3,303740,303740,303743,0,3,5
86612,1,1,303741,303743,303744,2,3,0
86613,6,1,303747,303747,303748,0,1,3
86614,1,1,303748,303748,303749,0,1,0
86615,5,1,303753,303753,303754,0,1,4
86616,2,1,303755,303755,303756,0,1,1
86617,6,2,303761,303761,303763,0,2,5
86618,3,2,303764,303764,303766,0,2,1
86619,4,2,303768,303768,303770,0,2,2
86620,5,2,303773,303773,303775,0,2,3
86621,5,1,303778,303778,303779,0,1,3
86622,1,1,303779,303779,303780,0,1,0
86623,6,3,303785,303785,303788,0,3,5
86624,5,2,303790,303790,303792,0,2,2
86625,2,1,303792,303792,303793,0,1,0
86626,6,1,303798,303798,303799,0,1,5
86627,3,2,303801,303801,303803,0,2,2
86628,4,1,303805,303805,303806,0,1,2
86629,4,2,303809,303809,303811,0,2,3
86630,5,2,303814,303814,303816,0,2,3
86631,3,1,303817,303817,303818,0,1,1
86632,3,2,303820,303820,303822,0,2,2
86633,5,3,303825,303825,303828,0,3,3
86634,3,3,303828,303828,303831,0,3,0
86635,4,3,303832,303832,303835,0,3,1
86636,5,1,303837,303837,303838,0,1,2
86637,5,1,303842,303842,303843,0,1,4
86638,4,1,303846,303846,303847,0,1,3
86639,2,1,303848,303848,303849,0,1,1
86640,6,1,303854,303854,303855,0,1,5
86641,2,1,303856,303856,303857,0,1,1
86642,1,2,303857,303857,303859,0,2,0
86643,5,3,303862,303862,303865,0,3,3
86644,1,2,303863,303865,303867,2,4,0
86645,4,1,303867,303867,303868,0,1,0
86646,6,2,303873,303873,303875,0,2,5
86647,4,1,303877,303877,303878,0,1,2
86648,2,1,303879,303879,303880,0,1,1
86649,3,1,303882,303882,303883,0,1,2
86650,1,1,303883,303883,303884,0,1,0
86651,2,3,303885,303885,303888,0,3,1
86652,5,3,303890,303890,303893,0,3,2
86653,2,2,303892,303893,303895,1,3,0
86654,4,3,303896,303896,303899,0,3,1
86655,4,2,303900,303900,303902,0,2,1
86656,2,2,303902,303902,303904,0,2,0
86657,1,2,303903,303904,303906,1,3,0
86658,1,3,303904,303906,303909,2,5,0
86659,5,2,303909,303909,303911,0,2,0
86660,3,2,303912,303912,303914,0,2,1
86661,1,1,303913,303914,303915,1,2,0
86662,5,3,303918,303918,303921,0,3,3
86663,2,3,303920,303921,303924,1,4,0
86664,3,2,303923,303924,303926,1,3,0
86665,3,1,303926,303926,303927,0,1,0
86666,5,3,303931,303931,303934,0,3,4
86667,2,3,303933,303934,303937,1,4,0
86668,2,3,303935,303937,303940,2,5,0
86669,2,2,303937,303940,303942,3,5,0
86670,3,2,303940,303942,303944,2,4,0
86671,1,3,303941,303944,303947,3,6,0
86672,1,2,303942,303947,303949,5,7,0
86673,5,2,303947,303949,303951,2,4,0
86674,5,1,303952,303952,303953,0,1,1
86675,1,2,303953,303953,303955,0,2,0
86676,5,2,303958,303958,303960,0,2,3
86677,5,1,303963,303963,303964,0,1,3
86678,5,2,303968,303968,303970,0,2,4
86679,3,3,303971,303971,303974,0,3,1
86680,3,3,303974,303974,303977,0,3,0
86681,5,2,303979,303979,303981,0,2,2
86682,5,3,303984,303984,303987,0,3,3
86683,3,1,303987,303987,303988,0,1,0
86684,2,3,303989,303989,303992,0,3,1
86685,1,3,303990,303992,303995,2,5,0
86686,5,1,303995,303995,303996,0,1,0
86687,5,1,304000,304000,304001,0,1,4
86688,2,1,304002,304002,304003,0,1,1
86689,4,2,304006,304006,304008,0,2,3
86690,4,3,304010,304010,304013,0,3,2
86691,3,2,304013,304013,304015,0,2,0
86692,4,2,304017,304017,304019,0,2,2
86693,4,1,304021,304021,304022,0,1,2
86694,4,2,304025,304025,304027,0,2,3
86695,1,3,304026,304027,304030,1,4,0
86696,4,1,304030,304030,304031,0,1,0
86697,3,2,304033,304033,304035,0,2,2
86698,6,3,304039,304039,304042,0,3,4
86699,5,3,304044,304044,304047,0,3,2
86700,1,1,304045,304047,304048,2,3,0
86701,4,2,304049,304049,304051,0,2,1
86702,2,3,304051,304051,304054,0,3,0
86703,2,1,304053,304054,304055,1,2,0
86704,2,1,304055,304055,304056,0,1,0
86705,1,1,304056,304056,304057,0,1,0
86706,1,1,304057,304057,304058,0,1,0
86707,6,1,304063,304063,304064,0,1,5
86708,2,3,304065,304065,304068,0,3,1
86709,6,3,304071,304071,304074,0,3,3
86710,5,1,304076,304076,304077,0,1,2
86711,6,3,304082,304082,304085,0,3,5
86712,4,1,304086,304086,304087,0,1,1
86713,4,2,304090,304090,304092,0,2,3
86714,6,3,304096,304096,304099,0,3,4
86715,3,1,304099,304099,304100,0,1,0
86716,3,2,304102,304102,304104,0,2,2
86717,3,2,304105,304105,304107,0,2,1
86718,6,2,304111,304111,304113,0,2,4
86719,6,3,304117,304117,304120,0,3,4
86720,6,3,304123,304123,304126,0,3,3
86721,5,2,304128,304128,304130,0,2,2
86722,2,1,304130,304130,304131,0,1,0
86723,5,2,304135,304135,304137,0,2,4
86724,1,3,304136,304137,304140,1,4,0
86725,1,2,304137,304140,304142,3,5,0
86726,2,2,304139,304142,304144,3,5,0
86727,2,3,304141,304144,304147,3,6,0
86728,2,1,304143,304147,304148,4,5,0
86729,6,1,304149,304149,304150,0,1,1
86730,2,1,304151,304151,304152,0,1,1
86731,6,3,304157,304157,304160,0,3,5
86732,1,3,304158,304160,304163,2,5,0
86733,4,1,304162,304163,304164,1,2,0
86734,4,3,304166,304166,304169,0,3,2
86735,2,1,304168,304169,304170,1,2,0
86736,6,2,304174,304174,304176,0,2,4
86737,6,2,304180,304180,304182,0,2,4
86738,4,1,304184,304184,304185,0,1,2
86739,2,1,304186,304186,304187,0,1,1
86740,1,1,304187,304187,304188,0,1,0
86741,5,1,304192,304192,304193,0,1,4
86742,3,3,304195,304195,304198,0,3,2
86743,2,1,304197,304198,304199,1,2,0
86744,3,1,304200,304200,304201,0,1,1
86745,5,2,304205,304205,304207,0,2,4
86746,4,3,304209,304209,304212,0,3,2
86747,3,1,304212,304212,304213,0,1,0
86748,2,2,304214,304214,304216,0,2,1
86749,6,3,304220,304220,304223,0,3,4
86750,2,1,304222,304223,304224,1,2,0
86751,4,2,304226,304226,304228,0,2,2
86752,6,2,304232,304232,304234,0,2,4
86753,6,1,304238,304238,304239,0,1,4
86754,4,2,304242,304242,304244,0,2,3
86755,3,3,304245,304245,304248,0,3,1
86756,1,3,304246,304248,304251,2,5,0
86757,5,2,304251,304251,304253,0,2,0
86758,1,2,304252,304253,304255,1,3,0
86759,5,3,304257,304257,304260,0,3,2
86760,3,3,304260,304260,304263,0,3,0
86761,1,1,304261,304263,304264,2,3,0
86762,6,3,304267,304267,304270,0,3,3
86763,4,1,304271,304271,304272,0,1,1
86764,4,1,304275,304275,304276,0,1,3
86765,1,2,304276,304276,304278,0,2,0
86766,3,1,304279,304279,304280,0,1,1
86767,3,2,304282,304282,304284,0,2,2
86768,2,3,304284,304284,304287,0,3,0
86769,1,3,304285,304287,304290,2,5,0
86770,2,2,304287,304290,304292,3,5,0
86771,6,3,304293,304293,304296,0,3,1
86772,2,1,304295,304296,304297,1,2,0
86773,5,1,304300,304300,304301,0,1,3
86774,2,1,304302,304302,304303,0,1,1
86775,5,2,304307,304307,304309,0,2,4
86776,4,3,304311,304311,304314,0,3,2
86777,4,1,304315,304315,304316,0,1,1
86778,6,1,304321,304321,304322,0,1,5
86779,1,1,304322,304322,304323,0,1,0
86780,4,1,304326,304326,304327,0,1,3
86781,6,2,304332,304332,304334,0,2,5
86782,1,3,304333,304334,304337,1,4,0
86783,6,3,304339,304339,304342,0,3,2
86784,4,1,304343,304343,304344,0,1,1
86785,5,3,304348,304348,304351,0,3,4
86786,3,1,304351,304351,304352,0,1,0
86787,2,1,304353,304353,304354,0,1,1
86788,6,3,304359,304359,304362,0,3,5
86789,5,2,304364,304364,304366,0,2,2
86790,1,1,304365,304366,304367,1,2,0
86791,4,2,304369,304369,304371,0,2,2
86792,3,1,304372,304372,304373,0,1,1
86793,2,2,304374,304374,304376,0,2,1
86794,5,1,304379,304379,304380,0,1,3
86795,6,1,304385,304385,304386,0,1,5
86796,5,3,304390,304390,304393,0,3,4
86797,5,2,304395,304395,304397,0,2,2
86798,5,3,304400,304400,304403,0,3,3
86799,1,1,304401,304403,304404,2,3,0
86800,5,2,304406,304406,304408,0,2,2
86801,4,1,304410,304410,304411,0,1,2
86802,5,1,304415,304415,304416,0,1,4
86803,4,2,304419,304419,304421,0,2,3
86804,2,3,304421,304421,304424,0,3,0
86805,2,2,304423,304424,304426,1,3,0
86806,1,2,304424,304426,304428,2,4,0
86807,2,3,304426,304428,304431,2,5,0
86808,6,1,304432,304432,304433,0,1,1
86809,3,3,304435,304435,304438,0,3,2
86810,5,3,304440,304440,304443,0,3,2
86811,2,2,304442,304443,304445,1,3,0
86812,1,1,304443,304445,304446,2,3,0
86813,5,1,304448,304448,304449,0,1,2
86814,2,3,304450,304450,304453,0,3,1
86815,2,2,304452,304453,304455,1,3,0
86816,2,1,304454,304455,304456,1,2,0
86817,5,1,304459,304459,304460,0,1,3
86818,4,3,304463,304463,304466,0,3,3
86819,2,3,304465,304466,304469,1,4,0
86820,6,1,304471,304471,304472,0,1,2
86821,2,1,304473,304473,304474,0,1,1
86822,2,3,304475,304475,304478,0,3,1
86823,4,1,304479,304479,304480,0,1,1
86824,1,3,304480,304480,304483,0,3,0
86825,2,3,304482,304483,304486,1,4,0
86826,3,1,304485,304486,304487,1,2,0
86827,3,3,304488,304488,304491,0,3,1
86828,4,2,304492,304492,304494,0,2,1
86829,5,2,304497,304497,304499,0,2,3
86830,3,3,304500,304500,304503,0,3,1
86831,3,2,304503,304503,304505,0,2,0
86832,4,3,304507,304507,304510,0,3,2
86833,3,3,304510,304510,304513,0,3,0
86834,6,2,304516,304516,304518,0,2,3
86835,3,2,304519,304519,304521,0,2,1
86836,3,2,304522,304522,304524,0,2,1
86837,2,1,304524,304524,304525,0,1,0
86838,2,2,304526,304526,304528,0,2,1
86839,4,3,304530,304530,304533,0,3,2
86840,4,3,304534,304534,304537,0,3,1
86841,6,3,304540,304540,304543,0,3,3
86842,4,1,304544,304544,304545,0,1,1
86843,5,2,304549,304549,304551,0,2,4
86844,4,3,304553,304553,304556,0,3,2
86845,4,3,304557,304557,304560,0,3,1
86846,1,2,304558,304560,304562,2,4,0
86847,4,2,304562,304562,304564,0,2,0
86848,1,2,304563,304564,304566,1,3,0
86849,1,1,304564,304566,304567,2,3,0
86850,2,1,304566,304567,304568,1,2,0
86851,5,1,304571,304571,304572,0,1,3
86852,4,2,304575,304575,304577,0,2,3
86853,4,2,304579,304579,304581,0,2,2
86854,6,2,304585,304585,304587,0,2,4
86855,3,2,304588,304588,304590,0,2,1
86856,2,3,304590,304590,304593,0,3,0
86857,6,3,304596,304596,304599,0,3,3
86858,2,1,304598,304599,304600,1,2,0
86859,5,1,304603,304603,304604,0,1,3
86860,5,2,304608,304608,304610,0,2,4
86861,4,2,304612,304612,304614,0,2,2
86862,3,1,304615,304615,304616,0,1,1
86863,4,1,304619,304619,304620,0,1,3
86864,5,2,304624,304624,304626,0,2,4
86865,5,1,304629,304629,304630,0,1,3
86866,4,1,304633,304633,304634,0,1,3
86867,3,1,304636,304636,304637,0,1,2
86868,6,3,304642,304642,304645,0,3,5
86869,2,2,304644,304645,304647,1,3,0
86870,5,2,304649,304649,304651,0,2,2
86871,4,1,304653,304653,304654,0,1,2
86872,1,2,304654,304654,304656,0,2,0
86873,4,2,304658,304658,304660,0,2,2
86874,2,1,304660,304660,304661,0,1,0
86875,2,3,304662,304662,304665,0,3,1
86876,5,1,304667,304667,304668,0,1,2
86877,6,1,304673,304673,304674,0,1,5
86878,1,2,304674,304674,304676,0,2,0
86879,3,2,304677,304677,304679,0,2,1
86880,2,2,304679,304679,304681,0,2,0
86881,3,1,304682,304682,304683,0,1,1
86882,5,1,304687,304687,304688,0,1,4
86883,4,3,304691,304691,304694,0,3,3
86884,3,3,304694,304694,304697,0,3,0
86885,1,2,304695,304697,304699,2,4,0
86886,5,3,304700,304700,304703,0,3,1
86887,5,1,304705,304705,304706,0,1,2
86888,6,2,304711,304711,304713,0,2,5
86889,5,1,304716,304716,304717,0,1,3
86890,6,3,304722,304722,304725,0,3,5
86891,3,1,304725,304725,304726,0,1,0
86892,4,3,304729,304729,304732,0,3,3
86893,1,1,304730,304732,304733,2,3,0
86894,3,2,304733,304733,304735,0,2,0
86895,2,1,304735,304735,304736,0,1,0
86896,6,3,304741,304741,304744,0,3,5
86897,6,2,304747,304747,304749,0,2,3
86898,2,3,304749,304749,304752,0,3,0
86899,1,3,304750,304752,304755,2,5,0
86900,2,2,304752,304755,304757,3,5,0
86901,5,3,304757,304757,304760,0,3,0
86902,2,1,304759,304760,304761,1,2,0
86903,4,2,304763,304763,304765,0,2,2
86904,5,3,304768,304768,304771,0,3,3
86905,2,3,304770,304771,304774,1,4,0
86906,1,1,304771,304774,304775,3,4,0
86907,1,1,304772,304775,304776,3,4,0
86908,5,1,304777,304777,304778,0,1,1
86909,2,3,304779,304779,304782,0,3,1
86910,2,2,304781,304782,304784,1,3,0
86911,6,2,304787,304787,304789,0,2,3
86912,1,3,304788,304789,304792,1,4,0
86913,1,3,304789,304792,304795,3,6,0
86914,1,2,304790,304795,304797,5,7,0
86915,2,1,304792,304797,304798,5,6,0
86916,4,3,304796,304798,304801,2,5,0
86917,1,1,304797,304801,304802,4,5,0
86918,1,3,304798,304802,304805,4,7,0
86919,5,1,304803,304805,304806,2,3,0
86920,4,3,304807,304807,304810,0,3,1
86921,1,2,304808,304810,304812,2,4,0
86922,6,2,304814,304814,304816,0,2,2
86923,1,1,304815,304816,304817,1,2,0
86924,5,2,304820,304820,304822,0,2,3
86925,1,1,304821,304822,304823,1,2,0
86926,2,3,304823,304823,304826,0,3,0
86927,6,3,304829,304829,304832,0,3,3
86928,5,3,304834,304834,304837,0,3,2
86929,5,1,304839,304839,304840,0,1,2
86930,3,3,304842,304842,304845,0,3,2
86931,3,1,304845,304845,304846,0,1,0
86932,3,1,304848,304848,304849,0,1,2
86933,3,1,304851,304851,304852,0,1,2
86934,6,1,304857,304857,304858,0,1,5
86935,6,3,304863,304863,304866,0,3,5
86936,6,3,304869,304869,304872,0,3,3
86937,2,1,304871,304872,304873,1,2,0
86938,1,1,304872,304873,304874,1,2,0
86939,5,3,304877,304877,304880,0,3,3
86940,6,3,304883,304883,304886,0,3,3
86941,3,2,304886,304886,304888,0,2,0
86942,4,3,304890,304890,304893,0,3,2
86943,3,2,304893,304893,304895,0,2,0
86944,1,3,304894,304895,304898,1,4,0
86945,5,3,304899,304899,304902,0,3,1
86946,2,2,304901,304902,304904,1,3,0
86947,6,2,304907,304907,304909,0,2,3
86948,3,2,304910,304910,304912,0,2,1
86949,5,3,304915,304915,304918,0,3,3
86950,3,2,304918,304918,304920,0,2,0
86951,4,2,304922,304922,304924,0,2,2
86952,2,3,304924,304924,304927,0,3,0
86953,2,2,304926,304927,304929,1,3,0
86954,2,2,304928,304929,304931,1,3,0
86955,4,2,304932,304932,304934,0,2,1
86956,3,1,304935,304935,304936,0,1,1
86957,2,3,304937,304937,304940,0,3,1
86958,4,2,304941,304941,304943,0,2,1
86959,1,1,304942,304943,304944,1,2,0
86960,3,2,304945,304945,304947,0,2,1
86961,1,2,304946,304947,304949,1,3,0
86962,5,3,304951,304951,304954,0,3,2
86963,2,1,304953,304954,304955,1,2,0
86964,4,2,304957,304957,304959,0,2,2
86965,3,3,304960,304960,304963,0,3,1
86966,2,3,304962,304963,304966,1,4,0
86967,4,1,304966,304966,304967,0,1,0
86968,3,3,304969,304969,304972,0,3,2
86969,4,1,304973,304973,304974,0,1,1
86970,5,1,304978,304978,304979,0,1,4
86971,5,3,304983,304983,304986,0,3,4
86972,6,2,304989,304989,304991,0,2,3
86973,4,3,304993,304993,304996,0,3,2
86974,1,3,304994,304996,304999,2,5,0
86975,6,3,305000,305000,305003,0,3,1
86976,5,2,305005,305005,305007,0,2,2
86977,1,3,305006,305007,305010,1,4,0
86978,3,1,305009,305010,305011,1,2,0
86979,4,1,305013,305013,305014,0,1,2
86980,4,2,305017,305017,305019,0,2,3
86981,6,1,305023,305023,305024,0,1,4
86982,3,2,305026,305026,305028,0,2,2
86983,2,2,305028,305028,305030,0,2,0
86984,5,3,305033,305033,305036,0,3,3
86985,6,2,305039,305039,305041,0,2,3
86986,2,3,305041,305041,305044,0,3,0
86987,3,1,305044,305044,305045,0,1,0
86988,6,1,305050,305050,305051,0,1,5
86989,2,1,305052,305052,305053,0,1,1
86990,5,2,305057,305057,305059,0,2,4
86991,3,1,305060,305060,305061,0,1,1
86992,2,2,305062,305062,305064,0,2,1
86993,3,3,305065,305065,305068,0,3,1
86994,3,2,305068,305068,305070,0,2,0
86995,1,1,305069,305070,305071,1,2,0
86996,6,2,305075,305075,305077,0,2,4
86997,6,2,305081,305081,305083,0,2,4
86998,2,2,305083,305083,305085,0,2,0
86999,3,3,305086,305086,305089,0,3,1
87000,4,3,305090,305090,305093,0,3,1
87001,6,2,305096,305096,305098,0,2,3
87002,6,2,305102,305102,305104,0,2,4
87003,4,2,305106,305106,305108,0,2,2
87004,5,1,305111,305111,305112,0,1,3
87005,1,2,305112,305112,305114,0,2,0
87006,2,1,305114,305114,305115,0,1,0
87007,4,1,305118,305118,305119,0,1,3
87008,5,2,305123,305123,305125,0,2,4
87009,5,2,305128,305128,305130,0,2,3
87010,2,2,305130,305130,305132,0,2,0
87011,4,1,305134,305134,305135,0,1,2
87012,3,1,305137,305137,305138,0,1,2
87013,3,3,305140,305140,305143,0,3,2
87014,4,1,305144,305144,305145,0,1,1
87015,2,3,305146,305146,305149,0,3,1
87016,1,1,305147,305149,305150,2,3,0
87017,6,3,305153,305153,305156,0,3,3
87018,1,2,305154,305156,305158,2,4,0
87019,4,2,305158,305158,305160,0,2,0
87020,2,2,305160,305160,305162,0,2,0
87021,2,1,305162,305162,305163,0,1,0
87022,6,2,305168,305168,305170,0,2,5
87023,1,1,305169,305170,305171,1,2,0
87024,1,2,305170,305171,305173,1,3,0
87025,4,2,305174,305174,305176,0,2,1
87026,1,1,305175,305176,305177,1,2,0
87027,1,1,305176,305177,305178,1,2,0
87028,5,3,305181,305181,305184,0,3,3
87029,2,2,305183,305184,305186,1,3,0
87030,5,3,305188,305188,305191,0,3,2
87031,5,2,305193,305193,305195,0,2,2
87032,6,1,305199,305199,305200,0,1,4
87033,1,2,305200,305200,305202,0,2,0
87034,5,1,305205,305205,305206,0,1,3
87035,5,2,305210,305210,305212,0,2,4
87036,3,3,305213,305213,305216,0,3,1
87037,5,2,305218,305218,305220,0,2,2
87038,2,3,305220,305220,305223,0,3,0
87039,6,2,305226,305226,305228,0,2,3
87040,1,3,305227,305228,305231,1,4,0
87041,2,1,305229,305231,305232,2,3,0
87042,5,3,305234,305234,305237,0,3,2
87043,1,2,305235,305237,305239,2,4,0
87044,3,2,305238,305239,305241,1,3,0
87045,1,3,305239,305241,305244,2,5,0
87046,2,1,305241,305244,305245,3,4,0
87047,2,3,305243,305245,305248,2,5,0
87048,6,1,305249,305249,305250,0,1,1
87049,3,3,305252,305252,305255,0,3,2
87050,4,2,305256,305256,305258,0,2,1
87051,6,1,305262,305262,305263,0,1,4
87052,6,3,305268,305268,305271,0,3,5
87053,2,3,305270,305271,305274,1,4,0
87054,2,2,305272,305274,305276,2,4,0
87055,6,3,305278,305278,305281,0,3,2
87056,3,1,305281,305281,305282,0,1,0
87057,5,1,305286,305286,305287,0,1,4
87058,4,3,305290,305290,305293,0,3,3
87059,3,2,305293,305293,305295,0,2,0
87060,5,1,305298,305298,305299,0,1,3
87061,2,3,305300,305300,305303,0,3,1
87062,6,3,305306,305306,305309,0,3,3
87063,1,3,305307,305309,305312,2,5,0
87064,5,2,305312,305312,305314,0,2,0
87065,6,2,305318,305318,305320,0,2,4
87066,6,2,305324,305324,305326,0,2,4
87067,2,2,305326,305326,305328,0,2,0
87068,2,2,305328,305328,305330,0,2,0
87069,2,1,305330,305330,305331,0,1,0
87070,5,2,305335,305335,305337,0,2,4
87071,4,3,305339,305339,305342,0,3,2
87072,1,3,305340,305342,305345,2,5,0
87073,5,2,305345,305345,305347,0,2,0
87074,5,1,305350,305350,305351,0,1,3
87075,3,1,305353,305353,305354,0,1,2
87076,5,1,305358,305358,305359,0,1,4
87077,3,2,305361,305361,305363,0,2,2
87078,3,3,305364,305364,305367,0,3,1
87079,1,1,305365,305367,305368,2,3,0
87080,6,2,305371,305371,305373,0,2,3
87081,6,1,305377,305377,305378,0,1,4
87082,4,2,305381,305381,305383,0,2,3
87083,4,2,305385,305385,305387,0,2,2
87084,6,2,305391,305391,305393,0,2,4
87085,4,2,305395,305395,305397,0,2,2
87086,5,3,305400,305400,305403,0,3,3
87087,6,2,305406,305406,305408,0,2,3
87088,2,1,305408,305408,305409,0,1,0
87089,4,3,305412,305412,305415,0,3,3
87090,1,1,305413,305415,305416,2,3,0
87091,6,2,305419,305419,305421,0,2,3
87092,2,1,305421,305421,305422,0,1,0
87093,2,2,305423,305423,305425,0,2,1
87094,4,1,305427,305427,305428,0,1,2
87095,4,1,305431,305431,305432,0,1,3
87096,4,3,305435,305435,305438,0,3,3
87097,2,1,305437,305438,305439,1,2,0
87098,4,2,305441,305441,305443,0,2,2
87099,2,1,305443,305443,305444,0,1,0
87100,5,2,305448,305448,305450,0,2,4
87101,6,3,305454,305454,305457,0,3,4
87102,6,1,305460,305460,305461,0,1,3
87103,5,1,305465,305465,305466,0,1,4
87104,5,1,305470,305470,305471,0,1,4
87105,5,1,305475,305475,305476,0,1,4
87106,3,2,305478,305478,305480,0,2,2
87107,4,3,305482,305482,305485,0,3,2
87108,2,3,305484,305485,305488,1,4,0
87109,1,1,305485,305488,305489,3,4,0
87110,4,2,305489,305489,305491,0,2,0
87111,4,3,305493,305493,305496,0,3,2
87112,1,3,305494,305496,305499,2,5,0
87113,6,2,305500,305500,305502,0,2,1
87114,5,1,305505,305505,305506,0,1,3
87115,3,3,305508,305508,305511,0,3,2
87116,3,1,305511,305511,305512,0,1,0
87117,5,1,305516,305516,305517,0,1,4
87118,3,3,305519,305519,305522,0,3,2
87119,5,2,305524,305524,305526,0,2,2
87120,6,1,305530,305530,305531,0,1,4
87121,3,2,305533,305533,305535,0,2,2
87122,4,2,305537,305537,305539,0,2,2
87123,2,2,305539,305539,305541,0,2,0
87124,2,2,305541,305541,305543,0,2,0
87125,2,3,305543,305543,305546,0,3,0
87126,4,2,305547,305547,305549,0,2,1
87127,4,2,305551,305551,305553,0,2,2
87128,4,3,305555,305555,305558,0,3,2
87129,5,3,305560,305560,305563,0,3,2
87130,2,1,305562,305563,305564,1,2,0
87131,4,2,305566,305566,305568,0,2,2
87132,4,2,305570,305570,305572,0,2,2
87133,3,3,305573,305573,305576,0,3,1
87134,6,1,305579,305579,305580,0,1,3
87135,3,3,305582,305582,305585,0,3,2
87136,6,2,305588,305588,305590,0,2,3
87137,4,3,305592,305592,305595,0,3,2
87138,3,1,305595,305595,305596,0,1,0
87139,6,3,305601,305601,305604,0,3,5
87140,5,2,305606,305606,305608,0,2,2
87141,5,1,305611,305611,305612,0,1,3
87142,2,2,305613,305613,305615,0,2,1
87143,6,3,305619,305619,305622,0,3,4
87144,1,1,305620,305622,305623,2,3,0
87145,6,2,305626,305626,305628,0,2,3
87146,6,1,305632,305632,305633,0,1,4
87147,3,2,305635,305635,305637,0,2,2
87148,1,1,305636,305637,305638,1,2,0
87149,5,2,305641,305641,305643,0,2,3
87150,5,1,305646,305646,305647,0,1,3
87151,3,2,305649,305649,305651,0,2,2
87152,2,2,305651,305651,305653,0,2,0
87153,5,3,305656,305656,305659,0,3,3
87154,2,2,305658,305659,305661,1,3,0
87155,1,1,305659,305661,305662,2,3,0
87156,6,1,305665,305665,305666,0,1,3
87157,2,3,305667,305667,305670,0,3,1
87158,2,2,305669,305670,305672,1,3,0
87159,5,1,305674,305674,305675,0,1,2
87160,6,2,305680,305680,305682,0,2,5
87161,1,2,305681,305682,305684,1,3,0
87162,5,2,305686,305686,305688,0,2,2
87163,4,1,305690,305690,305691,0,1,2
87164,2,3,305692,305692,305695,0,3,1
87165,1,1,305693,305695,305696,2,3,0
87166,2,2,305695,305696,305698,1,3,0
87167,4,3,305699,305699,305702,0,3,1
87168,2,2,305701,305702,305704,1,3,0
87169,5,1,305706,305706,305707,0,1,2
87170,2,3,305708,305708,305711,0,3,1
87171,4,1,305712,305712,305713,0,1,1
87172,4,2,305716,305716,305718,0,2,3
87173,5,2,305721,305721,305723,0,2,3
87174,3,1,305724,305724,305725,0,1,1
87175,6,3,305730,305730,305733,0,3,5
87176,6,1,305736,305736,305737,0,1,3
87177,4,1,305740,305740,305741,0,1,3
87178,6,2,305746,305746,305748,0,2,5
87179,1,1,305747,305748,305749,1,2,0
87180,3,3,305750,305750,305753,0,3,1
87181,6,2,305756,305756,305758,0,2,3
87182,4,3,305760,305760,305763,0,3,2
87183,6,3,305766,305766,305769,0,3,3
87184,3,3,305769,305769,305772,0,3,0
87185,2,1,305771,305772,305773,1,2,0
87186,2,1,305773,305773,305774,0,1,0
87187,2,3,305775,305775,305778,0,3,1
87188,4,2,305779,305779,305781,0,2,1
87189,6,3,305785,305785,305788,0,3,4
87190,1,3,305786,305788,305791,2,5,0
87191,4,1,305790,305791,305792,1,2,0
87192,4,2,305794,305794,305796,0,2,2
87193,5,3,305799,305799,305802,0,3,3
87194,5,3,305804,305804,305807,0,3,2
87195,5,3,305809,305809,305812,0,3,2
87196,1,3,305810,305812,305815,2,5,0
87197,2,3,305812,305815,305818,3,6,0
87198,3,1,305815,305818,305819,3,4,0
87199,2,2,305817,305819,305821,2,4,0
87200,2,2,305819,305821,305823,2,4,0
87201,6,3,305825,305825,305828,0,3,2
87202,1,2,305826,305828,305830,2,4,0
87203,3,2,305829,305830,305832,1,3,0
87204,4,2,305833,305833,305835,0,2,1
87205,5,2,305838,305838,305840,0,2,3
87206,5,2,305843,305843,305845,0,2,3
87207,3,3,305846,305846,305849,0,3,1
87208,5,3,305851,305851,305854,0,3,2
87209,4,2,305855,305855,305857,0,2,1
87210,4,3,305859,305859,305862,0,3,2
87211,4,1,305863,305863,305864,0,1,1
87212,4,2,305867,305867,305869,0,2,3
87213,6,3,305873,305873,305876,0,3,4
87214,2,3,305875,305876,305879,1,4,0
87215,2,3,305877,305879,305882,2,5,0
87216,2,1,305879,305882,305883,3,4,0
87217,1,3,305880,305883,305886,3,6,0
87218,5,3,305885,305886,305889,1,4,0
87219,4,2,305889,305889,305891,0,2,0
87220,5,1,305894,305894,305895,0,1,3
87221,6,3,305900,305900,305903,0,3,5
87222,2,3,305902,305903,305906,1,4,0
87223,3,3,305905,305906,305909,1,4,0
87224,2,1,305907,305909,305910,2,3,0
87225,4,3,305911,305911,305914,0,3,1
87226,4,2,305915,305915,305917,0,2,1
87227,6,3,305921,305921,305924,0,3,4
87228,6,1,305927,305927,305928,0,1,3
87229,5,1,305932,305932,305933,0,1,4
87230,4,3,305936,305936,305939,0,3,3
87231,2,1,305938,305939,305940,1,2,0
87232,6,1,305944,305944,305945,0,1,4
87233,6,3,305950,305950,305953,0,3,5
87234,1,2,305951,305953,305955,2,4,0
87235,2,3,305953,305955,305958,2,5,0
87236,5,2,305958,305958,305960,0,2,0
87237,4,2,305962,305962,305964,0,2,2
87238,2,1,305964,305964,305965,0,1,0
87239,4,3,305968,305968,305971,0,3,3
87240,6,2,305974,305974,305976,0,2,3
87241,6,3,305980,305980,305983,0,3,4
87242,1,3,305981,305983,305986,2,5,0
87243,1,2,305982,305986,305988,4,6,0
87244,4,2,305986,305988,305990,2,4,0
87245,1,3,305987,305990,305993,3,6,0
87246,3,1,305990,305993,305994,3,4,0
87247,6,1,305996,305996,305997,0,1,2
87248,2,3,305998,305998,306001,0,3,1
87249,4,2,306002,306002,306004,0,2,1
87250,1,2,306003,306004,306006,1,3,0
87251,5,2,306008,306008,306010,0,2,2
87252,1,1,306009,306010,306011,1,2,0
87253,5,3,306014,306014,306017,0,3,3
87254,4,1,306018,306018,306019,0,1,1
87255,3,1,306021,306021,306022,0,1,2
87256,2,1,306023,306023,306024,0,1,1
87257,4,1,306027,306027,306028,0,1,3
87258,3,3,306030,306030,306033,0,3,2
87259,3,1,306033,306033,306034,0,1,0
87260,4,1,306037,306037,306038,0,1,3
87261,3,2,306040,306040,306042,0,2,2
87262,5,1,306045,306045,306046,0,1,3
87263,5,3,306050,306050,306053,0,3,4
87264,1,1,306051,306053,306054,2,3,0
87265,4,1,306055,306055,306056,0,1,1
87266,1,2,306056,306056,306058,0,2,0
87267,4,3,306060,306060,306063,0,3,2
87268,6,1,306066,306066,306067,0,1,3
87269,2,1,306068,306068,306069,0,1,1
87270,4,2,306072,306072,306074,0,2,3
87271,4,1,306076,306076,306077,0,1,2
87272,5,2,306081,306081,306083,0,2,4
87273,2,1,306083,306083,306084,0,1,0
87274,1,2,306084,306084,306086,0,2,0
87275,4,2,306088,306088,306090,0,2,2
87276,1,3,306089,306090,306093,1,4,0
87277,3,3,306092,306093,306096,1,4,0
87278,4,1,306096,306096,306097,0,1,0
87279,6,2,306102,306102,306104,0,2,5
87280,3,3,306105,306105,306108,0,3,1
87281,3,1,306108,306108,306109,0,1,0
87282,2,2,306110,306110,306112,0,2,1
87283,6,1,306116,306116,306117,0,1,4
87284,5,2,306121,306121,306123,0,2,4
87285,2,2,306123,306123,306125,0,2,0
87286,4,1,306127,306127,306128,0,1,2
87287,1,3,306128,306128,306131,0,3,0
87288,5,3,306133,306133,306136,0,3,2
87289,4,2,306137,306137,306139,0,2,1
87290,4,3,306141,306141,306144,0,3,2
87291,5,3,306146,306146,306149,0,3,2
87292,1,3,306147,306149,306152,2,5,0
87293,1,1,306148,306152,306153,4,5,0
87294,1,3,306149,306153,306156,4,7,0
87295,1,1,306150,306156,306157,6,7,0
87296,2,1,306152,306157,306158,5,6,0
87297,6,1,306158,306158,306159,0,1,0
87298,2,1,306160,306160,306161,0,1,1
87299,3,2,306163,306163,306165,0,2,2
87300,6,3,306169,306169,306172,0,3,4
87301,1,3,306170,306172,306175,2,5,0
87302,2,3,306172,306175,306178,3,6,0
87303,4,1,306176,306178,306179,2,3,0
87304,2,2,306178,306179,306181,1,3,0
87305,3,1,306181,306181,306182,0,1,0
87306,4,3,306185,306185,306188,0,3,3
87307,1,2,306186,306188,306190,2,4,0
87308,1,2,306187,306190,306192,3,5,0
87309,1,1,306188,306192,306193,4,5,0
87310,3,2,306191,306193,306195,2,4,0
87311,6,2,306197,306197,306199,0,2,2
87312,2,1,306199,306199,306200,0,1,0
87313,3,1,306202,306202,306203,0,1,2
87314,1,2,306203,306203,306205,0,2,0
87315,1,3,306204,306205,306208,1,4,0
87316,2,1,306206,306208,306209,2,3,0
87317,3,3,306209,306209,306212,0,3,0
87318,3,2,306212,306212,306214,0,2,0
87319,4,2,306216,306216,306218,0,2,2
87320,4,1,306220,306220,306221,0,1,2
87321,5,2,306225,306225,306227,0,2,4
87322,2,3,306227,306227,306230,0,3,0
87323,2,1,306229,306230,306231,1,2,0
87324,6,2,306235,306235,306237,0,2,4
87325,4,1,306239,306239,306240,0,1,2
87326,6,1,306245,306245,306246,0,1,5
87327,5,1,306250,306250,306251,0,1,4
87328,3,3,306253,306253,306256,0,3,2
87329,1,3,306254,306256,306259,2,5,0
87330,2,3,306256,306259,306262,3,6,0
87331,1,1,306257,306262,306263,5,6,0
87332,6,1,306263,306263,306264,0,1,0
87333,5,2,306268,306268,306270,0,2,4
87334,3,3,306271,306271,306274,0,3,1
87335,3,2,306274,306274,306276,0,2,0
87336,4,3,306278,306278,306281,0,3,2
87337,6,3,306284,306284,306287,0,3,3
87338,3,3,306287,306287,306290,0,3,0
87339,4,3,306291,306291,306294,0,3,1
87340,2,2,306293,306294,306296,1,3,0
87341,5,3,306298,306298,306301,0,3,2
87342,1,2,306299,306301,306303,2,4,0
87343,3,3,306302,306303,306306,1,4,0
87344,3,1,306305,306306,306307,1,2,0
87345,1,1,306306,306307,306308,1,2,0
87346,5,1,306311,306311,306312,0,1,3
87347,4,3,306315,306315,306318,0,3,3
87348,1,1,306316,306318,306319,2,3,0
87349,6,3,306322,306322,306325,0,3,3
87350,3,3,306325,306325,306328,0,3,0
87351,3,3,306328,306328,306331,0,3,0
87352,5,2,306333,306333,306335,0,2,2
87353,5,1,306338,306338,306339,0,1,3
87354,6,1,306344,306344,306345,0,1,5
87355,4,2,306348,306348,306350,0,2,3
87356,4,2,306352,306352,306354,0,2,2
87357,5,2,306357,306357,306359,0,2,3
87358,1,1,306358,306359,306360,1,2,0
87359,3,2,306361,306361,306363,0,2,1
87360,3,2,306364,306364,306366,0,2,1
87361,5,3,306369,306369,306372,0,3,3
87362,2,3,306371,306372,306375,1,4,0
87363,4,2,306375,306375,306377,0,2,0
87364,1,1,306376,306377,306378,1,2,0
87365,5,1,306381,306381,306382,0,1,3
87366,3,2,306384,306384,306386,0,2,2
87367,1,3,306385,306386,306389,1,4,0
87368,3,2,306388,306389,306391,1,3,0
87369,1,1,306389,306391,306392,2,3,0
87370,4,3,306393,306393,306396,0,3,1
87371,2,1,306395,306396,306397,1,2,0
87372,4,2,306399,306399,306401,0,2,2
87373,4,1,306403,306403,306404,0,1,2
87374,4,1,306407,306407,306408,0,1,3
87375,6,3,306413,306413,306416,0,3,5
87376,4,2,306417,306417,306419,0,2,1
87377,5,2,306422,306422,306424,0,2,3
87378,4,2,306426,306426,306428,0,2,2
87379,5,2,306431,306431,306433,0,2,3
87380,6,1,306437,306437,306438,0,1,4
87381,5,1,306442,306442,306443,0,1,4
87382,6,3,306448,306448,306451,0,3,5
87383,4,1,306452,306452,306453,0,1,1
87384,6,2,306458,306458,306460,0,2,5
87385,2,2,306460,306460,306462,0,2,0
87386,1,2,306461,306462,306464,1,3,0
87387,5,3,306466,306466,306469,0,3,2
87388,6,3,306472,306472,306475,0,3,3
87389,2,1,306474,306475,306476,1,2,0
87390,5,3,306479,306479,306482,0,3,3
87391,1,3,306480,306482,306485,2,5,0
87392,4,3,306484,306485,306488,1,4,0
87393,6,1,306490,306490,306491,0,1,2
87394,2,3,306492,306492,306495,0,3,1
87395,5,3,306497,306497,306500,0,3,2
87396,6,2,306503,306503,306505,0,2,3
87397,3,2,306506,306506,306508,0,2,1
87398,1,1,306507,306508,306509,1,2,0
87399,3,1,306510,306510,306511,0,1,1
87400,4,2,306514,306514,306516,0,2,3
87401,4,3,306518,306518,306521,0,3,2
87402,6,2,306524,306524,306526,0,2,3
87403,2,1,306526,306526,306527,0,1,0
87404,1,2,306527,306527,306529,0,2,0
87405,1,3,306528,306529,306532,1,4,0
87406,2,2,306530,306532,306534,2,4,0
87407,4,1,306534,306534,306535,0,1,0
87408,4,2,306538,306538,306540,0,2,3
87409,2,1,306540,306540,306541,0,1,0
87410,3,3,306543,306543,306546,0,3,2
87411,1,3,306544,306546,306549,2,5,0
87412,6,3,306550,306550,306553,0,3,1
87413,2,3,306552,306553,306556,1,4,0
87414,1,1,306553,306556,306557,3,4,0
87415,4,3,306557,306557,306560,0,3,0
87416,5,2,306562,306562,306564,0,2,2
87417,5,3,306567,306567,306570,0,3,3
87418,2,3,306569,306570,306573,1,4,0
87419,4,2,306573,306573,306575,0,2,0
87420,4,1,306577,306577,306578,0,1,2
87421,2,2,306579,306579,306581,0,2,1
87422,4,1,306583,306583,306584,0,1,2
87423,2,2,306585,306585,306587,0,2,1
87424,4,3,306589,306589,306592,0,3,2
87425,4,2,306593,306593,306595,0,2,1
87426,6,3,306599,306599,306602,0,3,4
87427,1,1,306600,306602,306603,2,3,0
87428,2,1,306602,306603,306604,1,2,0
87429,6,3,306608,306608,306611,0,3,4
87430,6,3,306614,306614,306617,0,3,3
87431,2,3,306616,306617,306620,1,4,0
87432,5,3,306621,306621,306624,0,3,1
87433,1,1,306622,306624,306625,2,3,0
87434,5,2,306627,306627,306629,0,2,2
87435,1,3,306628,306629,306632,1,4,0
87436,5,3,306633,306633,306636,0,3,1
87437,6,2,306639,306639,306641,0,2,3
87438,3,1,306642,306642,306643,0,1,1
87439,5,2,306647,306647,306649,0,2,4
87440,3,2,306650,306650,306652,0,2,1
87441,3,3,306653,306653,306656,0,3,1
87442,6,1,306659,306659,306660,0,1,3
87443,5,1,306664,306664,306665,0,1,4
87444,1,3,306665,306665,306668,0,3,0
87445,5,3,306670,306670,306673,0,3,2
87446,4,2,306674,306674,306676,0,2,1
87447,1,3,306675,306676,306679,1,4,0
87448,1,1,306676,306679,306680,3,4,0
87449,4,3,306680,306680,306683,0,3,0
87450,4,3,306684,306684,306687,0,3,1
87451,3,1,306687,306687,306688,0,1,0
87452,1,1,306688,306688,306689,0,1,0
87453,1,3,306689,306689,306692,0,3,0
87454,5,2,306694,306694,306696,0,2,2
87455,3,3,306697,306697,306700,0,3,1
87456,5,2,306702,306702,306704,0,2,2
87457,6,1,306708,306708,306709,0,1,4
87458,5,2,306713,306713,306715,0,2,4
87459,3,3,306716,306716,306719,0,3,1
87460,4,3,306720,306720,306723,0,3,1
87461,2,1,306722,306723,306724,1,2,0
87462,1,2,306723,306724,306726,1,3,0
87463,1,3,306724,306726,306729,2,5,0
87464,6,1,306730,306730,306731,0,1,1
87465,4,2,306734,306734,306736,0,2,3
87466,1,3,306735,306736,306739,1,4,0
87467,5,2,306740,306740,306742,0,2,1
87468,5,3,306745,306745,306748,0,3,3
87469,3,2,306748,306748,306750,0,2,0
87470,5,1,306753,306753,306754,0,1,3
87471,5,1,306758,306758,306759,0,1,4
87472,4,1,306762,306762,306763,0,1,3
87473,1,1,306763,306763,306764,0,1,0
87474,5,3,306768,306768,306771,0,3,4
87475,3,1,306771,306771,306772,0,1,0
87476,2,1,306773,306773,306774,0,1,1
87477,4,1,306777,306777,306778,0,1,3
87478,5,2,306782,306782,306784,0,2,4
87479,3,3,306785,306785,306788,0,3,1
87480,1,3,306786,306788,306791,2,5,0
87481,3,2,306789,306791,306793,2,4,0
87482,3,2,306792,306793,306795,1,3,0
87483,2,2,306794,306795,306797,1,3,0
87484,5,3,306799,306799,306802,0,3,2
87485,4,1,306803,306803,306804,0,1,1
87486,1,1,306804,306804,306805,0,1,0
87487,4,1,306808,306808,306809,0,1,3
87488,5,2,306813,306813,306815,0,2,4
87489,5,2,306818,306818,306820,0,2,3
87490,4,2,306822,306822,306824,0,2,2
87491,2,3,306824,306824,306827,0,3,0
87492,5,3,306829,306829,306832,0,3,2
87493,6,2,306835,306835,306837,0,2,3
87494,6,3,306841,306841,306844,0,3,4
87495,5,3,306846,306846,306849,0,3,2
87496,1,3,306847,306849,306852,2,5,0
87497,1,3,306848,306852,306855,4,7,0
87498,4,1,306852,306855,306856,3,4,0
87499,4,2,306856,306856,306858,0,2,0
87500,2,2,306858,306858,306860,0,2,0
87501,2,2,306860,306860,306862,0,2,0
87502,5,2,306865,306865,306867,0,2,3
87503,3,3,306868,306868,306871,0,3,1
87504,5,2,306873,306873,306875,0,2,2
87505,6,3,306879,306879,306882,0,3,4
87506,2,2,306881,306882,306884,1,3,0
87507,4,3,306885,306885,306888,0,3,1
87508,3,1,306888,306888,306889,0,1,0
87509,2,2,306890,306890,306892,0,2,1
87510,6,3,306896,306896,306899,0,3,4
87511,2,1,306898,306899,306900,1,2,0
87512,4,3,306902,306902,306905,0,3,2
87513,5,3,306907,306907,306910,0,3,2
87514,6,2,306913,306913,306915,0,2,3
87515,5,3,306918,306918,306921,0,3,3
87516,6,3,306924,306924,306927,0,3,3
87517,5,2,306929,306929,306931,0,2,2
87518,6,1,306935,306935,306936,0,1,4
87519,4,2,306939,306939,306941,0,2,3
87520,2,2,306941,306941,306943,0,2,0
87521,3,1,306944,306944,306945,0,1,1
87522,4,2,306948,306948,306950,0,2,3
87523,5,1,306953,306953,306954,0,1,3
87524,6,3,306959,306959,306962,0,3,5
87525,3,3,306962,306962,306965,0,3,0
87526,6,3,306968,306968,306971,0,3,3
87527,5,1,306973,306973,306974,0,1,2
87528,5,3,306978,306978,306981,0,3,4
87529,6,2,306984,306984,306986,0,2,3
87530,1,2,306985,306986,306988,1,3,0
87531,2,1,306987,306988,306989,1,2,0
87532,4,3,306991,306991,306994,0,3,2
87533,6,2,306997,306997,306999,0,2,3
87534,2,2,306999,306999,307001,0,2,0
87535,1,2,307000,307001,307003,1,3,0
87536,1,1,307001,307003,307004,2,3,0
87537,5,2,307006,307006,307008,0,2,2
87538,3,2,307009,307009,307011,0,2,1
87539,5,2,307014,307014,307016,0,2,3
87540,2,3,307016,307016,307019,0,3,0
87541,3,2,307019,307019,307021,0,2,0
87542,3,2,307022,307022,307024,0,2,1
87543,5,1,307027,307027,307028,0,1,3
87544,4,2,307031,307031,307033,0,2,3
87545,3,3,307034,307034,307037,0,3,1
87546,6,3,307040,307040,307043,0,3,3
87547,1,2,307041,307043,307045,2,4,0
87548,1,1,307042,307045,307046,3,4,0
87549,5,3,307047,307047,307050,0,3,1
87550,4,3,307051,307051,307054,0,3,1
87551,4,1,307055,307055,307056,0,1,1
87552,1,2,307056,307056,307058,0,2,0
87553,2,2,307058,307058,307060,0,2,0
87554,4,2,307062,307062,307064,0,2,2
87555,4,3,307066,307066,307069,0,3,2
87556,6,2,307072,307072,307074,0,2,3
87557,3,3,307075,307075,307078,0,3,1
87558,3,3,307078,307078,307081,0,3,0
87559,6,3,307084,307084,307087,0,3,3
87560,6,2,307090,307090,307092,0,2,3
87561,5,3,307095,307095,307098,0,3,3
87562,5,2,307100,307100,307102,0,2,2
87563,2,3,307102,307102,307105,0,3,0
87564,5,3,307107,307107,307110,0,3,2
87565,3,3,307110,307110,307113,0,3,0
87566,2,3,307112,307113,307116,1,4,0
87567,3,2,307115,307116,307118,1,3,0
87568,3,2,307118,307118,307120,0,2,0
87569,2,2,307120,307120,307122,0,2,0
87570,6,3,307126,307126,307129,0,3,4
87571,6,1,307132,307132,307133,0,1,3
87572,6,3,307138,307138,307141,0,3,5
87573,3,2,307141,307141,307143,0,2,0
87574,1,2,307142,307143,307145,1,3,0
87575,6,2,307148,307148,307150,0,2,3
87576,3,3,307151,307151,307154,0,3,1
87577,6,2,307157,307157,307159,0,2,3
87578,3,3,307160,307160,307163,0,3,1
87579,2,2,307162,307163,307165,1,3,0
87580,3,2,307165,307165,307167,0,2,0
87581,3,1,307168,307168,307169,0,1,1
87582,5,2,307173,307173,307175,0,2,4
87583,5,1,307178,307178,307179,0,1,3
87584,1,2,307179,307179,307181,0,2,0
87585,5,3,307184,307184,307187,0,3,3
87586,1,1,307185,307187,307188,2,3,0
87587,5,3,307190,307190,307193,0,3,2
87588,5,1,307195,307195,307196,0,1,2
87589,4,3,307199,307199,307202,0,3,3
87590,2,3,307201,307202,307205,1,4,0
87591,4,2,307205,307205,307207,0,2,0
87592,2,3,307207,307207,307210,0,3,0
87593,3,3,307210,307210,307213,0,3,0
87594,6,2,307216,307216,307218,0,2,3
87595,2,2,307218,307218,307220,0,2,0
87596,1,2,307219,307220,307222,1,3,0
87597,1,3,307220,307222,307225,2,5,0
87598,6,2,307226,307226,307228,0,2,1
87599,2,1,307228,307228,307229,0,1,0
87600,5,3,307233,307233,307236,0,3,4
87601,4,1,307237,307237,307238,0,1,1
87602,1,3,307238,307238,307241,0,3,0
87603,5,3,307243,307243,307246,0,3,2
87604,3,2,307246,307246,307248,0,2,0
87605,3,2,307249,307249,307251,0,2,1
87606,1,1,307250,307251,307252,1,2,0
87607,1,2,307251,307252,307254,1,3,0
87608,2,1,307253,307254,307255,1,2,0
87609,5,2,307258,307258,307260,0,2,3
87610,2,3,307260,307260,307263,0,3,0
87611,2,2,307262,307263,307265,1,3,0
87612,5,2,307267,307267,307269,0,2,2
87613,3,3,307270,307270,307273,0,3,1
87614,3,3,307273,307273,307276,0,3,0
87615,2,1,307275,307276,307277,1,2,0
87616,5,2,307280,307280,307282,0,2,3
87617,2,1,307282,307282,307283,0,1,0
87618,1,3,307283,307283,307286,0,3,0
87619,4,1,307287,307287,307288,0,1,1
87620,5,2,307292,307292,307294,0,2,4
87621,2,3,307294,307294,307297,0,3,0
87622,6,2,307300,307300,307302,0,2,3
87623,3,3,307303,307303,307306,0,3,1
87624,4,3,307307,307307,307310,0,3,1
87625,2,1,307309,307310,307311,1,2,0
87626,1,1,307310,307311,307312,1,2,0
87627,4,3,307314,307314,307317,0,3,2
87628,2,2,307316,307317,307319,1,3,0
87629,5,2,307321,307321,307323,0,2,2
87630,2,1,307323,307323,307324,0,1,0
87631,6,3,307329,307329,307332,0,3,5
87632,2,2,307331,307332,307334,1,3,0
87633,6,2,307337,307337,307339,0,2,3
87634,2,1,307339,307339,307340,0,1,0
87635,1,2,307340,307340,307342,0,2,0
87636,5,2,307345,307345,307347,0,2,3
87637,3,2,307348,307348,307350,0,2,1
87638,4,1,307352,307352,307353,0,1,2
87639,2,3,307354,307354,307357,0,3,1
87640,5,3,307359,307359,307362,0,3,2
87641,1,2,307360,307362,307364,2,4,0
87642,5,3,307365,307365,307368,0,3,1
87643,4,2,307369,307369,307371,0,2,1
87644,3,1,307372,307372,307373,0,1,1
87645,4,1,307376,307376,307377,0,1,3
87646,5,2,307381,307381,307383,0,2,4
87647,4,1,307385,307385,307386,0,1,2
87648,2,1,307387,307387,307388,0,1,1
87649,4,3,307391,307391,307394,0,3,3
87650,6,1,307397,307397,307398,0,1,3
87651,1,3,307398,307398,307401,0,3,0
87652,1,2,307399,307401,307403,2,4,0
87653,6,1,307405,307405,307406,0,1,2
87654,2,3,307407,307407,307410,0,3,1
87655,6,1,307413,307413,307414,0,1,3
87656,5,2,307418,307418,307420,0,2,4
87657,2,3,307420,307420,307423,0,3,0
87658,5,3,307425,307425,307428,0,3,2
87659,1,3,307426,307428,307431,2,5,0
87660,4,3,307430,307431,307434,1,4,0
87661,4,3,307434,307434,307437,0,3,0
87662,4,2,307438,307438,307440,0,2,1
87663,4,1,307442,307442,307443,0,1,2
87664,3,1,307445,307445,307446,0,1,2
87665,4,1,307449,307449,307450,0,1,3
87666,4,1,307453,307453,307454,0,1,3
87667,6,1,307459,307459,307460,0,1,5
87668,4,2,307463,307463,307465,0,2,3
87669,3,3,307466,307466,307469,0,3,1
87670,5,1,307471,307471,307472,0,1,2
87671,1,2,307472,307472,307474,0,2,0
87672,4,2,307476,307476,307478,0,2,2
87673,2,3,307478,307478,307481,0,3,0
87674,4,1,307482,307482,307483,0,1,1
87675,2,3,307484,307484,307487,0,3,1
87676,4,3,307488,307488,307491,0,3,1
87677,5,2,307493,307493,307495,0,2,2
87678,5,3,307498,307498,307501,0,3,3
87679,3,3,307501,307501,307504,0,3,0
87680,4,1,307505,307505,307506,0,1,1
87681,3,3,307508,307508,307511,0,3,2
87682,6,2,307514,307514,307516,0,2,3
87683,6,1,307520,307520,307521,0,1,4
87684,4,3,307524,307524,307527,0,3,3
87685,1,3,307525,307527,307530,2,5,0
87686,4,1,307529,307530,307531,1,2,0
87687,2,1,307531,307531,307532,0,1,0
87688,3,3,307534,307534,307537,0,3,2
87689,5,2,307539,307539,307541,0,2,2
87690,5,2,307544,307544,307546,0,2,3
87691,6,2,307550,307550,307552,0,2,4
87692,4,2,307554,307554,307556,0,2,2
87693,5,3,307559,307559,307562,0,3,3
87694,1,1,307560,307562,307563,2,3,0
87695,1,3,307561,307563,307566,2,5,0
87696,2,2,307563,307566,307568,3,5,0
87697,4,2,307567,307568,307570,1,3,0
87698,2,3,307569,307570,307573,1,4,0
87699,4,2,307573,307573,307575,0,2,0
87700,3,1,307576,307576,307577,0,1,1
87701,6,3,307582,307582,307585,0,3,5
87702,2,1,307584,307585,307586,1,2,0
87703,3,1,307587,307587,307588,0,1,1
87704,2,2,307589,307589,307591,0,2,1
87705,4,2,307593,307593,307595,0,2,2
87706,5,2,307598,307598,307600,0,2,3
87707,6,1,307604,307604,307605,0,1,4
87708,3,2,307607,307607,307609,0,2,2
87709,1,1,307608,307609,307610,1,2,0
87710,2,3,307610,307610,307613,0,3,0
87711,3,3,307613,307613,307616,0,3,0
87712,4,1,307617,307617,307618,0,1,1
87713,4,2,307621,307621,307623,0,2,3
87714,3,1,307624,307624,307625,0,1,1
87715,6,1,307630,307630,307631,0,1,5
87716,4,2,307634,307634,307636,0,2,3
87717,3,2,307637,307637,307639,0,2,1
87718,4,2,307641,307641,307643,0,2,2
87719,1,2,307642,307643,307645,1,3,0
87720,4,1,307646,307646,307647,0,1,1
87721,2,1,307648,307648,307649,0,1,1
87722,1,2,307649,307649,307651,0,2,0
87723,6,1,307655,307655,307656,0,1,4
87724,5,1,307660,307660,307661,0,1,4
87725,5,1,307665,307665,307666,0,1,4
87726,1,1,307666,307666,307667,0,1,0
87727,3,3,307669,307669,307672,0,3,2
87728,5,1,307674,307674,307675,0,1,2
87729,1,3,307675,307675,307678,0,3,0
87730,5,2,307680,307680,307682,0,2,2
87731,6,3,307686,307686,307689,0,3,4
87732,5,1,307691,307691,307692,0,1,2
87733,6,3,307697,307697,307700,0,3,5
87734,5,1,307702,307702,307703,0,1,2
87735,2,3,307704,307704,307707,0,3,1
87736,1,2,307705,307707,307709,2,4,0
87737,4,3,307709,307709,307712,0,3,0
87738,6,2,307715,307715,307717,0,2,3
87739,2,1,307717,307717,307718,0,1,0
87740,2,2,307719,307719,307721,0,2,1
87741,6,1,307725,307725,307726,0,1,4
87742,2,1,307727,307727,307728,0,1,1
87743,1,1,307728,307728,307729,0,1,0
87744,5,1,307733,307733,307734,0,1,4
87745,3,1,307736,307736,307737,0,1,2
87746,6,3,307742,307742,307745,0,3,5
87747,3,2,307745,307745,307747,0,2,0
87748,6,2,307751,307751,307753,0,2,4
87749,1,3,307752,307753,307756,1,4,0
87750,3,1,307755,307756,307757,1,2,0
87751,1,3,307756,307757,307760,1,4,0
87752,3,3,307759,307760,307763,1,4,0
87753,3,1,307762,307763,307764,1,2,0
87754,2,1,307764,307764,307765,0,1,0
87755,2,2,307766,307766,307768,0,2,1
87756,4,3,307770,307770,307773,0,3,2
87757,3,3,307773,307773,307776,0,3,0
87758,2,2,307775,307776,307778,1,3,0
87759,4,1,307779,307779,307780,0,1,1
87760,2,3,307781,307781,307784,0,3,1
87761,2,2,307783,307784,307786,1,3,0
87762,1,1,307784,307786,307787,2,3,0
87763,1,3,307785,307787,307790,2,5,0
87764,2,1,307787,307790,307791,3,4,0
87765,4,3,307791,307791,307794,0,3,0
87766,3,2,307794,307794,307796,0,2,0
87767,1,2,307795,307796,307798,1,3,0
87768,1,2,307796,307798,307800,2,4,0
87769,6,1,307802,307802,307803,0,1,2
87770,2,3,307804,307804,307807,0,3,1
87771,3,3,307807,307807,307810,0,3,0
87772,4,3,307811,307811,307814,0,3,1
87773,2,3,307813,307814,307817,1,4,0
87774,4,2,307817,307817,307819,0,2,0
87775,6,3,307823,307823,307826,0,3,4
87776,5,1,307828,307828,307829,0,1,2
87777,5,3,307833,307833,307836,0,3,4
87778,4,1,307837,307837,307838,0,1,1
87779,1,2,307838,307838,307840,0,2,0
87780,3,3,307841,307841,307844,0,3,1
87781,4,3,307845,307845,307848,0,3,1
87782,4,3,307849,307849,307852,0,3,1
87783,2,2,307851,307852,307854,1,3,0
87784,1,1,307852,307854,307855,2,3,0
87785,3,3,307855,307855,307858,0,3,0
87786,1,2,307856,307858,307860,2,4,0
87787,3,2,307859,307860,307862,1,3,0
87788,4,2,307863,307863,307865,0,2,1
87789,3,1,307866,307866,307867,0,1,1
87790,1,1,307867,307867,307868,0,1,0
87791,6,1,307873,307873,307874,0,1,5
87792,3,3,307876,307876,307879,0,3,2
87793,1,2,307877,307879,307881,2,4,0
87794,3,3,307880,307881,307884,1,4,0
87795,1,1,307881,307884,307885,3,4,0
87796,2,1,307883,307885,307886,2,3,0
87797,2,3,307885,307886,307889,1,4,0
87798,5,1,307890,307890,307891,0,1,1
87799,2,1,307892,307892,307893,0,1,1
87800,1,2,307893,307893,307895,0,2,0
87801,4,2,307897,307897,307899,0,2,2
87802,3,1,307900,307900,307901,0,1,1
87803,2,2,307902,307902,307904,0,2,1
87804,6,2,307908,307908,307910,0,2,4
87805,2,2,307910,307910,307912,0,2,0
87806,2,2,307912,307912,307914,0,2,0
87807,2,1,307914,307914,307915,0,1,0
87808,5,1,307919,307919,307920,0,1,4
87809,4,1,307923,307923,307924,0,1,3
87810,4,3,307927,307927,307930,0,3,3
87811,2,1,307929,307930,307931,1,2,0
87812,5,3,307934,307934,307937,0,3,3
87813,6,2,307940,307940,307942,0,2,3
87814,3,2,307943,307943,307945,0,2,1
87815,2,1,307945,307945,307946,0,1,0
87816,5,1,307950,307950,307951,0,1,4
87817,1,3,307951,307951,307954,0,3,0
87818,1,3,307952,307954,307957,2,5,0
87819,2,2,307954,307957,307959,3,5,0
87820,1,3,307955,307959,307962,4,7,0
87821,5,3,307960,307962,307965,2,5,0
87822,5,1,307965,307965,307966,0,1,0
87823,1,2,307966,307966,307968,0,2,0
87824,5,2,307971,307971,307973,0,2,3
87825,1,1,307972,307973,307974,1,2,0
87826,5,2,307977,307977,307979,0,2,3
87827,3,3,307980,307980,307983,0,3,1
87828,4,2,307984,307984,307986,0,2,1
87829,4,1,307988,307988,307989,0,1,2
87830,5,2,307993,307993,307995,0,2,4
87831,2,3,307995,307995,307998,0,3,0
87832,2,2,307997,307998,308000,1,3,0
87833,6,2,308003,308003,308005,0,2,3
87834,1,1,308004,308005,308006,1,2,0
87835,5,1,308009,308009,308010,0,1,3
87836,6,2,308015,308015,308017,0,2,5
87837,5,2,308020,308020,308022,0,2,3
87838,5,1,308025,308025,308026,0,1,3
87839,3,1,308028,308028,308029,0,1,2
87840,3,3,308031,308031,308034,0,3,2
87841,2,3,308033,308034,308037,1,4,0
87842,2,1,308035,308037,308038,2,3,0
87843,3,1,308038,308038,308039,0,1,0
87844,2,3,308040,308040,308043,0,3,1
87845,4,1,308044,308044,308045,0,1,1
87846,3,2,308047,308047,308049,0,2,2
87847,2,3,308049,308049,308052,0,3,0
87848,4,1,308053,308053,308054,0,1,1
87849,5,2,308058,308058,308060,0,2,4
87850,1,3,308059,308060,308063,1,4,0
87851,4,1,308063,308063,308064,0,1,0
87852,3,1,308066,308066,308067,0,1,2
87853,2,1,308068,308068,308069,0,1,1
87854,3,1,308071,308071,308072,0,1,2
87855,6,3,308077,308077,308080,0,3,5
87856,3,2,308080,308080,308082,0,2,0
87857,3,2,308083,308083,308085,0,2,1
87858,5,1,308088,308088,308089,0,1,3
87859,1,1,308089,308089,308090,0,1,0
87860,5,2,308094,308094,308096,0,2,4
87861,6,3,308100,308100,308103,0,3,4
87862,3,2,308103,308103,308105,0,2,0
87863,5,2,308108,308108,308110,0,2,3
87864,3,2,308111,308111,308113,0,2,1
87865,6,3,308117,308117,308120,0,3,4
87866,1,1,308118,308120,308121,2,3,0
87867,3,2,308121,308121,308123,0,2,0
87868,6,3,308127,308127,308130,0,3,4
87869,3,2,308130,308130,308132,0,2,0
87870,6,1,308136,308136,308137,0,1,4
87871,2,2,308138,308138,308140,0,2,1
87872,4,2,308142,308142,308144,0,2,2
87873,1,3,308143,308144,308147,1,4,0
87874,5,3,308148,308148,308151,0,3,1
87875,1,3,308149,308151,308154,2,5,0
87876,3,3,308152,308154,308157,2,5,0
87877,5,3,308157,308157,308160,0,3,0
87878,2,2,308159,308160,308162,1,3,0
87879,6,1,308165,308165,308166,0,1,3
87880,1,2,308166,308166,308168,0,2,0
87881,6,3,308172,308172,308175,0,3,4
87882,5,1,308177,308177,308178,0,1,2
87883,2,3,308179,308179,308182,0,3,1
87884,2,3,308181,308182,308185,1,4,0
87885,3,1,308184,308185,308186,1,2,0
87886,4,3,308188,308188,308191,0,3,2
87887,5,2,308193,308193,308195,0,2,2
87888,2,3,308195,308195,308198,0,3,0
87889,2,2,308197,308198,308200,1,3,0
87890,4,1,308201,308201,308202,0,1,1
87891,4,2,308205,308205,308207,0,2,3
87892,6,2,308211,308211,308213,0,2,4
87893,6,3,308217,308217,308220,0,3,4
87894,2,1,308219,308220,308221,1,2,0
87895,6,2,308225,308225,308227,0,2,4
87896,3,2,308228,308228,308230,0,2,1
87897,5,1,308233,308233,308234,0,1,3
87898,4,2,308237,308237,308239,0,2,3
87899,1,3,308238,308239,308242,1,4,0
87900,2,2,308240,308242,308244,2,4,0
87901,2,3,308242,308244,308247,2,5,0
87902,6,3,308248,308248,308251,0,3,1
87903,3,3,308251,308251,308254,0,3,0
87904,3,3,308254,308254,308257,0,3,0
87905,3,3,308257,308257,308260,0,3,0
87906,2,3,308259,308260,308263,1,4,0
87907,2,2,308261,308263,308265,2,4,0
87908,5,2,308266,308266,308268,0,2,1
87909,5,2,308271,308271,308273,0,2,3
87910,4,1,308275,308275,308276,0,1,2
87911,6,1,308281,308281,308282,0,1,5
87912,6,1,308287,308287,308288,0,1,5
87913,1,3,308288,308288,308291,0,3,0
87914,6,1,308294,308294,308295,0,1,3
87915,2,2,308296,308296,308298,0,2,1
87916,6,1,308302,308302,308303,0,1,4
87917,2,3,308304,308304,308307,0,3,1
87918,5,3,308309,308309,308312,0,3,2
87919,3,1,308312,308312,308313,0,1,0
87920,5,2,308317,308317,308319,0,2,4
87921,6,1,308323,308323,308324,0,1,4
87922,2,1,308325,308325,308326,0,1,1
87923,3,3,308328,308328,308331,0,3,2
87924,3,1,308331,308331,308332,0,1,0
87925,5,3,308336,308336,308339,0,3,4
87926,1,3,308337,308339,308342,2,5,0
87927,1,1,308338,308342,308343,4,5,0
87928,6,1,308344,308344,308345,0,1,1
87929,6,2,308350,308350,308352,0,2,5
87930,5,2,308355,308355,308357,0,2,3
87931,2,3,308357,308357,308360,0,3,0
87932,4,2,308361,308361,308363,0,2,1
87933,3,3,308364,308364,308367,0,3,1
87934,4,1,308368,308368,308369,0,1,1
87935,6,1,308374,308374,308375,0,1,5
87936,3,2,308377,308377,308379,0,2,2
87937,5,1,308382,308382,308383,0,1,3
87938,1,3,308383,308383,308386,0,3,0
87939,4,3,308387,308387,308390,0,3,1
87940,3,2,308390,308390,308392,0,2,0
87941,6,3,308396,308396,308399,0,3,4
87942,5,3,308401,308401,308404,0,3,2
87943,5,2,308406,308406,308408,0,2,2
87944,6,3,308412,308412,308415,0,3,4
87945,2,2,308414,308415,308417,1,3,0
87946,6,2,308420,308420,308422,0,2,3
87947,4,1,308424,308424,308425,0,1,2
87948,4,1,308428,308428,308429,0,1,3
87949,6,2,308434,308434,308436,0,2,5
87950,6,2,308440,308440,308442,0,2,4
87951,5,3,308445,308445,308448,0,3,3
87952,2,3,308447,308448,308451,1,4,0
87953,2,1,308449,308451,308452,2,3,0
87954,4,1,308453,308453,308454,0,1,1
87955,5,3,308458,308458,308461,0,3,4
87956,2,3,308460,308461,308464,1,4,0
87957,2,3,308462,308464,308467,2,5,0
87958,4,1,308466,308467,308468,1,2,0
87959,2,3,308468,308468,308471,0,3,0
87960,3,3,308471,308471,308474,0,3,0
87961,6,3,308477,308477,308480,0,3,3
87962,3,1,308480,308480,308481,0,1,0
87963,5,3,308485,308485,308488,0,3,4
87964,2,3,308487,308488,308491,1,4,0
87965,2,1,308489,308491,308492,2,3,0
87966,5,3,308494,308494,308497,0,3,2
87967,6,3,308500,308500,308503,0,3,3
87968,1,2,308501,308503,308505,2,4,0
87969,4,3,308505,308505,308508,0,3,0
87970,1,2,308506,308508,308510,2,4,0
87971,4,3,308510,308510,308513,0,3,0
87972,3,2,308513,308513,308515,0,2,0
87973,4,1,308517,308517,308518,0,1,2
87974,2,1,308519,308519,308520,0,1,1
87975,2,3,308521,308521,308524,0,3,1
87976,2,2,308523,308524,308526,1,3,0
87977,2,3,308525,308526,308529,1,4,0
87978,5,1,308530,308530,308531,0,1,1
87979,3,3,308533,308533,308536,0,3,2
87980,3,2,308536,308536,308538,0,2,0
87981,2,3,308538,308538,308541,0,3,0
87982,4,1,308542,308542,308543,0,1,1
87983,4,3,308546,308546,308549,0,3,3
87984,6,2,308552,308552,308554,0,2,3
87985,5,3,308557,308557,308560,0,3,3
87986,4,2,308561,308561,308563,0,2,1
87987,4,2,308565,308565,308567,0,2,2
87988,3,2,308568,308568,308570,0,2,1
87989,1,1,308569,308570,308571,1,2,0
87990,1,3,308570,308571,308574,1,4,0
87991,3,1,308573,308574,308575,1,2,0
87992,5,3,308578,308578,308581,0,3,3
87993,5,1,308583,308583,308584,0,1,2
87994,4,3,308587,308587,308590,0,3,3
87995,4,1,308591,308591,308592,0,1,1
87996,5,2,308596,308596,308598,0,2,4
87997,4,1,308600,308600,308601,0,1,2
87998,1,1,308601,308601,308602,0,1,0
87999,6,3,308607,308607,308610,0,3,5
88000,6,3,308613,308613,308616,0,3,3
88001,3,2,308616,308616,308618,0,2,0
88002,5,2,308621,308621,308623,0,2,3
88003,3,2,308624,308624,308626,0,2,1
88004,3,3,308627,308627,308630,0,3,1
88005,5,3,308632,308632,308635,0,3,2
88006,2,2,308634,308635,308637,1,3,0
88007,1,3,308635,308637,308640,2,5,0
88008,2,1,308637,308640,308641,3,4,0
88009,3,1,308640,308641,308642,1,2,0
88010,5,1,308645,308645,308646,0,1,3
88011,2,1,308647,308647,308648,0,1,1
88012,6,3,308653,308653,308656,0,3,5
88013,5,3,308658,308658,308661,0,3,2
88014,2,3,308660,308661,308664,1,4,0
88015,5,1,308665,308665,308666,0,1,1
88016,2,2,308667,308667,308669,0,2,1
88017,3,1,308670,308670,308671,0,1,1
88018,6,1,308676,308676,308677,0,1,5
88019,5,3,308681,308681,308684,0,3,4
88020,6,1,308687,308687,308688,0,1,3
88021,1,3,308688,308688,308691,0,3,0
88022,2,2,308690,308691,308693,1,3,0
88023,1,1,308691,308693,308694,2,3,0
88024,6,3,308697,308697,308700,0,3,3
88025,6,1,308703,308703,308704,0,1,3
88026,1,3,308704,308704,308707,0,3,0
88027,1,2,308705,308707,308709,2,4,0
88028,6,2,308711,308711,308713,0,2,2
88029,1,2,308712,308713,308715,1,3,0
88030,4,1,308716,308716,308717,0,1,1
88031,5,2,308721,308721,308723,0,2,4
88032,4,3,308725,308725,308728,0,3,2
88033,4,1,308729,308729,308730,0,1,1
88034,3,2,308732,308732,308734,0,2,2
88035,6,2,308738,308738,308740,0,2,4
88036,3,1,308741,308741,308742,0,1,1
88037,6,2,308747,308747,308749,0,2,5
88038,4,2,308751,308751,308753,0,2,2
88039,1,3,308752,308753,308756,1,4,0
88040,5,3,308757,308757,308760,0,3,1
88041,3,1,308760,308760,308761,0,1,0
88042,3,1,308763,308763,308764,0,1,2
88043,4,2,308767,308767,308769,0,2,3
88044,1,3,308768,308769,308772,1,4,0
88045,1,3,308769,308772,308775,3,6,0
88046,4,2,308773,308775,308777,2,4,0
88047,1,3,308774,308777,308780,3,6,0
88048,5,3,308779,308780,308783,1,4,0
88049,6,2,308785,308785,308787,0,2,2
88050,1,3,308786,308787,308790,1,4,0
88051,6,1,308792,308792,308793,0,1,2
88052,6,1,308798,308798,308799,0,1,5
88053,5,3,308803,308803,308806,0,3,4
88054,5,3,308808,308808,308811,0,3,2
88055,6,1,308814,308814,308815,0,1,3
88056,3,1,308817,308817,308818,0,1,2
88057,6,3,308823,308823,308826,0,3,5
88058,2,1,308825,308826,308827,1,2,0
88059,4,2,308829,308829,308831,0,2,2
88060,6,1,308835,308835,308836,0,1,4
88061,6,1,308841,308841,308842,0,1,5
88062,5,3,308846,308846,308849,0,3,4
88063,3,3,308849,308849,308852,0,3,0
88064,2,1,308851,308852,308853,1,2,0
88065,4,1,308855,308855,308856,0,1,2
88066,2,2,308857,308857,308859,0,2,1
88067,5,1,308862,308862,308863,0,1,3
88068,2,3,308864,308864,308867,0,3,1
88069,3,2,308867,308867,308869,0,2,0
88070,1,2,308868,308869,308871,1,3,0
88071,4,3,308872,308872,308875,0,3,1
88072,5,1,308877,308877,308878,0,1,2
88073,6,2,308883,308883,308885,0,2,5
88074,3,2,308886,308886,308888,0,2,1
88075,5,3,308891,308891,308894,0,3,3
88076,1,3,308892,308894,308897,2,5,0
88077,3,3,308895,308897,308900,2,5,0
88078,2,2,308897,308900,308902,3,5,0
88079,5,2,308902,308902,308904,0,2,0
88080,3,2,308905,308905,308907,0,2,1
88081,2,2,308907,308907,308909,0,2,0
88082,2,1,308909,308909,308910,0,1,0
88083,1,1,308910,308910,308911,0,1,0
88084,3,2,308913,308913,308915,0,2,2
88085,5,3,308918,308918,308921,0,3,3
88086,1,2,308919,308921,308923,2,4,0
88087,1,3,308920,308923,308926,3,6,0
88088,3,1,308923,308926,308927,3,4,0
88089,1,2,308924,308927,308929,3,5,0
88090,2,1,308926,308929,308930,3,4,0
88091,5,1,308931,308931,308932,0,1,1
88092,5,1,308936,308936,308937,0,1,4
88093,6,2,308942,308942,308944,0,2,5
88094,5,1,308947,308947,308948,0,1,3
88095,2,1,308949,308949,308950,0,1,1
88096,1,3,308950,308950,308953,0,3,0
88097,1,2,308951,308953,308955,2,4,0
88098,1,2,308952,308955,308957,3,5,0
88099,4,2,308956,308957,308959,1,3,0
88100,6,3,308962,308962,308965,0,3,3
88101,1,1,308963,308965,308966,2,3,0
88102,1,1,308964,308966,308967,2,3,0
88103,2,1,308966,308967,308968,1,2,0
88104,1,3,308967,308968,308971,1,4,0
88105,4,1,308971,308971,308972,0,1,0
88106,3,1,308974,308974,308975,0,1,2
88107,3,2,308977,308977,308979,0,2,2
88108,2,2,308979,308979,308981,0,2,0
88109,2,1,308981,308981,308982,0,1,0
88110,5,1,308986,308986,308987,0,1,4
88111,4,2,308990,308990,308992,0,2,3
88112,2,3,308992,308992,308995,0,3,0
88113,3,3,308995,308995,308998,0,3,0
88114,3,2,308998,308998,309000,0,2,0
88115,4,3,309002,309002,309005,0,3,2
88116,5,1,309007,309007,309008,0,1,2
88117,6,3,309013,309013,309016,0,3,5
88118,3,3,309016,309016,309019,0,3,0
88119,3,2,309019,309019,309021,0,2,0
88120,4,3,309023,309023,309026,0,3,2
88121,6,1,309029,309029,309030,0,1,3
88122,3,2,309032,309032,309034,0,2,2
88123,6,1,309038,309038,309039,0,1,4
88124,6,1,309044,309044,309045,0,1,5
88125,5,3,309049,309049,309052,0,3,4
88126,4,1,309053,309053,309054,0,1,1
88127,5,3,309058,309058,309061,0,3,4
88128,4,2,309062,309062,309064,0,2,1
88129,3,1,309065,309065,309066,0,1,1
88130,2,2,309067,309067,309069,0,2,1
88131,5,2,309072,309072,309074,0,2,3
88132,1,1,309073,309074,309075,1,2,0
88133,5,2,309078,309078,309080,0,2,3
88134,2,1,309080,309080,309081,0,1,0
88135,6,2,309086,309086,309088,0,2,5
88136,2,1,309088,309088,309089,0,1,0
88137,6,2,309094,309094,309096,0,2,5
88138,3,3,309097,309097,309100,0,3,1
88139,4,2,309101,309101,309103,0,2,1
88140,6,2,309107,309107,309109,0,2,4
88141,5,3,309112,309112,309115,0,3,3
88142,3,3,309115,309115,309118,0,3,0
88143,5,3,309120,309120,309123,0,3,2
88144,5,2,309125,309125,309127,0,2,2
88145,2,2,309127,309127,309129,0,2,0
88146,3,1,309130,309130,309131,0,1,1
88147,6,2,309136,309136,309138,0,2,5
88148,2,1,309138,309138,309139,0,1,0
88149,3,3,309141,309141,309144,0,3,2
88150,1,3,309142,309144,309147,2,5,0
88151,6,3,309148,309148,309151,0,3,1
88152,6,1,309154,309154,309155,0,1,3
88153,5,1,309159,309159,309160,0,1,4
88154,6,1,309165,309165,309166,0,1,5
88155,3,3,309168,309168,309171,0,3,2
88156,2,1,309170,309171,309172,1,2,0
88157,1,3,309171,309172,309175,1,4,0
88158,3,3,309174,309175,309178,1,4,0
88159,2,3,309176,309178,309181,2,5,0
88160,5,3,309181,309181,309184,0,3,0
88161,5,3,309186,309186,309189,0,3,2
88162,6,2,309192,309192,309194,0,2,3
88163,2,1,309194,309194,309195,0,1,0
88164,2,3,309196,309196,309199,0,3,1
88165,4,3,309200,309200,309203,0,3,1
88166,6,2,309206,309206,309208,0,2,3
88167,4,3,309210,309210,309213,0,3,2
88168,3,1,309213,309213,309214,0,1,0
88169,6,1,309219,309219,309220,0,1,5
88170,1,2,309220,309220,309222,0,2,0
88171,2,1,309222,309222,309223,0,1,0
88172,1,2,309223,309223,309225,0,2,0
88173,5,3,309228,309228,309231,0,3,3
88174,4,1,309232,309232,309233,0,1,1
88175,4,2,309236,309236,309238,0,2,3
88176,4,1,309240,309240,309241,0,1,2
88177,6,2,309246,309246,309248,0,2,5
88178,2,1,309248,309248,309249,0,1,0
88179,1,3,309249,309249,309252,0,3,0
88180,5,3,309254,309254,309257,0,3,2
88181,5,1,309259,309259,309260,0,1,2
88182,3,2,309262,309262,309264,0,2,2
88183,1,2,309263,309264,309266,1,3,0
88184,2,2,309265,309266,309268,1,3,0
88185,4,2,309269,309269,309271,0,2,1
88186,1,1,309270,309271,309272,1,2,0
88187,5,3,309275,309275,309278,0,3,3
88188,5,1,309280,309280,309281,0,1,2
88189,5,3,309285,309285,309288,0,3,4
88190,1,3,309286,309288,309291,2,5,0
88191,6,1,309292,309292,309293,0,1,1
88192,5,3,309297,309297,309300,0,3,4
88193,1,2,309298,309300,309302,2,4,0
88194,6,2,309304,309304,309306,0,2,2
88195,3,2,309307,309307,309309,0,2,1
88196,4,2,309311,309311,309313,0,2,2
88197,6,2,309317,309317,309319,0,2,4
88198,2,3,309319,309319,309322,0,3,0
88199,6,2,309325,309325,309327,0,2,3
88200,4,3,309329,309329,309332,0,3,2
88201,5,2,309334,309334,309336,0,2,2
88202,5,1,309339,309339,309340,0,1,3
88203,5,3,309344,309344,309347,0,3,4
88204,1,3,309345,309347,309350,2,5,0
88205,3,3,309348,309350,309353,2,5,0
88206,3,2,309351,309353,309355,2,4,0
88207,1,3,309352,309355,309358,3,6,0
88208,6,2,309358,309358,309360,0,2,0
88209,5,2,309363,309363,309365,0,2,3
88210,3,3,309366,309366,309369,0,3,1
88211,5,1,309371,309371,309372,0,1,2
88212,3,3,309374,309374,309377,0,3,2
88213,6,3,309380,309380,309383,0,3,3
88214,1,1,309381,309383,309384,2,3,0
88215,5,2,309386,309386,309388,0,2,2
88216,4,3,309390,309390,309393,0,3,2
88217,5,3,309395,309395,309398,0,3,2
88218,2,1,309397,309398,309399,1,2,0
88219,1,1,309398,309399,309400,1,2,0
88220,2,2,309400,309400,309402,0,2,0
88221,3,3,309403,309403,309406,0,3,1
88222,6,3,309409,309409,309412,0,3,3
88223,1,3,309410,309412,309415,2,5,0
88224,5,2,309415,309415,309417,0,2,0
88225,2,3,309417,309417,309420,0,3,0
88226,1,1,309418,309420,309421,2,3,0
88227,4,2,309422,309422,309424,0,2,1
88228,6,1,309428,309428,309429,0,1,4
88229,3,1,309431,309431,309432,0,1,2
88230,5,3,309436,309436,309439,0,3,4
88231,3,2,309439,309439,309441,0,2,0
88232,2,3,309441,309441,309444,0,3,0
88233,2,1,309443,309444,309445,1,2,0
88234,1,1,309444,309445,309446,1,2,0
88235,6,3,309450,309450,309453,0,3,4
88236,2,2,309452,309453,309455,1,3,0
88237,1,2,309453,309455,309457,2,4,0
88238,1,3,309454,309457,309460,3,6,0
88239,5,1,309459,309460,309461,1,2,0
88240,1,3,309460,309461,309464,1,4,0
88241,1,2,309461,309464,309466,3,5,0
88242,1,3,309462,309466,309469,4,7,0
88243,4,1,309466,309469,309470,3,4,0
88244,2,2,309468,309470,309472,2,4,0
88245,2,3,309470,309472,309475,2,5,0
88246,5,3,309475,309475,309478,0,3,0
88247,5,3,309480,309480,309483,0,3,2
88248,6,2,309486,309486,309488,0,2,3
88249,1,2,309487,309488,309490,1,3,0
88250,3,1,309490,309490,309491,0,1,0
88251,3,2,309493,309493,309495,0,2,2
88252,1,2,309494,309495,309497,1,3,0
88253,6,1,309500,309500,309501,0,1,3
88254,2,1,309502,309502,309503,0,1,1
88255,4,3,309506,309506,309509,0,3,3
88256,6,2,309512,309512,309514,0,2,3
88257,3,2,309515,309515,309517,0,2,1
88258,4,1,309519,309519,309520,0,1,2
88259,2,1,309521,309521,309522,0,1,1
88260,5,1,309526,309526,309527,0,1,4
88261,6,2,309532,309532,309534,0,2,5
88262,4,2,309536,309536,309538,0,2,2
88263,4,1,309540,309540,309541,0,1,2
88264,1,1,309541,309541,309542,0,1,0
88265,3,2,309544,309544,309546,0,2,2
88266,4,1,309548,309548,309549,0,1,2
88267,2,2,309550,309550,309552,0,2,1
88268,1,2,309551,309552,309554,1,3,0
88269,5,1,309556,309556,309557,0,1,2
88270,6,2,309562,309562,309564,0,2,5
88271,3,2,309565,309565,309567,0,2,1
88272,2,1,309567,309567,309568,0,1,0
88273,3,2,309570,309570,309572,0,2,2
88274,4,3,309574,309574,309577,0,3,2
88275,1,3,309575,309577,309580,2,5,0
88276,2,3,309577,309580,309583,3,6,0
88277,3,2,309580,309583,309585,3,5,0
88278,4,2,309584,309585,309587,1,3,0
88279,2,1,309586,309587,309588,1,2,0
88280,1,2,309587,309588,309590,1,3,0
88281,4,2,309591,309591,309593,0,2,1
88282,4,1,309595,309595,309596,0,1,2
88283,5,1,309600,309600,309601,0,1,4
88284,1,1,309601,309601,309602,0,1,0
88285,1,1,309602,309602,309603,0,1,0
88286,3,1,309605,309605,309606,0,1,2
88287,5,2,309610,309610,309612,0,2,4
88288,1,2,309611,309612,309614,1,3,0
88289,1,2,309612,309614,309616,2,4,0
88290,5,1,309617,309617,309618,0,1,1
88291,6,1,309623,309623,309624,0,1,5
88292,6,2,309629,309629,309631,0,2,5
88293,2,2,309631,309631,309633,0,2,0
88294,1,2,309632,309633,309635,1,3,0
88295,3,2,309635,309635,309637,0,2,0
88296,5,3,309640,309640,309643,0,3,3
88297,2,1,309642,309643,309644,1,2,0
88298,3,3,309645,309645,309648,0,3,1
88299,3,3,309648,309648,309651,0,3,0
88300,2,3,309650,309651,309654,1,4,0
88301,3,2,309653,309654,309656,1,3,0
88302,2,3,309655,309656,309659,1,4,0
88303,3,3,309658,309659,309662,1,4,0
88304,1,1,309659,309662,309663,3,4,0
88305,6,3,309665,309665,309668,0,3,2
88306,3,2,309668,309668,309670,0,2,0
88307,1,3,309669,309670,309673,1,4,0
88308,5,1,309674,309674,309675,0,1,1
88309,5,3,309679,309679,309682,0,3,4
88310,4,2,309683,309683,309685,0,2,1
88311,3,1,309686,309686,309687,0,1,1
88312,1,1,309687,309687,309688,0,1,0
88313,5,2,309692,309692,309694,0,2,4
88314,6,1,309698,309698,309699,0,1,4
88315,6,3,309704,309704,309707,0,3,5
88316,1,2,309705,309707,309709,2,4,0
88317,3,1,309708,309709,309710,1,2,0
88318,6,2,309714,309714,309716,0,2,4
88319,3,3,309717,309717,309720,0,3,1
88320,2,2,309719,309720,309722,1,3,0
88321,1,3,309720,309722,309725,2,5,0
88322,2,2,309722,309725,309727,3,5,0
88323,3,2,309725,309727,309729,2,4,0
88324,1,2,309726,309729,309731,3,5,0
88325,1,1,309727,309731,309732,4,5,0
88326,3,3,309730,309732,309735,2,5,0
88327,2,3,309732,309735,309738,3,6,0
88328,1,3,309733,309738,309741,5,8,0
88329,3,3,309736,309741,309744,5,8,0
88330,5,2,309741,309744,309746,3,5,0
88331,5,3,309746,309746,309749,0,3,0
88332,3,2,309749,309749,309751,0,2,0
88333,3,3,309752,309752,309755,0,3,1
88334,6,3,309758,309758,309761,0,3,3
88335,6,2,309764,309764,309766,0,2,3
88336,2,2,309766,309766,309768,0,2,0
88337,6,3,309772,309772,309775,0,3,4
88338,4,3,309776,309776,309779,0,3,1
88339,5,1,309781,309781,309782,0,1,2
88340,4,1,309785,309785,309786,0,1,3
88341,4,1,309789,309789,309790,0,1,3
88342,3,3,309792,309792,309795,0,3,2
88343,4,2,309796,309796,309798,0,2,1
88344,2,3,309798,309798,309801,0,3,0
88345,1,1,309799,309801,309802,2,3,0
88346,3,2,309802,309802,309804,0,2,0
88347,3,3,309805,309805,309808,0,3,1
88348,4,1,309809,309809,309810,0,1,1
88349,5,1,309814,309814,309815,0,1,4
88350,5,2,309819,309819,309821,0,2,4
88351,6,3,309825,309825,309828,0,3,4
88352,1,3,309826,309828,309831,2,5,0
88353,5,3,309831,309831,309834,0,3,0
88354,2,3,309833,309834,309837,1,4,0
88355,5,1,309838,309838,309839,0,1,1
88356,5,3,309843,309843,309846,0,3,4
88357,3,3,309846,309846,309849,0,3,0
88358,5,2,309851,309851,309853,0,2,2
88359,5,1,309856,309856,309857,0,1,3
88360,6,3,309862,309862,309865,0,3,5
88361,5,3,309867,309867,309870,0,3,2
88362,3,2,309870,309870,309872,0,2,0
88363,3,2,309873,309873,309875,0,2,1
88364,4,1,309877,309877,309878,0,1,2
88365,5,2,309882,309882,309884,0,2,4
88366,6,3,309888,309888,309891,0,3,4
88367,1,3,309889,309891,309894,2,5,0
88368,5,2,309894,309894,309896,0,2,0
88369,6,2,309900,309900,309902,0,2,4
88370,5,1,309905,309905,309906,0,1,3
88371,4,1,309909,309909,309910,0,1,3
88372,2,3,309911,309911,309914,0,3,1
88373,3,1,309914,309914,309915,0,1,0
88374,6,3,309920,309920,309923,0,3,5
88375,4,3,309924,309924,309927,0,3,1
88376,2,2,309926,309927,309929,1,3,0
88377,1,1,309927,309929,309930,2,3,0
88378,4,1,309931,309931,309932,0,1,1
88379,2,2,309933,309933,309935,0,2,1
88380,1,1,309934,309935,309936,1,2,0
88381,1,1,309935,309936,309937,1,2,0
88382,4,1,309939,309939,309940,0,1,2
88383,2,2,309941,309941,309943,0,2,1
88384,2,3,309943,309943,309946,0,3,0
88385,6,3,309949,309949,309952,0,3,3
88386,3,1,309952,309952,309953,0,1,0
88387,1,2,309953,309953,309955,0,2,0
88388,2,2,309955,309955,309957,0,2,0
88389,6,1,309961,309961,309962,0,1,4
88390,3,3,309964,309964,309967,0,3,2
88391,5,1,309969,309969,309970,0,1,2
88392,1,2,309970,309970,309972,0,2,0
88393,3,1,309973,309973,309974,0,1,1
88394,6,3,309979,309979,309982,0,3,5
88395,2,1,309981,309982,309983,1,2,0
88396,4,2,309985,309985,309987,0,2,2
88397,3,1,309988,309988,309989,0,1,1
88398,1,1,309989,309989,309990,0,1,0
88399,3,1,309992,309992,309993,0,1,2
88400,6,2,309998,309998,310000,0,2,5
88401,5,3,310003,310003,310006,0,3,3
88402,6,2,310009,310009,310011,0,2,3
88403,5,1,310014,310014,310015,0,1,3
88404,2,2,310016,310016,310018,0,2,1
88405,2,2,310018,310018,310020,0,2,0
88406,6,3,310024,310024,310027,0,3,4
88407,5,2,310029,310029,310031,0,2,2
88408,3,2,310032,310032,310034,0,2,1
88409,3,2,310035,310035,310037,0,2,1
88410,1,2,310036,310037,310039,1,3,0
88411,2,1,310038,310039,310040,1,2,0
88412,4,2,310042,310042,310044,0,2,2
88413,1,3,310043,310044,310047,1,4,0
88414,2,3,310045,310047,310050,2,5,0
88415,1,2,310046,310050,310052,4,6,0
88416,4,3,310050,310052,310055,2,5,0
88417,1,1,310051,310055,310056,4,5,0
88418,5,1,310056,310056,310057,0,1,0
88419,6,3,310062,310062,310065,0,3,5
88420,6,2,310068,310068,310070,0,2,3
88421,6,3,310074,310074,310077,0,3,4
88422,1,1,310075,310077,310078,2,3,0
88423,5,2,310080,310080,310082,0,2,2
88424,1,2,310081,310082,310084,1,3,0
88425,3,1,310084,310084,310085,0,1,0
88426,4,1,310088,310088,310089,0,1,3
88427,2,3,310090,310090,310093,0,3,1
88428,2,2,310092,310093,310095,1,3,0
88429,6,2,310098,310098,310100,0,2,3
88430,1,1,310099,310100,310101,1,2,0
88431,6,2,310105,310105,310107,0,2,4
88432,2,2,310107,310107,310109,0,2,0
88433,3,1,310110,310110,310111,0,1,1
88434,2,2,310112,310112,310114,0,2,1
88435,1,1,310113,310114,310115,1,2,0
88436,6,1,310119,310119,310120,0,1,4
88437,4,1,310123,310123,310124,0,1,3
88438,6,3,310129,310129,310132,0,3,5
88439,2,2,310131,310132,310134,1,3,0
88440,4,2,310135,310135,310137,0,2,1
88441,1,3,310136,310137,310140,1,4,0
88442,1,1,310137,310140,310141,3,4,0
88443,2,1,310139,310141,310142,2,3,0
88444,3,3,310142,310142,310145,0,3,0
88445,3,3,310145,310145,310148,0,3,0
88446,6,2,310151,310151,310153,0,2,3
88447,4,3,310155,310155,310158,0,3,2
88448,6,3,310161,310161,310164,0,3,3
88449,6,3,310167,310167,310170,0,3,3
88450,4,1,310171,310171,310172,0,1,1
88451,4,1,310175,310175,310176,0,1,3
88452,5,2,310180,310180,310182,0,2,4
88453,5,3,310185,310185,310188,0,3,3
88454,6,2,310191,310191,310193,0,2,3
88455,5,2,310196,310196,310198,0,2,3
88456,1,2,310197,310198,310200,1,3,0
88457,1,2,310198,310200,310202,2,4,0
88458,5,3,310203,310203,310206,0,3,1
88459,5,1,310208,310208,310209,0,1,2
88460,3,1,310211,310211,310212,0,1,2
88461,6,3,310217,310217,310220,0,3,5
88462,4,2,310221,310221,310223,0,2,1
88463,1,3,310222,310223,310226,1,4,0
88464,6,2,310228,310228,310230,0,2,2
88465,6,2,310234,310234,310236,0,2,4
88466,6,1,310240,310240,310241,0,1,4
88467,2,3,310242,310242,310245,0,3,1
88468,6,1,310248,310248,310249,0,1,3
88469,6,2,310254,310254,310256,0,2,5
88470,5,3,310259,310259,310262,0,3,3
88471,5,2,310264,310264,310266,0,2,2
88472,6,3,310270,310270,310273,0,3,4
88473,3,3,310273,310273,310276,0,3,0
88474,3,3,310276,310276,310279,0,3,0
88475,3,1,310279,310279,310280,0,1,0
88476,5,3,310284,310284,310287,0,3,4
88477,1,1,310285,310287,310288,2,3,0
88478,2,2,310287,310288,310290,1,3,0
88479,3,1,310290,310290,310291,0,1,0
88480,5,3,310295,310295,310298,0,3,4
88481,5,1,310300,310300,310301,0,1,2
88482,6,2,310306,310306,310308,0,2,5
88483,1,3,310307,310308,310311,1,4,0
88484,1,2,310308,310311,310313,3,5,0
88485,1,2,310309,310313,310315,4,6,0
88486,4,1,310313,310315,310316,2,3,0
88487,4,3,310317,310317,310320,0,3,1
88488,3,3,310320,310320,310323,0,3,0
88489,1,2,310321,310323,310325,2,4,0
88490,3,3,310324,310325,310328,1,4,0
88491,1,3,310325,310328,310331,3,6,0
88492,3,1,310328,310331,310332,3,4,0
88493,6,1,310334,310334,310335,0,1,2
88494,3,2,310337,310337,310339,0,2,2
88495,4,1,310341,310341,310342,0,1,2
88496,3,1,310344,310344,310345,0,1,2
88497,1,3,310345,310345,310348,0,3,0
88498,3,3,310348,310348,310351,0,3,0
88499,3,3,310351,310351,310354,0,3,0
88500,4,3,310355,310355,310358,0,3,1
88501,5,1,310360,310360,310361,0,1,2
88502,3,2,310363,310363,310365,0,2,2
88503,1,3,310364,310365,310368,1,4,0
88504,2,2,310366,310368,310370,2,4,0
88505,5,1,310371,310371,310372,0,1,1
88506,6,1,310377,310377,310378,0,1,5
88507,3,2,310380,310380,310382,0,2,2
88508,1,2,310381,310382,310384,1,3,0
88509,6,1,310387,310387,310388,0,1,3
88510,5,2,310392,310392,310394,0,2,4
88511,5,2,310397,310397,310399,0,2,3
88512,6,2,310403,310403,310405,0,2,4
88513,6,2,310409,310409,310411,0,2,4
88514,5,3,310414,310414,310417,0,3,3
88515,3,3,310417,310417,310420,0,3,0
88516,4,2,310421,310421,310423,0,2,1
88517,5,2,310426,310426,310428,0,2,3
88518,5,2,310431,310431,310433,0,2,3
88519,4,3,310435,310435,310438,0,3,2
88520,4,1,310439,310439,310440,0,1,1
88521,6,1,310445,310445,310446,0,1,5
88522,5,2,310450,310450,310452,0,2,4
88523,5,2,310455,310455,310457,0,2,3
88524,1,2,310456,310457,310459,1,3,0
88525,6,1,310462,310462,310463,0,1,3
88526,1,1,310463,310463,310464,0,1,0
88527,6,3,310469,310469,310472,0,3,5
88528,4,3,310473,310473,310476,0,3,1
88529,6,1,310479,310479,310480,0,1,3
88530,3,1,310482,310482,310483,0,1,2
88531,5,3,310487,310487,310490,0,3,4
88532,6,1,310493,310493,310494,0,1,3
88533,5,3,310498,310498,310501,0,3,4
88534,3,2,310501,310501,310503,0,2,0
88535,5,3,310506,310506,310509,0,3,3
88536,2,2,310508,310509,310511,1,3,0
88537,3,2,310511,310511,310513,0,2,0
88538,4,3,310515,310515,310518,0,3,2
88539,2,3,310517,310518,310521,1,4,0
88540,5,3,310522,310522,310525,0,3,1
88541,4,3,310526,310526,310529,0,3,1
88542,5,2,310531,310531,310533,0,2,2
88543,6,2,310537,310537,310539,0,2,4
88544,1,3,310538,310539,310542,1,4,0
88545,6,2,310544,310544,310546,0,2,2
88546,1,1,310545,310546,310547,1,2,0
88547,6,1,310551,310551,310552,0,1,4
88548,5,2,310556,310556,310558,0,2,4
88549,4,1,310560,310560,310561,0,1,2
88550,2,1,310562,310562,310563,0,1,1
88551,3,2,310565,310565,310567,0,2,2
88552,3,3,310568,310568,310571,0,3,1
88553,1,3,310569,310571,310574,2,5,0
88554,5,1,310574,310574,310575,0,1,0
88555,3,2,310577,310577,310579,0,2,2
88556,2,1,310579,310579,310580,0,1,0
88557,5,2,310584,310584,310586,0,2,4
88558,1,1,310585,310586,310587,1,2,0
88559,1,1,310586,310587,310588,1,2,0
88560,6,3,310592,310592,310595,0,3,4
88561,3,3,310595,310595,310598,0,3,0
88562,5,1,310600,310600,310601,0,1,2
88563,4,1,310604,310604,310605,0,1,3
88564,6,3,310610,310610,310613,0,3,5
88565,1,3,310611,310613,310616,2,5,0
88566,1,2,310612,310616,310618,4,6,0
88567,6,3,310618,310618,310621,0,3,0
88568,1,2,310619,310621,310623,2,4,0
88569,3,1,310622,310623,310624,1,2,0
88570,2,2,310624,310624,310626,0,2,0
88571,4,3,310628,310628,310631,0,3,2
88572,5,2,310633,310633,310635,0,2,2
88573,3,1,310636,310636,310637,0,1,1
88574,1,2,310637,310637,310639,0,2,0
88575,2,3,310639,310639,310642,0,3,0
88576,2,3,310641,310642,310645,1,4,0
88577,3,3,310644,310645,310648,1,4,0
88578,5,3,310649,310649,310652,0,3,1
88579,5,1,310654,310654,310655,0,1,2
88580,5,1,310659,310659,310660,0,1,4
88581,1,3,310660,310660,310663,0,3,0
88582,1,1,310661,310663,310664,2,3,0
88583,3,3,310664,310664,310667,0,3,0
88584,4,2,310668,310668,310670,0,2,1
88585,5,3,310673,310673,310676,0,3,3
88586,4,2,310677,310677,310679,0,2,1
88587,2,3,310679,310679,310682,0,3,0
88588,5,2,310684,310684,310686,0,2,2
88589,5,3,310689,310689,310692,0,3,3
88590,6,2,310695,310695,310697,0,2,3
88591,4,2,310699,310699,310701,0,2,2
88592,6,1,310705,310705,310706,0,1,4
88593,4,1,310709,310709,310710,0,1,3
88594,3,1,310712,310712,310713,0,1,2
88595,1,3,310713,310713,310716,0,3,0
88596,6,2,310719,310719,310721,0,2,3
88597,1,3,310720,310721,310724,1,4,0
88598,3,3,310723,310724,310727,1,4,0
88599,3,1,310726,310727,310728,1,2,0
88600,4,1,310730,310730,310731,0,1,2
88601,1,3,310731,310731,310734,0,3,0
88602,4,2,310735,310735,310737,0,2,1
88603,1,2,310736,310737,310739,1,3,0
88604,2,2,310738,310739,310741,1,3,0
88605,4,3,310742,310742,310745,0,3,1
88606,3,3,310745,310745,310748,0,3,0
88607,5,2,310750,310750,310752,0,2,2
88608,4,1,310754,310754,310755,0,1,2
88609,5,3,310759,310759,310762,0,3,4
88610,1,3,310760,310762,310765,2,5,0
88611,4,3,310764,310765,310768,1,4,0
88612,2,1,310766,310768,310769,2,3,0
88613,2,2,310768,310769,310771,1,3,0
88614,1,2,310769,310771,310773,2,4,0
88615,3,1,310772,310773,310774,1,2,0
88616,5,1,310777,310777,310778,0,1,3
88617,4,2,310781,310781,310783,0,2,3
88618,4,3,310785,310785,310788,0,3,2
88619,2,3,310787,310788,310791,1,4,0
88620,1,3,310788,310791,310794,3,6,0
88621,2,1,310790,310794,310795,4,5,0
88622,2,1,310792,310795,310796,3,4,0
88623,6,1,310798,310798,310799,0,1,2
88624,6,2,310804,310804,310806,0,2,5
88625,4,2,310808,310808,310810,0,2,2
88626,6,1,310814,310814,310815,0,1,4
88627,6,3,310820,310820,310823,0,3,5
88628,2,3,310822,310823,310826,1,4,0
88629,1,1,310823,310826,310827,3,4,0
88630,2,1,310825,310827,310828,2,3,0
88631,3,2,310828,310828,310830,0,2,0
88632,1,3,310829,310830,310833,1,4,0
88633,2,1,310831,310833,310834,2,3,0
88634,6,1,310837,310837,310838,0,1,3
88635,4,2,310841,310841,310843,0,2,3
88636,2,2,310843,310843,310845,0,2,0
88637,1,2,310844,310845,310847,1,3,0
88638,6,1,310850,310850,310851,0,1,3
88639,2,2,310852,310852,310854,0,2,1
88640,5,1,310857,310857,310858,0,1,3
88641,6,3,310863,310863,310866,0,3,5
88642,6,1,310869,310869,310870,0,1,3
88643,4,1,310873,310873,310874,0,1,3
88644,1,1,310874,310874,310875,0,1,0
88645,5,1,310879,310879,310880,0,1,4
88646,4,3,310883,310883,310886,0,3,3
88647,4,3,310887,310887,310890,0,3,1
88648,3,1,310890,310890,310891,0,1,0
88649,3,3,310893,310893,310896,0,3,2
88650,2,3,310895,310896,310899,1,4,0
88651,6,1,310901,310901,310902,0,1,2
88652,4,2,310905,310905,310907,0,2,3
88653,1,2,310906,310907,310909,1,3,0
88654,3,3,310909,310909,310912,0,3,0
88655,3,1,310912,310912,310913,0,1,0
88656,5,2,310917,310917,310919,0,2,4
88657,3,1,310920,310920,310921,0,1,1
88658,3,2,310923,310923,310925,0,2,2
88659,6,1,310929,310929,310930,0,1,4
88660,5,3,310934,310934,310937,0,3,4
88661,4,2,310938,310938,310940,0,2,1
88662,2,2,310940,310940,310942,0,2,0
88663,6,3,310946,310946,310949,0,3,4
88664,2,1,310948,310949,310950,1,2,0
88665,5,1,310953,310953,310954,0,1,3
88666,4,1,310957,310957,310958,0,1,3
88667,5,1,310962,310962,310963,0,1,4
88668,5,1,310967,310967,310968,0,1,4
88669,6,2,310973,310973,310975,0,2,5
88670,6,2,310979,310979,310981,0,2,4
88671,2,1,310981,310981,310982,0,1,0
88672,5,3,310986,310986,310989,0,3,4
88673,3,2,310989,310989,310991,0,2,0
88674,1,3,310990,310991,310994,1,4,0
88675,4,2,310994,310994,310996,0,2,0
88676,2,1,310996,310996,310997,0,1,0
88677,5,1,311001,311001,311002,0,1,4
88678,5,2,311006,311006,311008,0,2,4
88679,3,3,311009,311009,311012,0,3,1
88680,6,3,311015,311015,311018,0,3,3
88681,4,3,311019,311019,311022,0,3,1
88682,4,2,311023,311023,311025,0,2,1
88683,3,1,311026,311026,311027,0,1,1
88684,1,3,311027,311027,311030,0,3,0
88685,3,1,311030,311030,311031,0,1,0
88686,2,2,311032,311032,311034,0,2,1
88687,6,1,311038,311038,311039,0,1,4
88688,5,2,311043,311043,311045,0,2,4
88689,5,2,311048,311048,311050,0,2,3
88690,2,1,311050,311050,311051,0,1,0
88691,5,1,311055,311055,311056,0,1,4
88692,5,2,311060,311060,311062,0,2,4
88693,6,3,311066,311066,311069,0,3,4
88694,1,1,311067,311069,311070,2,3,0
88695,4,1,311071,311071,311072,0,1,1
88696,3,2,311074,311074,311076,0,2,2
88697,6,1,311080,311080,311081,0,1,4
88698,5,3,311085,311085,311088,0,3,4
88699,3,2,311088,311088,311090,0,2,0
88700,1,2,311089,311090,311092,1,3,0
88701,2,1,311091,311092,311093,1,2,0
88702,3,2,311094,311094,311096,0,2,1
88703,6,3,311100,311100,311103,0,3,4
88704,2,1,311102,311103,311104,1,2,0
88705,1,1,311103,311104,311105,1,2,0
88706,2,1,311105,311105,311106,0,1,0
88707,3,1,311108,311108,311109,0,1,2
88708,5,2,311113,311113,311115,0,2,4
88709,3,2,311116,311116,311118,0,2,1
88710,4,3,311120,311120,311123,0,3,2
88711,4,2,311124,311124,311126,0,2,1
88712,1,3,311125,311126,311129,1,4,0
88713,5,2,311130,311130,311132,0,2,1
88714,2,2,311132,311132,311134,0,2,0
88715,3,3,311135,311135,311138,0,3,1
88716,6,3,311141,311141,311144,0,3,3
88717,6,3,311147,311147,311150,0,3,3
88718,4,1,311151,311151,311152,0,1,1
88719,3,2,311154,311154,311156,0,2,2
88720,4,2,311158,311158,311160,0,2,2
88721,6,2,311164,311164,311166,0,2,4
88722,6,3,311170,311170,311173,0,3,4
88723,6,3,311176,311176,311179,0,3,3
88724,5,2,311181,311181,311183,0,2,2
88725,5,3,311186,311186,311189,0,3,3
88726,4,3,311190,311190,311193,0,3,1
88727,5,3,311195,311195,311198,0,3,2
88728,5,2,311200,311200,311202,0,2,2
88729,2,2,311202,311202,311204,0,2,0
88730,6,2,311208,311208,311210,0,2,4
88731,5,2,311213,311213,311215,0,2,3
88732,6,1,311219,311219,311220,0,1,4
88733,2,3,311221,311221,311224,0,3,1
88734,1,2,311222,311224,311226,2,4,0
88735,5,2,311227,311227,311229,0,2,1
88736,2,1,311229,311229,311230,0,1,0
88737,2,3,311231,311231,311234,0,3,1
88738,6,1,311237,311237,311238,0,1,3
88739,6,1,311243,311243,311244,0,1,5
88740,1,2,311244,311244,311246,0,2,0
88741,3,1,311247,311247,311248,0,1,1
88742,4,1,311251,311251,311252,0,1,3
88743,2,3,311253,311253,311256,0,3,1
88744,5,2,311258,311258,311260,0,2,2
88745,3,3,311261,311261,311264,0,3,1
88746,1,2,311262,311264,311266,2,4,0
88747,5,2,311267,311267,311269,0,2,1
88748,4,2,311271,311271,311273,0,2,2
88749,1,3,311272,311273,311276,1,4,0
88750,5,1,311277,311277,311278,0,1,1
88751,2,1,311279,311279,311280,0,1,1
88752,3,2,311282,311282,311284,0,2,2
88753,5,3,311287,311287,311290,0,3,3
88754,4,1,311291,311291,311292,0,1,1
88755,3,2,311294,311294,311296,0,2,2
88756,4,2,311298,311298,311300,0,2,2
88757,4,3,311302,311302,311305,0,3,2
88758,1,1,311303,311305,311306,2,3,0
88759,5,2,311308,311308,311310,0,2,2
88760,5,2,311313,311313,311315,0,2,3
88761,2,2,311315,311315,311317,0,2,0
88762,2,3,311317,311317,311320,0,3,0
88763,5,1,311322,311322,311323,0,1,2
88764,5,3,311327,311327,311330,0,3,4
88765,2,3,311329,311330,311333,1,4,0
88766,4,3,311333,311333,311336,0,3,0
88767,3,2,311336,311336,311338,0,2,0
88768,2,2,311338,311338,311340,0,2,0
88769,5,2,311343,311343,311345,0,2,3
88770,4,1,311347,311347,311348,0,1,2
88771,6,3,311353,311353,311356,0,3,5
88772,3,1,311356,311356,311357,0,1,0
88773,4,1,311360,311360,311361,0,1,3
88774,1,2,311361,311361,311363,0,2,0
88775,1,2,311362,311363,311365,1,3,0
88776,1,3,311363,311365,311368,2,5,0
88777,2,3,311365,311368,311371,3,6,0
88778,6,3,311371,311371,311374,0,3,0
88779,6,1,311377,311377,311378,0,1,3
88780,5,2,311382,311382,311384,0,2,4
88781,5,3,311387,311387,311390,0,3,3
88782,4,2,311391,311391,311393,0,2,1
88783,1,2,311392,311393,311395,1,3,0
88784,6,1,311398,311398,311399,0,1,3
88785,5,2,311403,311403,311405,0,2,4
88786,6,2,311409,311409,311411,0,2,4
88787,3,2,311412,311412,311414,0,2,1
88788,4,2,311416,311416,311418,0,2,2
88789,4,1,311420,311420,311421,0,1,2
88790,1,2,311421,311421,311423,0,2,0
88791,1,3,311422,311423,311426,1,4,0
88792,2,2,311424,311426,311428,2,4,0
88793,3,3,311427,311428,311431,1,4,0
88794,2,1,311429,311431,311432,2,3,0
88795,4,3,311433,311433,311436,0,3,1
88796,1,3,311434,311436,311439,2,5,0
88797,6,1,311440,311440,311441,0,1,1
88798,5,3,311445,311445,311448,0,3,4
88799,6,2,311451,311451,311453,0,2,3
88800,2,2,311453,311453,311455,0,2,0
88801,4,3,311457,311457,311460,0,3,2
88802,2,2,311459,311460,311462,1,3,0
88803,3,3,311462,311462,311465,0,3,0
88804,1,3,311463,311465,311468,2,5,0
88805,6,2,311469,311469,311471,0,2,1
88806,1,3,311470,311471,311474,1,4,0
88807,3,3,311473,311474,311477,1,4,0
88808,4,2,311477,311477,311479,0,2,0
88809,6,1,311483,311483,311484,0,1,4
88810,5,2,311488,311488,311490,0,2,4
88811,6,3,311494,311494,311497,0,3,4
88812,3,2,311497,311497,311499,0,2,0
88813,3,1,311500,311500,311501,0,1,1
88814,5,1,311505,311505,311506,0,1,4
88815,1,3,311506,311506,311509,0,3,0
88816,2,2,311508,311509,311511,1,3,0
88817,1,1,311509,311511,311512,2,3,0
88818,3,2,311512,311512,311514,0,2,0
88819,3,2,311515,311515,311517,0,2,1
88820,5,2,311520,311520,311522,0,2,3
88821,3,3,311523,311523,311526,0,3,1
88822,3,2,311526,311526,311528,0,2,0
88823,1,3,311527,311528,311531,1,4,0
88824,5,2,311532,311532,311534,0,2,1
88825,1,3,311533,311534,311537,1,4,0
88826,2,2,311535,311537,311539,2,4,0
88827,5,2,311540,311540,311542,0,2,1
88828,2,3,311542,311542,311545,0,3,0
88829,5,1,311547,311547,311548,0,1,2
88830,2,3,311549,311549,311552,0,3,1
88831,4,3,311553,311553,311556,0,3,1
88832,3,3,311556,311556,311559,0,3,0
88833,3,2,311559,311559,311561,0,2,0
88834,2,3,311561,311561,311564,0,3,0
88835,1,1,311562,311564,311565,2,3,0
88836,5,2,311567,311567,311569,0,2,2
88837,2,3,311569,311569,311572,0,3,0
88838,5,1,311574,311574,311575,0,1,2
88839,6,3,311580,311580,311583,0,3,5
88840,6,2,311586,311586,311588,0,2,3
88841,5,1,311591,311591,311592,0,1,3
88842,4,1,311595,311595,311596,0,1,3
88843,4,1,311599,311599,311600,0,1,3
88844,1,1,311600,311600,311601,0,1,0
88845,5,3,311605,311605,311608,0,3,4
88846,4,3,311609,311609,311612,0,3,1
88847,2,1,311611,311612,311613,1,2,0
88848,5,1,311616,311616,311617,0,1,3
88849,3,3,311619,311619,311622,0,3,2
88850,3,3,311622,311622,311625,0,3,0
88851,5,1,311627,311627,311628,0,1,2
88852,2,2,311629,311629,311631,0,2,1
88853,3,3,311632,311632,311635,0,3,1
88854,3,2,311635,311635,311637,0,2,0
88855,2,1,311637,311637,311638,0,1,0
88856,4,1,311641,311641,311642,0,1,3
88857,6,3,311647,311647,311650,0,3,5
88858,1,1,311648,311650,311651,2,3,0
88859,4,3,311652,311652,311655,0,3,1
88860,3,2,311655,311655,311657,0,2,0
88861,6,2,311661,311661,311663,0,2,4
88862,6,1,311667,311667,311668,0,1,4
88863,3,3,311670,311670,311673,0,3,2
88864,6,1,311676,311676,311677,0,1,3
88865,4,3,311680,311680,311683,0,3,3
88866,1,1,311681,311683,311684,2,3,0
88867,1,1,311682,311684,311685,2,3,0
88868,4,3,311686,311686,311689,0,3,1
88869,2,3,311688,311689,311692,1,4,0
88870,2,1,311690,311692,311693,2,3,0
88871,6,2,311696,311696,311698,0,2,3
88872,3,2,311699,311699,311701,0,2,1
88873,2,2,311701,311701,311703,0,2,0
88874,1,1,311702,311703,311704,1,2,0
88875,6,2,311708,311708,311710,0,2,4
88876,3,3,311711,311711,311714,0,3,1
88877,2,1,311713,311714,311715,1,2,0
88878,3,1,311716,311716,311717,0,1,1
88879,3,1,311719,311719,311720,0,1,2
88880,6,3,311725,311725,311728,0,3,5
88881,2,2,311727,311728,311730,1,3,0
88882,5,1,311732,311732,311733,0,1,2
88883,6,1,311738,311738,311739,0,1,5
88884,3,2,311741,311741,311743,0,2,2
88885,6,1,311747,311747,311748,0,1,4
88886,3,2,311750,311750,311752,0,2,2
88887,6,3,311756,311756,311759,0,3,4
88888,2,1,311758,311759,311760,1,2,0
88889,5,3,311763,311763,311766,0,3,3
88890,6,3,311769,311769,311772,0,3,3
88891,1,2,311770,311772,311774,2,4,0
88892,1,1,311771,311774,311775,3,4,0
88893,2,2,311773,311775,311777,2,4,0
88894,1,1,311774,311777,311778,3,4,0
88895,6,3,311780,311780,311783,0,3,2
88896,3,1,311783,311783,311784,0,1,0
88897,3,1,311786,311786,311787,0,1,2
88898,4,2,311790,311790,311792,0,2,3
88899,2,2,311792,311792,311794,0,2,0
88900,5,1,311797,311797,311798,0,1,3
88901,1,3,311798,311798,311801,0,3,0
88902,5,1,311803,311803,311804,0,1,2
88903,4,3,311807,311807,311810,0,3,3
88904,6,2,311813,311813,311815,0,2,3
88905,5,3,311818,311818,311821,0,3,3
88906,2,1,311820,311821,311822,1,2,0
88907,1,2,311821,311822,311824,1,3,0
88908,2,2,311823,311824,311826,1,3,0
88909,1,2,311824,311826,311828,2,4,0
88910,5,3,311829,311829,311832,0,3,1
88911,1,1,311830,311832,311833,2,3,0
88912,1,3,311831,311833,311836,2,5,0
88913,3,2,311834,311836,311838,2,4,0
88914,5,2,311839,311839,311841,0,2,1
88915,3,2,311842,311842,311844,0,2,1
88916,6,3,311848,311848,311851,0,3,4
88917,5,1,311853,311853,311854,0,1,2
88918,1,2,311854,311854,311856,0,2,0
88919,3,2,311857,311857,311859,0,2,1
88920,6,1,311863,311863,311864,0,1,4
88921,6,1,311869,311869,311870,0,1,5
88922,2,3,311871,311871,311874,0,3,1
88923,1,3,311872,311874,311877,2,5,0
88924,1,1,311873,311877,311878,4,5,0
88925,4,1,311877,311878,311879,1,2,0
88926,2,1,311879,311879,311880,0,1,0
88927,5,3,311884,311884,311887,0,3,4
88928,6,2,311890,311890,311892,0,2,3
88929,1,3,311891,311892,311895,1,4,0
88930,5,1,311896,311896,311897,0,1,1
88931,5,3,311901,311901,311904,0,3,4
88932,6,2,311907,311907,311909,0,2,3
88933,2,2,311909,311909,311911,0,2,0
88934,5,1,311914,311914,311915,0,1,3
88935,4,1,311918,311918,311919,0,1,3
88936,5,3,311923,311923,311926,0,3,4
88937,6,3,311929,311929,311932,0,3,3
88938,4,1,311933,311933,311934,0,1,1
88939,2,2,311935,311935,311937,0,2,1
88940,2,3,311937,311937,311940,0,3,0
88941,2,1,311939,311940,311941,1,2,0
88942,6,2,311945,311945,311947,0,2,4
88943,6,2,311951,311951,311953,0,2,4
88944,1,3,311952,311953,311956,1,4,0
88945,5,2,311957,311957,311959,0,2,1
88946,1,1,311958,311959,311960,1,2,0
88947,6,1,311964,311964,311965,0,1,4
88948,1,2,311965,311965,311967,0,2,0
88949,5,2,311970,311970,311972,0,2,3
88950,1,1,311971,311972,311973,1,2,0
88951,6,1,311977,311977,311978,0,1,4
88952,5,3,311982,311982,311985,0,3,4
88953,6,2,311988,311988,311990,0,2,3
88954,3,2,311991,311991,311993,0,2,1
88955,4,3,311995,311995,311998,0,3,2
88956,2,3,311997,311998,312001,1,4,0
88957,1,1,311998,312001,312002,3,4,0
88958,1,2,311999,312002,312004,3,5,0
88959,4,3,312003,312004,312007,1,4,0
88960,1,3,312004,312007,312010,3,6,0
88961,2,2,312006,312010,312012,4,6,0
88962,1,2,312007,312012,312014,5,7,0
88963,6,1,312013,312014,312015,1,2,0
88964,2,1,312015,312015,312016,0,1,0
88965,1,1,312016,312016,312017,0,1,0
88966,2,1,312018,312018,312019,0,1,1
88967,4,1,312022,312022,312023,0,1,3
88968,6,1,312028,312028,312029,0,1,5
88969,2,1,312030,312030,312031,0,1,1
88970,5,3,312035,312035,312038,0,3,4
88971,2,3,312037,312038,312041,1,4,0
88972,1,2,312038,312041,312043,3,5,0
88973,5,2,312043,312043,312045,0,2,0
88974,2,2,312045,312045,312047,0,2,0
88975,6,3,312051,312051,312054,0,3,4
88976,5,3,312056,312056,312059,0,3,2
88977,2,2,312058,312059,312061,1,3,0
88978,5,3,312063,312063,312066,0,3,2
88979,5,2,312068,312068,312070,0,2,2
88980,4,1,312072,312072,312073,0,1,2
88981,2,2,312074,312074,312076,0,2,1
88982,5,1,312079,312079,312080,0,1,3
88983,2,2,312081,312081,312083,0,2,1
88984,2,1,312083,312083,312084,0,1,0
88985,2,1,312085,312085,312086,0,1,1
88986,3,1,312088,312088,312089,0,1,2
88987,3,3,312091,312091,312094,0,3,2
88988,1,1,312092,312094,312095,2,3,0
88989,6,3,312098,312098,312101,0,3,3
88990,2,3,312100,312101,312104,1,4,0
88991,2,1,312102,312104,312105,2,3,0
88992,2,1,312104,312105,312106,1,2,0
88993,3,2,312107,312107,312109,0,2,1
88994,2,3,312109,312109,312112,0,3,0
88995,4,2,312113,312113,312115,0,2,1
88996,3,2,312116,312116,312118,0,2,1
88997,5,1,312121,312121,312122,0,1,3
88998,2,2,312123,312123,312125,0,2,1
88999,1,1,312124,312125,312126,1,2,0
89000,1,3,312125,312126,312129,1,4,0
89001,3,3,312128,312129,312132,1,4,0
89002,4,3,312132,312132,312135,0,3,0
89003,2,2,312134,312135,312137,1,3,0
89004,3,3,312137,312137,312140,0,3,0
89005,6,2,312143,312143,312145,0,2,3
89006,4,1,312147,312147,312148,0,1,2
89007,5,3,312152,312152,312155,0,3,4
89008,3,2,312155,312155,312157,0,2,0
89009,4,1,312159,312159,312160,0,1,2
89010,6,2,312165,312165,312167,0,2,5
89011,2,2,312167,312167,312169,0,2,0
89012,1,3,312168,312169,312172,1,4,0
89013,2,1,312170,312172,312173,2,3,0
89014,2,2,312172,312173,312175,1,3,0
89015,5,2,312177,312177,312179,0,2,2
89016,6,1,312183,312183,312184,0,1,4
89017,5,1,312188,312188,312189,0,1,4
89018,1,3,312189,312189,312192,0,3,0
89019,4,3,312193,312193,312196,0,3,1
89020,2,1,312195,312196,312197,1,2,0
89021,5,1,312200,312200,312201,0,1,3
89022,5,1,312205,312205,312206,0,1,4
89023,5,3,312210,312210,312213,0,3,4
89024,6,2,312216,312216,312218,0,2,3
89025,1,3,312217,312218,312221,1,4,0
89026,4,3,312221,312221,312224,0,3,0
89027,6,2,312227,312227,312229,0,2,3
89028,4,3,312231,312231,312234,0,3,2
89029,5,1,312236,312236,312237,0,1,2
89030,4,3,312240,312240,312243,0,3,3
89031,2,3,312242,312243,312246,1,4,0
89032,2,3,312244,312246,312249,2,5,0
89033,3,1,312247,312249,312250,2,3,0
89034,5,2,312252,312252,312254,0,2,2
89035,3,1,312255,312255,312256,0,1,1
89036,6,2,312261,312261,312263,0,2,5
89037,6,2,312267,312267,312269,0,2,4
89038,6,2,312273,312273,312275,0,2,4
89039,1,1,312274,312275,312276,1,2,0
89040,2,3,312276,312276,312279,0,3,0
89041,6,1,312282,312282,312283,0,1,3
89042,3,1,312285,312285,312286,0,1,2
89043,1,1,312286,312286,312287,0,1,0
89044,5,3,312291,312291,312294,0,3,4
89045,4,1,312295,312295,312296,0,1,1
89046,3,1,312298,312298,312299,0,1,2
89047,4,1,312302,312302,312303,0,1,3
89048,5,1,312307,312307,312308,0,1,4
89049,6,3,312313,312313,312316,0,3,5
89050,2,3,312315,312316,312319,1,4,0
89051,4,1,312319,312319,312320,0,1,0
89052,4,2,312323,312323,312325,0,2,3
89053,1,3,312324,312325,312328,1,4,0
89054,5,1,312329,312329,312330,0,1,1
89055,4,1,312333,312333,312334,0,1,3
89056,5,2,312338,312338,312340,0,2,4
89057,2,3,312340,312340,312343,0,3,0
89058,3,1,312343,312343,312344,0,1,0
89059,4,2,312347,312347,312349,0,2,3
89060,1,2,312348,312349,312351,1,3,0
89061,5,2,312353,312353,312355,0,2,2
89062,6,1,312359,312359,312360,0,1,4
89063,1,1,312360,312360,312361,0,1,0
89064,4,2,312364,312364,312366,0,2,3
89065,1,3,312365,312366,312369,1,4,0
89066,6,3,312371,312371,312374,0,3,2
89067,6,2,312377,312377,312379,0,2,3
89068,1,2,312378,312379,312381,1,3,0
89069,6,1,312384,312384,312385,0,1,3
89070,6,3,312390,312390,312393,0,3,5
89071,6,2,312396,312396,312398,0,2,3
89072,6,3,312402,312402,312405,0,3,4
89073,4,1,312406,312406,312407,0,1,1
89074,4,2,312410,312410,312412,0,2,3
89075,5,1,312415,312415,312416,0,1,3
89076,6,1,312421,312421,312422,0,1,5
89077,4,2,312425,312425,312427,0,2,3
89078,1,3,312426,312427,312430,1,4,0
89079,4,1,312430,312430,312431,0,1,0
89080,5,2,312435,312435,312437,0,2,4
89081,1,1,312436,312437,312438,1,2,0
89082,1,2,312437,312438,312440,1,3,0
89083,6,3,312443,312443,312446,0,3,3
89084,1,3,312444,312446,312449,2,5,0
89085,3,2,312447,312449,312451,2,4,0
89086,4,3,312451,312451,312454,0,3,0
89087,3,1,312454,312454,312455,0,1,0
89088,4,1,312458,312458,312459,0,1,3
89089,1,1,312459,312459,312460,0,1,0
89090,6,2,312465,312465,312467,0,2,5
89091,4,2,312469,312469,312471,0,2,2
89092,6,1,312475,312475,312476,0,1,4
89093,6,3,312481,312481,312484,0,3,5
89094,4,3,312485,312485,312488,0,3,1
89095,4,2,312489,312489,312491,0,2,1
89096,5,1,312494,312494,312495,0,1,3
89097,6,2,312500,312500,312502,0,2,5
89098,4,2,312504,312504,312506,0,2,2
89099,4,1,312508,312508,312509,0,1,2
89100,1,1,312509,312509,312510,0,1,0
89101,4,1,312513,312513,312514,0,1,3
89102,4,3,312517,312517,312520,0,3,3
89103,3,1,312520,312520,312521,0,1,0
89104,2,1,312522,312522,312523,0,1,1
89105,6,3,312528,312528,312531,0,3,5
89106,5,2,312533,312533,312535,0,2,2
89107,5,3,312538,312538,312541,0,3,3
89108,6,2,312544,312544,312546,0,2,3
89109,1,3,312545,312546,312549,1,4,0
89110,6,3,312551,312551,312554,0,3,2
89111,2,1,312553,312554,312555,1,2,0
89112,2,2,312555,312555,312557,0,2,0
89113,1,3,312556,312557,312560,1,4,0
89114,5,2,312561,312561,312563,0,2,1
89115,2,1,312563,312563,312564,0,1,0
89116,6,3,312569,312569,312572,0,3,5
89117,4,2,312573,312573,312575,0,2,1
89118,4,1,312577,312577,312578,0,1,2
89119,2,1,312579,312579,312580,0,1,1
89120,1,2,312580,312580,312582,0,2,0
89121,3,3,312583,312583,312586,0,3,1
89122,3,2,312586,312586,312588,0,2,0
89123,2,1,312588,312588,312589,0,1,0
89124,5,3,312593,312593,312596,0,3,4
89125,6,2,312599,312599,312601,0,2,3
89126,1,2,312600,312601,312603,1,3,0
89127,2,2,312602,312603,312605,1,3,0
89128,2,2,312604,312605,312607,1,3,0
89129,5,1,312609,312609,312610,0,1,2
89130,3,3,312612,312612,312615,0,3,2
89131,1,2,312613,312615,312617,2,4,0
89132,4,1,312617,312617,312618,0,1,0
89133,1,3,312618,312618,312621,0,3,0
89134,1,2,312619,312621,312623,2,4,0
89135,5,2,312624,312624,312626,0,2,1
89136,3,3,312627,312627,312630,0,3,1
89137,2,2,312629,312630,312632,1,3,0
89138,1,3,312630,312632,312635,2,5,0
89139,6,1,312636,312636,312637,0,1,1
89140,5,2,312641,312641,312643,0,2,4
89141,5,2,312646,312646,312648,0,2,3
89142,4,2,312650,312650,312652,0,2,2
89143,3,1,312653,312653,312654,0,1,1
89144,2,3,312655,312655,312658,0,3,1
89145,5,3,312660,312660,312663,0,3,2
89146,1,3,312661,312663,312666,2,5,0
89147,3,1,312664,312666,312667,2,3,0
89148,2,1,312666,312667,312668,1,2,0
89149,1,3,312667,312668,312671,1,4,0
89150,1,2,312668,312671,312673,3,5,0
89151,5,2,312673,312673,312675,0,2,0
89152,3,3,312676,312676,312679,0,3,1
89153,3,3,312679,312679,312682,0,3,0
89154,5,2,312684,312684,312686,0,2,2
89155,1,1,312685,312686,312687,1,2,0
89156,2,2,312687,312687,312689,0,2,0
89157,3,3,312690,312690,312693,0,3,1
89158,3,1,312693,312693,312694,0,1,0
89159,5,3,312698,312698,312701,0,3,4
89160,5,2,312703,312703,312705,0,2,2
89161,3,1,312706,312706,312707,0,1,1
89162,2,3,312708,312708,312711,0,3,1
89163,5,1,312713,312713,312714,0,1,2
89164,6,2,312719,312719,312721,0,2,5
89165,2,3,312721,312721,312724,0,3,0
89166,4,2,312725,312725,312727,0,2,1
89167,4,1,312729,312729,312730,0,1,2
89168,6,1,312735,312735,312736,0,1,5
89169,2,1,312737,312737,312738,0,1,1
89170,6,1,312743,312743,312744,0,1,5
89171,4,3,312747,312747,312750,0,3,3
89172,1,1,312748,312750,312751,2,3,0
89173,3,2,312751,312751,312753,0,2,0
89174,6,3,312757,312757,312760,0,3,4
89175,2,3,312759,312760,312763,1,4,0
89176,1,2,312760,312763,312765,3,5,0
89177,1,3,312761,312765,312768,4,7,0
89178,4,3,312765,312768,312771,3,6,0
89179,3,2,312768,312771,312773,3,5,0
89180,1,2,312769,312773,312775,4,6,0
89181,5,2,312774,312775,312777,1,3,0
89182,4,3,312778,312778,312781,0,3,1
89183,5,2,312783,312783,312785,0,2,2
89184,2,3,312785,312785,312788,0,3,0
89185,1,1,312786,312788,312789,2,3,0
89186,4,3,312790,312790,312793,0,3,1
89187,4,3,312794,312794,312797,0,3,1
89188,2,3,312796,312797,312800,1,4,0
89189,1,1,312797,312800,312801,3,4,0
89190,2,1,312799,312801,312802,2,3,0
89191,6,3,312805,312805,312808,0,3,3
89192,4,2,312809,312809,312811,0,2,1
89193,6,2,312815,312815,312817,0,2,4
89194,4,1,312819,312819,312820,0,1,2
89195,5,2,312824,312824,312826,0,2,4
89196,6,1,312830,312830,312831,0,1,4
89197,5,2,312835,312835,312837,0,2,4
89198,2,3,312837,312837,312840,0,3,0
89199,2,3,312839,312840,312843,1,4,0
89200,3,2,312842,312843,312845,1,3,0
89201,3,2,312845,312845,312847,0,2,0
89202,2,3,312847,312847,312850,0,3,0
89203,1,1,312848,312850,312851,2,3,0
89204,2,3,312850,312851,312854,1,4,0
89205,1,2,312851,312854,312856,3,5,0
89206,3,2,312854,312856,312858,2,4,0
89207,6,1,312860,312860,312861,0,1,2
89208,3,1,312863,312863,312864,0,1,2
89209,2,2,312865,312865,312867,0,2,1
89210,6,3,312871,312871,312874,0,3,4
89211,6,3,312877,312877,312880,0,3,3
89212,3,3,312880,312880,312883,0,3,0
89213,1,2,312881,312883,312885,2,4,0
89214,4,2,312885,312885,312887,0,2,0
89215,5,3,312890,312890,312893,0,3,3
89216,4,1,312894,312894,312895,0,1,1
89217,2,1,312896,312896,312897,0,1,1
89218,4,3,312900,312900,312903,0,3,3
89219,6,2,312906,312906,312908,0,2,3
89220,4,3,312910,312910,312913,0,3,2
89221,2,2,312912,312913,312915,1,3,0
89222,3,3,312915,312915,312918,0,3,0
89223,6,2,312921,312921,312923,0,2,3
89224,1,1,312922,312923,312924,1,2,0
89225,4,1,312926,312926,312927,0,1,2
89226,3,1,312929,312929,312930,0,1,2
89227,2,2,312931,312931,312933,0,2,1
89228,2,1,312933,312933,312934,0,1,0
89229,2,3,312935,312935,312938,0,3,1
89230,5,1,312940,312940,312941,0,1,2
89231,3,1,312943,312943,312944,0,1,2
89232,4,3,312947,312947,312950,0,3,3
89233,5,2,312952,312952,312954,0,2,2
89234,5,3,312957,312957,312960,0,3,3
89235,3,3,312960,312960,312963,0,3,0
89236,4,3,312964,312964,312967,0,3,1
89237,2,2,312966,312967,312969,1,3,0
89238,4,2,312970,312970,312972,0,2,1
89239,3,1,312973,312973,312974,0,1,1
89240,1,1,312974,312974,312975,0,1,0
89241,1,3,312975,312975,312978,0,3,0
89242,6,2,312981,312981,312983,0,2,3
89243,1,1,312982,312983,312984,1,2,0
89244,3,2,312985,312985,312987,0,2,1
89245,2,3,312987,312987,312990,0,3,0
89246,2,1,312989,312990,312991,1,2,0
89247,2,1,312991,312991,312992,0,1,0
89248,6,2,312997,312997,312999,0,2,5
89249,4,2,313001,313001,313003,0,2,2
89250,5,3,313006,313006,313009,0,3,3
89251,6,2,313012,313012,313014,0,2,3
89252,5,3,313017,313017,313020,0,3,3
89253,6,1,313023,313023,313024,0,1,3
89254,1,1,313024,313024,313025,0,1,0
89255,3,1,313027,313027,313028,0,1,2
89256,5,1,313032,313032,313033,0,1,4
89257,1,2,313033,313033,313035,0,2,0
89258,3,1,313036,313036,313037,0,1,1
89259,5,3,313041,313041,313044,0,3,4
89260,2,1,313043,313044,313045,1,2,0
89261,2,1,313045,313045,313046,0,1,0
89262,5,2,313050,313050,313052,0,2,4
89263,1,1,313051,313052,313053,1,2,0
89264,2,3,313053,313053,313056,0,3,0
89265,6,1,313059,313059,313060,0,1,3
89266,6,3,313065,313065,313068,0,3,5
89267,4,1,313069,313069,313070,0,1,1
89268,6,1,313075,313075,313076,0,1,5
89269,3,3,313078,313078,313081,0,3,2
89270,4,2,313082,313082,313084,0,2,1
89271,3,2,313085,313085,313087,0,2,1
89272,1,2,313086,313087,313089,1,3,0
89273,3,2,313089,313089,313091,0,2,0
89274,1,1,313090,313091,313092,1,2,0
89275,6,1,313096,313096,313097,0,1,4
89276,4,1,313100,313100,313101,0,1,3
89277,1,2,313101,313101,313103,0,2,0
89278,5,2,313106,313106,313108,0,2,3
89279,3,3,313109,313109,313112,0,3,1
89280,2,2,313111,313112,313114,1,3,0
89281,6,2,313117,313117,313119,0,2,3
89282,2,2,313119,313119,313121,0,2,0
89283,5,2,313124,313124,313126,0,2,3
89284,3,1,313127,313127,313128,0,1,1
89285,5,1,313132,313132,313133,0,1,4
89286,2,3,313134,313134,313137,0,3,1
89287,6,2,313140,313140,313142,0,2,3
89288,4,3,313144,313144,313147,0,3,2
89289,6,2,313150,313150,313152,0,2,3
89290,1,3,313151,313152,313155,1,4,0
89291,2,2,313153,313155,313157,2,4,0
89292,4,2,313157,313157,313159,0,2,0
89293,2,3,313159,313159,313162,0,3,0
89294,5,1,313164,313164,313165,0,1,2
89295,5,3,313169,313169,313172,0,3,4
89296,2,3,313171,313172,313175,1,4,0
89297,2,3,313173,313175,313178,2,5,0
89298,6,1,313179,313179,313180,0,1,1
89299,4,1,313183,313183,313184,0,1,3
89300,3,1,313186,313186,313187,0,1,2
89301,4,2,313190,313190,313192,0,2,3
89302,6,3,313196,313196,313199,0,3,4
89303,3,2,313199,313199,313201,0,2,0
89304,6,1,313205,313205,313206,0,1,4
89305,3,2,313208,313208,313210,0,2,2
89306,1,3,313209,313210,313213,1,4,0
89307,6,3,313215,313215,313218,0,3,2
89308,5,2,313220,313220,313222,0,2,2
89309,4,3,313224,313224,313227,0,3,2
89310,4,2,313228,313228,313230,0,2,1
89311,6,2,313234,313234,313236,0,2,4
89312,1,3,313235,313236,313239,1,4,0
89313,2,1,313237,313239,313240,2,3,0
89314,6,1,313243,313243,313244,0,1,3
89315,2,3,313245,313245,313248,0,3,1
89316,4,2,313249,313249,313251,0,2,1
89317,6,3,313255,313255,313258,0,3,4
89318,3,1,313258,313258,313259,0,1,0
89319,2,2,313260,313260,313262,0,2,1
89320,6,1,313266,313266,313267,0,1,4
89321,6,1,313272,313272,313273,0,1,5
89322,1,2,313273,313273,313275,0,2,0
89323,1,3,313274,313275,313278,1,4,0
89324,4,3,313278,313278,313281,0,3,0
89325,5,1,313283,313283,313284,0,1,2
89326,2,1,313285,313285,313286,0,1,1
89327,4,3,313289,313289,313292,0,3,3
89328,6,3,313295,313295,313298,0,3,3
89329,6,3,313301,313301,313304,0,3,3
89330,1,2,313302,313304,313306,2,4,0
89331,2,2,313304,313306,313308,2,4,0
89332,3,3,313307,313308,313311,1,4,0
89333,2,1,313309,313311,313312,2,3,0
89334,5,1,313314,313314,313315,0,1,2
89335,4,2,313318,313318,313320,0,2,3
89336,1,3,313319,313320,313323,1,4,0
89337,1,3,313320,313323,313326,3,6,0
89338,1,3,313321,313326,313329,5,8,0
89339,2,2,313323,313329,313331,6,8,0
89340,5,2,313328,313331,313333,3,5,0
89341,6,2,313334,313334,313336,0,2,1
89342,1,2,313335,313336,313338,1,3,0
89343,3,1,313338,313338,313339,0,1,0
89344,5,1,313343,313343,313344,0,1,4
89345,5,2,313348,313348,313350,0,2,4
89346,2,1,313350,313350,313351,0,1,0
89347,3,3,313353,313353,313356,0,3,2
89348,5,3,313358,313358,313361,0,3,2
89349,1,2,313359,313361,313363,2,4,0
89350,5,3,313364,313364,313367,0,3,1
89351,2,3,313366,313367,313370,1,4,0
89352,1,2,313367,313370,313372,3,5,0
89353,2,3,313369,313372,313375,3,6,0
89354,2,3,313371,313375,313378,4,7,0
89355,5,3,313376,313378,313381,2,5,0
89356,4,1,313380,313381,313382,1,2,0
89357,5,2,313385,313385,313387,0,2,3
89358,4,2,313389,313389,313391,0,2,2
89359,4,2,313393,313393,313395,0,2,2
89360,2,1,313395,313395,313396,0,1,0
89361,2,3,313397,313397,313400,0,3,1
89362,5,2,313402,313402,313404,0,2,2
89363,5,2,313407,313407,313409,0,2,3
89364,2,3,313409,313409,313412,0,3,0
89365,5,1,313414,313414,313415,0,1,2
89366,2,1,313416,313416,313417,0,1,1
89367,6,3,313422,313422,313425,0,3,5
89368,4,3,313426,313426,313429,0,3,1
89369,6,2,313432,313432,313434,0,2,3
89370,3,1,313435,313435,313436,0,1,1
89371,6,2,313441,313441,313443,0,2,5
89372,3,2,313444,313444,313446,0,2,1
89373,5,2,313449,313449,313451,0,2,3
89374,2,2,313451,313451,313453,0,2,0
89375,2,1,313453,313453,313454,0,1,0
89376,4,1,313457,313457,313458,0,1,3
89377,2,3,313459,313459,313462,0,3,1
89378,2,1,313461,313462,313463,1,2,0
89379,2,3,313463,313463,313466,0,3,0
89380,5,1,313468,313468,313469,0,1,2
89381,4,1,313472,313472,313473,0,1,3
89382,6,2,313478,313478,313480,0,2,5
89383,2,2,313480,313480,313482,0,2,0
89384,1,3,313481,313482,313485,1,4,0
89385,5,2,313486,313486,313488,0,2,1
89386,3,1,313489,313489,313490,0,1,1
89387,6,2,313495,313495,313497,0,2,5
89388,1,2,313496,313497,313499,1,3,0
89389,4,3,313500,313500,313503,0,3,1
89390,1,2,313501,313503,313505,2,4,0
89391,3,3,313504,313505,313508,1,4,0
89392,2,2,313506,313508,313510,2,4,0
89393,4,3,313510,313510,313513,0,3,0
89394,3,2,313513,313513,313515,0,2,0
89395,1,2,313514,313515,313517,1,3,0
89396,3,2,313517,313517,313519,0,2,0
89397,3,2,313520,313520,313522,0,2,1
89398,4,1,313524,313524,313525,0,1,2
89399,5,2,313529,313529,313531,0,2,4
89400,4,2,313533,313533,313535,0,2,2
89401,5,3,313538,313538,313541,0,3,3
89402,2,1,313540,313541,313542,1,2,0
89403,6,2,313546,313546,313548,0,2,4
89404,3,2,313549,313549,313551,0,2,1
89405,6,3,313555,313555,313558,0,3,4
89406,1,2,313556,313558,313560,2,4,0
89407,3,1,313559,313560,313561,1,2,0
89408,5,3,313564,313564,313567,0,3,3
89409,3,2,313567,313567,313569,0,2,0
89410,4,3,313571,313571,313574,0,3,2
89411,5,2,313576,313576,313578,0,2,2
89412,1,3,313577,313578,313581,1,4,0
89413,6,1,313583,313583,313584,0,1,2
89414,4,1,313587,313587,313588,0,1,3
89415,2,3,313589,313589,313592,0,3,1
89416,6,3,313595,313595,313598,0,3,3
89417,1,2,313596,313598,313600,2,4,0
89418,5,1,313601,313601,313602,0,1,1
89419,6,3,313607,313607,313610,0,3,5
89420,6,3,313613,313613,313616,0,3,3
89421,4,1,313617,313617,313618,0,1,1
89422,5,2,313622,313622,313624,0,2,4
89423,2,3,313624,313624,313627,0,3,0
89424,4,1,313628,313628,313629,0,1,1
89425,3,1,313631,313631,313632,0,1,2
89426,6,2,313637,313637,313639,0,2,5
89427,2,3,313639,313639,313642,0,3,0
89428,5,2,313644,313644,313646,0,2,2
89429,5,1,313649,313649,313650,0,1,3
89430,4,3,313653,313653,313656,0,3,3
89431,3,2,313656,313656,313658,0,2,0
89432,3,2,313659,313659,313661,0,2,1
89433,2,1,313661,313661,313662,0,1,0
89434,1,3,313662,313662,313665,0,3,0
89435,5,1,313667,313667,313668,0,1,2
89436,2,3,313669,313669,313672,0,3,1
89437,6,2,313675,313675,313677,0,2,3
89438,4,2,313679,313679,313681,0,2,2
89439,3,2,313682,313682,313684,0,2,1
89440,2,2,313684,313684,313686,0,2,0
89441,6,2,313690,313690,313692,0,2,4
89442,1,1,313691,313692,313693,1,2,0
89443,4,2,313695,313695,313697,0,2,2
89444,1,2,313696,313697,313699,1,3,0
89445,5,2,313701,313701,313703,0,2,2
89446,5,3,313706,313706,313709,0,3,3
89447,3,3,313709,313709,313712,0,3,0
89448,3,3,313712,313712,313715,0,3,0
89449,1,1,313713,313715,313716,2,3,0
89450,3,1,313716,313716,313717,0,1,0
89451,4,1,313720,313720,313721,0,1,3
89452,6,3,313726,313726,313729,0,3,5
89453,6,1,313732,313732,313733,0,1,3
89454,2,3,313734,313734,313737,0,3,1
89455,2,3,313736,313737,313740,1,4,0
89456,3,1,313739,313740,313741,1,2,0
89457,6,3,313745,313745,313748,0,3,4
89458,4,3,313749,313749,313752,0,3,1
89459,4,1,313753,313753,313754,0,1,1
89460,3,3,313756,313756,313759,0,3,2
89461,2,2,313758,313759,313761,1,3,0
89462,2,2,313760,313761,313763,1,3,0
89463,2,1,313762,313763,313764,1,2,0
89464,5,3,313767,313767,313770,0,3,3
89465,5,2,313772,313772,313774,0,2,2
89466,1,3,313773,313774,313777,1,4,0
89467,2,1,313775,313777,313778,2,3,0
89468,1,2,313776,313778,313780,2,4,0
89469,1,2,313777,313780,313782,3,5,0
89470,4,2,313781,313782,313784,1,3,0
89471,3,3,313784,313784,313787,0,3,0
89472,4,3,313788,313788,313791,0,3,1
89473,2,2,313790,313791,313793,1,3,0
89474,2,3,313792,313793,313796,1,4,0
89475,1,3,313793,313796,313799,3,6,0
89476,3,1,313796,313799,313800,3,4,0
89477,1,2,313797,313800,313802,3,5,0
89478,6,1,313803,313803,313804,0,1,1
89479,2,2,313805,313805,313807,0,2,1
89480,4,3,313809,313809,313812,0,3,2
89481,2,1,313811,313812,313813,1,2,0
89482,4,3,313815,313815,313818,0,3,2
89483,5,3,313820,313820,313823,0,3,2
89484,4,1,313824,313824,313825,0,1,1
89485,2,2,313826,313826,313828,0,2,1
89486,4,2,313830,313830,313832,0,2,2
89487,1,2,313831,313832,313834,1,3,0
89488,4,3,313835,313835,313838,0,3,1
89489,1,1,313836,313838,313839,2,3,0
89490,5,3,313841,313841,313844,0,3,2
89491,3,2,313844,313844,313846,0,2,0
89492,2,3,313846,313846,313849,0,3,0
89493,5,1,313851,313851,313852,0,1,2
89494,5,3,313856,313856,313859,0,3,4
89495,4,2,313860,313860,313862,0,2,1
89496,6,1,313866,313866,313867,0,1,4
89497,1,2,313867,313867,313869,0,2,0
89498,5,3,313872,313872,313875,0,3,3
89499,5,1,313877,313877,313878,0,1,2
89500,6,1,313883,313883,313884,0,1,5
89501,1,1,313884,313884,313885,0,1,0
89502,3,2,313887,313887,313889,0,2,2
89503,4,2,313891,313891,313893,0,2,2
89504,3,2,313894,313894,313896,0,2,1
89505,2,1,313896,313896,313897,0,1,0
89506,4,2,313900,313900,313902,0,2,3
89507,4,1,313904,313904,313905,0,1,2
89508,4,1,313908,313908,313909,0,1,3
89509,6,2,313914,313914,313916,0,2,5
89510,4,1,313918,313918,313919,0,1,2
89511,6,2,313924,313924,313926,0,2,5
89512,3,3,313927,313927,313930,0,3,1
89513,3,1,313930,313930,313931,0,1,0
89514,3,1,313933,313933,313934,0,1,2
89515,2,2,313935,313935,313937,0,2,1
89516,2,3,313937,313937,313940,0,3,0
89517,4,1,313941,313941,313942,0,1,1
89518,3,3,313944,313944,313947,0,3,2
89519,6,1,313950,313950,313951,0,1,3
89520,4,1,313954,313954,313955,0,1,3
89521,3,1,313957,313957,313958,0,1,2
89522,6,3,313963,313963,313966,0,3,5
89523,6,3,313969,313969,313972,0,3,3
89524,3,2,313972,313972,313974,0,2,0
89525,1,3,313973,313974,313977,1,4,0
89526,3,3,313976,313977,313980,1,4,0
89527,2,1,313978,313980,313981,2,3,0
89528,4,1,313982,313982,313983,0,1,1
89529,5,1,313987,313987,313988,0,1,4
89530,1,2,313988,313988,313990,0,2,0
89531,4,3,313992,313992,313995,0,3,2
89532,2,2,313994,313995,313997,1,3,0
89533,4,2,313998,313998,314000,0,2,1
89534,6,1,314004,314004,314005,0,1,4
89535,1,3,314005,314005,314008,0,3,0
89536,6,1,314011,314011,314012,0,1,3
89537,1,3,314012,314012,314015,0,3,0
89538,4,3,314016,314016,314019,0,3,1
89539,6,3,314022,314022,314025,0,3,3
89540,3,2,314025,314025,314027,0,2,0
89541,5,3,314030,314030,314033,0,3,3
89542,2,1,314032,314033,314034,1,2,0
89543,1,1,314033,314034,314035,1,2,0
89544,5,3,314038,314038,314041,0,3,3
89545,2,3,314040,314041,314044,1,4,0
89546,3,3,314043,314044,314047,1,4,0
89547,6,1,314049,314049,314050,0,1,2
89548,5,3,314054,314054,314057,0,3,4
89549,2,1,314056,314057,314058,1,2,0
89550,1,3,314057,314058,314061,1,4,0
89551,2,1,314059,314061,314062,2,3,0
89552,3,3,314062,314062,314065,0,3,0
89553,1,2,314063,314065,314067,2,4,0
89554,5,2,314068,314068,314070,0,2,1
89555,2,1,314070,314070,314071,0,1,0
89556,2,1,314072,314072,314073,0,1,1
89557,5,1,314077,314077,314078,0,1,4
89558,2,3,314079,314079,314082,0,3,1
89559,4,1,314083,314083,314084,0,1,1
89560,1,3,314084,314084,314087,0,3,0
89561,5,1,314089,314089,314090,0,1,2
89562,2,3,314091,314091,314094,0,3,1
89563,2,2,314093,314094,314096,1,3,0
89564,1,3,314094,314096,314099,2,5,0
89565,2,2,314096,314099,314101,3,5,0
89566,6,2,314102,314102,314104,0,2,1
89567,4,1,314106,314106,314107,0,1,2
89568,1,2,314107,314107,314109,0,2,0
89569,1,1,314108,314109,314110,1,2,0
89570,3,3,314111,314111,314114,0,3,1
89571,6,2,314117,314117,314119,0,2,3
89572,3,2,314120,314120,314122,0,2,1
89573,5,3,314125,314125,314128,0,3,3
89574,5,3,314130,314130,314133,0,3,2
89575,5,2,314135,314135,314137,0,2,2
89576,1,1,314136,314137,314138,1,2,0
89577,6,3,314142,314142,314145,0,3,4
89578,6,1,314148,314148,314149,0,1,3
89579,3,3,314151,314151,314154,0,3,2
89580,6,2,314157,314157,314159,0,2,3
89581,5,3,314162,314162,314165,0,3,3
89582,3,1,314165,314165,314166,0,1,0
89583,4,1,314169,314169,314170,0,1,3
89584,5,1,314174,314174,314175,0,1,4
89585,4,3,314178,314178,314181,0,3,3
89586,3,3,314181,314181,314184,0,3,0
89587,3,2,314184,314184,314186,0,2,0
89588,1,1,314185,314186,314187,1,2,0
89589,6,2,314191,314191,314193,0,2,4
89590,2,1,314193,314193,314194,0,1,0
89591,6,1,314199,314199,314200,0,1,5
89592,5,2,314204,314204,314206,0,2,4
89593,3,3,314207,314207,314210,0,3,1
89594,6,3,314213,314213,314216,0,3,3
89595,4,3,314217,314217,314220,0,3,1
89596,3,3,314220,314220,314223,0,3,0
89597,6,2,314226,314226,314228,0,2,3
89598,6,2,314232,314232,314234,0,2,4
89599,3,3,314235,314235,314238,0,3,1
89600,2,3,314237,314238,314241,1,4,0
89601,1,2,314238,314241,314243,3,5,0
89602,2,3,314240,314243,314246,3,6,0
89603,2,3,314242,314246,314249,4,7,0
89604,6,1,314248,314249,314250,1,2,0
89605,1,3,314249,314250,314253,1,4,0
89606,3,2,314252,314253,314255,1,3,0
89607,5,3,314257,314257,314260,0,3,2
89608,4,2,314261,314261,314263,0,2,1
89609,1,2,314262,314263,314265,1,3,0
89610,1,1,314263,314265,314266,2,3,0
89611,5,3,314268,314268,314271,0,3,2
89612,4,1,314272,314272,314273,0,1,1
89613,5,3,314277,314277,314280,0,3,4
89614,4,3,314281,314281,314284,0,3,1
89615,5,2,314286,314286,314288,0,2,2
89616,2,3,314288,314288,314291,0,3,0
89617,5,2,314293,314293,314295,0,2,2
89618,6,3,314299,314299,314302,0,3,4
89619,3,1,314302,314302,314303,0,1,0
89620,5,3,314307,314307,314310,0,3,4
89621,1,2,314308,314310,314312,2,4,0
89622,4,1,314312,314312,314313,0,1,0
89623,3,3,314315,314315,314318,0,3,2
89624,1,3,314316,314318,314321,2,5,0
89625,2,1,314318,314321,314322,3,4,0
89626,1,1,314319,314322,314323,3,4,0
89627,2,2,314321,314323,314325,2,4,0
89628,6,1,314327,314327,314328,0,1,2
89629,5,2,314332,314332,314334,0,2,4
89630,2,1,314334,314334,314335,0,1,0
89631,5,1,314339,314339,314340,0,1,4
89632,3,2,314342,314342,314344,0,2,2
89633,3,2,314345,314345,314347,0,2,1
89634,2,3,314347,314347,314350,0,3,0
89635,6,3,314353,314353,314356,0,3,3
89636,4,3,314357,314357,314360,0,3,1
89637,4,1,314361,314361,314362,0,1,1
89638,1,3,314362,314362,314365,0,3,0
89639,1,3,314363,314365,314368,2,5,0
89640,5,2,314368,314368,314370,0,2,0
89641,4,3,314372,314372,314375,0,3,2
89642,6,1,314378,314378,314379,0,1,3
89643,6,2,314384,314384,314386,0,2,5
89644,1,1,314385,314386,314387,1,2,0
89645,6,3,314391,314391,314394,0,3,4
89646,4,1,314395,314395,314396,0,1,1
89647,5,1,314400,314400,314401,0,1,4
89648,6,1,314406,314406,314407,0,1,5
89649,2,2,314408,314408,314410,0,2,1
89650,2,1,314410,314410,314411,0,1,0
89651,6,1,314416,314416,314417,0,1,5
89652,6,3,314422,314422,314425,0,3,5
89653,3,2,314425,314425,314427,0,2,0
89654,3,1,314428,314428,314429,0,1,1
89655,3,3,314431,314431,314434,0,3,2
89656,4,1,314435,314435,314436,0,1,1
89657,4,3,314439,314439,314442,0,3,3
89658,2,2,314441,314442,314444,1,3,0
89659,2,3,314443,314444,314447,1,4,0
89660,2,2,314445,314447,314449,2,4,0
89661,2,2,314447,314449,314451,2,4,0
89662,2,3,314449,314451,314454,2,5,0
89663,3,3,314452,314454,314457,2,5,0
89664,5,1,314457,314457,314458,0,1,0
89665,5,2,314462,314462,314464,0,2,4
89666,2,2,314464,314464,314466,0,2,0
89667,4,1,314468,314468,314469,0,1,2
89668,6,2,314474,314474,314476,0,2,5
89669,1,3,314475,314476,314479,1,4,0
89670,3,3,314478,314479,314482,1,4,0
89671,3,1,314481,314482,314483,1,2,0
89672,5,2,314486,314486,314488,0,2,3
89673,5,2,314491,314491,314493,0,2,3
89674,4,3,314495,314495,314498,0,3,2
89675,3,3,314498,314498,314501,0,3,0
89676,2,3,314500,314501,314504,1,4,0
89677,5,2,314505,314505,314507,0,2,1
89678,3,2,314508,314508,314510,0,2,1
89679,1,3,314509,314510,314513,1,4,0
89680,1,1,314510,314513,314514,3,4,0
89681,5,2,314515,314515,314517,0,2,1
89682,2,2,314517,314517,314519,0,2,0
89683,4,2,314521,314521,314523,0,2,2
89684,1,1,314522,314523,314524,1,2,0
89685,3,1,314525,314525,314526,0,1,1
89686,4,2,314529,314529,314531,0,2,3
89687,6,2,314535,314535,314537,0,2,4
89688,3,3,314538,314538,314541,0,3,1
89689,4,3,314542,314542,314545,0,3,1
89690,5,2,314547,314547,314549,0,2,2
89691,3,1,314550,314550,314551,0,1,1
89692,6,2,314556,314556,314558,0,2,5
89693,3,3,314559,314559,314562,0,3,1
89694,1,2,314560,314562,314564,2,4,0
89695,4,1,314564,314564,314565,0,1,0
89696,1,3,314565,314565,314568,0,3,0
89697,5,3,314570,314570,314573,0,3,2
89698,1,3,314571,314573,314576,2,5,0
89699,4,1,314575,314576,314577,1,2,0
89700,1,1,314576,314577,314578,1,2,0
89701,6,3,314582,314582,314585,0,3,4
89702,3,1,314585,314585,314586,0,1,0
89703,1,3,314586,314586,314589,0,3,0
89704,4,2,314590,314590,314592,0,2,1
89705,4,2,314594,314594,314596,0,2,2
89706,1,3,314595,314596,314599,1,4,0
89707,3,2,314598,314599,314601,1,3,0
89708,6,2,314604,314604,314606,0,2,3
89709,4,2,314608,314608,314610,0,2,2
89710,1,3,314609,314610,314613,1,4,0
89711,6,3,314615,314615,314618,0,3,2
89712,5,2,314620,314620,314622,0,2,2
89713,2,3,314622,314622,314625,0,3,0
89714,6,2,314628,314628,314630,0,2,3
89715,4,1,314632,314632,314633,0,1,2
89716,5,1,314637,314637,314638,0,1,4
89717,6,3,314643,314643,314646,0,3,5
89718,3,3,314646,314646,314649,0,3,0
89719,5,3,314651,314651,314654,0,3,2
89720,6,1,314657,314657,314658,0,1,3
89721,5,1,314662,314662,314663,0,1,4
89722,3,2,314665,314665,314667,0,2,2
89723,6,2,314671,314671,314673,0,2,4
89724,5,2,314676,314676,314678,0,2,3
89725,4,2,314680,314680,314682,0,2,2
89726,3,2,314683,314683,314685,0,2,1
89727,1,1,314684,314685,314686,1,2,0
89728,5,1,314689,314689,314690,0,1,3
89729,6,1,314695,314695,314696,0,1,5
89730,4,3,314699,314699,314702,0,3,3
89731,4,3,314703,314703,314706,0,3,1
89732,3,2,314706,314706,314708,0,2,0
89733,5,3,314711,314711,314714,0,3,3
89734,4,3,314715,314715,314718,0,3,1
89735,5,1,314720,314720,314721,0,1,2
89736,4,3,314724,314724,314727,0,3,3
89737,5,2,314729,314729,314731,0,2,2
89738,1,3,314730,314731,314734,1,4,0
89739,1,1,314731,314734,314735,3,4,0
89740,2,3,314733,314735,314738,2,5,0
89741,1,3,314734,314738,314741,4,7,0
89742,3,2,314737,314741,314743,4,6,0
89743,2,2,314739,314743,314745,4,6,0
89744,5,1,314744,314745,314746,1,2,0
89745,2,2,314746,314746,314748,0,2,0
89746,3,3,314749,314749,314752,0,3,1
89747,6,1,314755,314755,314756,0,1,3
89748,4,1,314759,314759,314760,0,1,3
89749,4,1,314763,314763,314764,0,1,3
89750,4,3,314767,314767,314770,0,3,3
89751,2,3,314769,314770,314773,1,4,0
89752,5,3,314774,314774,314777,0,3,1
89753,4,3,314778,314778,314781,0,3,1
89754,2,3,314780,314781,314784,1,4,0
89755,3,1,314783,314784,314785,1,2,0
89756,1,3,314784,314785,314788,1,4,0
89757,1,1,314785,314788,314789,3,4,0
89758,4,1,314789,314789,314790,0,1,0
89759,3,1,314792,314792,314793,0,1,2
89760,2,1,314794,314794,314795,0,1,1
89761,6,2,314800,314800,314802,0,2,5
89762,1,2,314801,314802,314804,1,3,0
89763,2,2,314803,314804,314806,1,3,0
89764,1,2,314804,314806,314808,2,4,0
89765,3,3,314807,314808,314811,1,4,0
89766,2,1,314809,314811,314812,2,3,0
89767,3,1,314812,314812,314813,0,1,0
89768,2,1,314814,314814,314815,0,1,1
89769,5,1,314819,314819,314820,0,1,4
89770,1,2,314820,314820,314822,0,2,0
89771,4,2,314824,314824,314826,0,2,2
89772,6,1,314830,314830,314831,0,1,4
89773,2,3,314832,314832,314835,0,3,1
89774,3,1,314835,314835,314836,0,1,0
89775,5,2,314840,314840,314842,0,2,4
89776,5,3,314845,314845,314848,0,3,3
89777,5,3,314850,314850,314853,0,3,2
89778,1,1,314851,314853,314854,2,3,0
89779,3,3,314854,314854,314857,0,3,0
89780,2,2,314856,314857,314859,1,3,0
89781,2,2,314858,314859,314861,1,3,0
89782,2,1,314860,314861,314862,1,2,0
89783,5,3,314865,314865,314868,0,3,3
89784,3,2,314868,314868,314870,0,2,0
89785,1,1,314869,314870,314871,1,2,0
89786,5,2,314874,314874,314876,0,2,3
89787,1,1,314875,314876,314877,1,2,0
89788,4,3,314879,314879,314882,0,3,2
89789,3,3,314882,314882,314885,0,3,0
89790,2,2,314884,314885,314887,1,3,0
89791,1,3,314885,314887,314890,2,5,0
89792,2,2,314887,314890,314892,3,5,0
89793,4,2,314891,314892,314894,1,3,0
89794,2,1,314893,314894,314895,1,2,0
89795,6,1,314899,314899,314900,0,1,4
89796,1,2,314900,314900,314902,0,2,0
89797,5,2,314905,314905,314907,0,2,3
89798,2,3,314907,314907,314910,0,3,0
89799,3,1,314910,314910,314911,0,1,0
89800,6,1,314916,314916,314917,0,1,5
89801,1,1,314917,314917,314918,0,1,0
89802,3,2,314920,314920,314922,0,2,2
89803,6,2,314926,314926,314928,0,2,4
89804,6,1,314932,314932,314933,0,1,4
89805,5,2,314937,314937,314939,0,2,4
89806,4,2,314941,314941,314943,0,2,2
89807,5,2,314946,314946,314948,0,2,3
89808,5,3,314951,314951,314954,0,3,3
89809,5,1,314956,314956,314957,0,1,2
89810,3,3,314959,314959,314962,0,3,2
89811,6,3,314965,314965,314968,0,3,3
89812,2,1,314967,314968,314969,1,2,0
89813,1,1,314968,314969,314970,1,2,0
89814,3,3,314971,314971,314974,0,3,1
89815,2,1,314973,314974,314975,1,2,0
89816,6,3,314979,314979,314982,0,3,4
89817,5,3,314984,314984,314987,0,3,2
89818,3,2,314987,314987,314989,0,2,0
89819,3,3,314990,314990,314993,0,3,1
89820,4,2,314994,314994,314996,0,2,1
89821,2,1,314996,314996,314997,0,1,0
89822,4,1,315000,315000,315001,0,1,3
89823,5,2,315005,315005,315007,0,2,4
89824,1,2,315006,315007,315009,1,3,0
89825,1,3,315007,315009,315012,2,5,0
89826,3,2,315010,315012,315014,2,4,0
89827,5,3,315015,315015,315018,0,3,1
89828,4,3,315019,315019,315022,0,3,1
89829,6,1,315025,315025,315026,0,1,3
89830,3,3,315028,315028,315031,0,3,2
89831,3,3,315031,315031,315034,0,3,0
89832,5,1,315036,315036,315037,0,1,2
89833,3,2,315039,315039,315041,0,2,2
89834,4,2,315043,315043,315045,0,2,2
89835,4,3,315047,315047,315050,0,3,2
89836,3,2,315050,315050,315052,0,2,0
89837,4,2,315054,315054,315056,0,2,2
89838,1,1,315055,315056,315057,1,2,0
89839,3,1,315058,315058,315059,0,1,1
89840,1,3,315059,315059,315062,0,3,0
89841,6,1,315065,315065,315066,0,1,3
89842,6,2,315071,315071,315073,0,2,5
89843,5,2,315076,315076,315078,0,2,3
89844,1,2,315077,315078,315080,1,3,0
89845,6,1,315083,315083,315084,0,1,3
89846,3,1,315086,315086,315087,0,1,2
89847,6,3,315092,315092,315095,0,3,5
89848,2,3,315094,315095,315098,1,4,0
89849,3,2,315097,315098,315100,1,3,0
89850,4,2,315101,315101,315103,0,2,1
89851,3,1,315104,315104,315105,0,1,1
89852,5,1,315109,315109,315110,0,1,4
89853,4,1,315113,315113,315114,0,1,3
89854,1,3,315114,315114,315117,0,3,0
89855,4,1,315118,315118,315119,0,1,1
89856,5,3,315123,315123,315126,0,3,4
89857,5,2,315128,315128,315130,0,2,2
89858,4,3,315132,315132,315135,0,3,2
89859,1,2,315133,315135,315137,2,4,0
89860,5,2,315138,315138,315140,0,2,1
89861,4,2,315142,315142,315144,0,2,2
89862,5,2,315147,315147,315149,0,2,3
89863,1,2,315148,315149,315151,1,3,0
89864,6,1,315154,315154,315155,0,1,3
89865,1,3,315155,315155,315158,0,3,0
89866,6,2,315161,315161,315163,0,2,3
89867,5,3,315166,315166,315169,0,3,3
89868,5,2,315171,315171,315173,0,2,2
89869,6,2,315177,315177,315179,0,2,4
89870,6,1,315183,315183,315184,0,1,4
89871,3,1,315186,315186,315187,0,1,2
89872,5,3,315191,315191,315194,0,3,4
89873,4,3,315195,315195,315198,0,3,1
89874,4,2,315199,315199,315201,0,2,1
89875,4,3,315203,315203,315206,0,3,2
89876,5,1,315208,315208,315209,0,1,2
89877,1,3,315209,315209,315212,0,3,0
89878,4,2,315213,315213,315215,0,2,1
89879,2,1,315215,315215,315216,0,1,0
89880,4,3,315219,315219,315222,0,3,3
89881,4,2,315223,315223,315225,0,2,1
89882,2,3,315225,315225,315228,0,3,0
89883,5,1,315230,315230,315231,0,1,2
89884,6,1,315236,315236,315237,0,1,5
89885,4,2,315240,315240,315242,0,2,3
89886,3,2,315243,315243,315245,0,2,1
89887,1,1,315244,315245,315246,1,2,0
89888,4,1,315248,315248,315249,0,1,2
89889,3,2,315251,315251,315253,0,2,2
89890,1,2,315252,315253,315255,1,3,0
89891,1,1,315253,315255,315256,2,3,0
89892,2,1,315255,315256,315257,1,2,0
89893,6,1,315261,315261,315262,0,1,4
89894,6,1,315267,315267,315268,0,1,5
89895,3,1,315270,315270,315271,0,1,2
89896,3,1,315273,315273,315274,0,1,2
89897,2,1,315275,315275,315276,0,1,1
89898,3,2,315278,315278,315280,0,2,2
89899,5,2,315283,315283,315285,0,2,3
89900,4,2,315287,315287,315289,0,2,2
89901,3,2,315290,315290,315292,0,2,1
89902,5,2,315295,315295,315297,0,2,3
89903,2,1,315297,315297,315298,0,1,0
89904,1,2,315298,315298,315300,0,2,0
89905,6,2,315304,315304,315306,0,2,4
89906,4,3,315308,315308,315311,0,3,2
89907,4,2,315312,315312,315314,0,2,1
89908,6,2,315318,315318,315320,0,2,4
89909,6,2,315324,315324,315326,0,2,4
89910,1,2,315325,315326,315328,1,3,0
89911,3,3,315328,315328,315331,0,3,0
89912,1,3,315329,315331,315334,2,5,0
89913,3,3,315332,315334,315337,2,5,0
89914,3,2,315335,315337,315339,2,4,0
89915,6,1,315341,315341,315342,0,1,2
89916,4,1,315345,315345,315346,0,1,3
89917,6,1,315351,315351,315352,0,1,5
89918,1,3,315352,315352,315355,0,3,0
89919,2,3,315354,315355,315358,1,4,0
89920,2,1,315356,315358,315359,2,3,0
89921,3,1,315359,315359,315360,0,1,0
89922,3,2,315362,315362,315364,0,2,2
89923,6,2,315368,315368,315370,0,2,4
89924,4,3,315372,315372,315375,0,3,2
89925,6,1,315378,315378,315379,0,1,3
89926,4,3,315382,315382,315385,0,3,3
89927,2,1,315384,315385,315386,1,2,0
89928,4,2,315388,315388,315390,0,2,2
89929,5,2,315393,315393,315395,0,2,3
89930,1,2,315394,315395,315397,1,3,0
89931,1,2,315395,315397,315399,2,4,0
89932,2,2,315397,315399,315401,2,4,0
89933,6,3,315403,315403,315406,0,3,2
89934,6,1,315409,315409,315410,0,1,3
89935,6,3,315415,315415,315418,0,3,5
89936,1,3,315416,315418,315421,2,5,0
89937,3,2,315419,315421,315423,2,4,0
89938,5,1,315424,315424,315425,0,1,1
89939,6,1,315430,315430,315431,0,1,5
89940,3,3,315433,315433,315436,0,3,2
89941,1,1,315434,315436,315437,2,3,0
89942,4,1,315438,315438,315439,0,1,1
89943,6,3,315444,315444,315447,0,3,5
89944,1,1,315445,315447,315448,2,3,0
89945,4,2,315449,315449,315451,0,2,1
89946,6,1,315455,315455,315456,0,1,4
89947,2,2,315457,315457,315459,0,2,1
89948,4,3,315461,315461,315464,0,3,2
89949,1,1,315462,315464,315465,2,3,0
89950,5,1,315467,315467,315468,0,1,2
89951,2,2,315469,315469,315471,0,2,1
89952,4,2,315473,315473,315475,0,2,2
89953,1,2,315474,315475,315477,1,3,0
89954,5,1,315479,315479,315480,0,1,2
89955,5,1,315484,315484,315485,0,1,4
89956,5,3,315489,315489,315492,0,3,4
89957,5,2,315494,315494,315496,0,2,2
89958,6,2,315500,315500,315502,0,2,4
89959,3,2,315503,315503,315505,0,2,1
89960,4,3,315507,315507,315510,0,3,2
89961,1,1,315508,315510,315511,2,3,0
89962,3,2,315511,315511,315513,0,2,0
89963,5,1,315516,315516,315517,0,1,3
89964,3,3,315519,315519,315522,0,3,2
89965,4,2,315523,315523,315525,0,2,1
89966,3,3,315526,315526,315529,0,3,1
89967,4,3,315530,315530,315533,0,3,1
89968,6,3,315536,315536,315539,0,3,3
89969,2,2,315538,315539,315541,1,3,0
89970,6,3,315544,315544,315547,0,3,3
89971,3,3,315547,315547,315550,0,3,0
89972,5,2,315552,315552,315554,0,2,2
89973,2,1,315554,315554,315555,0,1,0
89974,2,1,315556,315556,315557,0,1,1
89975,5,2,315561,315561,315563,0,2,4
89976,3,3,315564,315564,315567,0,3,1
89977,3,3,315567,315567,315570,0,3,0
89978,1,1,315568,315570,315571,2,3,0
89979,5,1,315573,315573,315574,0,1,2
89980,1,3,315574,315574,315577,0,3,0
89981,3,3,315577,315577,315580,0,3,0
89982,1,3,315578,315580,315583,2,5,0
89983,4,3,315582,315583,315586,1,4,0
89984,1,1,315583,315586,315587,3,4,0
89985,4,1,315587,315587,315588,0,1,0
89986,1,3,315588,315588,315591,0,3,0
89987,1,2,315589,315591,315593,2,4,0
89988,6,3,315595,315595,315598,0,3,2
89989,3,2,315598,315598,315600,0,2,0
89990,4,3,315602,315602,315605,0,3,2
89991,6,2,315608,315608,315610,0,2,3
89992,3,3,315611,315611,315614,0,3,1
89993,2,2,315613,315614,315616,1,3,0
89994,3,1,315616,315616,315617,0,1,0
89995,1,2,315617,315617,315619,0,2,0
89996,5,3,315622,315622,315625,0,3,3
89997,5,2,315627,315627,315629,0,2,2
89998,1,1,315628,315629,315630,1,2,0
89999,6,1,315634,315634,315635,0,1,4
90000,4,2,315638,315638,315640,0,2,3
90001,4,2,315642,315642,315644,0,2,2
90002,3,3,315645,315645,315648,0,3,1
90003,3,3,315648,315648,315651,0,3,0
90004,5,1,315653,315653,315654,0,1,2
90005,2,3,315655,315655,315658,0,3,1
90006,6,1,315661,315661,315662,0,1,3
90007,6,2,315667,315667,315669,0,2,5
90008,2,3,315669,315669,315672,0,3,0
90009,6,2,315675,315675,315677,0,2,3
90010,3,1,315678,315678,315679,0,1,1
90011,6,2,315684,315684,315686,0,2,5
90012,3,1,315687,315687,315688,0,1,1
90013,1,2,315688,315688,315690,0,2,0
90014,2,3,315690,315690,315693,0,3,0
90015,2,3,315692,315693,315696,1,4,0
90016,3,2,315695,315696,315698,1,3,0
90017,2,2,315697,315698,315700,1,3,0
90018,4,1,315701,315701,315702,0,1,1
90019,6,2,315707,315707,315709,0,2,5
90020,5,1,315712,315712,315713,0,1,3
90021,2,3,315714,315714,315717,0,3,1
90022,3,2,315717,315717,315719,0,2,0
90023,5,2,315722,315722,315724,0,2,3
90024,3,2,315725,315725,315727,0,2,1
90025,2,3,315727,315727,315730,0,3,0
90026,6,2,315733,315733,315735,0,2,3
90027,2,2,315735,315735,315737,0,2,0
90028,4,3,315739,315739,315742,0,3,2
90029,1,1,315740,315742,315743,2,3,0
90030,4,1,315744,315744,315745,0,1,1
90031,6,1,315750,315750,315751,0,1,5
90032,2,3,315752,315752,315755,0,3,1
90033,4,1,315756,315756,315757,0,1,1
90034,2,3,315758,315758,315761,0,3,1
90035,3,2,315761,315761,315763,0,2,0
90036,6,2,315767,315767,315769,0,2,4
90037,4,2,315771,315771,315773,0,2,2
90038,6,2,315777,315777,315779,0,2,4
90039,3,3,315780,315780,315783,0,3,1
90040,1,2,315781,315783,315785,2,4,0
90041,2,3,315783,315785,315788,2,5,0
90042,3,2,315786,315788,315790,2,4,0
90043,6,1,315792,315792,315793,0,1,2
90044,2,2,315794,315794,315796,0,2,1
90045,2,3,315796,315796,315799,0,3,0
90046,5,3,315801,315801,315804,0,3,2
90047,3,1,315804,315804,315805,0,1,0
90048,6,3,315810,315810,315813,0,3,5
90049,1,1,315811,315813,315814,2,3,0
90050,1,2,315812,315814,315816,2,4,0
90051,4,1,315816,315816,315817,0,1,0
90052,1,3,315817,315817,315820,0,3,0
90053,1,1,315818,315820,315821,2,3,0
90054,1,1,315819,315821,315822,2,3,0
90055,5,3,315824,315824,315827,0,3,2
90056,1,1,315825,315827,315828,2,3,0
90057,6,3,315831,315831,315834,0,3,3
90058,4,3,315835,315835,315838,0,3,1
90059,5,1,315840,315840,315841,0,1,2
90060,3,2,315843,315843,315845,0,2,2
90061,1,2,315844,315845,315847,1,3,0
90062,1,2,315845,315847,315849,2,4,0
90063,4,2,315849,315849,315851,0,2,0
90064,1,1,315850,315851,315852,1,2,0
90065,5,1,315855,315855,315856,0,1,3
90066,1,2,315856,315856,315858,0,2,0
90067,6,1,315862,315862,315863,0,1,4
90068,4,3,315866,315866,315869,0,3,3
90069,2,3,315868,315869,315872,1,4,0
90070,2,1,315870,315872,315873,2,3,0
90071,2,2,315872,315873,315875,1,3,0
90072,2,2,315874,315875,315877,1,3,0
90073,6,2,315880,315880,315882,0,2,3
90074,5,1,315885,315885,315886,0,1,3
90075,1,2,315886,315886,315888,0,2,0
90076,1,1,315887,315888,315889,1,2,0
90077,4,2,315891,315891,315893,0,2,2
90078,1,1,315892,315893,315894,1,2,0
90079,2,2,315894,315894,315896,0,2,0
90080,4,2,315898,315898,315900,0,2,2
90081,4,2,315902,315902,315904,0,2,2
90082,2,3,315904,315904,315907,0,3,0
90083,1,2,315905,315907,315909,2,4,0
90084,3,3,315908,315909,315912,1,4,0
90085,2,2,315910,315912,315914,2,4,0
90086,5,3,315915,315915,315918,0,3,1
90087,6,2,315921,315921,315923,0,2,3
90088,4,3,315925,315925,315928,0,3,2
90089,6,1,315931,315931,315932,0,1,3
90090,6,2,315937,315937,315939,0,2,5
90091,3,3,315940,315940,315943,0,3,1
90092,3,2,315943,315943,315945,0,2,0
90093,4,3,315947,315947,315950,0,3,2
90094,4,3,315951,315951,315954,0,3,1
90095,6,2,315957,315957,315959,0,2,3
90096,4,3,315961,315961,315964,0,3,2
90097,6,1,315967,315967,315968,0,1,3
90098,6,1,315973,315973,315974,0,1,5
90099,3,1,315976,315976,315977,0,1,2
90100,4,1,315980,315980,315981,0,1,3
90101,2,2,315982,315982,315984,0,2,1
90102,2,2,315984,315984,315986,0,2,0
90103,6,1,315990,315990,315991,0,1,4
90104,2,2,315992,315992,315994,0,2,1
90105,3,3,315995,315995,315998,0,3,1
90106,3,3,315998,315998,316001,0,3,0
90107,6,3,316004,316004,316007,0,3,3
90108,6,3,316010,316010,316013,0,3,3
90109,3,2,316013,316013,316015,0,2,0
90110,4,3,316017,316017,316020,0,3,2
90111,6,2,316023,316023,316025,0,2,3
90112,4,3,316027,316027,316030,0,3,2
90113,3,3,316030,316030,316033,0,3,0
90114,5,1,316035,316035,316036,0,1,2
90115,3,2,316038,316038,316040,0,2,2
90116,1,3,316039,316040,316043,1,4,0
90117,3,1,316042,316043,316044,1,2,0
90118,4,1,316046,316046,316047,0,1,2
90119,1,3,316047,316047,316050,0,3,0
90120,4,2,316051,316051,316053,0,2,1
90121,3,2,316054,316054,316056,0,2,1
90122,1,2,316055,316056,316058,1,3,0
90123,1,1,316056,316058,316059,2,3,0
90124,6,1,316062,316062,316063,0,1,3
90125,3,2,316065,316065,316067,0,2,2
90126,4,2,316069,316069,316071,0,2,2
90127,2,2,316071,316071,316073,0,2,0
90128,5,3,316076,316076,316079,0,3,3
90129,6,1,316082,316082,316083,0,1,3
90130,2,2,316084,316084,316086,0,2,1
90131,4,2,316088,316088,316090,0,2,2
90132,5,1,316093,316093,316094,0,1,3
90133,4,2,316097,316097,316099,0,2,3
90134,1,3,316098,316099,316102,1,4,0
90135,1,1,316099,316102,316103,3,4,0
90136,2,1,316101,316103,316104,2,3,0
90137,4,2,316105,316105,316107,0,2,1
90138,2,1,316107,316107,316108,0,1,0
90139,3,2,316110,316110,316112,0,2,2
90140,4,3,316114,316114,316117,0,3,2
90141,6,2,316120,316120,316122,0,2,3
90142,2,1,316122,316122,316123,0,1,0
90143,2,3,316124,316124,316127,0,3,1
90144,3,1,316127,316127,316128,0,1,0
90145,1,3,316128,316128,316131,0,3,0
90146,2,2,316130,316131,316133,1,3,0
90147,3,1,316133,316133,316134,0,1,0
90148,4,2,316137,316137,316139,0,2,3
90149,4,2,316141,316141,316143,0,2,2
90150,5,2,316146,316146,316148,0,2,3
90151,1,1,316147,316148,316149,1,2,0
90152,1,3,316148,316149,316152,1,4,0
90153,1,2,316149,316152,316154,3,5,0
90154,3,2,316152,316154,316156,2,4,0
90155,3,1,316155,316156,316157,1,2,0
90156,6,3,316161,316161,316164,0,3,4
90157,1,2,316162,316164,316166,2,4,0
90158,3,1,316165,316166,316167,1,2,0
90159,4,1,316169,316169,316170,0,1,2
90160,1,3,316170,316170,316173,0,3,0
90161,5,3,316175,316175,316178,0,3,2
90162,6,3,316181,316181,316184,0,3,3
90163,3,2,316184,316184,316186,0,2,0
90164,5,2,316189,316189,316191,0,2,3
90165,6,2,316195,316195,316197,0,2,4
90166,2,1,316197,316197,316198,0,1,0
90167,3,3,316200,316200,316203,0,3,2
90168,5,3,316205,316205,316208,0,3,2
90169,2,2,316207,316208,316210,1,3,0
90170,5,3,316212,316212,316215,0,3,2
90171,5,2,316217,316217,316219,0,2,2
90172,6,2,316223,316223,316225,0,2,4
90173,3,2,316226,316226,316228,0,2,1
90174,5,3,316231,316231,316234,0,3,3
90175,5,3,316236,316236,316239,0,3,2
90176,5,2,316241,316241,316243,0,2,2
90177,5,1,316246,316246,316247,0,1,3
90178,6,1,316252,316252,316253,0,1,5
90179,2,3,316254,316254,316257,0,3,1
90180,4,2,316258,316258,316260,0,2,1
90181,5,1,316263,316263,316264,0,1,3
90182,5,1,316268,316268,316269,0,1,4
90183,4,3,316272,316272,316275,0,3,3
90184,1,1,316273,316275,316276,2,3,0
90185,5,1,316278,316278,316279,0,1,2
90186,1,2,316279,316279,316281,0,2,0
90187,3,3,316282,316282,316285,0,3,1
90188,1,3,316283,316285,316288,2,5,0
90189,4,1,316287,316288,316289,1,2,0
90190,1,3,316288,316289,316292,1,4,0
90191,6,3,316294,316294,316297,0,3,2
90192,5,3,316299,316299,316302,0,3,2
90193,4,1,316303,316303,316304,0,1,1
90194,3,3,316306,316306,316309,0,3,2
90195,2,2,316308,316309,316311,1,3,0
90196,4,1,316312,316312,316313,0,1,1
90197,5,1,316317,316317,316318,0,1,4
90198,3,3,316320,316320,316323,0,3,2
90199,3,1,316323,316323,316324,0,1,0
90200,1,1,316324,316324,316325,0,1,0
90201,1,3,316325,316325,316328,0,3,0
90202,5,3,316330,316330,316333,0,3,2
90203,4,3,316334,316334,316337,0,3,1
90204,3,3,316337,316337,316340,0,3,0
90205,2,1,316339,316340,316341,1,2,0
90206,2,3,316341,316341,316344,0,3,0
90207,5,3,316346,316346,316349,0,3,2
90208,6,3,316352,316352,316355,0,3,3
90209,6,3,316358,316358,316361,0,3,3
90210,6,2,316364,316364,316366,0,2,3
90211,2,3,316366,316366,316369,0,3,0
90212,3,3,316369,316369,316372,0,3,0
90213,5,2,316374,316374,316376,0,2,2
90214,1,1,316375,316376,316377,1,2,0
90215,1,2,316376,316377,316379,1,3,0
90216,1,1,316377,316379,316380,2,3,0
90217,4,1,316381,316381,316382,0,1,1
90218,5,2,316386,316386,316388,0,2,4
90219,5,2,316391,316391,316393,0,2,3
90220,3,1,316394,316394,316395,0,1,1
90221,5,1,316399,316399,316400,0,1,4
90222,4,1,316403,316403,316404,0,1,3
90223,1,3,316404,316404,316407,0,3,0
90224,5,1,316409,316409,316410,0,1,2
90225,2,3,316411,316411,316414,0,3,1
90226,6,3,316417,316417,316420,0,3,3
90227,3,2,316420,316420,316422,0,2,0
90228,5,1,316425,316425,316426,0,1,3
90229,3,3,316428,316428,316431,0,3,2
90230,4,2,316432,316432,316434,0,2,1
90231,4,2,316436,316436,316438,0,2,2
90232,6,3,316442,316442,316445,0,3,4
90233,3,3,316445,316445,316448,0,3,0
90234,3,1,316448,316448,316449,0,1,0
90235,3,2,316451,316451,316453,0,2,2
90236,4,1,316455,316455,316456,0,1,2
90237,5,2,316460,316460,316462,0,2,4
90238,2,3,316462,316462,316465,0,3,0
90239,3,1,316465,316465,316466,0,1,0
90240,5,1,316470,316470,316471,0,1,4
90241,1,1,316471,316471,316472,0,1,0
90242,1,3,316472,316472,316475,0,3,0
90243,1,2,316473,316475,316477,2,4,0
90244,4,1,316477,316477,316478,0,1,0
90245,4,3,316481,316481,316484,0,3,3
90246,2,1,316483,316484,316485,1,2,0
90247,6,3,316489,316489,316492,0,3,4
90248,5,1,316494,316494,316495,0,1,2
90249,5,2,316499,316499,316501,0,2,4
90250,6,3,316505,316505,316508,0,3,4
90251,4,3,316509,316509,316512,0,3,1
90252,6,1,316515,316515,316516,0,1,3
90253,6,3,316521,316521,316524,0,3,5
90254,6,1,316527,316527,316528,0,1,3
90255,5,1,316532,316532,316533,0,1,4
90256,1,3,316533,316533,316536,0,3,0
90257,6,2,316539,316539,316541,0,2,3
90258,4,1,316543,316543,316544,0,1,2
90259,5,3,316548,316548,316551,0,3,4
90260,5,3,316553,316553,316556,0,3,2
90261,4,1,316557,316557,316558,0,1,1
90262,5,2,316562,316562,316564,0,2,4
90263,5,1,316567,316567,316568,0,1,3
90264,4,2,316571,316571,316573,0,2,3
90265,6,3,316577,316577,316580,0,3,4
90266,2,2,316579,316580,316582,1,3,0
90267,1,2,316580,316582,316584,2,4,0
90268,5,3,316585,316585,316588,0,3,1
90269,1,1,316586,316588,316589,2,3,0
90270,4,1,316590,316590,316591,0,1,1
90271,6,3,316596,316596,316599,0,3,5
90272,4,2,316600,316600,316602,0,2,1
90273,2,2,316602,316602,316604,0,2,0
90274,6,3,316608,316608,316611,0,3,4
90275,4,1,316612,316612,316613,0,1,1
90276,4,3,316616,316616,316619,0,3,3
90277,2,3,316618,316619,316622,1,4,0
90278,1,2,316619,316622,316624,3,5,0
90279,6,3,316625,316625,316628,0,3,1
90280,4,3,316629,316629,316632,0,3,1
90281,1,3,316630,316632,316635,2,5,0
90282,1,2,316631,316635,316637,4,6,0
90283,1,2,316632,316637,316639,5,7,0
90284,3,2,316635,316639,316641,4,6,0
90285,4,3,316639,316641,316644,2,5,0
90286,2,2,316641,316644,316646,3,5,0
90287,2,3,316643,316646,316649,3,6,0
90288,1,2,316644,316649,316651,5,7,0
90289,6,3,316650,316651,316654,1,4,0
90290,2,2,316652,316654,316656,2,4,0
90291,3,1,316655,316656,316657,1,2,0
90292,4,3,316659,316659,316662,0,3,2
90293,4,2,316663,316663,316665,0,2,1
90294,4,1,316667,316667,316668,0,1,2
90295,6,2,316673,316673,316675,0,2,5
90296,2,3,316675,316675,316678,0,3,0
90297,3,2,316678,316678,316680,0,2,0
90298,3,2,316681,316681,316683,0,2,1
90299,1,3,316682,316683,316686,1,4,0
90300,4,1,316686,316686,316687,0,1,0
90301,5,1,316691,316691,316692,0,1,4
90302,4,1,316695,316695,316696,0,1,3
90303,3,1,316698,316698,316699,0,1,2
90304,6,1,316704,316704,316705,0,1,5
90305,2,3,316706,316706,316709,0,3,1
90306,6,2,316712,316712,316714,0,2,3
90307,4,1,316716,316716,316717,0,1,2
90308,2,3,316718,316718,316721,0,3,1
90309,2,1,316720,316721,316722,1,2,0
90310,5,1,316725,316725,316726,0,1,3
90311,5,1,316730,316730,316731,0,1,4
90312,4,1,316734,316734,316735,0,1,3
90313,3,2,316737,316737,316739,0,2,2
90314,2,1,316739,316739,316740,0,1,0
90315,6,2,316745,316745,316747,0,2,5
90316,5,1,316750,316750,316751,0,1,3
90317,4,3,316754,316754,316757,0,3,3
90318,4,1,316758,316758,316759,0,1,1
90319,5,1,316763,316763,316764,0,1,4
90320,4,2,316767,316767,316769,0,2,3
90321,6,3,316773,316773,316776,0,3,4
90322,4,1,316777,316777,316778,0,1,1
90323,6,2,316783,316783,316785,0,2,5
90324,1,1,316784,316785,316786,1,2,0
90325,6,2,316790,316790,316792,0,2,4
90326,6,2,316796,316796,316798,0,2,4
90327,2,1,316798,316798,316799,0,1,0
90328,3,3,316801,316801,316804,0,3,2
90329,5,1,316806,316806,316807,0,1,2
90330,4,2,316810,316810,316812,0,2,3
90331,3,1,316813,316813,316814,0,1,1
90332,3,1,316816,316816,316817,0,1,2
90333,2,3,316818,316818,316821,0,3,1
90334,6,2,316824,316824,316826,0,2,3
90335,6,2,316830,316830,316832,0,2,4
90336,5,2,316835,316835,316837,0,2,3
90337,6,2,316841,316841,316843,0,2,4
90338,5,3,316846,316846,316849,0,3,3
90339,6,1,316852,316852,316853,0,1,3
90340,3,3,316855,316855,316858,0,3,2
90341,3,2,316858,316858,316860,0,2,0
90342,6,1,316864,316864,316865,0,1,4
90343,1,3,316865,316865,316868,0,3,0
90344,2,2,316867,316868,316870,1,3,0
90345,2,1,316869,316870,316871,1,2,0
90346,6,3,316875,316875,316878,0,3,4
90347,2,3,316877,316878,316881,1,4,0
90348,3,3,316880,316881,316884,1,4,0
90349,3,1,316883,316884,316885,1,2,0
90350,6,3,316889,316889,316892,0,3,4
90351,2,1,316891,316892,316893,1,2,0
90352,3,1,316894,316894,316895,0,1,1
90353,4,2,316898,316898,316900,0,2,3
90354,2,1,316900,316900,316901,0,1,0
90355,4,2,316904,316904,316906,0,2,3
90356,4,2,316908,316908,316910,0,2,2
90357,4,2,316912,316912,316914,0,2,2
90358,6,3,316918,316918,316921,0,3,4
90359,2,3,316920,316921,316924,1,4,0
90360,5,2,316925,316925,316927,0,2,1
90361,5,2,316930,316930,316932,0,2,3
90362,5,1,316935,316935,316936,0,1,3
90363,3,2,316938,316938,316940,0,2,2
90364,5,1,316943,316943,316944,0,1,3
90365,1,1,316944,316944,316945,0,1,0
90366,3,1,316947,316947,316948,0,1,2
90367,5,2,316952,316952,316954,0,2,4
90368,1,1,316953,316954,316955,1,2,0
90369,5,1,316958,316958,316959,0,1,3
90370,3,3,316961,316961,316964,0,3,2
90371,3,2,316964,316964,316966,0,2,0
90372,3,3,316967,316967,316970,0,3,1
90373,4,2,316971,316971,316973,0,2,1
90374,4,2,316975,316975,316977,0,2,2
90375,5,3,316980,316980,316983,0,3,3
90376,2,2,316982,316983,316985,1,3,0
90377,2,1,316984,316985,316986,1,2,0
90378,1,3,316985,316986,316989,1,4,0
90379,2,2,316987,316989,316991,2,4,0
90380,5,1,316992,316992,316993,0,1,1
90381,2,1,316994,316994,316995,0,1,1
90382,4,1,316998,316998,316999,0,1,3
90383,3,2,317001,317001,317003,0,2,2
90384,1,1,317002,317003,317004,1,2,0
90385,4,1,317006,317006,317007,0,1,2
90386,2,1,317008,317008,317009,0,1,1
90387,6,2,317014,317014,317016,0,2,5
90388,3,2,317017,317017,317019,0,2,1
90389,5,2,317022,317022,317024,0,2,3
90390,2,1,317024,317024,317025,0,1,0
90391,1,1,317025,317025,317026,0,1,0
90392,4,2,317029,317029,317031,0,2,3
90393,3,2,317032,317032,317034,0,2,1
90394,3,2,317035,317035,317037,0,2,1
90395,5,2,317040,317040,317042,0,2,3
90396,2,1,317042,317042,317043,0,1,0
90397,1,3,317043,317043,317046,0,3,0
90398,1,2,317044,317046,317048,2,4,0
90399,2,1,317046,317048,317049,2,3,0
90400,3,1,317049,317049,317050,0,1,0
90401,2,3,317051,317051,317054,0,3,1
90402,4,3,317055,317055,317058,0,3,1
90403,6,2,317061,317061,317063,0,2,3
90404,1,2,317062,317063,317065,1,3,0
90405,6,1,317068,317068,317069,0,1,3
90406,4,2,317072,317072,317074,0,2,3
90407,3,2,317075,317075,317077,0,2,1
90408,2,3,317077,317077,317080,0,3,0
90409,1,3,317078,317080,317083,2,5,0
90410,4,3,317082,317083,317086,1,4,0
90411,3,3,317085,317086,317089,1,4,0
90412,4,1,317089,317089,317090,0,1,0
90413,2,1,317091,317091,317092,0,1,1
90414,5,2,317096,317096,317098,0,2,4
90415,6,3,317102,317102,317105,0,3,4
90416,4,2,317106,317106,317108,0,2,1
90417,6,3,317112,317112,317115,0,3,4
90418,1,2,317113,317115,317117,2,4,0
90419,2,2,317115,317117,317119,2,4,0
90420,4,1,317119,317119,317120,0,1,0
90421,6,3,317125,317125,317128,0,3,5
90422,3,1,317128,317128,317129,0,1,0
90423,4,3,317132,317132,317135,0,3,3
90424,1,2,317133,317135,317137,2,4,0
90425,2,3,317135,317137,317140,2,5,0
90426,4,1,317139,317140,317141,1,2,0
90427,6,2,317145,317145,317147,0,2,4
90428,5,2,317150,317150,317152,0,2,3
90429,5,1,317155,317155,317156,0,1,3
90430,2,1,317157,317157,317158,0,1,1
90431,4,2,317161,317161,317163,0,2,3
90432,3,2,317164,317164,317166,0,2,1
90433,4,3,317168,317168,317171,0,3,2
90434,5,2,317173,317173,317175,0,2,2
90435,6,3,317179,317179,317182,0,3,4
90436,4,3,317183,317183,317186,0,3,1
90437,6,1,317189,317189,317190,0,1,3
90438,5,2,317194,317194,317196,0,2,4
90439,5,2,317199,317199,317201,0,2,3
90440,3,2,317202,317202,317204,0,2,1
90441,2,3,317204,317204,317207,0,3,0
90442,5,2,317209,317209,317211,0,2,2
90443,5,3,317214,317214,317217,0,3,3
90444,2,3,317216,317217,317220,1,4,0
90445,3,3,317219,317220,317223,1,4,0
90446,6,1,317225,317225,317226,0,1,2
90447,2,3,317227,317227,317230,0,3,1
90448,5,3,317232,317232,317235,0,3,2
90449,1,1,317233,317235,317236,2,3,0
90450,4,3,317237,317237,317240,0,3,1
90451,4,2,317241,317241,317243,0,2,1
90452,4,2,317245,317245,317247,0,2,2
90453,4,1,317249,317249,317250,0,1,2
90454,2,1,317251,317251,317252,0,1,1
90455,1,3,317252,317252,317255,0,3,0
90456,3,3,317255,317255,317258,0,3,0
90457,2,3,317257,317258,317261,1,4,0
90458,1,3,317258,317261,317264,3,6,0
90459,4,3,317262,317264,317267,2,5,0
90460,4,3,317266,317267,317270,1,4,0
90461,2,2,317268,317270,317272,2,4,0
90462,3,1,317271,317272,317273,1,2,0
90463,2,3,317273,317273,317276,0,3,0
90464,5,1,317278,317278,317279,0,1,2
90465,5,2,317283,317283,317285,0,2,4
90466,2,1,317285,317285,317286,0,1,0
90467,3,1,317288,317288,317289,0,1,2
90468,1,1,317289,317289,317290,0,1,0
90469,3,3,317292,317292,317295,0,3,2
90470,2,2,317294,317295,317297,1,3,0
90471,1,2,317295,317297,317299,2,4,0
90472,5,3,317300,317300,317303,0,3,1
90473,1,2,317301,317303,317305,2,4,0
90474,1,3,317302,317305,317308,3,6,0
90475,1,3,317303,317308,317311,5,8,0
90476,4,2,317307,317311,317313,4,6,0
90477,2,3,317309,317313,317316,4,7,0
90478,5,3,317314,317316,317319,2,5,0
90479,3,1,317317,317319,317320,2,3,0
90480,1,3,317318,317320,317323,2,5,0
90481,4,2,317322,317323,317325,1,3,0
90482,6,2,317328,317328,317330,0,2,3
90483,5,1,317333,317333,317334,0,1,3
90484,3,2,317336,317336,317338,0,2,2
90485,2,2,317338,317338,317340,0,2,0
90486,6,3,317344,317344,317347,0,3,4
90487,5,2,317349,317349,317351,0,2,2
90488,6,3,317355,317355,317358,0,3,4
90489,2,1,317357,317358,317359,1,2,0
90490,2,1,317359,317359,317360,0,1,0
90491,2,3,317361,317361,317364,0,3,1
90492,6,1,317367,317367,317368,0,1,3
90493,6,2,317373,317373,317375,0,2,5
90494,4,3,317377,317377,317380,0,3,2
90495,3,2,317380,317380,317382,0,2,0
90496,6,3,317386,317386,317389,0,3,4
90497,6,3,317392,317392,317395,0,3,3
90498,4,3,317396,317396,317399,0,3,1
90499,6,3,317402,317402,317405,0,3,3
90500,4,2,317406,317406,317408,0,2,1
90501,2,2,317408,317408,317410,0,2,0
90502,5,1,317413,317413,317414,0,1,3
90503,4,2,317417,317417,317419,0,2,3
90504,4,2,317421,317421,317423,0,2,2
90505,5,1,317426,317426,317427,0,1,3
90506,3,2,317429,317429,317431,0,2,2
90507,5,1,317434,317434,317435,0,1,3
90508,5,1,317439,317439,317440,0,1,4
90509,4,3,317443,317443,317446,0,3,3
90510,2,3,317445,317446,317449,1,4,0
90511,3,1,317448,317449,317450,1,2,0
90512,2,1,317450,317450,317451,0,1,0
90513,1,2,317451,317451,317453,0,2,0
90514,5,1,317456,317456,317457,0,1,3
90515,1,2,317457,317457,317459,0,2,0
90516,3,3,317460,317460,317463,0,3,1
90517,2,2,317462,317463,317465,1,3,0
90518,2,3,317464,317465,317468,1,4,0
90519,3,3,317467,317468,317471,1,4,0
90520,4,3,317471,317471,317474,0,3,0
90521,5,2,317476,317476,317478,0,2,2
90522,6,3,317482,317482,317485,0,3,4
90523,6,3,317488,317488,317491,0,3,3
90524,2,2,317490,317491,317493,1,3,0
90525,1,2,317491,317493,317495,2,4,0
90526,3,2,317494,317495,317497,1,3,0
90527,2,2,317496,317497,317499,1,3,0
90528,2,2,317498,317499,317501,1,3,0
90529,4,2,317502,317502,317504,0,2,1
90530,3,3,317505,317505,317508,0,3,1
90531,1,1,317506,317508,317509,2,3,0
90532,2,2,317508,317509,317511,1,3,0
90533,1,3,317509,317511,317514,2,5,0
90534,6,2,317515,317515,317517,0,2,1
90535,6,1,317521,317521,317522,0,1,4
90536,4,2,317525,317525,317527,0,2,3
90537,5,2,317530,317530,317532,0,2,3
90538,4,3,317534,317534,317537,0,3,2
90539,3,1,317537,317537,317538,0,1,0
90540,4,2,317541,317541,317543,0,2,3
90541,4,2,317545,317545,317547,0,2,2
90542,6,3,317551,317551,317554,0,3,4
90543,6,1,317557,317557,317558,0,1,3
90544,4,1,317561,317561,317562,0,1,3
90545,1,1,317562,317562,317563,0,1,0
90546,2,3,317564,317564,317567,0,3,1
90547,4,3,317568,317568,317571,0,3,1
90548,5,2,317573,317573,317575,0,2,2
90549,2,1,317575,317575,317576,0,1,0
90550,3,3,317578,317578,317581,0,3,2
90551,4,1,317582,317582,317583,0,1,1
90552,6,1,317588,317588,317589,0,1,5
90553,2,2,317590,317590,317592,0,2,1
90554,4,3,317594,317594,317597,0,3,2
90555,1,3,317595,317597,317600,2,5,0
90556,5,3,317600,317600,317603,0,3,0
90557,5,1,317605,317605,317606,0,1,2
90558,4,1,317609,317609,317610,0,1,3
90559,1,2,317610,317610,317612,0,2,0
90560,2,2,317612,317612,317614,0,2,0
90561,3,2,317615,317615,317617,0,2,1
90562,6,3,317621,317621,317624,0,3,4
90563,3,3,317624,317624,317627,0,3,0
90564,5,3,317629,317629,317632,0,3,2
90565,5,3,317634,317634,317637,0,3,2
90566,6,3,317640,317640,317643,0,3,3
90567,1,1,317641,317643,317644,2,3,0
90568,5,1,317646,317646,317647,0,1,2
90569,5,2,317651,317651,317653,0,2,4
90570,4,1,317655,317655,317656,0,1,2
90571,3,3,317658,317658,317661,0,3,2
90572,3,2,317661,317661,317663,0,2,0
90573,1,2,317662,317663,317665,1,3,0
90574,6,1,317668,317668,317669,0,1,3
90575,5,1,317673,317673,317674,0,1,4
90576,3,3,317676,317676,317679,0,3,2
90577,3,1,317679,317679,317680,0,1,0
90578,2,2,317681,317681,317683,0,2,1
90579,6,1,317687,317687,317688,0,1,4
90580,4,2,317691,317691,317693,0,2,3
90581,5,3,317696,317696,317699,0,3,3
90582,4,1,317700,317700,317701,0,1,1
90583,5,1,317705,317705,317706,0,1,4
90584,1,2,317706,317706,317708,0,2,0
90585,3,2,317709,317709,317711,0,2,1
90586,1,1,317710,317711,317712,1,2,0
90587,5,1,317715,317715,317716,0,1,3
90588,2,1,317717,317717,317718,0,1,1
90589,4,1,317721,317721,317722,0,1,3
90590,6,1,317727,317727,317728,0,1,5
90591,2,2,317729,317729,317731,0,2,1
90592,4,1,317733,317733,317734,0,1,2
90593,4,1,317737,317737,317738,0,1,3
90594,3,1,317740,317740,317741,0,1,2
90595,1,3,317741,317741,317744,0,3,0
90596,4,2,317745,317745,317747,0,2,1
90597,1,1,317746,317747,317748,1,2,0
90598,2,1,317748,317748,317749,0,1,0
90599,5,2,317753,317753,317755,0,2,4
90600,5,1,317758,317758,317759,0,1,3
90601,5,1,317763,317763,317764,0,1,4
90602,3,3,317766,317766,317769,0,3,2
90603,4,1,317770,317770,317771,0,1,1
90604,2,1,317772,317772,317773,0,1,1
90605,5,1,317777,317777,317778,0,1,4
90606,4,2,317781,317781,317783,0,2,3
90607,1,2,317782,317783,317785,1,3,0
90608,6,3,317788,317788,317791,0,3,3
90609,4,3,317792,317792,317795,0,3,1
90610,5,3,317797,317797,317800,0,3,2
90611,2,1,317799,317800,317801,1,2,0
90612,3,2,317802,317802,317804,0,2,1
90613,3,3,317805,317805,317808,0,3,1
90614,1,3,317806,317808,317811,2,5,0
90615,2,3,317808,317811,317814,3,6,0
90616,5,3,317813,317814,317817,1,4,0
90617,6,1,317819,317819,317820,0,1,2
90618,3,1,317822,317822,317823,0,1,2
90619,5,2,317827,317827,317829,0,2,4
90620,1,3,317828,317829,317832,1,4,0
90621,4,2,317832,317832,317834,0,2,0
90622,3,3,317835,317835,317838,0,3,1
90623,3,2,317838,317838,317840,0,2,0
90624,2,3,317840,317840,317843,0,3,0
90625,3,1,317843,317843,317844,0,1,0
90626,5,2,317848,317848,317850,0,2,4
90627,3,1,317851,317851,317852,0,1,1
90628,5,3,317856,317856,317859,0,3,4
90629,6,1,317862,317862,317863,0,1,3
90630,2,2,317864,317864,317866,0,2,1
90631,5,2,317869,317869,317871,0,2,3
90632,1,1,317870,317871,317872,1,2,0
90633,6,1,317876,317876,317877,0,1,4
90634,3,2,317879,317879,317881,0,2,2
90635,2,1,317881,317881,317882,0,1,0
90636,2,3,317883,317883,317886,0,3,1
90637,4,2,317887,317887,317889,0,2,1
90638,2,2,317889,317889,317891,0,2,0
90639,5,1,317894,317894,317895,0,1,3
90640,6,2,317900,317900,317902,0,2,5
90641,5,3,317905,317905,317908,0,3,3
90642,2,1,317907,317908,317909,1,2,0
90643,3,1,317910,317910,317911,0,1,1
90644,5,1,317915,317915,317916,0,1,4
90645,1,3,317916,317916,317919,0,3,0
90646,1,3,317917,317919,317922,2,5,0
90647,1,2,317918,317922,317924,4,6,0
90648,1,2,317919,317924,317926,5,7,0
90649,6,2,317925,317926,317928,1,3,0
90650,5,1,317930,317930,317931,0,1,2
90651,3,2,317933,317933,317935,0,2,2
90652,6,2,317939,317939,317941,0,2,4
90653,3,2,317942,317942,317944,0,2,1
90654,6,1,317948,317948,317949,0,1,4
90655,6,1,317954,317954,317955,0,1,5
90656,4,1,317958,317958,317959,0,1,3
90657,5,3,317963,317963,317966,0,3,4
90658,1,3,317964,317966,317969,2,5,0
90659,5,3,317969,317969,317972,0,3,0
90660,4,3,317973,317973,317976,0,3,1
90661,4,1,317977,317977,317978,0,1,1
90662,5,3,317982,317982,317985,0,3,4
90663,6,3,317988,317988,317991,0,3,3
90664,3,2,317991,317991,317993,0,2,0
90665,4,1,317995,317995,317996,0,1,2
90666,3,3,317998,317998,318001,0,3,2
90667,3,3,318001,318001,318004,0,3,0
90668,1,2,318002,318004,318006,2,4,0
90669,6,1,318008,318008,318009,0,1,2
90670,4,2,318012,318012,318014,0,2,3
90671,3,3,318015,318015,318018,0,3,1
90672,4,3,318019,318019,318022,0,3,1
90673,5,2,318024,318024,318026,0,2,2
90674,1,2,318025,318026,318028,1,3,0
90675,2,3,318027,318028,318031,1,4,0
90676,1,1,318028,318031,318032,3,4,0
90677,4,2,318032,318032,318034,0,2,0
90678,3,1,318035,318035,318036,0,1,1
90679,3,2,318038,318038,318040,0,2,2
90680,5,1,318043,318043,318044,0,1,3
90681,5,2,318048,318048,318050,0,2,4
90682,4,3,318052,318052,318055,0,3,2
90683,2,2,318054,318055,318057,1,3,0
90684,6,2,318060,318060,318062,0,2,3
90685,6,1,318066,318066,318067,0,1,4
90686,3,1,318069,318069,318070,0,1,2
90687,6,3,318075,318075,318078,0,3,5
90688,5,2,318080,318080,318082,0,2,2
90689,3,2,318083,318083,318085,0,2,1
90690,3,1,318086,318086,318087,0,1,1
90691,2,1,318088,318088,318089,0,1,1
90692,3,3,318091,318091,318094,0,3,2
90693,5,3,318096,318096,318099,0,3,2
90694,5,1,318101,318101,318102,0,1,2
90695,1,1,318102,318102,318103,0,1,0
90696,1,3,318103,318103,318106,0,3,0
90697,6,3,318109,318109,318112,0,3,3
90698,2,1,318111,318112,318113,1,2,0
90699,6,1,318117,318117,318118,0,1,4
90700,2,2,318119,318119,318121,0,2,1
90701,2,3,318121,318121,318124,0,3,0
90702,2,3,318123,318124,318127,1,4,0
90703,6,2,318129,318129,318131,0,2,2
90704,3,3,318132,318132,318135,0,3,1
90705,5,3,318137,318137,318140,0,3,2
90706,2,3,318139,318140,318143,1,4,0
90707,3,2,318142,318143,318145,1,3,0
90708,3,1,318145,318145,318146,0,1,0
90709,1,2,318146,318146,318148,0,2,0
90710,3,2,318149,318149,318151,0,2,1
90711,1,1,318150,318151,318152,1,2,0
90712,4,3,318154,318154,318157,0,3,2
90713,3,1,318157,318157,318158,0,1,0
90714,3,2,318160,318160,318162,0,2,2
90715,2,3,318162,318162,318165,0,3,0
90716,3,1,318165,318165,318166,0,1,0
90717,5,1,318170,318170,318171,0,1,4
90718,1,3,318171,318171,318174,0,3,0
90719,3,1,318174,318174,318175,0,1,0
90720,2,1,318176,318176,318177,0,1,1
90721,5,3,318181,318181,318184,0,3,4
90722,2,1,318183,318184,318185,1,2,0
90723,3,1,318186,318186,318187,0,1,1
90724,4,2,318190,318190,318192,0,2,3
90725,3,3,318193,318193,318196,0,3,1
90726,4,2,318197,318197,318199,0,2,1
90727,6,1,318203,318203,318204,0,1,4
90728,4,1,318207,318207,318208,0,1,3
90729,3,3,318210,318210,318213,0,3,2
90730,3,2,318213,318213,318215,0,2,0
90731,3,1,318216,318216,318217,0,1,1
90732,5,1,318221,318221,318222,0,1,4
90733,1,1,318222,318222,318223,0,1,0
90734,5,3,318227,318227,318230,0,3,4
90735,5,2,318232,318232,318234,0,2,2
90736,1,1,318233,318234,318235,1,2,0
90737,1,3,318234,318235,318238,1,4,0
90738,5,3,318239,318239,318242,0,3,1
90739,5,2,318244,318244,318246,0,2,2
90740,3,1,318247,318247,318248,0,1,1
90741,6,3,318253,318253,318256,0,3,5
90742,4,3,318257,318257,318260,0,3,1
90743,4,1,318261,318261,318262,0,1,1
90744,6,2,318267,318267,318269,0,2,5
90745,3,1,318270,318270,318271,0,1,1
90746,4,2,318274,318274,318276,0,2,3
90747,5,2,318279,318279,318281,0,2,3
90748,3,3,318282,318282,318285,0,3,1
90749,3,1,318285,318285,318286,0,1,0
90750,1,2,318286,318286,318288,0,2,0
90751,1,1,318287,318288,318289,1,2,0
90752,2,3,318289,318289,318292,0,3,0
90753,1,2,318290,318292,318294,2,4,0
90754,1,3,318291,318294,318297,3,6,0
90755,5,3,318296,318297,318300,1,4,0
90756,1,1,318297,318300,318301,3,4,0
90757,1,1,318298,318301,318302,3,4,0
90758,6,1,318304,318304,318305,0,1,2
90759,1,1,318305,318305,318306,0,1,0
90760,4,2,318309,318309,318311,0,2,3
90761,5,2,318314,318314,318316,0,2,3
90762,4,3,318318,318318,318321,0,3,2
90763,1,2,318319,318321,318323,2,4,0
90764,5,2,318324,318324,318326,0,2,1
90765,2,1,318326,318326,318327,0,1,0
90766,1,1,318327,318327,318328,0,1,0
90767,4,2,318331,318331,318333,0,2,3
90768,6,2,318337,318337,318339,0,2,4
90769,2,3,318339,318339,318342,0,3,0
90770,2,1,318341,318342,318343,1,2,0
90771,2,3,318343,318343,318346,0,3,0
90772,2,3,318345,318346,318349,1,4,0
90773,5,3,318350,318350,318353,0,3,1
90774,1,2,318351,318353,318355,2,4,0
90775,3,1,318354,318355,318356,1,2,0
90776,2,3,318356,318356,318359,0,3,0
90777,1,2,318357,318359,318361,2,4,0
90778,1,3,318358,318361,318364,3,6,0
90779,6,1,318364,318364,318365,0,1,0
90780,2,2,318366,318366,318368,0,2,1
90781,6,3,318372,318372,318375,0,3,4
90782,5,2,318377,318377,318379,0,2,2
90783,4,2,318381,318381,318383,0,2,2
90784,5,1,318386,318386,318387,0,1,3
90785,1,3,318387,318387,318390,0,3,0
90786,4,2,318391,318391,318393,0,2,1
90787,2,1,318393,318393,318394,0,1,0
90788,2,3,318395,318395,318398,0,3,1
90789,2,2,318397,318398,318400,1,3,0
90790,6,1,318403,318403,318404,0,1,3
90791,3,3,318406,318406,318409,0,3,2
90792,6,3,318412,318412,318415,0,3,3
90793,3,1,318415,318415,318416,0,1,0
90794,5,3,318420,318420,318423,0,3,4
90795,6,3,318426,318426,318429,0,3,3
90796,1,2,318427,318429,318431,2,4,0
90797,3,1,318430,318431,318432,1,2,0
90798,6,3,318436,318436,318439,0,3,4
90799,2,1,318438,318439,318440,1,2,0
90800,4,1,318442,318442,318443,0,1,2
90801,6,3,318448,318448,318451,0,3,5
90802,1,1,318449,318451,318452,2,3,0
90803,2,1,318451,318452,318453,1,2,0
90804,6,2,318457,318457,318459,0,2,4
90805,6,1,318463,318463,318464,0,1,4
90806,5,2,318468,318468,318470,0,2,4
90807,1,2,318469,318470,318472,1,3,0
90808,6,3,318475,318475,318478,0,3,3
90809,4,3,318479,318479,318482,0,3,1
90810,4,3,318483,318483,318486,0,3,1
90811,1,3,318484,318486,318489,2,5,0
90812,2,2,318486,318489,318491,3,5,0
90813,2,2,318488,318491,318493,3,5,0
90814,6,3,318494,318494,318497,0,3,1
90815,2,2,318496,318497,318499,1,3,0
90816,2,3,318498,318499,318502,1,4,0
90817,2,1,318500,318502,318503,2,3,0
90818,1,1,318501,318503,318504,2,3,0
90819,1,1,318502,318504,318505,2,3,0
90820,4,1,318506,318506,318507,0,1,1
90821,5,3,318511,318511,318514,0,3,4
90822,1,2,318512,318514,318516,2,4,0
90823,2,2,318514,318516,318518,2,4,0
90824,2,3,318516,318518,318521,2,5,0
90825,6,1,318522,318522,318523,0,1,1
90826,6,2,318528,318528,318530,0,2,5
90827,1,2,318529,318530,318532,1,3,0
90828,3,3,318532,318532,318535,0,3,0
90829,6,2,318538,318538,318540,0,2,3
90830,4,3,318542,318542,318545,0,3,2
90831,2,1,318544,318545,318546,1,2,0
90832,6,3,318550,318550,318553,0,3,4
90833,2,3,318552,318553,318556,1,4,0
90834,6,1,318558,318558,318559,0,1,2
90835,3,1,318561,318561,318562,0,1,2
90836,2,3,318563,318563,318566,0,3,1
90837,1,2,318564,318566,318568,2,4,0
90838,6,2,318570,318570,318572,0,2,2
90839,1,3,318571,318572,318575,1,4,0
90840,6,2,318577,318577,318579,0,2,2
90841,6,2,318583,318583,318585,0,2,4
90842,1,1,318584,318585,318586,1,2,0
90843,1,1,318585,318586,318587,1,2,0
90844,6,3,318591,318591,318594,0,3,4
90845,6,2,318597,318597,318599,0,2,3
90846,3,1,318600,318600,318601,0,1,1
90847,2,1,318602,318602,318603,0,1,1
90848,6,1,318608,318608,318609,0,1,5
90849,6,1,318614,318614,318615,0,1,5
90850,2,1,318616,318616,318617,0,1,1
90851,2,1,318618,318618,318619,0,1,1
90852,4,2,318622,318622,318624,0,2,3
90853,6,3,318628,318628,318631,0,3,4
90854,3,1,318631,318631,318632,0,1,0
90855,4,2,318635,318635,318637,0,2,3
90856,5,2,318640,318640,318642,0,2,3
90857,4,3,318644,318644,318647,0,3,2
90858,3,3,318647,318647,318650,0,3,0
90859,1,1,318648,318650,318651,2,3,0
90860,4,1,318652,318652,318653,0,1,1
90861,3,2,318655,318655,318657,0,2,2
90862,3,2,318658,318658,318660,0,2,1
90863,6,3,318664,318664,318667,0,3,4
90864,2,3,318666,318667,318670,1,4,0
90865,3,1,318669,318670,318671,1,2,0
90866,2,2,318671,318671,318673,0,2,0
90867,6,1,318677,318677,318678,0,1,4
90868,5,2,318682,318682,318684,0,2,4
90869,2,2,318684,318684,318686,0,2,0
90870,5,3,318689,318689,318692,0,3,3
90871,3,1,318692,318692,318693,0,1,0
90872,2,1,318694,318694,318695,0,1,1
90873,6,3,318700,318700,318703,0,3,5
90874,6,2,318706,318706,318708,0,2,3
90875,2,2,318708,318708,318710,0,2,0
90876,6,1,318714,318714,318715,0,1,4
90877,4,2,318718,318718,318720,0,2,3
90878,3,1,318721,318721,318722,0,1,1
90879,2,1,318723,318723,318724,0,1,1
90880,1,2,318724,318724,318726,0,2,0
90881,3,3,318727,318727,318730,0,3,1
90882,6,1,318733,318733,318734,0,1,3
90883,4,3,318737,318737,318740,0,3,3
90884,1,1,318738,318740,318741,2,3,0
90885,3,2,318741,318741,318743,0,2,0
90886,5,1,318746,318746,318747,0,1,3
90887,3,1,318749,318749,318750,0,1,2
90888,6,3,318755,318755,318758,0,3,5
90889,2,1,318757,318758,318759,1,2,0
90890,5,1,318762,318762,318763,0,1,3
90891,1,3,318763,318763,318766,0,3,0
90892,3,2,318766,318766,318768,0,2,0
90893,3,1,318769,318769,318770,0,1,1
90894,6,1,318775,318775,318776,0,1,5
90895,4,3,318779,318779,318782,0,3,3
90896,5,3,318784,318784,318787,0,3,2
90897,5,1,318789,318789,318790,0,1,2
90898,6,3,318795,318795,318798,0,3,5
90899,3,3,318798,318798,318801,0,3,0
90900,1,1,318799,318801,318802,2,3,0
90901,4,3,318803,318803,318806,0,3,1
90902,3,2,318806,318806,318808,0,2,0
90903,4,1,318810,318810,318811,0,1,2
90904,5,3,318815,318815,318818,0,3,4
90905,1,2,318816,318818,318820,2,4,0
90906,5,2,318821,318821,318823,0,2,1
90907,6,1,318827,318827,318828,0,1,4
90908,1,1,318828,318828,318829,0,1,0
90909,3,2,318831,318831,318833,0,2,2
90910,6,3,318837,318837,318840,0,3,4
90911,4,3,318841,318841,318844,0,3,1
90912,5,2,318846,318846,318848,0,2,2
90913,1,2,318847,318848,318850,1,3,0
90914,3,3,318850,318850,318853,0,3,0
90915,1,3,318851,318853,318856,2,5,0
90916,4,3,318855,318856,318859,1,4,0
90917,4,3,318859,318859,318862,0,3,0
90918,4,3,318863,318863,318866,0,3,1
90919,6,2,318869,318869,318871,0,2,3
90920,6,2,318875,318875,318877,0,2,4
90921,5,2,318880,318880,318882,0,2,3
90922,6,2,318886,318886,318888,0,2,4
90923,3,1,318889,318889,318890,0,1,1
90924,5,2,318894,318894,318896,0,2,4
90925,5,3,318899,318899,318902,0,3,3
90926,1,2,318900,318902,318904,2,4,0
90927,6,2,318906,318906,318908,0,2,2
90928,3,2,318909,318909,318911,0,2,1
90929,6,3,318915,318915,318918,0,3,4
90930,6,2,318921,318921,318923,0,2,3
90931,4,1,318925,318925,318926,0,1,2
90932,2,3,318927,318927,318930,0,3,1
90933,6,3,318933,318933,318936,0,3,3
90934,5,2,318938,318938,318940,0,2,2
90935,6,3,318944,318944,318947,0,3,4
90936,2,3,318946,318947,318950,1,4,0
90937,4,2,318950,318950,318952,0,2,0
90938,1,1,318951,318952,318953,1,2,0
90939,1,1,318952,318953,318954,1,2,0
90940,3,2,318955,318955,318957,0,2,1
90941,6,2,318961,318961,318963,0,2,4
90942,2,2,318963,318963,318965,0,2,0
90943,4,3,318967,318967,318970,0,3,2
90944,5,2,318972,318972,318974,0,2,2
90945,5,2,318977,318977,318979,0,2,3
90946,5,1,318982,318982,318983,0,1,3
90947,3,1,318985,318985,318986,0,1,2
90948,1,2,318986,318986,318988,0,2,0
90949,6,3,318992,318992,318995,0,3,4
90950,1,1,318993,318995,318996,2,3,0
90951,1,3,318994,318996,318999,2,5,0
90952,2,2,318996,318999,319001,3,5,0
90953,5,2,319001,319001,319003,0,2,0
90954,6,2,319007,319007,319009,0,2,4
90955,1,3,319008,319009,319012,1,4,0
90956,5,1,319013,319013,319014,0,1,1
90957,6,2,319019,319019,319021,0,2,5
90958,5,2,319024,319024,319026,0,2,3
90959,2,2,319026,319026,319028,0,2,0
90960,3,2,319029,319029,319031,0,2,1
90961,4,1,319033,319033,319034,0,1,2
90962,2,3,319035,319035,319038,0,3,1
90963,4,3,319039,319039,319042,0,3,1
90964,4,3,319043,319043,319046,0,3,1
90965,6,1,319049,319049,319050,0,1,3
90966,1,1,319050,319050,319051,0,1,0
90967,5,3,319055,319055,319058,0,3,4
90968,4,1,319059,319059,319060,0,1,1
90969,4,3,319063,319063,319066,0,3,3
90970,5,1,319068,319068,319069,0,1,2
90971,3,2,319071,319071,319073,0,2,2
90972,6,3,319077,319077,319080,0,3,4
90973,4,3,319081,319081,319084,0,3,1
90974,2,1,319083,319084,319085,1,2,0
90975,5,1,319088,319088,319089,0,1,3
90976,3,1,319091,319091,319092,0,1,2
90977,6,2,319097,319097,319099,0,2,5
90978,3,1,319100,319100,319101,0,1,1
90979,2,2,319102,319102,319104,0,2,1
90980,4,1,319106,319106,319107,0,1,2
90981,3,2,319109,319109,319111,0,2,2
90982,4,3,319113,319113,319116,0,3,2
90983,2,2,319115,319116,319118,1,3,0
90984,5,3,319120,319120,319123,0,3,2
90985,3,3,319123,319123,319126,0,3,0
90986,4,3,319127,319127,319130,0,3,1
90987,6,2,319133,319133,319135,0,2,3
90988,4,2,319137,319137,319139,0,2,2
90989,2,2,319139,319139,319141,0,2,0
90990,3,2,319142,319142,319144,0,2,1
90991,6,2,319148,319148,319150,0,2,4
90992,4,1,319152,319152,319153,0,1,2
90993,4,2,319156,319156,319158,0,2,3
90994,2,3,319158,319158,319161,0,3,0
90995,1,1,319159,319161,319162,2,3,0
90996,5,3,319164,319164,319167,0,3,2
90997,1,2,319165,319167,319169,2,4,0
90998,1,1,319166,319169,319170,3,4,0
90999,4,3,319170,319170,319173,0,3,0
91000,2,2,319172,319173,319175,1,3,0
91001,5,2,319177,319177,319179,0,2,2
91002,6,2,319183,319183,319185,0,2,4
91003,3,3,319186,319186,319189,0,3,1
91004,2,2,319188,319189,319191,1,3,0
91005,3,2,319191,319191,319193,0,2,0
91006,5,3,319196,319196,319199,0,3,3
91007,1,1,319197,319199,319200,2,3,0
91008,6,3,319203,319203,319206,0,3,3
91009,5,2,319208,319208,319210,0,2,2
91010,2,2,319210,319210,319212,0,2,0
91011,1,3,319211,319212,319215,1,4,0
91012,2,1,319213,319215,319216,2,3,0
91013,1,3,319214,319216,319219,2,5,0
91014,6,1,319220,319220,319221,0,1,1
91015,2,2,319222,319222,319224,0,2,1
91016,2,2,319224,319224,319226,0,2,0
91017,6,3,319230,319230,319233,0,3,4
91018,1,3,319231,319233,319236,2,5,0
91019,6,1,319237,319237,319238,0,1,1
91020,4,2,319241,319241,319243,0,2,3
91021,3,3,319244,319244,319247,0,3,1
91022,4,1,319248,319248,319249,0,1,1
91023,2,3,319250,319250,319253,0,3,1
91024,4,3,319254,319254,319257,0,3,1
91025,6,3,319260,319260,319263,0,3,3
91026,2,1,319262,319263,319264,1,2,0
91027,2,2,319264,319264,319266,0,2,0
91028,5,3,319269,319269,319272,0,3,3
91029,3,3,319272,319272,319275,0,3,0
91030,1,1,319273,319275,319276,2,3,0
91031,3,3,319276,319276,319279,0,3,0
91032,2,1,319278,319279,319280,1,2,0
91033,6,3,319284,319284,319287,0,3,4
91034,4,3,319288,319288,319291,0,3,1
91035,6,2,319294,319294,319296,0,2,3
91036,3,3,319297,319297,319300,0,3,1
91037,5,3,319302,319302,319305,0,3,2
91038,4,2,319306,319306,319308,0,2,1
91039,2,3,319308,319308,319311,0,3,0
91040,2,3,319310,319311,319314,1,4,0
91041,1,1,319311,319314,319315,3,4,0
91042,4,3,319315,319315,319318,0,3,0
91043,4,2,319319,319319,319321,0,2,1
91044,3,1,319322,319322,319323,0,1,1
91045,6,3,319328,319328,319331,0,3,5
91046,6,1,319334,319334,319335,0,1,3
91047,5,2,319339,319339,319341,0,2,4
91048,2,3,319341,319341,319344,0,3,0
91049,2,2,319343,319344,319346,1,3,0
91050,5,2,319348,319348,319350,0,2,2
91051,1,3,319349,319350,319353,1,4,0
91052,2,3,319351,319353,319356,2,5,0
91053,5,3,319356,319356,319359,0,3,0
91054,6,3,319362,319362,319365,0,3,3
91055,1,1,319363,319365,319366,2,3,0
91056,5,2,319368,319368,319370,0,2,2
91057,4,3,319372,319372,319375,0,3,2
91058,5,3,319377,319377,319380,0,3,2
91059,2,1,319379,319380,319381,1,2,0
91060,6,2,319385,319385,319387,0,2,4
91061,3,2,319388,319388,319390,0,2,1
91062,1,1,319389,319390,319391,1,2,0
91063,4,1,319393,319393,319394,0,1,2
91064,1,1,319394,319394,319395,0,1,0
91065,5,1,319399,319399,319400,0,1,4
91066,2,3,319401,319401,319404,0,3,1
91067,1,3,319402,319404,319407,2,5,0
91068,1,3,319403,319407,319410,4,7,0
91069,1,2,319404,319410,319412,6,8,0
91070,3,2,319407,319412,319414,5,7,0
91071,1,2,319408,319414,319416,6,8,0
91072,1,3,319409,319416,319419,7,10,0
91073,2,2,319411,319419,319421,8,10,0
91074,3,2,319414,319421,319423,7,9,0
91075,1,3,319415,319423,319426,8,11,0
91076,5,1,319420,319426,319427,6,7,0
91077,5,3,319425,319427,319430,2,5,0
91078,1,3,319426,319430,319433,4,7,0
91079,6,2,319432,319433,319435,1,3,0
91080,2,1,319434,319435,319436,1,2,0
91081,1,2,319435,319436,319438,1,3,0
91082,3,2,319438,319438,319440,0,2,0
91083,5,3,319443,319443,319446,0,3,3
91084,5,1,319448,319448,319449,0,1,2
91085,4,1,319452,319452,319453,0,1,3
91086,1,1,319453,319453,319454,0,1,0
91087,3,3,319456,319456,319459,0,3,2
91088,6,2,319462,319462,319464,0,2,3
91089,2,1,319464,319464,319465,0,1,0
91090,4,2,319468,319468,319470,0,2,3
91091,2,1,319470,319470,319471,0,1,0
91092,4,3,319474,319474,319477,0,3,3
91093,4,1,319478,319478,319479,0,1,1
91094,4,3,319482,319482,319485,0,3,3
91095,2,3,319484,319485,319488,1,4,0
91096,3,1,319487,319488,319489,1,2,0
91097,4,1,319491,319491,319492,0,1,2
91098,2,3,319493,319493,319496,0,3,1
91099,4,2,319497,319497,319499,0,2,1
91100,5,2,319502,319502,319504,0,2,3
91101,1,2,319503,319504,319506,1,3,0
91102,1,2,319504,319506,319508,2,4,0
91103,6,1,319510,319510,319511,0,1,2
91104,2,2,319512,319512,319514,0,2,1
91105,5,2,319517,319517,319519,0,2,3
91106,2,1,319519,319519,319520,0,1,0
91107,5,2,319524,319524,319526,0,2,4
91108,2,3,319526,319526,319529,0,3,0
91109,4,1,319530,319530,319531,0,1,1
91110,4,3,319534,319534,319537,0,3,3
91111,4,2,319538,319538,319540,0,2,1
91112,3,3,319541,319541,319544,0,3,1
91113,3,3,319544,319544,319547,0,3,0
91114,4,2,319548,319548,319550,0,2,1
91115,3,3,319551,319551,319554,0,3,1
91116,4,1,319555,319555,319556,0,1,1
91117,2,2,319557,319557,319559,0,2,1
91118,3,2,319560,319560,319562,0,2,1
91119,4,2,319564,319564,319566,0,2,2
91120,1,3,319565,319566,319569,1,4,0
91121,6,2,319571,319571,319573,0,2,2
91122,6,1,319577,319577,319578,0,1,4
91123,5,2,319582,319582,319584,0,2,4
91124,2,2,319584,319584,319586,0,2,0
91125,6,3,319590,319590,319593,0,3,4
91126,1,2,319591,319593,319595,2,4,0
91127,2,3,319593,319595,319598,2,5,0
91128,6,3,319599,319599,319602,0,3,1
91129,5,2,319604,319604,319606,0,2,2
91130,3,2,319607,319607,319609,0,2,1
91131,5,2,319612,319612,319614,0,2,3
91132,1,3,319613,319614,319617,1,4,0
91133,5,1,319618,319618,319619,0,1,1
91134,5,2,319623,319623,319625,0,2,4
91135,3,3,319626,319626,319629,0,3,1
91136,3,3,319629,319629,319632,0,3,0
91137,6,1,319635,319635,319636,0,1,3
91138,5,2,319640,319640,319642,0,2,4
91139,5,2,319645,319645,319647,0,2,3
91140,2,1,319647,319647,319648,0,1,0
91141,3,2,319650,319650,319652,0,2,2
91142,6,1,319656,319656,319657,0,1,4
91143,1,1,319657,319657,319658,0,1,0
91144,4,1,319661,319661,319662,0,1,3
91145,5,2,319666,319666,319668,0,2,4
91146,3,3,319669,319669,319672,0,3,1
91147,4,2,319673,319673,319675,0,2,1
91148,5,2,319678,319678,319680,0,2,3
91149,2,2,319680,319680,319682,0,2,0
91150,4,2,319684,319684,319686,0,2,2
91151,4,2,319688,319688,319690,0,2,2
91152,5,3,319693,319693,319696,0,3,3
91153,4,3,319697,319697,319700,0,3,1
91154,2,1,319699,319700,319701,1,2,0
91155,1,2,319700,319701,319703,1,3,0
91156,5,2,319705,319705,319707,0,2,2
91157,1,1,319706,319707,319708,1,2,0
91158,2,1,319708,319708,319709,0,1,0
91159,6,3,319714,319714,319717,0,3,5
91160,5,3,319719,319719,319722,0,3,2
91161,2,1,319721,319722,319723,1,2,0
91162,5,1,319726,319726,319727,0,1,3
91163,4,1,319730,319730,319731,0,1,3
91164,4,1,319734,319734,319735,0,1,3
91165,4,1,319738,319738,319739,0,1,3
91166,3,2,319741,319741,319743,0,2,2
91167,4,3,319745,319745,319748,0,3,2
91168,2,3,319747,319748,319751,1,4,0
91169,3,2,319750,319751,319753,1,3,0
91170,3,1,319753,319753,319754,0,1,0
91171,5,3,319758,319758,319761,0,3,4
91172,1,2,319759,319761,319763,2,4,0
91173,5,1,319764,319764,319765,0,1,1
91174,1,3,319765,319765,319768,0,3,0
91175,5,1,319770,319770,319771,0,1,2
91176,3,3,319773,319773,319776,0,3,2
91177,6,2,319779,319779,319781,0,2,3
91178,2,1,319781,319781,319782,0,1,0
91179,3,3,319784,319784,319787,0,3,2
91180,4,1,319788,319788,319789,0,1,1
91181,4,3,319792,319792,319795,0,3,3
91182,4,3,319796,319796,319799,0,3,1
91183,1,3,319797,319799,319802,2,5,0
91184,2,3,319799,319802,319805,3,6,0
91185,5,3,319804,319805,319808,1,4,0
91186,4,3,319808,319808,319811,0,3,0
91187,6,2,319814,319814,319816,0,2,3
91188,2,1,319816,319816,319817,0,1,0
91189,1,2,319817,319817,319819,0,2,0
91190,4,2,319821,319821,319823,0,2,2
91191,4,3,319825,319825,319828,0,3,2
91192,1,1,319826,319828,319829,2,3,0
91193,3,3,319829,319829,319832,0,3,0
91194,5,2,319834,319834,319836,0,2,2
91195,4,2,319838,319838,319840,0,2,2
91196,5,3,319843,319843,319846,0,3,3
91197,2,2,319845,319846,319848,1,3,0
91198,6,3,319851,319851,319854,0,3,3
91199,1,1,319852,319854,319855,2,3,0
91200,1,3,319853,319855,319858,2,5,0
91201,4,2,319857,319858,319860,1,3,0
91202,4,3,319861,319861,319864,0,3,1
91203,6,3,319867,319867,319870,0,3,3
91204,2,3,319869,319870,319873,1,4,0
91205,2,1,319871,319873,319874,2,3,0
91206,3,3,319874,319874,319877,0,3,0
91207,4,3,319878,319878,319881,0,3,1
91208,6,3,319884,319884,319887,0,3,3
91209,5,2,319889,319889,319891,0,2,2
91210,2,3,319891,319891,319894,0,3,0
91211,5,1,319896,319896,319897,0,1,2
91212,5,1,319901,319901,319902,0,1,4
91213,5,1,319906,319906,319907,0,1,4
91214,3,2,319909,319909,319911,0,2,2
91215,6,1,319915,319915,319916,0,1,4
91216,4,3,319919,319919,319922,0,3,3
91217,5,1,319924,319924,319925,0,1,2
91218,6,2,319930,319930,319932,0,2,5
91219,1,1,319931,319932,319933,1,2,0
91220,4,2,319935,319935,319937,0,2,2
91221,1,3,319936,319937,319940,1,4,0
91222,3,1,319939,319940,319941,1,2,0
91223,6,1,319945,319945,319946,0,1,4
91224,3,1,319948,319948,319949,0,1,2
91225,5,1,319953,319953,319954,0,1,4
91226,6,1,319959,319959,319960,0,1,5
91227,6,1,319965,319965,319966,0,1,5
91228,4,1,319969,319969,319970,0,1,3
91229,5,3,319974,319974,319977,0,3,4
91230,4,2,319978,319978,319980,0,2,1
91231,6,1,319984,319984,319985,0,1,4
91232,6,2,319990,319990,319992,0,2,5
91233,4,1,319994,319994,319995,0,1,2
91234,2,3,319996,319996,319999,0,3,1
91235,2,2,319998,319999,320001,1,3,0
91236,6,2,320004,320004,320006,0,2,3
91237,4,3,320008,320008,320011,0,3,2
91238,6,2,320014,320014,320016,0,2,3
91239,5,3,320019,320019,320022,0,3,3
91240,5,3,320024,320024,320027,0,3,2
91241,2,1,320026,320027,320028,1,2,0
91242,5,2,320031,320031,320033,0,2,3
91243,6,3,320037,320037,320040,0,3,4
91244,5,3,320042,320042,320045,0,3,2
91245,5,3,320047,320047,320050,0,3,2
91246,3,2,320050,320050,320052,0,2,0
91247,1,2,320051,320052,320054,1,3,0
91248,3,2,320054,320054,320056,0,2,0
91249,3,1,320057,320057,320058,0,1,1
91250,6,3,320063,320063,320066,0,3,5
91251,1,3,320064,320066,320069,2,5,0
91252,2,2,320066,320069,320071,3,5,0
91253,2,3,320068,320071,320074,3,6,0
91254,1,3,320069,320074,320077,5,8,0
91255,6,2,320075,320077,320079,2,4,0
91256,2,2,320077,320079,320081,2,4,0
91257,6,2,320083,320083,320085,0,2,2
91258,4,3,320087,320087,320090,0,3,2
91259,2,3,320089,320090,320093,1,4,0
91260,2,3,320091,320093,320096,2,5,0
91261,2,1,320093,320096,320097,3,4,0
91262,5,2,320098,320098,320100,0,2,1
91263,3,1,320101,320101,320102,0,1,1
91264,5,2,320106,320106,320108,0,2,4
91265,6,1,320112,320112,320113,0,1,4
91266,5,1,320117,320117,320118,0,1,4
91267,5,2,320122,320122,320124,0,2,4
91268,4,1,320126,320126,320127,0,1,2
91269,3,2,320129,320129,320131,0,2,2
91270,6,2,320135,320135,320137,0,2,4
91271,6,3,320141,320141,320144,0,3,4
91272,1,1,320142,320144,320145,2,3,0
91273,6,2,320148,320148,320150,0,2,3
91274,5,1,320153,320153,320154,0,1,3
91275,6,1,320159,320159,320160,0,1,5
91276,2,2,320161,320161,320163,0,2,1
91277,5,2,320166,320166,320168,0,2,3
91278,3,2,320169,320169,320171,0,2,1
91279,2,3,320171,320171,320174,0,3,0
91280,4,2,320175,320175,320177,0,2,1
91281,1,3,320176,320177,320180,1,4,0
91282,1,1,320177,320180,320181,3,4,0
91283,4,2,320181,320181,320183,0,2,0
91284,1,3,320182,320183,320186,1,4,0
91285,4,1,320186,320186,320187,0,1,0
91286,4,1,320190,320190,320191,0,1,3
91287,1,2,320191,320191,320193,0,2,0
91288,3,2,320194,320194,320196,0,2,1
91289,6,1,320200,320200,320201,0,1,4
91290,4,3,320204,320204,320207,0,3,3
91291,4,2,320208,320208,320210,0,2,1
91292,4,1,320212,320212,320213,0,1,2
91293,3,3,320215,320215,320218,0,3,2
91294,3,2,320218,320218,320220,0,2,0
91295,4,1,320222,320222,320223,0,1,2
91296,2,2,320224,320224,320226,0,2,1
91297,4,1,320228,320228,320229,0,1,2
91298,5,1,320233,320233,320234,0,1,4
91299,6,3,320239,320239,320242,0,3,5
91300,1,2,320240,320242,320244,2,4,0
91301,4,1,320244,320244,320245,0,1,0
91302,3,1,320247,320247,320248,0,1,2
91303,3,2,320250,320250,320252,0,2,2
91304,2,3,320252,320252,320255,0,3,0
91305,1,2,320253,320255,320257,2,4,0
91306,2,3,320255,320257,320260,2,5,0
91307,2,2,320257,320260,320262,3,5,0
91308,1,3,320258,320262,320265,4,7,0
91309,2,1,320260,320265,320266,5,6,0
91310,3,1,320263,320266,320267,3,4,0
91311,4,1,320267,320267,320268,0,1,0
91312,4,2,320271,320271,320273,0,2,3
91313,1,2,320272,320273,320275,1,3,0
91314,1,2,320273,320275,320277,2,4,0
91315,2,1,320275,320277,320278,2,3,0
91316,6,2,320281,320281,320283,0,2,3
91317,6,2,320287,320287,320289,0,2,4
91318,1,2,320288,320289,320291,1,3,0
91319,3,3,320291,320291,320294,0,3,0
91320,5,3,320296,320296,320299,0,3,2
91321,6,1,320302,320302,320303,0,1,3
91322,2,3,320304,320304,320307,0,3,1
91323,5,3,320309,320309,320312,0,3,2
91324,5,3,320314,320314,320317,0,3,2
91325,1,1,320315,320317,320318,2,3,0
91326,3,3,320318,320318,320321,0,3,0
91327,1,3,320319,320321,320324,2,5,0
91328,4,3,320323,320324,320327,1,4,0
91329,4,2,320327,320327,320329,0,2,0
91330,2,1,320329,320329,320330,0,1,0
91331,1,3,320330,320330,320333,0,3,0
91332,1,3,320331,320333,320336,2,5,0
91333,1,3,320332,320336,320339,4,7,0
91334,6,3,320338,320339,320342,1,4,0
91335,6,2,320344,320344,320346,0,2,2
91336,5,3,320349,320349,320352,0,3,3
91337,4,1,320353,320353,320354,0,1,1
91338,3,1,320356,320356,320357,0,1,2
91339,2,3,320358,320358,320361,0,3,1
91340,2,3,320360,320361,320364,1,4,0
91341,2,3,320362,320364,320367,2,5,0
91342,2,3,320364,320367,320370,3,6,0
91343,5,1,320369,320370,320371,1,2,0
91344,1,3,320370,320371,320374,1,4,0
91345,2,2,320372,320374,320376,2,4,0
91346,3,1,320375,320376,320377,1,2,0
91347,5,2,320380,320380,320382,0,2,3
91348,6,1,320386,320386,320387,0,1,4
91349,1,2,320387,320387,320389,0,2,0
91350,1,2,320388,320389,320391,1,3,0
91351,6,1,320394,320394,320395,0,1,3
91352,2,2,320396,320396,320398,0,2,1
91353,2,1,320398,320398,320399,0,1,0
91354,3,3,320401,320401,320404,0,3,2
91355,4,2,320405,320405,320407,0,2,1
91356,5,2,320410,320410,320412,0,2,3
91357,5,1,320415,320415,320416,0,1,3
91358,4,2,320419,320419,320421,0,2,3
91359,3,2,320422,320422,320424,0,2,1
91360,3,3,320425,320425,320428,0,3,1
91361,6,2,320431,320431,320433,0,2,3
91362,3,3,320434,320434,320437,0,3,1
91363,4,2,320438,320438,320440,0,2,1
91364,4,2,320442,320442,320444,0,2,2
91365,5,2,320447,320447,320449,0,2,3
91366,3,3,320450,320450,320453,0,3,1
91367,4,1,320454,320454,320455,0,1,1
91368,6,1,320460,320460,320461,0,1,5
91369,4,2,320464,320464,320466,0,2,3
91370,3,3,320467,320467,320470,0,3,1
91371,5,3,320472,320472,320475,0,3,2
91372,3,3,320475,320475,320478,0,3,0
91373,6,1,320481,320481,320482,0,1,3
91374,2,3,320483,320483,320486,0,3,1
91375,6,1,320489,320489,320490,0,1,3
91376,2,1,320491,320491,320492,0,1,1
91377,1,3,320492,320492,320495,0,3,0
91378,1,2,320493,320495,320497,2,4,0
91379,2,3,320495,320497,320500,2,5,0
91380,5,3,320500,320500,320503,0,3,0
91381,2,1,320502,320503,320504,1,2,0
91382,6,3,320508,320508,320511,0,3,4
91383,1,3,320509,320511,320514,2,5,0
91384,6,2,320515,320515,320517,0,2,1
91385,3,3,320518,320518,320521,0,3,1
91386,6,1,320524,320524,320525,0,1,3
91387,4,2,320528,320528,320530,0,2,3
91388,3,1,320531,320531,320532,0,1,1
91389,4,1,320535,320535,320536,0,1,3
91390,5,1,320540,320540,320541,0,1,4
91391,3,3,320543,320543,320546,0,3,2
91392,2,3,320545,320546,320549,1,4,0
91393,6,3,320551,320551,320554,0,3,2
91394,2,3,320553,320554,320557,1,4,0
91395,2,3,320555,320557,320560,2,5,0
91396,3,3,320558,320560,320563,2,5,0
91397,2,2,320560,320563,320565,3,5,0
91398,2,1,320562,320565,320566,3,4,0
91399,6,2,320568,320568,320570,0,2,2
91400,2,1,320570,320570,320571,0,1,0
91401,2,3,320572,320572,320575,0,3,1
91402,1,2,320573,320575,320577,2,4,0
91403,1,1,320574,320577,320578,3,4,0
91404,1,1,320575,320578,320579,3,4,0
91405,4,3,320579,320579,320582,0,3,0
91406,5,1,320584,320584,320585,0,1,2
91407,5,1,320589,320589,320590,0,1,4
91408,6,3,320595,320595,320598,0,3,5
91409,6,1,320601,320601,320602,0,1,3
91410,4,2,320605,320605,320607,0,2,3
91411,5,3,320610,320610,320613,0,3,3
91412,3,2,320613,320613,320615,0,2,0
91413,5,1,320618,320618,320619,0,1,3
91414,3,1,320621,320621,320622,0,1,2
91415,2,2,320623,320623,320625,0,2,1
91416,6,3,320629,320629,320632,0,3,4
91417,2,2,320631,320632,320634,1,3,0
91418,3,3,320634,320634,320637,0,3,0
91419,2,1,320636,320637,320638,1,2,0
91420,1,1,320637,320638,320639,1,2,0
91421,2,2,320639,320639,320641,0,2,0
91422,2,2,320641,320641,320643,0,2,0
91423,3,2,320644,320644,320646,0,2,1
91424,5,3,320649,320649,320652,0,3,3
91425,1,2,320650,320652,320654,2,4,0
91426,4,2,320654,320654,320656,0,2,0
91427,2,1,320656,320656,320657,0,1,0
91428,5,1,320661,320661,320662,0,1,4
91429,2,3,320663,320663,320666,0,3,1
91430,1,3,320664,320666,320669,2,5,0
91431,2,2,320666,320669,320671,3,5,0
91432,3,2,320669,320671,320673,2,4,0
91433,3,1,320672,320673,320674,1,2,0
91434,2,1,320674,320674,320675,0,1,0
91435,2,1,320676,320676,320677,0,1,1
91436,1,1,320677,320677,320678,0,1,0
91437,1,3,320678,320678,320681,0,3,0
91438,6,1,320684,320684,320685,0,1,3
91439,2,1,320686,320686,320687,0,1,1
91440,1,3,320687,320687,320690,0,3,0
91441,3,2,320690,320690,320692,0,2,0
91442,1,3,320691,320692,320695,1,4,0
91443,4,2,320695,320695,320697,0,2,0
91444,5,1,320700,320700,320701,0,1,3
91445,1,3,320701,320701,320704,0,3,0
91446,2,2,320703,320704,320706,1,3,0
91447,2,1,320705,320706,320707,1,2,0
91448,1,3,320706,320707,320710,1,4,0
91449,5,3,320711,320711,320714,0,3,1
91450,2,3,320713,320714,320717,1,4,0
91451,3,2,320716,320717,320719,1,3,0
91452,6,3,320722,320722,320725,0,3,3
91453,1,2,320723,320725,320727,2,4,0
91454,6,3,320729,320729,320732,0,3,2
91455,5,1,320734,320734,320735,0,1,2
91456,6,3,320740,320740,320743,0,3,5
91457,5,3,320745,320745,320748,0,3,2
91458,1,2,320746,320748,320750,2,4,0
91459,6,1,320752,320752,320753,0,1,2
91460,2,3,320754,320754,320757,0,3,1
91461,3,2,320757,320757,320759,0,2,0
91462,6,2,320763,320763,320765,0,2,4
91463,1,1,320764,320765,320766,1,2,0
91464,4,1,320768,320768,320769,0,1,2
91465,2,3,320770,320770,320773,0,3,1
91466,1,2,320771,320773,320775,2,4,0
91467,1,2,320772,320775,320777,3,5,0
91468,1,1,320773,320777,320778,4,5,0
91469,6,2,320779,320779,320781,0,2,1
91470,3,2,320782,320782,320784,0,2,1
91471,4,2,320786,320786,320788,0,2,2
91472,3,3,320789,320789,320792,0,3,1
91473,3,2,320792,320792,320794,0,2,0
91474,3,2,320795,320795,320797,0,2,1
91475,2,2,320797,320797,320799,0,2,0
91476,2,1,320799,320799,320800,0,1,0
91477,1,2,320800,320800,320802,0,2,0
91478,5,2,320805,320805,320807,0,2,3
91479,2,3,320807,320807,320810,0,3,0
91480,5,2,320812,320812,320814,0,2,2
91481,3,2,320815,320815,320817,0,2,1
91482,1,2,320816,320817,320819,1,3,0
91483,2,2,320818,320819,320821,1,3,0
91484,4,3,320822,320822,320825,0,3,1
91485,5,3,320827,320827,320830,0,3,2
91486,6,3,320833,320833,320836,0,3,3
91487,5,3,320838,320838,320841,0,3,2
91488,6,3,320844,320844,320847,0,3,3
91489,2,3,320846,320847,320850,1,4,0
91490,5,1,320851,320851,320852,0,1,1
91491,3,1,320854,320854,320855,0,1,2
91492,3,2,320857,320857,320859,0,2,2
91493,6,1,320863,320863,320864,0,1,4
91494,1,2,320864,320864,320866,0,2,0
91495,1,1,320865,320866,320867,1,2,0
91496,3,2,320868,320868,320870,0,2,1
91497,1,3,320869,320870,320873,1,4,0
91498,5,2,320874,320874,320876,0,2,1
91499,1,2,320875,320876,320878,1,3,0
91500,5,2,320880,320880,320882,0,2,2
91501,5,3,320885,320885,320888,0,3,3
91502,4,1,320889,320889,320890,0,1,1
91503,6,3,320895,320895,320898,0,3,5
91504,2,3,320897,320898,320901,1,4,0
91505,4,2,320901,320901,320903,0,2,0
91506,5,2,320906,320906,320908,0,2,3
91507,5,1,320911,320911,320912,0,1,3
91508,2,1,320913,320913,320914,0,1,1
91509,1,1,320914,320914,320915,0,1,0
91510,6,1,320920,320920,320921,0,1,5
91511,4,3,320924,320924,320927,0,3,3
91512,1,1,320925,320927,320928,2,3,0
91513,3,2,320928,320928,320930,0,2,0
91514,4,2,320932,320932,320934,0,2,2
91515,2,3,320934,320934,320937,0,3,0
91516,5,2,320939,320939,320941,0,2,2
91517,1,1,320940,320941,320942,1,2,0
91518,6,3,320946,320946,320949,0,3,4
91519,5,3,320951,320951,320954,0,3,2
91520,4,2,320955,320955,320957,0,2,1
91521,4,1,320959,320959,320960,0,1,2
91522,6,3,320965,320965,320968,0,3,5
91523,5,1,320970,320970,320971,0,1,2
91524,4,3,320974,320974,320977,0,3,3
91525,1,2,320975,320977,320979,2,4,0
91526,3,3,320978,320979,320982,1,4,0
91527,3,3,320981,320982,320985,1,4,0
91528,4,2,320985,320985,320987,0,2,0
91529,4,1,320989,320989,320990,0,1,2
91530,4,1,320993,320993,320994,0,1,3
91531,4,1,320997,320997,320998,0,1,3
91532,1,1,320998,320998,320999,0,1,0
91533,5,1,321003,321003,321004,0,1,4
91534,5,3,321008,321008,321011,0,3,4
91535,2,2,321010,321011,321013,1,3,0
91536,5,3,321015,321015,321018,0,3,2
91537,1,2,321016,321018,321020,2,4,0
91538,1,2,321017,321020,321022,3,5,0
91539,3,1,321020,321022,321023,2,3,0
91540,1,3,321021,321023,321026,2,5,0
91541,6,3,321027,321027,321030,0,3,1
91542,1,1,321028,321030,321031,2,3,0
91543,6,1,321034,321034,321035,0,1,3
91544,4,2,321038,321038,321040,0,2,3
91545,3,3,321041,321041,321044,0,3,1
91546,3,1,321044,321044,321045,0,1,0
91547,4,3,321048,321048,321051,0,3,3
91548,1,2,321049,321051,321053,2,4,0
91549,4,1,321053,321053,321054,0,1,0
91550,5,2,321058,321058,321060,0,2,4
91551,5,3,321063,321063,321066,0,3,3
91552,6,2,321069,321069,321071,0,2,3
91553,1,3,321070,321071,321074,1,4,0
91554,6,1,321076,321076,321077,0,1,2
91555,3,1,321079,321079,321080,0,1,2
91556,1,1,321080,321080,321081,0,1,0
91557,2,3,321082,321082,321085,0,3,1
91558,1,3,321083,321085,321088,2,5,0
91559,6,3,321089,321089,321092,0,3,1
91560,6,2,321095,321095,321097,0,2,3
91561,2,1,321097,321097,321098,0,1,0
91562,5,3,321102,321102,321105,0,3,4
91563,4,1,321106,321106,321107,0,1,1
91564,2,3,321108,321108,321111,0,3,1
91565,3,1,321111,321111,321112,0,1,0
91566,6,2,321117,321117,321119,0,2,5
91567,1,2,321118,321119,321121,1,3,0
91568,1,3,321119,321121,321124,2,5,0
91569,1,1,321120,321124,321125,4,5,0
91570,1,2,321121,321125,321127,4,6,0
91571,4,3,321125,321127,321130,2,5,0
91572,5,2,321130,321130,321132,0,2,0
91573,4,3,321134,321134,321137,0,3,2
91574,3,1,321137,321137,321138,0,1,0
91575,6,2,321143,321143,321145,0,2,5
91576,1,2,321144,321145,321147,1,3,0
91577,1,1,321145,321147,321148,2,3,0
91578,5,3,321150,321150,321153,0,3,2
91579,3,2,321153,321153,321155,0,2,0
91580,4,1,321157,321157,321158,0,1,2
91581,5,1,321162,321162,321163,0,1,4
91582,5,1,321167,321167,321168,0,1,4
91583,5,2,321172,321172,321174,0,2,4
91584,6,2,321178,321178,321180,0,2,4
91585,2,3,321180,321180,321183,0,3,0
91586,4,3,321184,321184,321187,0,3,1
91587,5,1,321189,321189,321190,0,1,2
91588,5,1,321194,321194,321195,0,1,4
91589,1,3,321195,321195,321198,0,3,0
91590,4,3,321199,321199,321202,0,3,1
91591,4,1,321203,321203,321204,0,1,1
91592,1,2,321204,321204,321206,0,2,0
91593,3,2,321207,321207,321209,0,2,1
91594,4,1,321211,321211,321212,0,1,2
91595,4,2,321215,321215,321217,0,2,3
91596,5,1,321220,321220,321221,0,1,3
91597,1,2,321221,321221,321223,0,2,0
91598,4,2,321225,321225,321227,0,2,2
91599,4,1,321229,321229,321230,0,1,2
91600,4,2,321233,321233,321235,0,2,3
91601,2,3,321235,321235,321238,0,3,0
91602,1,2,321236,321238,321240,2,4,0
91603,6,1,321242,321242,321243,0,1,2
91604,2,3,321244,321244,321247,0,3,1
91605,6,3,321250,321250,321253,0,3,3
91606,4,2,321254,321254,321256,0,2,1
91607,1,3,321255,321256,321259,1,4,0
91608,2,3,321257,321259,321262,2,5,0
91609,6,2,321263,321263,321265,0,2,1
91610,4,3,321267,321267,321270,0,3,2
91611,5,1,321272,321272,321273,0,1,2
91612,2,2,321274,321274,321276,0,2,1
91613,5,1,321279,321279,321280,0,1,3
91614,4,2,321283,321283,321285,0,2,3
91615,1,1,321284,321285,321286,1,2,0
91616,1,3,321285,321286,321289,1,4,0
91617,5,2,321290,321290,321292,0,2,1
91618,1,2,321291,321292,321294,1,3,0
91619,3,3,321294,321294,321297,0,3,0
91620,6,2,321300,321300,321302,0,2,3
91621,6,3,321306,321306,321309,0,3,4
91622,2,1,321308,321309,321310,1,2,0
91623,1,1,321309,321310,321311,1,2,0
91624,1,2,321310,321311,321313,1,3,0
91625,6,3,321316,321316,321319,0,3,3
91626,4,2,321320,321320,321322,0,2,1
91627,4,2,321324,321324,321326,0,2,2
91628,1,3,321325,321326,321329,1,4,0
91629,3,3,321328,321329,321332,1,4,0
91630,6,3,321334,321334,321337,0,3,2
91631,5,3,321339,321339,321342,0,3,2
91632,5,2,321344,321344,321346,0,2,2
91633,3,3,321347,321347,321350,0,3,1
91634,1,2,321348,321350,321352,2,4,0
91635,1,1,321349,321352,321353,3,4,0
91636,5,1,321354,321354,321355,0,1,1
91637,6,1,321360,321360,321361,0,1,5
91638,2,3,321362,321362,321365,0,3,1
91639,4,2,321366,321366,321368,0,2,1
91640,5,3,321371,321371,321374,0,3,3
91641,2,2,321373,321374,321376,1,3,0
91642,3,3,321376,321376,321379,0,3,0
91643,6,2,321382,321382,321384,0,2,3
91644,1,2,321383,321384,321386,1,3,0
91645,4,3,321387,321387,321390,0,3,1
91646,5,3,321392,321392,321395,0,3,2
91647,4,3,321396,321396,321399,0,3,1
91648,2,1,321398,321399,321400,1,2,0
91649,6,3,321404,321404,321407,0,3,4
91650,3,3,321407,321407,321410,0,3,0
91651,2,3,321409,321410,321413,1,4,0
91652,2,3,321411,321413,321416,2,5,0
91653,1,2,321412,321416,321418,4,6,0
91654,1,3,321413,321418,321421,5,8,0
91655,2,3,321415,321421,321424,6,9,0
91656,1,3,321416,321424,321427,8,11,0
91657,1,1,321417,321427,321428,10,11,0
91658,3,3,321420,321428,321431,8,11,0
91659,4,1,321424,321431,321432,7,8,0
91660,2,3,321426,321432,321435,6,9,0
91661,5,3,321431,321435,321438,4,7,0
91662,5,1,321436,321438,321439,2,3,0
91663,3,1,321439,321439,321440,0,1,0
91664,4,1,321443,321443,321444,0,1,3
91665,6,1,321449,321449,321450,0,1,5
91666,6,3,321455,321455,321458,0,3,5
91667,3,1,321458,321458,321459,0,1,0
91668,6,2,321464,321464,321466,0,2,5
91669,6,1,321470,321470,321471,0,1,4
91670,5,1,321475,321475,321476,0,1,4
91671,5,2,321480,321480,321482,0,2,4
91672,2,2,321482,321482,321484,0,2,0
91673,5,1,321487,321487,321488,0,1,3
91674,2,2,321489,321489,321491,0,2,1
91675,4,3,321493,321493,321496,0,3,2
91676,4,3,321497,321497,321500,0,3,1
91677,3,1,321500,321500,321501,0,1,0
91678,4,3,321504,321504,321507,0,3,3
91679,4,3,321508,321508,321511,0,3,1
91680,2,1,321510,321511,321512,1,2,0
91681,2,2,321512,321512,321514,0,2,0
91682,2,2,321514,321514,321516,0,2,0
91683,1,2,321515,321516,321518,1,3,0
91684,3,3,321518,321518,321521,0,3,0
91685,3,1,321521,321521,321522,0,1,0
91686,1,2,321522,321522,321524,0,2,0
91687,2,2,321524,321524,321526,0,2,0
91688,1,2,321525,321526,321528,1,3,0
91689,1,3,321526,321528,321531,2,5,0
91690,1,1,321527,321531,321532,4,5,0
91691,3,1,321530,321532,321533,2,3,0
91692,5,3,321535,321535,321538,0,3,2
91693,6,1,321541,321541,321542,0,1,3
91694,3,3,321544,321544,321547,0,3,2
91695,5,1,321549,321549,321550,0,1,2
91696,2,2,321551,321551,321553,0,2,1
91697,3,2,321554,321554,321556,0,2,1
91698,5,3,321559,321559,321562,0,3,3
91699,4,2,321563,321563,321565,0,2,1
91700,1,1,321564,321565,321566,1,2,0
91701,3,1,321567,321567,321568,0,1,1
91702,4,1,321571,321571,321572,0,1,3
91703,6,3,321577,321577,321580,0,3,5
91704,4,3,321581,321581,321584,0,3,1
91705,1,1,321582,321584,321585,2,3,0
91706,6,1,321588,321588,321589,0,1,3
91707,6,2,321594,321594,321596,0,2,5
91708,6,1,321600,321600,321601,0,1,4
91709,3,1,321603,321603,321604,0,1,2
91710,6,2,321609,321609,321611,0,2,5
91711,5,3,321614,321614,321617,0,3,3
91712,3,1,321617,321617,321618,0,1,0
91713,3,1,321620,321620,321621,0,1,2
91714,6,2,321626,321626,321628,0,2,5
91715,4,3,321630,321630,321633,0,3,2
91716,3,2,321633,321633,321635,0,2,0
91717,1,3,321634,321635,321638,1,4,0
91718,1,3,321635,321638,321641,3,6,0
91719,5,3,321640,321641,321644,1,4,0
91720,6,3,321646,321646,321649,0,3,2
91721,3,1,321649,321649,321650,0,1,0
91722,5,3,321654,321654,321657,0,3,4
91723,2,3,321656,321657,321660,1,4,0
91724,1,2,321657,321660,321662,3,5,0
91725,6,2,321663,321663,321665,0,2,1
91726,4,3,321667,321667,321670,0,3,2
91727,1,3,321668,321670,321673,2,5,0
91728,5,1,321673,321673,321674,0,1,0
91729,4,1,321677,321677,321678,0,1,3
91730,1,1,321678,321678,321679,0,1,0
91731,5,1,321683,321683,321684,0,1,4
91732,5,2,321688,321688,321690,0,2,4
91733,6,2,321694,321694,321696,0,2,4
91734,3,3,321697,321697,321700,0,3,1
91735,1,1,321698,321700,321701,2,3,0
91736,3,1,321701,321701,321702,0,1,0
91737,2,2,321703,321703,321705,0,2,1
91738,4,1,321707,321707,321708,0,1,2
91739,1,3,321708,321708,321711,0,3,0
91740,6,1,321714,321714,321715,0,1,3
91741,2,2,321716,321716,321718,0,2,1
91742,1,3,321717,321718,321721,1,4,0
91743,4,2,321721,321721,321723,0,2,0
91744,4,3,321725,321725,321728,0,3,2
91745,2,1,321727,321728,321729,1,2,0
91746,4,1,321731,321731,321732,0,1,2
91747,6,2,321737,321737,321739,0,2,5
91748,5,3,321742,321742,321745,0,3,3
91749,6,2,321748,321748,321750,0,2,3
91750,4,3,321752,321752,321755,0,3,2
91751,3,3,321755,321755,321758,0,3,0
91752,6,2,321761,321761,321763,0,2,3
91753,1,3,321762,321763,321766,1,4,0
91754,5,3,321767,321767,321770,0,3,1
91755,3,3,321770,321770,321773,0,3,0
91756,5,2,321775,321775,321777,0,2,2
91757,3,2,321778,321778,321780,0,2,1
91758,6,2,321784,321784,321786,0,2,4
91759,1,3,321785,321786,321789,1,4,0
91760,3,3,321788,321789,321792,1,4,0
91761,4,1,321792,321792,321793,0,1,0
91762,5,2,321797,321797,321799,0,2,4
91763,2,2,321799,321799,321801,0,2,0
91764,1,1,321800,321801,321802,1,2,0
91765,5,3,321805,321805,321808,0,3,3
91766,1,3,321806,321808,321811,2,5,0
91767,6,2,321812,321812,321814,0,2,1
91768,6,1,321818,321818,321819,0,1,4
91769,3,1,321821,321821,321822,0,1,2
91770,1,1,321822,321822,321823,0,1,0
91771,6,3,321828,321828,321831,0,3,5
91772,4,3,321832,321832,321835,0,3,1
91773,6,1,321838,321838,321839,0,1,3
91774,2,1,321840,321840,321841,0,1,1
91775,3,2,321843,321843,321845,0,2,2
91776,4,3,321847,321847,321850,0,3,2
91777,4,2,321851,321851,321853,0,2,1
91778,5,3,321856,321856,321859,0,3,3
91779,2,2,321858,321859,321861,1,3,0
91780,3,2,321861,321861,321863,0,2,0
91781,1,3,321862,321863,321866,1,4,0
91782,1,2,321863,321866,321868,3,5,0
91783,3,2,321866,321868,321870,2,4,0
91784,6,1,321872,321872,321873,0,1,2
91785,2,2,321874,321874,321876,0,2,1
91786,6,3,321880,321880,321883,0,3,4
91787,6,1,321886,321886,321887,0,1,3
91788,4,3,321890,321890,321893,0,3,3
91789,3,1,321893,321893,321894,0,1,0
91790,3,3,321896,321896,321899,0,3,2
91791,1,3,321897,321899,321902,2,5,0
91792,2,2,321899,321902,321904,3,5,0
91793,3,1,321902,321904,321905,2,3,0
91794,2,3,321904,321905,321908,1,4,0
91795,6,2,321910,321910,321912,0,2,2
91796,3,2,321913,321913,321915,0,2,1
91797,5,2,321918,321918,321920,0,2,3
91798,6,1,321924,321924,321925,0,1,4
91799,3,3,321927,321927,321930,0,3,2
91800,4,3,321931,321931,321934,0,3,1
91801,2,3,321933,321934,321937,1,4,0
91802,2,1,321935,321937,321938,2,3,0
91803,6,2,321941,321941,321943,0,2,3
91804,1,2,321942,321943,321945,1,3,0
91805,3,1,321945,321945,321946,0,1,0
91806,4,3,321949,321949,321952,0,3,3
91807,5,3,321954,321954,321957,0,3,2
91808,1,1,321955,321957,321958,2,3,0
91809,2,3,321957,321958,321961,1,4,0
91810,4,3,321961,321961,321964,0,3,0
91811,5,1,321966,321966,321967,0,1,2
91812,6,3,321972,321972,321975,0,3,5
91813,2,1,321974,321975,321976,1,2,0
91814,5,1,321979,321979,321980,0,1,3
91815,2,2,321981,321981,321983,0,2,1
91816,3,3,321984,321984,321987,0,3,1
91817,4,2,321988,321988,321990,0,2,1
91818,3,1,321991,321991,321992,0,1,1
91819,2,1,321993,321993,321994,0,1,1
91820,1,3,321994,321994,321997,0,3,0
91821,5,2,321999,321999,322001,0,2,2
91822,1,3,322000,322001,322004,1,4,0
91823,4,1,322004,322004,322005,0,1,0
91824,3,2,322007,322007,322009,0,2,2
91825,4,1,322011,322011,322012,0,1,2
91826,5,2,322016,322016,322018,0,2,4
91827,4,1,322020,322020,322021,0,1,2
91828,3,1,322023,322023,322024,0,1,2
91829,1,1,322024,322024,322025,0,1,0
91830,3,3,322027,322027,322030,0,3,2
91831,4,2,322031,322031,322033,0,2,1
91832,1,3,322032,322033,322036,1,4,0
91833,3,1,322035,322036,322037,1,2,0
91834,6,3,322041,322041,322044,0,3,4
91835,6,3,322047,322047,322050,0,3,3
91836,3,3,322050,322050,322053,0,3,0
91837,1,3,322051,322053,322056,2,5,0
91838,5,1,322056,322056,322057,0,1,0
91839,4,1,322060,322060,322061,0,1,3
91840,4,1,322064,322064,322065,0,1,3
91841,2,3,322066,322066,322069,0,3,1
91842,2,2,322068,322069,322071,1,3,0
91843,6,1,322074,322074,322075,0,1,3
91844,3,3,322077,322077,322080,0,3,2
91845,2,2,322079,322080,322082,1,3,0
91846,2,2,322081,322082,322084,1,3,0
91847,4,2,322085,322085,322087,0,2,1
91848,3,3,322088,322088,322091,0,3,1
91849,1,1,322089,322091,322092,2,3,0
91850,4,2,322093,322093,322095,0,2,1
91851,5,1,322098,322098,322099,0,1,3
91852,3,2,322101,322101,322103,0,2,2
91853,3,3,322104,322104,322107,0,3,1
91854,3,1,322107,322107,322108,0,1,0
91855,2,3,322109,322109,322112,0,3,1
91856,3,2,322112,322112,322114,0,2,0
91857,3,2,322115,322115,322117,0,2,1
91858,4,3,322119,322119,322122,0,3,2
91859,3,3,322122,322122,322125,0,3,0
91860,5,2,322127,322127,322129,0,2,2
91861,5,3,322132,322132,322135,0,3,3
91862,4,3,322136,322136,322139,0,3,1
91863,2,2,322138,322139,322141,1,3,0
91864,1,2,322139,322141,322143,2,4,0
91865,4,1,322143,322143,322144,0,1,0
91866,3,1,322146,322146,322147,0,1,2
91867,5,1,322151,322151,322152,0,1,4
91868,6,3,322157,322157,322160,0,3,5
91869,6,2,322163,322163,322165,0,2,3
91870,5,3,322168,322168,322171,0,3,3
91871,1,3,322169,322171,322174,2,5,0
91872,3,1,322172,322174,322175,2,3,0
91873,1,1,322173,322175,322176,2,3,0
91874,5,2,322178,322178,322180,0,2,2
91875,2,2,322180,322180,322182,0,2,0
91876,2,1,322182,322182,322183,0,1,0
91877,5,1,322187,322187,322188,0,1,4
91878,4,1,322191,322191,322192,0,1,3
91879,5,3,322196,322196,322199,0,3,4
91880,4,1,322200,322200,322201,0,1,1
91881,3,3,322203,322203,322206,0,3,2
91882,4,1,322207,322207,322208,0,1,1
91883,5,3,322212,322212,322215,0,3,4
91884,6,2,322218,322218,322220,0,2,3
91885,2,3,322220,322220,322223,0,3,0
91886,1,2,322221,322223,322225,2,4,0
91887,3,2,322224,322225,322227,1,3,0
91888,1,1,322225,322227,322228,2,3,0
91889,3,3,322228,322228,322231,0,3,0
91890,1,1,322229,322231,322232,2,3,0
91891,1,2,322230,322232,322234,2,4,0
91892,3,2,322233,322234,322236,1,3,0
91893,5,2,322238,322238,322240,0,2,2
91894,1,1,322239,322240,322241,1,2,0
91895,4,1,322243,322243,322244,0,1,2
91896,3,1,322246,322246,322247,0,1,2
91897,4,3,322250,322250,322253,0,3,3
91898,5,2,322255,322255,322257,0,2,2
91899,2,2,322257,322257,322259,0,2,0
91900,5,1,322262,322262,322263,0,1,3
91901,5,2,322267,322267,322269,0,2,4
91902,4,1,322271,322271,322272,0,1,2
91903,6,1,322277,322277,322278,0,1,5
91904,3,3,322280,322280,322283,0,3,2
91905,4,1,322284,322284,322285,0,1,1
91906,3,1,322287,322287,322288,0,1,2
91907,5,3,322292,322292,322295,0,3,4
91908,6,1,322298,322298,322299,0,1,3
91909,6,3,322304,322304,322307,0,3,5
91910,4,1,322308,322308,322309,0,1,1
91911,6,1,322314,322314,322315,0,1,5
91912,3,1,322317,322317,322318,0,1,2
91913,6,3,322323,322323,322326,0,3,5
91914,6,1,322329,322329,322330,0,1,3
91915,1,1,322330,322330,322331,0,1,0
91916,6,2,322336,322336,322338,0,2,5
91917,2,2,322338,322338,322340,0,2,0
91918,3,3,322341,322341,322344,0,3,1
91919,5,3,322346,322346,322349,0,3,2
91920,6,1,322352,322352,322353,0,1,3
91921,6,3,322358,322358,322361,0,3,5
91922,6,1,322364,322364,322365,0,1,3
91923,2,3,322366,322366,322369,0,3,1
91924,1,2,322367,322369,322371,2,4,0
91925,2,3,322369,322371,322374,2,5,0
91926,3,2,322372,322374,322376,2,4,0
91927,1,3,322373,322376,322379,3,6,0
91928,3,3,322376,322379,322382,3,6,0
91929,4,1,322380,322382,322383,2,3,0
91930,1,1,322381,322383,322384,2,3,0
91931,1,3,322382,322384,322387,2,5,0
91932,2,1,322384,322387,322388,3,4,0
91933,6,3,322390,322390,322393,0,3,2
91934,6,3,322396,322396,322399,0,3,3
91935,5,3,322401,322401,322404,0,3,2
91936,5,2,322406,322406,322408,0,2,2
91937,6,3,322412,322412,322415,0,3,4
91938,3,1,322415,322415,322416,0,1,0
91939,6,1,322421,322421,322422,0,1,5
91940,5,1,322426,322426,322427,0,1,4
91941,5,2,322431,322431,322433,0,2,4
91942,4,1,322435,322435,322436,0,1,2
91943,3,2,322438,322438,322440,0,2,2
91944,3,3,322441,322441,322444,0,3,1
91945,2,1,322443,322444,322445,1,2,0
91946,6,3,322449,322449,322452,0,3,4
91947,6,3,322455,322455,322458,0,3,3
91948,2,3,322457,322458,322461,1,4,0
91949,4,1,322461,322461,322462,0,1,0
91950,2,1,322463,322463,322464,0,1,1
91951,5,1,322468,322468,322469,0,1,4
91952,2,1,322470,322470,322471,0,1,1
91953,6,2,322476,322476,322478,0,2,5
91954,5,3,322481,322481,322484,0,3,3
91955,4,3,322485,322485,322488,0,3,1
91956,3,1,322488,322488,322489,0,1,0
91957,6,1,322494,322494,322495,0,1,5
91958,1,2,322495,322495,322497,0,2,0
91959,2,2,322497,322497,322499,0,2,0
91960,6,2,322503,322503,322505,0,2,4
91961,4,3,322507,322507,322510,0,3,2
91962,6,1,322513,322513,322514,0,1,3
91963,1,2,322514,322514,322516,0,2,0
91964,5,1,322519,322519,322520,0,1,3
91965,2,1,322521,322521,322522,0,1,1
91966,4,1,322525,322525,322526,0,1,3
91967,6,2,322531,322531,322533,0,2,5
91968,2,1,322533,322533,322534,0,1,0
91969,3,2,322536,322536,322538,0,2,2
91970,1,2,322537,322538,322540,1,3,0
91971,4,2,322541,322541,322543,0,2,1
91972,1,3,322542,322543,322546,1,4,0
91973,6,1,322548,322548,322549,0,1,2
91974,4,2,322552,322552,322554,0,2,3
91975,5,1,322557,322557,322558,0,1,3
91976,4,1,322561,322561,322562,0,1,3
91977,5,3,322566,322566,322569,0,3,4
91978,4,3,322570,322570,322573,0,3,1
91979,1,3,322571,322573,322576,2,5,0
91980,5,2,322576,322576,322578,0,2,0
91981,1,3,322577,322578,322581,1,4,0
91982,4,2,322581,322581,322583,0,2,0
91983,2,2,322583,322583,322585,0,2,0
91984,3,3,322586,322586,322589,0,3,1
91985,3,3,322589,322589,322592,0,3,0
91986,2,3,322591,322592,322595,1,4,0
91987,1,2,322592,322595,322597,3,5,0
91988,6,2,322598,322598,322600,0,2,1
91989,1,1,322599,322600,322601,1,2,0
91990,3,2,322602,322602,322604,0,2,1
91991,5,3,322607,322607,322610,0,3,3
91992,4,3,322611,322611,322614,0,3,1
91993,6,1,322617,322617,322618,0,1,3
91994,2,1,322619,322619,322620,0,1,1
91995,4,2,322623,322623,322625,0,2,3
91996,6,3,322629,322629,322632,0,3,4
91997,4,1,322633,322633,322634,0,1,1
91998,3,3,322636,322636,322639,0,3,2
91999,1,1,322637,322639,322640,2,3,0
92000,2,1,322639,322640,322641,1,2,0
92001,2,1,322641,322641,322642,0,1,0
92002,6,2,322647,322647,322649,0,2,5
92003,2,2,322649,322649,322651,0,2,0
92004,5,1,322654,322654,322655,0,1,3
92005,6,3,322660,322660,322663,0,3,5
92006,5,3,322665,322665,322668,0,3,2
92007,2,1,322667,322668,322669,1,2,0
92008,6,3,322673,322673,322676,0,3,4
92009,6,2,322679,322679,322681,0,2,3
92010,4,1,322683,322683,322684,0,1,2
92011,4,2,322687,322687,322689,0,2,3
92012,6,2,322693,322693,322695,0,2,4
92013,1,3,322694,322695,322698,1,4,0
92014,6,1,322700,322700,322701,0,1,2
92015,3,2,322703,322703,322705,0,2,2
92016,6,2,322709,322709,322711,0,2,4
92017,4,2,322713,322713,322715,0,2,2
92018,1,3,322714,322715,322718,1,4,0
92019,5,3,322719,322719,322722,0,3,1
92020,2,3,322721,322722,322725,1,4,0
92021,6,2,322727,322727,322729,0,2,2
92022,4,3,322731,322731,322734,0,3,2
92023,3,2,322734,322734,322736,0,2,0
92024,6,1,322740,322740,322741,0,1,4
92025,3,3,322743,322743,322746,0,3,2
92026,1,1,322744,322746,322747,2,3,0
92027,1,1,322745,322747,322748,2,3,0
92028,5,3,322750,322750,322753,0,3,2
92029,2,2,322752,322753,322755,1,3,0
92030,4,2,322756,322756,322758,0,2,1
92031,2,2,322758,322758,322760,0,2,0
92032,1,3,322759,322760,322763,1,4,0
92033,5,3,322764,322764,322767,0,3,1
92034,3,2,322767,322767,322769,0,2,0
92035,5,1,322772,322772,322773,0,1,3
92036,3,1,322775,322775,322776,0,1,2
92037,1,2,322776,322776,322778,0,2,0
92038,1,3,322777,322778,322781,1,4,0
92039,6,3,322783,322783,322786,0,3,2
92040,5,1,322788,322788,322789,0,1,2
92041,3,1,322791,322791,322792,0,1,2
92042,3,2,322794,322794,322796,0,2,2
92043,3,2,322797,322797,322799,0,2,1
92044,5,2,322802,322802,322804,0,2,3
92045,6,1,322808,322808,322809,0,1,4
92046,4,3,322812,322812,322815,0,3,3
92047,5,2,322817,322817,322819,0,2,2
92048,5,1,322822,322822,322823,0,1,3
92049,4,1,322826,322826,322827,0,1,3
92050,5,2,322831,322831,322833,0,2,4
92051,4,1,322835,322835,322836,0,1,2
92052,3,3,322838,322838,322841,0,3,2
92053,5,3,322843,322843,322846,0,3,2
92054,1,3,322844,322846,322849,2,5,0
92055,3,2,322847,322849,322851,2,4,0
92056,3,2,322850,322851,322853,1,3,0
92057,6,3,322856,322856,322859,0,3,3
92058,4,3,322860,322860,322863,0,3,1
92059,2,3,322862,322863,322866,1,4,0
92060,2,2,322864,322866,322868,2,4,0
92061,6,3,322870,322870,322873,0,3,2
92062,1,3,322871,322873,322876,2,5,0
92063,1,1,322872,322876,322877,4,5,0
92064,6,1,322878,322878,322879,0,1,1
92065,3,3,322881,322881,322884,0,3,2
92066,2,2,322883,322884,322886,1,3,0
92067,3,1,322886,322886,322887,0,1,0
92068,2,1,322888,322888,322889,0,1,1
92069,5,2,322893,322893,322895,0,2,4
92070,3,2,322896,322896,322898,0,2,1
92071,4,2,322900,322900,322902,0,2,2
92072,2,1,322902,322902,322903,0,1,0
92073,2,3,322904,322904,322907,0,3,1
92074,5,1,322909,322909,322910,0,1,2
92075,4,3,322913,322913,322916,0,3,3
92076,3,2,322916,322916,322918,0,2,0
92077,5,1,322921,322921,322922,0,1,3
92078,2,2,322923,322923,322925,0,2,1
92079,1,3,322924,322925,322928,1,4,0
92080,2,1,322926,322928,322929,2,3,0
92081,6,2,322932,322932,322934,0,2,3
92082,5,3,322937,322937,322940,0,3,3
92083,6,2,322943,322943,322945,0,2,3
92084,4,3,322947,322947,322950,0,3,2
92085,5,1,322952,322952,322953,0,1,2
92086,2,1,322954,322954,322955,0,1,1
92087,4,2,322958,322958,322960,0,2,3
92088,2,3,322960,322960,322963,0,3,0
92089,1,2,322961,322963,322965,2,4,0
92090,6,2,322967,322967,322969,0,2,2
92091,6,1,322973,322973,322974,0,1,4
92092,3,2,322976,322976,322978,0,2,2
92093,2,3,322978,322978,322981,0,3,0
92094,3,3,322981,322981,322984,0,3,0
92095,3,1,322984,322984,322985,0,1,0
92096,2,3,322986,322986,322989,0,3,1
92097,5,3,322991,322991,322994,0,3,2
92098,2,1,322993,322994,322995,1,2,0
92099,4,3,322997,322997,323000,0,3,2
92100,6,3,323003,323003,323006,0,3,3
92101,1,3,323004,323006,323009,2,5,0
92102,4,3,323008,323009,323012,1,4,0
92103,6,3,323014,323014,323017,0,3,2
92104,4,1,323018,323018,323019,0,1,1
92105,6,3,323024,323024,323027,0,3,5
92106,4,1,323028,323028,323029,0,1,1
92107,6,2,323034,323034,323036,0,2,5
92108,3,3,323037,323037,323040,0,3,1
92109,3,2,323040,323040,323042,0,2,0
92110,3,2,323043,323043,323045,0,2,1
92111,1,2,323044,323045,323047,1,3,0
92112,6,1,323050,323050,323051,0,1,3
92113,1,2,323051,323051,323053,0,2,0
92114,2,3,323053,323053,323056,0,3,0
92115,6,1,323059,323059,323060,0,1,3
92116,3,2,323062,323062,323064,0,2,2
92117,1,2,323063,323064,323066,1,3,0
92118,4,3,323067,323067,323070,0,3,1
92119,1,3,323068,323070,323073,2,5,0
92120,2,1,323070,323073,323074,3,4,0
92121,6,2,323076,323076,323078,0,2,2
92122,3,2,323079,323079,323081,0,2,1
92123,1,1,323080,323081,323082,1,2,0
92124,3,2,323083,323083,323085,0,2,1
92125,1,2,323084,323085,323087,1,3,0
92126,3,3,323087,323087,323090,0,3,0
92127,3,3,323090,323090,323093,0,3,0
92128,2,2,323092,323093,323095,1,3,0
92129,2,1,323094,323095,323096,1,2,0
92130,6,2,323100,323100,323102,0,2,4
92131,1,3,323101,323102,323105,1,4,0
92132,3,2,323104,323105,323107,1,3,0
92133,5,1,323109,323109,323110,0,1,2
92134,5,1,323114,323114,323115,0,1,4
92135,1,3,323115,323115,323118,0,3,0
92136,6,1,323121,323121,323122,0,1,3
92137,2,2,323123,323123,323125,0,2,1
92138,5,3,323128,323128,323131,0,3,3
92139,3,2,323131,323131,323133,0,2,0
92140,5,3,323136,323136,323139,0,3,3
92141,5,1,323141,323141,323142,0,1,2
92142,6,1,323147,323147,323148,0,1,5
92143,1,2,323148,323148,323150,0,2,0
92144,5,2,323153,323153,323155,0,2,3
92145,2,2,323155,323155,323157,0,2,0
92146,5,1,323160,323160,323161,0,1,3
92147,6,1,323166,323166,323167,0,1,5
92148,6,2,323172,323172,323174,0,2,5
92149,2,2,323174,323174,323176,0,2,0
92150,4,1,323178,323178,323179,0,1,2
92151,2,2,323180,323180,323182,0,2,1
92152,3,3,323183,323183,323186,0,3,1
92153,6,1,323189,323189,323190,0,1,3
92154,1,2,323190,323190,323192,0,2,0
92155,6,3,323196,323196,323199,0,3,4
92156,5,3,323201,323201,323204,0,3,2
92157,1,2,323202,323204,323206,2,4,0
92158,4,3,323206,323206,323209,0,3,0
92159,2,2,323208,323209,323211,1,3,0
92160,4,1,323212,323212,323213,0,1,1
92161,2,2,323214,323214,323216,0,2,1
92162,2,3,323216,323216,323219,0,3,0
92163,4,3,323220,323220,323223,0,3,1
92164,1,3,323221,323223,323226,2,5,0
92165,3,3,323224,323226,323229,2,5,0
92166,6,1,323230,323230,323231,0,1,1
92167,2,3,323232,323232,323235,0,3,1
92168,5,1,323237,323237,323238,0,1,2
92169,6,3,323243,323243,323246,0,3,5
92170,2,1,323245,323246,323247,1,2,0
92171,3,2,323248,323248,323250,0,2,1
92172,6,2,323254,323254,323256,0,2,4
92173,2,1,323256,323256,323257,0,1,0
92174,5,3,323261,323261,323264,0,3,4
92175,2,3,323263,323264,323267,1,4,0
92176,4,3,323267,323267,323270,0,3,0
92177,3,3,323270,323270,323273,0,3,0
92178,3,1,323273,323273,323274,0,1,0
92179,1,3,323274,323274,323277,0,3,0
92180,1,3,323275,323277,323280,2,5,0
92181,6,2,323281,323281,323283,0,2,1
92182,2,1,323283,323283,323284,0,1,0
92183,6,1,323289,323289,323290,0,1,5
92184,2,3,323291,323291,323294,0,3,1
92185,5,2,323296,323296,323298,0,2,2
92186,4,1,323300,323300,323301,0,1,2
92187,1,2,323301,323301,323303,0,2,0
92188,3,2,323304,323304,323306,0,2,1
92189,2,1,323306,323306,323307,0,1,0
92190,1,3,323307,323307,323310,0,3,0
92191,2,1,323309,323310,323311,1,2,0
92192,4,1,323313,323313,323314,0,1,2
92193,6,3,323319,323319,323322,0,3,5
92194,6,2,323325,323325,323327,0,2,3
92195,2,2,323327,323327,323329,0,2,0
92196,5,3,323332,323332,323335,0,3,3
92197,2,3,323334,323335,323338,1,4,0
92198,5,2,323339,323339,323341,0,2,1
92199,4,3,323343,323343,323346,0,3,2
92200,6,1,323349,323349,323350,0,1,3
92201,1,2,323350,323350,323352,0,2,0
92202,1,1,323351,323352,323353,1,2,0
92203,1,1,323352,323353,323354,1,2,0
92204,4,3,323356,323356,323359,0,3,2
92205,5,1,323361,323361,323362,0,1,2
92206,5,3,323366,323366,323369,0,3,4
92207,2,3,323368,323369,323372,1,4,0
92208,3,1,323371,323372,323373,1,2,0
92209,4,2,323375,323375,323377,0,2,2
92210,4,2,323379,323379,323381,0,2,2
92211,6,2,323385,323385,323387,0,2,4
92212,1,1,323386,323387,323388,1,2,0
92213,4,1,323390,323390,323391,0,1,2
92214,6,3,323396,323396,323399,0,3,5
92215,4,3,323400,323400,323403,0,3,1
92216,5,2,323405,323405,323407,0,2,2
92217,3,3,323408,323408,323411,0,3,1
92218,3,2,323411,323411,323413,0,2,0
92219,3,1,323414,323414,323415,0,1,1
92220,5,3,323419,323419,323422,0,3,4
92221,3,2,323422,323422,323424,0,2,0
92222,3,1,323425,323425,323426,0,1,1
92223,2,1,323427,323427,323428,0,1,1
92224,4,2,323431,323431,323433,0,2,3
92225,2,3,323433,323433,323436,0,3,0
92226,3,3,323436,323436,323439,0,3,0
92227,3,2,323439,323439,323441,0,2,0
92228,3,1,323442,323442,323443,0,1,1
92229,5,1,323447,323447,323448,0,1,4
92230,4,3,323451,323451,323454,0,3,3
92231,5,1,323456,323456,323457,0,1,2
92232,3,1,323459,323459,323460,0,1,2
92233,5,3,323464,323464,323467,0,3,4
92234,1,2,323465,323467,323469,2,4,0
92235,4,3,323469,323469,323472,0,3,0
92236,1,2,323470,323472,323474,2,4,0
92237,5,3,323475,323475,323478,0,3,1
92238,2,2,323477,323478,323480,1,3,0
92239,4,3,323481,323481,323484,0,3,1
92240,1,1,323482,323484,323485,2,3,0
92241,1,1,323483,323485,323486,2,3,0
92242,6,1,323489,323489,323490,0,1,3
92243,6,3,323495,323495,323498,0,3,5
92244,1,3,323496,323498,323501,2,5,0
92245,1,1,323497,323501,323502,4,5,0
92246,5,1,323502,323502,323503,0,1,0
92247,3,3,323505,323505,323508,0,3,2
92248,4,1,323509,323509,323510,0,1,1
92249,1,3,323510,323510,323513,0,3,0
92250,1,1,323511,323513,323514,2,3,0
92251,6,1,323517,323517,323518,0,1,3
92252,1,1,323518,323518,323519,0,1,0
92253,2,2,323520,323520,323522,0,2,1
92254,3,2,323523,323523,323525,0,2,1
92255,2,2,323525,323525,323527,0,2,0
92256,2,1,323527,323527,323528,0,1,0
92257,2,1,323529,323529,323530,0,1,1
92258,6,2,323535,323535,323537,0,2,5
92259,2,2,323537,323537,323539,0,2,0
92260,6,3,323543,323543,323546,0,3,4
92261,1,1,323544,323546,323547,2,3,0
92262,3,2,323547,323547,323549,0,2,0
92263,6,2,323553,323553,323555,0,2,4
92264,3,2,323556,323556,323558,0,2,1
92265,3,2,323559,323559,323561,0,2,1
92266,3,3,323562,323562,323565,0,3,1
92267,3,2,323565,323565,323567,0,2,0
92268,5,1,323570,323570,323571,0,1,3
92269,2,3,323572,323572,323575,0,3,1
92270,2,3,323574,323575,323578,1,4,0
92271,2,2,323576,323578,323580,2,4,0
92272,6,3,323582,323582,323585,0,3,2
92273,5,2,323587,323587,323589,0,2,2
92274,1,2,323588,323589,323591,1,3,0
92275,1,3,323589,323591,323594,2,5,0
92276,2,3,323591,323594,323597,3,6,0
92277,6,1,323597,323597,323598,0,1,0
92278,2,2,323599,323599,323601,0,2,1
92279,4,2,323603,323603,323605,0,2,2
92280,1,1,323604,323605,323606,1,2,0
92281,1,1,323605,323606,323607,1,2,0
92282,5,3,323610,323610,323613,0,3,3
92283,5,1,323615,323615,323616,0,1,2
92284,1,1,323616,323616,323617,0,1,0
92285,3,3,323619,323619,323622,0,3,2
92286,3,1,323622,323622,323623,0,1,0
92287,1,1,323623,323623,323624,0,1,0
92288,2,3,323625,323625,323628,0,3,1
92289,2,3,323627,323628,323631,1,4,0
92290,1,1,323628,323631,323632,3,4,0
92291,3,2,323631,323632,323634,1,3,0
92292,3,1,323634,323634,323635,0,1,0
92293,2,3,323636,323636,323639,0,3,1
92294,5,2,323641,323641,323643,0,2,2
92295,2,2,323643,323643,323645,0,2,0
92296,5,1,323648,323648,323649,0,1,3
92297,6,2,323654,323654,323656,0,2,5
92298,6,1,323660,323660,323661,0,1,4
92299,3,1,323663,323663,323664,0,1,2
92300,6,1,323669,323669,323670,0,1,5
92301,4,1,323673,323673,323674,0,1,3
92302,4,1,323677,323677,323678,0,1,3
92303,2,3,323679,323679,323682,0,3,1
92304,5,3,323684,323684,323687,0,3,2
92305,1,3,323685,323687,323690,2,5,0
92306,4,1,323689,323690,323691,1,2,0
92307,2,2,323691,323691,323693,0,2,0
92308,5,2,323696,323696,323698,0,2,3
92309,6,1,323702,323702,323703,0,1,4
92310,6,1,323708,323708,323709,0,1,5
92311,1,2,323709,323709,323711,0,2,0
92312,4,1,323713,323713,323714,0,1,2
92313,6,3,323719,323719,323722,0,3,5
92314,5,1,323724,323724,323725,0,1,2
92315,4,2,323728,323728,323730,0,2,3
92316,2,1,323730,323730,323731,0,1,0
92317,2,2,323732,323732,323734,0,2,1
92318,2,2,323734,323734,323736,0,2,0
92319,2,2,323736,323736,323738,0,2,0
92320,4,2,323740,323740,323742,0,2,2
92321,6,3,323746,323746,323749,0,3,4
92322,5,1,323751,323751,323752,0,1,2
92323,3,3,323754,323754,323757,0,3,2
92324,4,1,323758,323758,323759,0,1,1
92325,4,2,323762,323762,323764,0,2,3
92326,2,3,323764,323764,323767,0,3,0
92327,3,3,323767,323767,323770,0,3,0
92328,2,3,323769,323770,323773,1,4,0
92329,3,1,323772,323773,323774,1,2,0
92330,6,1,323778,323778,323779,0,1,4
92331,5,1,323783,323783,323784,0,1,4
92332,5,3,323788,323788,323791,0,3,4
92333,6,3,323794,323794,323797,0,3,3
92334,6,1,323800,323800,323801,0,1,3
92335,3,2,323803,323803,323805,0,2,2
92336,3,2,323806,323806,323808,0,2,1
92337,3,2,323809,323809,323811,0,2,1
92338,4,1,323813,323813,323814,0,1,2
92339,6,2,323819,323819,323821,0,2,5
92340,2,3,323821,323821,323824,0,3,0
92341,6,2,323827,323827,323829,0,2,3
92342,2,2,323829,323829,323831,0,2,0
92343,6,2,323835,323835,323837,0,2,4
92344,5,2,323840,323840,323842,0,2,3
92345,3,2,323843,323843,323845,0,2,1
92346,3,1,323846,323846,323847,0,1,1
92347,6,3,323852,323852,323855,0,3,5
92348,4,2,323856,323856,323858,0,2,1
92349,1,2,323857,323858,323860,1,3,0
92350,4,2,323861,323861,323863,0,2,1
92351,2,1,323863,323863,323864,0,1,0
92352,4,1,323867,323867,323868,0,1,3
92353,2,1,323869,323869,323870,0,1,1
92354,5,2,323874,323874,323876,0,2,4
92355,4,1,323878,323878,323879,0,1,2
92356,1,3,323879,323879,323882,0,3,0
92357,3,3,323882,323882,323885,0,3,0
92358,6,1,323888,323888,323889,0,1,3
92359,2,3,323890,323890,323893,0,3,1
92360,6,1,323896,323896,323897,0,1,3
92361,6,2,323902,323902,323904,0,2,5
92362,2,3,323904,323904,323907,0,3,0
92363,3,3,323907,323907,323910,0,3,0
92364,1,3,323908,323910,323913,2,5,0
92365,2,1,323910,323913,323914,3,4,0
92366,4,3,323914,323914,323917,0,3,0
92367,3,2,323917,323917,323919,0,2,0
92368,1,3,323918,323919,323922,1,4,0
92369,1,3,323919,323922,323925,3,6,0
92370,3,2,323922,323925,323927,3,5,0
92371,6,1,323928,323928,323929,0,1,1
92372,3,1,323931,323931,323932,0,1,2
92373,3,1,323934,323934,323935,0,1,2
92374,6,2,323940,323940,323942,0,2,5
92375,2,1,323942,323942,323943,0,1,0
92376,3,3,323945,323945,323948,0,3,2
92377,2,1,323947,323948,323949,1,2,0
92378,2,3,323949,323949,323952,0,3,0
92379,4,3,323953,323953,323956,0,3,1
92380,6,2,323959,323959,323961,0,2,3
92381,1,2,323960,323961,323963,1,3,0
92382,3,3,323963,323963,323966,0,3,0
92383,5,2,323968,323968,323970,0,2,2
92384,2,1,323970,323970,323971,0,1,0
92385,5,2,323975,323975,323977,0,2,4
92386,3,1,323978,323978,323979,0,1,1
92387,4,1,323982,323982,323983,0,1,3
92388,5,1,323987,323987,323988,0,1,4
92389,4,1,323991,323991,323992,0,1,3
92390,5,3,323996,323996,323999,0,3,4
92391,1,2,323997,323999,324001,2,4,0
92392,6,3,324003,324003,324006,0,3,2
92393,4,2,324007,324007,324009,0,2,1
92394,1,2,324008,324009,324011,1,3,0
92395,6,2,324014,324014,324016,0,2,3
92396,2,1,324016,324016,324017,0,1,0
92397,3,3,324019,324019,324022,0,3,2
92398,5,2,324024,324024,324026,0,2,2
92399,4,1,324028,324028,324029,0,1,2
92400,1,1,324029,324029,324030,0,1,0
92401,3,1,324032,324032,324033,0,1,2
92402,3,3,324035,324035,324038,0,3,2
92403,1,3,324036,324038,324041,2,5,0
92404,2,1,324038,324041,324042,3,4,0
92405,2,3,324040,324042,324045,2,5,0
92406,6,1,324046,324046,324047,0,1,1
92407,4,2,324050,324050,324052,0,2,3
92408,4,1,324054,324054,324055,0,1,2
92409,3,2,324057,324057,324059,0,2,2
92410,6,3,324063,324063,324066,0,3,4
92411,2,3,324065,324066,324069,1,4,0
92412,3,3,324068,324069,324072,1,4,0
92413,5,2,324073,324073,324075,0,2,1
92414,6,1,324079,324079,324080,0,1,4
92415,2,3,324081,324081,324084,0,3,1
92416,2,3,324083,324084,324087,1,4,0
92417,5,1,324088,324088,324089,0,1,1
92418,3,2,324091,324091,324093,0,2,2
92419,6,3,324097,324097,324100,0,3,4
92420,5,2,324102,324102,324104,0,2,2
92421,1,3,324103,324104,324107,1,4,0
92422,6,1,324109,324109,324110,0,1,2
92423,4,2,324113,324113,324115,0,2,3
92424,2,2,324115,324115,324117,0,2,0
92425,1,1,324116,324117,324118,1,2,0
92426,6,3,324122,324122,324125,0,3,4
92427,5,3,324127,324127,324130,0,3,2
92428,4,1,324131,324131,324132,0,1,1
92429,6,1,324137,324137,324138,0,1,5
92430,2,1,324139,324139,324140,0,1,1
92431,6,1,324145,324145,324146,0,1,5
92432,2,2,324147,324147,324149,0,2,1
92433,3,2,324150,324150,324152,0,2,1
92434,1,3,324151,324152,324155,1,4,0
92435,5,3,324156,324156,324159,0,3,1
92436,5,3,324161,324161,324164,0,3,2
92437,6,1,324167,324167,324168,0,1,3
92438,3,2,324170,324170,324172,0,2,2
92439,2,3,324172,324172,324175,0,3,0
92440,2,1,324174,324175,324176,1,2,0
92441,5,2,324179,324179,324181,0,2,3
92442,6,2,324185,324185,324187,0,2,4
92443,1,3,324186,324187,324190,1,4,0
92444,1,3,324187,324190,324193,3,6,0
92445,6,2,324193,324193,324195,0,2,0
92446,6,3,324199,324199,324202,0,3,4
92447,3,1,324202,324202,324203,0,1,0
92448,5,3,324207,324207,324210,0,3,4
92449,4,2,324211,324211,324213,0,2,1
92450,2,3,324213,324213,324216,0,3,0
92451,5,1,324218,324218,324219,0,1,2
92452,5,1,324223,324223,324224,0,1,4
92453,3,1,324226,324226,324227,0,1,2
92454,1,1,324227,324227,324228,0,1,0
92455,6,1,324233,324233,324234,0,1,5
92456,4,3,324237,324237,324240,0,3,3
92457,1,2,324238,324240,324242,2,4,0
92458,2,3,324240,324242,324245,2,5,0
92459,6,1,324246,324246,324247,0,1,1
92460,6,2,324252,324252,324254,0,2,5
92461,6,2,324258,324258,324260,0,2,4
92462,2,3,324260,324260,324263,0,3,0
92463,3,2,324263,324263,324265,0,2,0
92464,2,3,324265,324265,324268,0,3,0
92465,4,2,324269,324269,324271,0,2,1
92466,5,3,324274,324274,324277,0,3,3
92467,1,3,324275,324277,324280,2,5,0
92468,6,2,324281,324281,324283,0,2,1
92469,2,2,324283,324283,324285,0,2,0
92470,1,2,324284,324285,324287,1,3,0
92471,4,1,324288,324288,324289,0,1,1
92472,4,1,324292,324292,324293,0,1,3
92473,5,3,324297,324297,324300,0,3,4
92474,1,2,324298,324300,324302,2,4,0
92475,3,2,324301,324302,324304,1,3,0
92476,2,1,324303,324304,324305,1,2,0
92477,5,3,324308,324308,324311,0,3,3
92478,3,2,324311,324311,324313,0,2,0
92479,5,3,324316,324316,324319,0,3,3
92480,6,2,324322,324322,324324,0,2,3
92481,4,2,324326,324326,324328,0,2,2
92482,4,1,324330,324330,324331,0,1,2
92483,5,3,324335,324335,324338,0,3,4
92484,6,1,324341,324341,324342,0,1,3
92485,2,3,324343,324343,324346,0,3,1
92486,1,2,324344,324346,324348,2,4,0
92487,2,2,324346,324348,324350,2,4,0
92488,2,1,324348,324350,324351,2,3,0
92489,2,3,324350,324351,324354,1,4,0
92490,2,3,324352,324354,324357,2,5,0
92491,1,2,324353,324357,324359,4,6,0
92492,4,2,324357,324359,324361,2,4,0
92493,5,3,324362,324362,324365,0,3,1
92494,5,1,324367,324367,324368,0,1,2
92495,4,1,324371,324371,324372,0,1,3
92496,5,1,324376,324376,324377,0,1,4
92497,1,3,324377,324377,324380,0,3,0
92498,1,3,324378,324380,324383,2,5,0
92499,5,3,324383,324383,324386,0,3,0
92500,6,3,324389,324389,324392,0,3,3
92501,5,3,324394,324394,324397,0,3,2
92502,2,1,324396,324397,324398,1,2,0
92503,3,1,324399,324399,324400,0,1,1
92504,1,2,324400,324400,324402,0,2,0
92505,5,1,324405,324405,324406,0,1,3
92506,6,1,324411,324411,324412,0,1,5
92507,1,3,324412,324412,324415,0,3,0
92508,2,1,324414,324415,324416,1,2,0
92509,4,3,324418,324418,324421,0,3,2
92510,6,1,324424,324424,324425,0,1,3
92511,3,2,324427,324427,324429,0,2,2
92512,1,3,324428,324429,324432,1,4,0
92513,6,3,324434,324434,324437,0,3,2
92514,5,3,324439,324439,324442,0,3,2
92515,4,1,324443,324443,324444,0,1,1
92516,6,3,324449,324449,324452,0,3,5
92517,3,2,324452,324452,324454,0,2,0
92518,1,2,324453,324454,324456,1,3,0
92519,1,2,324454,324456,324458,2,4,0
92520,1,1,324455,324458,324459,3,4,0
92521,5,2,324460,324460,324462,0,2,1
92522,6,2,324466,324466,324468,0,2,4
92523,2,1,324468,324468,324469,0,1,0
92524,5,3,324473,324473,324476,0,3,4
92525,4,1,324477,324477,324478,0,1,1
92526,2,3,324479,324479,324482,0,3,1
92527,4,1,324483,324483,324484,0,1,1
92528,2,1,324485,324485,324486,0,1,1
92529,2,1,324487,324487,324488,0,1,1
92530,2,1,324489,324489,324490,0,1,1
92531,1,2,324490,324490,324492,0,2,0
92532,4,1,324494,324494,324495,0,1,2
92533,3,3,324497,324497,324500,0,3,2
92534,1,2,324498,324500,324502,2,4,0
92535,1,1,324499,324502,324503,3,4,0
92536,4,1,324503,324503,324504,0,1,0
92537,2,2,324505,324505,324507,0,2,1
92538,1,3,324506,324507,324510,1,4,0
92539,3,3,324509,324510,324513,1,4,0
92540,4,2,324513,324513,324515,0,2,0
92541,4,2,324517,324517,324519,0,2,2
92542,4,1,324521,324521,324522,0,1,2
92543,6,2,324527,324527,324529,0,2,5
92544,4,3,324531,324531,324534,0,3,2
92545,4,2,324535,324535,324537,0,2,1
92546,5,1,324540,324540,324541,0,1,3
92547,2,2,324542,324542,324544,0,2,1
92548,5,3,324547,324547,324550,0,3,3
92549,5,2,324552,324552,324554,0,2,2
92550,4,3,324556,324556,324559,0,3,2
92551,4,2,324560,324560,324562,0,2,1
92552,1,1,324561,324562,324563,1,2,0
92553,1,2,324562,324563,324565,1,3,0
92554,4,3,324566,324566,324569,0,3,1
92555,6,3,324572,324572,324575,0,3,3
92556,2,1,324574,324575,324576,1,2,0
92557,3,1,324577,324577,324578,0,1,1
92558,1,2,324578,324578,324580,0,2,0
92559,2,1,324580,324580,324581,0,1,0
92560,2,1,324582,324582,324583,0,1,1
92561,1,3,324583,324583,324586,0,3,0
92562,3,1,324586,324586,324587,0,1,0
92563,5,3,324591,324591,324594,0,3,4
92564,5,3,324596,324596,324599,0,3,2
92565,1,2,324597,324599,324601,2,4,0
92566,2,1,324599,324601,324602,2,3,0
92567,4,3,324603,324603,324606,0,3,1
92568,2,3,324605,324606,324609,1,4,0
92569,4,1,324609,324609,324610,0,1,0
92570,6,3,324615,324615,324618,0,3,5
92571,4,3,324619,324619,324622,0,3,1
92572,5,2,324624,324624,324626,0,2,2
92573,3,2,324627,324627,324629,0,2,1
92574,3,1,324630,324630,324631,0,1,1
92575,5,2,324635,324635,324637,0,2,4
92576,2,1,324637,324637,324638,0,1,0
92577,5,3,324642,324642,324645,0,3,4
92578,5,3,324647,324647,324650,0,3,2
92579,3,3,324650,324650,324653,0,3,0
92580,1,1,324651,324653,324654,2,3,0
92581,5,1,324656,324656,324657,0,1,2
92582,5,2,324661,324661,324663,0,2,4
92583,4,2,324665,324665,324667,0,2,2
92584,2,3,324667,324667,324670,0,3,0
92585,1,2,324668,324670,324672,2,4,0
92586,2,3,324670,324672,324675,2,5,0
92587,5,2,324675,324675,324677,0,2,0
92588,4,2,324679,324679,324681,0,2,2
92589,1,2,324680,324681,324683,1,3,0
92590,4,2,324684,324684,324686,0,2,1
92591,1,2,324685,324686,324688,1,3,0
92592,1,1,324686,324688,324689,2,3,0
92593,4,3,324690,324690,324693,0,3,1
92594,4,1,324694,324694,324695,0,1,1
92595,4,1,324698,324698,324699,0,1,3
92596,5,2,324703,324703,324705,0,2,4
92597,5,3,324708,324708,324711,0,3,3
92598,6,3,324714,324714,324717,0,3,3
92599,2,1,324716,324717,324718,1,2,0
92600,4,2,324720,324720,324722,0,2,2
92601,4,3,324724,324724,324727,0,3,2
92602,5,2,324729,324729,324731,0,2,2
92603,4,2,324733,324733,324735,0,2,2
92604,2,2,324735,324735,324737,0,2,0
92605,4,3,324739,324739,324742,0,3,2
92606,5,3,324744,324744,324747,0,3,2
92607,6,3,324750,324750,324753,0,3,3
92608,5,2,324755,324755,324757,0,2,2
92609,2,2,324757,324757,324759,0,2,0
92610,6,2,324763,324763,324765,0,2,4
92611,2,3,324765,324765,324768,0,3,0
92612,6,2,324771,324771,324773,0,2,3
92613,3,2,324774,324774,324776,0,2,1
92614,6,3,324780,324780,324783,0,3,4
92615,5,3,324785,324785,324788,0,3,2
92616,4,2,324789,324789,324791,0,2,1
92617,5,2,324794,324794,324796,0,2,3
92618,6,3,324800,324800,324803,0,3,4
92619,6,3,324806,324806,324809,0,3,3
92620,1,1,324807,324809,324810,2,3,0
92621,2,1,324809,324810,324811,1,2,0
92622,2,1,324811,324811,324812,0,1,0
92623,6,2,324817,324817,324819,0,2,5
92624,6,2,324823,324823,324825,0,2,4
92625,1,3,324824,324825,324828,1,4,0
92626,1,2,324825,324828,324830,3,5,0
92627,5,3,324830,324830,324833,0,3,0
92628,2,3,324832,324833,324836,1,4,0
92629,2,1,324834,324836,324837,2,3,0
92630,3,2,324837,324837,324839,0,2,0
92631,5,1,324842,324842,324843,0,1,3
92632,4,2,324846,324846,324848,0,2,3
92633,5,1,324851,324851,324852,0,1,3
92634,6,2,324857,324857,324859,0,2,5
92635,1,2,324858,324859,324861,1,3,0
92636,6,2,324864,324864,324866,0,2,3
92637,2,2,324866,324866,324868,0,2,0
92638,1,3,324867,324868,324871,1,4,0
92639,6,3,324873,324873,324876,0,3,2
92640,3,2,324876,324876,324878,0,2,0
92641,6,2,324882,324882,324884,0,2,4
92642,6,3,324888,324888,324891,0,3,4
92643,2,1,324890,324891,324892,1,2,0
92644,3,2,324893,324893,324895,0,2,1
92645,2,3,324895,324895,324898,0,3,0
92646,1,1,324896,324898,324899,2,3,0
92647,2,1,324898,324899,324900,1,2,0
92648,4,3,324902,324902,324905,0,3,2
92649,3,2,324905,324905,324907,0,2,0
92650,4,1,324909,324909,324910,0,1,2
92651,1,1,324910,324910,324911,0,1,0
92652,6,2,324916,324916,324918,0,2,5
92653,2,2,324918,324918,324920,0,2,0
92654,2,3,324920,324920,324923,0,3,0
92655,3,1,324923,324923,324924,0,1,0
92656,6,2,324929,324929,324931,0,2,5
92657,5,1,324934,324934,324935,0,1,3
92658,6,2,324940,324940,324942,0,2,5
92659,4,3,324944,324944,324947,0,3,2
92660,1,3,324945,324947,324950,2,5,0
92661,6,3,324951,324951,324954,0,3,1
92662,3,1,324954,324954,324955,0,1,0
92663,4,2,324958,324958,324960,0,2,3
92664,6,2,324964,324964,324966,0,2,4
92665,1,2,324965,324966,324968,1,3,0
92666,2,1,324967,324968,324969,1,2,0
92667,4,3,324971,324971,324974,0,3,2
92668,6,1,324977,324977,324978,0,1,3
92669,6,3,324983,324983,324986,0,3,5
92670,4,3,324987,324987,324990,0,3,1
92671,6,2,324993,324993,324995,0,2,3
92672,4,2,324997,324997,324999,0,2,2
92673,2,1,324999,324999,325000,0,1,0
92674,4,3,325003,325003,325006,0,3,3
92675,4,1,325007,325007,325008,0,1,1
92676,5,3,325012,325012,325015,0,3,4
92677,5,3,325017,325017,325020,0,3,2
92678,3,2,325020,325020,325022,0,2,0
92679,6,2,325026,325026,325028,0,2,4
92680,4,2,325030,325030,325032,0,2,2
92681,3,2,325033,325033,325035,0,2,1
92682,2,3,325035,325035,325038,0,3,0
92683,5,3,325040,325040,325043,0,3,2
92684,3,2,325043,325043,325045,0,2,0
92685,2,1,325045,325045,325046,0,1,0
92686,3,2,325048,325048,325050,0,2,2
92687,1,1,325049,325050,325051,1,2,0
92688,3,1,325052,325052,325053,0,1,1
92689,6,2,325058,325058,325060,0,2,5
92690,2,3,325060,325060,325063,0,3,0
92691,4,2,325064,325064,325066,0,2,1
92692,6,2,325070,325070,325072,0,2,4
92693,2,3,325072,325072,325075,0,3,0
92694,1,2,325073,325075,325077,2,4,0
92695,2,2,325075,325077,325079,2,4,0
92696,4,2,325079,325079,325081,0,2,0
92697,4,1,325083,325083,325084,0,1,2
92698,4,3,325087,325087,325090,0,3,3
92699,2,1,325089,325090,325091,1,2,0
92700,1,2,325090,325091,325093,1,3,0
92701,5,2,325095,325095,325097,0,2,2
92702,1,3,325096,325097,325100,1,4,0
92703,1,3,325097,325100,325103,3,6,0
92704,4,1,325101,325103,325104,2,3,0
92705,1,1,325102,325104,325105,2,3,0
92706,4,1,325106,325106,325107,0,1,1
92707,1,3,325107,325107,325110,0,3,0
92708,6,3,325113,325113,325116,0,3,3
92709,1,2,325114,325116,325118,2,4,0
92710,1,1,325115,325118,325119,3,4,0
92711,1,1,325116,325119,325120,3,4,0
92712,1,3,325117,325120,325123,3,6,0
92713,1,3,325118,325123,325126,5,8,0
92714,3,2,325121,325126,325128,5,7,0
92715,2,2,325123,325128,325130,5,7,0
92716,5,1,325128,325130,325131,2,3,0
92717,6,1,325134,325134,325135,0,1,3
92718,1,1,325135,325135,325136,0,1,0
92719,4,3,325139,325139,325142,0,3,3
92720,3,1,325142,325142,325143,0,1,0
92721,2,2,325144,325144,325146,0,2,1
92722,2,3,325146,325146,325149,0,3,0
92723,3,3,325149,325149,325152,0,3,0
92724,5,2,325154,325154,325156,0,2,2
92725,2,1,325156,325156,325157,0,1,0
92726,1,2,325157,325157,325159,0,2,0
92727,3,2,325160,325160,325162,0,2,1
92728,2,3,325162,325162,325165,0,3,0
92729,4,1,325166,325166,325167,0,1,1
92730,5,3,325171,325171,325174,0,3,4
92731,4,3,325175,325175,325178,0,3,1
92732,2,2,325177,325178,325180,1,3,0
92733,5,2,325182,325182,325184,0,2,2
92734,1,1,325183,325184,325185,1,2,0
92735,6,3,325189,325189,325192,0,3,4
92736,1,3,325190,325192,325195,2,5,0
92737,2,1,325192,325195,325196,3,4,0
92738,5,3,325197,325197,325200,0,3,1
92739,1,3,325198,325200,325203,2,5,0
92740,3,2,325201,325203,325205,2,4,0
92741,3,2,325204,325205,325207,1,3,0
92742,2,1,325206,325207,325208,1,2,0
92743,2,1,325208,325208,325209,0,1,0
92744,4,3,325212,325212,325215,0,3,3
92745,1,2,325213,325215,325217,2,4,0
92746,2,1,325215,325217,325218,2,3,0
92747,6,1,325221,325221,325222,0,1,3
92748,3,3,325224,325224,325227,0,3,2
92749,6,3,325230,325230,325233,0,3,3
92750,1,2,325231,325233,325235,2,4,0
92751,5,2,325236,325236,325238,0,2,1
92752,3,3,325239,325239,325242,0,3,1
92753,3,2,325242,325242,325244,0,2,0
92754,3,2,325245,325245,325247,0,2,1
92755,5,1,325250,325250,325251,0,1,3
92756,5,2,325255,325255,325257,0,2,4
92757,2,1,325257,325257,325258,0,1,0
92758,1,1,325258,325258,325259,0,1,0
92759,3,3,325261,325261,325264,0,3,2
92760,3,3,325264,325264,325267,0,3,0
92761,1,1,325265,325267,325268,2,3,0
92762,6,1,325271,325271,325272,0,1,3
92763,3,3,325274,325274,325277,0,3,2
92764,1,3,325275,325277,325280,2,5,0
92765,3,1,325278,325280,325281,2,3,0
92766,2,2,325280,325281,325283,1,3,0
92767,3,2,325283,325283,325285,0,2,0
92768,5,2,325288,325288,325290,0,2,3
92769,5,2,325293,325293,325295,0,2,3
92770,2,3,325295,325295,325298,0,3,0
92771,5,1,325300,325300,325301,0,1,2
92772,5,1,325305,325305,325306,0,1,4
92773,3,2,325308,325308,325310,0,2,2
92774,1,3,325309,325310,325313,1,4,0
92775,4,3,325313,325313,325316,0,3,0
92776,3,1,325316,325316,325317,0,1,0
92777,1,3,325317,325317,325320,0,3,0
92778,6,3,325323,325323,325326,0,3,3
92779,5,3,325328,325328,325331,0,3,2
92780,5,2,325333,325333,325335,0,2,2
92781,3,3,325336,325336,325339,0,3,1
92782,4,1,325340,325340,325341,0,1,1
92783,1,1,325341,325341,325342,0,1,0
92784,4,3,325345,325345,325348,0,3,3
92785,1,2,325346,325348,325350,2,4,0
92786,5,2,325351,325351,325353,0,2,1
92787,5,1,325356,325356,325357,0,1,3
92788,2,2,325358,325358,325360,0,2,1
92789,3,1,325361,325361,325362,0,1,1
92790,1,2,325362,325362,325364,0,2,0
92791,1,1,325363,325364,325365,1,2,0
92792,4,1,325367,325367,325368,0,1,2
92793,2,2,325369,325369,325371,0,2,1
92794,6,3,325375,325375,325378,0,3,4
92795,4,1,325379,325379,325380,0,1,1
92796,6,1,325385,325385,325386,0,1,5
92797,5,3,325390,325390,325393,0,3,4
92798,2,2,325392,325393,325395,1,3,0
92799,6,2,325398,325398,325400,0,2,3
92800,2,1,325400,325400,325401,0,1,0
92801,1,1,325401,325401,325402,0,1,0
92802,1,2,325402,325402,325404,0,2,0
92803,1,1,325403,325404,325405,1,2,0
92804,2,3,325405,325405,325408,0,3,0
92805,6,3,325411,325411,325414,0,3,3
92806,1,1,325412,325414,325415,2,3,0
92807,3,3,325415,325415,325418,0,3,0
92808,4,1,325419,325419,325420,0,1,1
92809,6,1,325425,325425,325426,0,1,5
92810,6,2,325431,325431,325433,0,2,5
92811,3,3,325434,325434,325437,0,3,1
92812,3,3,325437,325437,325440,0,3,0
92813,5,3,325442,325442,325445,0,3,2
92814,6,1,325448,325448,325449,0,1,3
92815,4,1,325452,325452,325453,0,1,3
92816,5,3,325457,325457,325460,0,3,4
92817,3,2,325460,325460,325462,0,2,0
92818,3,1,325463,325463,325464,0,1,1
92819,3,1,325466,325466,325467,0,1,2
92820,3,1,325469,325469,325470,0,1,2
92821,3,1,325472,325472,325473,0,1,2
92822,1,1,325473,325473,325474,0,1,0
92823,6,2,325479,325479,325481,0,2,5
92824,2,3,325481,325481,325484,0,3,0
92825,5,3,325486,325486,325489,0,3,2
92826,4,3,325490,325490,325493,0,3,1
92827,1,3,325491,325493,325496,2,5,0
92828,3,1,325494,325496,325497,2,3,0
92829,1,3,325495,325497,325500,2,5,0
92830,6,2,325501,325501,325503,0,2,1
92831,2,2,325503,325503,325505,0,2,0
92832,6,3,325509,325509,325512,0,3,4
92833,4,3,325513,325513,325516,0,3,1
92834,4,2,325517,325517,325519,0,2,1
92835,1,1,325518,325519,325520,1,2,0
92836,4,2,325522,325522,325524,0,2,2
92837,6,2,325528,325528,325530,0,2,4
92838,1,3,325529,325530,325533,1,4,0
92839,5,2,325534,325534,325536,0,2,1
92840,4,2,325538,325538,325540,0,2,2
92841,3,2,325541,325541,325543,0,2,1
92842,2,3,325543,325543,325546,0,3,0
92843,4,2,325547,325547,325549,0,2,1
92844,1,1,325548,325549,325550,1,2,0
92845,2,1,325550,325550,325551,0,1,0
92846,1,2,325551,325551,325553,0,2,0
92847,3,2,325554,325554,325556,0,2,1
92848,3,2,325557,325557,325559,0,2,1
92849,5,1,325562,325562,325563,0,1,3
92850,1,3,325563,325563,325566,0,3,0
92851,2,3,325565,325566,325569,1,4,0
92852,2,3,325567,325569,325572,2,5,0
92853,4,1,325571,325572,325573,1,2,0
92854,6,3,325577,325577,325580,0,3,4
92855,1,3,325578,325580,325583,2,5,0
92856,5,1,325583,325583,325584,0,1,0
92857,2,3,325585,325585,325588,0,3,1
92858,6,1,325591,325591,325592,0,1,3
92859,6,1,325597,325597,325598,0,1,5
92860,3,2,325600,325600,325602,0,2,2
92861,6,2,325606,325606,325608,0,2,4
92862,6,2,325612,325612,325614,0,2,4
92863,1,3,325613,325614,325617,1,4,0
92864,4,2,325617,325617,325619,0,2,0
92865,4,3,325621,325621,325624,0,3,2
92866,4,2,325625,325625,325627,0,2,1
92867,2,2,325627,325627,325629,0,2,0
92868,3,3,325630,325630,325633,0,3,1
92869,1,1,325631,325633,325634,2,3,0
92870,3,3,325634,325634,325637,0,3,0
92871,6,1,325640,325640,325641,0,1,3
92872,2,1,325642,325642,325643,0,1,1
92873,1,1,325643,325643,325644,0,1,0
92874,5,3,325648,325648,325651,0,3,4
92875,2,3,325650,325651,325654,1,4,0
92876,4,3,325654,325654,325657,0,3,0
92877,3,3,325657,325657,325660,0,3,0
92878,5,3,325662,325662,325665,0,3,2
92879,1,2,325663,325665,325667,2,4,0
92880,1,3,325664,325667,325670,3,6,0
92881,5,1,325669,325670,325671,1,2,0
92882,4,1,325673,325673,325674,0,1,2
92883,4,1,325677,325677,325678,0,1,3
92884,6,3,325683,325683,325686,0,3,5
92885,2,3,325685,325686,325689,1,4,0
92886,4,2,325689,325689,325691,0,2,0
92887,4,3,325693,325693,325696,0,3,2
92888,3,3,325696,325696,325699,0,3,0
92889,4,1,325700,325700,325701,0,1,1
92890,5,2,325705,325705,325707,0,2,4
92891,3,1,325708,325708,325709,0,1,1
92892,1,2,325709,325709,325711,0,2,0
92893,5,3,325714,325714,325717,0,3,3
92894,5,1,325719,325719,325720,0,1,2
92895,1,2,325720,325720,325722,0,2,0
92896,2,3,325722,325722,325725,0,3,0
92897,6,1,325728,325728,325729,0,1,3
92898,4,1,325732,325732,325733,0,1,3
92899,6,3,325738,325738,325741,0,3,5
92900,4,2,325742,325742,325744,0,2,1
92901,3,1,325745,325745,325746,0,1,1
92902,3,3,325748,325748,325751,0,3,2
92903,1,3,325749,325751,325754,2,5,0
92904,3,3,325752,325754,325757,2,5,0
92905,6,1,325758,325758,325759,0,1,1
92906,2,2,325760,325760,325762,0,2,1
92907,4,3,325764,325764,325767,0,3,2
92908,1,3,325765,325767,325770,2,5,0
92909,5,2,325770,325770,325772,0,2,0
92910,3,1,325773,325773,325774,0,1,1
92911,6,2,325779,325779,325781,0,2,5
92912,6,3,325785,325785,325788,0,3,4
92913,1,1,325786,325788,325789,2,3,0
92914,1,3,325787,325789,325792,2,5,0
92915,3,3,325790,325792,325795,2,5,0
92916,5,1,325795,325795,325796,0,1,0
92917,2,1,325797,325797,325798,0,1,1
92918,1,1,325798,325798,325799,0,1,0
92919,6,3,325804,325804,325807,0,3,5
92920,5,1,325809,325809,325810,0,1,2
92921,1,3,325810,325810,325813,0,3,0
92922,4,1,325814,325814,325815,0,1,1
92923,3,3,325817,325817,325820,0,3,2
92924,3,1,325820,325820,325821,0,1,0
92925,2,3,325822,325822,325825,0,3,1
92926,3,1,325825,325825,325826,0,1,0
92927,2,3,325827,325827,325830,0,3,1
92928,5,1,325832,325832,325833,0,1,2
92929,3,3,325835,325835,325838,0,3,2
92930,5,2,325840,325840,325842,0,2,2
92931,3,1,325843,325843,325844,0,1,1
92932,4,1,325847,325847,325848,0,1,3
92933,5,2,325852,325852,325854,0,2,4
92934,6,2,325858,325858,325860,0,2,4
92935,2,1,325860,325860,325861,0,1,0
92936,4,3,325864,325864,325867,0,3,3
92937,2,3,325866,325867,325870,1,4,0
92938,3,3,325869,325870,325873,1,4,0
92939,2,1,325871,325873,325874,2,3,0
92940,1,3,325872,325874,325877,2,5,0
92941,3,2,325875,325877,325879,2,4,0
92942,3,3,325878,325879,325882,1,4,0
92943,2,3,325880,325882,325885,2,5,0
92944,3,3,325883,325885,325888,2,5,0
92945,5,2,325888,325888,325890,0,2,0
92946,5,2,325893,325893,325895,0,2,3
92947,5,3,325898,325898,325901,0,3,3
92948,2,1,325900,325901,325902,1,2,0
92949,1,3,325901,325902,325905,1,4,0
92950,1,3,325902,325905,325908,3,6,0
92951,3,3,325905,325908,325911,3,6,0
92952,6,3,325911,325911,325914,0,3,0
92953,1,3,325912,325914,325917,2,5,0
92954,4,2,325916,325917,325919,1,3,0
92955,1,2,325917,325919,325921,2,4,0
92956,2,2,325919,325921,325923,2,4,0
92957,6,1,325925,325925,325926,0,1,2
92958,3,3,325928,325928,325931,0,3,2
92959,3,3,325931,325931,325934,0,3,0
92960,2,2,325933,325934,325936,1,3,0
92961,5,2,325938,325938,325940,0,2,2
92962,2,3,325940,325940,325943,0,3,0
92963,2,3,325942,325943,325946,1,4,0
92964,2,1,325944,325946,325947,2,3,0
92965,1,1,325945,325947,325948,2,3,0
92966,1,2,325946,325948,325950,2,4,0
92967,4,2,325950,325950,325952,0,2,0
92968,6,2,325956,325956,325958,0,2,4
92969,6,3,325962,325962,325965,0,3,4
92970,3,2,325965,325965,325967,0,2,0
92971,3,2,325968,325968,325970,0,2,1
92972,3,3,325971,325971,325974,0,3,1
92973,5,1,325976,325976,325977,0,1,2
92974,5,3,325981,325981,325984,0,3,4
92975,6,2,325987,325987,325989,0,2,3
92976,5,1,325992,325992,325993,0,1,3
92977,5,1,325997,325997,325998,0,1,4
92978,2,3,325999,325999,326002,0,3,1
92979,5,1,326004,326004,326005,0,1,2
92980,2,2,326006,326006,326008,0,2,1
92981,3,1,326009,326009,326010,0,1,1
92982,3,1,326012,326012,326013,0,1,2
92983,2,3,326014,326014,326017,0,3,1
92984,3,1,326017,326017,326018,0,1,0
92985,4,1,326021,326021,326022,0,1,3
92986,6,2,326027,326027,326029,0,2,5
92987,1,1,326028,326029,326030,1,2,0
92988,5,2,326033,326033,326035,0,2,3
92989,5,3,326038,326038,326041,0,3,3
92990,4,3,326042,326042,326045,0,3,1
92991,5,1,326047,326047,326048,0,1,2
92992,4,3,326051,326051,326054,0,3,3
92993,4,1,326055,326055,326056,0,1,1
92994,5,1,326060,326060,326061,0,1,4
92995,4,3,326064,326064,326067,0,3,3
92996,5,1,326069,326069,326070,0,1,2
92997,6,2,326075,326075,326077,0,2,5
92998,3,1,326078,326078,326079,0,1,1
92999,4,2,326082,326082,326084,0,2,3
93000,4,2,326086,326086,326088,0,2,2
93001,4,1,326090,326090,326091,0,1,2
93002,5,1,326095,326095,326096,0,1,4
93003,6,3,326101,326101,326104,0,3,5
93004,1,3,326102,326104,326107,2,5,0
93005,1,3,326103,326107,326110,4,7,0
93006,3,1,326106,326110,326111,4,5,0
93007,3,2,326109,326111,326113,2,4,0
93008,3,1,326112,326113,326114,1,2,0
93009,3,3,326115,326115,326118,0,3,1
93010,5,2,326120,326120,326122,0,2,2
93011,5,3,326125,326125,326128,0,3,3
93012,6,2,326131,326131,326133,0,2,3
93013,2,2,326133,326133,326135,0,2,0
93014,1,1,326134,326135,326136,1,2,0
93015,4,1,326138,326138,326139,0,1,2
93016,1,3,326139,326139,326142,0,3,0
93017,2,1,326141,326142,326143,1,2,0
93018,1,1,326142,326143,326144,1,2,0
93019,1,2,326143,326144,326146,1,3,0
93020,3,1,326146,326146,326147,0,1,0
93021,2,3,326148,326148,326151,0,3,1
93022,3,3,326151,326151,326154,0,3,0
93023,1,3,326152,326154,326157,2,5,0
93024,4,2,326156,326157,326159,1,3,0
93025,4,1,326160,326160,326161,0,1,1
93026,1,3,326161,326161,326164,0,3,0
93027,2,1,326163,326164,326165,1,2,0
93028,4,1,326167,326167,326168,0,1,2
93029,5,2,326172,326172,326174,0,2,4
93030,4,3,326176,326176,326179,0,3,2
93031,1,3,326177,326179,326182,2,5,0
93032,5,1,326182,326182,326183,0,1,0
93033,1,3,326183,326183,326186,0,3,0
93034,6,1,326189,326189,326190,0,1,3
93035,6,1,326195,326195,326196,0,1,5
93036,4,3,326199,326199,326202,0,3,3
93037,4,3,326203,326203,326206,0,3,1
93038,1,3,326204,326206,326209,2,5,0
93039,2,2,326206,326209,326211,3,5,0
93040,2,2,326208,326211,326213,3,5,0
93041,5,2,326213,326213,326215,0,2,0
93042,5,1,326218,326218,326219,0,1,3
93043,5,2,326223,326223,326225,0,2,4
93044,4,2,326227,326227,326229,0,2,2
93045,2,1,326229,326229,326230,0,1,0
93046,2,3,326231,326231,326234,0,3,1
93047,2,2,326233,326234,326236,1,3,0
93048,1,2,326234,326236,326238,2,4,0
93049,5,2,326239,326239,326241,0,2,1
93050,6,3,326245,326245,326248,0,3,4
93051,3,3,326248,326248,326251,0,3,0
93052,6,2,326254,326254,326256,0,2,3
93053,3,3,326257,326257,326260,0,3,1
93054,3,2,326260,326260,326262,0,2,0
93055,3,1,326263,326263,326264,0,1,1
93056,5,3,326268,326268,326271,0,3,4
93057,2,1,326270,326271,326272,1,2,0
93058,2,3,326272,326272,326275,0,3,0
93059,1,1,326273,326275,326276,2,3,0
93060,5,2,326278,326278,326280,0,2,2
93061,3,2,326281,326281,326283,0,2,1
93062,4,1,326285,326285,326286,0,1,2
93063,4,3,326289,326289,326292,0,3,3
93064,4,2,326293,326293,326295,0,2,1
93065,1,1,326294,326295,326296,1,2,0
93066,6,3,326300,326300,326303,0,3,4
93067,5,3,326305,326305,326308,0,3,2
93068,2,1,326307,326308,326309,1,2,0
93069,3,1,326310,326310,326311,0,1,1
93070,5,3,326315,326315,326318,0,3,4
93071,6,2,326321,326321,326323,0,2,3
93072,4,3,326325,326325,326328,0,3,2
93073,6,3,326331,326331,326334,0,3,3
93074,3,3,326334,326334,326337,0,3,0
93075,5,1,326339,326339,326340,0,1,2
93076,4,2,326343,326343,326345,0,2,3
93077,1,3,326344,326345,326348,1,4,0
93078,3,2,326347,326348,326350,1,3,0
93079,5,1,326352,326352,326353,0,1,2
93080,6,3,326358,326358,326361,0,3,5
93081,3,2,326361,326361,326363,0,2,0
93082,3,2,326364,326364,326366,0,2,1
93083,4,3,326368,326368,326371,0,3,2
93084,4,1,326372,326372,326373,0,1,1
93085,5,1,326377,326377,326378,0,1,4
93086,6,1,326383,326383,326384,0,1,5
93087,1,1,326384,326384,326385,0,1,0
93088,3,2,326387,326387,326389,0,2,2
93089,1,3,326388,326389,326392,1,4,0
93090,3,1,326391,326392,326393,1,2,0
93091,6,3,326397,326397,326400,0,3,4
93092,6,3,326403,326403,326406,0,3,3
93093,4,2,326407,326407,326409,0,2,1
93094,6,1,326413,326413,326414,0,1,4
93095,6,2,326419,326419,326421,0,2,5
93096,5,3,326424,326424,326427,0,3,3
93097,6,3,326430,326430,326433,0,3,3
93098,1,1,326431,326433,326434,2,3,0
93099,3,3,326434,326434,326437,0,3,0
93100,6,1,326440,326440,326441,0,1,3
93101,4,1,326444,326444,326445,0,1,3
93102,2,3,326446,326446,326449,0,3,1
93103,4,3,326450,326450,326453,0,3,1
93104,1,2,326451,326453,326455,2,4,0
93105,2,3,326453,326455,326458,2,5,0
93106,5,2,326458,326458,326460,0,2,0
93107,5,1,326463,326463,326464,0,1,3
93108,2,2,326465,326465,326467,0,2,1
93109,2,2,326467,326467,326469,0,2,0
93110,6,2,326473,326473,326475,0,2,4
93111,1,3,326474,326475,326478,1,4,0
93112,6,1,326480,326480,326481,0,1,2
93113,5,1,326485,326485,326486,0,1,4
93114,2,3,326487,326487,326490,0,3,1
93115,6,1,326493,326493,326494,0,1,3
93116,3,2,326496,326496,326498,0,2,2
93117,1,3,326497,326498,326501,1,4,0
93118,2,1,326499,326501,326502,2,3,0
93119,5,2,326504,326504,326506,0,2,2
93120,6,2,326510,326510,326512,0,2,4
93121,6,3,326516,326516,326519,0,3,4
93122,5,1,326521,326521,326522,0,1,2
93123,5,2,326526,326526,326528,0,2,4
93124,1,3,326527,326528,326531,1,4,0
93125,5,3,326532,326532,326535,0,3,1
93126,5,1,326537,326537,326538,0,1,2
93127,1,3,326538,326538,326541,0,3,0
93128,5,1,326543,326543,326544,0,1,2
93129,6,1,326549,326549,326550,0,1,5
93130,2,3,326551,326551,326554,0,3,1
93131,4,2,326555,326555,326557,0,2,1
93132,6,2,326561,326561,326563,0,2,4
93133,3,3,326564,326564,326567,0,3,1
93134,3,1,326567,326567,326568,0,1,0
93135,1,3,326568,326568,326571,0,3,0
93136,1,3,326569,326571,326574,2,5,0
93137,3,1,326572,326574,326575,2,3,0
93138,6,3,326578,326578,326581,0,3,3
93139,4,2,326582,326582,326584,0,2,1
93140,6,2,326588,326588,326590,0,2,4
93141,4,2,326592,326592,326594,0,2,2
93142,1,1,326593,326594,326595,1,2,0
93143,4,1,326597,326597,326598,0,1,2
93144,6,3,326603,326603,326606,0,3,5
93145,3,2,326606,326606,326608,0,2,0
93146,5,3,326611,326611,326614,0,3,3
93147,4,3,326615,326615,326618,0,3,1
93148,2,1,326617,326618,326619,1,2,0
93149,3,1,326620,326620,326621,0,1,1
93150,3,2,326623,326623,326625,0,2,2
93151,4,2,326627,326627,326629,0,2,2
93152,3,1,326630,326630,326631,0,1,1
93153,6,2,326636,326636,326638,0,2,5
93154,6,1,326642,326642,326643,0,1,4
93155,5,3,326647,326647,326650,0,3,4
93156,4,2,326651,326651,326653,0,2,1
93157,3,3,326654,326654,326657,0,3,1
93158,3,1,326657,326657,326658,0,1,0
93159,2,2,326659,326659,326661,0,2,1
93160,1,1,326660,326661,326662,1,2,0
93161,4,1,326664,326664,326665,0,1,2
93162,2,1,326666,326666,326667,0,1,1
93163,2,3,326668,326668,326671,0,3,1
93164,5,3,326673,326673,326676,0,3,2
93165,4,2,326677,326677,326679,0,2,1
93166,6,1,326683,326683,326684,0,1,4
93167,3,2,326686,326686,326688,0,2,2
93168,5,1,326691,326691,326692,0,1,3
93169,1,3,326692,326692,326695,0,3,0
93170,3,3,326695,326695,326698,0,3,0
93171,4,3,326699,326699,326702,0,3,1
93172,3,1,326702,326702,326703,0,1,0
93173,5,2,326707,326707,326709,0,2,4
93174,3,2,326710,326710,326712,0,2,1
93175,2,2,326712,326712,326714,0,2,0
93176,1,2,326713,326714,326716,1,3,0
93177,4,3,326717,326717,326720,0,3,1
93178,4,3,326721,326721,326724,0,3,1
93179,1,1,326722,326724,326725,2,3,0
93180,5,2,326727,326727,326729,0,2,2
93181,3,3,326730,326730,326733,0,3,1
93182,4,2,326734,326734,326736,0,2,1
93183,6,2,326740,326740,326742,0,2,4
93184,2,1,326742,326742,326743,0,1,0
93185,3,2,326745,326745,326747,0,2,2
93186,5,3,326750,326750,326753,0,3,3
93187,5,3,326755,326755,326758,0,3,2
93188,4,3,326759,326759,326762,0,3,1
93189,4,2,326763,326763,326765,0,2,1
93190,4,1,326767,326767,326768,0,1,2
93191,5,1,326772,326772,326773,0,1,4
93192,1,3,326773,326773,326776,0,3,0
93193,3,3,326776,326776,326779,0,3,0
93194,2,1,326778,326779,326780,1,2,0
93195,2,1,326780,326780,326781,0,1,0
93196,6,2,326786,326786,326788,0,2,5
93197,1,2,326787,326788,326790,1,3,0
93198,3,2,326790,326790,326792,0,2,0
93199,4,2,326794,326794,326796,0,2,2
93200,2,1,326796,326796,326797,0,1,0
93201,3,3,326799,326799,326802,0,3,2
93202,2,1,326801,326802,326803,1,2,0
93203,3,1,326804,326804,326805,0,1,1
93204,2,2,326806,326806,326808,0,2,1
93205,2,1,326808,326808,326809,0,1,0
93206,2,3,326810,326810,326813,0,3,1
93207,2,1,326812,326813,326814,1,2,0
93208,4,3,326816,326816,326819,0,3,2
93209,2,2,326818,326819,326821,1,3,0
93210,5,1,326823,326823,326824,0,1,2
93211,3,2,326826,326826,326828,0,2,2
93212,6,2,326832,326832,326834,0,2,4
93213,3,1,326835,326835,326836,0,1,1
93214,2,2,326837,326837,326839,0,2,1
93215,2,1,326839,326839,326840,0,1,0
93216,1,2,326840,326840,326842,0,2,0
93217,1,1,326841,326842,326843,1,2,0
93218,4,3,326845,326845,326848,0,3,2
93219,4,2,326849,326849,326851,0,2,1
93220,2,2,326851,326851,326853,0,2,0
93221,4,3,326855,326855,326858,0,3,2
93222,2,2,326857,326858,326860,1,3,0
93223,6,2,326863,326863,326865,0,2,3
93224,4,1,326867,326867,326868,0,1,2
93225,6,1,326873,326873,326874,0,1,5
93226,2,2,326875,326875,326877,0,2,1
93227,3,2,326878,326878,326880,0,2,1
93228,5,1,326883,326883,326884,0,1,3
93229,6,2,326889,326889,326891,0,2,5
93230,3,3,326892,326892,326895,0,3,1
93231,1,1,326893,326895,326896,2,3,0
93232,1,1,326894,326896,326897,2,3,0
93233,1,1,326895,326897,326898,2,3,0
93234,6,1,326901,326901,326902,0,1,3
93235,2,1,326903,326903,326904,0,1,1
93236,2,1,326905,326905,326906,0,1,1
93237,1,1,326906,326906,326907,0,1,0
93238,1,2,326907,326907,326909,0,2,0
93239,3,2,326910,326910,326912,0,2,1
93240,1,1,326911,326912,326913,1,2,0
93241,2,2,326913,326913,326915,0,2,0
93242,6,1,326919,326919,326920,0,1,4
93243,5,3,326924,326924,326927,0,3,4
93244,1,1,326925,326927,326928,2,3,0
93245,5,3,326930,326930,326933,0,3,2
93246,5,1,326935,326935,326936,0,1,2
93247,6,1,326941,326941,326942,0,1,5
93248,2,3,326943,326943,326946,0,3,1
93249,1,2,326944,326946,326948,2,4,0
93250,4,1,326948,326948,326949,0,1,0
93251,5,1,326953,326953,326954,0,1,4
93252,4,2,326957,326957,326959,0,2,3
93253,2,2,326959,326959,326961,0,2,0
93254,6,2,326965,326965,326967,0,2,4
93255,4,2,326969,326969,326971,0,2,2
93256,6,3,326975,326975,326978,0,3,4
93257,5,2,326980,326980,326982,0,2,2
93258,4,3,326984,326984,326987,0,3,2
93259,4,2,326988,326988,326990,0,2,1
93260,6,2,326994,326994,326996,0,2,4
93261,4,2,326998,326998,327000,0,2,2
93262,5,1,327003,327003,327004,0,1,3
93263,4,1,327007,327007,327008,0,1,3
93264,3,3,327010,327010,327013,0,3,2
93265,5,3,327015,327015,327018,0,3,2
93266,3,2,327018,327018,327020,0,2,0
93267,4,2,327022,327022,327024,0,2,2
93268,5,2,327027,327027,327029,0,2,3
93269,1,2,327028,327029,327031,1,3,0
93270,1,1,327029,327031,327032,2,3,0
93271,1,2,327030,327032,327034,2,4,0
93272,3,1,327033,327034,327035,1,2,0
93273,6,2,327039,327039,327041,0,2,4
93274,2,3,327041,327041,327044,0,3,0
93275,4,3,327045,327045,327048,0,3,1
93276,1,3,327046,327048,327051,2,5,0
93277,4,2,327050,327051,327053,1,3,0
93278,4,2,327054,327054,327056,0,2,1
93279,3,2,327057,327057,327059,0,2,1
93280,6,3,327063,327063,327066,0,3,4
93281,4,3,327067,327067,327070,0,3,1
93282,5,1,327072,327072,327073,0,1,2
93283,3,3,327075,327075,327078,0,3,2
93284,4,2,327079,327079,327081,0,2,1
93285,4,2,327083,327083,327085,0,2,2
93286,6,2,327089,327089,327091,0,2,4
93287,6,2,327095,327095,327097,0,2,4
93288,6,3,327101,327101,327104,0,3,4
93289,3,2,327104,327104,327106,0,2,0
93290,4,2,327108,327108,327110,0,2,2
93291,5,3,327113,327113,327116,0,3,3
93292,6,3,327119,327119,327122,0,3,3
93293,3,3,327122,327122,327125,0,3,0
93294,2,3,327124,327125,327128,1,4,0
93295,2,1,327126,327128,327129,2,3,0
93296,1,3,327127,327129,327132,2,5,0
93297,5,3,327132,327132,327135,0,3,0
93298,4,3,327136,327136,327139,0,3,1
93299,5,3,327141,327141,327144,0,3,2
93300,5,3,327146,327146,327149,0,3,2
93301,1,2,327147,327149,327151,2,4,0
93302,2,1,327149,327151,327152,2,3,0
93303,6,3,327155,327155,327158,0,3,3
93304,3,2,327158,327158,327160,0,2,0
93305,4,3,327162,327162,327165,0,3,2
93306,1,3,327163,327165,327168,2,5,0
93307,4,2,327167,327168,327170,1,3,0
93308,4,1,327171,327171,327172,0,1,1
93309,1,3,327172,327172,327175,0,3,0
93310,3,1,327175,327175,327176,0,1,0
93311,2,3,327177,327177,327180,0,3,1
93312,6,3,327183,327183,327186,0,3,3
93313,6,1,327189,327189,327190,0,1,3
93314,4,3,327193,327193,327196,0,3,3
93315,2,3,327195,327196,327199,1,4,0
93316,4,3,327199,327199,327202,0,3,0
93317,1,1,327200,327202,327203,2,3,0
93318,4,2,327204,327204,327206,0,2,1
93319,1,3,327205,327206,327209,1,4,0
93320,3,3,327208,327209,327212,1,4,0
93321,4,1,327212,327212,327213,0,1,0
93322,2,2,327214,327214,327216,0,2,1
93323,5,3,327219,327219,327222,0,3,3
93324,6,1,327225,327225,327226,0,1,3
93325,1,1,327226,327226,327227,0,1,0
93326,4,3,327230,327230,327233,0,3,3
93327,5,2,327235,327235,327237,0,2,2
93328,2,3,327237,327237,327240,0,3,0
93329,1,2,327238,327240,327242,2,4,0
93330,4,1,327242,327242,327243,0,1,0
93331,5,3,327247,327247,327250,0,3,4
93332,1,3,327248,327250,327253,2,5,0
93333,5,3,327253,327253,327256,0,3,0
93334,2,3,327255,327256,327259,1,4,0
93335,4,3,327259,327259,327262,0,3,0
93336,4,3,327263,327263,327266,0,3,1
93337,2,1,327265,327266,327267,1,2,0
93338,1,2,327266,327267,327269,1,3,0
93339,4,3,327270,327270,327273,0,3,1
93340,1,2,327271,327273,327275,2,4,0
93341,3,3,327274,327275,327278,1,4,0
93342,4,3,327278,327278,327281,0,3,0
93343,4,3,327282,327282,327285,0,3,1
93344,4,3,327286,327286,327289,0,3,1
93345,4,1,327290,327290,327291,0,1,1
93346,3,2,327293,327293,327295,0,2,2
93347,1,3,327294,327295,327298,1,4,0
93348,1,1,327295,327298,327299,3,4,0
93349,1,2,327296,327299,327301,3,5,0
93350,3,3,327299,327301,327304,2,5,0
93351,4,2,327303,327304,327306,1,3,0
93352,1,1,327304,327306,327307,2,3,0
93353,3,1,327307,327307,327308,0,1,0
93354,1,2,327308,327308,327310,0,2,0
93355,2,2,327310,327310,327312,0,2,0
93356,5,1,327315,327315,327316,0,1,3
93357,1,2,327316,327316,327318,0,2,0
93358,3,3,327319,327319,327322,0,3,1
93359,3,1,327322,327322,327323,0,1,0
93360,1,1,327323,327323,327324,0,1,0
93361,5,3,327328,327328,327331,0,3,4
93362,4,2,327332,327332,327334,0,2,1
93363,3,3,327335,327335,327338,0,3,1
93364,4,3,327339,327339,327342,0,3,1
93365,6,3,327345,327345,327348,0,3,3
93366,5,1,327350,327350,327351,0,1,2
93367,5,3,327355,327355,327358,0,3,4
93368,3,3,327358,327358,327361,0,3,0
93369,5,2,327363,327363,327365,0,2,2
93370,3,2,327366,327366,327368,0,2,1
93371,3,1,327369,327369,327370,0,1,1
93372,4,1,327373,327373,327374,0,1,3
93373,5,2,327378,327378,327380,0,2,4
93374,5,1,327383,327383,327384,0,1,3
93375,2,3,327385,327385,327388,0,3,1
93376,5,3,327390,327390,327393,0,3,2
93377,5,3,327395,327395,327398,0,3,2
93378,2,1,327397,327398,327399,1,2,0
93379,4,1,327401,327401,327402,0,1,2
93380,6,1,327407,327407,327408,0,1,5
93381,3,2,327410,327410,327412,0,2,2
93382,3,3,327413,327413,327416,0,3,1
93383,4,1,327417,327417,327418,0,1,1
93384,3,3,327420,327420,327423,0,3,2
93385,6,1,327426,327426,327427,0,1,3
93386,5,3,327431,327431,327434,0,3,4
93387,3,3,327434,327434,327437,0,3,0
93388,5,1,327439,327439,327440,0,1,2
93389,1,2,327440,327440,327442,0,2,0
93390,3,1,327443,327443,327444,0,1,1
93391,3,1,327446,327446,327447,0,1,2
93392,2,3,327448,327448,327451,0,3,1
93393,2,3,327450,327451,327454,1,4,0
93394,1,1,327451,327454,327455,3,4,0
93395,2,2,327453,327455,327457,2,4,0
93396,4,2,327457,327457,327459,0,2,0
93397,5,2,327462,327462,327464,0,2,3
93398,1,2,327463,327464,327466,1,3,0
93399,6,2,327469,327469,327471,0,2,3
93400,3,2,327472,327472,327474,0,2,1
93401,3,3,327475,327475,327478,0,3,1
93402,4,2,327479,327479,327481,0,2,1
93403,2,3,327481,327481,327484,0,3,0
93404,6,3,327487,327487,327490,0,3,3
93405,3,3,327490,327490,327493,0,3,0
93406,5,2,327495,327495,327497,0,2,2
93407,6,1,327501,327501,327502,0,1,4
93408,3,3,327504,327504,327507,0,3,2
93409,5,1,327509,327509,327510,0,1,2
93410,1,2,327510,327510,327512,0,2,0
93411,5,3,327515,327515,327518,0,3,3
93412,1,1,327516,327518,327519,2,3,0
93413,6,3,327522,327522,327525,0,3,3
93414,2,2,327524,327525,327527,1,3,0
93415,4,2,327528,327528,327530,0,2,1
93416,3,2,327531,327531,327533,0,2,1
93417,2,1,327533,327533,327534,0,1,0
93418,2,3,327535,327535,327538,0,3,1
93419,6,2,327541,327541,327543,0,2,3
93420,2,2,327543,327543,327545,0,2,0
93421,2,3,327545,327545,327548,0,3,0
93422,3,2,327548,327548,327550,0,2,0
93423,3,1,327551,327551,327552,0,1,1
93424,3,3,327554,327554,327557,0,3,2
93425,5,2,327559,327559,327561,0,2,2
93426,4,3,327563,327563,327566,0,3,2
93427,1,3,327564,327566,327569,2,5,0
93428,1,3,327565,327569,327572,4,7,0
93429,1,1,327566,327572,327573,6,7,0
93430,1,2,327567,327573,327575,6,8,0
93431,1,1,327568,327575,327576,7,8,0
93432,6,3,327574,327576,327579,2,5,0
93433,2,3,327576,327579,327582,3,6,0
93434,5,3,327581,327582,327585,1,4,0
93435,1,3,327582,327585,327588,3,6,0
93436,6,2,327588,327588,327590,0,2,0
93437,6,3,327594,327594,327597,0,3,4
93438,1,2,327595,327597,327599,2,4,0
93439,1,3,327596,327599,327602,3,6,0
93440,4,1,327600,327602,327603,2,3,0
93441,6,1,327606,327606,327607,0,1,3
93442,5,1,327611,327611,327612,0,1,4
93443,3,3,327614,327614,327617,0,3,2
93444,4,1,327618,327618,327619,0,1,1
93445,3,1,327621,327621,327622,0,1,2
93446,5,1,327626,327626,327627,0,1,4
93447,4,2,327630,327630,327632,0,2,3
93448,4,3,327634,327634,327637,0,3,2
93449,4,2,327638,327638,327640,0,2,1
93450,4,1,327642,327642,327643,0,1,2
93451,5,1,327647,327647,327648,0,1,4
93452,5,3,327652,327652,327655,0,3,4
93453,4,1,327656,327656,327657,0,1,1
93454,6,1,327662,327662,327663,0,1,5
93455,6,3,327668,327668,327671,0,3,5
93456,2,3,327670,327671,327674,1,4,0
93457,4,3,327674,327674,327677,0,3,0
93458,5,1,327679,327679,327680,0,1,2
93459,6,2,327685,327685,327687,0,2,5
93460,2,1,327687,327687,327688,0,1,0
93461,6,3,327693,327693,327696,0,3,5
93462,5,2,327698,327698,327700,0,2,2
93463,4,3,327702,327702,327705,0,3,2
93464,2,1,327704,327705,327706,1,2,0
93465,5,1,327709,327709,327710,0,1,3
93466,2,2,327711,327711,327713,0,2,1
93467,4,1,327715,327715,327716,0,1,2
93468,6,1,327721,327721,327722,0,1,5
93469,4,2,327725,327725,327727,0,2,3
93470,5,3,327730,327730,327733,0,3,3
93471,4,2,327734,327734,327736,0,2,1
93472,5,2,327739,327739,327741,0,2,3
93473,6,1,327745,327745,327746,0,1,4
93474,1,3,327746,327746,327749,0,3,0
93475,3,3,327749,327749,327752,0,3,0
93476,4,2,327753,327753,327755,0,2,1
93477,3,3,327756,327756,327759,0,3,1
93478,5,2,327761,327761,327763,0,2,2
93479,4,1,327765,327765,327766,0,1,2
93480,4,2,327769,327769,327771,0,2,3
93481,2,2,327771,327771,327773,0,2,0
93482,2,1,327773,327773,327774,0,1,0
93483,6,3,327779,327779,327782,0,3,5
93484,5,1,327784,327784,327785,0,1,2
93485,1,2,327785,327785,327787,0,2,0
93486,6,1,327791,327791,327792,0,1,4
93487,4,1,327795,327795,327796,0,1,3
93488,1,1,327796,327796,327797,0,1,0
93489,6,3,327802,327802,327805,0,3,5
93490,2,3,327804,327805,327808,1,4,0
93491,1,3,327805,327808,327811,3,6,0
93492,2,3,327807,327811,327814,4,7,0
93493,3,3,327810,327814,327817,4,7,0
93494,6,2,327816,327817,327819,1,3,0
93495,5,2,327821,327821,327823,0,2,2
93496,6,2,327827,327827,327829,0,2,4
93497,1,3,327828,327829,327832,1,4,0
93498,5,2,327833,327833,327835,0,2,1
93499,6,3,327839,327839,327842,0,3,4
93500,2,3,327841,327842,327845,1,4,0
93501,6,2,327847,327847,327849,0,2,2
93502,3,1,327850,327850,327851,0,1,1
93503,3,1,327853,327853,327854,0,1,2
93504,4,2,327857,327857,327859,0,2,3
93505,3,1,327860,327860,327861,0,1,1
93506,5,1,327865,327865,327866,0,1,4
93507,6,1,327871,327871,327872,0,1,5
93508,3,1,327874,327874,327875,0,1,2
93509,2,2,327876,327876,327878,0,2,1
93510,2,2,327878,327878,327880,0,2,0
93511,3,1,327881,327881,327882,0,1,1
93512,2,1,327883,327883,327884,0,1,1
93513,2,1,327885,327885,327886,0,1,1
93514,4,2,327889,327889,327891,0,2,3
93515,3,1,327892,327892,327893,0,1,1
93516,3,3,327895,327895,327898,0,3,2
93517,6,3,327901,327901,327904,0,3,3
93518,1,3,327902,327904,327907,2,5,0
93519,6,1,327908,327908,327909,0,1,1
93520,2,1,327910,327910,327911,0,1,1
93521,6,3,327916,327916,327919,0,3,5
93522,4,1,327920,327920,327921,0,1,1
93523,1,2,327921,327921,327923,0,2,0
93524,1,3,327922,327923,327926,1,4,0
93525,3,1,327925,327926,327927,1,2,0
93526,4,2,327929,327929,327931,0,2,2
93527,3,1,327932,327932,327933,0,1,1
93528,6,2,327938,327938,327940,0,2,5
93529,3,3,327941,327941,327944,0,3,1
93530,2,3,327943,327944,327947,1,4,0
93531,1,2,327944,327947,327949,3,5,0
93532,5,1,327949,327949,327950,0,1,0
93533,5,1,327954,327954,327955,0,1,4
93534,1,1,327955,327955,327956,0,1,0
93535,4,1,327959,327959,327960,0,1,3
93536,5,2,327964,327964,327966,0,2,4
93537,3,2,327967,327967,327969,0,2,1
93538,3,3,327970,327970,327973,0,3,1
93539,3,3,327973,327973,327976,0,3,0
93540,6,3,327979,327979,327982,0,3,3
93541,1,1,327980,327982,327983,2,3,0
93542,6,2,327986,327986,327988,0,2,3
93543,3,3,327989,327989,327992,0,3,1
93544,5,1,327994,327994,327995,0,1,2
93545,4,3,327998,327998,328001,0,3,3
93546,3,1,328001,328001,328002,0,1,0
93547,4,3,328005,328005,328008,0,3,3
93548,2,3,328007,328008,328011,1,4,0
93549,5,2,328012,328012,328014,0,2,1
93550,6,1,328018,328018,328019,0,1,4
93551,3,2,328021,328021,328023,0,2,2
93552,2,2,328023,328023,328025,0,2,0
93553,2,1,328025,328025,328026,0,1,0
93554,2,3,328027,328027,328030,0,3,1
93555,5,2,328032,328032,328034,0,2,2
93556,5,1,328037,328037,328038,0,1,3
93557,5,2,328042,328042,328044,0,2,4
93558,3,1,328045,328045,328046,0,1,1
93559,1,1,328046,328046,328047,0,1,0
93560,5,2,328051,328051,328053,0,2,4
93561,2,3,328053,328053,328056,0,3,0
93562,5,3,328058,328058,328061,0,3,2
93563,1,1,328059,328061,328062,2,3,0
93564,5,1,328064,328064,328065,0,1,2
93565,2,2,328066,328066,328068,0,2,1
93566,1,1,328067,328068,328069,1,2,0
93567,3,3,328070,328070,328073,0,3,1
93568,3,3,328073,328073,328076,0,3,0
93569,2,3,328075,328076,328079,1,4,0
93570,3,2,328078,328079,328081,1,3,0
93571,6,2,328084,328084,328086,0,2,3
93572,1,2,328085,328086,328088,1,3,0
93573,3,2,328088,328088,328090,0,2,0
93574,2,3,328090,328090,328093,0,3,0
93575,1,1,328091,328093,328094,2,3,0
93576,1,3,328092,328094,328097,2,5,0
93577,6,3,328098,328098,328101,0,3,1
93578,3,1,328101,328101,328102,0,1,0
93579,6,2,328107,328107,328109,0,2,5
93580,2,2,328109,328109,328111,0,2,0
93581,5,1,328114,328114,328115,0,1,3
93582,1,3,328115,328115,328118,0,3,0
93583,2,1,328117,328118,328119,1,2,0
93584,6,1,328123,328123,328124,0,1,4
93585,3,1,328126,328126,328127,0,1,2
93586,5,2,328131,328131,328133,0,2,4
93587,3,3,328134,328134,328137,0,3,1
93588,2,3,328136,328137,328140,1,4,0
93589,2,2,328138,328140,328142,2,4,0
93590,2,3,328140,328142,328145,2,5,0
93591,2,3,328142,328145,328148,3,6,0
93592,3,1,328145,328148,328149,3,4,0
93593,3,1,328148,328149,328150,1,2,0
93594,2,1,328150,328150,328151,0,1,0
93595,1,1,328151,328151,328152,0,1,0
93596,3,2,328154,328154,328156,0,2,2
93597,6,2,328160,328160,328162,0,2,4
93598,3,1,328163,328163,328164,0,1,1
93599,5,3,328168,328168,328171,0,3,4
93600,1,3,328169,328171,328174,2,5,0
93601,6,2,328175,328175,328177,0,2,1
93602,3,1,328178,328178,328179,0,1,1
93603,3,1,328181,328181,328182,0,1,2
93604,1,1,328182,328182,328183,0,1,0
93605,1,1,328183,328183,328184,0,1,0
93606,3,1,328186,328186,328187,0,1,2
93607,6,3,328192,328192,328195,0,3,5
93608,3,1,328195,328195,328196,0,1,0
93609,1,2,328196,328196,328198,0,2,0
93610,1,1,328197,328198,328199,1,2,0
93611,2,2,328199,328199,328201,0,2,0
93612,3,2,328202,328202,328204,0,2,1
93613,5,2,328207,328207,328209,0,2,3
93614,2,2,328209,328209,328211,0,2,0
93615,6,3,328215,328215,328218,0,3,4
93616,4,2,328219,328219,328221,0,2,1
93617,6,2,328225,328225,328227,0,2,4
93618,1,3,328226,328227,328230,1,4,0
93619,4,2,328230,328230,328232,0,2,0
93620,5,3,328235,328235,328238,0,3,3
93621,4,2,328239,328239,328241,0,2,1
93622,3,2,328242,328242,328244,0,2,1
93623,6,2,328248,328248,328250,0,2,4
93624,5,2,328253,328253,328255,0,2,3
93625,2,2,328255,328255,328257,0,2,0
93626,6,2,328261,328261,328263,0,2,4
93627,4,3,328265,328265,328268,0,3,2
93628,6,1,328271,328271,328272,0,1,3
93629,1,1,328272,328272,328273,0,1,0
93630,6,1,328278,328278,328279,0,1,5
93631,5,3,328283,328283,328286,0,3,4
93632,4,1,328287,328287,328288,0,1,1
93633,2,1,328289,328289,328290,0,1,1
93634,5,2,328294,328294,328296,0,2,4
93635,4,3,328298,328298,328301,0,3,2
93636,4,2,328302,328302,328304,0,2,1
93637,3,1,328305,328305,328306,0,1,1
93638,2,3,328307,328307,328310,0,3,1
93639,1,1,328308,328310,328311,2,3,0
93640,2,2,328310,328311,328313,1,3,0
93641,3,1,328313,328313,328314,0,1,0
93642,1,2,328314,328314,328316,0,2,0
93643,3,1,328317,328317,328318,0,1,1
93644,4,2,328321,328321,328323,0,2,3
93645,2,3,328323,328323,328326,0,3,0
93646,4,2,328327,328327,328329,0,2,1
93647,1,1,328328,328329,328330,1,2,0
93648,6,1,328334,328334,328335,0,1,4
93649,2,1,328336,328336,328337,0,1,1
93650,5,1,328341,328341,328342,0,1,4
93651,6,1,328347,328347,328348,0,1,5
93652,2,1,328349,328349,328350,0,1,1
93653,1,2,328350,328350,328352,0,2,0
93654,5,1,328355,328355,328356,0,1,3
93655,2,2,328357,328357,328359,0,2,1
93656,2,3,328359,328359,328362,0,3,0
93657,4,3,328363,328363,328366,0,3,1
93658,1,3,328364,328366,328369,2,5,0
93659,5,2,328369,328369,328371,0,2,0
93660,3,3,328372,328372,328375,0,3,1
93661,4,1,328376,328376,328377,0,1,1
93662,6,3,328382,328382,328385,0,3,5
93663,2,2,328384,328385,328387,1,3,0
93664,1,2,328385,328387,328389,2,4,0
93665,2,3,328387,328389,328392,2,5,0
93666,5,1,328392,328392,328393,0,1,0
93667,6,3,328398,328398,328401,0,3,5
93668,2,3,328400,328401,328404,1,4,0
93669,5,1,328405,328405,328406,0,1,1
93670,2,2,328407,328407,328409,0,2,1
93671,4,2,328411,328411,328413,0,2,2
93672,4,2,328415,328415,328417,0,2,2
93673,3,3,328418,328418,328421,0,3,1
93674,4,1,328422,328422,328423,0,1,1
93675,3,1,328425,328425,328426,0,1,2
93676,1,2,328426,328426,328428,0,2,0
93677,1,2,328427,328428,328430,1,3,0
93678,1,3,328428,328430,328433,2,5,0
93679,5,2,328433,328433,328435,0,2,0
93680,2,2,328435,328435,328437,0,2,0
93681,3,1,328438,328438,328439,0,1,1
93682,3,3,328441,328441,328444,0,3,2
93683,1,3,328442,328444,328447,2,5,0
93684,2,3,328444,328447,328450,3,6,0
93685,2,2,328446,328450,328452,4,6,0
93686,6,1,328452,328452,328453,0,1,0
93687,6,3,328458,328458,328461,0,3,5
93688,6,1,328464,328464,328465,0,1,3
93689,5,2,328469,328469,328471,0,2,4
93690,5,2,328474,328474,328476,0,2,3
93691,2,2,328476,328476,328478,0,2,0
93692,2,1,328478,328478,328479,0,1,0
93693,6,3,328484,328484,328487,0,3,5
93694,4,1,328488,328488,328489,0,1,1
93695,6,1,328494,328494,328495,0,1,5
93696,5,2,328499,328499,328501,0,2,4
93697,4,2,328503,328503,328505,0,2,2
93698,5,1,328508,328508,328509,0,1,3
93699,2,2,328510,328510,328512,0,2,1
93700,5,1,328515,328515,328516,0,1,3
93701,2,1,328517,328517,328518,0,1,1
93702,5,1,328522,328522,328523,0,1,4
93703,5,3,328527,328527,328530,0,3,4
93704,2,1,328529,328530,328531,1,2,0
93705,1,2,328530,328531,328533,1,3,0
93706,5,1,328535,328535,328536,0,1,2
93707,3,2,328538,328538,328540,0,2,2
93708,4,2,328542,328542,328544,0,2,2
93709,3,1,328545,328545,328546,0,1,1
93710,2,2,328547,328547,328549,0,2,1
93711,4,3,328551,328551,328554,0,3,2
93712,6,2,328557,328557,328559,0,2,3
93713,2,1,328559,328559,328560,0,1,0
93714,2,1,328561,328561,328562,0,1,1
93715,3,1,328564,328564,328565,0,1,2
93716,4,1,328568,328568,328569,0,1,3
93717,3,3,328571,328571,328574,0,3,2
93718,3,1,328574,328574,328575,0,1,0
93719,1,2,328575,328575,328577,0,2,0
93720,2,3,328577,328577,328580,0,3,0
93721,2,1,328579,328580,328581,1,2,0
93722,6,3,328585,328585,328588,0,3,4
93723,2,2,328587,328588,328590,1,3,0
93724,4,2,328591,328591,328593,0,2,1
93725,5,3,328596,328596,328599,0,3,3
93726,1,1,328597,328599,328600,2,3,0
93727,4,3,328601,328601,328604,0,3,1
93728,1,3,328602,328604,328607,2,5,0
93729,2,2,328604,328607,328609,3,5,0
93730,4,3,328608,328609,328612,1,4,0
93731,6,3,328614,328614,328617,0,3,2
93732,6,3,328620,328620,328623,0,3,3
93733,3,1,328623,328623,328624,0,1,0
93734,6,2,328629,328629,328631,0,2,5
93735,5,2,328634,328634,328636,0,2,3
93736,4,1,328638,328638,328639,0,1,2
93737,4,2,328642,328642,328644,0,2,3
93738,1,2,328643,328644,328646,1,3,0
93739,1,3,328644,328646,328649,2,5,0
93740,6,3,328650,328650,328653,0,3,1
93741,6,2,328656,328656,328658,0,2,3
93742,6,3,328662,328662,328665,0,3,4
93743,5,1,328667,328667,328668,0,1,2
93744,6,3,328673,328673,328676,0,3,5
93745,3,2,328676,328676,328678,0,2,0
93746,2,1,328678,328678,328679,0,1,0
93747,4,3,328682,328682,328685,0,3,3
93748,5,2,328687,328687,328689,0,2,2
93749,3,1,328690,328690,328691,0,1,1
93750,4,1,328694,328694,328695,0,1,3
93751,3,2,328697,328697,328699,0,2,2
93752,4,1,328701,328701,328702,0,1,2
93753,5,2,328706,328706,328708,0,2,4
93754,1,1,328707,328708,328709,1,2,0
93755,1,2,328708,328709,328711,1,3,0
93756,1,2,328709,328711,328713,2,4,0
93757,3,1,328712,328713,328714,1,2,0
93758,4,1,328716,328716,328717,0,1,2
93759,6,2,328722,328722,328724,0,2,5
93760,2,3,328724,328724,328727,0,3,0
93761,5,3,328729,328729,328732,0,3,2
93762,2,1,328731,328732,328733,1,2,0
93763,5,1,328736,328736,328737,0,1,3
93764,2,2,328738,328738,328740,0,2,1
93765,1,3,328739,328740,328743,1,4,0
93766,5,3,328744,328744,328747,0,3,1
93767,4,2,328748,328748,328750,0,2,1
93768,2,1,328750,328750,328751,0,1,0
93769,1,1,328751,328751,328752,0,1,0
93770,2,2,328753,328753,328755,0,2,1
93771,1,1,328754,328755,328756,1,2,0
93772,1,1,328755,328756,328757,1,2,0
93773,3,2,328758,328758,328760,0,2,1
93774,2,1,328760,328760,328761,0,1,0
93775,4,3,328764,328764,328767,0,3,3
93776,5,1,328769,328769,328770,0,1,2
93777,3,2,328772,328772,328774,0,2,2
93778,4,2,328776,328776,328778,0,2,2
93779,2,1,328778,328778,328779,0,1,0
93780,3,1,328781,328781,328782,0,1,2
93781,5,2,328786,328786,328788,0,2,4
93782,3,3,328789,328789,328792,0,3,1
93783,2,1,328791,328792,328793,1,2,0
93784,3,1,328794,328794,328795,0,1,1
93785,2,1,328796,328796,328797,0,1,1
93786,6,2,328802,328802,328804,0,2,5
93787,1,2,328803,328804,328806,1,3,0
93788,4,1,328807,328807,328808,0,1,1
93789,2,2,328809,328809,328811,0,2,1
93790,1,1,328810,328811,328812,1,2,0
93791,2,1,328812,328812,328813,0,1,0
93792,2,2,328814,328814,328816,0,2,1
93793,6,1,328820,328820,328821,0,1,4
93794,1,2,328821,328821,328823,0,2,0
93795,5,2,328826,328826,328828,0,2,3
93796,3,3,328829,328829,328832,0,3,1
93797,2,2,328831,328832,328834,1,3,0
93798,4,3,328835,328835,328838,0,3,1
93799,3,2,328838,328838,328840,0,2,0
93800,1,3,328839,328840,328843,1,4,0
93801,5,1,328844,328844,328845,0,1,1
93802,2,1,328846,328846,328847,0,1,1
93803,1,1,328847,328847,328848,0,1,0
93804,1,3,328848,328848,328851,0,3,0
93805,2,2,328850,328851,328853,1,3,0
93806,3,3,328853,328853,328856,0,3,0
93807,4,1,328857,328857,328858,0,1,1
93808,5,1,328862,328862,328863,0,1,4
93809,3,3,328865,328865,328868,0,3,2
93810,3,2,328868,328868,328870,0,2,0
93811,6,3,328874,328874,328877,0,3,4
93812,6,1,328880,328880,328881,0,1,3
93813,6,1,328886,328886,328887,0,1,5
93814,6,1,328892,328892,328893,0,1,5
93815,1,3,328893,328893,328896,0,3,0
93816,5,1,328898,328898,328899,0,1,2
93817,6,3,328904,328904,328907,0,3,5
93818,6,1,328910,328910,328911,0,1,3
93819,6,1,328916,328916,328917,0,1,5
93820,5,1,328921,328921,328922,0,1,4
93821,4,2,328925,328925,328927,0,2,3
93822,3,3,328928,328928,328931,0,3,1
93823,6,2,328934,328934,328936,0,2,3
93824,5,3,328939,328939,328942,0,3,3
93825,6,3,328945,328945,328948,0,3,3
93826,1,3,328946,328948,328951,2,5,0
93827,6,3,328952,328952,328955,0,3,1
93828,1,1,328953,328955,328956,2,3,0
93829,6,2,328959,328959,328961,0,2,3
93830,2,3,328961,328961,328964,0,3,0
93831,1,3,328962,328964,328967,2,5,0
93832,4,3,328966,328967,328970,1,4,0
93833,4,1,328970,328970,328971,0,1,0
93834,6,2,328976,328976,328978,0,2,5
93835,1,1,328977,328978,328979,1,2,0
93836,4,2,328981,328981,328983,0,2,2
93837,4,2,328985,328985,328987,0,2,2
93838,3,2,328988,328988,328990,0,2,1
93839,5,3,328993,328993,328996,0,3,3
93840,6,3,328999,328999,329002,0,3,3
93841,5,1,329004,329004,329005,0,1,2
93842,1,1,329005,329005,329006,0,1,0
93843,2,3,329007,329007,329010,0,3,1
93844,2,2,329009,329010,329012,1,3,0
93845,4,3,329013,329013,329016,0,3,1
93846,2,1,329015,329016,329017,1,2,0
93847,3,2,329018,329018,329020,0,2,1
93848,1,3,329019,329020,329023,1,4,0
93849,1,1,329020,329023,329024,3,4,0
93850,6,3,329026,329026,329029,0,3,2
93851,1,2,329027,329029,329031,2,4,0
93852,3,1,329030,329031,329032,1,2,0
93853,5,2,329035,329035,329037,0,2,3
93854,1,3,329036,329037,329040,1,4,0
93855,2,1,329038,329040,329041,2,3,0
93856,6,3,329044,329044,329047,0,3,3
93857,4,3,329048,329048,329051,0,3,1
93858,5,1,329053,329053,329054,0,1,2
93859,3,3,329056,329056,329059,0,3,2
93860,1,2,329057,329059,329061,2,4,0
93861,6,1,329063,329063,329064,0,1,2
93862,2,1,329065,329065,329066,0,1,1
93863,6,3,329071,329071,329074,0,3,5
93864,5,1,329076,329076,329077,0,1,2
93865,4,3,329080,329080,329083,0,3,3
93866,2,3,329082,329083,329086,1,4,0
93867,2,2,329084,329086,329088,2,4,0
93868,5,2,329089,329089,329091,0,2,1
93869,4,3,329093,329093,329096,0,3,2
93870,1,2,329094,329096,329098,2,4,0
93871,5,2,329099,329099,329101,0,2,1
93872,3,3,329102,329102,329105,0,3,1
93873,1,2,329103,329105,329107,2,4,0
93874,1,3,329104,329107,329110,3,6,0
93875,3,3,329107,329110,329113,3,6,0
93876,3,3,329110,329113,329116,3,6,0
93877,6,2,329116,329116,329118,0,2,0
93878,1,2,329117,329118,329120,1,3,0
93879,4,1,329121,329121,329122,0,1,1
93880,1,2,329122,329122,329124,0,2,0
93881,6,2,329128,329128,329130,0,2,4
93882,5,2,329133,329133,329135,0,2,3
93883,6,2,329139,329139,329141,0,2,4
93884,1,1,329140,329141,329142,1,2,0
93885,4,1,329144,329144,329145,0,1,2
93886,4,2,329148,329148,329150,0,2,3
93887,2,1,329150,329150,329151,0,1,0
93888,3,1,329153,329153,329154,0,1,2
93889,4,3,329157,329157,329160,0,3,3
93890,3,3,329160,329160,329163,0,3,0
93891,2,2,329162,329163,329165,1,3,0
93892,5,1,329167,329167,329168,0,1,2
93893,2,2,329169,329169,329171,0,2,1
93894,2,2,329171,329171,329173,0,2,0
93895,5,3,329176,329176,329179,0,3,3
93896,5,2,329181,329181,329183,0,2,2
93897,4,3,329185,329185,329188,0,3,2
93898,2,1,329187,329188,329189,1,2,0
93899,2,1,329189,329189,329190,0,1,0
93900,6,2,329195,329195,329197,0,2,5
93901,3,2,329198,329198,329200,0,2,1
93902,5,2,329203,329203,329205,0,2,3
93903,2,2,329205,329205,329207,0,2,0
93904,6,3,329211,329211,329214,0,3,4
93905,2,2,329213,329214,329216,1,3,0
93906,3,1,329216,329216,329217,0,1,0
93907,1,1,329217,329217,329218,0,1,0
93908,1,2,329218,329218,329220,0,2,0
93909,5,1,329223,329223,329224,0,1,3
93910,1,3,329224,329224,329227,0,3,0
93911,3,3,329227,329227,329230,0,3,0
93912,5,2,329232,329232,329234,0,2,2
93913,6,3,329238,329238,329241,0,3,4
93914,4,1,329242,329242,329243,0,1,1
93915,6,3,329248,329248,329251,0,3,5
93916,1,1,329249,329251,329252,2,3,0
93917,1,3,329250,329252,329255,2,5,0
93918,5,2,329255,329255,329257,0,2,0
93919,2,3,329257,329257,329260,0,3,0
93920,1,1,329258,329260,329261,2,3,0
93921,1,3,329259,329261,329264,2,5,0
93922,1,3,329260,329264,329267,4,7,0
93923,1,1,329261,329267,329268,6,7,0
93924,3,1,329264,329268,329269,4,5,0
93925,5,1,329269,329269,329270,0,1,0
93926,6,1,329275,329275,329276,0,1,5
93927,3,3,329278,329278,329281,0,3,2
93928,3,3,329281,329281,329284,0,3,0
93929,1,1,329282,329284,329285,2,3,0
93930,5,3,329287,329287,329290,0,3,2
93931,6,3,329293,329293,329296,0,3,3
93932,3,3,329296,329296,329299,0,3,0
93933,4,3,329300,329300,329303,0,3,1
93934,3,2,329303,329303,329305,0,2,0
93935,1,2,329304,329305,329307,1,3,0
93936,6,2,329310,329310,329312,0,2,3
93937,2,2,329312,329312,329314,0,2,0
93938,1,1,329313,329314,329315,1,2,0
93939,4,3,329317,329317,329320,0,3,2
93940,2,1,329319,329320,329321,1,2,0
93941,4,1,329323,329323,329324,0,1,2
93942,3,1,329326,329326,329327,0,1,2
93943,5,2,329331,329331,329333,0,2,4
93944,6,3,329337,329337,329340,0,3,4
93945,5,1,329342,329342,329343,0,1,2
93946,5,1,329347,329347,329348,0,1,4
93947,6,3,329353,329353,329356,0,3,5
93948,4,2,329357,329357,329359,0,2,1
93949,2,3,329359,329359,329362,0,3,0
93950,5,3,329364,329364,329367,0,3,2
93951,5,3,329369,329369,329372,0,3,2
93952,2,3,329371,329372,329375,1,4,0
93953,6,1,329377,329377,329378,0,1,2
93954,4,3,329381,329381,329384,0,3,3
93955,5,2,329386,329386,329388,0,2,2
93956,6,2,329392,329392,329394,0,2,4
93957,3,1,329395,329395,329396,0,1,1
93958,4,1,329399,329399,329400,0,1,3
93959,4,1,329403,329403,329404,0,1,3
93960,4,2,329407,329407,329409,0,2,3
93961,3,2,329410,329410,329412,0,2,1
93962,4,2,329414,329414,329416,0,2,2
93963,3,1,329417,329417,329418,0,1,1
93964,1,3,329418,329418,329421,0,3,0
93965,1,1,329419,329421,329422,2,3,0
93966,5,1,329424,329424,329425,0,1,2
93967,2,1,329426,329426,329427,0,1,1
93968,3,1,329429,329429,329430,0,1,2
93969,1,2,329430,329430,329432,0,2,0
93970,4,3,329434,329434,329437,0,3,2
93971,5,1,329439,329439,329440,0,1,2
93972,1,3,329440,329440,329443,0,3,0
93973,5,3,329445,329445,329448,0,3,2
93974,4,1,329449,329449,329450,0,1,1
93975,3,1,329452,329452,329453,0,1,2
93976,5,3,329457,329457,329460,0,3,4
93977,1,1,329458,329460,329461,2,3,0
93978,3,2,329461,329461,329463,0,2,0
93979,3,2,329464,329464,329466,0,2,1
93980,1,1,329465,329466,329467,1,2,0
93981,2,1,329467,329467,329468,0,1,0
93982,5,2,329472,329472,329474,0,2,4
93983,6,1,329478,329478,329479,0,1,4
93984,6,3,329484,329484,329487,0,3,5
93985,2,2,329486,329487,329489,1,3,0
93986,5,3,329491,329491,329494,0,3,2
93987,1,3,329492,329494,329497,2,5,0
93988,5,3,329497,329497,329500,0,3,0
93989,5,2,329502,329502,329504,0,2,2
93990,5,1,329507,329507,329508,0,1,3
93991,3,3,329510,329510,329513,0,3,2
93992,4,3,329514,329514,329517,0,3,1
93993,3,1,329517,329517,329518,0,1,0
93994,1,2,329518,329518,329520,0,2,0
93995,4,2,329522,329522,329524,0,2,2
93996,6,1,329528,329528,329529,0,1,4
93997,6,3,329534,329534,329537,0,3,5
93998,5,3,329539,329539,329542,0,3,2
93999,4,3,329543,329543,329546,0,3,1
94000,2,1,329545,329546,329547,1,2,0
94001,5,1,329550,329550,329551,0,1,3
94002,5,3,329555,329555,329558,0,3,4
94003,6,3,329561,329561,329564,0,3,3
94004,4,3,329565,329565,329568,0,3,1
94005,4,1,329569,329569,329570,0,1,1
94006,3,3,329572,329572,329575,0,3,2
94007,3,3,329575,329575,329578,0,3,0
94008,3,3,329578,329578,329581,0,3,0
94009,3,1,329581,329581,329582,0,1,0
94010,1,2,329582,329582,329584,0,2,0
94011,6,3,329588,329588,329591,0,3,4
94012,2,1,329590,329591,329592,1,2,0
94013,4,3,329594,329594,329597,0,3,2
94014,2,2,329596,329597,329599,1,3,0
94015,5,1,329601,329601,329602,0,1,2
94016,5,2,329606,329606,329608,0,2,4
94017,2,1,329608,329608,329609,0,1,0
94018,4,2,329612,329612,329614,0,2,3
94019,2,3,329614,329614,329617,0,3,0
94020,6,2,329620,329620,329622,0,2,3
94021,5,2,329625,329625,329627,0,2,3
94022,1,3,329626,329627,329630,1,4,0
94023,3,3,329629,329630,329633,1,4,0
94024,1,3,329630,329633,329636,3,6,0
94025,1,2,329631,329636,329638,5,7,0
94026,6,3,329637,329638,329641,1,4,0
94027,1,1,329638,329641,329642,3,4,0
94028,6,2,329644,329644,329646,0,2,2
94029,3,3,329647,329647,329650,0,3,1
94030,1,3,329648,329650,329653,2,5,0
94031,2,2,329650,329653,329655,3,5,0
94032,1,1,329651,329655,329656,4,5,0
94033,3,3,329654,329656,329659,2,5,0
94034,6,1,329660,329660,329661,0,1,1
94035,1,1,329661,329661,329662,0,1,0
94036,6,1,329667,329667,329668,0,1,5
94037,2,3,329669,329669,329672,0,3,1
94038,1,2,329670,329672,329674,2,4,0
94039,2,1,329672,329674,329675,2,3,0
94040,2,1,329674,329675,329676,1,2,0
94041,3,1,329677,329677,329678,0,1,1
94042,1,2,329678,329678,329680,0,2,0
94043,1,2,329679,329680,329682,1,3,0
94044,5,1,329684,329684,329685,0,1,2
94045,4,1,329688,329688,329689,0,1,3
94046,5,2,329693,329693,329695,0,2,4
94047,5,2,329698,329698,329700,0,2,3
94048,1,3,329699,329700,329703,1,4,0
94049,6,1,329705,329705,329706,0,1,2
94050,5,2,329710,329710,329712,0,2,4
94051,6,1,329716,329716,329717,0,1,4
94052,6,1,329722,329722,329723,0,1,5
94053,5,2,329727,329727,329729,0,2,4
94054,1,2,329728,329729,329731,1,3,0
94055,4,2,329732,329732,329734,0,2,1
94056,2,2,329734,329734,329736,0,2,0
94057,5,2,329739,329739,329741,0,2,3
94058,1,3,329740,329741,329744,1,4,0
94059,1,3,329741,329744,329747,3,6,0
94060,3,3,329744,329747,329750,3,6,0
94061,5,3,329749,329750,329753,1,4,0
94062,6,2,329755,329755,329757,0,2,2
94063,2,2,329757,329757,329759,0,2,0
94064,6,3,329763,329763,329766,0,3,4
94065,6,1,329769,329769,329770,0,1,3
94066,2,2,329771,329771,329773,0,2,1
94067,5,3,329776,329776,329779,0,3,3
94068,2,2,329778,329779,329781,1,3,0
94069,1,3,329779,329781,329784,2,5,0
94070,5,2,329784,329784,329786,0,2,0
94071,2,1,329786,329786,329787,0,1,0
94072,4,1,329790,329790,329791,0,1,3
94073,4,1,329794,329794,329795,0,1,3
94074,2,1,329796,329796,329797,0,1,1
94075,4,2,329800,329800,329802,0,2,3
94076,1,1,329801,329802,329803,1,2,0
94077,1,3,329802,329803,329806,1,4,0
94078,5,3,329807,329807,329810,0,3,1
94079,4,2,329811,329811,329813,0,2,1
94080,5,2,329816,329816,329818,0,2,3
94081,1,2,329817,329818,329820,1,3,0
94082,6,3,329823,329823,329826,0,3,3
94083,2,3,329825,329826,329829,1,4,0
94084,5,3,329830,329830,329833,0,3,1
94085,5,1,329835,329835,329836,0,1,2
94086,1,3,329836,329836,329839,0,3,0
94087,2,3,329838,329839,329842,1,4,0
94088,1,1,329839,329842,329843,3,4,0
94089,3,2,329842,329843,329845,1,3,0
94090,3,3,329845,329845,329848,0,3,0
94091,6,3,329851,329851,329854,0,3,3
94092,3,1,329854,329854,329855,0,1,0
94093,3,2,329857,329857,329859,0,2,2
94094,6,1,329863,329863,329864,0,1,4
94095,3,3,329866,329866,329869,0,3,2
94096,5,1,329871,329871,329872,0,1,2
94097,6,3,329877,329877,329880,0,3,5
94098,5,1,329882,329882,329883,0,1,2
94099,1,3,329883,329883,329886,0,3,0
94100,2,2,329885,329886,329888,1,3,0
94101,1,3,329886,329888,329891,2,5,0
94102,1,3,329887,329891,329894,4,7,0
94103,4,1,329891,329894,329895,3,4,0
94104,2,3,329893,329895,329898,2,5,0
94105,5,1,329898,329898,329899,0,1,0
94106,5,2,329903,329903,329905,0,2,4
94107,1,3,329904,329905,329908,1,4,0
94108,2,1,329906,329908,329909,2,3,0
94109,3,2,329909,329909,329911,0,2,0
94110,3,2,329912,329912,329914,0,2,1
94111,4,2,329916,329916,329918,0,2,2
94112,6,2,329922,329922,329924,0,2,4
94113,2,2,329924,329924,329926,0,2,0
94114,2,1,329926,329926,329927,0,1,0
94115,1,1,329927,329927,329928,0,1,0
94116,1,1,329928,329928,329929,0,1,0
94117,1,1,329929,329929,329930,0,1,0
94118,6,1,329935,329935,329936,0,1,5
94119,5,1,329940,329940,329941,0,1,4
94120,6,1,329946,329946,329947,0,1,5
94121,6,2,329952,329952,329954,0,2,5
94122,6,2,329958,329958,329960,0,2,4
94123,4,2,329962,329962,329964,0,2,2
94124,2,1,329964,329964,329965,0,1,0
94125,2,3,329966,329966,329969,0,3,1
94126,6,2,329972,329972,329974,0,2,3
94127,6,2,329978,329978,329980,0,2,4
94128,1,2,329979,329980,329982,1,3,0
94129,2,1,329981,329982,329983,1,2,0
94130,2,3,329983,329983,329986,0,3,0
94131,2,3,329985,329986,329989,1,4,0
94132,4,2,329989,329989,329991,0,2,0
94133,1,1,329990,329991,329992,1,2,0
94134,4,2,329994,329994,329996,0,2,2
94135,2,3,329996,329996,329999,0,3,0
94136,5,3,330001,330001,330004,0,3,2
94137,2,1,330003,330004,330005,1,2,0
94138,2,1,330005,330005,330006,0,1,0
94139,5,1,330010,330010,330011,0,1,4
94140,1,2,330011,330011,330013,0,2,0
94141,3,3,330014,330014,330017,0,3,1
94142,5,1,330019,330019,330020,0,1,2
94143,5,1,330024,330024,330025,0,1,4
94144,2,3,330026,330026,330029,0,3,1
94145,1,1,330027,330029,330030,2,3,0
94146,3,2,330030,330030,330032,0,2,0
94147,1,2,330031,330032,330034,1,3,0
94148,4,1,330035,330035,330036,0,1,1
94149,6,2,330041,330041,330043,0,2,5
94150,4,2,330045,330045,330047,0,2,2
94151,1,3,330046,330047,330050,1,4,0
94152,2,3,330048,330050,330053,2,5,0
94153,6,1,330054,330054,330055,0,1,1
94154,4,3,330058,330058,330061,0,3,3
94155,1,1,330059,330061,330062,2,3,0
94156,6,1,330065,330065,330066,0,1,3
94157,2,1,330067,330067,330068,0,1,1
94158,4,1,330071,330071,330072,0,1,3
94159,5,3,330076,330076,330079,0,3,4
94160,2,2,330078,330079,330081,1,3,0
94161,4,3,330082,330082,330085,0,3,1
94162,5,1,330087,330087,330088,0,1,2
94163,5,2,330092,330092,330094,0,2,4
94164,6,1,330098,330098,330099,0,1,4
94165,6,1,330104,330104,330105,0,1,5
94166,2,2,330106,330106,330108,0,2,1
94167,1,2,330107,330108,330110,1,3,0
94168,3,1,330110,330110,330111,0,1,0
94169,4,2,330114,330114,330116,0,2,3
94170,1,3,330115,330116,330119,1,4,0
94171,5,3,330120,330120,330123,0,3,1
94172,2,3,330122,330123,330126,1,4,0
94173,1,3,330123,330126,330129,3,6,0
94174,2,3,330125,330129,330132,4,7,0
94175,3,2,330128,330132,330134,4,6,0
94176,6,1,330134,330134,330135,0,1,0
94177,5,3,330139,330139,330142,0,3,4
94178,6,3,330145,330145,330148,0,3,3
94179,4,3,330149,330149,330152,0,3,1
94180,6,1,330155,330155,330156,0,1,3
94181,1,2,330156,330156,330158,0,2,0
94182,6,3,330162,330162,330165,0,3,4
94183,6,1,330168,330168,330169,0,1,3
94184,6,3,330174,330174,330177,0,3,5
94185,6,3,330180,330180,330183,0,3,3
94186,4,1,330184,330184,330185,0,1,1
94187,4,2,330188,330188,330190,0,2,3
94188,4,2,330192,330192,330194,0,2,2
94189,5,2,330197,330197,330199,0,2,3
94190,5,2,330202,330202,330204,0,2,3
94191,6,3,330208,330208,330211,0,3,4
94192,1,2,330209,330211,330213,2,4,0
94193,6,2,330215,330215,330217,0,2,2
94194,2,2,330217,330217,330219,0,2,0
94195,6,1,330223,330223,330224,0,1,4
94196,6,2,330229,330229,330231,0,2,5
94197,5,1,330234,330234,330235,0,1,3
94198,2,2,330236,330236,330238,0,2,1
94199,4,1,330240,330240,330241,0,1,2
94200,2,1,330242,330242,330243,0,1,1
94201,1,1,330243,330243,330244,0,1,0
94202,3,2,330246,330246,330248,0,2,2
94203,1,3,330247,330248,330251,1,4,0
94204,4,3,330251,330251,330254,0,3,0
94205,4,3,330255,330255,330258,0,3,1
94206,2,3,330257,330258,330261,1,4,0
94207,6,1,330263,330263,330264,0,1,2
94208,6,2,330269,330269,330271,0,2,5
94209,2,1,330271,330271,330272,0,1,0
94210,1,2,330272,330272,330274,0,2,0
94211,1,1,330273,330274,330275,1,2,0
94212,4,2,330277,330277,330279,0,2,2
94213,1,3,330278,330279,330282,1,4,0
94214,1,1,330279,330282,330283,3,4,0
94215,1,2,330280,330283,330285,3,5,0
94216,3,3,330283,330285,330288,2,5,0
94217,1,1,330284,330288,330289,4,5,0
94218,5,3,330289,330289,330292,0,3,0
94219,5,3,330294,330294,330297,0,3,2
94220,6,1,330300,330300,330301,0,1,3
94221,3,1,330303,330303,330304,0,1,2
94222,4,1,330307,330307,330308,0,1,3
94223,1,3,330308,330308,330311,0,3,0
94224,1,3,330309,330311,330314,2,5,0
94225,3,1,330312,330314,330315,2,3,0
94226,2,3,330314,330315,330318,1,4,0
94227,3,2,330317,330318,330320,1,3,0
94228,1,1,330318,330320,330321,2,3,0
94229,1,1,330319,330321,330322,2,3,0
94230,3,2,330322,330322,330324,0,2,0
94231,6,1,330328,330328,330329,0,1,4
94232,3,2,330331,330331,330333,0,2,2
94233,3,1,330334,330334,330335,0,1,1
94234,1,1,330335,330335,330336,0,1,0
94235,6,3,330341,330341,330344,0,3,5
94236,4,2,330345,330345,330347,0,2,1
94237,4,2,330349,330349,330351,0,2,2
94238,1,1,330350,330351,330352,1,2,0
94239,2,2,330352,330352,330354,0,2,0
94240,4,2,330356,330356,330358,0,2,2
94241,1,3,330357,330358,330361,1,4,0
94242,4,3,330361,330361,330364,0,3,0
94243,4,1,330365,330365,330366,0,1,1
94244,3,1,330368,330368,330369,0,1,2
94245,2,3,330370,330370,330373,0,3,1
94246,5,3,330375,330375,330378,0,3,2
94247,5,3,330380,330380,330383,0,3,2
94248,1,2,330381,330383,330385,2,4,0
94249,5,1,330386,330386,330387,0,1,1
94250,3,2,330389,330389,330391,0,2,2
94251,5,2,330394,330394,330396,0,2,3
94252,4,2,330398,330398,330400,0,2,2
94253,5,1,330403,330403,330404,0,1,3
94254,2,2,330405,330405,330407,0,2,1
94255,3,2,330408,330408,330410,0,2,1
94256,6,1,330414,330414,330415,0,1,4
94257,4,1,330418,330418,330419,0,1,3
94258,1,2,330419,330419,330421,0,2,0
94259,2,1,330421,330421,330422,0,1,0
94260,4,2,330425,330425,330427,0,2,3
94261,1,3,330426,330427,330430,1,4,0
94262,3,1,330429,330430,330431,1,2,0
94263,5,1,330434,330434,330435,0,1,3
94264,3,2,330437,330437,330439,0,2,2
94265,5,2,330442,330442,330444,0,2,3
94266,5,3,330447,330447,330450,0,3,3
94267,1,1,330448,330450,330451,2,3,0
94268,6,1,330454,330454,330455,0,1,3
94269,6,3,330460,330460,330463,0,3,5
94270,5,3,330465,330465,330468,0,3,2
94271,3,1,330468,330468,330469,0,1,0
94272,1,2,330469,330469,330471,0,2,0
94273,1,3,330470,330471,330474,1,4,0
94274,3,1,330473,330474,330475,1,2,0
94275,3,2,330476,330476,330478,0,2,1
94276,5,1,330481,330481,330482,0,1,3
94277,3,2,330484,330484,330486,0,2,2
94278,3,1,330487,330487,330488,0,1,1
94279,1,2,330488,330488,330490,0,2,0
94280,3,1,330491,330491,330492,0,1,1
94281,4,2,330495,330495,330497,0,2,3
94282,5,1,330500,330500,330501,0,1,3
94283,2,2,330502,330502,330504,0,2,1
94284,2,3,330504,330504,330507,0,3,0
94285,3,1,330507,330507,330508,0,1,0
94286,2,1,330509,330509,330510,0,1,1
94287,2,1,330511,330511,330512,0,1,1
94288,2,1,330513,330513,330514,0,1,1
94289,3,3,330516,330516,330519,0,3,2
94290,6,3,330522,330522,330525,0,3,3
94291,5,3,330527,330527,330530,0,3,2
94292,2,1,330529,330530,330531,1,2,0
94293,3,3,330532,330532,330535,0,3,1
94294,5,1,330537,330537,330538,0,1,2
94295,4,1,330541,330541,330542,0,1,3
94296,1,1,330542,330542,330543,0,1,0
94297,2,3,330544,330544,330547,0,3,1
94298,5,1,330549,330549,330550,0,1,2
94299,6,2,330555,330555,330557,0,2,5
94300,5,1,330560,330560,330561,0,1,3
94301,4,2,330564,330564,330566,0,2,3
94302,2,3,330566,330566,330569,0,3,0
94303,1,2,330567,330569,330571,2,4,0
94304,3,1,330570,330571,330572,1,2,0
94305,2,2,330572,330572,330574,0,2,0
94306,6,2,330578,330578,330580,0,2,4
94307,3,2,330581,330581,330583,0,2,1
94308,1,1,330582,330583,330584,1,2,0
94309,4,2,330586,330586,330588,0,2,2
94310,6,2,330592,330592,330594,0,2,4
94311,3,3,330595,330595,330598,0,3,1
94312,3,3,330598,330598,330601,0,3,0
94313,1,1,330599,330601,330602,2,3,0
94314,5,2,330604,330604,330606,0,2,2
94315,6,3,330610,330610,330613,0,3,4
94316,5,2,330615,330615,330617,0,2,2
94317,1,2,330616,330617,330619,1,3,0
94318,3,1,330619,330619,330620,0,1,0
94319,3,1,330622,330622,330623,0,1,2
94320,4,3,330626,330626,330629,0,3,3
94321,5,1,330631,330631,330632,0,1,2
94322,5,2,330636,330636,330638,0,2,4
94323,6,2,330642,330642,330644,0,2,4
94324,4,2,330646,330646,330648,0,2,2
94325,1,3,330647,330648,330651,1,4,0
94326,2,1,330649,330651,330652,2,3,0
94327,4,1,330653,330653,330654,0,1,1
94328,1,2,330654,330654,330656,0,2,0
94329,4,2,330658,330658,330660,0,2,2
94330,2,1,330660,330660,330661,0,1,0
94331,4,2,330664,330664,330666,0,2,3
94332,5,3,330669,330669,330672,0,3,3
94333,5,2,330674,330674,330676,0,2,2
94334,3,3,330677,330677,330680,0,3,1
94335,1,3,330678,330680,330683,2,5,0
94336,4,3,330682,330683,330686,1,4,0
94337,3,3,330685,330686,330689,1,4,0
94338,1,3,330686,330689,330692,3,6,0
94339,2,1,330688,330692,330693,4,5,0
94340,2,1,330690,330693,330694,3,4,0
94341,4,3,330694,330694,330697,0,3,0
94342,2,3,330696,330697,330700,1,4,0
94343,5,2,330701,330701,330703,0,2,1
94344,4,3,330705,330705,330708,0,3,2
94345,2,1,330707,330708,330709,1,2,0
94346,5,3,330712,330712,330715,0,3,3
94347,1,3,330713,330715,330718,2,5,0
94348,4,3,330717,330718,330721,1,4,0
94349,5,2,330722,330722,330724,0,2,1
94350,5,3,330727,330727,330730,0,3,3
94351,2,2,330729,330730,330732,1,3,0
94352,5,1,330734,330734,330735,0,1,2
94353,1,3,330735,330735,330738,0,3,0
94354,1,2,330736,330738,330740,2,4,0
94355,6,2,330742,330742,330744,0,2,2
94356,4,1,330746,330746,330747,0,1,2
94357,6,3,330752,330752,330755,0,3,5
94358,1,2,330753,330755,330757,2,4,0
94359,3,3,330756,330757,330760,1,4,0
94360,3,3,330759,330760,330763,1,4,0
94361,4,3,330763,330763,330766,0,3,0
94362,3,3,330766,330766,330769,0,3,0
94363,4,3,330770,330770,330773,0,3,1
94364,1,2,330771,330773,330775,2,4,0
94365,1,3,330772,330775,330778,3,6,0
94366,1,1,330773,330778,330779,5,6,0
94367,4,2,330777,330779,330781,2,4,0
94368,1,3,330778,330781,330784,3,6,0
94369,1,1,330779,330784,330785,5,6,0
94370,5,3,330784,330785,330788,1,4,0
94371,4,3,330788,330788,330791,0,3,0
94372,3,2,330791,330791,330793,0,2,0
94373,3,2,330794,330794,330796,0,2,1
94374,6,3,330800,330800,330803,0,3,4
94375,3,2,330803,330803,330805,0,2,0
94376,2,1,330805,330805,330806,0,1,0
94377,1,3,330806,330806,330809,0,3,0
94378,3,3,330809,330809,330812,0,3,0
94379,6,3,330815,330815,330818,0,3,3
94380,3,1,330818,330818,330819,0,1,0
94381,2,2,330820,330820,330822,0,2,1
94382,4,3,330824,330824,330827,0,3,2
94383,2,3,330826,330827,330830,1,4,0
94384,6,2,330832,330832,330834,0,2,2
94385,2,1,330834,330834,330835,0,1,0
94386,2,2,330836,330836,330838,0,2,1
94387,6,2,330842,330842,330844,0,2,4
94388,2,1,330844,330844,330845,0,1,0
94389,5,2,330849,330849,330851,0,2,4
94390,1,1,330850,330851,330852,1,2,0
94391,6,3,330856,330856,330859,0,3,4
94392,4,3,330860,330860,330863,0,3,1
94393,4,1,330864,330864,330865,0,1,1
94394,6,3,330870,330870,330873,0,3,5
94395,5,2,330875,330875,330877,0,2,2
94396,5,3,330880,330880,330883,0,3,3
94397,1,3,330881,330883,330886,2,5,0
94398,1,1,330882,330886,330887,4,5,0
94399,4,2,330886,330887,330889,1,3,0
94400,5,2,330891,330891,330893,0,2,2
94401,1,3,330892,330893,330896,1,4,0
94402,5,3,330897,330897,330900,0,3,1
94403,2,3,330899,330900,330903,1,4,0
94404,4,3,330903,330903,330906,0,3,0
94405,3,3,330906,330906,330909,0,3,0
94406,3,1,330909,330909,330910,0,1,0
94407,6,3,330915,330915,330918,0,3,5
94408,2,2,330917,330918,330920,1,3,0
94409,6,2,330923,330923,330925,0,2,3
94410,3,3,330926,330926,330929,0,3,1
94411,4,3,330930,330930,330933,0,3,1
94412,6,3,330936,330936,330939,0,3,3
94413,6,2,330942,330942,330944,0,2,3
94414,2,1,330944,330944,330945,0,1,0
94415,2,1,330946,330946,330947,0,1,1
94416,5,3,330951,330951,330954,0,3,4
94417,6,1,330957,330957,330958,0,1,3
94418,6,2,330963,330963,330965,0,2,5
94419,4,1,330967,330967,330968,0,1,2
94420,6,1,330973,330973,330974,0,1,5
94421,6,3,330979,330979,330982,0,3,5
94422,1,3,330980,330982,330985,2,5,0
94423,2,2,330982,330985,330987,3,5,0
94424,5,1,330987,330987,330988,0,1,0
94425,1,2,330988,330988,330990,0,2,0
94426,6,2,330994,330994,330996,0,2,4
94427,3,2,330997,330997,330999,0,2,1
94428,6,1,331003,331003,331004,0,1,4
94429,3,3,331006,331006,331009,0,3,2
94430,6,3,331012,331012,331015,0,3,3
94431,5,1,331017,331017,331018,0,1,2
94432,4,1,331021,331021,331022,0,1,3
94433,5,1,331026,331026,331027,0,1,4
94434,1,1,331027,331027,331028,0,1,0
94435,4,1,331031,331031,331032,0,1,3
94436,5,2,331036,331036,331038,0,2,4
94437,4,3,331040,331040,331043,0,3,2
94438,6,1,331046,331046,331047,0,1,3
94439,6,3,331052,331052,331055,0,3,5
94440,3,1,331055,331055,331056,0,1,0
94441,5,2,331060,331060,331062,0,2,4
94442,4,2,331064,331064,331066,0,2,2
94443,1,3,331065,331066,331069,1,4,0
94444,5,2,331070,331070,331072,0,2,1
94445,6,1,331076,331076,331077,0,1,4
94446,6,2,331082,331082,331084,0,2,5
94447,1,3,331083,331084,331087,1,4,0
94448,1,1,331084,331087,331088,3,4,0
94449,6,1,331090,331090,331091,0,1,2
94450,5,2,331095,331095,331097,0,2,4
94451,4,2,331099,331099,331101,0,2,2
94452,1,1,331100,331101,331102,1,2,0
94453,5,1,331105,331105,331106,0,1,3
94454,2,2,331107,331107,331109,0,2,1
94455,3,2,331110,331110,331112,0,2,1
94456,2,2,331112,331112,331114,0,2,0
94457,2,1,331114,331114,331115,0,1,0
94458,5,2,331119,331119,331121,0,2,4
94459,3,3,331122,331122,331125,0,3,1
94460,6,2,331128,331128,331130,0,2,3
94461,3,2,331131,331131,331133,0,2,1
94462,1,1,331132,331133,331134,1,2,0
94463,4,3,331136,331136,331139,0,3,2
94464,4,2,331140,331140,331142,0,2,1
94465,3,1,331143,331143,331144,0,1,1
94466,4,1,331147,331147,331148,0,1,3
94467,2,1,331149,331149,331150,0,1,1
94468,1,2,331150,331150,331152,0,2,0
94469,1,1,331151,331152,331153,1,2,0
94470,1,3,331152,331153,331156,1,4,0
94471,2,2,331154,331156,331158,2,4,0
94472,1,3,331155,331158,331161,3,6,0
94473,2,1,331157,331161,331162,4,5,0
94474,3,1,331160,331162,331163,2,3,0
94475,6,1,331166,331166,331167,0,1,3
94476,6,1,331172,331172,331173,0,1,5
94477,6,1,331178,331178,331179,0,1,5
94478,6,1,331184,331184,331185,0,1,5
94479,4,1,331188,331188,331189,0,1,3
94480,1,2,331189,331189,331191,0,2,0
94481,6,3,331195,331195,331198,0,3,4
94482,5,2,331200,331200,331202,0,2,2
94483,1,2,331201,331202,331204,1,3,0
94484,1,2,331202,331204,331206,2,4,0
94485,6,1,331208,331208,331209,0,1,2
94486,6,3,331214,331214,331217,0,3,5
94487,5,1,331219,331219,331220,0,1,2
94488,3,1,331222,331222,331223,0,1,2
94489,2,3,331224,331224,331227,0,3,1
94490,3,2,331227,331227,331229,0,2,0
94491,6,2,331233,331233,331235,0,2,4
94492,1,3,331234,331235,331238,1,4,0
94493,2,3,331236,331238,331241,2,5,0
94494,4,3,331240,331241,331244,1,4,0
94495,1,1,331241,331244,331245,3,4,0
94496,4,1,331245,331245,331246,0,1,0
94497,5,2,331250,331250,331252,0,2,4
94498,3,1,331253,331253,331254,0,1,1
94499,1,3,331254,331254,331257,0,3,0
94500,2,1,331256,331257,331258,1,2,0
94501,3,3,331259,331259,331262,0,3,1
94502,1,1,331260,331262,331263,2,3,0
94503,5,1,331265,331265,331266,0,1,2
94504,3,2,331268,331268,331270,0,2,2
94505,5,1,331273,331273,331274,0,1,3
94506,3,2,331276,331276,331278,0,2,2
94507,5,3,331281,331281,331284,0,3,3
94508,3,1,331284,331284,331285,0,1,0
94509,3,3,331287,331287,331290,0,3,2
94510,6,1,331293,331293,331294,0,1,3
94511,2,2,331295,331295,331297,0,2,1
94512,1,1,331296,331297,331298,1,2,0
94513,6,3,331302,331302,331305,0,3,4
94514,2,2,331304,331305,331307,1,3,0
94515,5,3,331309,331309,331312,0,3,2
94516,1,1,331310,331312,331313,2,3,0
94517,2,2,331312,331313,331315,1,3,0
94518,1,2,331313,331315,331317,2,4,0
94519,1,1,331314,331317,331318,3,4,0
94520,3,1,331317,331318,331319,1,2,0
94521,5,2,331322,331322,331324,0,2,3
94522,4,1,331326,331326,331327,0,1,2
94523,3,3,331329,331329,331332,0,3,2
94524,5,2,331334,331334,331336,0,2,2
94525,2,2,331336,331336,331338,0,2,0
94526,2,2,331338,331338,331340,0,2,0
94527,1,3,331339,331340,331343,1,4,0
94528,1,1,331340,331343,331344,3,4,0
94529,3,1,331343,331344,331345,1,2,0
94530,3,2,331346,331346,331348,0,2,1
94531,5,3,331351,331351,331354,0,3,3
94532,2,2,331353,331354,331356,1,3,0
94533,5,3,331358,331358,331361,0,3,2
94534,5,3,331363,331363,331366,0,3,2
94535,3,1,331366,331366,331367,0,1,0
94536,6,1,331372,331372,331373,0,1,5
94537,5,3,331377,331377,331380,0,3,4
94538,1,2,331378,331380,331382,2,4,0
94539,2,2,331380,331382,331384,2,4,0
94540,4,1,331384,331384,331385,0,1,0
94541,2,3,331386,331386,331389,0,3,1
94542,4,3,331390,331390,331393,0,3,1
94543,2,2,331392,331393,331395,1,3,0
94544,4,2,331396,331396,331398,0,2,1
94545,5,1,331401,331401,331402,0,1,3
94546,2,1,331403,331403,331404,0,1,1
94547,4,2,331407,331407,331409,0,2,3
94548,1,1,331408,331409,331410,1,2,0
94549,3,3,331411,331411,331414,0,3,1
94550,3,1,331414,331414,331415,0,1,0
94551,1,1,331415,331415,331416,0,1,0
94552,1,1,331416,331416,331417,0,1,0
94553,1,3,331417,331417,331420,0,3,0
94554,5,3,331422,331422,331425,0,3,2
94555,2,2,331424,331425,331427,1,3,0
94556,4,2,331428,331428,331430,0,2,1
94557,4,2,331432,331432,331434,0,2,2
94558,6,2,331438,331438,331440,0,2,4
94559,5,3,331443,331443,331446,0,3,3
94560,5,2,331448,331448,331450,0,2,2
94561,6,2,331454,331454,331456,0,2,4
94562,1,1,331455,331456,331457,1,2,0
94563,4,2,331459,331459,331461,0,2,2
94564,1,1,331460,331461,331462,1,2,0
94565,6,1,331466,331466,331467,0,1,4
94566,5,3,331471,331471,331474,0,3,4
94567,6,1,331477,331477,331478,0,1,3
94568,6,3,331483,331483,331486,0,3,5
94569,2,1,331485,331486,331487,1,2,0
94570,2,3,331487,331487,331490,0,3,0
94571,5,3,331492,331492,331495,0,3,2
94572,5,1,331497,331497,331498,0,1,2
94573,5,2,331502,331502,331504,0,2,4
94574,4,2,331506,331506,331508,0,2,2
94575,5,1,331511,331511,331512,0,1,3
94576,4,3,331515,331515,331518,0,3,3
94577,6,2,331521,331521,331523,0,2,3
94578,6,2,331527,331527,331529,0,2,4
94579,5,1,331532,331532,331533,0,1,3
94580,3,1,331535,331535,331536,0,1,2
94581,5,2,331540,331540,331542,0,2,4
94582,6,2,331546,331546,331548,0,2,4
94583,4,1,331550,331550,331551,0,1,2
94584,5,2,331555,331555,331557,0,2,4
94585,5,2,331560,331560,331562,0,2,3
94586,6,2,331566,331566,331568,0,2,4
94587,6,3,331572,331572,331575,0,3,4
94588,6,2,331578,331578,331580,0,2,3
94589,3,1,331581,331581,331582,0,1,1
94590,3,1,331584,331584,331585,0,1,2
94591,2,2,331586,331586,331588,0,2,1
94592,3,2,331589,331589,331591,0,2,1
94593,3,3,331592,331592,331595,0,3,1
94594,6,2,331598,331598,331600,0,2,3
94595,1,3,331599,331600,331603,1,4,0
94596,2,1,331601,331603,331604,2,3,0
94597,4,1,331605,331605,331606,0,1,1
94598,2,1,331607,331607,331608,0,1,1
94599,1,1,331608,331608,331609,0,1,0
94600,3,2,331611,331611,331613,0,2,2
94601,4,3,331615,331615,331618,0,3,2
94602,3,1,331618,331618,331619,0,1,0
94603,6,3,331624,331624,331627,0,3,5
94604,4,1,331628,331628,331629,0,1,1
94605,5,1,331633,331633,331634,0,1,4
94606,1,2,331634,331634,331636,0,2,0
94607,1,3,331635,331636,331639,1,4,0
94608,6,2,331641,331641,331643,0,2,2
94609,2,1,331643,331643,331644,0,1,0
94610,6,1,331649,331649,331650,0,1,5
94611,2,3,331651,331651,331654,0,3,1
94612,6,1,331657,331657,331658,0,1,3
94613,5,3,331662,331662,331665,0,3,4
94614,5,1,331667,331667,331668,0,1,2
94615,1,3,331668,331668,331671,0,3,0
94616,5,2,331673,331673,331675,0,2,2
94617,5,2,331678,331678,331680,0,2,3
94618,2,2,331680,331680,331682,0,2,0
94619,5,3,331685,331685,331688,0,3,3
94620,6,2,331691,331691,331693,0,2,3
94621,4,1,331695,331695,331696,0,1,2
94622,4,2,331699,331699,331701,0,2,3
94623,2,2,331701,331701,331703,0,2,0
94624,1,3,331702,331703,331706,1,4,0
94625,6,1,331708,331708,331709,0,1,2
94626,6,2,331714,331714,331716,0,2,5
94627,2,2,331716,331716,331718,0,2,0
94628,2,2,331718,331718,331720,0,2,0
94629,3,3,331721,331721,331724,0,3,1
94630,2,3,331723,331724,331727,1,4,0
94631,4,3,331727,331727,331730,0,3,0
94632,5,2,331732,331732,331734,0,2,2
94633,2,2,331734,331734,331736,0,2,0
94634,2,2,331736,331736,331738,0,2,0
94635,6,3,331742,331742,331745,0,3,4
94636,1,1,331743,331745,331746,2,3,0
94637,1,2,331744,331746,331748,2,4,0
94638,4,3,331748,331748,331751,0,3,0
94639,4,2,331752,331752,331754,0,2,1
94640,6,3,331758,331758,331761,0,3,4
94641,1,3,331759,331761,331764,2,5,0
94642,6,1,331765,331765,331766,0,1,1
94643,2,1,331767,331767,331768,0,1,1
94644,2,3,331769,331769,331772,0,3,1
94645,1,1,331770,331772,331773,2,3,0
94646,3,3,331773,331773,331776,0,3,0
94647,6,2,331779,331779,331781,0,2,3
94648,3,1,331782,331782,331783,0,1,1
94649,6,3,331788,331788,331791,0,3,5
94650,5,1,331793,331793,331794,0,1,2
94651,2,3,331795,331795,331798,0,3,1
94652,1,1,331796,331798,331799,2,3,0
94653,1,1,331797,331799,331800,2,3,0
94654,5,3,331802,331802,331805,0,3,2
94655,6,3,331808,331808,331811,0,3,3
94656,5,2,331813,331813,331815,0,2,2
94657,5,1,331818,331818,331819,0,1,3
94658,3,3,331821,331821,331824,0,3,2
94659,1,3,331822,331824,331827,2,5,0
94660,5,2,331827,331827,331829,0,2,0
94661,3,1,331830,331830,331831,0,1,1
94662,2,2,331832,331832,331834,0,2,1
94663,1,2,331833,331834,331836,1,3,0
94664,6,3,331839,331839,331842,0,3,3
94665,4,3,331843,331843,331846,0,3,1
94666,4,2,331847,331847,331849,0,2,1
94667,6,2,331853,331853,331855,0,2,4
94668,4,2,331857,331857,331859,0,2,2
94669,1,2,331858,331859,331861,1,3,0
94670,5,2,331863,331863,331865,0,2,2
94671,4,2,331867,331867,331869,0,2,2
94672,2,3,331869,331869,331872,0,3,0
94673,1,3,331870,331872,331875,2,5,0
94674,4,1,331874,331875,331876,1,2,0
94675,3,1,331877,331877,331878,0,1,1
94676,5,2,331882,331882,331884,0,2,4
94677,5,2,331887,331887,331889,0,2,3
94678,1,3,331888,331889,331892,1,4,0
94679,3,3,331891,331892,331895,1,4,0
94680,5,3,331896,331896,331899,0,3,1
94681,3,2,331899,331899,331901,0,2,0
94682,2,1,331901,331901,331902,0,1,0
94683,6,3,331907,331907,331910,0,3,5
94684,4,3,331911,331911,331914,0,3,1
94685,4,2,331915,331915,331917,0,2,1
94686,6,2,331921,331921,331923,0,2,4
94687,6,3,331927,331927,331930,0,3,4
94688,2,3,331929,331930,331933,1,4,0
94689,5,3,331934,331934,331937,0,3,1
94690,6,2,331940,331940,331942,0,2,3
94691,1,2,331941,331942,331944,1,3,0
94692,4,2,331945,331945,331947,0,2,1
94693,5,2,331950,331950,331952,0,2,3
94694,1,2,331951,331952,331954,1,3,0
94695,3,3,331954,331954,331957,0,3,0
94696,2,1,331956,331957,331958,1,2,0
94697,2,2,331958,331958,331960,0,2,0
94698,4,1,331962,331962,331963,0,1,2
94699,6,3,331968,331968,331971,0,3,5
94700,1,2,331969,331971,331973,2,4,0
94701,4,2,331973,331973,331975,0,2,0
94702,5,1,331978,331978,331979,0,1,3
94703,1,1,331979,331979,331980,0,1,0
94704,5,2,331984,331984,331986,0,2,4
94705,6,1,331990,331990,331991,0,1,4
94706,1,1,331991,331991,331992,0,1,0
94707,5,3,331996,331996,331999,0,3,4
94708,4,3,332000,332000,332003,0,3,1
94709,5,3,332005,332005,332008,0,3,2
94710,3,1,332008,332008,332009,0,1,0
94711,6,1,332014,332014,332015,0,1,5
94712,2,3,332016,332016,332019,0,3,1
94713,5,3,332021,332021,332024,0,3,2
94714,5,3,332026,332026,332029,0,3,2
94715,5,2,332031,332031,332033,0,2,2
94716,3,2,332034,332034,332036,0,2,1
94717,1,3,332035,332036,332039,1,4,0
94718,4,2,332039,332039,332041,0,2,0
94719,5,2,332044,332044,332046,0,2,3
94720,4,2,332048,332048,332050,0,2,2
94721,1,1,332049,332050,332051,1,2,0
94722,6,1,332055,332055,332056,0,1,4
94723,1,1,332056,332056,332057,0,1,0
94724,4,1,332060,332060,332061,0,1,3
94725,2,2,332062,332062,332064,0,2,1
94726,5,2,332067,332067,332069,0,2,3
94727,2,1,332069,332069,332070,0,1,0
94728,1,1,332070,332070,332071,0,1,0
94729,6,1,332076,332076,332077,0,1,5
94730,3,2,332079,332079,332081,0,2,2
94731,4,2,332083,332083,332085,0,2,2
94732,4,1,332087,332087,332088,0,1,2
94733,1,2,332088,332088,332090,0,2,0
94734,5,2,332093,332093,332095,0,2,3
94735,4,3,332097,332097,332100,0,3,2
94736,1,1,332098,332100,332101,2,3,0
94737,6,1,332104,332104,332105,0,1,3
94738,4,1,332108,332108,332109,0,1,3
94739,6,2,332114,332114,332116,0,2,5
94740,3,1,332117,332117,332118,0,1,1
94741,6,3,332123,332123,332126,0,3,5
94742,1,3,332124,332126,332129,2,5,0
94743,6,1,332130,332130,332131,0,1,1
94744,2,2,332132,332132,332134,0,2,1
94745,3,1,332135,332135,332136,0,1,1
94746,5,1,332140,332140,332141,0,1,4
94747,6,3,332146,332146,332149,0,3,5
94748,1,3,332147,332149,332152,2,5,0
94749,6,2,332153,332153,332155,0,2,1
94750,2,2,332155,332155,332157,0,2,0
94751,3,2,332158,332158,332160,0,2,1
94752,5,3,332163,332163,332166,0,3,3
94753,6,1,332169,332169,332170,0,1,3
94754,3,1,332172,332172,332173,0,1,2
94755,5,3,332177,332177,332180,0,3,4
94756,6,1,332183,332183,332184,0,1,3
94757,4,2,332187,332187,332189,0,2,3
94758,4,2,332191,332191,332193,0,2,2
94759,1,2,332192,332193,332195,1,3,0
94760,2,1,332194,332195,332196,1,2,0
94761,1,2,332195,332196,332198,1,3,0
94762,4,1,332199,332199,332200,0,1,1
94763,4,3,332203,332203,332206,0,3,3
94764,2,2,332205,332206,332208,1,3,0
94765,2,1,332207,332208,332209,1,2,0
94766,1,3,332208,332209,332212,1,4,0
94767,3,1,332211,332212,332213,1,2,0
94768,3,1,332214,332214,332215,0,1,1
94769,6,3,332220,332220,332223,0,3,5
94770,3,2,332223,332223,332225,0,2,0
94771,2,2,332225,332225,332227,0,2,0
94772,5,1,332230,332230,332231,0,1,3
94773,5,3,332235,332235,332238,0,3,4
94774,2,3,332237,332238,332241,1,4,0
94775,5,1,332242,332242,332243,0,1,1
94776,6,3,332248,332248,332251,0,3,5
94777,1,2,332249,332251,332253,2,4,0
94778,6,2,332255,332255,332257,0,2,2
94779,1,3,332256,332257,332260,1,4,0
94780,6,3,332262,332262,332265,0,3,2
94781,6,3,332268,332268,332271,0,3,3
94782,6,2,332274,332274,332276,0,2,3
94783,3,3,332277,332277,332280,0,3,1
94784,1,2,332278,332280,332282,2,4,0
94785,5,2,332283,332283,332285,0,2,1
94786,2,2,332285,332285,332287,0,2,0
94787,5,1,332290,332290,332291,0,1,3
94788,2,1,332292,332292,332293,0,1,1
94789,2,2,332294,332294,332296,0,2,1
94790,1,3,332295,332296,332299,1,4,0
94791,3,2,332298,332299,332301,1,3,0
94792,4,2,332302,332302,332304,0,2,1
94793,3,1,332305,332305,332306,0,1,1
94794,1,1,332306,332306,332307,0,1,0
94795,5,1,332311,332311,332312,0,1,4
94796,5,3,332316,332316,332319,0,3,4
94797,5,3,332321,332321,332324,0,3,2
94798,2,2,332323,332324,332326,1,3,0
94799,6,2,332329,332329,332331,0,2,3
94800,3,1,332332,332332,332333,0,1,1
94801,3,2,332335,332335,332337,0,2,2
94802,3,2,332338,332338,332340,0,2,1
94803,6,3,332344,332344,332347,0,3,4
94804,2,2,332346,332347,332349,1,3,0
94805,5,2,332351,332351,332353,0,2,2
94806,2,1,332353,332353,332354,0,1,0
94807,3,2,332356,332356,332358,0,2,2
94808,5,2,332361,332361,332363,0,2,3
94809,1,1,332362,332363,332364,1,2,0
94810,5,1,332367,332367,332368,0,1,3
94811,6,3,332373,332373,332376,0,3,5
94812,1,2,332374,332376,332378,2,4,0
94813,5,1,332379,332379,332380,0,1,1
94814,5,2,332384,332384,332386,0,2,4
94815,4,3,332388,332388,332391,0,3,2
94816,5,1,332393,332393,332394,0,1,2
94817,5,2,332398,332398,332400,0,2,4
94818,5,2,332403,332403,332405,0,2,3
94819,2,2,332405,332405,332407,0,2,0
94820,3,3,332408,332408,332411,0,3,1
94821,3,1,332411,332411,332412,0,1,0
94822,1,2,332412,332412,332414,0,2,0
94823,5,1,332417,332417,332418,0,1,3
94824,2,2,332419,332419,332421,0,2,1
94825,5,1,332424,332424,332425,0,1,3
94826,1,3,332425,332425,332428,0,3,0
94827,5,3,332430,332430,332433,0,3,2
94828,4,1,332434,332434,332435,0,1,1
94829,4,1,332438,332438,332439,0,1,3
94830,3,2,332441,332441,332443,0,2,2
94831,6,2,332447,332447,332449,0,2,4
94832,3,2,332450,332450,332452,0,2,1
94833,3,2,332453,332453,332455,0,2,1
94834,6,3,332459,332459,332462,0,3,4
94835,2,1,332461,332462,332463,1,2,0
94836,6,2,332467,332467,332469,0,2,4
94837,3,3,332470,332470,332473,0,3,1
94838,1,1,332471,332473,332474,2,3,0
94839,1,1,332472,332474,332475,2,3,0
94840,5,2,332477,332477,332479,0,2,2
94841,1,2,332478,332479,332481,1,3,0
94842,4,3,332482,332482,332485,0,3,1
94843,2,2,332484,332485,332487,1,3,0
94844,4,3,332488,332488,332491,0,3,1
94845,3,2,332491,332491,332493,0,2,0
94846,5,1,332496,332496,332497,0,1,3
94847,6,2,332502,332502,332504,0,2,5
94848,6,3,332508,332508,332511,0,3,4
94849,3,1,332511,332511,332512,0,1,0
94850,4,3,332515,332515,332518,0,3,3
94851,4,3,332519,332519,332522,0,3,1
94852,4,2,332523,332523,332525,0,2,1
94853,5,1,332528,332528,332529,0,1,3
94854,3,2,332531,332531,332533,0,2,2
94855,2,3,332533,332533,332536,0,3,0
94856,2,2,332535,332536,332538,1,3,0
94857,3,2,332538,332538,332540,0,2,0
94858,4,3,332542,332542,332545,0,3,2
94859,3,2,332545,332545,332547,0,2,0
94860,4,2,332549,332549,332551,0,2,2
94861,4,3,332553,332553,332556,0,3,2
94862,4,3,332557,332557,332560,0,3,1
94863,6,2,332563,332563,332565,0,2,3
94864,5,2,332568,332568,332570,0,2,3
94865,2,2,332570,332570,332572,0,2,0
94866,6,1,332576,332576,332577,0,1,4
94867,4,1,332580,332580,332581,0,1,3
94868,6,1,332586,332586,332587,0,1,5
94869,4,1,332590,332590,332591,0,1,3
94870,4,3,332594,332594,332597,0,3,3
94871,4,2,332598,332598,332600,0,2,1
94872,2,3,332600,332600,332603,0,3,0
94873,4,2,332604,332604,332606,0,2,1
94874,3,3,332607,332607,332610,0,3,1
94875,1,1,332608,332610,332611,2,3,0
94876,5,2,332613,332613,332615,0,2,2
94877,3,1,332616,332616,332617,0,1,1
94878,4,2,332620,332620,332622,0,2,3
94879,1,2,332621,332622,332624,1,3,0
94880,4,2,332625,332625,332627,0,2,1
94881,5,1,332630,332630,332631,0,1,3
94882,5,1,332635,332635,332636,0,1,4
94883,2,1,332637,332637,332638,0,1,1
94884,5,2,332642,332642,332644,0,2,4
94885,3,1,332645,332645,332646,0,1,1
94886,2,2,332647,332647,332649,0,2,1
94887,2,1,332649,332649,332650,0,1,0
94888,3,2,332652,332652,332654,0,2,2
94889,6,3,332658,332658,332661,0,3,4
94890,5,2,332663,332663,332665,0,2,2
94891,2,1,332665,332665,332666,0,1,0
94892,6,1,332671,332671,332672,0,1,5
94893,2,2,332673,332673,332675,0,2,1
94894,4,3,332677,332677,332680,0,3,2
94895,1,2,332678,332680,332682,2,4,0
94896,4,1,332682,332682,332683,0,1,0
94897,2,2,332684,332684,332686,0,2,1
94898,3,3,332687,332687,332690,0,3,1
94899,5,3,332692,332692,332695,0,3,2
94900,2,1,332694,332695,332696,1,2,0
94901,1,2,332695,332696,332698,1,3,0
94902,2,1,332697,332698,332699,1,2,0
94903,2,3,332699,332699,332702,0,3,0
94904,6,1,332705,332705,332706,0,1,3
94905,3,3,332708,332708,332711,0,3,2
94906,6,3,332714,332714,332717,0,3,3
94907,4,1,332718,332718,332719,0,1,1
94908,6,1,332724,332724,332725,0,1,5
94909,5,2,332729,332729,332731,0,2,4
94910,4,3,332733,332733,332736,0,3,2
94911,2,1,332735,332736,332737,1,2,0
94912,6,1,332741,332741,332742,0,1,4
94913,2,1,332743,332743,332744,0,1,1
94914,4,3,332747,332747,332750,0,3,3
94915,6,3,332753,332753,332756,0,3,3
94916,3,2,332756,332756,332758,0,2,0
94917,4,2,332760,332760,332762,0,2,2
94918,5,1,332765,332765,332766,0,1,3
94919,6,1,332771,332771,332772,0,1,5
94920,6,3,332777,332777,332780,0,3,5
94921,6,2,332783,332783,332785,0,2,3
94922,4,3,332787,332787,332790,0,3,2
94923,5,2,332792,332792,332794,0,2,2
94924,2,2,332794,332794,332796,0,2,0
94925,6,2,332800,332800,332802,0,2,4
94926,5,1,332805,332805,332806,0,1,3
94927,2,2,332807,332807,332809,0,2,1
94928,3,1,332810,332810,332811,0,1,1
94929,3,2,332813,332813,332815,0,2,2
94930,3,2,332816,332816,332818,0,2,1
94931,3,2,332819,332819,332821,0,2,1
94932,5,1,332824,332824,332825,0,1,3
94933,1,1,332825,332825,332826,0,1,0
94934,4,2,332829,332829,332831,0,2,3
94935,3,3,332832,332832,332835,0,3,1
94936,4,3,332836,332836,332839,0,3,1
94937,5,1,332841,332841,332842,0,1,2
94938,4,2,332845,332845,332847,0,2,3
94939,4,1,332849,332849,332850,0,1,2
94940,4,2,332853,332853,332855,0,2,3
94941,5,3,332858,332858,332861,0,3,3
94942,4,3,332862,332862,332865,0,3,1
94943,5,1,332867,332867,332868,0,1,2
94944,1,2,332868,332868,332870,0,2,0
94945,3,1,332871,332871,332872,0,1,1
94946,4,1,332875,332875,332876,0,1,3
94947,5,2,332880,332880,332882,0,2,4
94948,1,2,332881,332882,332884,1,3,0
94949,1,1,332882,332884,332885,2,3,0
94950,3,3,332885,332885,332888,0,3,0
94951,5,1,332890,332890,332891,0,1,2
94952,1,3,332891,332891,332894,0,3,0
94953,1,1,332892,332894,332895,2,3,0
94954,2,1,332894,332895,332896,1,2,0
94955,1,2,332895,332896,332898,1,3,0
94956,3,1,332898,332898,332899,0,1,0
94957,6,2,332904,332904,332906,0,2,5
94958,5,2,332909,332909,332911,0,2,3
94959,6,2,332915,332915,332917,0,2,4
94960,3,3,332918,332918,332921,0,3,1
94961,6,3,332924,332924,332927,0,3,3
94962,4,3,332928,332928,332931,0,3,1
94963,1,1,332929,332931,332932,2,3,0
94964,3,2,332932,332932,332934,0,2,0
94965,5,1,332937,332937,332938,0,1,3
94966,4,2,332941,332941,332943,0,2,3
94967,2,2,332943,332943,332945,0,2,0
94968,2,1,332945,332945,332946,0,1,0
94969,3,1,332948,332948,332949,0,1,2
94970,4,2,332952,332952,332954,0,2,3
94971,4,3,332956,332956,332959,0,3,2
94972,3,3,332959,332959,332962,0,3,0
94973,6,1,332965,332965,332966,0,1,3
94974,5,3,332970,332970,332973,0,3,4
94975,5,1,332975,332975,332976,0,1,2
94976,3,1,332978,332978,332979,0,1,2
94977,2,3,332980,332980,332983,0,3,1
94978,3,1,332983,332983,332984,0,1,0
94979,2,3,332985,332985,332988,0,3,1
94980,4,2,332989,332989,332991,0,2,1
94981,4,3,332993,332993,332996,0,3,2
94982,4,3,332997,332997,333000,0,3,1
94983,3,1,333000,333000,333001,0,1,0
94984,1,3,333001,333001,333004,0,3,0
94985,2,2,333003,333004,333006,1,3,0
94986,5,3,333008,333008,333011,0,3,2
94987,3,2,333011,333011,333013,0,2,0
94988,2,1,333013,333013,333014,0,1,0
94989,2,2,333015,333015,333017,0,2,1
94990,4,3,333019,333019,333022,0,3,2
94991,4,3,333023,333023,333026,0,3,1
94992,5,1,333028,333028,333029,0,1,2
94993,6,1,333034,333034,333035,0,1,5
94994,5,3,333039,333039,333042,0,3,4
94995,3,1,333042,333042,333043,0,1,0
94996,1,1,333043,333043,333044,0,1,0
94997,2,1,333045,333045,333046,0,1,1
94998,3,1,333048,333048,333049,0,1,2
94999,3,2,333051,333051,333053,0,2,2
95000,3,1,333054,333054,333055,0,1,1
95001,4,3,333058,333058,333061,0,3,3
95002,3,1,333061,333061,333062,0,1,0
95003,3,1,333064,333064,333065,0,1,2
95004,1,2,333065,333065,333067,0,2,0
95005,6,1,333071,333071,333072,0,1,4
95006,6,1,333077,333077,333078,0,1,5
95007,5,1,333082,333082,333083,0,1,4
95008,3,1,333085,333085,333086,0,1,2
95009,3,2,333088,333088,333090,0,2,2
95010,1,1,333089,333090,333091,1,2,0
95011,2,3,333091,333091,333094,0,3,0
95012,3,3,333094,333094,333097,0,3,0
95013,1,1,333095,333097,333098,2,3,0
95014,1,3,333096,333098,333101,2,5,0
95015,3,2,333099,333101,333103,2,4,0
95016,3,2,333102,333103,333105,1,3,0
95017,4,1,333106,333106,333107,0,1,1
95018,5,2,333111,333111,333113,0,2,4
95019,6,3,333117,333117,333120,0,3,4
95020,4,1,333121,333121,333122,0,1,1
95021,4,3,333125,333125,333128,0,3,3
95022,6,1,333131,333131,333132,0,1,3
95023,6,3,333137,333137,333140,0,3,5
95024,1,1,333138,333140,333141,2,3,0
95025,3,1,333141,333141,333142,0,1,0
95026,2,2,333143,333143,333145,0,2,1
95027,4,3,333147,333147,333150,0,3,2
95028,1,3,333148,333150,333153,2,5,0
95029,4,2,333152,333153,333155,1,3,0
95030,1,2,333153,333155,333157,2,4,0
95031,4,1,333157,333157,333158,0,1,0
95032,3,2,333160,333160,333162,0,2,2
95033,1,2,333161,333162,333164,1,3,0
95034,4,2,333165,333165,333167,0,2,1
95035,5,1,333170,333170,333171,0,1,3
95036,2,2,333172,333172,333174,0,2,1
95037,4,2,333176,333176,333178,0,2,2
95038,5,1,333181,333181,333182,0,1,3
95039,6,2,333187,333187,333189,0,2,5
95040,1,3,333188,333189,333192,1,4,0
95041,6,1,333194,333194,333195,0,1,2
95042,4,3,333198,333198,333201,0,3,3
95043,3,3,333201,333201,333204,0,3,0
95044,4,1,333205,333205,333206,0,1,1
95045,4,1,333209,333209,333210,0,1,3
95046,3,3,333212,333212,333215,0,3,2
95047,2,1,333214,333215,333216,1,2,0
95048,6,2,333220,333220,333222,0,2,4
95049,6,2,333226,333226,333228,0,2,4
95050,3,2,333229,333229,333231,0,2,1
95051,6,1,333235,333235,333236,0,1,4
95052,2,1,333237,333237,333238,0,1,1
95053,3,3,333240,333240,333243,0,3,2
95054,3,1,333243,333243,333244,0,1,0
95055,6,2,333249,333249,333251,0,2,5
95056,3,3,333252,333252,333255,0,3,1
95057,1,1,333253,333255,333256,2,3,0
95058,2,1,333255,333256,333257,1,2,0
95059,2,1,333257,333257,333258,0,1,0
95060,5,3,333262,333262,333265,0,3,4
95061,6,3,333268,333268,333271,0,3,3
95062,1,1,333269,333271,333272,2,3,0
95063,1,3,333270,333272,333275,2,5,0
95064,3,1,333273,333275,333276,2,3,0
95065,6,2,333279,333279,333281,0,2,3
95066,5,2,333284,333284,333286,0,2,3
95067,3,2,333287,333287,333289,0,2,1
95068,3,1,333290,333290,333291,0,1,1
95069,2,1,333292,333292,333293,0,1,1
95070,2,3,333294,333294,333297,0,3,1
95071,3,1,333297,333297,333298,0,1,0
95072,6,2,333303,333303,333305,0,2,5
95073,1,1,333304,333305,333306,1,2,0
95074,2,2,333306,333306,333308,0,2,0
95075,1,2,333307,333308,333310,1,3,0
95076,1,2,333308,333310,333312,2,4,0
95077,6,1,333314,333314,333315,0,1,2
95078,6,3,333320,333320,333323,0,3,5
95079,6,3,333326,333326,333329,0,3,3
95080,1,3,333327,333329,333332,2,5,0
95081,5,2,333332,333332,333334,0,2,0
95082,5,1,333337,333337,333338,0,1,3
95083,4,1,333341,333341,333342,0,1,3
95084,6,1,333347,333347,333348,0,1,5
95085,6,1,333353,333353,333354,0,1,5
95086,6,3,333359,333359,333362,0,3,5
95087,3,3,333362,333362,333365,0,3,0
95088,6,3,333368,333368,333371,0,3,3
95089,3,1,333371,333371,333372,0,1,0
95090,1,1,333372,333372,333373,0,1,0
95091,6,3,333378,333378,333381,0,3,5
95092,6,1,333384,333384,333385,0,1,3
95093,5,1,333389,333389,333390,0,1,4
95094,6,3,333395,333395,333398,0,3,5
95095,2,3,333397,333398,333401,1,4,0
95096,6,1,333403,333403,333404,0,1,2
95097,3,3,333406,333406,333409,0,3,2
95098,1,2,333407,333409,333411,2,4,0
95099,4,2,333411,333411,333413,0,2,0
95100,2,3,333413,333413,333416,0,3,0
95101,2,3,333415,333416,333419,1,4,0
95102,4,3,333419,333419,333422,0,3,0
95103,6,2,333425,333425,333427,0,2,3
95104,2,3,333427,333427,333430,0,3,0
95105,2,3,333429,333430,333433,1,4,0
95106,2,3,333431,333433,333436,2,5,0
95107,4,2,333435,333436,333438,1,3,0
95108,4,1,333439,333439,333440,0,1,1
95109,4,2,333443,333443,333445,0,2,3
95110,6,2,333449,333449,333451,0,2,4
95111,1,2,333450,333451,333453,1,3,0
95112,2,1,333452,333453,333454,1,2,0
95113,4,1,333456,333456,333457,0,1,2
95114,2,3,333458,333458,333461,0,3,1
95115,3,3,333461,333461,333464,0,3,0
95116,6,3,333467,333467,333470,0,3,3
95117,4,2,333471,333471,333473,0,2,1
95118,5,2,333476,333476,333478,0,2,3
95119,1,3,333477,333478,333481,1,4,0
95120,5,2,333482,333482,333484,0,2,1
95121,1,3,333483,333484,333487,1,4,0
95122,6,2,333489,333489,333491,0,2,2
95123,3,1,333492,333492,333493,0,1,1
95124,3,1,333495,333495,333496,0,1,2
95125,5,3,333500,333500,333503,0,3,4
95126,2,1,333502,333503,333504,1,2,0
95127,4,1,333506,333506,333507,0,1,2
95128,4,3,333510,333510,333513,0,3,3
95129,3,1,333513,333513,333514,0,1,0
95130,5,3,333518,333518,333521,0,3,4
95131,3,2,333521,333521,333523,0,2,0
95132,1,1,333522,333523,333524,1,2,0
95133,6,1,333528,333528,333529,0,1,4
95134,3,1,333531,333531,333532,0,1,2
95135,6,3,333537,333537,333540,0,3,5
95136,4,1,333541,333541,333542,0,1,1
95137,1,1,333542,333542,333543,0,1,0
95138,2,1,333544,333544,333545,0,1,1
95139,3,3,333547,333547,333550,0,3,2
95140,2,2,333549,333550,333552,1,3,0
95141,5,3,333554,333554,333557,0,3,2
95142,3,3,333557,333557,333560,0,3,0
95143,6,1,333563,333563,333564,0,1,3
95144,5,1,333568,333568,333569,0,1,4
95145,4,1,333572,333572,333573,0,1,3
95146,2,1,333574,333574,333575,0,1,1
95147,3,2,333577,333577,333579,0,2,2
95148,6,3,333583,333583,333586,0,3,4
95149,5,3,333588,333588,333591,0,3,2
95150,5,2,333593,333593,333595,0,2,2
95151,6,3,333599,333599,333602,0,3,4
95152,2,1,333601,333602,333603,1,2,0
95153,3,3,333604,333604,333607,0,3,1
95154,5,3,333609,333609,333612,0,3,2
95155,6,3,333615,333615,333618,0,3,3
95156,2,1,333617,333618,333619,1,2,0
95157,1,2,333618,333619,333621,1,3,0
95158,1,1,333619,333621,333622,2,3,0
95159,6,2,333625,333625,333627,0,2,3
95160,2,2,333627,333627,333629,0,2,0
95161,4,1,333631,333631,333632,0,1,2
95162,5,1,333636,333636,333637,0,1,4
95163,6,1,333642,333642,333643,0,1,5
95164,3,1,333645,333645,333646,0,1,2
95165,2,1,333647,333647,333648,0,1,1
95166,3,1,333650,333650,333651,0,1,2
95167,6,3,333656,333656,333659,0,3,5
95168,4,2,333660,333660,333662,0,2,1
95169,6,2,333666,333666,333668,0,2,4
95170,4,2,333670,333670,333672,0,2,2
95171,5,2,333675,333675,333677,0,2,3
95172,6,2,333681,333681,333683,0,2,4
95173,4,3,333685,333685,333688,0,3,2
95174,3,1,333688,333688,333689,0,1,0
95175,3,2,333691,333691,333693,0,2,2
95176,4,3,333695,333695,333698,0,3,2
95177,4,1,333699,333699,333700,0,1,1
95178,6,1,333705,333705,333706,0,1,5
95179,2,3,333707,333707,333710,0,3,1
95180,6,3,333713,333713,333716,0,3,3
95181,4,2,333717,333717,333719,0,2,1
95182,2,3,333719,333719,333722,0,3,0
95183,3,1,333722,333722,333723,0,1,0
95184,5,3,333727,333727,333730,0,3,4
95185,3,1,333730,333730,333731,0,1,0
95186,1,1,333731,333731,333732,0,1,0
95187,3,2,333734,333734,333736,0,2,2
95188,5,2,333739,333739,333741,0,2,3
95189,6,3,333745,333745,333748,0,3,4
95190,1,3,333746,333748,333751,2,5,0
95191,5,2,333751,333751,333753,0,2,0
95192,2,2,333753,333753,333755,0,2,0
95193,2,2,333755,333755,333757,0,2,0
95194,5,1,333760,333760,333761,0,1,3
95195,1,1,333761,333761,333762,0,1,0
95196,2,1,333763,333763,333764,0,1,1
95197,2,3,333765,333765,333768,0,3,1
95198,4,1,333769,333769,333770,0,1,1
95199,1,3,333770,333770,333773,0,3,0
95200,5,3,333775,333775,333778,0,3,2
95201,6,3,333781,333781,333784,0,3,3
95202,6,1,333787,333787,333788,0,1,3
95203,3,1,333790,333790,333791,0,1,2
95204,1,3,333791,333791,333794,0,3,0
95205,1,3,333792,333794,333797,2,5,0
95206,6,2,333798,333798,333800,0,2,1
95207,6,2,333804,333804,333806,0,2,4
95208,2,1,333806,333806,333807,0,1,0
95209,6,1,333812,333812,333813,0,1,5
95210,6,2,333818,333818,333820,0,2,5
95211,5,2,333823,333823,333825,0,2,3
95212,2,2,333825,333825,333827,0,2,0
95213,3,2,333828,333828,333830,0,2,1
95214,6,3,333834,333834,333837,0,3,4
95215,3,2,333837,333837,333839,0,2,0
95216,6,3,333843,333843,333846,0,3,4
95217,3,3,333846,333846,333849,0,3,0
95218,2,2,333848,333849,333851,1,3,0
95219,1,1,333849,333851,333852,2,3,0
95220,1,1,333850,333852,333853,2,3,0
95221,3,1,333853,333853,333854,0,1,0
95222,3,2,333856,333856,333858,0,2,2
95223,2,2,333858,333858,333860,0,2,0
95224,4,1,333862,333862,333863,0,1,2
95225,5,1,333867,333867,333868,0,1,4
95226,6,2,333873,333873,333875,0,2,5
95227,1,1,333874,333875,333876,1,2,0
95228,3,1,333877,333877,333878,0,1,1
95229,1,2,333878,333878,333880,0,2,0
95230,3,3,333881,333881,333884,0,3,1
95231,5,2,333886,333886,333888,0,2,2
95232,2,2,333888,333888,333890,0,2,0
95233,2,2,333890,333890,333892,0,2,0
95234,5,3,333895,333895,333898,0,3,3
95235,5,2,333900,333900,333902,0,2,2
95236,1,3,333901,333902,333905,1,4,0
95237,1,2,333902,333905,333907,3,5,0
95238,6,1,333908,333908,333909,0,1,1
95239,1,1,333909,333909,333910,0,1,0
95240,3,2,333912,333912,333914,0,2,2
95241,1,2,333913,333914,333916,1,3,0
95242,1,3,333914,333916,333919,2,5,0
95243,6,1,333920,333920,333921,0,1,1
95244,3,1,333923,333923,333924,0,1,2
95245,4,3,333927,333927,333930,0,3,3
95246,3,2,333930,333930,333932,0,2,0
95247,2,3,333932,333932,333935,0,3,0
95248,5,3,333937,333937,333940,0,3,2
95249,1,3,333938,333940,333943,2,5,0
95250,5,2,333943,333943,333945,0,2,0
95251,5,2,333948,333948,333950,0,2,3
95252,3,1,333951,333951,333952,0,1,1
95253,1,3,333952,333952,333955,0,3,0
95254,2,3,333954,333955,333958,1,4,0
95255,5,1,333959,333959,333960,0,1,1
95256,2,1,333961,333961,333962,0,1,1
95257,3,2,333964,333964,333966,0,2,2
95258,4,1,333968,333968,333969,0,1,2
95259,1,3,333969,333969,333972,0,3,0
95260,5,1,333974,333974,333975,0,1,2
95261,5,2,333979,333979,333981,0,2,4
95262,1,2,333980,333981,333983,1,3,0
95263,5,3,333985,333985,333988,0,3,2
95264,1,1,333986,333988,333989,2,3,0
95265,6,1,333992,333992,333993,0,1,3
95266,3,2,333995,333995,333997,0,2,2
95267,2,3,333997,333997,334000,0,3,0
95268,3,3,334000,334000,334003,0,3,0
95269,1,3,334001,334003,334006,2,5,0
95270,1,1,334002,334006,334007,4,5,0
95271,1,2,334003,334007,334009,4,6,0
95272,2,1,334005,334009,334010,4,5,0
95273,1,3,334006,334010,334013,4,7,0
95274,4,1,334010,334013,334014,3,4,0
95275,5,3,334015,334015,334018,0,3,1
95276,3,1,334018,334018,334019,0,1,0
95277,6,1,334024,334024,334025,0,1,5
95278,2,2,334026,334026,334028,0,2,1
95279,1,1,334027,334028,334029,1,2,0
95280,6,2,334033,334033,334035,0,2,4
95281,5,1,334038,334038,334039,0,1,3
95282,3,2,334041,334041,334043,0,2,2
95283,2,1,334043,334043,334044,0,1,0
95284,3,1,334046,334046,334047,0,1,2
95285,6,2,334052,334052,334054,0,2,5
95286,4,3,334056,334056,334059,0,3,2
95287,2,1,334058,334059,334060,1,2,0
95288,2,3,334060,334060,334063,0,3,0
95289,4,1,334064,334064,334065,0,1,1
95290,1,2,334065,334065,334067,0,2,0
95291,6,3,334071,334071,334074,0,3,4
95292,6,2,334077,334077,334079,0,2,3
95293,1,1,334078,334079,334080,1,2,0
95294,5,2,334083,334083,334085,0,2,3
95295,3,1,334086,334086,334087,0,1,1
95296,5,3,334091,334091,334094,0,3,4
95297,3,2,334094,334094,334096,0,2,0
95298,3,1,334097,334097,334098,0,1,1
95299,3,2,334100,334100,334102,0,2,2
95300,6,3,334106,334106,334109,0,3,4
95301,2,2,334108,334109,334111,1,3,0
95302,3,2,334111,334111,334113,0,2,0
95303,6,2,334117,334117,334119,0,2,4
95304,1,3,334118,334119,334122,1,4,0
95305,3,3,334121,334122,334125,1,4,0
95306,3,1,334124,334125,334126,1,2,0
95307,5,1,334129,334129,334130,0,1,3
95308,5,2,334134,334134,334136,0,2,4
95309,5,1,334139,334139,334140,0,1,3
95310,5,1,334144,334144,334145,0,1,4
95311,6,2,334150,334150,334152,0,2,5
95312,4,3,334154,334154,334157,0,3,2
95313,5,2,334159,334159,334161,0,2,2
95314,6,2,334165,334165,334167,0,2,4
95315,4,2,334169,334169,334171,0,2,2
95316,4,2,334173,334173,334175,0,2,2
95317,6,2,334179,334179,334181,0,2,4
95318,2,2,334181,334181,334183,0,2,0
95319,1,3,334182,334183,334186,1,4,0
95320,5,2,334187,334187,334189,0,2,1
95321,3,1,334190,334190,334191,0,1,1
95322,2,2,334192,334192,334194,0,2,1
95323,1,3,334193,334194,334197,1,4,0
95324,5,1,334198,334198,334199,0,1,1
95325,6,1,334204,334204,334205,0,1,5
95326,4,3,334208,334208,334211,0,3,3
95327,5,1,334213,334213,334214,0,1,2
95328,3,3,334216,334216,334219,0,3,2
95329,3,2,334219,334219,334221,0,2,0
95330,1,2,334220,334221,334223,1,3,0
95331,4,3,334224,334224,334227,0,3,1
95332,1,3,334225,334227,334230,2,5,0
95333,3,1,334228,334230,334231,2,3,0
95334,1,1,334229,334231,334232,2,3,0
95335,2,2,334231,334232,334234,1,3,0
95336,5,1,334236,334236,334237,0,1,2
95337,5,1,334241,334241,334242,0,1,4
95338,3,2,334244,334244,334246,0,2,2
95339,4,1,334248,334248,334249,0,1,2
95340,5,2,334253,334253,334255,0,2,4
95341,1,1,334254,334255,334256,1,2,0
95342,3,1,334257,334257,334258,0,1,1
95343,1,1,334258,334258,334259,0,1,0
95344,2,3,334260,334260,334263,0,3,1
95345,1,1,334261,334263,334264,2,3,0
95346,4,3,334265,334265,334268,0,3,1
95347,1,2,334266,334268,334270,2,4,0
95348,1,3,334267,334270,334273,3,6,0
95349,1,3,334268,334273,334276,5,8,0
95350,6,1,334274,334276,334277,2,3,0
95351,1,1,334275,334277,334278,2,3,0
95352,1,2,334276,334278,334280,2,4,0
95353,4,3,334280,334280,334283,0,3,0
95354,1,3,334281,334283,334286,2,5,0
95355,6,3,334287,334287,334290,0,3,1
95356,3,3,334290,334290,334293,0,3,0
95357,3,1,334293,334293,334294,0,1,0
95358,2,3,334295,334295,334298,0,3,1
95359,1,3,334296,334298,334301,2,5,0
95360,6,3,334302,334302,334305,0,3,1
95361,1,1,334303,334305,334306,2,3,0
95362,2,2,334305,334306,334308,1,3,0
95363,2,3,334307,334308,334311,1,4,0
95364,4,1,334311,334311,334312,0,1,0
95365,2,2,334313,334313,334315,0,2,1
95366,2,3,334315,334315,334318,0,3,0
95367,2,1,334317,334318,334319,1,2,0
95368,3,1,334320,334320,334321,0,1,1
95369,5,1,334325,334325,334326,0,1,4
95370,1,2,334326,334326,334328,0,2,0
95371,2,2,334328,334328,334330,0,2,0
95372,2,1,334330,334330,334331,0,1,0
95373,6,1,334336,334336,334337,0,1,5
95374,4,3,334340,334340,334343,0,3,3
95375,1,1,334341,334343,334344,2,3,0
95376,2,3,334343,334344,334347,1,4,0
95377,1,2,334344,334347,334349,3,5,0
95378,5,2,334349,334349,334351,0,2,0
95379,6,1,334355,334355,334356,0,1,4
95380,5,1,334360,334360,334361,0,1,4
95381,1,1,334361,334361,334362,0,1,0
95382,6,1,334367,334367,334368,0,1,5
95383,5,3,334372,334372,334375,0,3,4
95384,2,3,334374,334375,334378,1,4,0
95385,1,2,334375,334378,334380,3,5,0
95386,2,3,334377,334380,334383,3,6,0
95387,4,3,334381,334383,334386,2,5,0
95388,2,2,334383,334386,334388,3,5,0
95389,3,2,334386,334388,334390,2,4,0
95390,3,3,334389,334390,334393,1,4,0
95391,2,2,334391,334393,334395,2,4,0
95392,5,3,334396,334396,334399,0,3,1
95393,4,1,334400,334400,334401,0,1,1
95394,4,2,334404,334404,334406,0,2,3
95395,4,3,334408,334408,334411,0,3,2
95396,2,3,334410,334411,334414,1,4,0
95397,3,3,334413,334414,334417,1,4,0
95398,1,2,334414,334417,334419,3,5,0
95399,5,1,334419,334419,334420,0,1,0
95400,4,1,334423,334423,334424,0,1,3
95401,4,2,334427,334427,334429,0,2,3
95402,6,2,334433,334433,334435,0,2,4
95403,5,1,334438,334438,334439,0,1,3
95404,3,2,334441,334441,334443,0,2,2
95405,3,1,334444,334444,334445,0,1,1
95406,4,2,334448,334448,334450,0,2,3
95407,6,3,334454,334454,334457,0,3,4
95408,2,1,334456,334457,334458,1,2,0
95409,6,1,334462,334462,334463,0,1,4
95410,5,1,334467,334467,334468,0,1,4
95411,4,3,334471,334471,334474,0,3,3
95412,6,2,334477,334477,334479,0,2,3
95413,4,2,334481,334481,334483,0,2,2
95414,1,1,334482,334483,334484,1,2,0
95415,1,2,334483,334484,334486,1,3,0
95416,4,3,334487,334487,334490,0,3,1
95417,4,1,334491,334491,334492,0,1,1
95418,5,3,334496,334496,334499,0,3,4
95419,3,3,334499,334499,334502,0,3,0
95420,1,3,334500,334502,334505,2,5,0
95421,5,2,334505,334505,334507,0,2,0
95422,6,1,334511,334511,334512,0,1,4
95423,5,2,334516,334516,334518,0,2,4
95424,5,3,334521,334521,334524,0,3,3
95425,5,2,334526,334526,334528,0,2,2
95426,6,3,334532,334532,334535,0,3,4
95427,6,3,334538,334538,334541,0,3,3
95428,2,1,334540,334541,334542,1,2,0
95429,5,1,334545,334545,334546,0,1,3
95430,6,2,334551,334551,334553,0,2,5
95431,5,3,334556,334556,334559,0,3,3
95432,5,3,334561,334561,334564,0,3,2
95433,5,3,334566,334566,334569,0,3,2
95434,4,2,334570,334570,334572,0,2,1
95435,5,3,334575,334575,334578,0,3,3
95436,1,3,334576,334578,334581,2,5,0
95437,5,2,334581,334581,334583,0,2,0
95438,6,1,334587,334587,334588,0,1,4
95439,6,1,334593,334593,334594,0,1,5
95440,5,1,334598,334598,334599,0,1,4
95441,1,3,334599,334599,334602,0,3,0
95442,1,2,334600,334602,334604,2,4,0
95443,1,2,334601,334604,334606,3,5,0
95444,3,1,334604,334606,334607,2,3,0
95445,6,3,334610,334610,334613,0,3,3
95446,4,3,334614,334614,334617,0,3,1
95447,2,3,334616,334617,334620,1,4,0
95448,6,1,334622,334622,334623,0,1,2
95449,5,2,334627,334627,334629,0,2,4
95450,3,2,334630,334630,334632,0,2,1
95451,4,3,334634,334634,334637,0,3,2
95452,6,2,334640,334640,334642,0,2,3
95453,1,2,334641,334642,334644,1,3,0
95454,4,1,334645,334645,334646,0,1,1
95455,4,2,334649,334649,334651,0,2,3
95456,5,3,334654,334654,334657,0,3,3
95457,5,2,334659,334659,334661,0,2,2
95458,3,2,334662,334662,334664,0,2,1
95459,2,1,334664,334664,334665,0,1,0
95460,2,1,334666,334666,334667,0,1,1
95461,2,2,334668,334668,334670,0,2,1
95462,6,2,334674,334674,334676,0,2,4
95463,1,2,334675,334676,334678,1,3,0
95464,2,3,334677,334678,334681,1,4,0
95465,1,2,334678,334681,334683,3,5,0
95466,6,2,334684,334684,334686,0,2,1
95467,2,1,334686,334686,334687,0,1,0
95468,4,1,334690,334690,334691,0,1,3
95469,6,3,334696,334696,334699,0,3,5
95470,5,3,334701,334701,334704,0,3,2
95471,1,2,334702,334704,334706,2,4,0
95472,6,1,334708,334708,334709,0,1,2
95473,4,2,334712,334712,334714,0,2,3
95474,3,1,334715,334715,334716,0,1,1
95475,1,1,334716,334716,334717,0,1,0
95476,5,3,334721,334721,334724,0,3,4
95477,1,1,334722,334724,334725,2,3,0
95478,2,1,334724,334725,334726,1,2,0
95479,4,2,334728,334728,334730,0,2,2
95480,4,1,334732,334732,334733,0,1,2
95481,6,1,334738,334738,334739,0,1,5
95482,4,2,334742,334742,334744,0,2,3
95483,3,3,334745,334745,334748,0,3,1
95484,4,3,334749,334749,334752,0,3,1
95485,2,3,334751,334752,334755,1,4,0
95486,4,2,334755,334755,334757,0,2,0
95487,6,1,334761,334761,334762,0,1,4
95488,2,2,334763,334763,334765,0,2,1
95489,4,1,334767,334767,334768,0,1,2
95490,2,1,334769,334769,334770,0,1,1
95491,5,2,334774,334774,334776,0,2,4
95492,4,3,334778,334778,334781,0,3,2
95493,2,3,334780,334781,334784,1,4,0
95494,4,1,334784,334784,334785,0,1,0
95495,6,3,334790,334790,334793,0,3,5
95496,1,3,334791,334793,334796,2,5,0
95497,6,3,334797,334797,334800,0,3,1
95498,5,1,334802,334802,334803,0,1,2
95499,5,3,334807,334807,334810,0,3,4
95500,1,3,334808,334810,334813,2,5,0
95501,6,3,334814,334814,334817,0,3,1
95502,6,2,334820,334820,334822,0,2,3
95503,2,1,334822,334822,334823,0,1,0
95504,3,2,334825,334825,334827,0,2,2
95505,4,3,334829,334829,334832,0,3,2
95506,1,2,334830,334832,334834,2,4,0
95507,4,2,334834,334834,334836,0,2,0
95508,1,1,334835,334836,334837,1,2,0
95509,4,1,334839,334839,334840,0,1,2
95510,6,2,334845,334845,334847,0,2,5
95511,6,1,334851,334851,334852,0,1,4
95512,2,1,334853,334853,334854,0,1,1
95513,1,2,334854,334854,334856,0,2,0
95514,4,1,334858,334858,334859,0,1,2
95515,1,2,334859,334859,334861,0,2,0
95516,1,2,334860,334861,334863,1,3,0
95517,5,1,334865,334865,334866,0,1,2
95518,2,3,334867,334867,334870,0,3,1
95519,4,3,334871,334871,334874,0,3,1
95520,5,2,334876,334876,334878,0,2,2
95521,6,3,334882,334882,334885,0,3,4
95522,1,1,334883,334885,334886,2,3,0
95523,2,3,334885,334886,334889,1,4,0
95524,3,1,334888,334889,334890,1,2,0
95525,3,1,334891,334891,334892,0,1,1
95526,5,3,334896,334896,334899,0,3,4
95527,5,2,334901,334901,334903,0,2,2
95528,3,2,334904,334904,334906,0,2,1
95529,3,1,334907,334907,334908,0,1,1
95530,3,2,334910,334910,334912,0,2,2
95531,1,3,334911,334912,334915,1,4,0
95532,5,1,334916,334916,334917,0,1,1
95533,5,3,334921,334921,334924,0,3,4
95534,6,3,334927,334927,334930,0,3,3
95535,4,1,334931,334931,334932,0,1,1
95536,3,3,334934,334934,334937,0,3,2
95537,4,3,334938,334938,334941,0,3,1
95538,6,2,334944,334944,334946,0,2,3
95539,3,1,334947,334947,334948,0,1,1
95540,6,1,334953,334953,334954,0,1,5
95541,6,3,334959,334959,334962,0,3,5
95542,5,1,334964,334964,334965,0,1,2
95543,3,2,334967,334967,334969,0,2,2
95544,5,1,334972,334972,334973,0,1,3
95545,4,1,334976,334976,334977,0,1,3
95546,4,3,334980,334980,334983,0,3,3
95547,6,2,334986,334986,334988,0,2,3
95548,6,2,334992,334992,334994,0,2,4
95549,2,1,334994,334994,334995,0,1,0
95550,1,3,334995,334995,334998,0,3,0
95551,4,2,334999,334999,335001,0,2,1
95552,4,3,335003,335003,335006,0,3,2
95553,3,1,335006,335006,335007,0,1,0
95554,4,1,335010,335010,335011,0,1,3
95555,3,1,335013,335013,335014,0,1,2
95556,1,3,335014,335014,335017,0,3,0
95557,3,2,335017,335017,335019,0,2,0
95558,2,1,335019,335019,335020,0,1,0
95559,6,2,335025,335025,335027,0,2,5
95560,2,2,335027,335027,335029,0,2,0
95561,3,3,335030,335030,335033,0,3,1
95562,5,2,335035,335035,335037,0,2,2
95563,2,1,335037,335037,335038,0,1,0
95564,4,3,335041,335041,335044,0,3,3
95565,3,2,335044,335044,335046,0,2,0
95566,4,1,335048,335048,335049,0,1,2
95567,5,3,335053,335053,335056,0,3,4
95568,4,2,335057,335057,335059,0,2,1
95569,5,3,335062,335062,335065,0,3,3
95570,1,2,335063,335065,335067,2,4,0
95571,3,3,335066,335067,335070,1,4,0
95572,5,3,335071,335071,335074,0,3,1
95573,5,3,335076,335076,335079,0,3,2
95574,3,3,335079,335079,335082,0,3,0
95575,4,3,335083,335083,335086,0,3,1
95576,6,1,335089,335089,335090,0,1,3
95577,2,3,335091,335091,335094,0,3,1
95578,5,1,335096,335096,335097,0,1,2
95579,3,1,335099,335099,335100,0,1,2
95580,3,1,335102,335102,335103,0,1,2
95581,6,3,335108,335108,335111,0,3,5
95582,5,3,335113,335113,335116,0,3,2
95583,5,1,335118,335118,335119,0,1,2
95584,4,3,335122,335122,335125,0,3,3
95585,4,3,335126,335126,335129,0,3,1
95586,1,1,335127,335129,335130,2,3,0
95587,1,3,335128,335130,335133,2,5,0
95588,3,3,335131,335133,335136,2,5,0
95589,4,1,335135,335136,335137,1,2,0
95590,5,2,335140,335140,335142,0,2,3
95591,6,3,335146,335146,335149,0,3,4
95592,5,3,335151,335151,335154,0,3,2
95593,2,2,335153,335154,335156,1,3,0
95594,3,1,335156,335156,335157,0,1,0
95595,2,2,335158,335158,335160,0,2,1
95596,2,2,335160,335160,335162,0,2,0
95597,1,2,335161,335162,335164,1,3,0
95598,2,2,335163,335164,335166,1,3,0
95599,5,2,335168,335168,335170,0,2,2
95600,5,3,335173,335173,335176,0,3,3
95601,3,1,335176,335176,335177,0,1,0
95602,2,3,335178,335178,335181,0,3,1
95603,4,3,335182,335182,335185,0,3,1
95604,4,1,335186,335186,335187,0,1,1
95605,4,1,335190,335190,335191,0,1,3
95606,1,1,335191,335191,335192,0,1,0
95607,6,3,335197,335197,335200,0,3,5
95608,6,3,335203,335203,335206,0,3,3
95609,4,2,335207,335207,335209,0,2,1
95610,3,3,335210,335210,335213,0,3,1
95611,3,2,335213,335213,335215,0,2,0
95612,2,3,335215,335215,335218,0,3,0
95613,3,3,335218,335218,335221,0,3,0
95614,5,3,335223,335223,335226,0,3,2
95615,3,2,335226,335226,335228,0,2,0
95616,1,3,335227,335228,335231,1,4,0
95617,3,3,335230,335231,335234,1,4,0
95618,1,3,335231,335234,335237,3,6,0
95619,3,1,335234,335237,335238,3,4,0
95620,1,3,335235,335238,335241,3,6,0
95621,6,2,335241,335241,335243,0,2,0
95622,5,1,335246,335246,335247,0,1,3
95623,4,3,335250,335250,335253,0,3,3
95624,6,1,335256,335256,335257,0,1,3
95625,5,1,335261,335261,335262,0,1,4
95626,6,2,335267,335267,335269,0,2,5
95627,6,2,335273,335273,335275,0,2,4
95628,3,3,335276,335276,335279,0,3,1
95629,3,1,335279,335279,335280,0,1,0
95630,1,2,335280,335280,335282,0,2,0
95631,5,1,335285,335285,335286,0,1,3
95632,3,1,335288,335288,335289,0,1,2
95633,4,3,335292,335292,335295,0,3,3
95634,2,1,335294,335295,335296,1,2,0
95635,6,2,335300,335300,335302,0,2,4
95636,2,3,335302,335302,335305,0,3,0
95637,1,3,335303,335305,335308,2,5,0
95638,2,2,335305,335308,335310,3,5,0
95639,2,3,335307,335310,335313,3,6,0
95640,2,3,335309,335313,335316,4,7,0
95641,5,2,335314,335316,335318,2,4,0
95642,3,3,335317,335318,335321,1,4,0
95643,5,2,335322,335322,335324,0,2,1
95644,6,1,335328,335328,335329,0,1,4
95645,1,3,335329,335329,335332,0,3,0
95646,3,1,335332,335332,335333,0,1,0
95647,2,2,335334,335334,335336,0,2,1
95648,1,2,335335,335336,335338,1,3,0
95649,5,1,335340,335340,335341,0,1,2
95650,3,1,335343,335343,335344,0,1,2
95651,2,1,335345,335345,335346,0,1,1
95652,5,3,335350,335350,335353,0,3,4
95653,5,2,335355,335355,335357,0,2,2
95654,2,2,335357,335357,335359,0,2,0
95655,4,1,335361,335361,335362,0,1,2
95656,6,3,335367,335367,335370,0,3,5
95657,1,1,335368,335370,335371,2,3,0
95658,2,3,335370,335371,335374,1,4,0
95659,2,3,335372,335374,335377,2,5,0
95660,3,1,335375,335377,335378,2,3,0
95661,4,3,335379,335379,335382,0,3,1
95662,4,1,335383,335383,335384,0,1,1
95663,6,2,335389,335389,335391,0,2,5
95664,2,1,335391,335391,335392,0,1,0
95665,6,3,335397,335397,335400,0,3,5
95666,6,3,335403,335403,335406,0,3,3
95667,1,1,335404,335406,335407,2,3,0
95668,6,3,335410,335410,335413,0,3,3
95669,1,3,335411,335413,335416,2,5,0
95670,2,2,335413,335416,335418,3,5,0
95671,5,1,335418,335418,335419,0,1,0
95672,5,2,335423,335423,335425,0,2,4
95673,2,1,335425,335425,335426,0,1,0
95674,3,3,335428,335428,335431,0,3,2
95675,3,3,335431,335431,335434,0,3,0
95676,6,2,335437,335437,335439,0,2,3
95677,4,3,335441,335441,335444,0,3,2
95678,1,2,335442,335444,335446,2,4,0
95679,6,2,335448,335448,335450,0,2,2
95680,2,2,335450,335450,335452,0,2,0
95681,4,3,335454,335454,335457,0,3,2
95682,2,3,335456,335457,335460,1,4,0
95683,2,3,335458,335460,335463,2,5,0
95684,6,3,335464,335464,335467,0,3,1
95685,4,1,335468,335468,335469,0,1,1
95686,3,3,335471,335471,335474,0,3,2
95687,3,3,335474,335474,335477,0,3,0
95688,5,1,335479,335479,335480,0,1,2
95689,4,3,335483,335483,335486,0,3,3
95690,2,1,335485,335486,335487,1,2,0
95691,4,1,335489,335489,335490,0,1,2
95692,3,2,335492,335492,335494,0,2,2
95693,1,3,335493,335494,335497,1,4,0
95694,3,3,335496,335497,335500,1,4,0
95695,1,3,335497,335500,335503,3,6,0
95696,5,2,335502,335503,335505,1,3,0
95697,1,3,335503,335505,335508,2,5,0
95698,1,3,335504,335508,335511,4,7,0
95699,2,3,335506,335511,335514,5,8,0
95700,5,1,335511,335514,335515,3,4,0
95701,4,1,335515,335515,335516,0,1,0
95702,4,2,335519,335519,335521,0,2,3
95703,6,2,335525,335525,335527,0,2,4
95704,2,3,335527,335527,335530,0,3,0
95705,2,1,335529,335530,335531,1,2,0
95706,4,3,335533,335533,335536,0,3,2
95707,1,1,335534,335536,335537,2,3,0
95708,4,1,335538,335538,335539,0,1,1
95709,4,1,335542,335542,335543,0,1,3
95710,6,2,335548,335548,335550,0,2,5
95711,3,3,335551,335551,335554,0,3,1
95712,2,2,335553,335554,335556,1,3,0
95713,2,3,335555,335556,335559,1,4,0
95714,6,2,335561,335561,335563,0,2,2
95715,6,1,335567,335567,335568,0,1,4
95716,1,3,335568,335568,335571,0,3,0
95717,5,1,335573,335573,335574,0,1,2
95718,3,2,335576,335576,335578,0,2,2
95719,1,1,335577,335578,335579,1,2,0
95720,4,2,335581,335581,335583,0,2,2
95721,3,1,335584,335584,335585,0,1,1
95722,4,3,335588,335588,335591,0,3,3
95723,5,1,335593,335593,335594,0,1,2
95724,2,3,335595,335595,335598,0,3,1
95725,5,3,335600,335600,335603,0,3,2
95726,5,2,335605,335605,335607,0,2,2
95727,5,1,335610,335610,335611,0,1,3
95728,5,3,335615,335615,335618,0,3,4
95729,2,2,335617,335618,335620,1,3,0
95730,4,3,335621,335621,335624,0,3,1
95731,4,2,335625,335625,335627,0,2,1
95732,4,3,335629,335629,335632,0,3,2
95733,6,1,335635,335635,335636,0,1,3
95734,1,2,335636,335636,335638,0,2,0
95735,1,1,335637,335638,335639,1,2,0
95736,3,1,335640,335640,335641,0,1,1
95737,3,1,335643,335643,335644,0,1,2
95738,2,2,335645,335645,335647,0,2,1
95739,2,2,335647,335647,335649,0,2,0
95740,6,3,335653,335653,335656,0,3,4
95741,2,1,335655,335656,335657,1,2,0
95742,5,1,335660,335660,335661,0,1,3
95743,5,1,335665,335665,335666,0,1,4
95744,6,2,335671,335671,335673,0,2,5
95745,6,3,335677,335677,335680,0,3,4
95746,4,3,335681,335681,335684,0,3,1
95747,1,1,335682,335684,335685,2,3,0
95748,6,3,335688,335688,335691,0,3,3
95749,4,2,335692,335692,335694,0,2,1
95750,4,2,335696,335696,335698,0,2,2
95751,5,3,335701,335701,335704,0,3,3
95752,6,2,335707,335707,335709,0,2,3
95753,3,1,335710,335710,335711,0,1,1
95754,1,1,335711,335711,335712,0,1,0
95755,2,3,335713,335713,335716,0,3,1
95756,4,3,335717,335717,335720,0,3,1
95757,2,1,335719,335720,335721,1,2,0
95758,3,2,335722,335722,335724,0,2,1
95759,5,3,335727,335727,335730,0,3,3
95760,3,3,335730,335730,335733,0,3,0
95761,2,2,335732,335733,335735,1,3,0
95762,6,3,335738,335738,335741,0,3,3
95763,3,2,335741,335741,335743,0,2,0
95764,2,1,335743,335743,335744,0,1,0
95765,1,3,335744,335744,335747,0,3,0
95766,5,2,335749,335749,335751,0,2,2
95767,6,3,335755,335755,335758,0,3,4
95768,6,1,335761,335761,335762,0,1,3
95769,5,1,335766,335766,335767,0,1,4
95770,2,2,335768,335768,335770,0,2,1
95771,1,2,335769,335770,335772,1,3,0
95772,2,3,335771,335772,335775,1,4,0
95773,6,2,335777,335777,335779,0,2,2
95774,5,2,335782,335782,335784,0,2,3
95775,4,3,335786,335786,335789,0,3,2
95776,1,3,335787,335789,335792,2,5,0
95777,1,1,335788,335792,335793,4,5,0
95778,1,2,335789,335793,335795,4,6,0
95779,1,2,335790,335795,335797,5,7,0
95780,3,2,335793,335797,335799,4,6,0
95781,3,3,335796,335799,335802,3,6,0
95782,1,3,335797,335802,335805,5,8,0
95783,3,3,335800,335805,335808,5,8,0
95784,4,2,335804,335808,335810,4,6,0
95785,1,3,335805,335810,335813,5,8,0
95786,2,2,335807,335813,335815,6,8,0
95787,6,2,335813,335815,335817,2,4,0
95788,1,2,335814,335817,335819,3,5,0
95789,6,2,335820,335820,335822,0,2,1
95790,3,2,335823,335823,335825,0,2,1
95791,2,2,335825,335825,335827,0,2,0
95792,4,2,335829,335829,335831,0,2,2
95793,1,1,335830,335831,335832,1,2,0
95794,5,3,335835,335835,335838,0,3,3
95795,6,1,335841,335841,335842,0,1,3
95796,4,2,335845,335845,335847,0,2,3
95797,3,3,335848,335848,335851,0,3,1
95798,1,2,335849,335851,335853,2,4,0
95799,6,3,335855,335855,335858,0,3,2
95800,2,2,335857,335858,335860,1,3,0
95801,5,1,335862,335862,335863,0,1,2
95802,2,1,335864,335864,335865,0,1,1
95803,1,3,335865,335865,335868,0,3,0
95804,5,2,335870,335870,335872,0,2,2
95805,1,2,335871,335872,335874,1,3,0
95806,3,2,335874,335874,335876,0,2,0
95807,1,1,335875,335876,335877,1,2,0
95808,6,1,335881,335881,335882,0,1,4
95809,3,2,335884,335884,335886,0,2,2
95810,4,1,335888,335888,335889,0,1,2
95811,1,3,335889,335889,335892,0,3,0
95812,5,1,335894,335894,335895,0,1,2
95813,3,3,335897,335897,335900,0,3,2
95814,2,2,335899,335900,335902,1,3,0
95815,3,2,335902,335902,335904,0,2,0
95816,4,2,335906,335906,335908,0,2,2
95817,6,1,335912,335912,335913,0,1,4
95818,2,2,335914,335914,335916,0,2,1
95819,3,1,335917,335917,335918,0,1,1
95820,2,1,335919,335919,335920,0,1,1
95821,3,1,335922,335922,335923,0,1,2
95822,4,2,335926,335926,335928,0,2,3
95823,4,2,335930,335930,335932,0,2,2
95824,4,1,335934,335934,335935,0,1,2
95825,5,3,335939,335939,335942,0,3,4
95826,5,2,335944,335944,335946,0,2,2
95827,3,3,335947,335947,335950,0,3,1
95828,5,3,335952,335952,335955,0,3,2
95829,2,2,335954,335955,335957,1,3,0
95830,2,3,335956,335957,335960,1,4,0
95831,5,2,335961,335961,335963,0,2,1
95832,2,2,335963,335963,335965,0,2,0
95833,4,2,335967,335967,335969,0,2,2
95834,4,1,335971,335971,335972,0,1,2
95835,1,1,335972,335972,335973,0,1,0
95836,4,1,335976,335976,335977,0,1,3
95837,3,2,335979,335979,335981,0,2,2
95838,4,2,335983,335983,335985,0,2,2
95839,3,3,335986,335986,335989,0,3,1
95840,1,3,335987,335989,335992,2,5,0
95841,1,2,335988,335992,335994,4,6,0
95842,3,1,335991,335994,335995,3,4,0
95843,4,1,335995,335995,335996,0,1,0
95844,4,3,335999,335999,336002,0,3,3
95845,3,1,336002,336002,336003,0,1,0
95846,6,1,336008,336008,336009,0,1,5
95847,1,2,336009,336009,336011,0,2,0
95848,1,3,336010,336011,336014,1,4,0
95849,1,1,336011,336014,336015,3,4,0
95850,1,1,336012,336015,336016,3,4,0
95851,6,3,336018,336018,336021,0,3,2
95852,2,3,336020,336021,336024,1,4,0
95853,1,2,336021,336024,336026,3,5,0
95854,1,3,336022,336026,336029,4,7,0
95855,4,1,336026,336029,336030,3,4,0
95856,4,2,336030,336030,336032,0,2,0
95857,2,1,336032,336032,336033,0,1,0
95858,4,3,336036,336036,336039,0,3,3
95859,1,3,336037,336039,336042,2,5,0
95860,4,2,336041,336042,336044,1,3,0
95861,1,3,336042,336044,336047,2,5,0
95862,4,3,336046,336047,336050,1,4,0
95863,4,2,336050,336050,336052,0,2,0
95864,5,1,336055,336055,336056,0,1,3
95865,4,3,336059,336059,336062,0,3,3
95866,3,3,336062,336062,336065,0,3,0
95867,5,3,336067,336067,336070,0,3,2
95868,2,3,336069,336070,336073,1,4,0
95869,3,2,336072,336073,336075,1,3,0
95870,4,1,336076,336076,336077,0,1,1
95871,4,3,336080,336080,336083,0,3,3
95872,1,1,336081,336083,336084,2,3,0
95873,1,3,336082,336084,336087,2,5,0
95874,2,1,336084,336087,336088,3,4,0
95875,2,1,336086,336088,336089,2,3,0
95876,6,1,336092,336092,336093,0,1,3
95877,2,1,336094,336094,336095,0,1,1
95878,2,3,336096,336096,336099,0,3,1
95879,4,2,336100,336100,336102,0,2,1
95880,1,3,336101,336102,336105,1,4,0
95881,6,1,336107,336107,336108,0,1,2
95882,2,3,336109,336109,336112,0,3,1
95883,3,1,336112,336112,336113,0,1,0
95884,1,1,336113,336113,336114,0,1,0
95885,2,1,336115,336115,336116,0,1,1
95886,5,1,336120,336120,336121,0,1,4
95887,3,3,336123,336123,336126,0,3,2
95888,2,2,336125,336126,336128,1,3,0
95889,1,1,336126,336128,336129,2,3,0
95890,1,2,336127,336129,336131,2,4,0
95891,1,2,336128,336131,336133,3,5,0
95892,3,1,336131,336133,336134,2,3,0
95893,4,2,336135,336135,336137,0,2,1
95894,6,2,336141,336141,336143,0,2,4
95895,6,1,336147,336147,336148,0,1,4
95896,2,2,336149,336149,336151,0,2,1
95897,4,2,336153,336153,336155,0,2,2
95898,3,3,336156,336156,336159,0,3,1
95899,2,2,336158,336159,336161,1,3,0
95900,6,3,336164,336164,336167,0,3,3
95901,2,2,336166,336167,336169,1,3,0
95902,4,1,336170,336170,336171,0,1,1
95903,2,2,336172,336172,336174,0,2,1
95904,1,2,336173,336174,336176,1,3,0
95905,4,1,336177,336177,336178,0,1,1
95906,3,3,336180,336180,336183,0,3,2
95907,2,3,336182,336183,336186,1,4,0
95908,6,2,336188,336188,336190,0,2,2
95909,4,2,336192,336192,336194,0,2,2
95910,5,3,336197,336197,336200,0,3,3
95911,2,2,336199,336200,336202,1,3,0
95912,6,3,336205,336205,336208,0,3,3
95913,3,2,336208,336208,336210,0,2,0
95914,1,2,336209,336210,336212,1,3,0
95915,6,3,336215,336215,336218,0,3,3
95916,3,2,336218,336218,336220,0,2,0
95917,5,2,336223,336223,336225,0,2,3
95918,3,2,336226,336226,336228,0,2,1
95919,5,1,336231,336231,336232,0,1,3
95920,5,2,336236,336236,336238,0,2,4
95921,5,1,336241,336241,336242,0,1,3
95922,3,3,336244,336244,336247,0,3,2
95923,5,1,336249,336249,336250,0,1,2
95924,6,2,336255,336255,336257,0,2,5
95925,6,1,336261,336261,336262,0,1,4
95926,2,3,336263,336263,336266,0,3,1
95927,1,2,336264,336266,336268,2,4,0
95928,1,1,336265,336268,336269,3,4,0
95929,5,3,336270,336270,336273,0,3,1
95930,6,3,336276,336276,336279,0,3,3
95931,4,2,336280,336280,336282,0,2,1
95932,5,3,336285,336285,336288,0,3,3
95933,2,3,336287,336288,336291,1,4,0
95934,5,2,336292,336292,336294,0,2,1
95935,5,3,336297,336297,336300,0,3,3
95936,5,2,336302,336302,336304,0,2,2
95937,6,1,336308,336308,336309,0,1,4
95938,5,3,336313,336313,336316,0,3,4
95939,6,1,336319,336319,336320,0,1,3
95940,3,2,336322,336322,336324,0,2,2
95941,4,1,336326,336326,336327,0,1,2
95942,3,2,336329,336329,336331,0,2,2
95943,3,1,336332,336332,336333,0,1,1
95944,3,2,336335,336335,336337,0,2,2
95945,5,3,336340,336340,336343,0,3,3
95946,4,3,336344,336344,336347,0,3,1
95947,3,3,336347,336347,336350,0,3,0
95948,4,2,336351,336351,336353,0,2,1
95949,4,1,336355,336355,336356,0,1,2
95950,6,2,336361,336361,336363,0,2,5
95951,3,2,336364,336364,336366,0,2,1
95952,2,2,336366,336366,336368,0,2,0
95953,2,1,336368,336368,336369,0,1,0
95954,4,2,336372,336372,336374,0,2,3
95955,1,1,336373,336374,336375,1,2,0
95956,4,3,336377,336377,336380,0,3,2
95957,1,3,336378,336380,336383,2,5,0
95958,3,3,336381,336383,336386,2,5,0
95959,4,2,336385,336386,336388,1,3,0
95960,3,1,336388,336388,336389,0,1,0
95961,3,2,336391,336391,336393,0,2,2
95962,1,2,336392,336393,336395,1,3,0
95963,1,3,336393,336395,336398,2,5,0
95964,4,2,336397,336398,336400,1,3,0
95965,5,1,336402,336402,336403,0,1,2
95966,2,2,336404,336404,336406,0,2,1
95967,4,1,336408,336408,336409,0,1,2
95968,1,3,336409,336409,336412,0,3,0
95969,2,2,336411,336412,336414,1,3,0
95970,2,2,336413,336414,336416,1,3,0
95971,4,2,336417,336417,336419,0,2,1
95972,1,2,336418,336419,336421,1,3,0
95973,2,3,336420,336421,336424,1,4,0
95974,6,1,336426,336426,336427,0,1,2
95975,3,1,336429,336429,336430,0,1,2
95976,2,2,336431,336431,336433,0,2,1
95977,1,2,336432,336433,336435,1,3,0
95978,1,2,336433,336435,336437,2,4,0
95979,6,3,336439,336439,336442,0,3,2
95980,1,3,336440,336442,336445,2,5,0
95981,6,1,336446,336446,336447,0,1,1
95982,2,2,336448,336448,336450,0,2,1
95983,3,2,336451,336451,336453,0,2,1
95984,4,1,336455,336455,336456,0,1,2
95985,1,1,336456,336456,336457,0,1,0
95986,4,2,336460,336460,336462,0,2,3
95987,6,1,336466,336466,336467,0,1,4
95988,3,2,336469,336469,336471,0,2,2
95989,4,1,336473,336473,336474,0,1,2
95990,5,2,336478,336478,336480,0,2,4
95991,6,1,336484,336484,336485,0,1,4
95992,1,3,336485,336485,336488,0,3,0
95993,2,3,336487,336488,336491,1,4,0
95994,3,2,336490,336491,336493,1,3,0
95995,6,3,336496,336496,336499,0,3,3
95996,2,3,336498,336499,336502,1,4,0
95997,1,3,336499,336502,336505,3,6,0
95998,1,1,336500,336505,336506,5,6,0
95999,4,1,336504,336506,336507,2,3,0
96000,3,3,336507,336507,336510,0,3,0
96001,1,3,336508,336510,336513,2,5,0
96002,6,3,336514,336514,336517,0,3,1
96003,5,3,336519,336519,336522,0,3,2
96004,2,1,336521,336522,336523,1,2,0
96005,2,3,336523,336523,336526,0,3,0
96006,5,3,336528,336528,336531,0,3,2
96007,2,3,336530,336531,336534,1,4,0
96008,2,1,336532,336534,336535,2,3,0
96009,3,1,336535,336535,336536,0,1,0
96010,3,3,336538,336538,336541,0,3,2
96011,6,3,336544,336544,336547,0,3,3
96012,1,3,336545,336547,336550,2,5,0
96013,2,1,336547,336550,336551,3,4,0
96014,4,3,336551,336551,336554,0,3,0
96015,4,3,336555,336555,336558,0,3,1
96016,2,3,336557,336558,336561,1,4,0
96017,2,2,336559,336561,336563,2,4,0
96018,1,2,336560,336563,336565,3,5,0
96019,6,1,336566,336566,336567,0,1,1
96020,1,1,336567,336567,336568,0,1,0
96021,1,2,336568,336568,336570,0,2,0
96022,2,3,336570,336570,336573,0,3,0
96023,1,1,336571,336573,336574,2,3,0
96024,5,3,336576,336576,336579,0,3,2
96025,6,1,336582,336582,336583,0,1,3
96026,5,3,336587,336587,336590,0,3,4
96027,6,2,336593,336593,336595,0,2,3
96028,6,3,336599,336599,336602,0,3,4
96029,2,1,336601,336602,336603,1,2,0
96030,1,3,336602,336603,336606,1,4,0
96031,2,3,336604,336606,336609,2,5,0
96032,2,2,336606,336609,336611,3,5,0
96033,1,3,336607,336611,336614,4,7,0
96034,5,1,336612,336614,336615,2,3,0
96035,4,1,336616,336616,336617,0,1,1
96036,4,2,336620,336620,336622,0,2,3
96037,2,1,336622,336622,336623,0,1,0
96038,4,3,336626,336626,336629,0,3,3
96039,2,1,336628,336629,336630,1,2,0
96040,1,2,336629,336630,336632,1,3,0
96041,6,3,336635,336635,336638,0,3,3
96042,3,2,336638,336638,336640,0,2,0
96043,2,2,336640,336640,336642,0,2,0
96044,3,1,336643,336643,336644,0,1,1
96045,1,2,336644,336644,336646,0,2,0
96046,3,2,336647,336647,336649,0,2,1
96047,1,1,336648,336649,336650,1,2,0
96048,3,2,336651,336651,336653,0,2,1
96049,3,1,336654,336654,336655,0,1,1
96050,2,2,336656,336656,336658,0,2,1
96051,5,2,336661,336661,336663,0,2,3
96052,5,3,336666,336666,336669,0,3,3
96053,1,1,336667,336669,336670,2,3,0
96054,1,1,336668,336670,336671,2,3,0
96055,2,3,336670,336671,336674,1,4,0
96056,1,2,336671,336674,336676,3,5,0
96057,6,3,336677,336677,336680,0,3,1
96058,4,3,336681,336681,336684,0,3,1
96059,6,1,336687,336687,336688,0,1,3
96060,1,1,336688,336688,336689,0,1,0
96061,2,1,336690,336690,336691,0,1,1
96062,6,1,336696,336696,336697,0,1,5
96063,1,1,336697,336697,336698,0,1,0
96064,1,2,336698,336698,336700,0,2,0
96065,4,2,336702,336702,336704,0,2,2
96066,1,1,336703,336704,336705,1,2,0
96067,6,2,336709,336709,336711,0,2,4
96068,6,1,336715,336715,336716,0,1,4
96069,4,2,336719,336719,336721,0,2,3
96070,6,3,336725,336725,336728,0,3,4
96071,4,2,336729,336729,336731,0,2,1
96072,4,1,336733,336733,336734,0,1,2
96073,1,3,336734,336734,336737,0,3,0
96074,4,2,336738,336738,336740,0,2,1
96075,5,1,336743,336743,336744,0,1,3
96076,1,3,336744,336744,336747,0,3,0
96077,4,3,336748,336748,336751,0,3,1
96078,1,1,336749,336751,336752,2,3,0
96079,3,2,336752,336752,336754,0,2,0
96080,6,3,336758,336758,336761,0,3,4
96081,4,1,336762,336762,336763,0,1,1
96082,4,1,336766,336766,336767,0,1,3
96083,1,1,336767,336767,336768,0,1,0
96084,5,2,336772,336772,336774,0,2,4
96085,2,1,336774,336774,336775,0,1,0
96086,5,1,336779,336779,336780,0,1,4
96087,6,3,336785,336785,336788,0,3,5
96088,6,2,336791,336791,336793,0,2,3
96089,3,2,336794,336794,336796,0,2,1
96090,4,1,336798,336798,336799,0,1,2
96091,5,2,336803,336803,336805,0,2,4
96092,2,1,336805,336805,336806,0,1,0
96093,4,1,336809,336809,336810,0,1,3
96094,4,3,336813,336813,336816,0,3,3
96095,6,1,336819,336819,336820,0,1,3
96096,6,1,336825,336825,336826,0,1,5
96097,1,2,336826,336826,336828,0,2,0
96098,3,1,336829,336829,336830,0,1,1
96099,4,3,336833,336833,336836,0,3,3
96100,5,1,336838,336838,336839,0,1,2
96101,4,1,336842,336842,336843,0,1,3
96102,5,3,336847,336847,336850,0,3,4
96103,6,2,336853,336853,336855,0,2,3
96104,4,2,336857,336857,336859,0,2,2
96105,5,2,336862,336862,336864,0,2,3
96106,6,1,336868,336868,336869,0,1,4
96107,6,2,336874,336874,336876,0,2,5
96108,1,2,336875,336876,336878,1,3,0
96109,6,1,336881,336881,336882,0,1,3
96110,3,2,336884,336884,336886,0,2,2
96111,4,3,336888,336888,336891,0,3,2
96112,4,3,336892,336892,336895,0,3,1
96113,6,2,336898,336898,336900,0,2,3
96114,4,3,336902,336902,336905,0,3,2
96115,1,2,336903,336905,336907,2,4,0
96116,6,3,336909,336909,336912,0,3,2
96117,4,1,336913,336913,336914,0,1,1
96118,6,3,336919,336919,336922,0,3,5
96119,6,3,336925,336925,336928,0,3,3
96120,4,1,336929,336929,336930,0,1,1
96121,5,1,336934,336934,336935,0,1,4
96122,2,1,336936,336936,336937,0,1,1
96123,3,2,336939,336939,336941,0,2,2
96124,6,2,336945,336945,336947,0,2,4
96125,6,3,336951,336951,336954,0,3,4
96126,3,1,336954,336954,336955,0,1,0
96127,3,1,336957,336957,336958,0,1,2
96128,4,1,336961,336961,336962,0,1,3
96129,2,2,336963,336963,336965,0,2,1
96130,3,3,336966,336966,336969,0,3,1
96131,5,1,336971,336971,336972,0,1,2
96132,1,2,336972,336972,336974,0,2,0
96133,5,3,336977,336977,336980,0,3,3
96134,4,3,336981,336981,336984,0,3,1
96135,5,1,336986,336986,336987,0,1,2
96136,6,2,336992,336992,336994,0,2,5
96137,2,3,336994,336994,336997,0,3,0
96138,5,2,336999,336999,337001,0,2,2
96139,3,3,337002,337002,337005,0,3,1
96140,3,3,337005,337005,337008,0,3,0
96141,5,3,337010,337010,337013,0,3,2
96142,4,3,337014,337014,337017,0,3,1
96143,5,3,337019,337019,337022,0,3,2
96144,5,2,337024,337024,337026,0,2,2
96145,5,3,337029,337029,337032,0,3,3
96146,3,1,337032,337032,337033,0,1,0
96147,4,3,337036,337036,337039,0,3,3
96148,2,2,337038,337039,337041,1,3,0
96149,4,1,337042,337042,337043,0,1,1
96150,2,2,337044,337044,337046,0,2,1
96151,6,2,337050,337050,337052,0,2,4
96152,2,3,337052,337052,337055,0,3,0
96153,6,3,337058,337058,337061,0,3,3
96154,6,3,337064,337064,337067,0,3,3
96155,1,3,337065,337067,337070,2,5,0
96156,4,2,337069,337070,337072,1,3,0
96157,1,3,337070,337072,337075,2,5,0
96158,4,3,337074,337075,337078,1,4,0
96159,6,2,337080,337080,337082,0,2,2
96160,6,1,337086,337086,337087,0,1,4
96161,6,3,337092,337092,337095,0,3,5
96162,5,3,337097,337097,337100,0,3,2
96163,2,1,337099,337100,337101,1,2,0
96164,4,1,337103,337103,337104,0,1,2
96165,3,2,337106,337106,337108,0,2,2
96166,2,2,337108,337108,337110,0,2,0
96167,4,1,337112,337112,337113,0,1,2
96168,1,1,337113,337113,337114,0,1,0
96169,2,3,337115,337115,337118,0,3,1
96170,4,3,337119,337119,337122,0,3,1
96171,5,3,337124,337124,337127,0,3,2
96172,1,1,337125,337127,337128,2,3,0
96173,2,1,337127,337128,337129,1,2,0
96174,2,2,337129,337129,337131,0,2,0
96175,3,3,337132,337132,337135,0,3,1
96176,1,2,337133,337135,337137,2,4,0
96177,4,1,337137,337137,337138,0,1,0
96178,4,2,337141,337141,337143,0,2,3
96179,6,1,337147,337147,337148,0,1,4
96180,3,2,337150,337150,337152,0,2,2
96181,4,3,337154,337154,337157,0,3,2
96182,6,2,337160,337160,337162,0,2,3
96183,2,3,337162,337162,337165,0,3,0
96184,3,1,337165,337165,337166,0,1,0
96185,5,2,337170,337170,337172,0,2,4
96186,4,1,337174,337174,337175,0,1,2
96187,3,3,337177,337177,337180,0,3,2
96188,1,3,337178,337180,337183,2,5,0
96189,1,2,337179,337183,337185,4,6,0
96190,1,2,337180,337185,337187,5,7,0
96191,6,3,337186,337187,337190,1,4,0
96192,2,1,337188,337190,337191,2,3,0
96193,4,1,337192,337192,337193,0,1,1
96194,3,1,337195,337195,337196,0,1,2
96195,5,3,337200,337200,337203,0,3,4
96196,4,1,337204,337204,337205,0,1,1
96197,3,1,337207,337207,337208,0,1,2
96198,5,3,337212,337212,337215,0,3,4
96199,6,1,337218,337218,337219,0,1,3
96200,3,3,337221,337221,337224,0,3,2
96201,3,1,337224,337224,337225,0,1,0
96202,1,1,337225,337225,337226,0,1,0
96203,6,2,337231,337231,337233,0,2,5
96204,6,2,337237,337237,337239,0,2,4
96205,2,1,337239,337239,337240,0,1,0
96206,4,3,337243,337243,337246,0,3,3
96207,3,1,337246,337246,337247,0,1,0
96208,5,2,337251,337251,337253,0,2,4
96209,6,2,337257,337257,337259,0,2,4
96210,2,1,337259,337259,337260,0,1,0
96211,2,1,337261,337261,337262,0,1,1
96212,1,1,337262,337262,337263,0,1,0
96213,5,2,337267,337267,337269,0,2,4
96214,4,1,337271,337271,337272,0,1,2
96215,1,1,337272,337272,337273,0,1,0
96216,6,3,337278,337278,337281,0,3,5
96217,4,1,337282,337282,337283,0,1,1
96218,1,1,337283,337283,337284,0,1,0
96219,3,3,337286,337286,337289,0,3,2
96220,1,3,337287,337289,337292,2,5,0
96221,1,1,337288,337292,337293,4,5,0
96222,2,1,337290,337293,337294,3,4,0
96223,4,2,337294,337294,337296,0,2,0
96224,2,2,337296,337296,337298,0,2,0
96225,2,3,337298,337298,337301,0,3,0
96226,6,3,337304,337304,337307,0,3,3
96227,6,2,337310,337310,337312,0,2,3
96228,5,1,337315,337315,337316,0,1,3
96229,1,1,337316,337316,337317,0,1,0
96230,1,2,337317,337317,337319,0,2,0
96231,4,3,337321,337321,337324,0,3,2
96232,2,2,337323,337324,337326,1,3,0
96233,2,3,337325,337326,337329,1,4,0
96234,3,1,337328,337329,337330,1,2,0
96235,5,3,337333,337333,337336,0,3,3
96236,1,2,337334,337336,337338,2,4,0
96237,6,1,337340,337340,337341,0,1,2
96238,5,1,337345,337345,337346,0,1,4
96239,5,3,337350,337350,337353,0,3,4
96240,4,3,337354,337354,337357,0,3,1
96241,6,2,337360,337360,337362,0,2,3
96242,6,3,337366,337366,337369,0,3,4
96243,3,2,337369,337369,337371,0,2,0
96244,1,3,337370,337371,337374,1,4,0
96245,1,1,337371,337374,337375,3,4,0
96246,6,1,337377,337377,337378,0,1,2
96247,6,1,337383,337383,337384,0,1,5
96248,2,3,337385,337385,337388,0,3,1
96249,5,1,337390,337390,337391,0,1,2
96250,3,2,337393,337393,337395,0,2,2
96251,2,3,337395,337395,337398,0,3,0
96252,4,2,337399,337399,337401,0,2,1
96253,3,1,337402,337402,337403,0,1,1
96254,5,2,337407,337407,337409,0,2,4
96255,3,1,337410,337410,337411,0,1,1
96256,6,2,337416,337416,337418,0,2,5
96257,6,1,337422,337422,337423,0,1,4
96258,4,3,337426,337426,337429,0,3,3
96259,3,3,337429,337429,337432,0,3,0
96260,4,3,337433,337433,337436,0,3,1
96261,4,2,337437,337437,337439,0,2,1
96262,3,1,337440,337440,337441,0,1,1
96263,5,1,337445,337445,337446,0,1,4
96264,6,3,337451,337451,337454,0,3,5
96265,3,2,337454,337454,337456,0,2,0
96266,3,1,337457,337457,337458,0,1,1
96267,2,2,337459,337459,337461,0,2,1
96268,6,2,337465,337465,337467,0,2,4
96269,4,2,337469,337469,337471,0,2,2
96270,4,1,337473,337473,337474,0,1,2
96271,4,1,337477,337477,337478,0,1,3
96272,4,1,337481,337481,337482,0,1,3
96273,3,1,337484,337484,337485,0,1,2
96274,3,1,337487,337487,337488,0,1,2
96275,6,1,337493,337493,337494,0,1,5
96276,6,2,337499,337499,337501,0,2,5
96277,2,1,337501,337501,337502,0,1,0
96278,2,3,337503,337503,337506,0,3,1
96279,5,2,337508,337508,337510,0,2,2
96280,1,3,337509,337510,337513,1,4,0
96281,2,1,337511,337513,337514,2,3,0
96282,1,2,337512,337514,337516,2,4,0
96283,6,3,337518,337518,337521,0,3,2
96284,3,1,337521,337521,337522,0,1,0
96285,4,1,337525,337525,337526,0,1,3
96286,6,2,337531,337531,337533,0,2,5
96287,3,3,337534,337534,337537,0,3,1
96288,1,1,337535,337537,337538,2,3,0
96289,2,1,337537,337538,337539,1,2,0
96290,2,3,337539,337539,337542,0,3,0
96291,3,3,337542,337542,337545,0,3,0
96292,1,2,337543,337545,337547,2,4,0
96293,4,2,337547,337547,337549,0,2,0
96294,4,2,337551,337551,337553,0,2,2
96295,4,3,337555,337555,337558,0,3,2
96296,1,1,337556,337558,337559,2,3,0
96297,3,3,337559,337559,337562,0,3,0
96298,4,2,337563,337563,337565,0,2,1
96299,4,1,337567,337567,337568,0,1,2
96300,6,1,337573,337573,337574,0,1,5
96301,1,1,337574,337574,337575,0,1,0
96302,4,2,337578,337578,337580,0,2,3
96303,2,2,337580,337580,337582,0,2,0
96304,3,3,337583,337583,337586,0,3,1
96305,6,1,337589,337589,337590,0,1,3
96306,4,2,337593,337593,337595,0,2,3
96307,6,2,337599,337599,337601,0,2,4
96308,6,1,337605,337605,337606,0,1,4
96309,5,1,337610,337610,337611,0,1,4
96310,6,2,337616,337616,337618,0,2,5
96311,3,1,337619,337619,337620,0,1,1
96312,3,1,337622,337622,337623,0,1,2
96313,6,1,337628,337628,337629,0,1,5
96314,6,3,337634,337634,337637,0,3,5
96315,2,3,337636,337637,337640,1,4,0
96316,2,1,337638,337640,337641,2,3,0
96317,6,2,337644,337644,337646,0,2,3
96318,6,2,337650,337650,337652,0,2,4
96319,3,1,337653,337653,337654,0,1,1
96320,5,3,337658,337658,337661,0,3,4
96321,3,3,337661,337661,337664,0,3,0
96322,6,2,337667,337667,337669,0,2,3
96323,2,2,337669,337669,337671,0,2,0
96324,1,3,337670,337671,337674,1,4,0
96325,5,2,337675,337675,337677,0,2,1
96326,2,2,337677,337677,337679,0,2,0
96327,4,3,337681,337681,337684,0,3,2
96328,4,3,337685,337685,337688,0,3,1
96329,3,3,337688,337688,337691,0,3,0
96330,3,3,337691,337691,337694,0,3,0
96331,5,2,337696,337696,337698,0,2,2
96332,3,3,337699,337699,337702,0,3,1
96333,5,1,337704,337704,337705,0,1,2
96334,4,1,337708,337708,337709,0,1,3
96335,3,3,337711,337711,337714,0,3,2
96336,2,1,337713,337714,337715,1,2,0
96337,5,1,337718,337718,337719,0,1,3
96338,3,3,337721,337721,337724,0,3,2
96339,6,1,337727,337727,337728,0,1,3
96340,4,1,337731,337731,337732,0,1,3
96341,1,1,337732,337732,337733,0,1,0
96342,6,3,337738,337738,337741,0,3,5
96343,3,1,337741,337741,337742,0,1,0
96344,5,3,337746,337746,337749,0,3,4
96345,3,2,337749,337749,337751,0,2,0
96346,2,1,337751,337751,337752,0,1,0
96347,4,1,337755,337755,337756,0,1,3
96348,3,2,337758,337758,337760,0,2,2
96349,1,2,337759,337760,337762,1,3,0
96350,2,2,337761,337762,337764,1,3,0
96351,6,1,337767,337767,337768,0,1,3
96352,2,2,337769,337769,337771,0,2,1
96353,5,1,337774,337774,337775,0,1,3
96354,5,3,337779,337779,337782,0,3,4
96355,4,1,337783,337783,337784,0,1,1
96356,6,1,337789,337789,337790,0,1,5
96357,6,1,337795,337795,337796,0,1,5
96358,3,2,337798,337798,337800,0,2,2
96359,5,2,337803,337803,337805,0,2,3
96360,4,3,337807,337807,337810,0,3,2
96361,5,1,337812,337812,337813,0,1,2
96362,1,2,337813,337813,337815,0,2,0
96363,2,3,337815,337815,337818,0,3,0
96364,4,2,337819,337819,337821,0,2,1
96365,1,3,337820,337821,337824,1,4,0
96366,3,2,337823,337824,337826,1,3,0
96367,1,3,337824,337826,337829,2,5,0
96368,4,3,337828,337829,337832,1,4,0
96369,6,3,337834,337834,337837,0,3,2
96370,6,2,337840,337840,337842,0,2,3
96371,2,1,337842,337842,337843,0,1,0
96372,1,3,337843,337843,337846,0,3,0
96373,4,3,337847,337847,337850,0,3,1
96374,2,2,337849,337850,337852,1,3,0
96375,6,3,337855,337855,337858,0,3,3
96376,1,2,337856,337858,337860,2,4,0
96377,5,3,337861,337861,337864,0,3,1
96378,6,3,337867,337867,337870,0,3,3
96379,5,1,337872,337872,337873,0,1,2
96380,3,2,337875,337875,337877,0,2,2
96381,5,2,337880,337880,337882,0,2,3
96382,1,3,337881,337882,337885,1,4,0
96383,2,3,337883,337885,337888,2,5,0
96384,4,2,337887,337888,337890,1,3,0
96385,3,1,337890,337890,337891,0,1,0
96386,2,3,337892,337892,337895,0,3,1
96387,2,2,337894,337895,337897,1,3,0
96388,1,3,337895,337897,337900,2,5,0
96389,5,3,337900,337900,337903,0,3,0
96390,6,2,337906,337906,337908,0,2,3
96391,5,3,337911,337911,337914,0,3,3
96392,2,2,337913,337914,337916,1,3,0
96393,4,1,337917,337917,337918,0,1,1
96394,2,1,337919,337919,337920,0,1,1
96395,5,3,337924,337924,337927,0,3,4
96396,4,3,337928,337928,337931,0,3,1
96397,3,3,337931,337931,337934,0,3,0
96398,5,1,337936,337936,337937,0,1,2
96399,3,1,337939,337939,337940,0,1,2
96400,4,3,337943,337943,337946,0,3,3
96401,5,1,337948,337948,337949,0,1,2
96402,3,1,337951,337951,337952,0,1,2
96403,2,2,337953,337953,337955,0,2,1
96404,6,2,337959,337959,337961,0,2,4
96405,5,1,337964,337964,337965,0,1,3
96406,3,1,337967,337967,337968,0,1,2
96407,1,1,337968,337968,337969,0,1,0
96408,3,1,337971,337971,337972,0,1,2
96409,2,2,337973,337973,337975,0,2,1
96410,3,2,337976,337976,337978,0,2,1
96411,2,1,337978,337978,337979,0,1,0
96412,4,3,337982,337982,337985,0,3,3
96413,1,2,337983,337985,337987,2,4,0
96414,5,1,337988,337988,337989,0,1,1
96415,6,3,337994,337994,337997,0,3,5
96416,1,2,337995,337997,337999,2,4,0
96417,6,1,338001,338001,338002,0,1,2
96418,5,2,338006,338006,338008,0,2,4
96419,1,1,338007,338008,338009,1,2,0
96420,4,3,338011,338011,338014,0,3,2
96421,3,2,338014,338014,338016,0,2,0
96422,2,2,338016,338016,338018,0,2,0
96423,1,3,338017,338018,338021,1,4,0
96424,3,3,338020,338021,338024,1,4,0
96425,1,3,338021,338024,338027,3,6,0
96426,4,2,338025,338027,338029,2,4,0
96427,6,2,338031,338031,338033,0,2,2
96428,6,3,338037,338037,338040,0,3,4
96429,2,3,338039,338040,338043,1,4,0
96430,4,3,338043,338043,338046,0,3,0
96431,3,2,338046,338046,338048,0,2,0
96432,3,1,338049,338049,338050,0,1,1
96433,2,2,338051,338051,338053,0,2,1
96434,6,1,338057,338057,338058,0,1,4
96435,3,2,338060,338060,338062,0,2,2
96436,6,2,338066,338066,338068,0,2,4
96437,3,3,338069,338069,338072,0,3,1
96438,2,1,338071,338072,338073,1,2,0
96439,6,1,338077,338077,338078,0,1,4
96440,6,2,338083,338083,338085,0,2,5
96441,2,2,338085,338085,338087,0,2,0
96442,3,1,338088,338088,338089,0,1,1
96443,1,2,338089,338089,338091,0,2,0
96444,2,1,338091,338091,338092,0,1,0
96445,6,2,338097,338097,338099,0,2,5
96446,6,3,338103,338103,338106,0,3,4
96447,1,1,338104,338106,338107,2,3,0
96448,4,3,338108,338108,338111,0,3,1
96449,1,1,338109,338111,338112,2,3,0
96450,5,3,338114,338114,338117,0,3,2
96451,5,2,338119,338119,338121,0,2,2
96452,3,2,338122,338122,338124,0,2,1
96453,4,2,338126,338126,338128,0,2,2
96454,2,2,338128,338128,338130,0,2,0
96455,6,3,338134,338134,338137,0,3,4
96456,3,3,338137,338137,338140,0,3,0
96457,4,3,338141,338141,338144,0,3,1
96458,3,3,338144,338144,338147,0,3,0
96459,1,2,338145,338147,338149,2,4,0
96460,1,3,338146,338149,338152,3,6,0
96461,2,1,338148,338152,338153,4,5,0
96462,3,3,338151,338153,338156,2,5,0
96463,2,2,338153,338156,338158,3,5,0
96464,5,3,338158,338158,338161,0,3,0
96465,6,1,338164,338164,338165,0,1,3
96466,2,2,338166,338166,338168,0,2,1
96467,6,1,338172,338172,338173,0,1,4
96468,2,3,338174,338174,338177,0,3,1
96469,4,1,338178,338178,338179,0,1,1
96470,2,3,338180,338180,338183,0,3,1
96471,4,2,338184,338184,338186,0,2,1
96472,4,1,338188,338188,338189,0,1,2
96473,4,1,338192,338192,338193,0,1,3
96474,4,1,338196,338196,338197,0,1,3
96475,4,3,338200,338200,338203,0,3,3
96476,1,1,338201,338203,338204,2,3,0
96477,2,3,338203,338204,338207,1,4,0
96478,2,2,338205,338207,338209,2,4,0
96479,2,2,338207,338209,338211,2,4,0
96480,3,1,338210,338211,338212,1,2,0
96481,1,1,338211,338212,338213,1,2,0
96482,6,1,338217,338217,338218,0,1,4
96483,4,3,338221,338221,338224,0,3,3
96484,6,1,338227,338227,338228,0,1,3
96485,3,3,338230,338230,338233,0,3,2
96486,6,2,338236,338236,338238,0,2,3
96487,6,3,338242,338242,338245,0,3,4
96488,1,1,338243,338245,338246,2,3,0
96489,4,2,338247,338247,338249,0,2,1
96490,4,3,338251,338251,338254,0,3,2
96491,1,2,338252,338254,338256,2,4,0
96492,2,2,338254,338256,338258,2,4,0
96493,4,1,338258,338258,338259,0,1,0
96494,4,1,338262,338262,338263,0,1,3
96495,3,3,338265,338265,338268,0,3,2
96496,4,1,338269,338269,338270,0,1,1
96497,5,3,338274,338274,338277,0,3,4
96498,3,2,338277,338277,338279,0,2,0
96499,3,3,338280,338280,338283,0,3,1
96500,4,3,338284,338284,338287,0,3,1
96501,1,3,338285,338287,338290,2,5,0
96502,2,3,338287,338290,338293,3,6,0
96503,3,2,338290,338293,338295,3,5,0
96504,5,1,338295,338295,338296,0,1,0
96505,1,1,338296,338296,338297,0,1,0
96506,3,2,338299,338299,338301,0,2,2
96507,1,1,338300,338301,338302,1,2,0
96508,2,2,338302,338302,338304,0,2,0
96509,2,1,338304,338304,338305,0,1,0
96510,3,3,338307,338307,338310,0,3,2
96511,5,2,338312,338312,338314,0,2,2
96512,4,2,338316,338316,338318,0,2,2
96513,1,2,338317,338318,338320,1,3,0
96514,2,3,338319,338320,338323,1,4,0
96515,4,2,338323,338323,338325,0,2,0
96516,6,2,338329,338329,338331,0,2,4
96517,1,3,338330,338331,338334,1,4,0
96518,4,3,338334,338334,338337,0,3,0
96519,6,3,338340,338340,338343,0,3,3
96520,2,1,338342,338343,338344,1,2,0
96521,2,2,338344,338344,338346,0,2,0
96522,4,2,338348,338348,338350,0,2,2
96523,5,1,338353,338353,338354,0,1,3
96524,4,1,338357,338357,338358,0,1,3
96525,3,2,338360,338360,338362,0,2,2
96526,5,2,338365,338365,338367,0,2,3
96527,2,2,338367,338367,338369,0,2,0
96528,5,1,338372,338372,338373,0,1,3
96529,1,3,338373,338373,338376,0,3,0
96530,6,3,338379,338379,338382,0,3,3
96531,1,3,338380,338382,338385,2,5,0
96532,5,2,338385,338385,338387,0,2,0
96533,2,3,338387,338387,338390,0,3,0
96534,4,2,338391,338391,338393,0,2,1
96535,3,2,338394,338394,338396,0,2,1
96536,6,2,338400,338400,338402,0,2,4
96537,1,2,338401,338402,338404,1,3,0
96538,5,3,338406,338406,338409,0,3,2
96539,3,2,338409,338409,338411,0,2,0
96540,6,1,338415,338415,338416,0,1,4
96541,2,2,338417,338417,338419,0,2,1
96542,5,3,338422,338422,338425,0,3,3
96543,6,2,338428,338428,338430,0,2,3
96544,6,3,338434,338434,338437,0,3,4
96545,5,1,338439,338439,338440,0,1,2
96546,6,3,338445,338445,338448,0,3,5
96547,4,1,338449,338449,338450,0,1,1
96548,4,3,338453,338453,338456,0,3,3
96549,1,2,338454,338456,338458,2,4,0
96550,3,2,338457,338458,338460,1,3,0
96551,6,3,338463,338463,338466,0,3,3
96552,6,1,338469,338469,338470,0,1,3
96553,2,1,338471,338471,338472,0,1,1
96554,3,1,338474,338474,338475,0,1,2
96555,4,2,338478,338478,338480,0,2,3
96556,2,1,338480,338480,338481,0,1,0
96557,3,1,338483,338483,338484,0,1,2
96558,6,2,338489,338489,338491,0,2,5
96559,3,1,338492,338492,338493,0,1,1
96560,1,1,338493,338493,338494,0,1,0
96561,6,2,338499,338499,338501,0,2,5
96562,3,3,338502,338502,338505,0,3,1
96563,3,3,338505,338505,338508,0,3,0
96564,6,3,338511,338511,338514,0,3,3
96565,1,1,338512,338514,338515,2,3,0
96566,3,2,338515,338515,338517,0,2,0
96567,5,1,338520,338520,338521,0,1,3
96568,5,3,338525,338525,338528,0,3,4
96569,6,1,338531,338531,338532,0,1,3
96570,1,2,338532,338532,338534,0,2,0
96571,3,1,338535,338535,338536,0,1,1
96572,4,1,338539,338539,338540,0,1,3
96573,4,2,338543,338543,338545,0,2,3
96574,1,2,338544,338545,338547,1,3,0
96575,5,2,338549,338549,338551,0,2,2
96576,2,3,338551,338551,338554,0,3,0
96577,4,1,338555,338555,338556,0,1,1
96578,4,1,338559,338559,338560,0,1,3
96579,3,2,338562,338562,338564,0,2,2
96580,1,3,338563,338564,338567,1,4,0
96581,5,3,338568,338568,338571,0,3,1
96582,2,1,338570,338571,338572,1,2,0
96583,3,3,338573,338573,338576,0,3,1
96584,4,2,338577,338577,338579,0,2,1
96585,6,2,338583,338583,338585,0,2,4
96586,3,3,338586,338586,338589,0,3,1
96587,1,1,338587,338589,338590,2,3,0
96588,1,1,338588,338590,338591,2,3,0
96589,5,1,338593,338593,338594,0,1,2
96590,6,1,338599,338599,338600,0,1,5
96591,2,3,338601,338601,338604,0,3,1
96592,5,1,338606,338606,338607,0,1,2
96593,6,3,338612,338612,338615,0,3,5
96594,6,2,338618,338618,338620,0,2,3
96595,4,3,338622,338622,338625,0,3,2
96596,1,1,338623,338625,338626,2,3,0
96597,6,1,338629,338629,338630,0,1,3
96598,5,2,338634,338634,338636,0,2,4
96599,2,2,338636,338636,338638,0,2,0
96600,5,2,338641,338641,338643,0,2,3
96601,3,3,338644,338644,338647,0,3,1
96602,3,1,338647,338647,338648,0,1,0
96603,3,1,338650,338650,338651,0,1,2
96604,1,1,338651,338651,338652,0,1,0
96605,6,3,338657,338657,338660,0,3,5
96606,6,1,338663,338663,338664,0,1,3
96607,2,3,338665,338665,338668,0,3,1
96608,3,3,338668,338668,338671,0,3,0
96609,2,2,338670,338671,338673,1,3,0
96610,1,2,338671,338673,338675,2,4,0
96611,2,1,338673,338675,338676,2,3,0
96612,2,3,338675,338676,338679,1,4,0
96613,1,1,338676,338679,338680,3,4,0
96614,4,3,338680,338680,338683,0,3,0
96615,1,1,338681,338683,338684,2,3,0
96616,1,1,338682,338684,338685,2,3,0
96617,6,1,338688,338688,338689,0,1,3
96618,2,1,338690,338690,338691,0,1,1
96619,5,2,338695,338695,338697,0,2,4
96620,3,3,338698,338698,338701,0,3,1
96621,6,3,338704,338704,338707,0,3,3
96622,5,1,338709,338709,338710,0,1,2
96623,1,1,338710,338710,338711,0,1,0
96624,5,1,338715,338715,338716,0,1,4
96625,4,3,338719,338719,338722,0,3,3
96626,6,3,338725,338725,338728,0,3,3
96627,3,3,338728,338728,338731,0,3,0
96628,2,1,338730,338731,338732,1,2,0
96629,3,1,338733,338733,338734,0,1,1
96630,1,1,338734,338734,338735,0,1,0
96631,6,1,338740,338740,338741,0,1,5
96632,2,3,338742,338742,338745,0,3,1
96633,2,2,338744,338745,338747,1,3,0
96634,6,2,338750,338750,338752,0,2,3
96635,6,2,338756,338756,338758,0,2,4
96636,6,3,338762,338762,338765,0,3,4
96637,2,1,338764,338765,338766,1,2,0
96638,4,2,338768,338768,338770,0,2,2
96639,2,2,338770,338770,338772,0,2,0
96640,2,3,338772,338772,338775,0,3,0
96641,6,2,338778,338778,338780,0,2,3
96642,6,1,338784,338784,338785,0,1,4
96643,1,3,338785,338785,338788,0,3,0
96644,5,3,338790,338790,338793,0,3,2
96645,3,1,338793,338793,338794,0,1,0
96646,3,1,338796,338796,338797,0,1,2
96647,4,1,338800,338800,338801,0,1,3
96648,1,1,338801,338801,338802,0,1,0
96649,1,2,338802,338802,338804,0,2,0
96650,5,3,338807,338807,338810,0,3,3
96651,6,1,338813,338813,338814,0,1,3
96652,3,3,338816,338816,338819,0,3,2
96653,4,1,338820,338820,338821,0,1,1
96654,1,2,338821,338821,338823,0,2,0
96655,1,1,338822,338823,338824,1,2,0
96656,1,1,338823,338824,338825,1,2,0
96657,1,2,338824,338825,338827,1,3,0
96658,4,2,338828,338828,338830,0,2,1
96659,5,3,338833,338833,338836,0,3,3
96660,1,1,338834,338836,338837,2,3,0
96661,1,1,338835,338837,338838,2,3,0
96662,2,1,338837,338838,338839,1,2,0
96663,5,2,338842,338842,338844,0,2,3
96664,6,1,338848,338848,338849,0,1,4
96665,1,2,338849,338849,338851,0,2,0
96666,6,2,338855,338855,338857,0,2,4
96667,5,2,338860,338860,338862,0,2,3
96668,1,2,338861,338862,338864,1,3,0
96669,4,2,338865,338865,338867,0,2,1
96670,5,2,338870,338870,338872,0,2,3
96671,6,2,338876,338876,338878,0,2,4
96672,2,2,338878,338878,338880,0,2,0
96673,2,2,338880,338880,338882,0,2,0
96674,3,2,338883,338883,338885,0,2,1
96675,5,3,338888,338888,338891,0,3,3
96676,3,2,338891,338891,338893,0,2,0
96677,6,1,338897,338897,338898,0,1,4
96678,2,2,338899,338899,338901,0,2,1
96679,3,1,338902,338902,338903,0,1,1
96680,2,2,338904,338904,338906,0,2,1
96681,3,1,338907,338907,338908,0,1,1
96682,4,1,338911,338911,338912,0,1,3
96683,6,2,338917,338917,338919,0,2,5
96684,4,2,338921,338921,338923,0,2,2
96685,5,3,338926,338926,338929,0,3,3
96686,2,2,338928,338929,338931,1,3,0
96687,2,2,338930,338931,338933,1,3,0
96688,2,3,338932,338933,338936,1,4,0
96689,4,3,338936,338936,338939,0,3,0
96690,6,3,338942,338942,338945,0,3,3
96691,4,2,338946,338946,338948,0,2,1
96692,4,1,338950,338950,338951,0,1,2
96693,5,1,338955,338955,338956,0,1,4
96694,3,1,338958,338958,338959,0,1,2
96695,4,3,338962,338962,338965,0,3,3
96696,5,1,338967,338967,338968,0,1,2
96697,4,2,338971,338971,338973,0,2,3
96698,4,2,338975,338975,338977,0,2,2
96699,2,1,338977,338977,338978,0,1,0
96700,2,2,338979,338979,338981,0,2,1
96701,4,2,338983,338983,338985,0,2,2
96702,2,1,338985,338985,338986,0,1,0
96703,5,1,338990,338990,338991,0,1,4
96704,4,1,338994,338994,338995,0,1,3
96705,4,3,338998,338998,339001,0,3,3
96706,2,3,339000,339001,339004,1,4,0
96707,2,1,339002,339004,339005,2,3,0
96708,3,1,339005,339005,339006,0,1,0
96709,3,2,339008,339008,339010,0,2,2
96710,5,2,339013,339013,339015,0,2,3
96711,3,2,339016,339016,339018,0,2,1
96712,5,3,339021,339021,339024,0,3,3
96713,2,1,339023,339024,339025,1,2,0
96714,3,1,339026,339026,339027,0,1,1
96715,3,2,339029,339029,339031,0,2,2
96716,2,1,339031,339031,339032,0,1,0
96717,3,1,339034,339034,339035,0,1,2
96718,6,2,339040,339040,339042,0,2,5
96719,1,3,339041,339042,339045,1,4,0
96720,3,3,339044,339045,339048,1,4,0
96721,6,2,339050,339050,339052,0,2,2
96722,2,1,339052,339052,339053,0,1,0
96723,6,2,339058,339058,339060,0,2,5
96724,6,2,339064,339064,339066,0,2,4
96725,5,3,339069,339069,339072,0,3,3
96726,5,2,339074,339074,339076,0,2,2
96727,3,3,339077,339077,339080,0,3,1
96728,2,1,339079,339080,339081,1,2,0
96729,6,1,339085,339085,339086,0,1,4
96730,4,1,339089,339089,339090,0,1,3
96731,6,3,339095,339095,339098,0,3,5
96732,6,1,339101,339101,339102,0,1,3
96733,2,3,339103,339103,339106,0,3,1
96734,2,2,339105,339106,339108,1,3,0
96735,2,1,339107,339108,339109,1,2,0
96736,1,2,339108,339109,339111,1,3,0
96737,4,3,339112,339112,339115,0,3,1
96738,6,2,339118,339118,339120,0,2,3
96739,4,3,339122,339122,339125,0,3,2
96740,4,1,339126,339126,339127,0,1,1
96741,5,3,339131,339131,339134,0,3,4
96742,1,1,339132,339134,339135,2,3,0
96743,5,3,339137,339137,339140,0,3,2
96744,3,3,339140,339140,339143,0,3,0
96745,6,1,339146,339146,339147,0,1,3
96746,4,3,339150,339150,339153,0,3,3
96747,4,2,339154,339154,339156,0,2,1
96748,4,3,339158,339158,339161,0,3,2
96749,2,3,339160,339161,339164,1,4,0
96750,2,3,339162,339164,339167,2,5,0
96751,6,2,339168,339168,339170,0,2,1
96752,2,1,339170,339170,339171,0,1,0
96753,5,1,339175,339175,339176,0,1,4
96754,3,3,339178,339178,339181,0,3,2
96755,1,2,339179,339181,339183,2,4,0
96756,4,1,339183,339183,339184,0,1,0
96757,3,1,339186,339186,339187,0,1,2
96758,4,2,339190,339190,339192,0,2,3
96759,1,2,339191,339192,339194,1,3,0
96760,6,1,339197,339197,339198,0,1,3
96761,4,3,339201,339201,339204,0,3,3
96762,1,1,339202,339204,339205,2,3,0
96763,5,2,339207,339207,339209,0,2,2
96764,2,2,339209,339209,339211,0,2,0
96765,5,1,339214,339214,339215,0,1,3
96766,3,1,339217,339217,339218,0,1,2
96767,5,3,339222,339222,339225,0,3,4
96768,5,1,339227,339227,339228,0,1,2
96769,2,2,339229,339229,339231,0,2,1
96770,2,1,339231,339231,339232,0,1,0
96771,3,2,339234,339234,339236,0,2,2
96772,1,1,339235,339236,339237,1,2,0
96773,1,2,339236,339237,339239,1,3,0
96774,5,2,339241,339241,339243,0,2,2
96775,4,2,339245,339245,339247,0,2,2
96776,2,3,339247,339247,339250,0,3,0
96777,1,3,339248,339250,339253,2,5,0
96778,2,3,339250,339253,339256,3,6,0
96779,2,2,339252,339256,339258,4,6,0
96780,1,2,339253,339258,339260,5,7,0
96781,3,2,339256,339260,339262,4,6,0
96782,6,2,339262,339262,339264,0,2,0
96783,2,2,339264,339264,339266,0,2,0
96784,5,3,339269,339269,339272,0,3,3
96785,1,3,339270,339272,339275,2,5,0
96786,4,2,339274,339275,339277,1,3,0
96787,5,1,339279,339279,339280,0,1,2
96788,2,3,339281,339281,339284,0,3,1
96789,4,1,339285,339285,339286,0,1,1
96790,2,2,339287,339287,339289,0,2,1
96791,1,2,339288,339289,339291,1,3,0
96792,4,1,339292,339292,339293,0,1,1
96793,2,3,339294,339294,339297,0,3,1
96794,1,1,339295,339297,339298,2,3,0
96795,2,1,339297,339298,339299,1,2,0
96796,2,2,339299,339299,339301,0,2,0
96797,5,3,339304,339304,339307,0,3,3
96798,3,3,339307,339307,339310,0,3,0
96799,2,3,339309,339310,339313,1,4,0
96800,6,2,339315,339315,339317,0,2,2
96801,2,1,339317,339317,339318,0,1,0
96802,4,3,339321,339321,339324,0,3,3
96803,5,3,339326,339326,339329,0,3,2
96804,3,1,339329,339329,339330,0,1,0
96805,4,3,339333,339333,339336,0,3,3
96806,5,2,339338,339338,339340,0,2,2
96807,5,1,339343,339343,339344,0,1,3
96808,4,2,339347,339347,339349,0,2,3
96809,2,2,339349,339349,339351,0,2,0
96810,2,2,339351,339351,339353,0,2,0
96811,6,3,339357,339357,339360,0,3,4
96812,6,1,339363,339363,339364,0,1,3
96813,2,1,339365,339365,339366,0,1,1
96814,1,2,339366,339366,339368,0,2,0
96815,2,2,339368,339368,339370,0,2,0
96816,2,3,339370,339370,339373,0,3,0
96817,5,1,339375,339375,339376,0,1,2
96818,6,3,339381,339381,339384,0,3,5
96819,1,3,339382,339384,339387,2,5,0
96820,5,3,339387,339387,339390,0,3,0
96821,3,1,339390,339390,339391,0,1,0
96822,6,3,339396,339396,339399,0,3,5
96823,5,2,339401,339401,339403,0,2,2
96824,6,3,339407,339407,339410,0,3,4
96825,5,3,339412,339412,339415,0,3,2
96826,6,3,339418,339418,339421,0,3,3
96827,6,3,339424,339424,339427,0,3,3
96828,6,2,339430,339430,339432,0,2,3
96829,6,3,339436,339436,339439,0,3,4
96830,1,1,339437,339439,339440,2,3,0
96831,1,2,339438,339440,339442,2,4,0
96832,3,3,339441,339442,339445,1,4,0
96833,3,3,339444,339445,339448,1,4,0
96834,3,1,339447,339448,339449,1,2,0
96835,4,1,339451,339451,339452,0,1,2
96836,3,1,339454,339454,339455,0,1,2
96837,6,2,339460,339460,339462,0,2,5
96838,6,1,339466,339466,339467,0,1,4
96839,2,1,339468,339468,339469,0,1,1
96840,2,2,339470,339470,339472,0,2,1
96841,4,2,339474,339474,339476,0,2,2
96842,2,2,339476,339476,339478,0,2,0
96843,4,1,339480,339480,339481,0,1,2
96844,2,1,339482,339482,339483,0,1,1
96845,1,3,339483,339483,339486,0,3,0
96846,3,3,339486,339486,339489,0,3,0
96847,3,2,339489,339489,339491,0,2,0
96848,1,2,339490,339491,339493,1,3,0
96849,2,3,339492,339493,339496,1,4,0
96850,3,3,339495,339496,339499,1,4,0
96851,4,1,339499,339499,339500,0,1,0
96852,3,3,339502,339502,339505,0,3,2
96853,2,1,339504,339505,339506,1,2,0
96854,5,2,339509,339509,339511,0,2,3
96855,3,1,339512,339512,339513,0,1,1
96856,6,3,339518,339518,339521,0,3,5
96857,4,1,339522,339522,339523,0,1,1
96858,2,1,339524,339524,339525,0,1,1
96859,5,2,339529,339529,339531,0,2,4
96860,4,1,339533,339533,339534,0,1,2
96861,2,2,339535,339535,339537,0,2,1
96862,3,3,339538,339538,339541,0,3,1
96863,1,3,339539,339541,339544,2,5,0
96864,3,3,339542,339544,339547,2,5,0
96865,1,2,339543,339547,339549,4,6,0
96866,5,3,339548,339549,339552,1,4,0
96867,4,2,339552,339552,339554,0,2,0
96868,1,1,339553,339554,339555,1,2,0
96869,5,2,339558,339558,339560,0,2,3
96870,4,2,339562,339562,339564,0,2,2
96871,1,3,339563,339564,339567,1,4,0
96872,3,1,339566,339567,339568,1,2,0
96873,1,1,339567,339568,339569,1,2,0
96874,1,1,339568,339569,339570,1,2,0
96875,5,2,339573,339573,339575,0,2,3
96876,5,3,339578,339578,339581,0,3,3
96877,1,1,339579,339581,339582,2,3,0
96878,5,2,339584,339584,339586,0,2,2
96879,1,2,339585,339586,339588,1,3,0
96880,4,1,339589,339589,339590,0,1,1
96881,6,1,339595,339595,339596,0,1,5
96882,4,2,339599,339599,339601,0,2,3
96883,6,2,339605,339605,339607,0,2,4
96884,4,3,339609,339609,339612,0,3,2
96885,4,1,339613,339613,339614,0,1,1
96886,6,3,339619,339619,339622,0,3,5
96887,4,1,339623,339623,339624,0,1,1
96888,5,1,339628,339628,339629,0,1,4
96889,4,3,339632,339632,339635,0,3,3
96890,3,2,339635,339635,339637,0,2,0
96891,1,3,339636,339637,339640,1,4,0
96892,5,2,339641,339641,339643,0,2,1
96893,6,1,339647,339647,339648,0,1,4
96894,4,2,339651,339651,339653,0,2,3
96895,6,2,339657,339657,339659,0,2,4
96896,5,2,339662,339662,339664,0,2,3
96897,3,1,339665,339665,339666,0,1,1
96898,2,1,339667,339667,339668,0,1,1
96899,1,3,339668,339668,339671,0,3,0
96900,3,3,339671,339671,339674,0,3,0
96901,3,1,339674,339674,339675,0,1,0
96902,3,1,339677,339677,339678,0,1,2
96903,2,2,339679,339679,339681,0,2,1
96904,1,2,339680,339681,339683,1,3,0
96905,5,1,339685,339685,339686,0,1,2
96906,1,3,339686,339686,339689,0,3,0
96907,2,3,339688,339689,339692,1,4,0
96908,4,1,339692,339692,339693,0,1,0
96909,2,3,339694,339694,339697,0,3,1
96910,2,1,339696,339697,339698,1,2,0
96911,2,3,339698,339698,339701,0,3,0
96912,1,3,339699,339701,339704,2,5,0
96913,3,3,339702,339704,339707,2,5,0
96914,2,3,339704,339707,339710,3,6,0
96915,3,2,339707,339710,339712,3,5,0
96916,4,3,339711,339712,339715,1,4,0
96917,4,3,339715,339715,339718,0,3,0
96918,4,3,339719,339719,339722,0,3,1
96919,5,3,339724,339724,339727,0,3,2
96920,5,1,339729,339729,339730,0,1,2
96921,5,1,339734,339734,339735,0,1,4
96922,1,3,339735,339735,339738,0,3,0
96923,2,3,339737,339738,339741,1,4,0
96924,3,2,339740,339741,339743,1,3,0
96925,3,2,339743,339743,339745,0,2,0
96926,6,1,339749,339749,339750,0,1,4
96927,3,1,339752,339752,339753,0,1,2
96928,4,2,339756,339756,339758,0,2,3
96929,2,1,339758,339758,339759,0,1,0
96930,4,2,339762,339762,339764,0,2,3
96931,1,3,339763,339764,339767,1,4,0
96932,2,1,339765,339767,339768,2,3,0
96933,3,2,339768,339768,339770,0,2,0
96934,3,3,339771,339771,339774,0,3,1
96935,3,3,339774,339774,339777,0,3,0
96936,6,1,339780,339780,339781,0,1,3
96937,5,2,339785,339785,339787,0,2,4
96938,4,3,339789,339789,339792,0,3,2
96939,4,3,339793,339793,339796,0,3,1
96940,2,2,339795,339796,339798,1,3,0
96941,1,3,339796,339798,339801,2,5,0
96942,2,1,339798,339801,339802,3,4,0
96943,1,3,339799,339802,339805,3,6,0
96944,5,1,339804,339805,339806,1,2,0
96945,4,3,339808,339808,339811,0,3,2
96946,5,1,339813,339813,339814,0,1,2
96947,3,2,339816,339816,339818,0,2,2
96948,3,1,339819,339819,339820,0,1,1
96949,1,1,339820,339820,339821,0,1,0
96950,2,2,339822,339822,339824,0,2,1
96951,3,3,339825,339825,339828,0,3,1
96952,2,1,339827,339828,339829,1,2,0
96953,1,3,339828,339829,339832,1,4,0
96954,5,3,339833,339833,339836,0,3,1
96955,5,3,339838,339838,339841,0,3,2
96956,2,1,339840,339841,339842,1,2,0
96957,2,1,339842,339842,339843,0,1,0
96958,4,3,339846,339846,339849,0,3,3
96959,1,2,339847,339849,339851,2,4,0
96960,3,2,339850,339851,339853,1,3,0
96961,3,2,339853,339853,339855,0,2,0
96962,1,3,339854,339855,339858,1,4,0
96963,1,1,339855,339858,339859,3,4,0
96964,3,1,339858,339859,339860,1,2,0
96965,6,1,339864,339864,339865,0,1,4
96966,1,1,339865,339865,339866,0,1,0
96967,4,1,339869,339869,339870,0,1,3
96968,5,2,339874,339874,339876,0,2,4
96969,2,3,339876,339876,339879,0,3,0
96970,6,3,339882,339882,339885,0,3,3
96971,4,3,339886,339886,339889,0,3,1
96972,4,2,339890,339890,339892,0,2,1
96973,5,1,339895,339895,339896,0,1,3
96974,5,3,339900,339900,339903,0,3,4
96975,5,1,339905,339905,339906,0,1,2
96976,4,1,339909,339909,339910,0,1,3
96977,3,2,339912,339912,339914,0,2,2
96978,5,1,339917,339917,339918,0,1,3
96979,6,2,339923,339923,339925,0,2,5
96980,2,1,339925,339925,339926,0,1,0
96981,6,2,339931,339931,339933,0,2,5
96982,6,1,339937,339937,339938,0,1,4
96983,2,1,339939,339939,339940,0,1,1
96984,6,2,339945,339945,339947,0,2,5
96985,3,1,339948,339948,339949,0,1,1
96986,3,1,339951,339951,339952,0,1,2
96987,6,3,339957,339957,339960,0,3,5
96988,2,1,339959,339960,339961,1,2,0
96989,1,2,339960,339961,339963,1,3,0
96990,2,1,339962,339963,339964,1,2,0
96991,6,1,339968,339968,339969,0,1,4
96992,1,2,339969,339969,339971,0,2,0
96993,3,3,339972,339972,339975,0,3,1
96994,4,3,339976,339976,339979,0,3,1
96995,4,3,339980,339980,339983,0,3,1
96996,4,3,339984,339984,339987,0,3,1
96997,5,2,339989,339989,339991,0,2,2
96998,2,2,339991,339991,339993,0,2,0
96999,4,1,339995,339995,339996,0,1,2
97000,2,2,339997,339997,339999,0,2,1
97001,6,1,340003,340003,340004,0,1,4
97002,2,2,340005,340005,340007,0,2,1
97003,3,2,340008,340008,340010,0,2,1
97004,6,1,340014,340014,340015,0,1,4
97005,2,1,340016,340016,340017,0,1,1
97006,1,1,340017,340017,340018,0,1,0
97007,6,3,340023,340023,340026,0,3,5
97008,5,1,340028,340028,340029,0,1,2
97009,4,3,340032,340032,340035,0,3,3
97010,2,1,340034,340035,340036,1,2,0
97011,2,2,340036,340036,340038,0,2,0
97012,3,1,340039,340039,340040,0,1,1
97013,3,3,340042,340042,340045,0,3,2
97014,3,3,340045,340045,340048,0,3,0
97015,3,3,340048,340048,340051,0,3,0
97016,6,2,340054,340054,340056,0,2,3
97017,2,3,340056,340056,340059,0,3,0
97018,5,2,340061,340061,340063,0,2,2
97019,5,3,340066,340066,340069,0,3,3
97020,4,1,340070,340070,340071,0,1,1
97021,6,3,340076,340076,340079,0,3,5
97022,4,1,340080,340080,340081,0,1,1
97023,4,3,340084,340084,340087,0,3,3
97024,2,1,340086,340087,340088,1,2,0
97025,5,1,340091,340091,340092,0,1,3
97026,4,2,340095,340095,340097,0,2,3
97027,5,2,340100,340100,340102,0,2,3
97028,3,3,340103,340103,340106,0,3,1
97029,5,2,340108,340108,340110,0,2,2
97030,6,1,340114,340114,340115,0,1,4
97031,4,1,340118,340118,340119,0,1,3
97032,2,2,340120,340120,340122,0,2,1
97033,3,1,340123,340123,340124,0,1,1
97034,2,2,340125,340125,340127,0,2,1
97035,1,2,340126,340127,340129,1,3,0
97036,6,1,340132,340132,340133,0,1,3
97037,3,1,340135,340135,340136,0,1,2
97038,4,1,340139,340139,340140,0,1,3
97039,1,1,340140,340140,340141,0,1,0
97040,5,1,340145,340145,340146,0,1,4
97041,3,3,340148,340148,340151,0,3,2
97042,1,1,340149,340151,340152,2,3,0
97043,3,1,340152,340152,340153,0,1,0
97044,2,1,340154,340154,340155,0,1,1
97045,6,3,340160,340160,340163,0,3,5
97046,5,2,340165,340165,340167,0,2,2
97047,1,3,340166,340167,340170,1,4,0
97048,3,2,340169,340170,340172,1,3,0
97049,1,3,340170,340172,340175,2,5,0
97050,4,2,340174,340175,340177,1,3,0
97051,2,3,340176,340177,340180,1,4,0
97052,6,3,340182,340182,340185,0,3,2
97053,3,1,340185,340185,340186,0,1,0
97054,2,3,340187,340187,340190,0,3,1
97055,3,3,340190,340190,340193,0,3,0
97056,4,3,340194,340194,340197,0,3,1
97057,3,2,340197,340197,340199,0,2,0
97058,3,3,340200,340200,340203,0,3,1
97059,2,2,340202,340203,340205,1,3,0
97060,1,1,340203,340205,340206,2,3,0
97061,5,1,340208,340208,340209,0,1,2
97062,3,1,340211,340211,340212,0,1,2
97063,4,1,340215,340215,340216,0,1,3
97064,5,3,340220,340220,340223,0,3,4
97065,3,3,340223,340223,340226,0,3,0
97066,1,3,340224,340226,340229,2,5,0
97067,3,2,340227,340229,340231,2,4,0
97068,1,3,340228,340231,340234,3,6,0
97069,2,2,340230,340234,340236,4,6,0
97070,4,3,340234,340236,340239,2,5,0
97071,5,3,340239,340239,340242,0,3,0
97072,3,2,340242,340242,340244,0,2,0
97073,3,2,340245,340245,340247,0,2,1
97074,4,3,340249,340249,340252,0,3,2
97075,2,2,340251,340252,340254,1,3,0
97076,5,2,340256,340256,340258,0,2,2
97077,1,2,340257,340258,340260,1,3,0
97078,4,1,340261,340261,340262,0,1,1
97079,2,2,340263,340263,340265,0,2,1
97080,4,1,340267,340267,340268,0,1,2
97081,5,3,340272,340272,340275,0,3,4
97082,6,1,340278,340278,340279,0,1,3
97083,3,1,340281,340281,340282,0,1,2
97084,6,2,340287,340287,340289,0,2,5
97085,1,2,340288,340289,340291,1,3,0
97086,5,1,340293,340293,340294,0,1,2
97087,1,2,340294,340294,340296,0,2,0
97088,3,1,340297,340297,340298,0,1,1
97089,1,3,340298,340298,340301,0,3,0
97090,6,2,340304,340304,340306,0,2,3
97091,6,1,340310,340310,340311,0,1,4
97092,5,2,340315,340315,340317,0,2,4
97093,3,3,340318,340318,340321,0,3,1
97094,5,3,340323,340323,340326,0,3,2
97095,3,2,340326,340326,340328,0,2,0
97096,5,3,340331,340331,340334,0,3,3
97097,1,2,340332,340334,340336,2,4,0
97098,3,2,340335,340336,340338,1,3,0
97099,2,2,340337,340338,340340,1,3,0
97100,4,3,340341,340341,340344,0,3,1
97101,6,3,340347,340347,340350,0,3,3
97102,2,2,340349,340350,340352,1,3,0
97103,6,3,340355,340355,340358,0,3,3
97104,6,2,340361,340361,340363,0,2,3
97105,2,2,340363,340363,340365,0,2,0
97106,2,3,340365,340365,340368,0,3,0
97107,1,3,340366,340368,340371,2,5,0
97108,6,2,340372,340372,340374,0,2,1
97109,2,2,340374,340374,340376,0,2,0
97110,1,1,340375,340376,340377,1,2,0
97111,4,3,340379,340379,340382,0,3,2
97112,5,2,340384,340384,340386,0,2,2
97113,2,3,340386,340386,340389,0,3,0
97114,1,1,340387,340389,340390,2,3,0
97115,6,3,340393,340393,340396,0,3,3
97116,6,2,340399,340399,340401,0,2,3
97117,6,3,340405,340405,340408,0,3,4
97118,5,3,340410,340410,340413,0,3,2
97119,2,2,340412,340413,340415,1,3,0
97120,3,1,340415,340415,340416,0,1,0
97121,3,2,340418,340418,340420,0,2,2
97122,3,3,340421,340421,340424,0,3,1
97123,5,2,340426,340426,340428,0,2,2
97124,3,1,340429,340429,340430,0,1,1
97125,2,3,340431,340431,340434,0,3,1
97126,1,2,340432,340434,340436,2,4,0
97127,2,1,340434,340436,340437,2,3,0
97128,5,1,340439,340439,340440,0,1,2
97129,3,2,340442,340442,340444,0,2,2
97130,4,3,340446,340446,340449,0,3,2
97131,3,3,340449,340449,340452,0,3,0
97132,3,2,340452,340452,340454,0,2,0
97133,1,3,340453,340454,340457,1,4,0
97134,4,2,340457,340457,340459,0,2,0
97135,4,3,340461,340461,340464,0,3,2
97136,2,3,340463,340464,340467,1,4,0
97137,5,1,340468,340468,340469,0,1,1
97138,4,3,340472,340472,340475,0,3,3
97139,5,3,340477,340477,340480,0,3,2
97140,3,2,340480,340480,340482,0,2,0
97141,3,1,340483,340483,340484,0,1,1
97142,5,2,340488,340488,340490,0,2,4
97143,5,2,340493,340493,340495,0,2,3
97144,5,2,340498,340498,340500,0,2,3
97145,1,2,340499,340500,340502,1,3,0
97146,3,1,340502,340502,340503,0,1,0
97147,2,1,340504,340504,340505,0,1,1
97148,1,2,340505,340505,340507,0,2,0
97149,2,2,340507,340507,340509,0,2,0
97150,2,2,340509,340509,340511,0,2,0
97151,5,3,340514,340514,340517,0,3,3
97152,2,3,340516,340517,340520,1,4,0
97153,2,3,340518,340520,340523,2,5,0
97154,1,1,340519,340523,340524,4,5,0
97155,3,1,340522,340524,340525,2,3,0
97156,6,3,340528,340528,340531,0,3,3
97157,3,2,340531,340531,340533,0,2,0
97158,2,1,340533,340533,340534,0,1,0
97159,5,2,340538,340538,340540,0,2,4
97160,6,3,340544,340544,340547,0,3,4
97161,2,3,340546,340547,340550,1,4,0
97162,2,1,340548,340550,340551,2,3,0
97163,1,2,340549,340551,340553,2,4,0
97164,2,1,340551,340553,340554,2,3,0
97165,6,2,340557,340557,340559,0,2,3
97166,3,1,340560,340560,340561,0,1,1
97167,5,2,340565,340565,340567,0,2,4
97168,4,3,340569,340569,340572,0,3,2
97169,6,1,340575,340575,340576,0,1,3
97170,2,2,340577,340577,340579,0,2,1
97171,6,3,340583,340583,340586,0,3,4
97172,2,2,340585,340586,340588,1,3,0
97173,6,3,340591,340591,340594,0,3,3
97174,3,2,340594,340594,340596,0,2,0
97175,1,2,340595,340596,340598,1,3,0
97176,4,1,340599,340599,340600,0,1,1
97177,6,3,340605,340605,340608,0,3,5
97178,4,1,340609,340609,340610,0,1,1
97179,5,3,340614,340614,340617,0,3,4
97180,2,3,340616,340617,340620,1,4,0
97181,6,2,340622,340622,340624,0,2,2
97182,1,1,340623,340624,340625,1,2,0
97183,5,3,340628,340628,340631,0,3,3
97184,2,1,340630,340631,340632,1,2,0
97185,2,1,340632,340632,340633,0,1,0
97186,2,2,340634,340634,340636,0,2,1
97187,5,2,340639,340639,340641,0,2,3
97188,1,3,340640,340641,340644,1,4,0
97189,3,1,340643,340644,340645,1,2,0
97190,2,3,340645,340645,340648,0,3,0
97191,5,1,340650,340650,340651,0,1,2
97192,5,1,340655,340655,340656,0,1,4
97193,2,2,340657,340657,340659,0,2,1
97194,4,3,340661,340661,340664,0,3,2
97195,6,3,340667,340667,340670,0,3,3
97196,3,3,340670,340670,340673,0,3,0
97197,4,2,340674,340674,340676,0,2,1
97198,6,3,340680,340680,340683,0,3,4
97199,2,3,340682,340683,340686,1,4,0
97200,6,3,340688,340688,340691,0,3,2
97201,2,3,340690,340691,340694,1,4,0
97202,6,3,340696,340696,340699,0,3,2
97203,4,3,340700,340700,340703,0,3,1
97204,5,2,340705,340705,340707,0,2,2
97205,4,3,340709,340709,340712,0,3,2
97206,4,3,340713,340713,340716,0,3,1
97207,3,3,340716,340716,340719,0,3,0
97208,4,1,340720,340720,340721,0,1,1
97209,5,3,340725,340725,340728,0,3,4
97210,6,1,340731,340731,340732,0,1,3
97211,6,3,340737,340737,340740,0,3,5
97212,3,3,340740,340740,340743,0,3,0
97213,1,1,340741,340743,340744,2,3,0
97214,5,2,340746,340746,340748,0,2,2
97215,1,1,340747,340748,340749,1,2,0
97216,4,3,340751,340751,340754,0,3,2
97217,2,3,340753,340754,340757,1,4,0
97218,1,2,340754,340757,340759,3,5,0
97219,5,1,340759,340759,340760,0,1,0
97220,2,1,340761,340761,340762,0,1,1
97221,4,3,340765,340765,340768,0,3,3
97222,6,1,340771,340771,340772,0,1,3
97223,5,3,340776,340776,340779,0,3,4
97224,6,2,340782,340782,340784,0,2,3
97225,2,1,340784,340784,340785,0,1,0
97226,5,3,340789,340789,340792,0,3,4
97227,4,2,340793,340793,340795,0,2,1
97228,4,3,340797,340797,340800,0,3,2
97229,1,2,340798,340800,340802,2,4,0
97230,2,2,340800,340802,340804,2,4,0
97231,1,1,340801,340804,340805,3,4,0
97232,3,2,340804,340805,340807,1,3,0
97233,4,2,340808,340808,340810,0,2,1
97234,5,2,340813,340813,340815,0,2,3
97235,3,3,340816,340816,340819,0,3,1
97236,3,1,340819,340819,340820,0,1,0
97237,4,3,340823,340823,340826,0,3,3
97238,6,3,340829,340829,340832,0,3,3
97239,4,1,340833,340833,340834,0,1,1
97240,1,3,340834,340834,340837,0,3,0
97241,2,1,340836,340837,340838,1,2,0
97242,6,1,340842,340842,340843,0,1,4
97243,4,3,340846,340846,340849,0,3,3
97244,1,2,340847,340849,340851,2,4,0
97245,2,1,340849,340851,340852,2,3,0
97246,3,2,340852,340852,340854,0,2,0
97247,4,3,340856,340856,340859,0,3,2
97248,4,3,340860,340860,340863,0,3,1
97249,4,2,340864,340864,340866,0,2,1
97250,3,3,340867,340867,340870,0,3,1
97251,5,2,340872,340872,340874,0,2,2
97252,2,2,340874,340874,340876,0,2,0
97253,3,1,340877,340877,340878,0,1,1
97254,5,3,340882,340882,340885,0,3,4
97255,5,2,340887,340887,340889,0,2,2
97256,5,2,340892,340892,340894,0,2,3
97257,4,2,340896,340896,340898,0,2,2
97258,4,2,340900,340900,340902,0,2,2
97259,4,2,340904,340904,340906,0,2,2
97260,1,2,340905,340906,340908,1,3,0
97261,6,3,340911,340911,340914,0,3,3
97262,2,1,340913,340914,340915,1,2,0
97263,2,1,340915,340915,340916,0,1,0
97264,6,2,340921,340921,340923,0,2,5
97265,1,1,340922,340923,340924,1,2,0
97266,1,1,340923,340924,340925,1,2,0
97267,4,1,340927,340927,340928,0,1,2
97268,1,1,340928,340928,340929,0,1,0
97269,6,2,340934,340934,340936,0,2,5
97270,3,1,340937,340937,340938,0,1,1
97271,5,1,340942,340942,340943,0,1,4
97272,2,3,340944,340944,340947,0,3,1
97273,5,2,340949,340949,340951,0,2,2
97274,6,1,340955,340955,340956,0,1,4
97275,6,3,340961,340961,340964,0,3,5
97276,1,3,340962,340964,340967,2,5,0
97277,6,3,340968,340968,340971,0,3,1
97278,4,1,340972,340972,340973,0,1,1
97279,6,1,340978,340978,340979,0,1,5
97280,4,1,340982,340982,340983,0,1,3
97281,2,2,340984,340984,340986,0,2,1
97282,3,3,340987,340987,340990,0,3,1
97283,4,3,340991,340991,340994,0,3,1
97284,3,3,340994,340994,340997,0,3,0
97285,6,1,341000,341000,341001,0,1,3
97286,5,2,341005,341005,341007,0,2,4
97287,1,2,341006,341007,341009,1,3,0
97288,1,1,341007,341009,341010,2,3,0
97289,3,1,341010,341010,341011,0,1,0
97290,5,3,341015,341015,341018,0,3,4
97291,6,2,341021,341021,341023,0,2,3
97292,3,3,341024,341024,341027,0,3,1
97293,5,3,341029,341029,341032,0,3,2
97294,1,2,341030,341032,341034,2,4,0
97295,6,1,341036,341036,341037,0,1,2
97296,5,1,341041,341041,341042,0,1,4
97297,6,1,341047,341047,341048,0,1,5
97298,2,3,341049,341049,341052,0,3,1
97299,3,3,341052,341052,341055,0,3,0
97300,2,1,341054,341055,341056,1,2,0
97301,5,2,341059,341059,341061,0,2,3
97302,3,2,341062,341062,341064,0,2,1
97303,2,3,341064,341064,341067,0,3,0
97304,4,3,341068,341068,341071,0,3,1
97305,5,1,341073,341073,341074,0,1,2
97306,3,2,341076,341076,341078,0,2,2
97307,3,3,341079,341079,341082,0,3,1
97308,3,1,341082,341082,341083,0,1,0
97309,5,1,341087,341087,341088,0,1,4
97310,1,2,341088,341088,341090,0,2,0
97311,4,1,341092,341092,341093,0,1,2
97312,6,2,341098,341098,341100,0,2,5
97313,1,2,341099,341100,341102,1,3,0
97314,2,1,341101,341102,341103,1,2,0
97315,6,3,341107,341107,341110,0,3,4
97316,3,1,341110,341110,341111,0,1,0
97317,3,1,341113,341113,341114,0,1,2
97318,2,1,341115,341115,341116,0,1,1
97319,4,2,341119,341119,341121,0,2,3
97320,6,3,341125,341125,341128,0,3,4
97321,3,2,341128,341128,341130,0,2,0
97322,5,3,341133,341133,341136,0,3,3
97323,6,3,341139,341139,341142,0,3,3
97324,3,2,341142,341142,341144,0,2,0
97325,5,1,341147,341147,341148,0,1,3
97326,2,2,341149,341149,341151,0,2,1
97327,4,3,341153,341153,341156,0,3,2
97328,5,3,341158,341158,341161,0,3,2
97329,6,3,341164,341164,341167,0,3,3
97330,6,1,341170,341170,341171,0,1,3
97331,3,1,341173,341173,341174,0,1,2
97332,4,3,341177,341177,341180,0,3,3
97333,2,2,341179,341180,341182,1,3,0
97334,3,2,341182,341182,341184,0,2,0
97335,3,3,341185,341185,341188,0,3,1
97336,3,3,341188,341188,341191,0,3,0
97337,5,2,341193,341193,341195,0,2,2
97338,6,3,341199,341199,341202,0,3,4
97339,1,1,341200,341202,341203,2,3,0
97340,3,1,341203,341203,341204,0,1,0
97341,3,2,341206,341206,341208,0,2,2
97342,4,1,341210,341210,341211,0,1,2
97343,2,3,341212,341212,341215,0,3,1
97344,4,1,341216,341216,341217,0,1,1
97345,6,2,341222,341222,341224,0,2,5
97346,1,3,341223,341224,341227,1,4,0
97347,4,3,341227,341227,341230,0,3,0
97348,6,3,341233,341233,341236,0,3,3
97349,3,3,341236,341236,341239,0,3,0
97350,2,3,341238,341239,341242,1,4,0
97351,1,2,341239,341242,341244,3,5,0
97352,5,3,341244,341244,341247,0,3,0
97353,6,2,341250,341250,341252,0,2,3
97354,4,2,341254,341254,341256,0,2,2
97355,3,2,341257,341257,341259,0,2,1
97356,6,2,341263,341263,341265,0,2,4
97357,3,1,341266,341266,341267,0,1,1
97358,3,3,341269,341269,341272,0,3,2
97359,6,2,341275,341275,341277,0,2,3
97360,5,2,341280,341280,341282,0,2,3
97361,3,2,341283,341283,341285,0,2,1
97362,5,2,341288,341288,341290,0,2,3
97363,5,2,341293,341293,341295,0,2,3
97364,5,1,341298,341298,341299,0,1,3
97365,3,2,341301,341301,341303,0,2,2
97366,6,2,341307,341307,341309,0,2,4
97367,2,3,341309,341309,341312,0,3,0
97368,1,2,341310,341312,341314,2,4,0
97369,6,3,341316,341316,341319,0,3,2
97370,5,3,341321,341321,341324,0,3,2
97371,6,3,341327,341327,341330,0,3,3
97372,2,2,341329,341330,341332,1,3,0
97373,1,3,341330,341332,341335,2,5,0
97374,2,2,341332,341335,341337,3,5,0
97375,4,3,341336,341337,341340,1,4,0
97376,3,1,341339,341340,341341,1,2,0
97377,6,1,341345,341345,341346,0,1,4
97378,3,3,341348,341348,341351,0,3,2
97379,6,3,341354,341354,341357,0,3,3
97380,3,2,341357,341357,341359,0,2,0
97381,4,3,341361,341361,341364,0,3,2
97382,5,1,341366,341366,341367,0,1,2
97383,4,1,341370,341370,341371,0,1,3
97384,5,3,341375,341375,341378,0,3,4
97385,5,2,341380,341380,341382,0,2,2
97386,6,3,341386,341386,341389,0,3,4
97387,6,2,341392,341392,341394,0,2,3
97388,3,1,341395,341395,341396,0,1,1
97389,6,2,341401,341401,341403,0,2,5
97390,4,3,341405,341405,341408,0,3,2
97391,1,3,341406,341408,341411,2,5,0
97392,5,1,341411,341411,341412,0,1,0
97393,6,3,341417,341417,341420,0,3,5
97394,1,1,341418,341420,341421,2,3,0
97395,6,3,341424,341424,341427,0,3,3
97396,3,3,341427,341427,341430,0,3,0
97397,4,3,341431,341431,341434,0,3,1
97398,3,1,341434,341434,341435,0,1,0
97399,3,2,341437,341437,341439,0,2,2
97400,5,1,341442,341442,341443,0,1,3
97401,5,2,341447,341447,341449,0,2,4
97402,1,2,341448,341449,341451,1,3,0
97403,4,1,341452,341452,341453,0,1,1
97404,2,1,341454,341454,341455,0,1,1
97405,2,1,341456,341456,341457,0,1,1
97406,3,1,341459,341459,341460,0,1,2
97407,6,3,341465,341465,341468,0,3,5
97408,1,3,341466,341468,341471,2,5,0
97409,2,2,341468,341471,341473,3,5,0
97410,1,1,341469,341473,341474,4,5,0
97411,6,3,341475,341475,341478,0,3,1
97412,3,3,341478,341478,341481,0,3,0
97413,3,1,341481,341481,341482,0,1,0
97414,6,3,341487,341487,341490,0,3,5
97415,4,2,341491,341491,341493,0,2,1
97416,4,2,341495,341495,341497,0,2,2
97417,4,3,341499,341499,341502,0,3,2
97418,3,3,341502,341502,341505,0,3,0
97419,4,1,341506,341506,341507,0,1,1
97420,1,3,341507,341507,341510,0,3,0
97421,1,1,341508,341510,341511,2,3,0
97422,3,1,341511,341511,341512,0,1,0
97423,3,3,341514,341514,341517,0,3,2
97424,4,1,341518,341518,341519,0,1,1
97425,1,2,341519,341519,341521,0,2,0
97426,5,3,341524,341524,341527,0,3,3
97427,3,1,341527,341527,341528,0,1,0
97428,4,3,341531,341531,341534,0,3,3
97429,3,1,341534,341534,341535,0,1,0
97430,4,1,341538,341538,341539,0,1,3
97431,6,3,341544,341544,341547,0,3,5
97432,3,1,341547,341547,341548,0,1,0
97433,2,1,341549,341549,341550,0,1,1
97434,5,2,341554,341554,341556,0,2,4
97435,1,1,341555,341556,341557,1,2,0
97436,5,1,341560,341560,341561,0,1,3
97437,6,1,341566,341566,341567,0,1,5
97438,2,1,341568,341568,341569,0,1,1
97439,1,1,341569,341569,341570,0,1,0
97440,4,3,341573,341573,341576,0,3,3
97441,2,1,341575,341576,341577,1,2,0
97442,5,3,341580,341580,341583,0,3,3
97443,4,3,341584,341584,341587,0,3,1
97444,1,1,341585,341587,341588,2,3,0
97445,6,3,341591,341591,341594,0,3,3
97446,1,3,341592,341594,341597,2,5,0
97447,6,1,341598,341598,341599,0,1,1
97448,6,3,341604,341604,341607,0,3,5
97449,6,3,341610,341610,341613,0,3,3
97450,1,3,341611,341613,341616,2,5,0
97451,5,2,341616,341616,341618,0,2,0
97452,3,2,341619,341619,341621,0,2,1
97453,1,3,341620,341621,341624,1,4,0
97454,6,3,341626,341626,341629,0,3,2
97455,6,2,341632,341632,341634,0,2,3
97456,1,2,341633,341634,341636,1,3,0
97457,2,1,341635,341636,341637,1,2,0
97458,2,3,341637,341637,341640,0,3,0
97459,2,3,341639,341640,341643,1,4,0
97460,1,2,341640,341643,341645,3,5,0
97461,4,3,341644,341645,341648,1,4,0
97462,3,2,341647,341648,341650,1,3,0
97463,6,1,341653,341653,341654,0,1,3
97464,1,1,341654,341654,341655,0,1,0
97465,6,2,341660,341660,341662,0,2,5
97466,1,3,341661,341662,341665,1,4,0
97467,1,2,341662,341665,341667,3,5,0
97468,4,3,341666,341667,341670,1,4,0
97469,4,3,341670,341670,341673,0,3,0
97470,3,3,341673,341673,341676,0,3,0
97471,6,3,341679,341679,341682,0,3,3
97472,4,3,341683,341683,341686,0,3,1
97473,1,2,341684,341686,341688,2,4,0
97474,2,2,341686,341688,341690,2,4,0
97475,2,3,341688,341690,341693,2,5,0
97476,3,1,341691,341693,341694,2,3,0
97477,4,3,341695,341695,341698,0,3,1
97478,2,2,341697,341698,341700,1,3,0
97479,1,3,341698,341700,341703,2,5,0
97480,6,2,341704,341704,341706,0,2,1
97481,5,3,341709,341709,341712,0,3,3
97482,5,2,341714,341714,341716,0,2,2
97483,3,1,341717,341717,341718,0,1,1
97484,5,3,341722,341722,341725,0,3,4
97485,3,3,341725,341725,341728,0,3,0
97486,4,1,341729,341729,341730,0,1,1
97487,4,3,341733,341733,341736,0,3,3
97488,3,2,341736,341736,341738,0,2,0
97489,3,2,341739,341739,341741,0,2,1
97490,6,1,341745,341745,341746,0,1,4
97491,6,1,341751,341751,341752,0,1,5
97492,2,3,341753,341753,341756,0,3,1
97493,6,1,341759,341759,341760,0,1,3
97494,5,2,341764,341764,341766,0,2,4
97495,2,1,341766,341766,341767,0,1,0
97496,4,3,341770,341770,341773,0,3,3
97497,2,2,341772,341773,341775,1,3,0
97498,6,2,341778,341778,341780,0,2,3
97499,1,2,341779,341780,341782,1,3,0
97500,3,3,341782,341782,341785,0,3,0
97501,4,3,341786,341786,341789,0,3,1
97502,2,2,341788,341789,341791,1,3,0
97503,3,3,341791,341791,341794,0,3,0
97504,5,1,341796,341796,341797,0,1,2
97505,4,1,341800,341800,341801,0,1,3
97506,3,1,341803,341803,341804,0,1,2
97507,3,1,341806,341806,341807,0,1,2
97508,6,2,341812,341812,341814,0,2,5
97509,2,2,341814,341814,341816,0,2,0
97510,5,2,341819,341819,341821,0,2,3
97511,3,2,341822,341822,341824,0,2,1
97512,5,1,341827,341827,341828,0,1,3
97513,5,1,341832,341832,341833,0,1,4
97514,2,1,341834,341834,341835,0,1,1
97515,3,2,341837,341837,341839,0,2,2
97516,3,3,341840,341840,341843,0,3,1
97517,4,2,341844,341844,341846,0,2,1
97518,1,1,341845,341846,341847,1,2,0
97519,4,3,341849,341849,341852,0,3,2
97520,4,2,341853,341853,341855,0,2,1
97521,1,1,341854,341855,341856,1,2,0
97522,6,1,341860,341860,341861,0,1,4
97523,3,3,341863,341863,341866,0,3,2
97524,2,3,341865,341866,341869,1,4,0
97525,6,1,341871,341871,341872,0,1,2
97526,5,3,341876,341876,341879,0,3,4
97527,2,3,341878,341879,341882,1,4,0
97528,6,1,341884,341884,341885,0,1,2
97529,5,1,341889,341889,341890,0,1,4
97530,6,1,341895,341895,341896,0,1,5
97531,5,1,341900,341900,341901,0,1,4
97532,4,2,341904,341904,341906,0,2,3
97533,3,2,341907,341907,341909,0,2,1
97534,4,2,341911,341911,341913,0,2,2
97535,2,2,341913,341913,341915,0,2,0
97536,5,3,341918,341918,341921,0,3,3
97537,1,3,341919,341921,341924,2,5,0
97538,5,2,341924,341924,341926,0,2,0
97539,6,3,341930,341930,341933,0,3,4
97540,4,3,341934,341934,341937,0,3,1
97541,2,3,341936,341937,341940,1,4,0
97542,3,1,341939,341940,341941,1,2,0
97543,6,1,341945,341945,341946,0,1,4
97544,6,2,341951,341951,341953,0,2,5
97545,4,2,341955,341955,341957,0,2,2
97546,4,2,341959,341959,341961,0,2,2
97547,3,3,341962,341962,341965,0,3,1
97548,2,3,341964,341965,341968,1,4,0
97549,5,1,341969,341969,341970,0,1,1
97550,3,3,341972,341972,341975,0,3,2
97551,4,3,341976,341976,341979,0,3,1
97552,3,1,341979,341979,341980,0,1,0
97553,3,1,341982,341982,341983,0,1,2
97554,4,1,341986,341986,341987,0,1,3
97555,6,2,341992,341992,341994,0,2,5
97556,3,2,341995,341995,341997,0,2,1
97557,5,3,342000,342000,342003,0,3,3
97558,2,3,342002,342003,342006,1,4,0
97559,5,2,342007,342007,342009,0,2,1
97560,4,1,342011,342011,342012,0,1,2
97561,5,3,342016,342016,342019,0,3,4
97562,5,3,342021,342021,342024,0,3,2
97563,1,2,342022,342024,342026,2,4,0
97564,2,1,342024,342026,342027,2,3,0
97565,4,1,342028,342028,342029,0,1,1
97566,6,1,342034,342034,342035,0,1,5
97567,5,1,342039,342039,342040,0,1,4
97568,5,2,342044,342044,342046,0,2,4
97569,6,3,342050,342050,342053,0,3,4
97570,5,2,342055,342055,342057,0,2,2
97571,2,3,342057,342057,342060,0,3,0
97572,1,2,342058,342060,342062,2,4,0
97573,5,3,342063,342063,342066,0,3,1
97574,2,2,342065,342066,342068,1,3,0
97575,5,2,342070,342070,342072,0,2,2
97576,2,1,342072,342072,342073,0,1,0
97577,4,1,342076,342076,342077,0,1,3
97578,6,3,342082,342082,342085,0,3,5
97579,3,1,342085,342085,342086,0,1,0
97580,2,1,342087,342087,342088,0,1,1
97581,5,1,342092,342092,342093,0,1,4
97582,5,1,342097,342097,342098,0,1,4
97583,3,2,342100,342100,342102,0,2,2
97584,4,3,342104,342104,342107,0,3,2
97585,1,1,342105,342107,342108,2,3,0
97586,3,3,342108,342108,342111,0,3,0
97587,4,2,342112,342112,342114,0,2,1
97588,1,2,342113,342114,342116,1,3,0
97589,1,1,342114,342116,342117,2,3,0
97590,5,1,342119,342119,342120,0,1,2
97591,5,3,342124,342124,342127,0,3,4
97592,6,1,342130,342130,342131,0,1,3
97593,1,3,342131,342131,342134,0,3,0
97594,5,2,342136,342136,342138,0,2,2
97595,4,2,342140,342140,342142,0,2,2
97596,3,2,342143,342143,342145,0,2,1
97597,1,3,342144,342145,342148,1,4,0
97598,5,3,342149,342149,342152,0,3,1
97599,5,2,342154,342154,342156,0,2,2
97600,1,3,342155,342156,342159,1,4,0
97601,3,2,342158,342159,342161,1,3,0
97602,4,2,342162,342162,342164,0,2,1
97603,3,1,342165,342165,342166,0,1,1
97604,1,1,342166,342166,342167,0,1,0
97605,6,1,342172,342172,342173,0,1,5
97606,2,2,342174,342174,342176,0,2,1
97607,2,3,342176,342176,342179,0,3,0
97608,6,1,342182,342182,342183,0,1,3
97609,5,2,342187,342187,342189,0,2,4
97610,1,3,342188,342189,342192,1,4,0
97611,1,3,342189,342192,342195,3,6,0
97612,3,3,342192,342195,342198,3,6,0
97613,3,2,342195,342198,342200,3,5,0
97614,1,3,342196,342200,342203,4,7,0
97615,2,3,342198,342203,342206,5,8,0
97616,1,2,342199,342206,342208,7,9,0
97617,4,1,342203,342208,342209,5,6,0
97618,4,2,342207,342209,342211,2,4,0
97619,4,2,342211,342211,342213,0,2,0
97620,1,3,342212,342213,342216,1,4,0
97621,3,2,342215,342216,342218,1,3,0
97622,2,3,342217,342218,342221,1,4,0
97623,4,2,342221,342221,342223,0,2,0
97624,1,2,342222,342223,342225,1,3,0
97625,3,3,342225,342225,342228,0,3,0
97626,4,2,342229,342229,342231,0,2,1
97627,6,2,342235,342235,342237,0,2,4
97628,1,1,342236,342237,342238,1,2,0
97629,3,3,342239,342239,342242,0,3,1
97630,1,1,342240,342242,342243,2,3,0
97631,4,1,342244,342244,342245,0,1,1
97632,3,2,342247,342247,342249,0,2,2
97633,1,1,342248,342249,342250,1,2,0
97634,1,2,342249,342250,342252,1,3,0
97635,5,2,342254,342254,342256,0,2,2
97636,6,1,342260,342260,342261,0,1,4
97637,4,2,342264,342264,342266,0,2,3
97638,1,3,342265,342266,342269,1,4,0
97639,1,3,342266,342269,342272,3,6,0
97640,2,1,342268,342272,342273,4,5,0
97641,1,1,342269,342273,342274,4,5,0
97642,6,3,342275,342275,342278,0,3,1
97643,6,2,342281,342281,342283,0,2,3
97644,3,3,342284,342284,342287,0,3,1
97645,4,2,342288,342288,342290,0,2,1
97646,4,3,342292,342292,342295,0,3,2
97647,2,3,342294,342295,342298,1,4,0
97648,2,2,342296,342298,342300,2,4,0
97649,4,1,342300,342300,342301,0,1,0
97650,5,2,342305,342305,342307,0,2,4
97651,5,3,342310,342310,342313,0,3,3
97652,5,1,342315,342315,342316,0,1,2
97653,6,2,342321,342321,342323,0,2,5
97654,1,1,342322,342323,342324,1,2,0
97655,6,3,342328,342328,342331,0,3,4
97656,6,2,342334,342334,342336,0,2,3
97657,2,2,342336,342336,342338,0,2,0
97658,6,2,342342,342342,342344,0,2,4
97659,6,1,342348,342348,342349,0,1,4
97660,3,1,342351,342351,342352,0,1,2
97661,2,2,342353,342353,342355,0,2,1
97662,2,1,342355,342355,342356,0,1,0
97663,6,3,342361,342361,342364,0,3,5
97664,5,3,342366,342366,342369,0,3,2
97665,6,3,342372,342372,342375,0,3,3
97666,6,1,342378,342378,342379,0,1,3
97667,6,3,342384,342384,342387,0,3,5
97668,1,1,342385,342387,342388,2,3,0
97669,1,3,342386,342388,342391,2,5,0
97670,1,2,342387,342391,342393,4,6,0
97671,3,2,342390,342393,342395,3,5,0
97672,6,3,342396,342396,342399,0,3,1
97673,4,1,342400,342400,342401,0,1,1
97674,3,2,342403,342403,342405,0,2,2
97675,2,1,342405,342405,342406,0,1,0
97676,6,1,342411,342411,342412,0,1,5
97677,3,2,342414,342414,342416,0,2,2
97678,1,3,342415,342416,342419,1,4,0
97679,2,3,342417,342419,342422,2,5,0
97680,4,1,342421,342422,342423,1,2,0
97681,1,1,342422,342423,342424,1,2,0
97682,1,3,342423,342424,342427,1,4,0
97683,5,2,342428,342428,342430,0,2,1
97684,3,3,342431,342431,342434,0,3,1
97685,5,1,342436,342436,342437,0,1,2
97686,1,1,342437,342437,342438,0,1,0
97687,1,3,342438,342438,342441,0,3,0
97688,5,2,342443,342443,342445,0,2,2
97689,2,2,342445,342445,342447,0,2,0
97690,5,2,342450,342450,342452,0,2,3
97691,5,2,342455,342455,342457,0,2,3
97692,2,1,342457,342457,342458,0,1,0
97693,4,1,342461,342461,342462,0,1,3
97694,4,2,342465,342465,342467,0,2,3
97695,5,1,342470,342470,342471,0,1,3
97696,1,3,342471,342471,342474,0,3,0
97697,2,1,342473,342474,342475,1,2,0
97698,5,1,342478,342478,342479,0,1,3
97699,4,1,342482,342482,342483,0,1,3
97700,6,1,342488,342488,342489,0,1,5
97701,2,1,342490,342490,342491,0,1,1
97702,3,3,342493,342493,342496,0,3,2
97703,2,1,342495,342496,342497,1,2,0
97704,3,2,342498,342498,342500,0,2,1
97705,3,1,342501,342501,342502,0,1,1
97706,1,1,342502,342502,342503,0,1,0
97707,4,1,342506,342506,342507,0,1,3
97708,2,2,342508,342508,342510,0,2,1
97709,2,2,342510,342510,342512,0,2,0
97710,2,2,342512,342512,342514,0,2,0
97711,4,3,342516,342516,342519,0,3,2
97712,1,2,342517,342519,342521,2,4,0
97713,4,1,342521,342521,342522,0,1,0
97714,1,3,342522,342522,342525,0,3,0
97715,3,1,342525,342525,342526,0,1,0
97716,2,1,342527,342527,342528,0,1,1
97717,6,1,342533,342533,342534,0,1,5
97718,5,2,342538,342538,342540,0,2,4
97719,3,2,342541,342541,342543,0,2,1
97720,4,3,342545,342545,342548,0,3,2
97721,1,2,342546,342548,342550,2,4,0
97722,3,1,342549,342550,342551,1,2,0
97723,1,2,342550,342551,342553,1,3,0
97724,2,2,342552,342553,342555,1,3,0
97725,4,2,342556,342556,342558,0,2,1
97726,6,2,342562,342562,342564,0,2,4
97727,1,2,342563,342564,342566,1,3,0
97728,6,2,342569,342569,342571,0,2,3
97729,3,1,342572,342572,342573,0,1,1
97730,5,1,342577,342577,342578,0,1,4
97731,6,2,342583,342583,342585,0,2,5
97732,4,3,342587,342587,342590,0,3,2
97733,2,2,342589,342590,342592,1,3,0
97734,1,2,342590,342592,342594,2,4,0
97735,2,3,342592,342594,342597,2,5,0
97736,2,2,342594,342597,342599,3,5,0
97737,6,1,342600,342600,342601,0,1,1
97738,3,2,342603,342603,342605,0,2,2
97739,5,1,342608,342608,342609,0,1,3
97740,1,3,342609,342609,342612,0,3,0
97741,2,2,342611,342612,342614,1,3,0
97742,6,3,342617,342617,342620,0,3,3
97743,1,2,342618,342620,342622,2,4,0
97744,6,3,342624,342624,342627,0,3,2
97745,2,1,342626,342627,342628,1,2,0
97746,4,1,342630,342630,342631,0,1,2
97747,3,2,342633,342633,342635,0,2,2
97748,6,2,342639,342639,342641,0,2,4
97749,1,2,342640,342641,342643,1,3,0
97750,5,1,342645,342645,342646,0,1,2
97751,6,1,342651,342651,342652,0,1,5
97752,6,1,342657,342657,342658,0,1,5
97753,5,3,342662,342662,342665,0,3,4
97754,2,3,342664,342665,342668,1,4,0
97755,2,3,342666,342668,342671,2,5,0
97756,6,1,342672,342672,342673,0,1,1
97757,6,3,342678,342678,342681,0,3,5
97758,6,1,342684,342684,342685,0,1,3
97759,3,2,342687,342687,342689,0,2,2
97760,2,1,342689,342689,342690,0,1,0
97761,4,3,342693,342693,342696,0,3,3
97762,3,2,342696,342696,342698,0,2,0
97763,6,3,342702,342702,342705,0,3,4
97764,2,3,342704,342705,342708,1,4,0
97765,2,3,342706,342708,342711,2,5,0
97766,4,2,342710,342711,342713,1,3,0
97767,5,3,342715,342715,342718,0,3,2
97768,6,3,342721,342721,342724,0,3,3
97769,4,1,342725,342725,342726,0,1,1
97770,3,3,342728,342728,342731,0,3,2
97771,4,1,342732,342732,342733,0,1,1
97772,2,1,342734,342734,342735,0,1,1
97773,3,1,342737,342737,342738,0,1,2
97774,4,2,342741,342741,342743,0,2,3
97775,3,3,342744,342744,342747,0,3,1
97776,4,1,342748,342748,342749,0,1,1
97777,4,1,342752,342752,342753,0,1,3
97778,2,3,342754,342754,342757,0,3,1
97779,3,1,342757,342757,342758,0,1,0
97780,1,2,342758,342758,342760,0,2,0
97781,6,1,342764,342764,342765,0,1,4
97782,3,1,342767,342767,342768,0,1,2
97783,4,1,342771,342771,342772,0,1,3
97784,1,1,342772,342772,342773,0,1,0
97785,1,2,342773,342773,342775,0,2,0
97786,3,2,342776,342776,342778,0,2,1
97787,5,3,342781,342781,342784,0,3,3
97788,3,2,342784,342784,342786,0,2,0
97789,6,1,342790,342790,342791,0,1,4
97790,5,2,342795,342795,342797,0,2,4
97791,4,2,342799,342799,342801,0,2,2
97792,4,3,342803,342803,342806,0,3,2
97793,1,3,342804,342806,342809,2,5,0
97794,6,2,342810,342810,342812,0,2,1
97795,4,1,342814,342814,342815,0,1,2
97796,4,1,342818,342818,342819,0,1,3
97797,6,1,342824,342824,342825,0,1,5
97798,6,3,342830,342830,342833,0,3,5
97799,4,2,342834,342834,342836,0,2,1
97800,4,3,342838,342838,342841,0,3,2
97801,2,1,342840,342841,342842,1,2,0
97802,1,3,342841,342842,342845,1,4,0
97803,5,2,342846,342846,342848,0,2,1
97804,4,2,342850,342850,342852,0,2,2
97805,5,1,342855,342855,342856,0,1,3
97806,6,1,342861,342861,342862,0,1,5
97807,2,3,342863,342863,342866,0,3,1
97808,6,3,342869,342869,342872,0,3,3
97809,3,3,342872,342872,342875,0,3,0
97810,4,2,342876,342876,342878,0,2,1
97811,2,3,342878,342878,342881,0,3,0
97812,3,3,342881,342881,342884,0,3,0
97813,2,1,342883,342884,342885,1,2,0
97814,5,2,342888,342888,342890,0,2,3
97815,1,1,342889,342890,342891,1,2,0
97816,5,1,342894,342894,342895,0,1,3
97817,5,1,342899,342899,342900,0,1,4
97818,4,1,342903,342903,342904,0,1,3
97819,6,3,342909,342909,342912,0,3,5
97820,3,1,342912,342912,342913,0,1,0
97821,4,2,342916,342916,342918,0,2,3
97822,1,2,342917,342918,342920,1,3,0
97823,1,2,342918,342920,342922,2,4,0
97824,1,3,342919,342922,342925,3,6,0
97825,3,2,342922,342925,342927,3,5,0
97826,6,3,342928,342928,342931,0,3,1
97827,4,3,342932,342932,342935,0,3,1
97828,5,3,342937,342937,342940,0,3,2
97829,3,2,342940,342940,342942,0,2,0
97830,5,1,342945,342945,342946,0,1,3
97831,5,3,342950,342950,342953,0,3,4
97832,5,3,342955,342955,342958,0,3,2
97833,5,1,342960,342960,342961,0,1,2
97834,1,1,342961,342961,342962,0,1,0
97835,5,2,342966,342966,342968,0,2,4
97836,3,2,342969,342969,342971,0,2,1
97837,1,1,342970,342971,342972,1,2,0
97838,4,3,342974,342974,342977,0,3,2
97839,4,2,342978,342978,342980,0,2,1
97840,1,2,342979,342980,342982,1,3,0
97841,1,2,342980,342982,342984,2,4,0
97842,2,3,342982,342984,342987,2,5,0
97843,3,3,342985,342987,342990,2,5,0
97844,4,3,342989,342990,342993,1,4,0
97845,1,3,342990,342993,342996,3,6,0
97846,6,2,342996,342996,342998,0,2,0
97847,3,2,342999,342999,343001,0,2,1
97848,2,1,343001,343001,343002,0,1,0
97849,3,3,343004,343004,343007,0,3,2
97850,1,3,343005,343007,343010,2,5,0
97851,6,2,343011,343011,343013,0,2,1
97852,6,1,343017,343017,343018,0,1,4
97853,6,1,343023,343023,343024,0,1,5
97854,1,2,343024,343024,343026,0,2,0
97855,4,3,343028,343028,343031,0,3,2
97856,2,2,343030,343031,343033,1,3,0
97857,6,1,343036,343036,343037,0,1,3
97858,6,3,343042,343042,343045,0,3,5
97859,6,3,343048,343048,343051,0,3,3
97860,4,1,343052,343052,343053,0,1,1
97861,5,1,343057,343057,343058,0,1,4
97862,5,3,343062,343062,343065,0,3,4
97863,5,1,343067,343067,343068,0,1,2
97864,6,3,343073,343073,343076,0,3,5
97865,6,1,343079,343079,343080,0,1,3
97866,1,1,343080,343080,343081,0,1,0
97867,6,2,343086,343086,343088,0,2,5
97868,1,1,343087,343088,343089,1,2,0
97869,3,2,343090,343090,343092,0,2,1
97870,2,3,343092,343092,343095,0,3,0
97871,5,2,343097,343097,343099,0,2,2
97872,1,2,343098,343099,343101,1,3,0
97873,4,3,343102,343102,343105,0,3,1
97874,5,3,343107,343107,343110,0,3,2
97875,1,2,343108,343110,343112,2,4,0
97876,6,2,343114,343114,343116,0,2,2
97877,6,3,343120,343120,343123,0,3,4
97878,4,2,343124,343124,343126,0,2,1
97879,6,3,343130,343130,343133,0,3,4
97880,2,1,343132,343133,343134,1,2,0
97881,2,3,343134,343134,343137,0,3,0
97882,5,2,343139,343139,343141,0,2,2
97883,3,2,343142,343142,343144,0,2,1
97884,3,1,343145,343145,343146,0,1,1
97885,4,2,343149,343149,343151,0,2,3
97886,5,1,343154,343154,343155,0,1,3
97887,6,2,343160,343160,343162,0,2,5
97888,5,2,343165,343165,343167,0,2,3
97889,2,3,343167,343167,343170,0,3,0
97890,2,3,343169,343170,343173,1,4,0
97891,5,1,343174,343174,343175,0,1,1
97892,5,1,343179,343179,343180,0,1,4
97893,6,3,343185,343185,343188,0,3,5
97894,5,2,343190,343190,343192,0,2,2
97895,6,2,343196,343196,343198,0,2,4
97896,2,1,343198,343198,343199,0,1,0
97897,1,1,343199,343199,343200,0,1,0
97898,4,1,343203,343203,343204,0,1,3
97899,6,1,343209,343209,343210,0,1,5
97900,5,1,343214,343214,343215,0,1,4
97901,3,1,343217,343217,343218,0,1,2
97902,3,1,343220,343220,343221,0,1,2
97903,5,2,343225,343225,343227,0,2,4
97904,2,1,343227,343227,343228,0,1,0
97905,5,2,343232,343232,343234,0,2,4
97906,5,2,343237,343237,343239,0,2,3
97907,3,3,343240,343240,343243,0,3,1
97908,5,1,343245,343245,343246,0,1,2
97909,1,2,343246,343246,343248,0,2,0
97910,4,2,343250,343250,343252,0,2,2
97911,5,3,343255,343255,343258,0,3,3
97912,3,2,343258,343258,343260,0,2,0
97913,6,3,343264,343264,343267,0,3,4
97914,4,1,343268,343268,343269,0,1,1
97915,4,1,343272,343272,343273,0,1,3
97916,3,1,343275,343275,343276,0,1,2
97917,2,2,343277,343277,343279,0,2,1
97918,6,2,343283,343283,343285,0,2,4
97919,5,1,343288,343288,343289,0,1,3
97920,4,3,343292,343292,343295,0,3,3
97921,6,3,343298,343298,343301,0,3,3
97922,4,3,343302,343302,343305,0,3,1
97923,6,2,343308,343308,343310,0,2,3
97924,6,2,343314,343314,343316,0,2,4
97925,5,1,343319,343319,343320,0,1,3
97926,3,2,343322,343322,343324,0,2,2
97927,2,1,343324,343324,343325,0,1,0
97928,6,3,343330,343330,343333,0,3,5
97929,4,3,343334,343334,343337,0,3,1
97930,1,2,343335,343337,343339,2,4,0
97931,6,2,343341,343341,343343,0,2,2
97932,1,3,343342,343343,343346,1,4,0
97933,3,1,343345,343346,343347,1,2,0
97934,5,2,343350,343350,343352,0,2,3
97935,2,1,343352,343352,343353,0,1,0
97936,2,1,343354,343354,343355,0,1,1
97937,2,2,343356,343356,343358,0,2,1
97938,4,3,343360,343360,343363,0,3,2
97939,5,1,343365,343365,343366,0,1,2
97940,1,2,343366,343366,343368,0,2,0
97941,4,1,343370,343370,343371,0,1,2
97942,1,1,343371,343371,343372,0,1,0
97943,2,3,343373,343373,343376,0,3,1
97944,1,1,343374,343376,343377,2,3,0
97945,2,1,343376,343377,343378,1,2,0
97946,5,2,343381,343381,343383,0,2,3
97947,3,2,343384,343384,343386,0,2,1
97948,1,3,343385,343386,343389,1,4,0
97949,4,1,343389,343389,343390,0,1,0
97950,5,2,343394,343394,343396,0,2,4
97951,4,2,343398,343398,343400,0,2,2
97952,5,2,343403,343403,343405,0,2,3
97953,5,1,343408,343408,343409,0,1,3
97954,2,3,343410,343410,343413,0,3,1
97955,1,2,343411,343413,343415,2,4,0
97956,3,2,343414,343415,343417,1,3,0
97957,1,2,343415,343417,343419,2,4,0
97958,1,2,343416,343419,343421,3,5,0
97959,3,2,343419,343421,343423,2,4,0
97960,5,1,343424,343424,343425,0,1,1
97961,2,2,343426,343426,343428,0,2,1
97962,3,2,343429,343429,343431,0,2,1
97963,2,1,343431,343431,343432,0,1,0
97964,4,1,343435,343435,343436,0,1,3
97965,4,3,343439,343439,343442,0,3,3
97966,1,3,343440,343442,343445,2,5,0
97967,6,3,343446,343446,343449,0,3,1
97968,1,1,343447,343449,343450,2,3,0
97969,4,1,343451,343451,343452,0,1,1
97970,3,2,343454,343454,343456,0,2,2
97971,2,3,343456,343456,343459,0,3,0
97972,4,3,343460,343460,343463,0,3,1
97973,1,2,343461,343463,343465,2,4,0
97974,3,2,343464,343465,343467,1,3,0
97975,6,3,343470,343470,343473,0,3,3
97976,5,3,343475,343475,343478,0,3,2
97977,2,2,343477,343478,343480,1,3,0
97978,6,2,343483,343483,343485,0,2,3
97979,2,1,343485,343485,343486,0,1,0
97980,6,2,343491,343491,343493,0,2,5
97981,5,1,343496,343496,343497,0,1,3
97982,1,1,343497,343497,343498,0,1,0
97983,3,3,343500,343500,343503,0,3,2
97984,5,3,343505,343505,343508,0,3,2
97985,3,1,343508,343508,343509,0,1,0
97986,5,1,343513,343513,343514,0,1,4
97987,4,2,343517,343517,343519,0,2,3
97988,1,3,343518,343519,343522,1,4,0
97989,1,1,343519,343522,343523,3,4,0
97990,1,3,343520,343523,343526,3,6,0
97991,4,3,343524,343526,343529,2,5,0
97992,6,3,343530,343530,343533,0,3,1
97993,1,3,343531,343533,343536,2,5,0
97994,2,2,343533,343536,343538,3,5,0
97995,1,3,343534,343538,343541,4,7,0
97996,6,3,343540,343541,343544,1,4,0
97997,1,1,343541,343544,343545,3,4,0
97998,2,3,343543,343545,343548,2,5,0
97999,5,2,343548,343548,343550,0,2,0
98000,1,2,343549,343550,343552,1,3,0
98001,5,3,343554,343554,343557,0,3,2
98002,5,2,343559,343559,343561,0,2,2
98003,4,3,343563,343563,343566,0,3,2
98004,3,3,343566,343566,343569,0,3,0
98005,5,2,343571,343571,343573,0,2,2
98006,1,2,343572,343573,343575,1,3,0
98007,6,3,343578,343578,343581,0,3,3
98008,3,2,343581,343581,343583,0,2,0
98009,6,2,343587,343587,343589,0,2,4
98010,6,2,343593,343593,343595,0,2,4
98011,3,3,343596,343596,343599,0,3,1
98012,1,1,343597,343599,343600,2,3,0
98013,4,2,343601,343601,343603,0,2,1
98014,4,2,343605,343605,343607,0,2,2
98015,4,2,343609,343609,343611,0,2,2
98016,5,3,343614,343614,343617,0,3,3
98017,3,2,343617,343617,343619,0,2,0
98018,5,1,343622,343622,343623,0,1,3
98019,4,2,343626,343626,343628,0,2,3
98020,3,3,343629,343629,343632,0,3,1
98021,5,2,343634,343634,343636,0,2,2
98022,5,2,343639,343639,343641,0,2,3
98023,4,1,343643,343643,343644,0,1,2
98024,6,3,343649,343649,343652,0,3,5
98025,4,3,343653,343653,343656,0,3,1
98026,4,2,343657,343657,343659,0,2,1
98027,3,3,343660,343660,343663,0,3,1
98028,4,1,343664,343664,343665,0,1,1
98029,6,3,343670,343670,343673,0,3,5
98030,2,2,343672,343673,343675,1,3,0
98031,4,3,343676,343676,343679,0,3,1
98032,1,3,343677,343679,343682,2,5,0
98033,2,3,343679,343682,343685,3,6,0
98034,1,3,343680,343685,343688,5,8,0
98035,6,1,343686,343688,343689,2,3,0
98036,6,3,343692,343692,343695,0,3,3
98037,4,2,343696,343696,343698,0,2,1
98038,3,2,343699,343699,343701,0,2,1
98039,5,1,343704,343704,343705,0,1,3
98040,3,2,343707,343707,343709,0,2,2
98041,5,1,343712,343712,343713,0,1,3
98042,4,1,343716,343716,343717,0,1,3
98043,6,3,343722,343722,343725,0,3,5
98044,4,1,343726,343726,343727,0,1,1
98045,1,1,343727,343727,343728,0,1,0
98046,3,2,343730,343730,343732,0,2,2
98047,1,2,343731,343732,343734,1,3,0
98048,3,2,343734,343734,343736,0,2,0
98049,4,3,343738,343738,343741,0,3,2
98050,2,3,343740,343741,343744,1,4,0
98051,3,3,343743,343744,343747,1,4,0
98052,6,3,343749,343749,343752,0,3,2
98053,1,2,343750,343752,343754,2,4,0
98054,3,2,343753,343754,343756,1,3,0
98055,1,2,343754,343756,343758,2,4,0
98056,1,3,343755,343758,343761,3,6,0
98057,3,3,343758,343761,343764,3,6,0
98058,6,3,343764,343764,343767,0,3,0
98059,5,2,343769,343769,343771,0,2,2
98060,3,1,343772,343772,343773,0,1,1
98061,5,2,343777,343777,343779,0,2,4
98062,1,1,343778,343779,343780,1,2,0
98063,5,1,343783,343783,343784,0,1,3
98064,2,2,343785,343785,343787,0,2,1
98065,6,2,343791,343791,343793,0,2,4
98066,3,1,343794,343794,343795,0,1,1
98067,5,3,343799,343799,343802,0,3,4
98068,3,3,343802,343802,343805,0,3,0
98069,6,2,343808,343808,343810,0,2,3
98070,5,1,343813,343813,343814,0,1,3
98071,3,1,343816,343816,343817,0,1,2
98072,2,2,343818,343818,343820,0,2,1
98073,1,3,343819,343820,343823,1,4,0
98074,4,3,343823,343823,343826,0,3,0
98075,5,3,343828,343828,343831,0,3,2
98076,3,3,343831,343831,343834,0,3,0
98077,3,2,343834,343834,343836,0,2,0
98078,6,3,343840,343840,343843,0,3,4
98079,1,1,343841,343843,343844,2,3,0
98080,3,3,343844,343844,343847,0,3,0
98081,5,1,343849,343849,343850,0,1,2
98082,6,2,343855,343855,343857,0,2,5
98083,4,1,343859,343859,343860,0,1,2
98084,6,3,343865,343865,343868,0,3,5
98085,3,3,343868,343868,343871,0,3,0
98086,2,3,343870,343871,343874,1,4,0
98087,1,1,343871,343874,343875,3,4,0
98088,4,2,343875,343875,343877,0,2,0
98089,6,3,343881,343881,343884,0,3,4
98090,5,1,343886,343886,343887,0,1,2
98091,4,3,343890,343890,343893,0,3,3
98092,4,3,343894,343894,343897,0,3,1
98093,2,1,343896,343897,343898,1,2,0
98094,5,3,343901,343901,343904,0,3,3
98095,2,3,343903,343904,343907,1,4,0
98096,4,3,343907,343907,343910,0,3,0
98097,6,3,343913,343913,343916,0,3,3
98098,2,1,343915,343916,343917,1,2,0
98099,3,3,343918,343918,343921,0,3,1
98100,2,3,343920,343921,343924,1,4,0
98101,2,2,343922,343924,343926,2,4,0
98102,2,1,343924,343926,343927,2,3,0
98103,5,1,343929,343929,343930,0,1,2
98104,5,2,343934,343934,343936,0,2,4
98105,2,1,343936,343936,343937,0,1,0
98106,2,3,343938,343938,343941,0,3,1
98107,3,3,343941,343941,343944,0,3,0
98108,2,3,343943,343944,343947,1,4,0
98109,4,2,343947,343947,343949,0,2,0
98110,3,1,343950,343950,343951,0,1,1
98111,1,2,343951,343951,343953,0,2,0
98112,5,2,343956,343956,343958,0,2,3
98113,5,2,343961,343961,343963,0,2,3
98114,3,3,343964,343964,343967,0,3,1
98115,4,3,343968,343968,343971,0,3,1
98116,2,2,343970,343971,343973,1,3,0
98117,3,3,343973,343973,343976,0,3,0
98118,5,3,343978,343978,343981,0,3,2
98119,2,2,343980,343981,343983,1,3,0
98120,4,3,343984,343984,343987,0,3,1
98121,1,3,343985,343987,343990,2,5,0
98122,3,3,343988,343990,343993,2,5,0
98123,3,2,343991,343993,343995,2,4,0
98124,6,2,343997,343997,343999,0,2,2
98125,5,1,344002,344002,344003,0,1,3
98126,5,2,344007,344007,344009,0,2,4
98127,6,2,344013,344013,344015,0,2,4
98128,2,1,344015,344015,344016,0,1,0
98129,5,1,344020,344020,344021,0,1,4
98130,3,2,344023,344023,344025,0,2,2
98131,6,3,344029,344029,344032,0,3,4
98132,2,3,344031,344032,344035,1,4,0
98133,6,1,344037,344037,344038,0,1,2
98134,1,2,344038,344038,344040,0,2,0
98135,2,2,344040,344040,344042,0,2,0
98136,3,2,344043,344043,344045,0,2,1
98137,2,1,344045,344045,344046,0,1,0
98138,1,3,344046,344046,344049,0,3,0
98139,4,1,344050,344050,344051,0,1,1
98140,4,1,344054,344054,344055,0,1,3
98141,5,2,344059,344059,344061,0,2,4
98142,3,2,344062,344062,344064,0,2,1
98143,2,2,344064,344064,344066,0,2,0
98144,6,3,344070,344070,344073,0,3,4
98145,4,1,344074,344074,344075,0,1,1
98146,1,3,344075,344075,344078,0,3,0
98147,1,2,344076,344078,344080,2,4,0
98148,3,2,344079,344080,344082,1,3,0
98149,3,1,344082,344082,344083,0,1,0
98150,1,3,344083,344083,344086,0,3,0
98151,2,3,344085,344086,344089,1,4,0
98152,1,1,344086,344089,344090,3,4,0
98153,1,1,344087,344090,344091,3,4,0
98154,2,2,344089,344091,344093,2,4,0
98155,6,1,344095,344095,344096,0,1,2
98156,5,1,344100,344100,344101,0,1,4
98157,3,1,344103,344103,344104,0,1,2
98158,3,3,344106,344106,344109,0,3,2
98159,5,3,344111,344111,344114,0,3,2
98160,5,1,344116,344116,344117,0,1,2
98161,4,1,344120,344120,344121,0,1,3
98162,2,1,344122,344122,344123,0,1,1
98163,1,2,344123,344123,344125,0,2,0
98164,1,1,344124,344125,344126,1,2,0
98165,3,2,344127,344127,344129,0,2,1
98166,5,2,344132,344132,344134,0,2,3
98167,6,3,344138,344138,344141,0,3,4
98168,5,2,344143,344143,344145,0,2,2
98169,1,1,344144,344145,344146,1,2,0
98170,1,1,344145,344146,344147,1,2,0
98171,1,2,344146,344147,344149,1,3,0
98172,3,1,344149,344149,344150,0,1,0
98173,6,2,344155,344155,344157,0,2,5
98174,3,1,344158,344158,344159,0,1,1
98175,3,2,344161,344161,344163,0,2,2
98176,6,2,344167,344167,344169,0,2,4
98177,5,3,344172,344172,344175,0,3,3
98178,5,3,344177,344177,344180,0,3,2
98179,5,2,344182,344182,344184,0,2,2
98180,2,3,344184,344184,344187,0,3,0
98181,2,3,344186,344187,344190,1,4,0
98182,5,2,344191,344191,344193,0,2,1
98183,2,3,344193,344193,344196,0,3,0
98184,4,3,344197,344197,344200,0,3,1
98185,5,1,344202,344202,344203,0,1,2
98186,3,3,344205,344205,344208,0,3,2
98187,6,2,344211,344211,344213,0,2,3
98188,5,1,344216,344216,344217,0,1,3
98189,6,2,344222,344222,344224,0,2,5
98190,4,3,344226,344226,344229,0,3,2
98191,3,2,344229,344229,344231,0,2,0
98192,5,1,344234,344234,344235,0,1,3
98193,5,3,344239,344239,344242,0,3,4
98194,3,2,344242,344242,344244,0,2,0
98195,5,2,344247,344247,344249,0,2,3
98196,2,3,344249,344249,344252,0,3,0
98197,4,3,344253,344253,344256,0,3,1
98198,5,2,344258,344258,344260,0,2,2
98199,6,2,344264,344264,344266,0,2,4
98200,2,2,344266,344266,344268,0,2,0
98201,1,2,344267,344268,344270,1,3,0
98202,2,3,344269,344270,344273,1,4,0
98203,1,1,344270,344273,344274,3,4,0
98204,3,2,344273,344274,344276,1,3,0
98205,6,1,344279,344279,344280,0,1,3
98206,1,1,344280,344280,344281,0,1,0
98207,1,3,344281,344281,344284,0,3,0
98208,2,1,344283,344284,344285,1,2,0
98209,6,3,344289,344289,344292,0,3,4
98210,3,1,344292,344292,344293,0,1,0
98211,4,1,344296,344296,344297,0,1,3
98212,4,2,344300,344300,344302,0,2,3
98213,5,1,344305,344305,344306,0,1,3
98214,3,1,344308,344308,344309,0,1,2
98215,2,1,344310,344310,344311,0,1,1
98216,5,1,344315,344315,344316,0,1,4
98217,2,3,344317,344317,344320,0,3,1
98218,6,2,344323,344323,344325,0,2,3
98219,2,1,344325,344325,344326,0,1,0
98220,4,2,344329,344329,344331,0,2,3
98221,6,1,344335,344335,344336,0,1,4
98222,2,1,344337,344337,344338,0,1,1
98223,5,3,344342,344342,344345,0,3,4
98224,3,3,344345,344345,344348,0,3,0
98225,6,2,344351,344351,344353,0,2,3
98226,3,1,344354,344354,344355,0,1,1
98227,1,1,344355,344355,344356,0,1,0
98228,6,3,344361,344361,344364,0,3,5
98229,5,2,344366,344366,344368,0,2,2
98230,2,3,344368,344368,344371,0,3,0
98231,3,2,344371,344371,344373,0,2,0
98232,2,1,344373,344373,344374,0,1,0
98233,4,2,344377,344377,344379,0,2,3
98234,4,1,344381,344381,344382,0,1,2
98235,1,1,344382,344382,344383,0,1,0
98236,6,2,344388,344388,344390,0,2,5
98237,5,1,344393,344393,344394,0,1,3
98238,3,3,344396,344396,344399,0,3,2
98239,4,3,344400,344400,344403,0,3,1
98240,6,3,344406,344406,344409,0,3,3
98241,1,3,344407,344409,344412,2,5,0
98242,3,3,344410,344412,344415,2,5,0
98243,3,3,344413,344415,344418,2,5,0
98244,5,3,344418,344418,344421,0,3,0
98245,4,3,344422,344422,344425,0,3,1
98246,5,3,344427,344427,344430,0,3,2
98247,3,1,344430,344430,344431,0,1,0
98248,4,1,344434,344434,344435,0,1,3
98249,4,3,344438,344438,344441,0,3,3
98250,3,1,344441,344441,344442,0,1,0
98251,4,3,344445,344445,344448,0,3,3
98252,5,1,344450,344450,344451,0,1,2
98253,2,3,344452,344452,344455,0,3,1
98254,5,2,344457,344457,344459,0,2,2
98255,6,3,344463,344463,344466,0,3,4
98256,4,2,344467,344467,344469,0,2,1
98257,4,2,344471,344471,344473,0,2,2
98258,4,2,344475,344475,344477,0,2,2
98259,6,3,344481,344481,344484,0,3,4
98260,2,1,344483,344484,344485,1,2,0
98261,6,2,344489,344489,344491,0,2,4
98262,2,2,344491,344491,344493,0,2,0
98263,1,1,344492,344493,344494,1,2,0
98264,6,1,344498,344498,344499,0,1,4
98265,5,3,344503,344503,344506,0,3,4
98266,5,3,344508,344508,344511,0,3,2
98267,5,2,344513,344513,344515,0,2,2
98268,6,1,344519,344519,344520,0,1,4
98269,5,3,344524,344524,344527,0,3,4
98270,5,2,344529,344529,344531,0,2,2
98271,1,1,344530,344531,344532,1,2,0
98272,6,3,344536,344536,344539,0,3,4
98273,3,2,344539,344539,344541,0,2,0
98274,5,1,344544,344544,344545,0,1,3
98275,6,1,344550,344550,344551,0,1,5
98276,6,3,344556,344556,344559,0,3,5
98277,2,1,344558,344559,344560,1,2,0
98278,5,1,344563,344563,344564,0,1,3
98279,3,1,344566,344566,344567,0,1,2
98280,1,3,344567,344567,344570,0,3,0
98281,2,1,344569,344570,344571,1,2,0
98282,2,1,344571,344571,344572,0,1,0
98283,2,1,344573,344573,344574,0,1,1
98284,3,3,344576,344576,344579,0,3,2
98285,4,1,344580,344580,344581,0,1,1
98286,6,1,344586,344586,344587,0,1,5
98287,2,2,344588,344588,344590,0,2,1
98288,1,1,344589,344590,344591,1,2,0
98289,5,2,344594,344594,344596,0,2,3
98290,3,1,344597,344597,344598,0,1,1
98291,3,2,344600,344600,344602,0,2,2
98292,4,3,344604,344604,344607,0,3,2
98293,5,3,344609,344609,344612,0,3,2
98294,5,2,344614,344614,344616,0,2,2
98295,6,3,344620,344620,344623,0,3,4
98296,2,1,344622,344623,344624,1,2,0
98297,1,1,344623,344624,344625,1,2,0
98298,5,2,344628,344628,344630,0,2,3
98299,1,3,344629,344630,344633,1,4,0
98300,6,1,344635,344635,344636,0,1,2
98301,1,1,344636,344636,344637,0,1,0
98302,3,3,344639,344639,344642,0,3,2
98303,1,2,344640,344642,344644,2,4,0
98304,4,3,344644,344644,344647,0,3,0
98305,2,3,344646,344647,344650,1,4,0
98306,2,3,344648,344650,344653,2,5,0
98307,5,2,344653,344653,344655,0,2,0
98308,4,3,344657,344657,344660,0,3,2
98309,6,3,344663,344663,344666,0,3,3
98310,2,1,344665,344666,344667,1,2,0
98311,4,1,344669,344669,344670,0,1,2
98312,1,1,344670,344670,344671,0,1,0
98313,3,2,344673,344673,344675,0,2,2
98314,2,1,344675,344675,344676,0,1,0
98315,2,1,344677,344677,344678,0,1,1
98316,3,2,344680,344680,344682,0,2,2
98317,3,2,344683,344683,344685,0,2,1
98318,6,2,344689,344689,344691,0,2,4
98319,3,2,344692,344692,344694,0,2,1
98320,1,2,344693,344694,344696,1,3,0
98321,5,2,344698,344698,344700,0,2,2
98322,5,2,344703,344703,344705,0,2,3
98323,4,2,344707,344707,344709,0,2,2
98324,6,2,344713,344713,344715,0,2,4
98325,4,2,344717,344717,344719,0,2,2
98326,5,3,344722,344722,344725,0,3,3
98327,4,2,344726,344726,344728,0,2,1
98328,3,2,344729,344729,344731,0,2,1
98329,3,3,344732,344732,344735,0,3,1
98330,4,2,344736,344736,344738,0,2,1
98331,6,3,344742,344742,344745,0,3,4
98332,3,1,344745,344745,344746,0,1,0
98333,3,3,344748,344748,344751,0,3,2
98334,3,3,344751,344751,344754,0,3,0
98335,1,3,344752,344754,344757,2,5,0
98336,6,3,344758,344758,344761,0,3,1
98337,4,3,344762,344762,344765,0,3,1
98338,2,3,344764,344765,344768,1,4,0
98339,2,1,344766,344768,344769,2,3,0
98340,2,2,344768,344769,344771,1,3,0
98341,4,1,344772,344772,344773,0,1,1
98342,6,2,344778,344778,344780,0,2,5
98343,6,3,344784,344784,344787,0,3,4
98344,1,3,344785,344787,344790,2,5,0
98345,2,3,344787,344790,344793,3,6,0
98346,6,3,344793,344793,344796,0,3,0
98347,3,1,344796,344796,344797,0,1,0
98348,3,2,344799,344799,344801,0,2,2
98349,5,1,344804,344804,344805,0,1,3
98350,2,3,344806,344806,344809,0,3,1
98351,5,2,344811,344811,344813,0,2,2
98352,3,2,344814,344814,344816,0,2,1
98353,5,3,344819,344819,344822,0,3,3
98354,2,2,344821,344822,344824,1,3,0
98355,5,3,344826,344826,344829,0,3,2
98356,3,2,344829,344829,344831,0,2,0
98357,3,3,344832,344832,344835,0,3,1
98358,6,1,344838,344838,344839,0,1,3
98359,1,3,344839,344839,344842,0,3,0
98360,6,3,344845,344845,344848,0,3,3
98361,2,2,344847,344848,344850,1,3,0
98362,3,1,344850,344850,344851,0,1,0
98363,2,3,344852,344852,344855,0,3,1
98364,6,2,344858,344858,344860,0,2,3
98365,2,3,344860,344860,344863,0,3,0
98366,4,2,344864,344864,344866,0,2,1
98367,1,2,344865,344866,344868,1,3,0
98368,4,2,344869,344869,344871,0,2,1
98369,3,1,344872,344872,344873,0,1,1
98370,2,3,344874,344874,344877,0,3,1
98371,5,2,344879,344879,344881,0,2,2
98372,4,2,344883,344883,344885,0,2,2
98373,1,2,344884,344885,344887,1,3,0
98374,3,1,344887,344887,344888,0,1,0
98375,4,1,344891,344891,344892,0,1,3
98376,1,1,344892,344892,344893,0,1,0
98377,6,2,344898,344898,344900,0,2,5
98378,2,3,344900,344900,344903,0,3,0
98379,6,1,344906,344906,344907,0,1,3
98380,5,1,344911,344911,344912,0,1,4
98381,5,2,344916,344916,344918,0,2,4
98382,1,1,344917,344918,344919,1,2,0
98383,5,3,344922,344922,344925,0,3,3
98384,3,3,344925,344925,344928,0,3,0
98385,5,1,344930,344930,344931,0,1,2
98386,6,3,344936,344936,344939,0,3,5
98387,3,3,344939,344939,344942,0,3,0
98388,2,2,344941,344942,344944,1,3,0
98389,1,3,344942,344944,344947,2,5,0
98390,6,1,344948,344948,344949,0,1,1
98391,1,3,344949,344949,344952,0,3,0
98392,2,1,344951,344952,344953,1,2,0
98393,3,1,344954,344954,344955,0,1,1
98394,6,2,344960,344960,344962,0,2,5
98395,2,3,344962,344962,344965,0,3,0
98396,5,2,344967,344967,344969,0,2,2
98397,5,1,344972,344972,344973,0,1,3
98398,5,2,344977,344977,344979,0,2,4
98399,6,2,344983,344983,344985,0,2,4
98400,1,1,344984,344985,344986,1,2,0
98401,1,1,344985,344986,344987,1,2,0
98402,2,2,344987,344987,344989,0,2,0
98403,6,2,344993,344993,344995,0,2,4
98404,2,3,344995,344995,344998,0,3,0
98405,3,2,344998,344998,345000,0,2,0
98406,4,1,345002,345002,345003,0,1,2
98407,1,3,345003,345003,345006,0,3,0
98408,5,3,345008,345008,345011,0,3,2
98409,2,1,345010,345011,345012,1,2,0
98410,3,2,345013,345013,345015,0,2,1
98411,2,1,345015,345015,345016,0,1,0
98412,6,3,345021,345021,345024,0,3,5
98413,4,2,345025,345025,345027,0,2,1
98414,3,1,345028,345028,345029,0,1,1
98415,1,3,345029,345029,345032,0,3,0
98416,6,2,345035,345035,345037,0,2,3
98417,6,1,345041,345041,345042,0,1,4
98418,4,1,345045,345045,345046,0,1,3
98419,1,1,345046,345046,345047,0,1,0
98420,4,3,345050,345050,345053,0,3,3
98421,5,1,345055,345055,345056,0,1,2
98422,6,1,345061,345061,345062,0,1,5
98423,5,3,345066,345066,345069,0,3,4
98424,6,2,345072,345072,345074,0,2,3
98425,2,1,345074,345074,345075,0,1,0
98426,2,3,345076,345076,345079,0,3,1
98427,4,2,345080,345080,345082,0,2,1
98428,3,1,345083,345083,345084,0,1,1
98429,6,2,345089,345089,345091,0,2,5
98430,3,1,345092,345092,345093,0,1,1
98431,2,3,345094,345094,345097,0,3,1
98432,6,3,345100,345100,345103,0,3,3
98433,2,2,345102,345103,345105,1,3,0
98434,5,1,345107,345107,345108,0,1,2
98435,2,3,345109,345109,345112,0,3,1
98436,1,2,345110,345112,345114,2,4,0
98437,6,1,345116,345116,345117,0,1,2
98438,2,1,345118,345118,345119,0,1,1
98439,2,3,345120,345120,345123,0,3,1
98440,2,1,345122,345123,345124,1,2,0
98441,1,2,345123,345124,345126,1,3,0
98442,4,3,345127,345127,345130,0,3,1
98443,4,3,345131,345131,345134,0,3,1
98444,4,2,345135,345135,345137,0,2,1
98445,2,3,345137,345137,345140,0,3,0
98446,2,3,345139,345140,345143,1,4,0
98447,4,1,345143,345143,345144,0,1,0
98448,1,2,345144,345144,345146,0,2,0
98449,5,1,345149,345149,345150,0,1,3
98450,3,2,345152,345152,345154,0,2,2
98451,1,1,345153,345154,345155,1,2,0
98452,2,2,345155,345155,345157,0,2,0
98453,4,3,345159,345159,345162,0,3,2
98454,3,2,345162,345162,345164,0,2,0
98455,5,1,345167,345167,345168,0,1,3
98456,4,2,345171,345171,345173,0,2,3
98457,1,1,345172,345173,345174,1,2,0
98458,6,2,345178,345178,345180,0,2,4
98459,4,2,345182,345182,345184,0,2,2
98460,3,3,345185,345185,345188,0,3,1
98461,1,3,345186,345188,345191,2,5,0
98462,5,2,345191,345191,345193,0,2,0
98463,4,2,345195,345195,345197,0,2,2
98464,2,3,345197,345197,345200,0,3,0
98465,3,2,345200,345200,345202,0,2,0
98466,4,2,345204,345204,345206,0,2,2
98467,4,3,345208,345208,345211,0,3,2
98468,5,2,345213,345213,345215,0,2,2
98469,1,3,345214,345215,345218,1,4,0
98470,4,1,345218,345218,345219,0,1,0
98471,3,2,345221,345221,345223,0,2,2
98472,6,3,345227,345227,345230,0,3,4
98473,6,1,345233,345233,345234,0,1,3
98474,6,3,345239,345239,345242,0,3,5
98475,6,2,345245,345245,345247,0,2,3
98476,3,2,345248,345248,345250,0,2,1
98477,3,1,345251,345251,345252,0,1,1
98478,6,3,345257,345257,345260,0,3,5
98479,3,3,345260,345260,345263,0,3,0
98480,2,3,345262,345263,345266,1,4,0
98481,2,2,345264,345266,345268,2,4,0
98482,6,1,345270,345270,345271,0,1,2
98483,4,1,345274,345274,345275,0,1,3
98484,4,1,345278,345278,345279,0,1,3
98485,3,2,345281,345281,345283,0,2,2
98486,5,1,345286,345286,345287,0,1,3
98487,1,2,345287,345287,345289,0,2,0
98488,1,2,345288,345289,345291,1,3,0
98489,6,3,345294,345294,345297,0,3,3
98490,1,2,345295,345297,345299,2,4,0
98491,5,1,345300,345300,345301,0,1,1
98492,5,1,345305,345305,345306,0,1,4
98493,1,3,345306,345306,345309,0,3,0
98494,1,3,345307,345309,345312,2,5,0
98495,2,1,345309,345312,345313,3,4,0
98496,3,1,345312,345313,345314,1,2,0
98497,3,2,345315,345315,345317,0,2,1
98498,4,2,345319,345319,345321,0,2,2
98499,5,3,345324,345324,345327,0,3,3
98500,1,2,345325,345327,345329,2,4,0
98501,5,3,345330,345330,345333,0,3,1
98502,2,2,345332,345333,345335,1,3,0
98503,5,2,345337,345337,345339,0,2,2
98504,4,1,345341,345341,345342,0,1,2
98505,1,2,345342,345342,345344,0,2,0
98506,2,2,345344,345344,345346,0,2,0
98507,1,3,345345,345346,345349,1,4,0
98508,6,3,345351,345351,345354,0,3,2
98509,5,3,345356,345356,345359,0,3,2
98510,3,1,345359,345359,345360,0,1,0
98511,3,1,345362,345362,345363,0,1,2
98512,6,2,345368,345368,345370,0,2,5
98513,3,2,345371,345371,345373,0,2,1
98514,3,1,345374,345374,345375,0,1,1
98515,4,3,345378,345378,345381,0,3,3
98516,2,2,345380,345381,345383,1,3,0
98517,6,2,345386,345386,345388,0,2,3
98518,6,1,345392,345392,345393,0,1,4
98519,2,2,345394,345394,345396,0,2,1
98520,4,2,345398,345398,345400,0,2,2
98521,4,2,345402,345402,345404,0,2,2
98522,5,1,345407,345407,345408,0,1,3
98523,5,1,345412,345412,345413,0,1,4
98524,5,3,345417,345417,345420,0,3,4
98525,1,3,345418,345420,345423,2,5,0
98526,1,1,345419,345423,345424,4,5,0
98527,4,3,345423,345424,345427,1,4,0
98528,2,2,345425,345427,345429,2,4,0
98529,6,3,345431,345431,345434,0,3,2
98530,4,2,345435,345435,345437,0,2,1
98531,4,2,345439,345439,345441,0,2,2
98532,2,2,345441,345441,345443,0,2,0
98533,6,2,345447,345447,345449,0,2,4
98534,6,3,345453,345453,345456,0,3,4
98535,4,3,345457,345457,345460,0,3,1
98536,4,1,345461,345461,345462,0,1,1
98537,6,3,345467,345467,345470,0,3,5
98538,6,3,345473,345473,345476,0,3,3
98539,2,2,345475,345476,345478,1,3,0
98540,1,3,345476,345478,345481,2,5,0
98541,6,1,345482,345482,345483,0,1,1
98542,1,2,345483,345483,345485,0,2,0
98543,1,3,345484,345485,345488,1,4,0
98544,6,3,345490,345490,345493,0,3,2
98545,1,2,345491,345493,345495,2,4,0
98546,1,1,345492,345495,345496,3,4,0
98547,6,2,345498,345498,345500,0,2,2
98548,1,2,345499,345500,345502,1,3,0
98549,2,3,345501,345502,345505,1,4,0
98550,5,1,345506,345506,345507,0,1,1
98551,1,1,345507,345507,345508,0,1,0
98552,2,1,345509,345509,345510,0,1,1
98553,4,1,345513,345513,345514,0,1,3
98554,3,1,345516,345516,345517,0,1,2
98555,5,3,345521,345521,345524,0,3,4
98556,1,3,345522,345524,345527,2,5,0
98557,3,2,345525,345527,345529,2,4,0
98558,3,1,345528,345529,345530,1,2,0
98559,4,2,345532,345532,345534,0,2,2
98560,4,1,345536,345536,345537,0,1,2
98561,1,3,345537,345537,345540,0,3,0
98562,1,1,345538,345540,345541,2,3,0
98563,6,3,345544,345544,345547,0,3,3
98564,2,2,345546,345547,345549,1,3,0
98565,6,2,345552,345552,345554,0,2,3
98566,6,1,345558,345558,345559,0,1,4
98567,4,3,345562,345562,345565,0,3,3
98568,3,3,345565,345565,345568,0,3,0
98569,2,3,345567,345568,345571,1,4,0
98570,3,1,345570,345571,345572,1,2,0
98571,6,3,345576,345576,345579,0,3,4
98572,6,3,345582,345582,345585,0,3,3
98573,3,3,345585,345585,345588,0,3,0
98574,3,2,345588,345588,345590,0,2,0
98575,3,3,345591,345591,345594,0,3,1
98576,2,1,345593,345594,345595,1,2,0
98577,1,2,345594,345595,345597,1,3,0
98578,4,3,345598,345598,345601,0,3,1
98579,3,1,345601,345601,345602,0,1,0
98580,6,2,345607,345607,345609,0,2,5
98581,6,3,345613,345613,345616,0,3,4
98582,2,2,345615,345616,345618,1,3,0
98583,3,1,345618,345618,345619,0,1,0
98584,2,2,345620,345620,345622,0,2,1
98585,1,1,345621,345622,345623,1,2,0
98586,6,2,345627,345627,345629,0,2,4
98587,5,1,345632,345632,345633,0,1,3
98588,3,1,345635,345635,345636,0,1,2
98589,1,1,345636,345636,345637,0,1,0
98590,3,3,345639,345639,345642,0,3,2
98591,3,1,345642,345642,345643,0,1,0
98592,5,1,345647,345647,345648,0,1,4
98593,3,1,345650,345650,345651,0,1,2
98594,3,1,345653,345653,345654,0,1,2
98595,1,2,345654,345654,345656,0,2,0
98596,5,3,345659,345659,345662,0,3,3
98597,2,2,345661,345662,345664,1,3,0
98598,1,1,345662,345664,345665,2,3,0
98599,5,2,345667,345667,345669,0,2,2
98600,4,2,345671,345671,345673,0,2,2
98601,4,3,345675,345675,345678,0,3,2
98602,4,1,345679,345679,345680,0,1,1
98603,3,2,345682,345682,345684,0,2,2
98604,5,2,345687,345687,345689,0,2,3
98605,4,3,345691,345691,345694,0,3,2
98606,4,2,345695,345695,345697,0,2,1
98607,5,2,345700,345700,345702,0,2,3
98608,6,3,345706,345706,345709,0,3,4
98609,6,3,345712,345712,345715,0,3,3
98610,5,1,345717,345717,345718,0,1,2
98611,3,2,345720,345720,345722,0,2,2
98612,4,3,345724,345724,345727,0,3,2
98613,6,3,345730,345730,345733,0,3,3
98614,4,3,345734,345734,345737,0,3,1
98615,2,1,345736,345737,345738,1,2,0
98616,5,2,345741,345741,345743,0,2,3
98617,6,2,345747,345747,345749,0,2,4
98618,2,3,345749,345749,345752,0,3,0
98619,1,1,345750,345752,345753,2,3,0
98620,6,1,345756,345756,345757,0,1,3
98621,5,2,345761,345761,345763,0,2,4
98622,4,1,345765,345765,345766,0,1,2
98623,2,2,345767,345767,345769,0,2,1
98624,6,3,345773,345773,345776,0,3,4
98625,2,1,345775,345776,345777,1,2,0
98626,3,3,345778,345778,345781,0,3,1
98627,2,2,345780,345781,345783,1,3,0
98628,5,1,345785,345785,345786,0,1,2
98629,6,1,345791,345791,345792,0,1,5
98630,1,3,345792,345792,345795,0,3,0
98631,4,2,345796,345796,345798,0,2,1
98632,3,2,345799,345799,345801,0,2,1
98633,5,1,345804,345804,345805,0,1,3
98634,1,2,345805,345805,345807,0,2,0
98635,3,1,345808,345808,345809,0,1,1
98636,1,1,345809,345809,345810,0,1,0
98637,1,2,345810,345810,345812,0,2,0
98638,1,1,345811,345812,345813,1,2,0
98639,2,1,345813,345813,345814,0,1,0
98640,4,2,345817,345817,345819,0,2,3
98641,3,3,345820,345820,345823,0,3,1
98642,4,3,345824,345824,345827,0,3,1
98643,5,2,345829,345829,345831,0,2,2
98644,2,1,345831,345831,345832,0,1,0
98645,2,2,345833,345833,345835,0,2,1
98646,6,1,345839,345839,345840,0,1,4
98647,3,2,345842,345842,345844,0,2,2
98648,6,3,345848,345848,345851,0,3,4
98649,1,3,345849,345851,345854,2,5,0
98650,5,1,345854,345854,345855,0,1,0
98651,3,2,345857,345857,345859,0,2,2
98652,1,1,345858,345859,345860,1,2,0
98653,3,2,345861,345861,345863,0,2,1
98654,6,3,345867,345867,345870,0,3,4
98655,6,1,345873,345873,345874,0,1,3
98656,2,3,345875,345875,345878,0,3,1
98657,5,1,345880,345880,345881,0,1,2
98658,2,2,345882,345882,345884,0,2,1
98659,4,3,345886,345886,345889,0,3,2
98660,6,2,345892,345892,345894,0,2,3
98661,3,1,345895,345895,345896,0,1,1
98662,5,3,345900,345900,345903,0,3,4
98663,3,2,345903,345903,345905,0,2,0
98664,5,3,345908,345908,345911,0,3,3
98665,2,2,345910,345911,345913,1,3,0
98666,5,1,345915,345915,345916,0,1,2
98667,6,1,345921,345921,345922,0,1,5
98668,6,3,345927,345927,345930,0,3,5
98669,6,1,345933,345933,345934,0,1,3
98670,3,2,345936,345936,345938,0,2,2
98671,2,1,345938,345938,345939,0,1,0
98672,5,3,345943,345943,345946,0,3,4
98673,4,3,345947,345947,345950,0,3,1
98674,2,3,345949,345950,345953,1,4,0
98675,2,2,345951,345953,345955,2,4,0
98676,1,1,345952,345955,345956,3,4,0
98677,2,3,345954,345956,345959,2,5,0
98678,5,2,345959,345959,345961,0,2,0
98679,2,1,345961,345961,345962,0,1,0
98680,3,3,345964,345964,345967,0,3,2
98681,4,2,345968,345968,345970,0,2,1
98682,2,3,345970,345970,345973,0,3,0
98683,5,3,345975,345975,345978,0,3,2
98684,4,3,345979,345979,345982,0,3,1
98685,4,3,345983,345983,345986,0,3,1
98686,4,2,345987,345987,345989,0,2,1
98687,4,2,345991,345991,345993,0,2,2
98688,4,1,345995,345995,345996,0,1,2
98689,5,2,346000,346000,346002,0,2,4
98690,4,3,346004,346004,346007,0,3,2
98691,5,3,346009,346009,346012,0,3,2
98692,2,1,346011,346012,346013,1,2,0
98693,1,1,346012,346013,346014,1,2,0
98694,5,3,346017,346017,346020,0,3,3
98695,6,1,346023,346023,346024,0,1,3
98696,1,2,346024,346024,346026,0,2,0
98697,6,3,346030,346030,346033,0,3,4
98698,5,2,346035,346035,346037,0,2,2
98699,1,2,346036,346037,346039,1,3,0
98700,3,3,346039,346039,346042,0,3,0
98701,3,1,346042,346042,346043,0,1,0
98702,4,3,346046,346046,346049,0,3,3
98703,3,1,346049,346049,346050,0,1,0
98704,1,2,346050,346050,346052,0,2,0
98705,2,2,346052,346052,346054,0,2,0
98706,3,1,346055,346055,346056,0,1,1
98707,3,2,346058,346058,346060,0,2,2
98708,4,3,346062,346062,346065,0,3,2
98709,3,3,346065,346065,346068,0,3,0
98710,1,1,346066,346068,346069,2,3,0
98711,3,1,346069,346069,346070,0,1,0
98712,1,2,346070,346070,346072,0,2,0
98713,2,1,346072,346072,346073,0,1,0
98714,4,3,346076,346076,346079,0,3,3
98715,3,3,346079,346079,346082,0,3,0
98716,2,3,346081,346082,346085,1,4,0
98717,6,3,346087,346087,346090,0,3,2
98718,3,3,346090,346090,346093,0,3,0
98719,5,2,346095,346095,346097,0,2,2
98720,2,2,346097,346097,346099,0,2,0
98721,6,2,346103,346103,346105,0,2,4
98722,1,3,346104,346105,346108,1,4,0
98723,4,2,346108,346108,346110,0,2,0
98724,5,2,346113,346113,346115,0,2,3
98725,6,3,346119,346119,346122,0,3,4
98726,2,3,346121,346122,346125,1,4,0
98727,1,1,346122,346125,346126,3,4,0
98728,4,2,346126,346126,346128,0,2,0
98729,1,2,346127,346128,346130,1,3,0
98730,3,1,346130,346130,346131,0,1,0
98731,6,3,346136,346136,346139,0,3,5
98732,2,2,346138,346139,346141,1,3,0
98733,5,3,346143,346143,346146,0,3,2
98734,3,2,346146,346146,346148,0,2,0
98735,3,2,346149,346149,346151,0,2,1
98736,4,3,346153,346153,346156,0,3,2
98737,6,3,346159,346159,346162,0,3,3
98738,5,3,346164,346164,346167,0,3,2
98739,3,2,346167,346167,346169,0,2,0
98740,6,2,346173,346173,346175,0,2,4
98741,5,3,346178,346178,346181,0,3,3
98742,6,1,346184,346184,346185,0,1,3
98743,1,1,346185,346185,346186,0,1,0
98744,2,1,346187,346187,346188,0,1,1
98745,4,2,346191,346191,346193,0,2,3
98746,2,2,346193,346193,346195,0,2,0
98747,5,1,346198,346198,346199,0,1,3
98748,4,2,346202,346202,346204,0,2,3
98749,6,1,346208,346208,346209,0,1,4
98750,3,3,346211,346211,346214,0,3,2
98751,3,1,346214,346214,346215,0,1,0
98752,5,2,346219,346219,346221,0,2,4
98753,3,3,346222,346222,346225,0,3,1
98754,2,3,346224,346225,346228,1,4,0
98755,6,2,346230,346230,346232,0,2,2
98756,4,2,346234,346234,346236,0,2,2
98757,5,3,346239,346239,346242,0,3,3
98758,1,3,346240,346242,346245,2,5,0
98759,3,3,346243,346245,346248,2,5,0
98760,4,2,346247,346248,346250,1,3,0
98761,4,3,346251,346251,346254,0,3,1
98762,1,1,346252,346254,346255,2,3,0
98763,4,3,346256,346256,346259,0,3,1
98764,1,3,346257,346259,346262,2,5,0
98765,2,3,346259,346262,346265,3,6,0
98766,2,2,346261,346265,346267,4,6,0
98767,6,2,346267,346267,346269,0,2,0
98768,1,3,346268,346269,346272,1,4,0
98769,6,2,346274,346274,346276,0,2,2
98770,1,1,346275,346276,346277,1,2,0
98771,5,1,346280,346280,346281,0,1,3
98772,3,2,346283,346283,346285,0,2,2
98773,2,3,346285,346285,346288,0,3,0
98774,5,2,346290,346290,346292,0,2,2
98775,6,2,346296,346296,346298,0,2,4
98776,5,2,346301,346301,346303,0,2,3
98777,5,3,346306,346306,346309,0,3,3
98778,1,1,346307,346309,346310,2,3,0
98779,4,3,346311,346311,346314,0,3,1
98780,2,3,346313,346314,346317,1,4,0
98781,6,2,346319,346319,346321,0,2,2
98782,6,3,346325,346325,346328,0,3,4
98783,3,1,346328,346328,346329,0,1,0
98784,5,2,346333,346333,346335,0,2,4
98785,5,1,346338,346338,346339,0,1,3
98786,3,3,346341,346341,346344,0,3,2
98787,3,1,346344,346344,346345,0,1,0
98788,1,2,346345,346345,346347,0,2,0
98789,1,3,346346,346347,346350,1,4,0
98790,2,1,346348,346350,346351,2,3,0
98791,5,3,346353,346353,346356,0,3,2
98792,6,1,346359,346359,346360,0,1,3
98793,3,1,346362,346362,346363,0,1,2
98794,4,1,346366,346366,346367,0,1,3
98795,3,1,346369,346369,346370,0,1,2
98796,6,1,346375,346375,346376,0,1,5
98797,4,3,346379,346379,346382,0,3,3
98798,4,1,346383,346383,346384,0,1,1
98799,2,3,346385,346385,346388,0,3,1
98800,6,3,346391,346391,346394,0,3,3
98801,1,3,346392,346394,346397,2,5,0
98802,3,1,346395,346397,346398,2,3,0
98803,3,2,346398,346398,346400,0,2,0
98804,4,2,346402,346402,346404,0,2,2
98805,6,1,346408,346408,346409,0,1,4
98806,3,3,346411,346411,346414,0,3,2
98807,6,3,346417,346417,346420,0,3,3
98808,3,1,346420,346420,346421,0,1,0
98809,1,3,346421,346421,346424,0,3,0
98810,4,3,346425,346425,346428,0,3,1
98811,5,2,346430,346430,346432,0,2,2
98812,6,1,346436,346436,346437,0,1,4
98813,4,1,346440,346440,346441,0,1,3
98814,2,1,346442,346442,346443,0,1,1
98815,3,2,346445,346445,346447,0,2,2
98816,3,2,346448,346448,346450,0,2,1
98817,5,2,346453,346453,346455,0,2,3
98818,2,3,346455,346455,346458,0,3,0
98819,2,3,346457,346458,346461,1,4,0
98820,3,2,346460,346461,346463,1,3,0
98821,2,2,346462,346463,346465,1,3,0
98822,6,1,346468,346468,346469,0,1,3
98823,5,2,346473,346473,346475,0,2,4
98824,5,3,346478,346478,346481,0,3,3
98825,1,2,346479,346481,346483,2,4,0
98826,5,3,346484,346484,346487,0,3,1
98827,1,1,346485,346487,346488,2,3,0
98828,5,2,346490,346490,346492,0,2,2
98829,5,1,346495,346495,346496,0,1,3
98830,5,3,346500,346500,346503,0,3,4
98831,4,2,346504,346504,346506,0,2,1
98832,2,1,346506,346506,346507,0,1,0
98833,5,2,346511,346511,346513,0,2,4
98834,3,1,346514,346514,346515,0,1,1
98835,2,1,346516,346516,346517,0,1,1
98836,3,1,346519,346519,346520,0,1,2
98837,4,3,346523,346523,346526,0,3,3
98838,3,3,346526,346526,346529,0,3,0
98839,2,2,346528,346529,346531,1,3,0
98840,3,3,346531,346531,346534,0,3,0
98841,2,1,346533,346534,346535,1,2,0
98842,6,2,346539,346539,346541,0,2,4
98843,6,1,346545,346545,346546,0,1,4
98844,6,2,346551,346551,346553,0,2,5
98845,4,3,346555,346555,346558,0,3,2
98846,4,3,346559,346559,346562,0,3,1
98847,6,3,346565,346565,346568,0,3,3
98848,1,2,346566,346568,346570,2,4,0
98849,4,3,346570,346570,346573,0,3,0
98850,5,1,346575,346575,346576,0,1,2
98851,4,1,346579,346579,346580,0,1,3
98852,6,3,346585,346585,346588,0,3,5
98853,4,1,346589,346589,346590,0,1,1
98854,4,1,346593,346593,346594,0,1,3
98855,4,2,346597,346597,346599,0,2,3
98856,1,3,346598,346599,346602,1,4,0
98857,3,1,346601,346602,346603,1,2,0
98858,6,1,346607,346607,346608,0,1,4
98859,4,2,346611,346611,346613,0,2,3
98860,3,3,346614,346614,346617,0,3,1
98861,5,1,346619,346619,346620,0,1,2
98862,5,2,346624,346624,346626,0,2,4
98863,2,3,346626,346626,346629,0,3,0
98864,4,3,346630,346630,346633,0,3,1
98865,4,1,346634,346634,346635,0,1,1
98866,2,3,346636,346636,346639,0,3,1
98867,1,1,346637,346639,346640,2,3,0
98868,1,3,346638,346640,346643,2,5,0
98869,4,3,346642,346643,346646,1,4,0
98870,4,3,346646,346646,346649,0,3,0
98871,2,1,346648,346649,346650,1,2,0
98872,2,2,346650,346650,346652,0,2,0
98873,6,2,346656,346656,346658,0,2,4
98874,6,1,346662,346662,346663,0,1,4
98875,6,2,346668,346668,346670,0,2,5
98876,4,2,346672,346672,346674,0,2,2
98877,2,3,346674,346674,346677,0,3,0
98878,4,3,346678,346678,346681,0,3,1
98879,1,3,346679,346681,346684,2,5,0
98880,2,3,346681,346684,346687,3,6,0
98881,5,1,346686,346687,346688,1,2,0
98882,1,3,346687,346688,346691,1,4,0
98883,3,2,346690,346691,346693,1,3,0
98884,6,1,346696,346696,346697,0,1,3
98885,6,1,346702,346702,346703,0,1,5
98886,5,1,346707,346707,346708,0,1,4
98887,3,3,346710,346710,346713,0,3,2
98888,6,3,346716,346716,346719,0,3,3
98889,5,3,346721,346721,346724,0,3,2
98890,4,3,346725,346725,346728,0,3,1
98891,4,1,346729,346729,346730,0,1,1
98892,3,2,346732,346732,346734,0,2,2
98893,5,2,346737,346737,346739,0,2,3
98894,1,3,346738,346739,346742,1,4,0
98895,6,1,346744,346744,346745,0,1,2
98896,6,1,346750,346750,346751,0,1,5
98897,2,1,346752,346752,346753,0,1,1
98898,6,2,346758,346758,346760,0,2,5
98899,6,3,346764,346764,346767,0,3,4
98900,1,2,346765,346767,346769,2,4,0
98901,1,1,346766,346769,346770,3,4,0
98902,6,1,346772,346772,346773,0,1,2
98903,2,1,346774,346774,346775,0,1,1
98904,5,3,346779,346779,346782,0,3,4
98905,6,3,346785,346785,346788,0,3,3
98906,2,1,346787,346788,346789,1,2,0
98907,3,2,346790,346790,346792,0,2,1
98908,2,1,346792,346792,346793,0,1,0
98909,3,1,346795,346795,346796,0,1,2
98910,6,2,346801,346801,346803,0,2,5
98911,5,1,346806,346806,346807,0,1,3
98912,1,2,346807,346807,346809,0,2,0
98913,6,3,346813,346813,346816,0,3,4
98914,3,1,346816,346816,346817,0,1,0
98915,2,1,346818,346818,346819,0,1,1
98916,2,3,346820,346820,346823,0,3,1
98917,4,2,346824,346824,346826,0,2,1
98918,3,3,346827,346827,346830,0,3,1
98919,1,3,346828,346830,346833,2,5,0
98920,1,1,346829,346833,346834,4,5,0
98921,4,1,346833,346834,346835,1,2,0
98922,5,2,346838,346838,346840,0,2,3
98923,4,2,346842,346842,346844,0,2,2
98924,6,2,346848,346848,346850,0,2,4
98925,6,3,346854,346854,346857,0,3,4
98926,5,3,346859,346859,346862,0,3,2
98927,5,2,346864,346864,346866,0,2,2
98928,5,2,346869,346869,346871,0,2,3
98929,2,2,346871,346871,346873,0,2,0
98930,3,1,346874,346874,346875,0,1,1
98931,3,2,346877,346877,346879,0,2,2
98932,4,1,346881,346881,346882,0,1,2
98933,6,1,346887,346887,346888,0,1,5
98934,3,1,346890,346890,346891,0,1,2
98935,1,2,346891,346891,346893,0,2,0
98936,2,1,346893,346893,346894,0,1,0
98937,6,3,346899,346899,346902,0,3,5
98938,6,3,346905,346905,346908,0,3,3
98939,3,1,346908,346908,346909,0,1,0
98940,4,3,346912,346912,346915,0,3,3
98941,4,1,346916,346916,346917,0,1,1
98942,6,2,346922,346922,346924,0,2,5
98943,2,3,346924,346924,346927,0,3,0
98944,3,3,346927,346927,346930,0,3,0
98945,6,2,346933,346933,346935,0,2,3
98946,2,3,346935,346935,346938,0,3,0
98947,2,3,346937,346938,346941,1,4,0
98948,4,1,346941,346941,346942,0,1,0
98949,5,3,346946,346946,346949,0,3,4
98950,4,2,346950,346950,346952,0,2,1
98951,3,1,346953,346953,346954,0,1,1
98952,5,2,346958,346958,346960,0,2,4
98953,2,3,346960,346960,346963,0,3,0
98954,1,1,346961,346963,346964,2,3,0
98955,1,2,346962,346964,346966,2,4,0
98956,6,2,346968,346968,346970,0,2,2
98957,5,3,346973,346973,346976,0,3,3
98958,2,1,346975,346976,346977,1,2,0
98959,1,1,346976,346977,346978,1,2,0
98960,3,3,346979,346979,346982,0,3,1
98961,5,3,346984,346984,346987,0,3,2
98962,1,3,346985,346987,346990,2,5,0
98963,3,3,346988,346990,346993,2,5,0
98964,6,2,346994,346994,346996,0,2,1
98965,6,2,347000,347000,347002,0,2,4
98966,3,2,347003,347003,347005,0,2,1
98967,1,3,347004,347005,347008,1,4,0
98968,2,1,347006,347008,347009,2,3,0
98969,4,1,347010,347010,347011,0,1,1
98970,3,2,347013,347013,347015,0,2,2
98971,5,1,347018,347018,347019,0,1,3
98972,3,3,347021,347021,347024,0,3,2
98973,2,2,347023,347024,347026,1,3,0
98974,5,2,347028,347028,347030,0,2,2
98975,4,1,347032,347032,347033,0,1,2
98976,3,2,347035,347035,347037,0,2,2
98977,1,2,347036,347037,347039,1,3,0
98978,6,2,347042,347042,347044,0,2,3
98979,3,3,347045,347045,347048,0,3,1
98980,4,1,347049,347049,347050,0,1,1
98981,3,2,347052,347052,347054,0,2,2
98982,2,3,347054,347054,347057,0,3,0
98983,4,3,347058,347058,347061,0,3,1
98984,6,1,347064,347064,347065,0,1,3
98985,5,1,347069,347069,347070,0,1,4
98986,5,2,347074,347074,347076,0,2,4
98987,4,1,347078,347078,347079,0,1,2
98988,2,1,347080,347080,347081,0,1,1
98989,6,3,347086,347086,347089,0,3,5
98990,5,1,347091,347091,347092,0,1,2
98991,1,2,347092,347092,347094,0,2,0
98992,5,2,347097,347097,347099,0,2,3
98993,5,2,347102,347102,347104,0,2,3
98994,5,3,347107,347107,347110,0,3,3
98995,2,1,347109,347110,347111,1,2,0
98996,6,2,347115,347115,347117,0,2,4
98997,4,2,347119,347119,347121,0,2,2
98998,3,2,347122,347122,347124,0,2,1
98999,4,1,347126,347126,347127,0,1,2
99000,3,2,347129,347129,347131,0,2,2
99001,6,2,347135,347135,347137,0,2,4
99002,3,1,347138,347138,347139,0,1,1
99003,3,2,347141,347141,347143,0,2,2
99004,5,1,347146,347146,347147,0,1,3
99005,6,3,347152,347152,347155,0,3,5
99006,3,2,347155,347155,347157,0,2,0
99007,2,3,347157,347157,347160,0,3,0
99008,2,3,347159,347160,347163,1,4,0
99009,5,2,347164,347164,347166,0,2,1
99010,3,1,347167,347167,347168,0,1,1
99011,1,2,347168,347168,347170,0,2,0
99012,6,3,347174,347174,347177,0,3,4
99013,4,1,347178,347178,347179,0,1,1
99014,3,3,347181,347181,347184,0,3,2
99015,2,2,347183,347184,347186,1,3,0
99016,2,2,347185,347186,347188,1,3,0
99017,5,2,347190,347190,347192,0,2,2
99018,2,3,347192,347192,347195,0,3,0
99019,5,3,347197,347197,347200,0,3,2
99020,3,1,347200,347200,347201,0,1,0
99021,4,3,347204,347204,347207,0,3,3
99022,3,1,347207,347207,347208,0,1,0
99023,5,1,347212,347212,347213,0,1,4
99024,6,2,347218,347218,347220,0,2,5
99025,1,1,347219,347220,347221,1,2,0
99026,3,2,347222,347222,347224,0,2,1
99027,4,3,347226,347226,347229,0,3,2
99028,4,1,347230,347230,347231,0,1,1
99029,4,3,347234,347234,347237,0,3,3
99030,5,2,347239,347239,347241,0,2,2
99031,2,3,347241,347241,347244,0,3,0
99032,2,3,347243,347244,347247,1,4,0
99033,4,1,347247,347247,347248,0,1,0
99034,3,2,347250,347250,347252,0,2,2
99035,3,1,347253,347253,347254,0,1,1
99036,3,2,347256,347256,347258,0,2,2
99037,1,1,347257,347258,347259,1,2,0
99038,3,2,347260,347260,347262,0,2,1
99039,1,1,347261,347262,347263,1,2,0
99040,5,1,347266,347266,347267,0,1,3
99041,5,3,347271,347271,347274,0,3,4
99042,2,1,347273,347274,347275,1,2,0
99043,6,1,347279,347279,347280,0,1,4
99044,2,2,347281,347281,347283,0,2,1
99045,3,3,347284,347284,347287,0,3,1
99046,5,2,347289,347289,347291,0,2,2
99047,1,3,347290,347291,347294,1,4,0
99048,1,2,347291,347294,347296,3,5,0
99049,3,2,347294,347296,347298,2,4,0
99050,1,1,347295,347298,347299,3,4,0
99051,4,3,347299,347299,347302,0,3,0
99052,2,1,347301,347302,347303,1,2,0
99053,2,2,347303,347303,347305,0,2,0
99054,5,3,347308,347308,347311,0,3,3
99055,1,3,347309,347311,347314,2,5,0
99056,2,1,347311,347314,347315,3,4,0
99057,2,2,347313,347315,347317,2,4,0
99058,6,2,347319,347319,347321,0,2,2
99059,3,3,347322,347322,347325,0,3,1
99060,2,3,347324,347325,347328,1,4,0
99061,3,2,347327,347328,347330,1,3,0
99062,4,1,347331,347331,347332,0,1,1
99063,6,3,347337,347337,347340,0,3,5
99064,6,1,347343,347343,347344,0,1,3
99065,5,2,347348,347348,347350,0,2,4
99066,3,3,347351,347351,347354,0,3,1
99067,6,3,347357,347357,347360,0,3,3
99068,5,3,347362,347362,347365,0,3,2
99069,1,2,347363,347365,347367,2,4,0
99070,2,1,347365,347367,347368,2,3,0
99071,3,3,347368,347368,347371,0,3,0
99072,2,2,347370,347371,347373,1,3,0
99073,2,3,347372,347373,347376,1,4,0
99074,3,2,347375,347376,347378,1,3,0
99075,4,3,347379,347379,347382,0,3,1
99076,1,3,347380,347382,347385,2,5,0
99077,4,3,347384,347385,347388,1,4,0
99078,4,1,347388,347388,347389,0,1,0
99079,2,3,347390,347390,347393,0,3,1
99080,4,1,347394,347394,347395,0,1,1
99081,2,2,347396,347396,347398,0,2,1
99082,3,3,347399,347399,347402,0,3,1
99083,6,2,347405,347405,347407,0,2,3
99084,3,2,347408,347408,347410,0,2,1
99085,2,2,347410,347410,347412,0,2,0
99086,1,3,347411,347412,347415,1,4,0
99087,3,3,347414,347415,347418,1,4,0
99088,1,1,347415,347418,347419,3,4,0
99089,5,3,347420,347420,347423,0,3,1
99090,2,1,347422,347423,347424,1,2,0
99091,4,1,347426,347426,347427,0,1,2
99092,4,3,347430,347430,347433,0,3,3
99093,4,3,347434,347434,347437,0,3,1
99094,4,1,347438,347438,347439,0,1,1
99095,6,1,347444,347444,347445,0,1,5
99096,2,3,347446,347446,347449,0,3,1
99097,4,1,347450,347450,347451,0,1,1
99098,1,2,347451,347451,347453,0,2,0
99099,1,3,347452,347453,347456,1,4,0
99100,1,2,347453,347456,347458,3,5,0
99101,3,2,347456,347458,347460,2,4,0
99102,3,1,347459,347460,347461,1,2,0
99103,6,3,347465,347465,347468,0,3,4
99104,1,3,347466,347468,347471,2,5,0
99105,1,3,347467,347471,347474,4,7,0
99106,2,3,347469,347474,347477,5,8,0
99107,6,2,347475,347477,347479,2,4,0
99108,1,2,347476,347479,347481,3,5,0
99109,1,1,347477,347481,347482,4,5,0
99110,6,3,347483,347483,347486,0,3,1
99111,3,1,347486,347486,347487,0,1,0
99112,5,1,347491,347491,347492,0,1,4
99113,2,2,347493,347493,347495,0,2,1
99114,6,1,347499,347499,347500,0,1,4
99115,6,1,347505,347505,347506,0,1,5
99116,5,3,347510,347510,347513,0,3,4
99117,5,3,347515,347515,347518,0,3,2
99118,5,2,347520,347520,347522,0,2,2
99119,4,2,347524,347524,347526,0,2,2
99120,1,2,347525,347526,347528,1,3,0
99121,4,2,347529,347529,347531,0,2,1
99122,3,2,347532,347532,347534,0,2,1
99123,3,2,347535,347535,347537,0,2,1
99124,4,2,347539,347539,347541,0,2,2
99125,3,2,347542,347542,347544,0,2,1
99126,4,2,347546,347546,347548,0,2,2
99127,4,2,347550,347550,347552,0,2,2
99128,5,2,347555,347555,347557,0,2,3
99129,3,1,347558,347558,347559,0,1,1
99130,2,2,347560,347560,347562,0,2,1
99131,1,1,347561,347562,347563,1,2,0
99132,5,1,347566,347566,347567,0,1,3
99133,3,3,347569,347569,347572,0,3,2
99134,4,1,347573,347573,347574,0,1,1
99135,4,3,347577,347577,347580,0,3,3
99136,2,1,347579,347580,347581,1,2,0
99137,5,1,347584,347584,347585,0,1,3
99138,6,2,347590,347590,347592,0,2,5
99139,6,3,347596,347596,347599,0,3,4
99140,4,3,347600,347600,347603,0,3,1
99141,2,3,347602,347603,347606,1,4,0
99142,1,3,347603,347606,347609,3,6,0
99143,5,2,347608,347609,347611,1,3,0
99144,2,3,347610,347611,347614,1,4,0
99145,2,2,347612,347614,347616,2,4,0
99146,2,2,347614,347616,347618,2,4,0
99147,1,3,347615,347618,347621,3,6,0
99148,1,3,347616,347621,347624,5,8,0
99149,4,2,347620,347624,347626,4,6,0
99150,2,1,347622,347626,347627,4,5,0
99151,1,2,347623,347627,347629,4,6,0
99152,6,3,347629,347629,347632,0,3,0
99153,5,2,347634,347634,347636,0,2,2
99154,2,2,347636,347636,347638,0,2,0
99155,1,3,347637,347638,347641,1,4,0
99156,2,2,347639,347641,347643,2,4,0
99157,4,2,347643,347643,347645,0,2,0
99158,1,3,347644,347645,347648,1,4,0
99159,2,2,347646,347648,347650,2,4,0
99160,4,2,347650,347650,347652,0,2,0
99161,3,1,347653,347653,347654,0,1,1
99162,2,2,347655,347655,347657,0,2,1
99163,3,2,347658,347658,347660,0,2,1
99164,4,2,347662,347662,347664,0,2,2
99165,6,2,347668,347668,347670,0,2,4
99166,1,1,347669,347670,347671,1,2,0
99167,4,1,347673,347673,347674,0,1,2
99168,2,1,347675,347675,347676,0,1,1
99169,2,2,347677,347677,347679,0,2,1
99170,2,3,347679,347679,347682,0,3,0
99171,6,2,347685,347685,347687,0,2,3
99172,5,2,347690,347690,347692,0,2,3
99173,6,3,347696,347696,347699,0,3,4
99174,5,3,347701,347701,347704,0,3,2
99175,2,1,347703,347704,347705,1,2,0
99176,4,3,347707,347707,347710,0,3,2
99177,4,1,347711,347711,347712,0,1,1
99178,2,2,347713,347713,347715,0,2,1
99179,4,3,347717,347717,347720,0,3,2
99180,2,3,347719,347720,347723,1,4,0
99181,5,2,347724,347724,347726,0,2,1
99182,1,1,347725,347726,347727,1,2,0
99183,3,3,347728,347728,347731,0,3,1
99184,1,2,347729,347731,347733,2,4,0
99185,5,2,347734,347734,347736,0,2,1
99186,6,3,347740,347740,347743,0,3,4
99187,1,1,347741,347743,347744,2,3,0
99188,1,3,347742,347744,347747,2,5,0
99189,4,3,347746,347747,347750,1,4,0
99190,1,3,347747,347750,347753,3,6,0
99191,6,2,347753,347753,347755,0,2,0
99192,4,3,347757,347757,347760,0,3,2
99193,5,1,347762,347762,347763,0,1,2
99194,6,1,347768,347768,347769,0,1,5
99195,1,1,347769,347769,347770,0,1,0
99196,3,2,347772,347772,347774,0,2,2
99197,2,3,347774,347774,347777,0,3,0
99198,4,1,347778,347778,347779,0,1,1
99199,4,3,347782,347782,347785,0,3,3
99200,3,3,347785,347785,347788,0,3,0
99201,4,3,347789,347789,347792,0,3,1
99202,6,3,347795,347795,347798,0,3,3
99203,3,1,347798,347798,347799,0,1,0
99204,4,2,347802,347802,347804,0,2,3
99205,1,1,347803,347804,347805,1,2,0
99206,5,1,347808,347808,347809,0,1,3
99207,1,1,347809,347809,347810,0,1,0
99208,5,3,347814,347814,347817,0,3,4
99209,2,3,347816,347817,347820,1,4,0
99210,1,3,347817,347820,347823,3,6,0
99211,2,1,347819,347823,347824,4,5,0
99212,3,2,347822,347824,347826,2,4,0
99213,2,1,347824,347826,347827,2,3,0
99214,6,1,347830,347830,347831,0,1,3
99215,1,3,347831,347831,347834,0,3,0
99216,4,1,347835,347835,347836,0,1,1
99217,6,3,347841,347841,347844,0,3,5
99218,6,2,347847,347847,347849,0,2,3
99219,4,3,347851,347851,347854,0,3,2
99220,1,2,347852,347854,347856,2,4,0
99221,2,1,347854,347856,347857,2,3,0
99222,3,2,347857,347857,347859,0,2,0
99223,2,3,347859,347859,347862,0,3,0
99224,6,1,347865,347865,347866,0,1,3
99225,6,3,347871,347871,347874,0,3,5
99226,3,2,347874,347874,347876,0,2,0
99227,6,1,347880,347880,347881,0,1,4
99228,6,2,347886,347886,347888,0,2,5
99229,1,3,347887,347888,347891,1,4,0
99230,1,1,347888,347891,347892,3,4,0
99231,3,1,347891,347892,347893,1,2,0
99232,2,1,347893,347893,347894,0,1,0
99233,4,3,347897,347897,347900,0,3,3
99234,6,2,347903,347903,347905,0,2,3
99235,4,2,347907,347907,347909,0,2,2
99236,5,3,347912,347912,347915,0,3,3
99237,6,2,347918,347918,347920,0,2,3
99238,1,2,347919,347920,347922,1,3,0
99239,5,3,347924,347924,347927,0,3,2
99240,6,1,347930,347930,347931,0,1,3
99241,6,2,347936,347936,347938,0,2,5
99242,2,1,347938,347938,347939,0,1,0
99243,4,3,347942,347942,347945,0,3,3
99244,2,1,347944,347945,347946,1,2,0
99245,1,3,347945,347946,347949,1,4,0
99246,5,2,347950,347950,347952,0,2,1
99247,1,1,347951,347952,347953,1,2,0
99248,4,2,347955,347955,347957,0,2,2
99249,3,1,347958,347958,347959,0,1,1
99250,5,3,347963,347963,347966,0,3,4
99251,4,2,347967,347967,347969,0,2,1
99252,5,2,347972,347972,347974,0,2,3
99253,3,3,347975,347975,347978,0,3,1
99254,4,3,347979,347979,347982,0,3,1
99255,3,1,347982,347982,347983,0,1,0
99256,3,3,347985,347985,347988,0,3,2
99257,3,1,347988,347988,347989,0,1,0
99258,6,2,347994,347994,347996,0,2,5
99259,1,2,347995,347996,347998,1,3,0
99260,4,2,347999,347999,348001,0,2,1
99261,1,2,348000,348001,348003,1,3,0
99262,5,3,348005,348005,348008,0,3,2
99263,2,2,348007,348008,348010,1,3,0
99264,1,3,348008,348010,348013,2,5,0
99265,4,1,348012,348013,348014,1,2,0
99266,5,2,348017,348017,348019,0,2,3
99267,5,1,348022,348022,348023,0,1,3
99268,5,3,348027,348027,348030,0,3,4
99269,5,3,348032,348032,348035,0,3,2
99270,1,2,348033,348035,348037,2,4,0
99271,5,3,348038,348038,348041,0,3,1
99272,1,1,348039,348041,348042,2,3,0
99273,1,1,348040,348042,348043,2,3,0
99274,3,3,348043,348043,348046,0,3,0
99275,6,2,348049,348049,348051,0,2,3
99276,4,1,348053,348053,348054,0,1,2
99277,3,2,348056,348056,348058,0,2,2
99278,2,2,348058,348058,348060,0,2,0
99279,1,1,348059,348060,348061,1,2,0
99280,2,3,348061,348061,348064,0,3,0
99281,3,3,348064,348064,348067,0,3,0
99282,4,1,348068,348068,348069,0,1,1
99283,2,1,348070,348070,348071,0,1,1
99284,3,3,348073,348073,348076,0,3,2
99285,1,3,348074,348076,348079,2,5,0
99286,6,1,348080,348080,348081,0,1,1
99287,6,3,348086,348086,348089,0,3,5
99288,3,1,348089,348089,348090,0,1,0
99289,4,2,348093,348093,348095,0,2,3
99290,1,2,348094,348095,348097,1,3,0
99291,5,1,348099,348099,348100,0,1,2
99292,4,3,348103,348103,348106,0,3,3
99293,4,3,348107,348107,348110,0,3,1
99294,5,3,348112,348112,348115,0,3,2
99295,3,3,348115,348115,348118,0,3,0
99296,5,3,348120,348120,348123,0,3,2
99297,2,1,348122,348123,348124,1,2,0
99298,6,1,348128,348128,348129,0,1,4
99299,1,1,348129,348129,348130,0,1,0
99300,4,2,348133,348133,348135,0,2,3
99301,5,1,348138,348138,348139,0,1,3
99302,5,3,348143,348143,348146,0,3,4
99303,4,1,348147,348147,348148,0,1,1
99304,2,2,348149,348149,348151,0,2,1
99305,5,3,348154,348154,348157,0,3,3
99306,3,1,348157,348157,348158,0,1,0
99307,1,1,348158,348158,348159,0,1,0
99308,1,3,348159,348159,348162,0,3,0
99309,4,2,348163,348163,348165,0,2,1
99310,1,2,348164,348165,348167,1,3,0
99311,3,2,348167,348167,348169,0,2,0
99312,3,2,348170,348170,348172,0,2,1
99313,6,2,348176,348176,348178,0,2,4
99314,4,1,348180,348180,348181,0,1,2
99315,3,3,348183,348183,348186,0,3,2
99316,3,2,348186,348186,348188,0,2,0
99317,4,2,348190,348190,348192,0,2,2
99318,3,2,348193,348193,348195,0,2,1
99319,2,1,348195,348195,348196,0,1,0
99320,1,3,348196,348196,348199,0,3,0
99321,5,3,348201,348201,348204,0,3,2
99322,4,1,348205,348205,348206,0,1,1
99323,3,2,348208,348208,348210,0,2,2
99324,2,1,348210,348210,348211,0,1,0
99325,5,2,348215,348215,348217,0,2,4
99326,5,2,348220,348220,348222,0,2,3
99327,1,2,348221,348222,348224,1,3,0
99328,6,2,348227,348227,348229,0,2,3
99329,3,1,348230,348230,348231,0,1,1
99330,3,3,348233,348233,348236,0,3,2
99331,2,3,348235,348236,348239,1,4,0
99332,1,1,348236,348239,348240,3,4,0
99333,2,1,348238,348240,348241,2,3,0
99334,6,3,348244,348244,348247,0,3,3
99335,6,1,348250,348250,348251,0,1,3
99336,3,1,348253,348253,348254,0,1,2
99337,6,2,348259,348259,348261,0,2,5
99338,5,3,348264,348264,348267,0,3,3
99339,1,1,348265,348267,348268,2,3,0
99340,4,1,348269,348269,348270,0,1,1
99341,3,2,348272,348272,348274,0,2,2
99342,2,1,348274,348274,348275,0,1,0
99343,3,3,348277,348277,348280,0,3,2
99344,6,3,348283,348283,348286,0,3,3
99345,6,3,348289,348289,348292,0,3,3
99346,2,2,348291,348292,348294,1,3,0
99347,4,3,348295,348295,348298,0,3,1
99348,4,3,348299,348299,348302,0,3,1
99349,3,2,348302,348302,348304,0,2,0
99350,3,2,348305,348305,348307,0,2,1
99351,1,1,348306,348307,348308,1,2,0
99352,1,3,348307,348308,348311,1,4,0
99353,6,1,348313,348313,348314,0,1,2
99354,4,1,348317,348317,348318,0,1,3
99355,4,1,348321,348321,348322,0,1,3
99356,5,1,348326,348326,348327,0,1,4
99357,2,3,348328,348328,348331,0,3,1
99358,1,1,348329,348331,348332,2,3,0
99359,5,2,348334,348334,348336,0,2,2
99360,2,1,348336,348336,348337,0,1,0
99361,5,1,348341,348341,348342,0,1,4
99362,4,3,348345,348345,348348,0,3,3
99363,6,2,348351,348351,348353,0,2,3
99364,5,3,348356,348356,348359,0,3,3
99365,6,1,348362,348362,348363,0,1,3
99366,3,1,348365,348365,348366,0,1,2
99367,4,2,348369,348369,348371,0,2,3
99368,3,1,348372,348372,348373,0,1,1
99369,3,3,348375,348375,348378,0,3,2
99370,3,3,348378,348378,348381,0,3,0
99371,3,1,348381,348381,348382,0,1,0
99372,2,2,348383,348383,348385,0,2,1
99373,1,2,348384,348385,348387,1,3,0
99374,1,3,348385,348387,348390,2,5,0
99375,1,2,348386,348390,348392,4,6,0
99376,1,2,348387,348392,348394,5,7,0
99377,5,2,348392,348394,348396,2,4,0
99378,4,3,348396,348396,348399,0,3,0
99379,5,2,348401,348401,348403,0,2,2
99380,5,1,348406,348406,348407,0,1,3
99381,2,3,348408,348408,348411,0,3,1
99382,5,1,348413,348413,348414,0,1,2
99383,6,2,348419,348419,348421,0,2,5
99384,4,1,348423,348423,348424,0,1,2
99385,1,1,348424,348424,348425,0,1,0
99386,4,1,348428,348428,348429,0,1,3
99387,1,2,348429,348429,348431,0,2,0
99388,1,2,348430,348431,348433,1,3,0
99389,1,2,348431,348433,348435,2,4,0
99390,6,1,348437,348437,348438,0,1,2
99391,3,1,348440,348440,348441,0,1,2
99392,3,2,348443,348443,348445,0,2,2
99393,6,2,348449,348449,348451,0,2,4
99394,5,3,348454,348454,348457,0,3,3
99395,4,1,348458,348458,348459,0,1,1
99396,4,1,348462,348462,348463,0,1,3
99397,5,3,348467,348467,348470,0,3,4
99398,1,2,348468,348470,348472,2,4,0
99399,3,1,348471,348472,348473,1,2,0
99400,2,3,348473,348473,348476,0,3,0
99401,2,2,348475,348476,348478,1,3,0
99402,5,2,348480,348480,348482,0,2,2
99403,5,3,348485,348485,348488,0,3,3
99404,3,1,348488,348488,348489,0,1,0
99405,2,2,348490,348490,348492,0,2,1
99406,5,1,348495,348495,348496,0,1,3
99407,2,2,348497,348497,348499,0,2,1
99408,3,1,348500,348500,348501,0,1,1
99409,1,2,348501,348501,348503,0,2,0
99410,3,1,348504,348504,348505,0,1,1
99411,1,2,348505,348505,348507,0,2,0
99412,2,3,348507,348507,348510,0,3,0
99413,6,3,348513,348513,348516,0,3,3
99414,4,3,348517,348517,348520,0,3,1
99415,1,1,348518,348520,348521,2,3,0
99416,6,2,348524,348524,348526,0,2,3
99417,1,3,348525,348526,348529,1,4,0
99418,1,3,348526,348529,348532,3,6,0
99419,5,1,348531,348532,348533,1,2,0
99420,2,2,348533,348533,348535,0,2,0
99421,2,1,348535,348535,348536,0,1,0
99422,6,1,348541,348541,348542,0,1,5
99423,2,2,348543,348543,348545,0,2,1
99424,3,2,348546,348546,348548,0,2,1
99425,3,3,348549,348549,348552,0,3,1
99426,1,3,348550,348552,348555,2,5,0
99427,1,1,348551,348555,348556,4,5,0
99428,2,3,348553,348556,348559,3,6,0
99429,6,1,348559,348559,348560,0,1,0
99430,1,3,348560,348560,348563,0,3,0
99431,4,2,348564,348564,348566,0,2,1
99432,2,1,348566,348566,348567,0,1,0
99433,4,1,348570,348570,348571,0,1,3
99434,6,1,348576,348576,348577,0,1,5
99435,6,1,348582,348582,348583,0,1,5
99436,2,2,348584,348584,348586,0,2,1
99437,1,1,348585,348586,348587,1,2,0
99438,1,2,348586,348587,348589,1,3,0
99439,5,1,348591,348591,348592,0,1,2
99440,6,3,348597,348597,348600,0,3,5
99441,6,2,348603,348603,348605,0,2,3
99442,3,3,348606,348606,348609,0,3,1
99443,1,2,348607,348609,348611,2,4,0
99444,6,2,348613,348613,348615,0,2,2
99445,4,3,348617,348617,348620,0,3,2
99446,5,3,348622,348622,348625,0,3,2
99447,5,2,348627,348627,348629,0,2,2
99448,3,1,348630,348630,348631,0,1,1
99449,1,2,348631,348631,348633,0,2,0
99450,1,3,348632,348633,348636,1,4,0
99451,4,2,348636,348636,348638,0,2,0
99452,1,3,348637,348638,348641,1,4,0
99453,5,2,348642,348642,348644,0,2,1
99454,6,1,348648,348648,348649,0,1,4
99455,5,1,348653,348653,348654,0,1,4
99456,3,2,348656,348656,348658,0,2,2
99457,5,3,348661,348661,348664,0,3,3
99458,2,2,348663,348664,348666,1,3,0
99459,5,3,348668,348668,348671,0,3,2
99460,5,3,348673,348673,348676,0,3,2
99461,3,3,348676,348676,348679,0,3,0
99462,4,3,348680,348680,348683,0,3,1
99463,3,1,348683,348683,348684,0,1,0
99464,3,1,348686,348686,348687,0,1,2
99465,4,2,348690,348690,348692,0,2,3
99466,5,3,348695,348695,348698,0,3,3
99467,5,2,348700,348700,348702,0,2,2
99468,6,1,348706,348706,348707,0,1,4
99469,5,3,348711,348711,348714,0,3,4
99470,5,3,348716,348716,348719,0,3,2
99471,3,2,348719,348719,348721,0,2,0
99472,3,3,348722,348722,348725,0,3,1
99473,5,3,348727,348727,348730,0,3,2
99474,2,3,348729,348730,348733,1,4,0
99475,1,1,348730,348733,348734,3,4,0
99476,5,1,348735,348735,348736,0,1,1
99477,5,2,348740,348740,348742,0,2,4
99478,4,2,348744,348744,348746,0,2,2
99479,1,2,348745,348746,348748,1,3,0
99480,1,2,348746,348748,348750,2,4,0
99481,6,2,348752,348752,348754,0,2,2
99482,3,1,348755,348755,348756,0,1,1
99483,2,2,348757,348757,348759,0,2,1
99484,6,3,348763,348763,348766,0,3,4
99485,1,3,348764,348766,348769,2,5,0
99486,5,1,348769,348769,348770,0,1,0
99487,5,1,348774,348774,348775,0,1,4
99488,3,1,348777,348777,348778,0,1,2
99489,2,1,348779,348779,348780,0,1,1
99490,1,3,348780,348780,348783,0,3,0
99491,3,1,348783,348783,348784,0,1,0
99492,3,1,348786,348786,348787,0,1,2
99493,1,2,348787,348787,348789,0,2,0
99494,3,3,348790,348790,348793,0,3,1
99495,2,1,348792,348793,348794,1,2,0
99496,4,1,348796,348796,348797,0,1,2
99497,4,2,348800,348800,348802,0,2,3
99498,3,3,348803,348803,348806,0,3,1
99499,3,2,348806,348806,348808,0,2,0
99500,2,3,348808,348808,348811,0,3,0
99501,5,2,348813,348813,348815,0,2,2
99502,5,3,348818,348818,348821,0,3,3
99503,6,1,348824,348824,348825,0,1,3
99504,5,1,348829,348829,348830,0,1,4
99505,5,3,348834,348834,348837,0,3,4
99506,2,2,348836,348837,348839,1,3,0
99507,4,1,348840,348840,348841,0,1,1
99508,3,3,348843,348843,348846,0,3,2
99509,1,1,348844,348846,348847,2,3,0
99510,4,2,348848,348848,348850,0,2,1
99511,4,2,348852,348852,348854,0,2,2
99512,1,1,348853,348854,348855,1,2,0
99513,5,1,348858,348858,348859,0,1,3
99514,4,2,348862,348862,348864,0,2,3
99515,4,1,348866,348866,348867,0,1,2
99516,3,3,348869,348869,348872,0,3,2
99517,3,3,348872,348872,348875,0,3,0
99518,3,2,348875,348875,348877,0,2,0
99519,6,1,348881,348881,348882,0,1,4
99520,6,2,348887,348887,348889,0,2,5
99521,1,3,348888,348889,348892,1,4,0
99522,1,3,348889,348892,348895,3,6,0
99523,1,3,348890,348895,348898,5,8,0
99524,2,1,348892,348898,348899,6,7,0
99525,5,2,348897,348899,348901,2,4,0
99526,5,3,348902,348902,348905,0,3,1
99527,1,2,348903,348905,348907,2,4,0
99528,4,2,348907,348907,348909,0,2,0
99529,5,3,348912,348912,348915,0,3,3
99530,3,3,348915,348915,348918,0,3,0
99531,2,2,348917,348918,348920,1,3,0
99532,5,3,348922,348922,348925,0,3,2
99533,2,1,348924,348925,348926,1,2,0
99534,1,1,348925,348926,348927,1,2,0
99535,2,1,348927,348927,348928,0,1,0
99536,5,2,348932,348932,348934,0,2,4
99537,1,3,348933,348934,348937,1,4,0
99538,1,1,348934,348937,348938,3,4,0
99539,2,2,348936,348938,348940,2,4,0
99540,2,2,348938,348940,348942,2,4,0
99541,5,3,348943,348943,348946,0,3,1
99542,1,2,348944,348946,348948,2,4,0
99543,4,3,348948,348948,348951,0,3,0
99544,2,3,348950,348951,348954,1,4,0
99545,6,1,348956,348956,348957,0,1,2
99546,3,2,348959,348959,348961,0,2,2
99547,3,1,348962,348962,348963,0,1,1
99548,4,3,348966,348966,348969,0,3,3
99549,4,1,348970,348970,348971,0,1,1
99550,6,1,348976,348976,348977,0,1,5
99551,2,1,348978,348978,348979,0,1,1
99552,4,2,348982,348982,348984,0,2,3
99553,4,3,348986,348986,348989,0,3,2
99554,5,2,348991,348991,348993,0,2,2
99555,1,1,348992,348993,348994,1,2,0
99556,1,3,348993,348994,348997,1,4,0
99557,3,3,348996,348997,349000,1,4,0
99558,4,2,349000,349000,349002,0,2,0
99559,6,3,349006,349006,349009,0,3,4
99560,1,3,349007,349009,349012,2,5,0
99561,4,2,349011,349012,349014,1,3,0
99562,4,1,349015,349015,349016,0,1,1
99563,6,2,349021,349021,349023,0,2,5
99564,2,1,349023,349023,349024,0,1,0
99565,3,1,349026,349026,349027,0,1,2
99566,3,1,349029,349029,349030,0,1,2
99567,2,2,349031,349031,349033,0,2,1
99568,5,1,349036,349036,349037,0,1,3
99569,3,1,349039,349039,349040,0,1,2
99570,3,2,349042,349042,349044,0,2,2
99571,5,1,349047,349047,349048,0,1,3
99572,6,3,349053,349053,349056,0,3,5
99573,4,3,349057,349057,349060,0,3,1
99574,5,3,349062,349062,349065,0,3,2
99575,2,1,349064,349065,349066,1,2,0
99576,2,3,349066,349066,349069,0,3,0
99577,5,1,349071,349071,349072,0,1,2
99578,4,3,349075,349075,349078,0,3,3
99579,6,2,349081,349081,349083,0,2,3
99580,5,1,349086,349086,349087,0,1,3
99581,6,3,349092,349092,349095,0,3,5
99582,4,1,349096,349096,349097,0,1,1
99583,3,2,349099,349099,349101,0,2,2
99584,1,3,349100,349101,349104,1,4,0
99585,2,3,349102,349104,349107,2,5,0
99586,1,3,349103,349107,349110,4,7,0
99587,3,1,349106,349110,349111,4,5,0
99588,2,1,349108,349111,349112,3,4,0
99589,4,2,349112,349112,349114,0,2,0
99590,1,3,349113,349114,349117,1,4,0
99591,3,3,349116,349117,349120,1,4,0
99592,3,1,349119,349120,349121,1,2,0
99593,2,2,349121,349121,349123,0,2,0
99594,6,3,349127,349127,349130,0,3,4
99595,2,3,349129,349130,349133,1,4,0
99596,2,1,349131,349133,349134,2,3,0
99597,2,3,349133,349134,349137,1,4,0
99598,6,3,349139,349139,349142,0,3,2
99599,3,1,349142,349142,349143,0,1,0
99600,2,3,349144,349144,349147,0,3,1
99601,5,3,349149,349149,349152,0,3,2
99602,4,3,349153,349153,349156,0,3,1
99603,3,3,349156,349156,349159,0,3,0
99604,1,2,349157,349159,349161,2,4,0
99605,1,1,349158,349161,349162,3,4,0
99606,1,3,349159,349162,349165,3,6,0
99607,1,3,349160,349165,349168,5,8,0
99608,1,1,349161,349168,349169,7,8,0
99609,6,1,349167,349169,349170,2,3,0
99610,3,3,349170,349170,349173,0,3,0
99611,2,3,349172,349173,349176,1,4,0
99612,4,3,349176,349176,349179,0,3,0
99613,4,2,349180,349180,349182,0,2,1
99614,6,1,349186,349186,349187,0,1,4
99615,4,2,349190,349190,349192,0,2,3
99616,3,3,349193,349193,349196,0,3,1
99617,1,2,349194,349196,349198,2,4,0
99618,5,3,349199,349199,349202,0,3,1
99619,3,1,349202,349202,349203,0,1,0
99620,3,3,349205,349205,349208,0,3,2
99621,2,3,349207,349208,349211,1,4,0
99622,5,2,349212,349212,349214,0,2,1
99623,5,2,349217,349217,349219,0,2,3
99624,1,1,349218,349219,349220,1,2,0
99625,1,3,349219,349220,349223,1,4,0
99626,3,2,349222,349223,349225,1,3,0
99627,3,2,349225,349225,349227,0,2,0
99628,4,2,349229,349229,349231,0,2,2
99629,3,3,349232,349232,349235,0,3,1
99630,1,3,349233,349235,349238,2,5,0
99631,1,2,349234,349238,349240,4,6,0
99632,1,3,349235,349240,349243,5,8,0
99633,6,2,349241,349243,349245,2,4,0
99634,2,1,349243,349245,349246,2,3,0
99635,1,1,349244,349246,349247,2,3,0
99636,4,3,349248,349248,349251,0,3,1
99637,6,1,349254,349254,349255,0,1,3
99638,5,3,349259,349259,349262,0,3,4
99639,2,3,349261,349262,349265,1,4,0
99640,3,2,349264,349265,349267,1,3,0
99641,6,3,349270,349270,349273,0,3,3
99642,6,2,349276,349276,349278,0,2,3
99643,3,2,349279,349279,349281,0,2,1
99644,2,1,349281,349281,349282,0,1,0
99645,3,1,349284,349284,349285,0,1,2
99646,4,3,349288,349288,349291,0,3,3
99647,5,3,349293,349293,349296,0,3,2
99648,2,1,349295,349296,349297,1,2,0
99649,2,1,349297,349297,349298,0,1,0
99650,5,1,349302,349302,349303,0,1,4
99651,6,2,349308,349308,349310,0,2,5
99652,2,3,349310,349310,349313,0,3,0
99653,3,2,349313,349313,349315,0,2,0
99654,4,3,349317,349317,349320,0,3,2
99655,4,1,349321,349321,349322,0,1,1
99656,3,2,349324,349324,349326,0,2,2
99657,2,2,349326,349326,349328,0,2,0
99658,1,3,349327,349328,349331,1,4,0
99659,4,1,349331,349331,349332,0,1,0
99660,1,2,349332,349332,349334,0,2,0
99661,6,1,349338,349338,349339,0,1,4
99662,4,2,349342,349342,349344,0,2,3
99663,1,3,349343,349344,349347,1,4,0
99664,3,1,349346,349347,349348,1,2,0
99665,3,2,349349,349349,349351,0,2,1
99666,2,2,349351,349351,349353,0,2,0
99667,1,1,349352,349353,349354,1,2,0
99668,2,3,349354,349354,349357,0,3,0
99669,1,3,349355,349357,349360,2,5,0
99670,4,3,349359,349360,349363,1,4,0
99671,5,1,349364,349364,349365,0,1,1
99672,2,1,349366,349366,349367,0,1,1
99673,6,2,349372,349372,349374,0,2,5
99674,6,3,349378,349378,349381,0,3,4
99675,5,1,349383,349383,349384,0,1,2
99676,5,2,349388,349388,349390,0,2,4
99677,5,3,349393,349393,349396,0,3,3
99678,1,3,349394,349396,349399,2,5,0
99679,3,3,349397,349399,349402,2,5,0
99680,6,2,349403,349403,349405,0,2,1
99681,2,3,349405,349405,349408,0,3,0
99682,2,2,349407,349408,349410,1,3,0
99683,6,1,349413,349413,349414,0,1,3
99684,1,2,349414,349414,349416,0,2,0
99685,2,1,349416,349416,349417,0,1,0
99686,2,1,349418,349418,349419,0,1,1
99687,6,1,349424,349424,349425,0,1,5
99688,3,3,349427,349427,349430,0,3,2
99689,4,3,349431,349431,349434,0,3,1
99690,3,3,349434,349434,349437,0,3,0
99691,4,1,349438,349438,349439,0,1,1
99692,3,3,349441,349441,349444,0,3,2
99693,5,1,349446,349446,349447,0,1,2
99694,6,2,349452,349452,349454,0,2,5
99695,5,3,349457,349457,349460,0,3,3
99696,2,2,349459,349460,349462,1,3,0
99697,3,3,349462,349462,349465,0,3,0
99698,1,3,349463,349465,349468,2,5,0
99699,4,2,349467,349468,349470,1,3,0
99700,3,3,349470,349470,349473,0,3,0
99701,4,2,349474,349474,349476,0,2,1
99702,1,1,349475,349476,349477,1,2,0
99703,6,3,349481,349481,349484,0,3,4
99704,2,2,349483,349484,349486,1,3,0
99705,6,1,349489,349489,349490,0,1,3
99706,3,2,349492,349492,349494,0,2,2
99707,1,1,349493,349494,349495,1,2,0
99708,2,2,349495,349495,349497,0,2,0
99709,2,2,349497,349497,349499,0,2,0
99710,6,3,349503,349503,349506,0,3,4
99711,3,3,349506,349506,349509,0,3,0
99712,1,2,349507,349509,349511,2,4,0
99713,5,1,349512,349512,349513,0,1,1
99714,3,1,349515,349515,349516,0,1,2
99715,2,3,349517,349517,349520,0,3,1
99716,1,1,349518,349520,349521,2,3,0
99717,6,2,349524,349524,349526,0,2,3
99718,3,1,349527,349527,349528,0,1,1
99719,6,1,349533,349533,349534,0,1,5
99720,3,1,349536,349536,349537,0,1,2
99721,2,2,349538,349538,349540,0,2,1
99722,6,1,349544,349544,349545,0,1,4
99723,2,2,349546,349546,349548,0,2,1
99724,2,3,349548,349548,349551,0,3,0
99725,3,3,349551,349551,349554,0,3,0
99726,6,2,349557,349557,349559,0,2,3
99727,4,1,349561,349561,349562,0,1,2
99728,2,2,349563,349563,349565,0,2,1
99729,4,1,349567,349567,349568,0,1,2
99730,4,3,349571,349571,349574,0,3,3
99731,3,3,349574,349574,349577,0,3,0
99732,4,3,349578,349578,349581,0,3,1
99733,4,2,349582,349582,349584,0,2,1
99734,3,3,349585,349585,349588,0,3,1
99735,6,2,349591,349591,349593,0,2,3
99736,1,3,349592,349593,349596,1,4,0
99737,1,2,349593,349596,349598,3,5,0
99738,6,1,349599,349599,349600,0,1,1
99739,6,3,349605,349605,349608,0,3,5
99740,4,3,349609,349609,349612,0,3,1
99741,6,1,349615,349615,349616,0,1,3
99742,5,1,349620,349620,349621,0,1,4
99743,3,2,349623,349623,349625,0,2,2
99744,4,2,349627,349627,349629,0,2,2
99745,6,2,349633,349633,349635,0,2,4
99746,4,1,349637,349637,349638,0,1,2
99747,2,3,349639,349639,349642,0,3,1
99748,5,3,349644,349644,349647,0,3,2
99749,3,1,349647,349647,349648,0,1,0
99750,2,2,349649,349649,349651,0,2,1
99751,2,1,349651,349651,349652,0,1,0
99752,1,2,349652,349652,349654,0,2,0
99753,1,1,349653,349654,349655,1,2,0
99754,5,1,349658,349658,349659,0,1,3
99755,5,2,349663,349663,349665,0,2,4
99756,3,2,349666,349666,349668,0,2,1
99757,3,1,349669,349669,349670,0,1,1
99758,1,1,349670,349670,349671,0,1,0
99759,3,1,349673,349673,349674,0,1,2
99760,5,2,349678,349678,349680,0,2,4
99761,2,1,349680,349680,349681,0,1,0
99762,1,3,349681,349681,349684,0,3,0
99763,5,2,349686,349686,349688,0,2,2
99764,2,1,349688,349688,349689,0,1,0
99765,6,1,349694,349694,349695,0,1,5
99766,6,1,349700,349700,349701,0,1,5
99767,3,3,349703,349703,349706,0,3,2
99768,4,1,349707,349707,349708,0,1,1
99769,5,3,349712,349712,349715,0,3,4
99770,2,2,349714,349715,349717,1,3,0
99771,4,3,349718,349718,349721,0,3,1
99772,3,1,349721,349721,349722,0,1,0
99773,3,3,349724,349724,349727,0,3,2
99774,2,3,349726,349727,349730,1,4,0
99775,2,1,349728,349730,349731,2,3,0
99776,3,1,349731,349731,349732,0,1,0
99777,2,1,349733,349733,349734,0,1,1
99778,2,1,349735,349735,349736,0,1,1
99779,2,3,349737,349737,349740,0,3,1
99780,3,1,349740,349740,349741,0,1,0
99781,1,2,349741,349741,349743,0,2,0
99782,2,3,349743,349743,349746,0,3,0
99783,2,1,349745,349746,349747,1,2,0
99784,3,3,349748,349748,349751,0,3,1
99785,2,2,349750,349751,349753,1,3,0
99786,5,2,349755,349755,349757,0,2,2
99787,6,1,349761,349761,349762,0,1,4
99788,2,2,349763,349763,349765,0,2,1
99789,2,2,349765,349765,349767,0,2,0
99790,4,3,349769,349769,349772,0,3,2
99791,4,2,349773,349773,349775,0,2,1
99792,4,1,349777,349777,349778,0,1,2
99793,3,3,349780,349780,349783,0,3,2
99794,1,1,349781,349783,349784,2,3,0
99795,1,1,349782,349784,349785,2,3,0
99796,6,2,349788,349788,349790,0,2,3
99797,2,1,349790,349790,349791,0,1,0
99798,3,2,349793,349793,349795,0,2,2
99799,1,3,349794,349795,349798,1,4,0
99800,5,2,349799,349799,349801,0,2,1
99801,2,1,349801,349801,349802,0,1,0
99802,2,3,349803,349803,349806,0,3,1
99803,6,2,349809,349809,349811,0,2,3
99804,2,3,349811,349811,349814,0,3,0
99805,2,3,349813,349814,349817,1,4,0
99806,6,1,349819,349819,349820,0,1,2
99807,4,1,349823,349823,349824,0,1,3
99808,3,1,349826,349826,349827,0,1,2
99809,6,1,349832,349832,349833,0,1,5
99810,2,3,349834,349834,349837,0,3,1
99811,5,2,349839,349839,349841,0,2,2
99812,5,2,349844,349844,349846,0,2,3
99813,1,3,349845,349846,349849,1,4,0
99814,1,1,349846,349849,349850,3,4,0
99815,5,2,349851,349851,349853,0,2,1
99816,2,1,349853,349853,349854,0,1,0
99817,1,3,349854,349854,349857,0,3,0
99818,4,3,349858,349858,349861,0,3,1
99819,3,3,349861,349861,349864,0,3,0
99820,1,3,349862,349864,349867,2,5,0
99821,2,1,349864,349867,349868,3,4,0
99822,1,3,349865,349868,349871,3,6,0
99823,3,2,349868,349871,349873,3,5,0
99824,1,3,349869,349873,349876,4,7,0
99825,5,1,349874,349876,349877,2,3,0
99826,3,2,349877,349877,349879,0,2,0
99827,1,3,349878,349879,349882,1,4,0
99828,2,1,349880,349882,349883,2,3,0
99829,4,2,349884,349884,349886,0,2,1
99830,4,3,349888,349888,349891,0,3,2
99831,6,3,349894,349894,349897,0,3,3
99832,5,1,349899,349899,349900,0,1,2
99833,5,1,349904,349904,349905,0,1,4
99834,5,2,349909,349909,349911,0,2,4
99835,2,2,349911,349911,349913,0,2,0
99836,3,3,349914,349914,349917,0,3,1
99837,3,1,349917,349917,349918,0,1,0
99838,6,2,349923,349923,349925,0,2,5
99839,4,3,349927,349927,349930,0,3,2
99840,3,3,349930,349930,349933,0,3,0
99841,6,1,349936,349936,349937,0,1,3
99842,2,3,349938,349938,349941,0,3,1
99843,4,3,349942,349942,349945,0,3,1
99844,4,2,349946,349946,349948,0,2,1
99845,3,2,349949,349949,349951,0,2,1
99846,6,2,349955,349955,349957,0,2,4
99847,4,1,349959,349959,349960,0,1,2
99848,4,2,349963,349963,349965,0,2,3
99849,3,2,349966,349966,349968,0,2,1
99850,2,2,349968,349968,349970,0,2,0
99851,4,1,349972,349972,349973,0,1,2
99852,6,1,349978,349978,349979,0,1,5
99853,5,3,349983,349983,349986,0,3,4
99854,4,1,349987,349987,349988,0,1,1
99855,6,2,349993,349993,349995,0,2,5
99856,1,3,349994,349995,349998,1,4,0
99857,4,2,349998,349998,350000,0,2,0
99858,1,2,349999,350000,350002,1,3,0
99859,4,2,350003,350003,350005,0,2,1
99860,5,2,350008,350008,350010,0,2,3
99861,3,1,350011,350011,350012,0,1,1
99862,6,2,350017,350017,350019,0,2,5
99863,5,1,350022,350022,350023,0,1,3
99864,5,2,350027,350027,350029,0,2,4
99865,5,3,350032,350032,350035,0,3,3
99866,5,3,350037,350037,350040,0,3,2
99867,4,2,350041,350041,350043,0,2,1
99868,2,2,350043,350043,350045,0,2,0
99869,1,2,350044,350045,350047,1,3,0
99870,5,3,350049,350049,350052,0,3,2
99871,6,1,350055,350055,350056,0,1,3
99872,4,1,350059,350059,350060,0,1,3
99873,5,2,350064,350064,350066,0,2,4
99874,6,1,350070,350070,350071,0,1,4
99875,5,2,350075,350075,350077,0,2,4
99876,3,1,350078,350078,350079,0,1,1
99877,6,3,350084,350084,350087,0,3,5
99878,4,3,350088,350088,350091,0,3,1
99879,5,1,350093,350093,350094,0,1,2
99880,2,1,350095,350095,350096,0,1,1
99881,2,2,350097,350097,350099,0,2,1
99882,3,2,350100,350100,350102,0,2,1
99883,5,3,350105,350105,350108,0,3,3
99884,2,3,350107,350108,350111,1,4,0
99885,2,1,350109,350111,350112,2,3,0
99886,1,1,350110,350112,350113,2,3,0
99887,5,3,350115,350115,350118,0,3,2
99888,3,2,350118,350118,350120,0,2,0
99889,2,1,350120,350120,350121,0,1,0
99890,1,3,350121,350121,350124,0,3,0
99891,2,1,350123,350124,350125,1,2,0
99892,2,2,350125,350125,350127,0,2,0
99893,1,2,350126,350127,350129,1,3,0
99894,5,2,350131,350131,350133,0,2,2
99895,1,1,350132,350133,350134,1,2,0
99896,6,2,350138,350138,350140,0,2,4
99897,2,2,350140,350140,350142,0,2,0
99898,6,2,350146,350146,350148,0,2,4
99899,4,1,350150,350150,350151,0,1,2
99900,5,3,350155,350155,350158,0,3,4
99901,2,3,350157,350158,350161,1,4,0
99902,3,2,350160,350161,350163,1,3,0
99903,2,2,350162,350163,350165,1,3,0
99904,2,3,350164,350165,350168,1,4,0
99905,4,2,350168,350168,350170,0,2,0
99906,3,1,350171,350171,350172,0,1,1
99907,2,1,350173,350173,350174,0,1,1
99908,5,2,350178,350178,350180,0,2,4
99909,3,2,350181,350181,350183,0,2,1
99910,5,1,350186,350186,350187,0,1,3
99911,3,3,350189,350189,350192,0,3,2
99912,5,3,350194,350194,350197,0,3,2
99913,4,3,350198,350198,350201,0,3,1
99914,1,2,350199,350201,350203,2,4,0
99915,3,1,350202,350203,350204,1,2,0
99916,5,2,350207,350207,350209,0,2,3
99917,1,1,350208,350209,350210,1,2,0
99918,4,3,350212,350212,350215,0,3,2
99919,1,3,350213,350215,350218,2,5,0
99920,1,2,350214,350218,350220,4,6,0
99921,4,1,350218,350220,350221,2,3,0
99922,5,2,350223,350223,350225,0,2,2
99923,2,2,350225,350225,350227,0,2,0
99924,3,3,350228,350228,350231,0,3,1
99925,2,1,350230,350231,350232,1,2,0
99926,1,3,350231,350232,350235,1,4,0
99927,2,2,350233,350235,350237,2,4,0
99928,2,3,350235,350237,350240,2,5,0
99929,6,1,350241,350241,350242,0,1,1
99930,6,1,350247,350247,350248,0,1,5
99931,5,1,350252,350252,350253,0,1,4
99932,2,1,350254,350254,350255,0,1,1
99933,2,1,350256,350256,350257,0,1,1
99934,5,3,350261,350261,350264,0,3,4
99935,1,2,350262,350264,350266,2,4,0
99936,4,3,350266,350266,350269,0,3,0
99937,3,2,350269,350269,350271,0,2,0
99938,3,1,350272,350272,350273,0,1,1
99939,3,1,350275,350275,350276,0,1,2
99940,3,2,350278,350278,350280,0,2,2
99941,5,2,350283,350283,350285,0,2,3
99942,1,3,350284,350285,350288,1,4,0
99943,1,3,350285,350288,350291,3,6,0
99944,5,1,350290,350291,350292,1,2,0
99945,5,2,350295,350295,350297,0,2,3
99946,2,3,350297,350297,350300,0,3,0
99947,1,3,350298,350300,350303,2,5,0
99948,1,3,350299,350303,350306,4,7,0
99949,3,3,350302,350306,350309,4,7,0
99950,3,3,350305,350309,350312,4,7,0
99951,6,3,350311,350312,350315,1,4,0
99952,2,2,350313,350315,350317,2,4,0
99953,5,3,350318,350318,350321,0,3,1
99954,3,2,350321,350321,350323,0,2,0
99955,6,1,350327,350327,350328,0,1,4
99956,2,1,350329,350329,350330,0,1,1
99957,6,3,350335,350335,350338,0,3,5
99958,3,2,350338,350338,350340,0,2,0
99959,5,1,350343,350343,350344,0,1,3
99960,1,3,350344,350344,350347,0,3,0
99961,6,2,350350,350350,350352,0,2,3
99962,5,3,350355,350355,350358,0,3,3
99963,2,2,350357,350358,350360,1,3,0
99964,5,1,350362,350362,350363,0,1,2
99965,6,1,350368,350368,350369,0,1,5
99966,4,2,350372,350372,350374,0,2,3
99967,2,3,350374,350374,350377,0,3,0
99968,1,3,350375,350377,350380,2,5,0
99969,3,3,350378,350380,350383,2,5,0
99970,2,2,350380,350383,350385,3,5,0
99971,1,3,350381,350385,350388,4,7,0
99972,4,2,350385,350388,350390,3,5,0
99973,6,2,350391,350391,350393,0,2,1
99974,6,1,350397,350397,350398,0,1,4
99975,2,1,350399,350399,350400,0,1,1
99976,1,2,350400,350400,350402,0,2,0
99977,5,1,350405,350405,350406,0,1,3
99978,3,1,350408,350408,350409,0,1,2
99979,3,2,350411,350411,350413,0,2,2
99980,2,2,350413,350413,350415,0,2,0
99981,3,2,350416,350416,350418,0,2,1
99982,5,1,350421,350421,350422,0,1,3
99983,3,1,350424,350424,350425,0,1,2
99984,2,3,350426,350426,350429,0,3,1
99985,2,2,350428,350429,350431,1,3,0
99986,4,1,350432,350432,350433,0,1,1
99987,2,2,350434,350434,350436,0,2,1
99988,6,3,350440,350440,350443,0,3,4
99989,2,1,350442,350443,350444,1,2,0
99990,6,2,350448,350448,350450,0,2,4
99991,4,1,350452,350452,350453,0,1,2
99992,6,1,350458,350458,350459,0,1,5
99993,5,2,350463,350463,350465,0,2,4
99994,2,3,350465,350465,350468,0,3,0
99995,3,2,350468,350468,350470,0,2,0
99996,2,1,350470,350470,350471,0,1,0
99997,6,1,350476,350476,350477,0,1,5
99998,2,3,350478,350478,350481,0,3,1
99999,3,3,350481,350481,350484,0,3,0
