,time_between,service_time,arrival_time,start_time,end_time,wait_time,system_time,idle_time
0,0,2,0,0,2,0,2,0
1,1,3,1,2,5,1,4,0
2,3,3,4,5,8,1,4,0
3,4,2,8,8,10,0,2,0
4,2,1,10,10,11,0,1,0
5,6,3,16,16,19,0,3,5
6,3,3,19,19,22,0,3,0
7,4,1,23,23,24,0,1,1
8,6,1,29,29,30,0,1,5
9,2,2,31,31,33,0,2,1
10,3,3,34,34,37,0,3,1
11,4,1,38,38,39,0,1,1
12,2,3,40,40,43,0,3,1
13,1,2,41,43,45,2,4,0
14,3,3,44,45,48,1,4,0
15,2,1,46,48,49,2,3,0
16,5,1,51,51,52,0,1,2
17,6,3,57,57,60,0,3,5
18,6,3,63,63,66,0,3,3
19,5,1,68,68,69,0,1,2
20,6,1,74,74,75,0,1,5
21,1,1,75,75,76,0,1,0
22,5,1,80,80,81,0,1,4
23,2,2,82,82,84,0,2,1
24,5,3,87,87,90,0,3,3
25,1,3,88,90,93,2,5,0
26,3,3,91,93,96,2,5,0
27,6,3,97,97,100,0,3,1
28,4,1,101,101,102,0,1,1
29,2,1,103,103,104,0,1,1
30,3,1,106,106,107,0,1,2
31,6,3,112,112,115,0,3,5
32,5,1,117,117,118,0,1,2
33,2,3,119,119,122,0,3,1
34,6,3,125,125,128,0,3,3
35,2,1,127,128,129,1,2,0
36,2,2,129,129,131,0,2,0
37,3,2,132,132,134,0,2,1
38,1,2,133,134,136,1,3,0
39,2,2,135,136,138,1,3,0
40,3,2,138,138,140,0,2,0
41,1,1,139,140,141,1,2,0
42,1,3,140,141,144,1,4,0
43,2,1,142,144,145,2,3,0
44,1,2,143,145,147,2,4,0
45,6,1,149,149,150,0,1,2
46,6,3,155,155,158,0,3,5
47,3,3,158,158,161,0,3,0
48,5,3,163,163,166,0,3,2
49,3,3,166,166,169,0,3,0
50,1,3,167,169,172,2,5,0
51,3,3,170,172,175,2,5,0
52,5,2,175,175,177,0,2,0
53,6,3,181,181,184,0,3,4
54,4,3,185,185,188,0,3,1
55,2,3,187,188,191,1,4,0
56,5,2,192,192,194,0,2,1
57,4,1,196,196,197,0,1,2
58,1,1,197,197,198,0,1,0
59,2,3,199,199,202,0,3,1
60,3,3,202,202,205,0,3,0
61,4,1,206,206,207,0,1,1
62,3,1,209,209,210,0,1,2
63,2,3,211,211,214,0,3,1
64,5,2,216,216,218,0,2,2
65,6,3,222,222,225,0,3,4
66,5,2,227,227,229,0,2,2
67,3,1,230,230,231,0,1,1
68,5,2,235,235,237,0,2,4
69,1,2,236,237,239,1,3,0
70,2,2,238,239,241,1,3,0
71,5,2,243,243,245,0,2,2
72,6,3,249,249,252,0,3,4
73,6,3,255,255,258,0,3,3
74,2,1,257,258,259,1,2,0
75,6,3,263,263,266,0,3,4
76,3,1,266,266,267,0,1,0
77,4,3,270,270,273,0,3,3
78,5,2,275,275,277,0,2,2
79,1,1,276,277,278,1,2,0
80,1,2,277,278,280,1,3,0
81,5,2,282,282,284,0,2,2
82,4,3,286,286,289,0,3,2
83,2,1,288,289,290,1,2,0
84,2,2,290,290,292,0,2,0
85,3,2,293,293,295,0,2,1
86,1,3,294,295,298,1,4,0
87,4,3,298,298,301,0,3,0
88,4,2,302,302,304,0,2,1
89,5,1,307,307,308,0,1,3
90,4,3,311,311,314,0,3,3
91,2,2,313,314,316,1,3,0
92,1,2,314,316,318,2,4,0
93,4,1,318,318,319,0,1,0
94,1,1,319,319,320,0,1,0
95,4,1,323,323,324,0,1,3
96,3,1,326,326,327,0,1,2
97,2,2,328,328,330,0,2,1
98,5,1,333,333,334,0,1,3
99,3,3,336,336,339,0,3,2
100,6,3,342,342,345,0,3,3
101,4,1,346,346,347,0,1,1
102,5,1,351,351,352,0,1,4
103,3,2,354,354,356,0,2,2
104,2,2,356,356,358,0,2,0
105,1,1,357,358,359,1,2,0
106,2,1,359,359,360,0,1,0
107,2,1,361,361,362,0,1,1
108,2,3,363,363,366,0,3,1
109,4,3,367,367,370,0,3,1
110,2,3,369,370,373,1,4,0
111,1,1,370,373,374,3,4,0
112,6,3,376,376,379,0,3,2
113,2,1,378,379,380,1,2,0
114,1,3,379,380,383,1,4,0
115,5,2,384,384,386,0,2,1
116,6,2,390,390,392,0,2,4
117,2,1,392,392,393,0,1,0
118,5,1,397,397,398,0,1,4
119,3,3,400,400,403,0,3,2
120,6,3,406,406,409,0,3,3
121,5,2,411,411,413,0,2,2
122,3,1,414,414,415,0,1,1
123,3,3,417,417,420,0,3,2
124,6,3,423,423,426,0,3,3
125,6,2,429,429,431,0,2,3
126,4,1,433,433,434,0,1,2
127,3,1,436,436,437,0,1,2
128,5,2,441,441,443,0,2,4
129,2,3,443,443,446,0,3,0
130,4,1,447,447,448,0,1,1
131,4,2,451,451,453,0,2,3
132,6,2,457,457,459,0,2,4
133,1,3,458,459,462,1,4,0
134,3,1,461,462,463,1,2,0
135,5,1,466,466,467,0,1,3
136,2,2,468,468,470,0,2,1
137,2,1,470,470,471,0,1,0
138,3,2,473,473,475,0,2,2
139,3,3,476,476,479,0,3,1
140,2,3,478,479,482,1,4,0
141,2,1,480,482,483,2,3,0
142,2,2,482,483,485,1,3,0
143,5,2,487,487,489,0,2,2
144,6,2,493,493,495,0,2,4
145,3,1,496,496,497,0,1,1
146,6,2,502,502,504,0,2,5
147,5,3,507,507,510,0,3,3
148,6,1,513,513,514,0,1,3
149,1,3,514,514,517,0,3,0
150,1,3,515,517,520,2,5,0
151,6,2,521,521,523,0,2,1
152,3,2,524,524,526,0,2,1
153,2,1,526,526,527,0,1,0
154,1,3,527,527,530,0,3,0
155,6,2,533,533,535,0,2,3
156,3,1,536,536,537,0,1,1
157,3,2,539,539,541,0,2,2
158,4,1,543,543,544,0,1,2
159,2,2,545,545,547,0,2,1
160,3,1,548,548,549,0,1,1
161,6,3,554,554,557,0,3,5
162,3,2,557,557,559,0,2,0
163,2,1,559,559,560,0,1,0
164,3,2,562,562,564,0,2,2
165,2,2,564,564,566,0,2,0
166,4,2,568,568,570,0,2,2
167,6,2,574,574,576,0,2,4
168,1,1,575,576,577,1,2,0
169,1,1,576,577,578,1,2,0
170,2,2,578,578,580,0,2,0
171,3,3,581,581,584,0,3,1
172,5,3,586,586,589,0,3,2
173,5,3,591,591,594,0,3,2
174,4,2,595,595,597,0,2,1
175,6,1,601,601,602,0,1,4
176,2,3,603,603,606,0,3,1
177,5,3,608,608,611,0,3,2
178,4,3,612,612,615,0,3,1
179,6,2,618,618,620,0,2,3
180,5,1,623,623,624,0,1,3
181,4,1,627,627,628,0,1,3
182,6,3,633,633,636,0,3,5
183,6,1,639,639,640,0,1,3
184,2,2,641,641,643,0,2,1
185,1,3,642,643,646,1,4,0
186,4,3,646,646,649,0,3,0
187,3,2,649,649,651,0,2,0
188,4,3,653,653,656,0,3,2
189,6,3,659,659,662,0,3,3
190,5,1,664,664,665,0,1,2
191,1,1,665,665,666,0,1,0
192,1,1,666,666,667,0,1,0
193,1,1,667,667,668,0,1,0
194,3,1,670,670,671,0,1,2
195,1,2,671,671,673,0,2,0
196,3,3,674,674,677,0,3,1
197,5,3,679,679,682,0,3,2
198,1,2,680,682,684,2,4,0
199,4,3,684,684,687,0,3,0
200,4,2,688,688,690,0,2,1
201,6,3,694,694,697,0,3,4
202,2,2,696,697,699,1,3,0
203,2,2,698,699,701,1,3,0
204,1,3,699,701,704,2,5,0
205,3,1,702,704,705,2,3,0
206,4,2,706,706,708,0,2,1
207,2,1,708,708,709,0,1,0
208,2,1,710,710,711,0,1,1
209,6,1,716,716,717,0,1,5
210,5,1,721,721,722,0,1,4
211,1,2,722,722,724,0,2,0
212,3,1,725,725,726,0,1,1
213,3,1,728,728,729,0,1,2
214,4,2,732,732,734,0,2,3
215,2,2,734,734,736,0,2,0
216,2,2,736,736,738,0,2,0
217,1,1,737,738,739,1,2,0
218,3,3,740,740,743,0,3,1
219,5,2,745,745,747,0,2,2
220,2,1,747,747,748,0,1,0
221,2,1,749,749,750,0,1,1
222,5,1,754,754,755,0,1,4
223,1,3,755,755,758,0,3,0
224,4,1,759,759,760,0,1,1
225,1,1,760,760,761,0,1,0
226,5,2,765,765,767,0,2,4
227,1,1,766,767,768,1,2,0
228,5,2,771,771,773,0,2,3
229,4,3,775,775,778,0,3,2
230,1,2,776,778,780,2,4,0
231,4,1,780,780,781,0,1,0
232,3,3,783,783,786,0,3,2
233,2,1,785,786,787,1,2,0
234,3,3,788,788,791,0,3,1
235,5,1,793,793,794,0,1,2
236,2,1,795,795,796,0,1,1
237,3,1,798,798,799,0,1,2
238,5,1,803,803,804,0,1,4
239,3,2,806,806,808,0,2,2
240,4,3,810,810,813,0,3,2
241,2,2,812,813,815,1,3,0
242,6,2,818,818,820,0,2,3
243,1,3,819,820,823,1,4,0
244,5,2,824,824,826,0,2,1
245,5,3,829,829,832,0,3,3
246,6,1,835,835,836,0,1,3
247,3,2,838,838,840,0,2,2
248,2,3,840,840,843,0,3,0
249,2,1,842,843,844,1,2,0
250,3,3,845,845,848,0,3,1
251,2,2,847,848,850,1,3,0
252,5,1,852,852,853,0,1,2
253,4,1,856,856,857,0,1,3
254,4,1,860,860,861,0,1,3
255,1,3,861,861,864,0,3,0
256,3,1,864,864,865,0,1,0
257,3,3,867,867,870,0,3,2
258,3,1,870,870,871,0,1,0
259,1,1,871,871,872,0,1,0
260,6,3,877,877,880,0,3,5
261,1,2,878,880,882,2,4,0
262,2,1,880,882,883,2,3,0
263,4,3,884,884,887,0,3,1
264,3,2,887,887,889,0,2,0
265,4,1,891,891,892,0,1,2
266,2,3,893,893,896,0,3,1
267,1,2,894,896,898,2,4,0
268,1,3,895,898,901,3,6,0
269,5,2,900,901,903,1,3,0
270,3,2,903,903,905,0,2,0
271,1,1,904,905,906,1,2,0
272,2,3,906,906,909,0,3,0
273,2,3,908,909,912,1,4,0
274,4,2,912,912,914,0,2,0
275,5,3,917,917,920,0,3,3
276,1,3,918,920,923,2,5,0
277,6,3,924,924,927,0,3,1
278,6,1,930,930,931,0,1,3
279,6,3,936,936,939,0,3,5
280,6,3,942,942,945,0,3,3
281,6,2,948,948,950,0,2,3
282,1,1,949,950,951,1,2,0
283,3,1,952,952,953,0,1,1
284,1,1,953,953,954,0,1,0
285,1,1,954,954,955,0,1,0
286,5,3,959,959,962,0,3,4
287,1,3,960,962,965,2,5,0
288,6,1,966,966,967,0,1,1
289,3,2,969,969,971,0,2,2
290,1,1,970,971,972,1,2,0
291,5,2,975,975,977,0,2,3
292,3,1,978,978,979,0,1,1
293,5,1,983,983,984,0,1,4
294,6,2,989,989,991,0,2,5
295,1,3,990,991,994,1,4,0
296,2,2,992,994,996,2,4,0
297,3,2,995,996,998,1,3,0
298,1,2,996,998,1000,2,4,0
299,3,1,999,1000,1001,1,2,0
300,5,2,1004,1004,1006,0,2,3
301,5,2,1009,1009,1011,0,2,3
302,5,3,1014,1014,1017,0,3,3
303,4,2,1018,1018,1020,0,2,1
304,6,2,1024,1024,1026,0,2,4
305,5,1,1029,1029,1030,0,1,3
306,4,1,1033,1033,1034,0,1,3
307,1,3,1034,1034,1037,0,3,0
308,4,2,1038,1038,1040,0,2,1
309,2,3,1040,1040,1043,0,3,0
310,4,3,1044,1044,1047,0,3,1
311,6,3,1050,1050,1053,0,3,3
312,1,1,1051,1053,1054,2,3,0
313,1,3,1052,1054,1057,2,5,0
314,3,1,1055,1057,1058,2,3,0
315,2,1,1057,1058,1059,1,2,0
316,3,1,1060,1060,1061,0,1,1
317,6,3,1066,1066,1069,0,3,5
318,3,1,1069,1069,1070,0,1,0
319,1,3,1070,1070,1073,0,3,0
320,6,2,1076,1076,1078,0,2,3
321,3,2,1079,1079,1081,0,2,1
322,6,1,1085,1085,1086,0,1,4
323,3,1,1088,1088,1089,0,1,2
324,4,1,1092,1092,1093,0,1,3
325,3,3,1095,1095,1098,0,3,2
326,1,2,1096,1098,1100,2,4,0
327,3,3,1099,1100,1103,1,4,0
328,1,2,1100,1103,1105,3,5,0
329,5,3,1105,1105,1108,0,3,0
330,6,3,1111,1111,1114,0,3,3
331,2,1,1113,1114,1115,1,2,0
332,3,2,1116,1116,1118,0,2,1
333,5,2,1121,1121,1123,0,2,3
334,5,3,1126,1126,1129,0,3,3
335,2,3,1128,1129,1132,1,4,0
336,3,1,1131,1132,1133,1,2,0
337,5,1,1136,1136,1137,0,1,3
338,6,3,1142,1142,1145,0,3,5
339,6,3,1148,1148,1151,0,3,3
340,6,3,1154,1154,1157,0,3,3
341,3,2,1157,1157,1159,0,2,0
342,4,3,1161,1161,1164,0,3,2
343,2,3,1163,1164,1167,1,4,0
344,5,1,1168,1168,1169,0,1,1
345,1,2,1169,1169,1171,0,2,0
346,4,3,1173,1173,1176,0,3,2
347,4,1,1177,1177,1178,0,1,1
348,3,2,1180,1180,1182,0,2,2
349,5,1,1185,1185,1186,0,1,3
350,3,3,1188,1188,1191,0,3,2
351,5,3,1193,1193,1196,0,3,2
352,6,2,1199,1199,1201,0,2,3
353,2,3,1201,1201,1204,0,3,0
354,5,3,1206,1206,1209,0,3,2
355,4,1,1210,1210,1211,0,1,1
356,3,2,1213,1213,1215,0,2,2
357,5,3,1218,1218,1221,0,3,3
358,5,2,1223,1223,1225,0,2,2
359,5,1,1228,1228,1229,0,1,3
360,1,1,1229,1229,1230,0,1,0
361,4,3,1233,1233,1236,0,3,3
362,1,3,1234,1236,1239,2,5,0
363,1,3,1235,1239,1242,4,7,0
364,4,2,1239,1242,1244,3,5,0
365,3,1,1242,1244,1245,2,3,0
366,6,2,1248,1248,1250,0,2,3
367,5,3,1253,1253,1256,0,3,3
368,2,1,1255,1256,1257,1,2,0
369,1,3,1256,1257,1260,1,4,0
370,4,1,1260,1260,1261,0,1,0
371,1,2,1261,1261,1263,0,2,0
372,2,3,1263,1263,1266,0,3,0
373,2,2,1265,1266,1268,1,3,0
374,1,2,1266,1268,1270,2,4,0
375,2,2,1268,1270,1272,2,4,0
376,5,2,1273,1273,1275,0,2,1
377,3,3,1276,1276,1279,0,3,1
378,1,2,1277,1279,1281,2,4,0
379,1,1,1278,1281,1282,3,4,0
380,2,3,1280,1282,1285,2,5,0
381,1,3,1281,1285,1288,4,7,0
382,4,3,1285,1288,1291,3,6,0
383,2,3,1287,1291,1294,4,7,0
384,3,3,1290,1294,1297,4,7,0
385,5,2,1295,1297,1299,2,4,0
386,5,3,1300,1300,1303,0,3,1
387,1,3,1301,1303,1306,2,5,0
388,6,1,1307,1307,1308,0,1,1
389,4,1,1311,1311,1312,0,1,3
390,2,3,1313,1313,1316,0,3,1
391,3,3,1316,1316,1319,0,3,0
392,2,1,1318,1319,1320,1,2,0
393,3,2,1321,1321,1323,0,2,1
394,1,2,1322,1323,1325,1,3,0
395,5,1,1327,1327,1328,0,1,2
396,3,1,1330,1330,1331,0,1,2
397,1,3,1331,1331,1334,0,3,0
398,4,1,1335,1335,1336,0,1,1
399,6,3,1341,1341,1344,0,3,5
400,1,3,1342,1344,1347,2,5,0
401,5,1,1347,1347,1348,0,1,0
402,3,3,1350,1350,1353,0,3,2
403,2,1,1352,1353,1354,1,2,0
404,5,2,1357,1357,1359,0,2,3
405,5,3,1362,1362,1365,0,3,3
406,1,2,1363,1365,1367,2,4,0
407,5,3,1368,1368,1371,0,3,1
408,2,3,1370,1371,1374,1,4,0
409,3,2,1373,1374,1376,1,3,0
410,1,3,1374,1376,1379,2,5,0
411,5,2,1379,1379,1381,0,2,0
412,2,1,1381,1381,1382,0,1,0
413,5,3,1386,1386,1389,0,3,4
414,4,2,1390,1390,1392,0,2,1
415,4,3,1394,1394,1397,0,3,2
416,3,3,1397,1397,1400,0,3,0
417,2,2,1399,1400,1402,1,3,0
418,2,1,1401,1402,1403,1,2,0
419,1,3,1402,1403,1406,1,4,0
420,2,1,1404,1406,1407,2,3,0
421,5,2,1409,1409,1411,0,2,2
422,1,3,1410,1411,1414,1,4,0
423,4,3,1414,1414,1417,0,3,0
424,4,3,1418,1418,1421,0,3,1
425,2,1,1420,1421,1422,1,2,0
426,5,3,1425,1425,1428,0,3,3
427,2,1,1427,1428,1429,1,2,0
428,1,1,1428,1429,1430,1,2,0
429,4,3,1432,1432,1435,0,3,2
430,3,1,1435,1435,1436,0,1,0
431,4,1,1439,1439,1440,0,1,3
432,1,1,1440,1440,1441,0,1,0
433,4,3,1444,1444,1447,0,3,3
434,2,3,1446,1447,1450,1,4,0
435,2,1,1448,1450,1451,2,3,0
436,4,2,1452,1452,1454,0,2,1
437,4,2,1456,1456,1458,0,2,2
438,5,3,1461,1461,1464,0,3,3
439,1,2,1462,1464,1466,2,4,0
440,6,3,1468,1468,1471,0,3,2
441,3,1,1471,1471,1472,0,1,0
442,5,1,1476,1476,1477,0,1,4
443,6,2,1482,1482,1484,0,2,5
444,1,2,1483,1484,1486,1,3,0
445,2,3,1485,1486,1489,1,4,0
446,4,3,1489,1489,1492,0,3,0
447,1,1,1490,1492,1493,2,3,0
448,2,2,1492,1493,1495,1,3,0
449,5,2,1497,1497,1499,0,2,2
450,3,1,1500,1500,1501,0,1,1
451,2,3,1502,1502,1505,0,3,1
452,3,1,1505,1505,1506,0,1,0
453,4,1,1509,1509,1510,0,1,3
454,1,3,1510,1510,1513,0,3,0
455,3,1,1513,1513,1514,0,1,0
456,3,2,1516,1516,1518,0,2,2
457,5,3,1521,1521,1524,0,3,3
458,4,3,1525,1525,1528,0,3,1
459,4,2,1529,1529,1531,0,2,1
460,6,2,1535,1535,1537,0,2,4
461,3,3,1538,1538,1541,0,3,1
462,3,1,1541,1541,1542,0,1,0
463,3,3,1544,1544,1547,0,3,2
464,1,1,1545,1547,1548,2,3,0
465,1,1,1546,1548,1549,2,3,0
466,4,1,1550,1550,1551,0,1,1
467,1,2,1551,1551,1553,0,2,0
468,1,3,1552,1553,1556,1,4,0
469,6,3,1558,1558,1561,0,3,2
470,1,3,1559,1561,1564,2,5,0
471,6,2,1565,1565,1567,0,2,1
472,2,3,1567,1567,1570,0,3,0
473,6,1,1573,1573,1574,0,1,3
474,3,1,1576,1576,1577,0,1,2
475,1,1,1577,1577,1578,0,1,0
476,2,2,1579,1579,1581,0,2,1
477,3,3,1582,1582,1585,0,3,1
478,6,3,1588,1588,1591,0,3,3
479,2,1,1590,1591,1592,1,2,0
480,4,1,1594,1594,1595,0,1,2
481,1,1,1595,1595,1596,0,1,0
482,4,1,1599,1599,1600,0,1,3
483,4,3,1603,1603,1606,0,3,3
484,2,2,1605,1606,1608,1,3,0
485,1,3,1606,1608,1611,2,5,0
486,1,2,1607,1611,1613,4,6,0
487,6,2,1613,1613,1615,0,2,0
488,3,2,1616,1616,1618,0,2,1
489,5,2,1621,1621,1623,0,2,3
490,2,1,1623,1623,1624,0,1,0
491,5,1,1628,1628,1629,0,1,4
492,2,2,1630,1630,1632,0,2,1
493,3,2,1633,1633,1635,0,2,1
494,3,1,1636,1636,1637,0,1,1
495,4,2,1640,1640,1642,0,2,3
496,6,2,1646,1646,1648,0,2,4
497,4,2,1650,1650,1652,0,2,2
498,2,1,1652,1652,1653,0,1,0
499,2,1,1654,1654,1655,0,1,1
500,4,1,1658,1658,1659,0,1,3
501,1,1,1659,1659,1660,0,1,0
502,3,3,1662,1662,1665,0,3,2
503,6,3,1668,1668,1671,0,3,3
504,6,3,1674,1674,1677,0,3,3
505,1,2,1675,1677,1679,2,4,0
506,6,3,1681,1681,1684,0,3,2
507,1,3,1682,1684,1687,2,5,0
508,2,3,1684,1687,1690,3,6,0
509,5,3,1689,1690,1693,1,4,0
510,6,3,1695,1695,1698,0,3,2
511,1,3,1696,1698,1701,2,5,0
512,3,2,1699,1701,1703,2,4,0
513,1,3,1700,1703,1706,3,6,0
514,4,2,1704,1706,1708,2,4,0
515,6,1,1710,1710,1711,0,1,2
516,2,1,1712,1712,1713,0,1,1
517,5,3,1717,1717,1720,0,3,4
518,3,3,1720,1720,1723,0,3,0
519,1,1,1721,1723,1724,2,3,0
520,6,1,1727,1727,1728,0,1,3
521,4,2,1731,1731,1733,0,2,3
522,5,1,1736,1736,1737,0,1,3
523,5,2,1741,1741,1743,0,2,4
524,4,3,1745,1745,1748,0,3,2
525,3,2,1748,1748,1750,0,2,0
526,1,2,1749,1750,1752,1,3,0
527,6,2,1755,1755,1757,0,2,3
528,1,1,1756,1757,1758,1,2,0
529,6,2,1762,1762,1764,0,2,4
530,2,2,1764,1764,1766,0,2,0
531,6,1,1770,1770,1771,0,1,4
532,2,1,1772,1772,1773,0,1,1
533,3,3,1775,1775,1778,0,3,2
534,1,3,1776,1778,1781,2,5,0
535,2,3,1778,1781,1784,3,6,0
536,1,2,1779,1784,1786,5,7,0
537,5,3,1784,1786,1789,2,5,0
538,4,2,1788,1789,1791,1,3,0
539,5,1,1793,1793,1794,0,1,2
540,2,3,1795,1795,1798,0,3,1
541,4,1,1799,1799,1800,0,1,1
542,6,2,1805,1805,1807,0,2,5
543,2,3,1807,1807,1810,0,3,0
544,2,3,1809,1810,1813,1,4,0
545,6,3,1815,1815,1818,0,3,2
546,4,3,1819,1819,1822,0,3,1
547,4,2,1823,1823,1825,0,2,1
548,5,2,1828,1828,1830,0,2,3
549,1,3,1829,1830,1833,1,4,0
550,4,1,1833,1833,1834,0,1,0
551,2,2,1835,1835,1837,0,2,1
552,6,2,1841,1841,1843,0,2,4
553,2,2,1843,1843,1845,0,2,0
554,6,2,1849,1849,1851,0,2,4
555,5,2,1854,1854,1856,0,2,3
556,1,3,1855,1856,1859,1,4,0
557,2,3,1857,1859,1862,2,5,0
558,1,2,1858,1862,1864,4,6,0
559,6,2,1864,1864,1866,0,2,0
560,3,3,1867,1867,1870,0,3,1
561,1,3,1868,1870,1873,2,5,0
562,3,1,1871,1873,1874,2,3,0
563,1,3,1872,1874,1877,2,5,0
564,2,2,1874,1877,1879,3,5,0
565,4,2,1878,1879,1881,1,3,0
566,4,3,1882,1882,1885,0,3,1
567,4,2,1886,1886,1888,0,2,1
568,5,2,1891,1891,1893,0,2,3
569,2,3,1893,1893,1896,0,3,0
570,6,1,1899,1899,1900,0,1,3
571,5,3,1904,1904,1907,0,3,4
572,6,1,1910,1910,1911,0,1,3
573,5,1,1915,1915,1916,0,1,4
574,6,1,1921,1921,1922,0,1,5
575,2,3,1923,1923,1926,0,3,1
576,2,3,1925,1926,1929,1,4,0
577,3,3,1928,1929,1932,1,4,0
578,2,1,1930,1932,1933,2,3,0
579,6,3,1936,1936,1939,0,3,3
580,4,2,1940,1940,1942,0,2,1
581,1,3,1941,1942,1945,1,4,0
582,4,3,1945,1945,1948,0,3,0
583,4,2,1949,1949,1951,0,2,1
584,1,2,1950,1951,1953,1,3,0
585,1,1,1951,1953,1954,2,3,0
586,2,1,1953,1954,1955,1,2,0
587,4,3,1957,1957,1960,0,3,2
588,3,1,1960,1960,1961,0,1,0
589,3,3,1963,1963,1966,0,3,2
590,6,1,1969,1969,1970,0,1,3
591,4,3,1973,1973,1976,0,3,3
592,2,1,1975,1976,1977,1,2,0
593,3,2,1978,1978,1980,0,2,1
594,5,3,1983,1983,1986,0,3,3
595,4,3,1987,1987,1990,0,3,1
596,5,3,1992,1992,1995,0,3,2
597,2,3,1994,1995,1998,1,4,0
598,6,1,2000,2000,2001,0,1,2
599,4,2,2004,2004,2006,0,2,3
600,4,1,2008,2008,2009,0,1,2
601,6,3,2014,2014,2017,0,3,5
602,3,3,2017,2017,2020,0,3,0
603,4,3,2021,2021,2024,0,3,1
604,1,2,2022,2024,2026,2,4,0
605,5,2,2027,2027,2029,0,2,1
606,2,1,2029,2029,2030,0,1,0
607,1,1,2030,2030,2031,0,1,0
608,1,3,2031,2031,2034,0,3,0
609,1,3,2032,2034,2037,2,5,0
610,4,3,2036,2037,2040,1,4,0
611,6,3,2042,2042,2045,0,3,2
612,1,2,2043,2045,2047,2,4,0
613,2,2,2045,2047,2049,2,4,0
614,4,3,2049,2049,2052,0,3,0
615,2,1,2051,2052,2053,1,2,0
616,3,3,2054,2054,2057,0,3,1
617,4,1,2058,2058,2059,0,1,1
618,4,3,2062,2062,2065,0,3,3
619,2,3,2064,2065,2068,1,4,0
620,3,1,2067,2068,2069,1,2,0
621,1,1,2068,2069,2070,1,2,0
622,3,2,2071,2071,2073,0,2,1
623,1,2,2072,2073,2075,1,3,0
624,1,1,2073,2075,2076,2,3,0
625,2,3,2075,2076,2079,1,4,0
626,4,1,2079,2079,2080,0,1,0
627,6,2,2085,2085,2087,0,2,5
628,3,3,2088,2088,2091,0,3,1
629,5,2,2093,2093,2095,0,2,2
630,3,2,2096,2096,2098,0,2,1
631,6,3,2102,2102,2105,0,3,4
632,1,1,2103,2105,2106,2,3,0
633,1,2,2104,2106,2108,2,4,0
634,2,2,2106,2108,2110,2,4,0
635,2,3,2108,2110,2113,2,5,0
636,4,3,2112,2113,2116,1,4,0
637,4,1,2116,2116,2117,0,1,0
638,2,3,2118,2118,2121,0,3,1
639,5,2,2123,2123,2125,0,2,2
640,4,2,2127,2127,2129,0,2,2
641,1,3,2128,2129,2132,1,4,0
642,6,3,2134,2134,2137,0,3,2
643,5,2,2139,2139,2141,0,2,2
644,1,2,2140,2141,2143,1,3,0
645,2,3,2142,2143,2146,1,4,0
646,3,2,2145,2146,2148,1,3,0
647,2,2,2147,2148,2150,1,3,0
648,2,1,2149,2150,2151,1,2,0
649,3,2,2152,2152,2154,0,2,1
650,4,1,2156,2156,2157,0,1,2
651,3,2,2159,2159,2161,0,2,2
652,3,3,2162,2162,2165,0,3,1
653,2,1,2164,2165,2166,1,2,0
654,5,3,2169,2169,2172,0,3,3
655,6,2,2175,2175,2177,0,2,3
656,3,3,2178,2178,2181,0,3,1
657,2,3,2180,2181,2184,1,4,0
658,6,2,2186,2186,2188,0,2,2
659,5,2,2191,2191,2193,0,2,3
660,6,3,2197,2197,2200,0,3,4
661,5,3,2202,2202,2205,0,3,2
662,6,2,2208,2208,2210,0,2,3
663,4,3,2212,2212,2215,0,3,2
664,5,1,2217,2217,2218,0,1,2
665,5,1,2222,2222,2223,0,1,4
666,2,2,2224,2224,2226,0,2,1
667,3,3,2227,2227,2230,0,3,1
668,1,1,2228,2230,2231,2,3,0
669,2,3,2230,2231,2234,1,4,0
670,5,1,2235,2235,2236,0,1,1
671,5,3,2240,2240,2243,0,3,4
672,3,1,2243,2243,2244,0,1,0
673,2,3,2245,2245,2248,0,3,1
674,1,3,2246,2248,2251,2,5,0
675,6,3,2252,2252,2255,0,3,1
676,1,2,2253,2255,2257,2,4,0
677,4,2,2257,2257,2259,0,2,0
678,2,1,2259,2259,2260,0,1,0
679,1,1,2260,2260,2261,0,1,0
680,1,1,2261,2261,2262,0,1,0
681,2,1,2263,2263,2264,0,1,1
682,6,3,2269,2269,2272,0,3,5
683,5,1,2274,2274,2275,0,1,2
684,5,3,2279,2279,2282,0,3,4
685,5,1,2284,2284,2285,0,1,2
686,2,3,2286,2286,2289,0,3,1
687,3,3,2289,2289,2292,0,3,0
688,6,1,2295,2295,2296,0,1,3
689,2,3,2297,2297,2300,0,3,1
690,2,3,2299,2300,2303,1,4,0
691,5,2,2304,2304,2306,0,2,1
692,6,2,2310,2310,2312,0,2,4
693,6,2,2316,2316,2318,0,2,4
694,5,3,2321,2321,2324,0,3,3
695,1,3,2322,2324,2327,2,5,0
696,3,2,2325,2327,2329,2,4,0
697,6,2,2331,2331,2333,0,2,2
698,6,1,2337,2337,2338,0,1,4
699,5,3,2342,2342,2345,0,3,4
700,1,1,2343,2345,2346,2,3,0
701,5,3,2348,2348,2351,0,3,2
702,5,2,2353,2353,2355,0,2,2
703,6,3,2359,2359,2362,0,3,4
704,1,3,2360,2362,2365,2,5,0
705,1,1,2361,2365,2366,4,5,0
706,2,2,2363,2366,2368,3,5,0
707,4,3,2367,2368,2371,1,4,0
708,2,2,2369,2371,2373,2,4,0
709,6,1,2375,2375,2376,0,1,2
710,4,1,2379,2379,2380,0,1,3
711,4,2,2383,2383,2385,0,2,3
712,4,1,2387,2387,2388,0,1,2
713,4,3,2391,2391,2394,0,3,3
714,3,1,2394,2394,2395,0,1,0
715,6,2,2400,2400,2402,0,2,5
716,3,2,2403,2403,2405,0,2,1
717,1,3,2404,2405,2408,1,4,0
718,4,3,2408,2408,2411,0,3,0
719,1,2,2409,2411,2413,2,4,0
720,3,1,2412,2413,2414,1,2,0
721,3,1,2415,2415,2416,0,1,1
722,4,3,2419,2419,2422,0,3,3
723,3,2,2422,2422,2424,0,2,0
724,6,2,2428,2428,2430,0,2,4
725,1,3,2429,2430,2433,1,4,0
726,1,1,2430,2433,2434,3,4,0
727,1,3,2431,2434,2437,3,6,0
728,5,2,2436,2437,2439,1,3,0
729,4,3,2440,2440,2443,0,3,1
730,5,3,2445,2445,2448,0,3,2
731,3,3,2448,2448,2451,0,3,0
732,6,1,2454,2454,2455,0,1,3
733,1,3,2455,2455,2458,0,3,0
734,4,2,2459,2459,2461,0,2,1
735,3,3,2462,2462,2465,0,3,1
736,5,3,2467,2467,2470,0,3,2
737,5,2,2472,2472,2474,0,2,2
738,4,2,2476,2476,2478,0,2,2
739,4,3,2480,2480,2483,0,3,2
740,6,1,2486,2486,2487,0,1,3
741,4,3,2490,2490,2493,0,3,3
742,3,2,2493,2493,2495,0,2,0
743,5,2,2498,2498,2500,0,2,3
744,6,1,2504,2504,2505,0,1,4
745,2,1,2506,2506,2507,0,1,1
746,5,1,2511,2511,2512,0,1,4
747,5,3,2516,2516,2519,0,3,4
748,5,1,2521,2521,2522,0,1,2
749,3,2,2524,2524,2526,0,2,2
750,4,3,2528,2528,2531,0,3,2
751,5,2,2533,2533,2535,0,2,2
752,4,2,2537,2537,2539,0,2,2
753,1,2,2538,2539,2541,1,3,0
754,4,2,2542,2542,2544,0,2,1
755,6,2,2548,2548,2550,0,2,4
756,1,3,2549,2550,2553,1,4,0
757,1,3,2550,2553,2556,3,6,0
758,6,2,2556,2556,2558,0,2,0
759,2,1,2558,2558,2559,0,1,0
760,5,3,2563,2563,2566,0,3,4
761,2,2,2565,2566,2568,1,3,0
762,1,2,2566,2568,2570,2,4,0
763,1,2,2567,2570,2572,3,5,0
764,5,2,2572,2572,2574,0,2,0
765,2,3,2574,2574,2577,0,3,0
766,5,3,2579,2579,2582,0,3,2
767,1,3,2580,2582,2585,2,5,0
768,2,1,2582,2585,2586,3,4,0
769,3,2,2585,2586,2588,1,3,0
770,5,2,2590,2590,2592,0,2,2
771,5,3,2595,2595,2598,0,3,3
772,5,1,2600,2600,2601,0,1,2
773,6,2,2606,2606,2608,0,2,5
774,2,3,2608,2608,2611,0,3,0
775,5,1,2613,2613,2614,0,1,2
776,4,1,2617,2617,2618,0,1,3
777,2,1,2619,2619,2620,0,1,1
778,4,2,2623,2623,2625,0,2,3
779,4,3,2627,2627,2630,0,3,2
780,6,1,2633,2633,2634,0,1,3
781,6,3,2639,2639,2642,0,3,5
782,1,3,2640,2642,2645,2,5,0
783,3,1,2643,2645,2646,2,3,0
784,2,1,2645,2646,2647,1,2,0
785,6,2,2651,2651,2653,0,2,4
786,2,1,2653,2653,2654,0,1,0
787,5,1,2658,2658,2659,0,1,4
788,1,1,2659,2659,2660,0,1,0
789,6,2,2665,2665,2667,0,2,5
790,3,2,2668,2668,2670,0,2,1
791,6,3,2674,2674,2677,0,3,4
792,3,1,2677,2677,2678,0,1,0
793,6,3,2683,2683,2686,0,3,5
794,2,3,2685,2686,2689,1,4,0
795,2,3,2687,2689,2692,2,5,0
796,5,2,2692,2692,2694,0,2,0
797,3,1,2695,2695,2696,0,1,1
798,4,2,2699,2699,2701,0,2,3
799,4,2,2703,2703,2705,0,2,2
800,4,2,2707,2707,2709,0,2,2
801,2,2,2709,2709,2711,0,2,0
802,6,1,2715,2715,2716,0,1,4
803,1,3,2716,2716,2719,0,3,0
804,3,3,2719,2719,2722,0,3,0
805,6,1,2725,2725,2726,0,1,3
806,2,1,2727,2727,2728,0,1,1
807,2,1,2729,2729,2730,0,1,1
808,6,2,2735,2735,2737,0,2,5
809,1,3,2736,2737,2740,1,4,0
810,4,1,2740,2740,2741,0,1,0
811,1,2,2741,2741,2743,0,2,0
812,1,3,2742,2743,2746,1,4,0
813,2,1,2744,2746,2747,2,3,0
814,6,1,2750,2750,2751,0,1,3
815,5,1,2755,2755,2756,0,1,4
816,1,1,2756,2756,2757,0,1,0
817,4,2,2760,2760,2762,0,2,3
818,1,3,2761,2762,2765,1,4,0
819,5,3,2766,2766,2769,0,3,1
820,1,2,2767,2769,2771,2,4,0
821,5,1,2772,2772,2773,0,1,1
822,3,2,2775,2775,2777,0,2,2
823,1,1,2776,2777,2778,1,2,0
824,5,2,2781,2781,2783,0,2,3
825,6,1,2787,2787,2788,0,1,4
826,1,2,2788,2788,2790,0,2,0
827,2,1,2790,2790,2791,0,1,0
828,3,1,2793,2793,2794,0,1,2
829,2,2,2795,2795,2797,0,2,1
830,4,2,2799,2799,2801,0,2,2
831,6,2,2805,2805,2807,0,2,4
832,1,3,2806,2807,2810,1,4,0
833,3,3,2809,2810,2813,1,4,0
834,5,1,2814,2814,2815,0,1,1
835,5,3,2819,2819,2822,0,3,4
836,1,1,2820,2822,2823,2,3,0
837,6,3,2826,2826,2829,0,3,3
838,5,2,2831,2831,2833,0,2,2
839,2,2,2833,2833,2835,0,2,0
840,4,2,2837,2837,2839,0,2,2
841,1,3,2838,2839,2842,1,4,0
842,6,1,2844,2844,2845,0,1,2
843,5,3,2849,2849,2852,0,3,4
844,2,1,2851,2852,2853,1,2,0
845,2,3,2853,2853,2856,0,3,0
846,3,1,2856,2856,2857,0,1,0
847,1,1,2857,2857,2858,0,1,0
848,2,2,2859,2859,2861,0,2,1
849,2,1,2861,2861,2862,0,1,0
850,4,1,2865,2865,2866,0,1,3
851,3,3,2868,2868,2871,0,3,2
852,2,2,2870,2871,2873,1,3,0
853,5,1,2875,2875,2876,0,1,2
854,6,3,2881,2881,2884,0,3,5
855,2,3,2883,2884,2887,1,4,0
856,3,1,2886,2887,2888,1,2,0
857,2,2,2888,2888,2890,0,2,0
858,4,2,2892,2892,2894,0,2,2
859,6,2,2898,2898,2900,0,2,4
860,5,1,2903,2903,2904,0,1,3
861,6,1,2909,2909,2910,0,1,5
862,5,2,2914,2914,2916,0,2,4
863,1,3,2915,2916,2919,1,4,0
864,1,3,2916,2919,2922,3,6,0
865,1,3,2917,2922,2925,5,8,0
866,1,1,2918,2925,2926,7,8,0
867,1,2,2919,2926,2928,7,9,0
868,3,3,2922,2928,2931,6,9,0
869,6,2,2928,2931,2933,3,5,0
870,1,1,2929,2933,2934,4,5,0
871,1,2,2930,2934,2936,4,6,0
872,5,1,2935,2936,2937,1,2,0
873,1,3,2936,2937,2940,1,4,0
874,1,1,2937,2940,2941,3,4,0
875,2,3,2939,2941,2944,2,5,0
876,1,1,2940,2944,2945,4,5,0
877,1,2,2941,2945,2947,4,6,0
878,6,1,2947,2947,2948,0,1,0
879,1,1,2948,2948,2949,0,1,0
880,6,1,2954,2954,2955,0,1,5
881,2,1,2956,2956,2957,0,1,1
882,6,3,2962,2962,2965,0,3,5
883,2,3,2964,2965,2968,1,4,0
884,3,1,2967,2968,2969,1,2,0
885,5,1,2972,2972,2973,0,1,3
886,5,2,2977,2977,2979,0,2,4
887,4,1,2981,2981,2982,0,1,2
888,1,3,2982,2982,2985,0,3,0
889,1,2,2983,2985,2987,2,4,0
890,1,2,2984,2987,2989,3,5,0
891,5,1,2989,2989,2990,0,1,0
892,3,3,2992,2992,2995,0,3,2
893,5,2,2997,2997,2999,0,2,2
894,6,1,3003,3003,3004,0,1,4
895,6,1,3009,3009,3010,0,1,5
896,5,2,3014,3014,3016,0,2,4
897,4,2,3018,3018,3020,0,2,2
898,3,1,3021,3021,3022,0,1,1
899,4,2,3025,3025,3027,0,2,3
900,2,2,3027,3027,3029,0,2,0
901,6,2,3033,3033,3035,0,2,4
902,4,2,3037,3037,3039,0,2,2
903,4,2,3041,3041,3043,0,2,2
904,4,1,3045,3045,3046,0,1,2
905,4,1,3049,3049,3050,0,1,3
906,2,1,3051,3051,3052,0,1,1
907,5,3,3056,3056,3059,0,3,4
908,4,3,3060,3060,3063,0,3,1
909,6,1,3066,3066,3067,0,1,3
910,6,3,3072,3072,3075,0,3,5
911,5,3,3077,3077,3080,0,3,2
912,4,1,3081,3081,3082,0,1,1
913,6,3,3087,3087,3090,0,3,5
914,6,3,3093,3093,3096,0,3,3
915,2,2,3095,3096,3098,1,3,0
916,6,1,3101,3101,3102,0,1,3
917,3,2,3104,3104,3106,0,2,2
918,4,2,3108,3108,3110,0,2,2
919,6,3,3114,3114,3117,0,3,4
920,4,1,3118,3118,3119,0,1,1
921,6,1,3124,3124,3125,0,1,5
922,3,1,3127,3127,3128,0,1,2
923,5,3,3132,3132,3135,0,3,4
924,5,2,3137,3137,3139,0,2,2
925,6,2,3143,3143,3145,0,2,4
926,4,3,3147,3147,3150,0,3,2
927,6,1,3153,3153,3154,0,1,3
928,2,1,3155,3155,3156,0,1,1
929,5,2,3160,3160,3162,0,2,4
930,5,3,3165,3165,3168,0,3,3
931,6,1,3171,3171,3172,0,1,3
932,5,3,3176,3176,3179,0,3,4
933,6,2,3182,3182,3184,0,2,3
934,4,2,3186,3186,3188,0,2,2
935,2,3,3188,3188,3191,0,3,0
936,3,2,3191,3191,3193,0,2,0
937,3,1,3194,3194,3195,0,1,1
938,3,3,3197,3197,3200,0,3,2
939,4,2,3201,3201,3203,0,2,1
940,4,3,3205,3205,3208,0,3,2
941,6,3,3211,3211,3214,0,3,3
942,2,3,3213,3214,3217,1,4,0
943,4,2,3217,3217,3219,0,2,0
944,6,3,3223,3223,3226,0,3,4
945,2,3,3225,3226,3229,1,4,0
946,1,2,3226,3229,3231,3,5,0
947,4,3,3230,3231,3234,1,4,0
948,6,1,3236,3236,3237,0,1,2
949,4,3,3240,3240,3243,0,3,3
950,6,3,3246,3246,3249,0,3,3
951,2,1,3248,3249,3250,1,2,0
952,4,2,3252,3252,3254,0,2,2
953,4,2,3256,3256,3258,0,2,2
954,4,3,3260,3260,3263,0,3,2
955,1,3,3261,3263,3266,2,5,0
956,4,3,3265,3266,3269,1,4,0
957,5,2,3270,3270,3272,0,2,1
958,2,1,3272,3272,3273,0,1,0
959,2,3,3274,3274,3277,0,3,1
960,4,1,3278,3278,3279,0,1,1
961,1,1,3279,3279,3280,0,1,0
962,1,2,3280,3280,3282,0,2,0
963,2,2,3282,3282,3284,0,2,0
964,2,1,3284,3284,3285,0,1,0
965,1,2,3285,3285,3287,0,2,0
966,1,3,3286,3287,3290,1,4,0
967,5,2,3291,3291,3293,0,2,1
968,5,3,3296,3296,3299,0,3,3
969,1,1,3297,3299,3300,2,3,0
970,5,3,3302,3302,3305,0,3,2
971,2,2,3304,3305,3307,1,3,0
972,5,3,3309,3309,3312,0,3,2
973,1,3,3310,3312,3315,2,5,0
974,4,3,3314,3315,3318,1,4,0
975,1,1,3315,3318,3319,3,4,0
976,5,2,3320,3320,3322,0,2,1
977,2,2,3322,3322,3324,0,2,0
978,1,2,3323,3324,3326,1,3,0
979,3,3,3326,3326,3329,0,3,0
980,5,2,3331,3331,3333,0,2,2
981,3,3,3334,3334,3337,0,3,1
982,6,3,3340,3340,3343,0,3,3
983,3,1,3343,3343,3344,0,1,0
984,5,1,3348,3348,3349,0,1,4
985,3,1,3351,3351,3352,0,1,2
986,2,2,3353,3353,3355,0,2,1
987,1,3,3354,3355,3358,1,4,0
988,2,1,3356,3358,3359,2,3,0
989,4,2,3360,3360,3362,0,2,1
990,3,1,3363,3363,3364,0,1,1
991,4,2,3367,3367,3369,0,2,3
992,4,2,3371,3371,3373,0,2,2
993,5,1,3376,3376,3377,0,1,3
994,2,3,3378,3378,3381,0,3,1
995,4,1,3382,3382,3383,0,1,1
996,2,3,3384,3384,3387,0,3,1
997,3,3,3387,3387,3390,0,3,0
998,5,3,3392,3392,3395,0,3,2
999,2,3,3394,3395,3398,1,4,0
1000,1,3,3395,3398,3401,3,6,0
1001,5,1,3400,3401,3402,1,2,0
1002,5,2,3405,3405,3407,0,2,3
1003,1,3,3406,3407,3410,1,4,0
1004,1,3,3407,3410,3413,3,6,0
1005,5,2,3412,3413,3415,1,3,0
1006,2,1,3414,3415,3416,1,2,0
1007,5,2,3419,3419,3421,0,2,3
1008,3,2,3422,3422,3424,0,2,1
1009,6,2,3428,3428,3430,0,2,4
1010,4,3,3432,3432,3435,0,3,2
1011,1,1,3433,3435,3436,2,3,0
1012,6,2,3439,3439,3441,0,2,3
1013,4,1,3443,3443,3444,0,1,2
1014,1,3,3444,3444,3447,0,3,0
1015,3,2,3447,3447,3449,0,2,0
1016,2,3,3449,3449,3452,0,3,0
1017,1,1,3450,3452,3453,2,3,0
1018,6,1,3456,3456,3457,0,1,3
1019,1,3,3457,3457,3460,0,3,0
1020,1,2,3458,3460,3462,2,4,0
1021,6,2,3464,3464,3466,0,2,2
1022,3,2,3467,3467,3469,0,2,1
1023,3,1,3470,3470,3471,0,1,1
1024,5,1,3475,3475,3476,0,1,4
1025,6,1,3481,3481,3482,0,1,5
1026,1,1,3482,3482,3483,0,1,0
1027,6,2,3488,3488,3490,0,2,5
1028,4,1,3492,3492,3493,0,1,2
1029,2,2,3494,3494,3496,0,2,1
1030,5,1,3499,3499,3500,0,1,3
1031,2,3,3501,3501,3504,0,3,1
1032,6,3,3507,3507,3510,0,3,3
1033,5,2,3512,3512,3514,0,2,2
1034,4,1,3516,3516,3517,0,1,2
1035,6,3,3522,3522,3525,0,3,5
1036,5,1,3527,3527,3528,0,1,2
1037,3,2,3530,3530,3532,0,2,2
1038,1,2,3531,3532,3534,1,3,0
1039,1,2,3532,3534,3536,2,4,0
1040,4,1,3536,3536,3537,0,1,0
1041,1,3,3537,3537,3540,0,3,0
1042,5,2,3542,3542,3544,0,2,2
1043,3,2,3545,3545,3547,0,2,1
1044,5,2,3550,3550,3552,0,2,3
1045,6,3,3556,3556,3559,0,3,4
1046,4,2,3560,3560,3562,0,2,1
1047,1,1,3561,3562,3563,1,2,0
1048,6,2,3567,3567,3569,0,2,4
1049,1,2,3568,3569,3571,1,3,0
1050,3,3,3571,3571,3574,0,3,0
1051,4,2,3575,3575,3577,0,2,1
1052,3,2,3578,3578,3580,0,2,1
1053,3,3,3581,3581,3584,0,3,1
1054,1,1,3582,3584,3585,2,3,0
1055,5,2,3587,3587,3589,0,2,2
1056,3,1,3590,3590,3591,0,1,1
1057,1,2,3591,3591,3593,0,2,0
1058,1,2,3592,3593,3595,1,3,0
1059,5,2,3597,3597,3599,0,2,2
1060,5,2,3602,3602,3604,0,2,3
1061,1,2,3603,3604,3606,1,3,0
1062,3,1,3606,3606,3607,0,1,0
1063,3,2,3609,3609,3611,0,2,2
1064,4,1,3613,3613,3614,0,1,2
1065,5,1,3618,3618,3619,0,1,4
1066,3,1,3621,3621,3622,0,1,2
1067,4,2,3625,3625,3627,0,2,3
1068,1,2,3626,3627,3629,1,3,0
1069,5,3,3631,3631,3634,0,3,2
1070,2,1,3633,3634,3635,1,2,0
1071,3,3,3636,3636,3639,0,3,1
1072,5,2,3641,3641,3643,0,2,2
1073,1,2,3642,3643,3645,1,3,0
1074,4,2,3646,3646,3648,0,2,1
1075,4,2,3650,3650,3652,0,2,2
1076,1,1,3651,3652,3653,1,2,0
1077,5,3,3656,3656,3659,0,3,3
1078,2,1,3658,3659,3660,1,2,0
1079,3,3,3661,3661,3664,0,3,1
1080,6,3,3667,3667,3670,0,3,3
1081,1,1,3668,3670,3671,2,3,0
1082,6,2,3674,3674,3676,0,2,3
1083,5,3,3679,3679,3682,0,3,3
1084,4,2,3683,3683,3685,0,2,1
1085,3,1,3686,3686,3687,0,1,1
1086,6,3,3692,3692,3695,0,3,5
1087,6,1,3698,3698,3699,0,1,3
1088,6,2,3704,3704,3706,0,2,5
1089,5,2,3709,3709,3711,0,2,3
1090,6,2,3715,3715,3717,0,2,4
1091,2,3,3717,3717,3720,0,3,0
1092,3,3,3720,3720,3723,0,3,0
1093,5,2,3725,3725,3727,0,2,2
1094,3,1,3728,3728,3729,0,1,1
1095,2,1,3730,3730,3731,0,1,1
1096,1,3,3731,3731,3734,0,3,0
1097,6,1,3737,3737,3738,0,1,3
1098,3,1,3740,3740,3741,0,1,2
1099,6,3,3746,3746,3749,0,3,5
1100,4,3,3750,3750,3753,0,3,1
1101,1,1,3751,3753,3754,2,3,0
1102,4,3,3755,3755,3758,0,3,1
1103,4,3,3759,3759,3762,0,3,1
1104,4,3,3763,3763,3766,0,3,1
1105,1,2,3764,3766,3768,2,4,0
1106,3,3,3767,3768,3771,1,4,0
1107,3,3,3770,3771,3774,1,4,0
1108,6,3,3776,3776,3779,0,3,2
1109,5,2,3781,3781,3783,0,2,2
1110,4,2,3785,3785,3787,0,2,2
1111,1,3,3786,3787,3790,1,4,0
1112,6,2,3792,3792,3794,0,2,2
1113,3,1,3795,3795,3796,0,1,1
1114,2,3,3797,3797,3800,0,3,1
1115,1,1,3798,3800,3801,2,3,0
1116,6,2,3804,3804,3806,0,2,3
1117,6,1,3810,3810,3811,0,1,4
1118,1,2,3811,3811,3813,0,2,0
1119,4,2,3815,3815,3817,0,2,2
1120,3,1,3818,3818,3819,0,1,1
1121,6,3,3824,3824,3827,0,3,5
1122,2,1,3826,3827,3828,1,2,0
1123,1,1,3827,3828,3829,1,2,0
1124,2,3,3829,3829,3832,0,3,0
1125,3,1,3832,3832,3833,0,1,0
1126,2,2,3834,3834,3836,0,2,1
1127,6,1,3840,3840,3841,0,1,4
1128,2,2,3842,3842,3844,0,2,1
1129,5,1,3847,3847,3848,0,1,3
1130,6,3,3853,3853,3856,0,3,5
1131,4,2,3857,3857,3859,0,2,1
1132,4,3,3861,3861,3864,0,3,2
1133,6,2,3867,3867,3869,0,2,3
1134,2,2,3869,3869,3871,0,2,0
1135,4,3,3873,3873,3876,0,3,2
1136,6,1,3879,3879,3880,0,1,3
1137,2,3,3881,3881,3884,0,3,1
1138,3,1,3884,3884,3885,0,1,0
1139,6,1,3890,3890,3891,0,1,5
1140,5,3,3895,3895,3898,0,3,4
1141,5,2,3900,3900,3902,0,2,2
1142,3,3,3903,3903,3906,0,3,1
1143,6,3,3909,3909,3912,0,3,3
1144,5,3,3914,3914,3917,0,3,2
1145,3,3,3917,3917,3920,0,3,0
1146,1,3,3918,3920,3923,2,5,0
1147,3,2,3921,3923,3925,2,4,0
1148,6,2,3927,3927,3929,0,2,2
1149,6,2,3933,3933,3935,0,2,4
1150,6,2,3939,3939,3941,0,2,4
1151,3,1,3942,3942,3943,0,1,1
1152,5,3,3947,3947,3950,0,3,4
1153,5,1,3952,3952,3953,0,1,2
1154,6,3,3958,3958,3961,0,3,5
1155,1,2,3959,3961,3963,2,4,0
1156,6,3,3965,3965,3968,0,3,2
1157,3,2,3968,3968,3970,0,2,0
1158,1,1,3969,3970,3971,1,2,0
1159,1,3,3970,3971,3974,1,4,0
1160,1,2,3971,3974,3976,3,5,0
1161,4,2,3975,3976,3978,1,3,0
1162,5,1,3980,3980,3981,0,1,2
1163,6,1,3986,3986,3987,0,1,5
1164,1,1,3987,3987,3988,0,1,0
1165,5,2,3992,3992,3994,0,2,4
1166,3,2,3995,3995,3997,0,2,1
1167,2,1,3997,3997,3998,0,1,0
1168,3,1,4000,4000,4001,0,1,2
1169,1,3,4001,4001,4004,0,3,0
1170,2,3,4003,4004,4007,1,4,0
1171,5,2,4008,4008,4010,0,2,1
1172,3,3,4011,4011,4014,0,3,1
1173,5,3,4016,4016,4019,0,3,2
1174,2,3,4018,4019,4022,1,4,0
1175,2,1,4020,4022,4023,2,3,0
1176,3,3,4023,4023,4026,0,3,0
1177,4,1,4027,4027,4028,0,1,1
1178,1,2,4028,4028,4030,0,2,0
1179,2,1,4030,4030,4031,0,1,0
1180,5,1,4035,4035,4036,0,1,4
1181,2,1,4037,4037,4038,0,1,1
1182,2,2,4039,4039,4041,0,2,1
1183,5,3,4044,4044,4047,0,3,3
1184,1,3,4045,4047,4050,2,5,0
1185,4,3,4049,4050,4053,1,4,0
1186,2,1,4051,4053,4054,2,3,0
1187,6,3,4057,4057,4060,0,3,3
1188,1,1,4058,4060,4061,2,3,0
1189,3,3,4061,4061,4064,0,3,0
1190,3,3,4064,4064,4067,0,3,0
1191,1,2,4065,4067,4069,2,4,0
1192,2,1,4067,4069,4070,2,3,0
1193,3,2,4070,4070,4072,0,2,0
1194,2,1,4072,4072,4073,0,1,0
1195,6,2,4078,4078,4080,0,2,5
1196,6,3,4084,4084,4087,0,3,4
1197,4,1,4088,4088,4089,0,1,1
1198,2,3,4090,4090,4093,0,3,1
1199,1,3,4091,4093,4096,2,5,0
1200,6,1,4097,4097,4098,0,1,1
1201,4,1,4101,4101,4102,0,1,3
1202,6,1,4107,4107,4108,0,1,5
1203,3,1,4110,4110,4111,0,1,2
1204,2,2,4112,4112,4114,0,2,1
1205,2,2,4114,4114,4116,0,2,0
1206,1,2,4115,4116,4118,1,3,0
1207,3,3,4118,4118,4121,0,3,0
1208,5,1,4123,4123,4124,0,1,2
1209,5,2,4128,4128,4130,0,2,4
1210,4,2,4132,4132,4134,0,2,2
1211,5,1,4137,4137,4138,0,1,3
1212,6,1,4143,4143,4144,0,1,5
1213,1,3,4144,4144,4147,0,3,0
1214,4,2,4148,4148,4150,0,2,1
1215,2,2,4150,4150,4152,0,2,0
1216,5,3,4155,4155,4158,0,3,3
1217,6,3,4161,4161,4164,0,3,3
1218,6,2,4167,4167,4169,0,2,3
1219,6,1,4173,4173,4174,0,1,4
1220,3,3,4176,4176,4179,0,3,2
1221,5,3,4181,4181,4184,0,3,2
1222,2,3,4183,4184,4187,1,4,0
1223,6,1,4189,4189,4190,0,1,2
1224,3,3,4192,4192,4195,0,3,2
1225,4,3,4196,4196,4199,0,3,1
1226,6,2,4202,4202,4204,0,2,3
1227,4,2,4206,4206,4208,0,2,2
1228,5,2,4211,4211,4213,0,2,3
1229,4,1,4215,4215,4216,0,1,2
1230,5,1,4220,4220,4221,0,1,4
1231,1,1,4221,4221,4222,0,1,0
1232,5,3,4226,4226,4229,0,3,4
1233,2,3,4228,4229,4232,1,4,0
1234,2,1,4230,4232,4233,2,3,0
1235,4,2,4234,4234,4236,0,2,1
1236,3,3,4237,4237,4240,0,3,1
1237,6,3,4243,4243,4246,0,3,3
1238,5,3,4248,4248,4251,0,3,2
1239,4,3,4252,4252,4255,0,3,1
1240,1,3,4253,4255,4258,2,5,0
1241,5,2,4258,4258,4260,0,2,0
1242,1,3,4259,4260,4263,1,4,0
1243,6,3,4265,4265,4268,0,3,2
1244,5,3,4270,4270,4273,0,3,2
1245,6,3,4276,4276,4279,0,3,3
1246,6,1,4282,4282,4283,0,1,3
1247,6,1,4288,4288,4289,0,1,5
1248,1,1,4289,4289,4290,0,1,0
1249,4,1,4293,4293,4294,0,1,3
1250,4,2,4297,4297,4299,0,2,3
1251,6,1,4303,4303,4304,0,1,4
1252,4,3,4307,4307,4310,0,3,3
1253,6,3,4313,4313,4316,0,3,3
1254,5,3,4318,4318,4321,0,3,2
1255,2,2,4320,4321,4323,1,3,0
1256,4,3,4324,4324,4327,0,3,1
1257,1,3,4325,4327,4330,2,5,0
1258,2,3,4327,4330,4333,3,6,0
1259,2,3,4329,4333,4336,4,7,0
1260,6,2,4335,4336,4338,1,3,0
1261,4,2,4339,4339,4341,0,2,1
1262,5,2,4344,4344,4346,0,2,3
1263,3,1,4347,4347,4348,0,1,1
1264,6,3,4353,4353,4356,0,3,5
1265,3,1,4356,4356,4357,0,1,0
1266,5,1,4361,4361,4362,0,1,4
1267,3,2,4364,4364,4366,0,2,2
1268,5,3,4369,4369,4372,0,3,3
1269,4,1,4373,4373,4374,0,1,1
1270,1,2,4374,4374,4376,0,2,0
1271,5,2,4379,4379,4381,0,2,3
1272,1,1,4380,4381,4382,1,2,0
1273,2,1,4382,4382,4383,0,1,0
1274,5,1,4387,4387,4388,0,1,4
1275,5,1,4392,4392,4393,0,1,4
1276,5,3,4397,4397,4400,0,3,4
1277,6,1,4403,4403,4404,0,1,3
1278,4,3,4407,4407,4410,0,3,3
1279,5,1,4412,4412,4413,0,1,2
1280,2,1,4414,4414,4415,0,1,1
1281,1,1,4415,4415,4416,0,1,0
1282,5,1,4420,4420,4421,0,1,4
1283,5,2,4425,4425,4427,0,2,4
1284,6,1,4431,4431,4432,0,1,4
1285,4,3,4435,4435,4438,0,3,3
1286,4,2,4439,4439,4441,0,2,1
1287,6,3,4445,4445,4448,0,3,4
1288,3,1,4448,4448,4449,0,1,0
1289,6,2,4454,4454,4456,0,2,5
1290,3,1,4457,4457,4458,0,1,1
1291,4,1,4461,4461,4462,0,1,3
1292,5,2,4466,4466,4468,0,2,4
1293,5,3,4471,4471,4474,0,3,3
1294,6,2,4477,4477,4479,0,2,3
1295,5,1,4482,4482,4483,0,1,3
1296,6,2,4488,4488,4490,0,2,5
1297,1,3,4489,4490,4493,1,4,0
1298,3,3,4492,4493,4496,1,4,0
1299,5,1,4497,4497,4498,0,1,1
1300,2,1,4499,4499,4500,0,1,1
1301,6,3,4505,4505,4508,0,3,5
1302,4,1,4509,4509,4510,0,1,1
1303,4,3,4513,4513,4516,0,3,3
1304,2,1,4515,4516,4517,1,2,0
1305,4,3,4519,4519,4522,0,3,2
1306,4,3,4523,4523,4526,0,3,1
1307,4,1,4527,4527,4528,0,1,1
1308,5,3,4532,4532,4535,0,3,4
1309,1,1,4533,4535,4536,2,3,0
1310,2,2,4535,4536,4538,1,3,0
1311,5,2,4540,4540,4542,0,2,2
1312,3,2,4543,4543,4545,0,2,1
1313,1,2,4544,4545,4547,1,3,0
1314,6,3,4550,4550,4553,0,3,3
1315,1,2,4551,4553,4555,2,4,0
1316,1,2,4552,4555,4557,3,5,0
1317,4,3,4556,4557,4560,1,4,0
1318,5,1,4561,4561,4562,0,1,1
1319,1,2,4562,4562,4564,0,2,0
1320,6,3,4568,4568,4571,0,3,4
1321,2,1,4570,4571,4572,1,2,0
1322,5,3,4575,4575,4578,0,3,3
1323,1,3,4576,4578,4581,2,5,0
1324,5,1,4581,4581,4582,0,1,0
1325,6,1,4587,4587,4588,0,1,5
1326,6,1,4593,4593,4594,0,1,5
1327,5,3,4598,4598,4601,0,3,4
1328,3,1,4601,4601,4602,0,1,0
1329,3,2,4604,4604,4606,0,2,2
1330,1,2,4605,4606,4608,1,3,0
1331,5,3,4610,4610,4613,0,3,2
1332,6,1,4616,4616,4617,0,1,3
1333,4,2,4620,4620,4622,0,2,3
1334,2,1,4622,4622,4623,0,1,0
1335,6,3,4628,4628,4631,0,3,5
1336,5,2,4633,4633,4635,0,2,2
1337,2,1,4635,4635,4636,0,1,0
1338,3,2,4638,4638,4640,0,2,2
1339,1,3,4639,4640,4643,1,4,0
1340,4,3,4643,4643,4646,0,3,0
1341,1,2,4644,4646,4648,2,4,0
1342,2,1,4646,4648,4649,2,3,0
1343,1,2,4647,4649,4651,2,4,0
1344,6,1,4653,4653,4654,0,1,2
1345,6,1,4659,4659,4660,0,1,5
1346,5,3,4664,4664,4667,0,3,4
1347,3,1,4667,4667,4668,0,1,0
1348,3,1,4670,4670,4671,0,1,2
1349,1,3,4671,4671,4674,0,3,0
1350,2,3,4673,4674,4677,1,4,0
1351,5,1,4678,4678,4679,0,1,1
1352,4,1,4682,4682,4683,0,1,3
1353,5,2,4687,4687,4689,0,2,4
1354,2,2,4689,4689,4691,0,2,0
1355,5,3,4694,4694,4697,0,3,3
1356,2,3,4696,4697,4700,1,4,0
1357,5,3,4701,4701,4704,0,3,1
1358,6,2,4707,4707,4709,0,2,3
1359,2,1,4709,4709,4710,0,1,0
1360,5,3,4714,4714,4717,0,3,4
1361,1,2,4715,4717,4719,2,4,0
1362,2,3,4717,4719,4722,2,5,0
1363,5,3,4722,4722,4725,0,3,0
1364,4,1,4726,4726,4727,0,1,1
1365,6,1,4732,4732,4733,0,1,5
1366,4,2,4736,4736,4738,0,2,3
1367,6,3,4742,4742,4745,0,3,4
1368,3,3,4745,4745,4748,0,3,0
1369,2,2,4747,4748,4750,1,3,0
1370,2,2,4749,4750,4752,1,3,0
1371,2,1,4751,4752,4753,1,2,0
1372,1,2,4752,4753,4755,1,3,0
1373,5,3,4757,4757,4760,0,3,2
1374,6,1,4763,4763,4764,0,1,3
1375,6,3,4769,4769,4772,0,3,5
1376,5,2,4774,4774,4776,0,2,2
1377,2,2,4776,4776,4778,0,2,0
1378,4,1,4780,4780,4781,0,1,2
1379,3,3,4783,4783,4786,0,3,2
1380,1,2,4784,4786,4788,2,4,0
1381,3,1,4787,4788,4789,1,2,0
1382,1,2,4788,4789,4791,1,3,0
1383,1,1,4789,4791,4792,2,3,0
1384,2,3,4791,4792,4795,1,4,0
1385,5,1,4796,4796,4797,0,1,1
1386,6,1,4802,4802,4803,0,1,5
1387,5,3,4807,4807,4810,0,3,4
1388,6,1,4813,4813,4814,0,1,3
1389,1,1,4814,4814,4815,0,1,0
1390,6,2,4820,4820,4822,0,2,5
1391,4,2,4824,4824,4826,0,2,2
1392,4,2,4828,4828,4830,0,2,2
1393,6,1,4834,4834,4835,0,1,4
1394,5,1,4839,4839,4840,0,1,4
1395,2,3,4841,4841,4844,0,3,1
1396,3,2,4844,4844,4846,0,2,0
1397,4,1,4848,4848,4849,0,1,2
1398,1,1,4849,4849,4850,0,1,0
1399,1,1,4850,4850,4851,0,1,0
1400,1,2,4851,4851,4853,0,2,0
1401,4,2,4855,4855,4857,0,2,2
1402,6,1,4861,4861,4862,0,1,4
1403,5,3,4866,4866,4869,0,3,4
1404,4,1,4870,4870,4871,0,1,1
1405,3,1,4873,4873,4874,0,1,2
1406,2,1,4875,4875,4876,0,1,1
1407,6,2,4881,4881,4883,0,2,5
1408,5,3,4886,4886,4889,0,3,3
1409,6,2,4892,4892,4894,0,2,3
1410,4,3,4896,4896,4899,0,3,2
1411,2,2,4898,4899,4901,1,3,0
1412,1,2,4899,4901,4903,2,4,0
1413,3,3,4902,4903,4906,1,4,0
1414,6,2,4908,4908,4910,0,2,2
1415,2,1,4910,4910,4911,0,1,0
1416,4,2,4914,4914,4916,0,2,3
1417,4,2,4918,4918,4920,0,2,2
1418,2,3,4920,4920,4923,0,3,0
1419,4,3,4924,4924,4927,0,3,1
1420,4,2,4928,4928,4930,0,2,1
1421,3,3,4931,4931,4934,0,3,1
1422,5,2,4936,4936,4938,0,2,2
1423,2,1,4938,4938,4939,0,1,0
1424,1,2,4939,4939,4941,0,2,0
1425,1,3,4940,4941,4944,1,4,0
1426,6,3,4946,4946,4949,0,3,2
1427,3,2,4949,4949,4951,0,2,0
1428,3,1,4952,4952,4953,0,1,1
1429,4,1,4956,4956,4957,0,1,3
1430,5,3,4961,4961,4964,0,3,4
1431,5,2,4966,4966,4968,0,2,2
1432,4,3,4970,4970,4973,0,3,2
1433,3,2,4973,4973,4975,0,2,0
1434,3,1,4976,4976,4977,0,1,1
1435,6,2,4982,4982,4984,0,2,5
1436,2,3,4984,4984,4987,0,3,0
1437,4,2,4988,4988,4990,0,2,1
1438,2,3,4990,4990,4993,0,3,0
1439,3,2,4993,4993,4995,0,2,0
1440,3,2,4996,4996,4998,0,2,1
1441,5,3,5001,5001,5004,0,3,3
1442,3,2,5004,5004,5006,0,2,0
1443,6,2,5010,5010,5012,0,2,4
1444,4,2,5014,5014,5016,0,2,2
1445,2,3,5016,5016,5019,0,3,0
1446,5,2,5021,5021,5023,0,2,2
1447,6,3,5027,5027,5030,0,3,4
1448,4,3,5031,5031,5034,0,3,1
1449,3,1,5034,5034,5035,0,1,0
1450,2,3,5036,5036,5039,0,3,1
1451,5,3,5041,5041,5044,0,3,2
1452,2,1,5043,5044,5045,1,2,0
1453,3,1,5046,5046,5047,0,1,1
1454,5,2,5051,5051,5053,0,2,4
1455,2,1,5053,5053,5054,0,1,0
1456,4,3,5057,5057,5060,0,3,3
1457,2,2,5059,5060,5062,1,3,0
1458,4,3,5063,5063,5066,0,3,1
1459,3,1,5066,5066,5067,0,1,0
1460,1,2,5067,5067,5069,0,2,0
1461,5,3,5072,5072,5075,0,3,3
1462,5,2,5077,5077,5079,0,2,2
1463,5,1,5082,5082,5083,0,1,3
1464,2,1,5084,5084,5085,0,1,1
1465,1,3,5085,5085,5088,0,3,0
1466,2,2,5087,5088,5090,1,3,0
1467,6,2,5093,5093,5095,0,2,3
1468,6,1,5099,5099,5100,0,1,4
1469,6,3,5105,5105,5108,0,3,5
1470,3,2,5108,5108,5110,0,2,0
1471,2,1,5110,5110,5111,0,1,0
1472,6,3,5116,5116,5119,0,3,5
1473,3,3,5119,5119,5122,0,3,0
1474,3,3,5122,5122,5125,0,3,0
1475,5,3,5127,5127,5130,0,3,2
1476,6,3,5133,5133,5136,0,3,3
1477,4,2,5137,5137,5139,0,2,1
1478,1,3,5138,5139,5142,1,4,0
1479,6,3,5144,5144,5147,0,3,2
1480,6,3,5150,5150,5153,0,3,3
1481,6,3,5156,5156,5159,0,3,3
1482,4,2,5160,5160,5162,0,2,1
1483,4,3,5164,5164,5167,0,3,2
1484,6,1,5170,5170,5171,0,1,3
1485,4,2,5174,5174,5176,0,2,3
1486,2,1,5176,5176,5177,0,1,0
1487,1,1,5177,5177,5178,0,1,0
1488,6,3,5183,5183,5186,0,3,5
1489,3,2,5186,5186,5188,0,2,0
1490,2,1,5188,5188,5189,0,1,0
1491,3,3,5191,5191,5194,0,3,2
1492,5,1,5196,5196,5197,0,1,2
1493,6,1,5202,5202,5203,0,1,5
1494,1,1,5203,5203,5204,0,1,0
1495,6,1,5209,5209,5210,0,1,5
1496,1,2,5210,5210,5212,0,2,0
1497,4,3,5214,5214,5217,0,3,2
1498,4,3,5218,5218,5221,0,3,1
1499,5,1,5223,5223,5224,0,1,2
1500,5,1,5228,5228,5229,0,1,4
1501,4,2,5232,5232,5234,0,2,3
1502,5,2,5237,5237,5239,0,2,3
1503,6,3,5243,5243,5246,0,3,4
1504,5,2,5248,5248,5250,0,2,2
1505,1,2,5249,5250,5252,1,3,0
1506,3,3,5252,5252,5255,0,3,0
1507,2,2,5254,5255,5257,1,3,0
1508,3,3,5257,5257,5260,0,3,0
1509,1,2,5258,5260,5262,2,4,0
1510,2,3,5260,5262,5265,2,5,0
1511,6,3,5266,5266,5269,0,3,1
1512,1,3,5267,5269,5272,2,5,0
1513,3,2,5270,5272,5274,2,4,0
1514,1,2,5271,5274,5276,3,5,0
1515,2,1,5273,5276,5277,3,4,0
1516,5,1,5278,5278,5279,0,1,1
1517,4,1,5282,5282,5283,0,1,3
1518,5,3,5287,5287,5290,0,3,4
1519,2,2,5289,5290,5292,1,3,0
1520,5,3,5294,5294,5297,0,3,2
1521,6,2,5300,5300,5302,0,2,3
1522,4,3,5304,5304,5307,0,3,2
1523,5,1,5309,5309,5310,0,1,2
1524,2,3,5311,5311,5314,0,3,1
1525,1,3,5312,5314,5317,2,5,0
1526,4,3,5316,5317,5320,1,4,0
1527,6,3,5322,5322,5325,0,3,2
1528,2,2,5324,5325,5327,1,3,0
1529,4,2,5328,5328,5330,0,2,1
1530,3,3,5331,5331,5334,0,3,1
1531,2,1,5333,5334,5335,1,2,0
1532,6,3,5339,5339,5342,0,3,4
1533,2,1,5341,5342,5343,1,2,0
1534,1,1,5342,5343,5344,1,2,0
1535,4,2,5346,5346,5348,0,2,2
1536,3,3,5349,5349,5352,0,3,1
1537,5,3,5354,5354,5357,0,3,2
1538,2,3,5356,5357,5360,1,4,0
1539,6,1,5362,5362,5363,0,1,2
1540,5,2,5367,5367,5369,0,2,4
1541,5,2,5372,5372,5374,0,2,3
1542,4,1,5376,5376,5377,0,1,2
1543,3,2,5379,5379,5381,0,2,2
1544,2,2,5381,5381,5383,0,2,0
1545,1,1,5382,5383,5384,1,2,0
1546,2,2,5384,5384,5386,0,2,0
1547,6,1,5390,5390,5391,0,1,4
1548,6,2,5396,5396,5398,0,2,5
1549,1,1,5397,5398,5399,1,2,0
1550,2,3,5399,5399,5402,0,3,0
1551,5,1,5404,5404,5405,0,1,2
1552,6,3,5410,5410,5413,0,3,5
1553,4,2,5414,5414,5416,0,2,1
1554,5,1,5419,5419,5420,0,1,3
1555,2,2,5421,5421,5423,0,2,1
1556,2,2,5423,5423,5425,0,2,0
1557,4,3,5427,5427,5430,0,3,2
1558,1,3,5428,5430,5433,2,5,0
1559,6,2,5434,5434,5436,0,2,1
1560,3,2,5437,5437,5439,0,2,1
1561,1,1,5438,5439,5440,1,2,0
1562,2,3,5440,5440,5443,0,3,0
1563,4,2,5444,5444,5446,0,2,1
1564,6,1,5450,5450,5451,0,1,4
1565,4,2,5454,5454,5456,0,2,3
1566,3,3,5457,5457,5460,0,3,1
1567,4,1,5461,5461,5462,0,1,1
1568,5,2,5466,5466,5468,0,2,4
1569,4,3,5470,5470,5473,0,3,2
1570,1,3,5471,5473,5476,2,5,0
1571,4,2,5475,5476,5478,1,3,0
1572,5,2,5480,5480,5482,0,2,2
1573,6,2,5486,5486,5488,0,2,4
1574,1,2,5487,5488,5490,1,3,0
1575,2,3,5489,5490,5493,1,4,0
1576,2,3,5491,5493,5496,2,5,0
1577,2,3,5493,5496,5499,3,6,0
1578,2,3,5495,5499,5502,4,7,0
1579,1,2,5496,5502,5504,6,8,0
1580,6,1,5502,5504,5505,2,3,0
1581,6,2,5508,5508,5510,0,2,3
1582,1,1,5509,5510,5511,1,2,0
1583,6,1,5515,5515,5516,0,1,4
1584,4,2,5519,5519,5521,0,2,3
1585,4,2,5523,5523,5525,0,2,2
1586,3,1,5526,5526,5527,0,1,1
1587,2,1,5528,5528,5529,0,1,1
1588,2,2,5530,5530,5532,0,2,1
1589,6,3,5536,5536,5539,0,3,4
1590,6,1,5542,5542,5543,0,1,3
1591,5,3,5547,5547,5550,0,3,4
1592,3,3,5550,5550,5553,0,3,0
1593,4,1,5554,5554,5555,0,1,1
1594,1,1,5555,5555,5556,0,1,0
1595,3,2,5558,5558,5560,0,2,2
1596,1,2,5559,5560,5562,1,3,0
1597,5,3,5564,5564,5567,0,3,2
1598,6,3,5570,5570,5573,0,3,3
1599,3,3,5573,5573,5576,0,3,0
1600,6,2,5579,5579,5581,0,2,3
1601,6,3,5585,5585,5588,0,3,4
1602,6,3,5591,5591,5594,0,3,3
1603,3,3,5594,5594,5597,0,3,0
1604,5,3,5599,5599,5602,0,3,2
1605,2,3,5601,5602,5605,1,4,0
1606,2,2,5603,5605,5607,2,4,0
1607,6,2,5609,5609,5611,0,2,2
1608,4,3,5613,5613,5616,0,3,2
1609,3,3,5616,5616,5619,0,3,0
1610,1,2,5617,5619,5621,2,4,0
1611,4,1,5621,5621,5622,0,1,0
1612,6,1,5627,5627,5628,0,1,5
1613,2,3,5629,5629,5632,0,3,1
1614,2,2,5631,5632,5634,1,3,0
1615,1,1,5632,5634,5635,2,3,0
1616,1,2,5633,5635,5637,2,4,0
1617,6,3,5639,5639,5642,0,3,2
1618,6,3,5645,5645,5648,0,3,3
1619,3,3,5648,5648,5651,0,3,0
1620,4,1,5652,5652,5653,0,1,1
1621,2,2,5654,5654,5656,0,2,1
1622,1,2,5655,5656,5658,1,3,0
1623,4,3,5659,5659,5662,0,3,1
1624,4,1,5663,5663,5664,0,1,1
1625,2,3,5665,5665,5668,0,3,1
1626,5,1,5670,5670,5671,0,1,2
1627,2,1,5672,5672,5673,0,1,1
1628,3,3,5675,5675,5678,0,3,2
1629,3,3,5678,5678,5681,0,3,0
1630,2,3,5680,5681,5684,1,4,0
1631,4,2,5684,5684,5686,0,2,0
1632,6,1,5690,5690,5691,0,1,4
1633,6,2,5696,5696,5698,0,2,5
1634,1,3,5697,5698,5701,1,4,0
1635,3,3,5700,5701,5704,1,4,0
1636,1,1,5701,5704,5705,3,4,0
1637,5,3,5706,5706,5709,0,3,1
1638,4,3,5710,5710,5713,0,3,1
1639,3,3,5713,5713,5716,0,3,0
1640,2,1,5715,5716,5717,1,2,0
1641,6,3,5721,5721,5724,0,3,4
1642,6,3,5727,5727,5730,0,3,3
1643,3,1,5730,5730,5731,0,1,0
1644,3,2,5733,5733,5735,0,2,2
1645,6,2,5739,5739,5741,0,2,4
1646,3,3,5742,5742,5745,0,3,1
1647,1,3,5743,5745,5748,2,5,0
1648,6,3,5749,5749,5752,0,3,1
1649,6,3,5755,5755,5758,0,3,3
1650,2,1,5757,5758,5759,1,2,0
1651,1,3,5758,5759,5762,1,4,0
1652,1,2,5759,5762,5764,3,5,0
1653,3,3,5762,5764,5767,2,5,0
1654,5,1,5767,5767,5768,0,1,0
1655,5,3,5772,5772,5775,0,3,4
1656,1,1,5773,5775,5776,2,3,0
1657,2,3,5775,5776,5779,1,4,0
1658,5,1,5780,5780,5781,0,1,1
1659,1,1,5781,5781,5782,0,1,0
1660,3,1,5784,5784,5785,0,1,2
1661,4,1,5788,5788,5789,0,1,3
1662,6,1,5794,5794,5795,0,1,5
1663,6,3,5800,5800,5803,0,3,5
1664,6,3,5806,5806,5809,0,3,3
1665,3,3,5809,5809,5812,0,3,0
1666,2,2,5811,5812,5814,1,3,0
1667,5,3,5816,5816,5819,0,3,2
1668,3,1,5819,5819,5820,0,1,0
1669,6,2,5825,5825,5827,0,2,5
1670,4,3,5829,5829,5832,0,3,2
1671,5,3,5834,5834,5837,0,3,2
1672,5,2,5839,5839,5841,0,2,2
1673,1,3,5840,5841,5844,1,4,0
1674,6,3,5846,5846,5849,0,3,2
1675,6,3,5852,5852,5855,0,3,3
1676,1,2,5853,5855,5857,2,4,0
1677,2,2,5855,5857,5859,2,4,0
1678,5,2,5860,5860,5862,0,2,1
1679,2,1,5862,5862,5863,0,1,0
1680,6,2,5868,5868,5870,0,2,5
1681,4,1,5872,5872,5873,0,1,2
1682,4,2,5876,5876,5878,0,2,3
1683,6,1,5882,5882,5883,0,1,4
1684,6,1,5888,5888,5889,0,1,5
1685,6,2,5894,5894,5896,0,2,5
1686,2,2,5896,5896,5898,0,2,0
1687,5,3,5901,5901,5904,0,3,3
1688,4,3,5905,5905,5908,0,3,1
1689,6,2,5911,5911,5913,0,2,3
1690,5,1,5916,5916,5917,0,1,3
1691,1,3,5917,5917,5920,0,3,0
1692,2,3,5919,5920,5923,1,4,0
1693,2,2,5921,5923,5925,2,4,0
1694,4,1,5925,5925,5926,0,1,0
1695,3,3,5928,5928,5931,0,3,2
1696,5,2,5933,5933,5935,0,2,2
1697,2,1,5935,5935,5936,0,1,0
1698,3,3,5938,5938,5941,0,3,2
1699,1,3,5939,5941,5944,2,5,0
1700,3,1,5942,5944,5945,2,3,0
1701,2,1,5944,5945,5946,1,2,0
1702,5,1,5949,5949,5950,0,1,3
1703,1,3,5950,5950,5953,0,3,0
1704,4,1,5954,5954,5955,0,1,1
1705,3,3,5957,5957,5960,0,3,2
1706,4,2,5961,5961,5963,0,2,1
1707,3,2,5964,5964,5966,0,2,1
1708,1,2,5965,5966,5968,1,3,0
1709,2,3,5967,5968,5971,1,4,0
1710,2,2,5969,5971,5973,2,4,0
1711,4,3,5973,5973,5976,0,3,0
1712,3,1,5976,5976,5977,0,1,0
1713,4,2,5980,5980,5982,0,2,3
1714,2,2,5982,5982,5984,0,2,0
1715,5,2,5987,5987,5989,0,2,3
1716,4,1,5991,5991,5992,0,1,2
1717,3,2,5994,5994,5996,0,2,2
1718,4,3,5998,5998,6001,0,3,2
1719,2,2,6000,6001,6003,1,3,0
1720,4,3,6004,6004,6007,0,3,1
1721,2,2,6006,6007,6009,1,3,0
1722,6,2,6012,6012,6014,0,2,3
1723,3,2,6015,6015,6017,0,2,1
1724,6,3,6021,6021,6024,0,3,4
1725,5,1,6026,6026,6027,0,1,2
1726,3,2,6029,6029,6031,0,2,2
1727,3,3,6032,6032,6035,0,3,1
1728,5,2,6037,6037,6039,0,2,2
1729,2,1,6039,6039,6040,0,1,0
1730,4,2,6043,6043,6045,0,2,3
1731,4,2,6047,6047,6049,0,2,2
1732,6,1,6053,6053,6054,0,1,4
1733,4,2,6057,6057,6059,0,2,3
1734,5,3,6062,6062,6065,0,3,3
1735,1,2,6063,6065,6067,2,4,0
1736,1,1,6064,6067,6068,3,4,0
1737,1,1,6065,6068,6069,3,4,0
1738,6,1,6071,6071,6072,0,1,2
1739,3,1,6074,6074,6075,0,1,2
1740,1,1,6075,6075,6076,0,1,0
1741,4,1,6079,6079,6080,0,1,3
1742,6,1,6085,6085,6086,0,1,5
1743,2,1,6087,6087,6088,0,1,1
1744,1,3,6088,6088,6091,0,3,0
1745,5,3,6093,6093,6096,0,3,2
1746,2,1,6095,6096,6097,1,2,0
1747,4,2,6099,6099,6101,0,2,2
1748,4,3,6103,6103,6106,0,3,2
1749,2,3,6105,6106,6109,1,4,0
1750,4,2,6109,6109,6111,0,2,0
1751,4,2,6113,6113,6115,0,2,2
1752,6,3,6119,6119,6122,0,3,4
1753,3,2,6122,6122,6124,0,2,0
1754,1,2,6123,6124,6126,1,3,0
1755,6,2,6129,6129,6131,0,2,3
1756,2,2,6131,6131,6133,0,2,0
1757,4,3,6135,6135,6138,0,3,2
1758,3,3,6138,6138,6141,0,3,0
1759,2,2,6140,6141,6143,1,3,0
1760,6,3,6146,6146,6149,0,3,3
1761,2,3,6148,6149,6152,1,4,0
1762,1,1,6149,6152,6153,3,4,0
1763,3,1,6152,6153,6154,1,2,0
1764,5,2,6157,6157,6159,0,2,3
1765,4,1,6161,6161,6162,0,1,2
1766,5,2,6166,6166,6168,0,2,4
1767,1,2,6167,6168,6170,1,3,0
1768,1,2,6168,6170,6172,2,4,0
1769,2,3,6170,6172,6175,2,5,0
1770,2,1,6172,6175,6176,3,4,0
1771,1,1,6173,6176,6177,3,4,0
1772,3,1,6176,6177,6178,1,2,0
1773,1,1,6177,6178,6179,1,2,0
1774,2,2,6179,6179,6181,0,2,0
1775,4,2,6183,6183,6185,0,2,2
1776,3,1,6186,6186,6187,0,1,1
1777,1,2,6187,6187,6189,0,2,0
1778,2,3,6189,6189,6192,0,3,0
1779,5,3,6194,6194,6197,0,3,2
1780,2,1,6196,6197,6198,1,2,0
1781,1,3,6197,6198,6201,1,4,0
1782,3,3,6200,6201,6204,1,4,0
1783,5,1,6205,6205,6206,0,1,1
1784,5,3,6210,6210,6213,0,3,4
1785,5,2,6215,6215,6217,0,2,2
1786,2,1,6217,6217,6218,0,1,0
1787,2,2,6219,6219,6221,0,2,1
1788,4,1,6223,6223,6224,0,1,2
1789,4,3,6227,6227,6230,0,3,3
1790,1,1,6228,6230,6231,2,3,0
1791,3,2,6231,6231,6233,0,2,0
1792,6,1,6237,6237,6238,0,1,4
1793,2,1,6239,6239,6240,0,1,1
1794,2,2,6241,6241,6243,0,2,1
1795,5,3,6246,6246,6249,0,3,3
1796,1,2,6247,6249,6251,2,4,0
1797,5,3,6252,6252,6255,0,3,1
1798,6,3,6258,6258,6261,0,3,3
1799,4,1,6262,6262,6263,0,1,1
1800,2,1,6264,6264,6265,0,1,1
1801,2,3,6266,6266,6269,0,3,1
1802,1,2,6267,6269,6271,2,4,0
1803,6,2,6273,6273,6275,0,2,2
1804,6,1,6279,6279,6280,0,1,4
1805,4,2,6283,6283,6285,0,2,3
1806,3,3,6286,6286,6289,0,3,1
1807,2,1,6288,6289,6290,1,2,0
1808,4,3,6292,6292,6295,0,3,2
1809,2,2,6294,6295,6297,1,3,0
1810,3,3,6297,6297,6300,0,3,0
1811,5,3,6302,6302,6305,0,3,2
1812,3,3,6305,6305,6308,0,3,0
1813,5,3,6310,6310,6313,0,3,2
1814,6,2,6316,6316,6318,0,2,3
1815,4,2,6320,6320,6322,0,2,2
1816,2,1,6322,6322,6323,0,1,0
1817,3,2,6325,6325,6327,0,2,2
1818,5,2,6330,6330,6332,0,2,3
1819,2,3,6332,6332,6335,0,3,0
1820,4,2,6336,6336,6338,0,2,1
1821,4,2,6340,6340,6342,0,2,2
1822,5,1,6345,6345,6346,0,1,3
1823,1,3,6346,6346,6349,0,3,0
1824,3,1,6349,6349,6350,0,1,0
1825,1,1,6350,6350,6351,0,1,0
1826,3,3,6353,6353,6356,0,3,2
1827,3,3,6356,6356,6359,0,3,0
1828,5,2,6361,6361,6363,0,2,2
1829,1,1,6362,6363,6364,1,2,0
1830,5,1,6367,6367,6368,0,1,3
1831,6,1,6373,6373,6374,0,1,5
1832,5,1,6378,6378,6379,0,1,4
1833,1,3,6379,6379,6382,0,3,0
1834,5,3,6384,6384,6387,0,3,2
1835,3,1,6387,6387,6388,0,1,0
1836,3,2,6390,6390,6392,0,2,2
1837,6,3,6396,6396,6399,0,3,4
1838,3,2,6399,6399,6401,0,2,0
1839,2,1,6401,6401,6402,0,1,0
1840,6,2,6407,6407,6409,0,2,5
1841,5,2,6412,6412,6414,0,2,3
1842,4,2,6416,6416,6418,0,2,2
1843,3,1,6419,6419,6420,0,1,1
1844,2,3,6421,6421,6424,0,3,1
1845,2,3,6423,6424,6427,1,4,0
1846,3,1,6426,6427,6428,1,2,0
1847,4,1,6430,6430,6431,0,1,2
1848,3,2,6433,6433,6435,0,2,2
1849,1,1,6434,6435,6436,1,2,0
1850,3,2,6437,6437,6439,0,2,1
1851,4,3,6441,6441,6444,0,3,2
1852,5,2,6446,6446,6448,0,2,2
1853,2,3,6448,6448,6451,0,3,0
1854,2,2,6450,6451,6453,1,3,0
1855,6,3,6456,6456,6459,0,3,3
1856,5,1,6461,6461,6462,0,1,2
1857,1,3,6462,6462,6465,0,3,0
1858,6,2,6468,6468,6470,0,2,3
1859,2,2,6470,6470,6472,0,2,0
1860,3,1,6473,6473,6474,0,1,1
1861,2,2,6475,6475,6477,0,2,1
1862,5,3,6480,6480,6483,0,3,3
1863,2,3,6482,6483,6486,1,4,0
1864,1,2,6483,6486,6488,3,5,0
1865,6,2,6489,6489,6491,0,2,1
1866,5,2,6494,6494,6496,0,2,3
1867,3,1,6497,6497,6498,0,1,1
1868,4,3,6501,6501,6504,0,3,3
1869,1,1,6502,6504,6505,2,3,0
1870,1,3,6503,6505,6508,2,5,0
1871,1,1,6504,6508,6509,4,5,0
1872,5,3,6509,6509,6512,0,3,0
1873,4,2,6513,6513,6515,0,2,1
1874,3,3,6516,6516,6519,0,3,1
1875,6,1,6522,6522,6523,0,1,3
1876,5,3,6527,6527,6530,0,3,4
1877,4,1,6531,6531,6532,0,1,1
1878,2,2,6533,6533,6535,0,2,1
1879,1,2,6534,6535,6537,1,3,0
1880,3,1,6537,6537,6538,0,1,0
1881,5,2,6542,6542,6544,0,2,4
1882,5,1,6547,6547,6548,0,1,3
1883,3,2,6550,6550,6552,0,2,2
1884,6,1,6556,6556,6557,0,1,4
1885,6,1,6562,6562,6563,0,1,5
1886,4,3,6566,6566,6569,0,3,3
1887,3,2,6569,6569,6571,0,2,0
1888,2,2,6571,6571,6573,0,2,0
1889,4,1,6575,6575,6576,0,1,2
1890,4,3,6579,6579,6582,0,3,3
1891,3,3,6582,6582,6585,0,3,0
1892,1,1,6583,6585,6586,2,3,0
1893,6,2,6589,6589,6591,0,2,3
1894,1,3,6590,6591,6594,1,4,0
1895,3,2,6593,6594,6596,1,3,0
1896,3,1,6596,6596,6597,0,1,0
1897,3,2,6599,6599,6601,0,2,2
1898,1,1,6600,6601,6602,1,2,0
1899,1,3,6601,6602,6605,1,4,0
1900,5,1,6606,6606,6607,0,1,1
1901,3,3,6609,6609,6612,0,3,2
1902,2,3,6611,6612,6615,1,4,0
1903,5,1,6616,6616,6617,0,1,1
1904,6,3,6622,6622,6625,0,3,5
1905,5,1,6627,6627,6628,0,1,2
1906,3,1,6630,6630,6631,0,1,2
1907,6,1,6636,6636,6637,0,1,5
1908,2,2,6638,6638,6640,0,2,1
1909,5,1,6643,6643,6644,0,1,3
1910,1,3,6644,6644,6647,0,3,0
1911,3,1,6647,6647,6648,0,1,0
1912,3,2,6650,6650,6652,0,2,2
1913,5,3,6655,6655,6658,0,3,3
1914,4,3,6659,6659,6662,0,3,1
1915,4,2,6663,6663,6665,0,2,1
1916,2,1,6665,6665,6666,0,1,0
1917,5,2,6670,6670,6672,0,2,4
1918,2,3,6672,6672,6675,0,3,0
1919,2,3,6674,6675,6678,1,4,0
1920,3,3,6677,6678,6681,1,4,0
1921,3,2,6680,6681,6683,1,3,0
1922,5,1,6685,6685,6686,0,1,2
1923,5,2,6690,6690,6692,0,2,4
1924,3,3,6693,6693,6696,0,3,1
1925,2,3,6695,6696,6699,1,4,0
1926,4,1,6699,6699,6700,0,1,0
1927,1,2,6700,6700,6702,0,2,0
1928,2,1,6702,6702,6703,0,1,0
1929,6,2,6708,6708,6710,0,2,5
1930,5,2,6713,6713,6715,0,2,3
1931,5,2,6718,6718,6720,0,2,3
1932,6,3,6724,6724,6727,0,3,4
1933,5,2,6729,6729,6731,0,2,2
1934,4,3,6733,6733,6736,0,3,2
1935,4,2,6737,6737,6739,0,2,1
1936,2,3,6739,6739,6742,0,3,0
1937,1,2,6740,6742,6744,2,4,0
1938,6,1,6746,6746,6747,0,1,2
1939,4,1,6750,6750,6751,0,1,3
1940,6,2,6756,6756,6758,0,2,5
1941,3,2,6759,6759,6761,0,2,1
1942,4,1,6763,6763,6764,0,1,2
1943,2,2,6765,6765,6767,0,2,1
1944,2,3,6767,6767,6770,0,3,0
1945,2,1,6769,6770,6771,1,2,0
1946,1,2,6770,6771,6773,1,3,0
1947,3,3,6773,6773,6776,0,3,0
1948,1,3,6774,6776,6779,2,5,0
1949,1,2,6775,6779,6781,4,6,0
1950,2,3,6777,6781,6784,4,7,0
1951,3,1,6780,6784,6785,4,5,0
1952,2,1,6782,6785,6786,3,4,0
1953,2,2,6784,6786,6788,2,4,0
1954,6,2,6790,6790,6792,0,2,2
1955,6,1,6796,6796,6797,0,1,4
1956,5,2,6801,6801,6803,0,2,4
1957,5,3,6806,6806,6809,0,3,3
1958,2,2,6808,6809,6811,1,3,0
1959,1,2,6809,6811,6813,2,4,0
1960,6,1,6815,6815,6816,0,1,2
1961,4,3,6819,6819,6822,0,3,3
1962,1,2,6820,6822,6824,2,4,0
1963,3,1,6823,6824,6825,1,2,0
1964,5,3,6828,6828,6831,0,3,3
1965,3,3,6831,6831,6834,0,3,0
1966,4,1,6835,6835,6836,0,1,1
1967,5,2,6840,6840,6842,0,2,4
1968,2,2,6842,6842,6844,0,2,0
1969,5,2,6847,6847,6849,0,2,3
1970,6,3,6853,6853,6856,0,3,4
1971,2,2,6855,6856,6858,1,3,0
1972,3,3,6858,6858,6861,0,3,0
1973,5,3,6863,6863,6866,0,3,2
1974,4,1,6867,6867,6868,0,1,1
1975,6,3,6873,6873,6876,0,3,5
1976,5,3,6878,6878,6881,0,3,2
1977,2,2,6880,6881,6883,1,3,0
1978,2,2,6882,6883,6885,1,3,0
1979,2,2,6884,6885,6887,1,3,0
1980,2,1,6886,6887,6888,1,2,0
1981,6,3,6892,6892,6895,0,3,4
1982,5,1,6897,6897,6898,0,1,2
1983,3,1,6900,6900,6901,0,1,2
1984,6,1,6906,6906,6907,0,1,5
1985,3,3,6909,6909,6912,0,3,2
1986,5,3,6914,6914,6917,0,3,2
1987,6,3,6920,6920,6923,0,3,3
1988,3,1,6923,6923,6924,0,1,0
1989,5,1,6928,6928,6929,0,1,4
1990,2,1,6930,6930,6931,0,1,1
1991,3,1,6933,6933,6934,0,1,2
1992,6,1,6939,6939,6940,0,1,5
1993,3,2,6942,6942,6944,0,2,2
1994,5,1,6947,6947,6948,0,1,3
1995,2,2,6949,6949,6951,0,2,1
1996,2,1,6951,6951,6952,0,1,0
1997,2,2,6953,6953,6955,0,2,1
1998,4,3,6957,6957,6960,0,3,2
1999,6,2,6963,6963,6965,0,2,3
2000,5,3,6968,6968,6971,0,3,3
2001,6,1,6974,6974,6975,0,1,3
2002,6,1,6980,6980,6981,0,1,5
2003,5,2,6985,6985,6987,0,2,4
2004,5,2,6990,6990,6992,0,2,3
2005,6,1,6996,6996,6997,0,1,4
2006,2,2,6998,6998,7000,0,2,1
2007,1,2,6999,7000,7002,1,3,0
2008,2,1,7001,7002,7003,1,2,0
2009,4,1,7005,7005,7006,0,1,2
2010,1,2,7006,7006,7008,0,2,0
2011,4,3,7010,7010,7013,0,3,2
2012,1,2,7011,7013,7015,2,4,0
2013,1,1,7012,7015,7016,3,4,0
2014,2,2,7014,7016,7018,2,4,0
2015,3,2,7017,7018,7020,1,3,0
2016,6,1,7023,7023,7024,0,1,3
2017,1,2,7024,7024,7026,0,2,0
2018,3,3,7027,7027,7030,0,3,1
2019,3,3,7030,7030,7033,0,3,0
2020,4,1,7034,7034,7035,0,1,1
2021,3,1,7037,7037,7038,0,1,2
2022,4,1,7041,7041,7042,0,1,3
2023,5,2,7046,7046,7048,0,2,4
2024,4,1,7050,7050,7051,0,1,2
2025,3,3,7053,7053,7056,0,3,2
2026,2,1,7055,7056,7057,1,2,0
2027,6,1,7061,7061,7062,0,1,4
2028,1,1,7062,7062,7063,0,1,0
2029,4,2,7066,7066,7068,0,2,3
2030,1,3,7067,7068,7071,1,4,0
2031,2,3,7069,7071,7074,2,5,0
2032,5,1,7074,7074,7075,0,1,0
2033,5,2,7079,7079,7081,0,2,4
2034,6,1,7085,7085,7086,0,1,4
2035,6,1,7091,7091,7092,0,1,5
2036,5,3,7096,7096,7099,0,3,4
2037,3,1,7099,7099,7100,0,1,0
2038,1,2,7100,7100,7102,0,2,0
2039,6,1,7106,7106,7107,0,1,4
2040,4,2,7110,7110,7112,0,2,3
2041,4,3,7114,7114,7117,0,3,2
2042,2,1,7116,7117,7118,1,2,0
2043,3,1,7119,7119,7120,0,1,1
2044,5,1,7124,7124,7125,0,1,4
2045,1,2,7125,7125,7127,0,2,0
2046,4,3,7129,7129,7132,0,3,2
2047,5,3,7134,7134,7137,0,3,2
2048,4,2,7138,7138,7140,0,2,1
2049,2,1,7140,7140,7141,0,1,0
2050,5,1,7145,7145,7146,0,1,4
2051,2,3,7147,7147,7150,0,3,1
2052,1,1,7148,7150,7151,2,3,0
2053,3,2,7151,7151,7153,0,2,0
2054,4,1,7155,7155,7156,0,1,2
2055,4,1,7159,7159,7160,0,1,3
2056,4,1,7163,7163,7164,0,1,3
2057,6,2,7169,7169,7171,0,2,5
2058,1,1,7170,7171,7172,1,2,0
2059,5,2,7175,7175,7177,0,2,3
2060,6,1,7181,7181,7182,0,1,4
2061,1,1,7182,7182,7183,0,1,0
2062,6,3,7188,7188,7191,0,3,5
2063,5,2,7193,7193,7195,0,2,2
2064,3,3,7196,7196,7199,0,3,1
2065,6,3,7202,7202,7205,0,3,3
2066,6,3,7208,7208,7211,0,3,3
2067,5,1,7213,7213,7214,0,1,2
2068,1,2,7214,7214,7216,0,2,0
2069,6,1,7220,7220,7221,0,1,4
2070,4,1,7224,7224,7225,0,1,3
2071,4,3,7228,7228,7231,0,3,3
2072,5,2,7233,7233,7235,0,2,2
2073,4,3,7237,7237,7240,0,3,2
2074,6,2,7243,7243,7245,0,2,3
2075,2,1,7245,7245,7246,0,1,0
2076,2,2,7247,7247,7249,0,2,1
2077,3,3,7250,7250,7253,0,3,1
2078,4,1,7254,7254,7255,0,1,1
2079,1,3,7255,7255,7258,0,3,0
2080,2,2,7257,7258,7260,1,3,0
2081,3,1,7260,7260,7261,0,1,0
2082,4,3,7264,7264,7267,0,3,3
2083,6,3,7270,7270,7273,0,3,3
2084,1,1,7271,7273,7274,2,3,0
2085,2,3,7273,7274,7277,1,4,0
2086,3,3,7276,7277,7280,1,4,0
2087,1,1,7277,7280,7281,3,4,0
2088,4,2,7281,7281,7283,0,2,0
2089,5,2,7286,7286,7288,0,2,3
2090,4,1,7290,7290,7291,0,1,2
2091,2,3,7292,7292,7295,0,3,1
2092,4,1,7296,7296,7297,0,1,1
2093,1,2,7297,7297,7299,0,2,0
2094,6,3,7303,7303,7306,0,3,4
2095,1,2,7304,7306,7308,2,4,0
2096,3,3,7307,7308,7311,1,4,0
2097,1,1,7308,7311,7312,3,4,0
2098,1,3,7309,7312,7315,3,6,0
2099,6,2,7315,7315,7317,0,2,0
2100,1,1,7316,7317,7318,1,2,0
2101,4,1,7320,7320,7321,0,1,2
2102,1,1,7321,7321,7322,0,1,0
2103,5,2,7326,7326,7328,0,2,4
2104,4,3,7330,7330,7333,0,3,2
2105,3,1,7333,7333,7334,0,1,0
2106,3,2,7336,7336,7338,0,2,2
2107,5,2,7341,7341,7343,0,2,3
2108,5,1,7346,7346,7347,0,1,3
2109,3,2,7349,7349,7351,0,2,2
2110,4,2,7353,7353,7355,0,2,2
2111,5,3,7358,7358,7361,0,3,3
2112,4,2,7362,7362,7364,0,2,1
2113,2,1,7364,7364,7365,0,1,0
2114,1,2,7365,7365,7367,0,2,0
2115,6,2,7371,7371,7373,0,2,4
2116,3,3,7374,7374,7377,0,3,1
2117,5,3,7379,7379,7382,0,3,2
2118,1,1,7380,7382,7383,2,3,0
2119,5,2,7385,7385,7387,0,2,2
2120,6,3,7391,7391,7394,0,3,4
2121,4,1,7395,7395,7396,0,1,1
2122,2,1,7397,7397,7398,0,1,1
2123,6,1,7403,7403,7404,0,1,5
2124,2,2,7405,7405,7407,0,2,1
2125,2,1,7407,7407,7408,0,1,0
2126,6,2,7413,7413,7415,0,2,5
2127,1,1,7414,7415,7416,1,2,0
2128,2,1,7416,7416,7417,0,1,0
2129,2,3,7418,7418,7421,0,3,1
2130,3,2,7421,7421,7423,0,2,0
2131,5,1,7426,7426,7427,0,1,3
2132,5,2,7431,7431,7433,0,2,4
2133,4,3,7435,7435,7438,0,3,2
2134,3,3,7438,7438,7441,0,3,0
2135,1,2,7439,7441,7443,2,4,0
2136,2,1,7441,7443,7444,2,3,0
2137,3,2,7444,7444,7446,0,2,0
2138,4,3,7448,7448,7451,0,3,2
2139,6,1,7454,7454,7455,0,1,3
2140,5,2,7459,7459,7461,0,2,4
2141,5,3,7464,7464,7467,0,3,3
2142,1,2,7465,7467,7469,2,4,0
2143,6,2,7471,7471,7473,0,2,2
2144,4,3,7475,7475,7478,0,3,2
2145,1,3,7476,7478,7481,2,5,0
2146,3,2,7479,7481,7483,2,4,0
2147,5,3,7484,7484,7487,0,3,1
2148,3,1,7487,7487,7488,0,1,0
2149,3,3,7490,7490,7493,0,3,2
2150,5,2,7495,7495,7497,0,2,2
2151,1,2,7496,7497,7499,1,3,0
2152,6,2,7502,7502,7504,0,2,3
2153,4,3,7506,7506,7509,0,3,2
2154,2,1,7508,7509,7510,1,2,0
2155,1,3,7509,7510,7513,1,4,0
2156,3,1,7512,7513,7514,1,2,0
2157,5,2,7517,7517,7519,0,2,3
2158,1,1,7518,7519,7520,1,2,0
2159,5,2,7523,7523,7525,0,2,3
2160,2,3,7525,7525,7528,0,3,0
2161,2,1,7527,7528,7529,1,2,0
2162,2,1,7529,7529,7530,0,1,0
2163,6,1,7535,7535,7536,0,1,5
2164,3,3,7538,7538,7541,0,3,2
2165,5,3,7543,7543,7546,0,3,2
2166,3,1,7546,7546,7547,0,1,0
2167,3,1,7549,7549,7550,0,1,2
2168,2,1,7551,7551,7552,0,1,1
2169,4,2,7555,7555,7557,0,2,3
2170,3,3,7558,7558,7561,0,3,1
2171,6,3,7564,7564,7567,0,3,3
2172,5,3,7569,7569,7572,0,3,2
2173,3,1,7572,7572,7573,0,1,0
2174,4,1,7576,7576,7577,0,1,3
2175,2,1,7578,7578,7579,0,1,1
2176,6,1,7584,7584,7585,0,1,5
2177,3,3,7587,7587,7590,0,3,2
2178,5,3,7592,7592,7595,0,3,2
2179,2,2,7594,7595,7597,1,3,0
2180,1,3,7595,7597,7600,2,5,0
2181,2,3,7597,7600,7603,3,6,0
2182,3,1,7600,7603,7604,3,4,0
2183,1,2,7601,7604,7606,3,5,0
2184,6,3,7607,7607,7610,0,3,1
2185,5,3,7612,7612,7615,0,3,2
2186,2,3,7614,7615,7618,1,4,0
2187,3,2,7617,7618,7620,1,3,0
2188,5,2,7622,7622,7624,0,2,2
2189,3,3,7625,7625,7628,0,3,1
2190,1,2,7626,7628,7630,2,4,0
2191,1,1,7627,7630,7631,3,4,0
2192,6,2,7633,7633,7635,0,2,2
2193,1,1,7634,7635,7636,1,2,0
2194,4,1,7638,7638,7639,0,1,2
2195,5,3,7643,7643,7646,0,3,4
2196,3,2,7646,7646,7648,0,2,0
2197,5,1,7651,7651,7652,0,1,3
2198,4,3,7655,7655,7658,0,3,3
2199,3,1,7658,7658,7659,0,1,0
2200,4,1,7662,7662,7663,0,1,3
2201,4,2,7666,7666,7668,0,2,3
2202,4,3,7670,7670,7673,0,3,2
2203,5,3,7675,7675,7678,0,3,2
2204,5,1,7680,7680,7681,0,1,2
2205,5,2,7685,7685,7687,0,2,4
2206,2,3,7687,7687,7690,0,3,0
2207,1,1,7688,7690,7691,2,3,0
2208,1,2,7689,7691,7693,2,4,0
2209,4,2,7693,7693,7695,0,2,0
2210,2,2,7695,7695,7697,0,2,0
2211,1,1,7696,7697,7698,1,2,0
2212,5,3,7701,7701,7704,0,3,3
2213,3,2,7704,7704,7706,0,2,0
2214,5,2,7709,7709,7711,0,2,3
2215,2,2,7711,7711,7713,0,2,0
2216,5,1,7716,7716,7717,0,1,3
2217,5,2,7721,7721,7723,0,2,4
2218,3,3,7724,7724,7727,0,3,1
2219,6,1,7730,7730,7731,0,1,3
2220,5,2,7735,7735,7737,0,2,4
2221,6,2,7741,7741,7743,0,2,4
2222,4,2,7745,7745,7747,0,2,2
2223,2,3,7747,7747,7750,0,3,0
2224,4,2,7751,7751,7753,0,2,1
2225,6,2,7757,7757,7759,0,2,4
2226,1,3,7758,7759,7762,1,4,0
2227,5,2,7763,7763,7765,0,2,1
2228,6,1,7769,7769,7770,0,1,4
2229,5,2,7774,7774,7776,0,2,4
2230,5,2,7779,7779,7781,0,2,3
2231,3,2,7782,7782,7784,0,2,1
2232,5,1,7787,7787,7788,0,1,3
2233,5,1,7792,7792,7793,0,1,4
2234,2,3,7794,7794,7797,0,3,1
2235,2,1,7796,7797,7798,1,2,0
2236,4,3,7800,7800,7803,0,3,2
2237,1,3,7801,7803,7806,2,5,0
2238,5,3,7806,7806,7809,0,3,0
2239,2,2,7808,7809,7811,1,3,0
2240,6,2,7814,7814,7816,0,2,3
2241,4,2,7818,7818,7820,0,2,2
2242,2,1,7820,7820,7821,0,1,0
2243,4,2,7824,7824,7826,0,2,3
2244,5,2,7829,7829,7831,0,2,3
2245,5,2,7834,7834,7836,0,2,3
2246,6,3,7840,7840,7843,0,3,4
2247,6,2,7846,7846,7848,0,2,3
2248,3,3,7849,7849,7852,0,3,1
2249,3,3,7852,7852,7855,0,3,0
2250,6,1,7858,7858,7859,0,1,3
2251,1,2,7859,7859,7861,0,2,0
2252,5,2,7864,7864,7866,0,2,3
2253,3,3,7867,7867,7870,0,3,1
2254,5,3,7872,7872,7875,0,3,2
2255,3,2,7875,7875,7877,0,2,0
2256,2,1,7877,7877,7878,0,1,0
2257,6,2,7883,7883,7885,0,2,5
2258,6,2,7889,7889,7891,0,2,4
2259,4,3,7893,7893,7896,0,3,2
2260,6,1,7899,7899,7900,0,1,3
2261,2,2,7901,7901,7903,0,2,1
2262,3,2,7904,7904,7906,0,2,1
2263,5,3,7909,7909,7912,0,3,3
2264,5,3,7914,7914,7917,0,3,2
2265,2,2,7916,7917,7919,1,3,0
2266,4,1,7920,7920,7921,0,1,1
2267,2,1,7922,7922,7923,0,1,1
2268,4,3,7926,7926,7929,0,3,3
2269,4,1,7930,7930,7931,0,1,1
2270,1,3,7931,7931,7934,0,3,0
2271,2,1,7933,7934,7935,1,2,0
2272,2,2,7935,7935,7937,0,2,0
2273,3,3,7938,7938,7941,0,3,1
2274,3,1,7941,7941,7942,0,1,0
2275,3,3,7944,7944,7947,0,3,2
2276,2,2,7946,7947,7949,1,3,0
2277,2,3,7948,7949,7952,1,4,0
2278,1,1,7949,7952,7953,3,4,0
2279,4,1,7953,7953,7954,0,1,0
2280,3,3,7956,7956,7959,0,3,2
2281,4,2,7960,7960,7962,0,2,1
2282,6,2,7966,7966,7968,0,2,4
2283,4,2,7970,7970,7972,0,2,2
2284,5,1,7975,7975,7976,0,1,3
2285,4,3,7979,7979,7982,0,3,3
2286,6,3,7985,7985,7988,0,3,3
2287,4,3,7989,7989,7992,0,3,1
2288,4,3,7993,7993,7996,0,3,1
2289,2,3,7995,7996,7999,1,4,0
2290,6,3,8001,8001,8004,0,3,2
2291,1,1,8002,8004,8005,2,3,0
2292,6,1,8008,8008,8009,0,1,3
2293,3,3,8011,8011,8014,0,3,2
2294,2,3,8013,8014,8017,1,4,0
2295,2,1,8015,8017,8018,2,3,0
2296,2,3,8017,8018,8021,1,4,0
2297,2,2,8019,8021,8023,2,4,0
2298,5,3,8024,8024,8027,0,3,1
2299,2,1,8026,8027,8028,1,2,0
2300,1,2,8027,8028,8030,1,3,0
2301,2,1,8029,8030,8031,1,2,0
2302,2,1,8031,8031,8032,0,1,0
2303,2,1,8033,8033,8034,0,1,1
2304,6,3,8039,8039,8042,0,3,5
2305,5,1,8044,8044,8045,0,1,2
2306,1,1,8045,8045,8046,0,1,0
2307,2,1,8047,8047,8048,0,1,1
2308,6,1,8053,8053,8054,0,1,5
2309,6,2,8059,8059,8061,0,2,5
2310,2,2,8061,8061,8063,0,2,0
2311,5,2,8066,8066,8068,0,2,3
2312,1,1,8067,8068,8069,1,2,0
2313,4,3,8071,8071,8074,0,3,2
2314,2,3,8073,8074,8077,1,4,0
2315,5,1,8078,8078,8079,0,1,1
2316,3,2,8081,8081,8083,0,2,2
2317,6,2,8087,8087,8089,0,2,4
2318,3,3,8090,8090,8093,0,3,1
2319,5,1,8095,8095,8096,0,1,2
2320,4,1,8099,8099,8100,0,1,3
2321,6,1,8105,8105,8106,0,1,5
2322,2,3,8107,8107,8110,0,3,1
2323,5,3,8112,8112,8115,0,3,2
2324,5,1,8117,8117,8118,0,1,2
2325,5,1,8122,8122,8123,0,1,4
2326,1,3,8123,8123,8126,0,3,0
2327,4,1,8127,8127,8128,0,1,1
2328,4,3,8131,8131,8134,0,3,3
2329,2,3,8133,8134,8137,1,4,0
2330,6,1,8139,8139,8140,0,1,2
2331,6,2,8145,8145,8147,0,2,5
2332,3,2,8148,8148,8150,0,2,1
2333,3,1,8151,8151,8152,0,1,1
2334,6,2,8157,8157,8159,0,2,5
2335,6,2,8163,8163,8165,0,2,4
2336,3,2,8166,8166,8168,0,2,1
2337,5,2,8171,8171,8173,0,2,3
2338,2,1,8173,8173,8174,0,1,0
2339,3,3,8176,8176,8179,0,3,2
2340,6,3,8182,8182,8185,0,3,3
2341,5,3,8187,8187,8190,0,3,2
2342,2,1,8189,8190,8191,1,2,0
2343,5,2,8194,8194,8196,0,2,3
2344,5,3,8199,8199,8202,0,3,3
2345,3,2,8202,8202,8204,0,2,0
2346,6,3,8208,8208,8211,0,3,4
2347,2,1,8210,8211,8212,1,2,0
2348,2,3,8212,8212,8215,0,3,0
2349,6,3,8218,8218,8221,0,3,3
2350,3,2,8221,8221,8223,0,2,0
2351,3,1,8224,8224,8225,0,1,1
2352,4,2,8228,8228,8230,0,2,3
2353,5,2,8233,8233,8235,0,2,3
2354,4,1,8237,8237,8238,0,1,2
2355,3,1,8240,8240,8241,0,1,2
2356,5,3,8245,8245,8248,0,3,4
2357,5,3,8250,8250,8253,0,3,2
2358,1,1,8251,8253,8254,2,3,0
2359,4,1,8255,8255,8256,0,1,1
2360,2,3,8257,8257,8260,0,3,1
2361,2,1,8259,8260,8261,1,2,0
2362,4,2,8263,8263,8265,0,2,2
2363,1,3,8264,8265,8268,1,4,0
2364,6,2,8270,8270,8272,0,2,2
2365,6,1,8276,8276,8277,0,1,4
2366,5,3,8281,8281,8284,0,3,4
2367,4,1,8285,8285,8286,0,1,1
2368,4,2,8289,8289,8291,0,2,3
2369,4,2,8293,8293,8295,0,2,2
2370,5,1,8298,8298,8299,0,1,3
2371,3,1,8301,8301,8302,0,1,2
2372,4,3,8305,8305,8308,0,3,3
2373,3,2,8308,8308,8310,0,2,0
2374,3,1,8311,8311,8312,0,1,1
2375,2,3,8313,8313,8316,0,3,1
2376,1,2,8314,8316,8318,2,4,0
2377,3,1,8317,8318,8319,1,2,0
2378,6,3,8323,8323,8326,0,3,4
2379,5,2,8328,8328,8330,0,2,2
2380,1,3,8329,8330,8333,1,4,0
2381,2,3,8331,8333,8336,2,5,0
2382,5,1,8336,8336,8337,0,1,0
2383,2,3,8338,8338,8341,0,3,1
2384,2,1,8340,8341,8342,1,2,0
2385,4,2,8344,8344,8346,0,2,2
2386,4,1,8348,8348,8349,0,1,2
2387,1,3,8349,8349,8352,0,3,0
2388,2,3,8351,8352,8355,1,4,0
2389,2,2,8353,8355,8357,2,4,0
2390,1,1,8354,8357,8358,3,4,0
2391,4,3,8358,8358,8361,0,3,0
2392,3,2,8361,8361,8363,0,2,0
2393,4,3,8365,8365,8368,0,3,2
2394,2,1,8367,8368,8369,1,2,0
2395,5,1,8372,8372,8373,0,1,3
2396,3,1,8375,8375,8376,0,1,2
2397,3,2,8378,8378,8380,0,2,2
2398,4,2,8382,8382,8384,0,2,2
2399,1,1,8383,8384,8385,1,2,0
2400,6,1,8389,8389,8390,0,1,4
2401,5,3,8394,8394,8397,0,3,4
2402,2,2,8396,8397,8399,1,3,0
2403,5,3,8401,8401,8404,0,3,2
2404,3,2,8404,8404,8406,0,2,0
2405,2,2,8406,8406,8408,0,2,0
2406,1,3,8407,8408,8411,1,4,0
2407,3,1,8410,8411,8412,1,2,0
2408,4,2,8414,8414,8416,0,2,2
2409,5,2,8419,8419,8421,0,2,3
2410,1,2,8420,8421,8423,1,3,0
2411,2,3,8422,8423,8426,1,4,0
2412,5,3,8427,8427,8430,0,3,1
2413,4,2,8431,8431,8433,0,2,1
2414,5,3,8436,8436,8439,0,3,3
2415,3,2,8439,8439,8441,0,2,0
2416,5,1,8444,8444,8445,0,1,3
2417,6,2,8450,8450,8452,0,2,5
2418,2,2,8452,8452,8454,0,2,0
2419,2,2,8454,8454,8456,0,2,0
2420,6,2,8460,8460,8462,0,2,4
2421,6,3,8466,8466,8469,0,3,4
2422,1,1,8467,8469,8470,2,3,0
2423,4,2,8471,8471,8473,0,2,1
2424,2,2,8473,8473,8475,0,2,0
2425,1,1,8474,8475,8476,1,2,0
2426,2,1,8476,8476,8477,0,1,0
2427,2,1,8478,8478,8479,0,1,1
2428,2,2,8480,8480,8482,0,2,1
2429,1,3,8481,8482,8485,1,4,0
2430,4,1,8485,8485,8486,0,1,0
2431,2,2,8487,8487,8489,0,2,1
2432,1,1,8488,8489,8490,1,2,0
2433,4,1,8492,8492,8493,0,1,2
2434,3,1,8495,8495,8496,0,1,2
2435,5,3,8500,8500,8503,0,3,4
2436,5,1,8505,8505,8506,0,1,2
2437,4,3,8509,8509,8512,0,3,3
2438,2,2,8511,8512,8514,1,3,0
2439,4,3,8515,8515,8518,0,3,1
2440,4,1,8519,8519,8520,0,1,1
2441,6,3,8525,8525,8528,0,3,5
2442,6,1,8531,8531,8532,0,1,3
2443,6,2,8537,8537,8539,0,2,5
2444,5,1,8542,8542,8543,0,1,3
2445,4,2,8546,8546,8548,0,2,3
2446,4,1,8550,8550,8551,0,1,2
2447,2,1,8552,8552,8553,0,1,1
2448,3,3,8555,8555,8558,0,3,2
2449,4,3,8559,8559,8562,0,3,1
2450,2,3,8561,8562,8565,1,4,0
2451,5,2,8566,8566,8568,0,2,1
2452,3,2,8569,8569,8571,0,2,1
2453,4,1,8573,8573,8574,0,1,2
2454,4,3,8577,8577,8580,0,3,3
2455,1,1,8578,8580,8581,2,3,0
2456,2,3,8580,8581,8584,1,4,0
2457,5,3,8585,8585,8588,0,3,1
2458,3,2,8588,8588,8590,0,2,0
2459,4,2,8592,8592,8594,0,2,2
2460,3,3,8595,8595,8598,0,3,1
2461,2,1,8597,8598,8599,1,2,0
2462,1,3,8598,8599,8602,1,4,0
2463,5,3,8603,8603,8606,0,3,1
2464,6,3,8609,8609,8612,0,3,3
2465,6,3,8615,8615,8618,0,3,3
2466,3,2,8618,8618,8620,0,2,0
2467,5,2,8623,8623,8625,0,2,3
2468,1,1,8624,8625,8626,1,2,0
2469,4,2,8628,8628,8630,0,2,2
2470,3,1,8631,8631,8632,0,1,1
2471,1,3,8632,8632,8635,0,3,0
2472,1,1,8633,8635,8636,2,3,0
2473,3,1,8636,8636,8637,0,1,0
2474,6,3,8642,8642,8645,0,3,5
2475,5,1,8647,8647,8648,0,1,2
2476,6,1,8653,8653,8654,0,1,5
2477,1,2,8654,8654,8656,0,2,0
2478,4,3,8658,8658,8661,0,3,2
2479,4,3,8662,8662,8665,0,3,1
2480,1,3,8663,8665,8668,2,5,0
2481,1,3,8664,8668,8671,4,7,0
2482,5,1,8669,8671,8672,2,3,0
2483,1,2,8670,8672,8674,2,4,0
2484,2,1,8672,8674,8675,2,3,0
2485,5,3,8677,8677,8680,0,3,2
2486,4,3,8681,8681,8684,0,3,1
2487,3,3,8684,8684,8687,0,3,0
2488,4,3,8688,8688,8691,0,3,1
2489,6,2,8694,8694,8696,0,2,3
2490,6,3,8700,8700,8703,0,3,4
2491,1,1,8701,8703,8704,2,3,0
2492,4,1,8705,8705,8706,0,1,1
2493,6,3,8711,8711,8714,0,3,5
2494,6,2,8717,8717,8719,0,2,3
2495,1,2,8718,8719,8721,1,3,0
2496,5,3,8723,8723,8726,0,3,2
2497,4,1,8727,8727,8728,0,1,1
2498,2,1,8729,8729,8730,0,1,1
2499,6,3,8735,8735,8738,0,3,5
2500,4,1,8739,8739,8740,0,1,1
2501,6,1,8745,8745,8746,0,1,5
2502,6,2,8751,8751,8753,0,2,5
2503,5,2,8756,8756,8758,0,2,3
2504,6,2,8762,8762,8764,0,2,4
2505,5,3,8767,8767,8770,0,3,3
2506,1,1,8768,8770,8771,2,3,0
2507,2,1,8770,8771,8772,1,2,0
2508,4,1,8774,8774,8775,0,1,2
2509,2,3,8776,8776,8779,0,3,1
2510,3,1,8779,8779,8780,0,1,0
2511,2,1,8781,8781,8782,0,1,1
2512,5,3,8786,8786,8789,0,3,4
2513,5,2,8791,8791,8793,0,2,2
2514,2,2,8793,8793,8795,0,2,0
2515,3,2,8796,8796,8798,0,2,1
2516,3,1,8799,8799,8800,0,1,1
2517,2,3,8801,8801,8804,0,3,1
2518,2,2,8803,8804,8806,1,3,0
2519,1,2,8804,8806,8808,2,4,0
2520,5,1,8809,8809,8810,0,1,1
2521,1,3,8810,8810,8813,0,3,0
2522,1,2,8811,8813,8815,2,4,0
2523,3,3,8814,8815,8818,1,4,0
2524,1,3,8815,8818,8821,3,6,0
2525,1,1,8816,8821,8822,5,6,0
2526,1,2,8817,8822,8824,5,7,0
2527,3,2,8820,8824,8826,4,6,0
2528,3,3,8823,8826,8829,3,6,0
2529,5,2,8828,8829,8831,1,3,0
2530,6,1,8834,8834,8835,0,1,3
2531,1,2,8835,8835,8837,0,2,0
2532,6,2,8841,8841,8843,0,2,4
2533,5,2,8846,8846,8848,0,2,3
2534,6,1,8852,8852,8853,0,1,4
2535,2,2,8854,8854,8856,0,2,1
2536,6,2,8860,8860,8862,0,2,4
2537,3,1,8863,8863,8864,0,1,1
2538,5,1,8868,8868,8869,0,1,4
2539,3,3,8871,8871,8874,0,3,2
2540,6,3,8877,8877,8880,0,3,3
2541,1,1,8878,8880,8881,2,3,0
2542,1,2,8879,8881,8883,2,4,0
2543,6,1,8885,8885,8886,0,1,2
2544,5,1,8890,8890,8891,0,1,4
2545,4,3,8894,8894,8897,0,3,3
2546,2,2,8896,8897,8899,1,3,0
2547,3,2,8899,8899,8901,0,2,0
2548,2,2,8901,8901,8903,0,2,0
2549,6,3,8907,8907,8910,0,3,4
2550,1,3,8908,8910,8913,2,5,0
2551,4,1,8912,8913,8914,1,2,0
2552,6,1,8918,8918,8919,0,1,4
2553,6,3,8924,8924,8927,0,3,5
2554,2,3,8926,8927,8930,1,4,0
2555,4,1,8930,8930,8931,0,1,0
2556,4,2,8934,8934,8936,0,2,3
2557,1,2,8935,8936,8938,1,3,0
2558,4,1,8939,8939,8940,0,1,1
2559,6,1,8945,8945,8946,0,1,5
2560,3,2,8948,8948,8950,0,2,2
2561,4,1,8952,8952,8953,0,1,2
2562,4,1,8956,8956,8957,0,1,3
2563,6,2,8962,8962,8964,0,2,5
2564,5,1,8967,8967,8968,0,1,3
2565,6,2,8973,8973,8975,0,2,5
2566,4,1,8977,8977,8978,0,1,2
2567,2,2,8979,8979,8981,0,2,1
2568,5,3,8984,8984,8987,0,3,3
2569,6,1,8990,8990,8991,0,1,3
2570,2,2,8992,8992,8994,0,2,1
2571,1,1,8993,8994,8995,1,2,0
2572,5,3,8998,8998,9001,0,3,3
2573,1,3,8999,9001,9004,2,5,0
2574,1,2,9000,9004,9006,4,6,0
2575,5,1,9005,9006,9007,1,2,0
2576,2,2,9007,9007,9009,0,2,0
2577,3,3,9010,9010,9013,0,3,1
2578,1,1,9011,9013,9014,2,3,0
2579,6,1,9017,9017,9018,0,1,3
2580,2,1,9019,9019,9020,0,1,1
2581,3,3,9022,9022,9025,0,3,2
2582,2,2,9024,9025,9027,1,3,0
2583,2,1,9026,9027,9028,1,2,0
2584,4,3,9030,9030,9033,0,3,2
2585,5,1,9035,9035,9036,0,1,2
2586,1,1,9036,9036,9037,0,1,0
2587,1,3,9037,9037,9040,0,3,0
2588,6,3,9043,9043,9046,0,3,3
2589,2,2,9045,9046,9048,1,3,0
2590,2,2,9047,9048,9050,1,3,0
2591,1,2,9048,9050,9052,2,4,0
2592,3,2,9051,9052,9054,1,3,0
2593,2,3,9053,9054,9057,1,4,0
2594,3,1,9056,9057,9058,1,2,0
2595,2,1,9058,9058,9059,0,1,0
2596,1,3,9059,9059,9062,0,3,0
2597,6,1,9065,9065,9066,0,1,3
2598,6,2,9071,9071,9073,0,2,5
2599,2,2,9073,9073,9075,0,2,0
2600,2,1,9075,9075,9076,0,1,0
2601,2,1,9077,9077,9078,0,1,1
2602,5,3,9082,9082,9085,0,3,4
2603,3,3,9085,9085,9088,0,3,0
2604,1,2,9086,9088,9090,2,4,0
2605,1,1,9087,9090,9091,3,4,0
2606,1,3,9088,9091,9094,3,6,0
2607,1,1,9089,9094,9095,5,6,0
2608,4,2,9093,9095,9097,2,4,0
2609,3,3,9096,9097,9100,1,4,0
2610,5,3,9101,9101,9104,0,3,1
2611,5,3,9106,9106,9109,0,3,2
2612,3,3,9109,9109,9112,0,3,0
2613,5,2,9114,9114,9116,0,2,2
2614,5,2,9119,9119,9121,0,2,3
2615,2,2,9121,9121,9123,0,2,0
2616,3,3,9124,9124,9127,0,3,1
2617,2,2,9126,9127,9129,1,3,0
2618,6,1,9132,9132,9133,0,1,3
2619,6,2,9138,9138,9140,0,2,5
2620,4,3,9142,9142,9145,0,3,2
2621,4,3,9146,9146,9149,0,3,1
2622,6,2,9152,9152,9154,0,2,3
2623,3,1,9155,9155,9156,0,1,1
2624,6,1,9161,9161,9162,0,1,5
2625,6,3,9167,9167,9170,0,3,5
2626,4,3,9171,9171,9174,0,3,1
2627,5,1,9176,9176,9177,0,1,2
2628,1,1,9177,9177,9178,0,1,0
2629,3,3,9180,9180,9183,0,3,2
2630,1,3,9181,9183,9186,2,5,0
2631,5,1,9186,9186,9187,0,1,0
2632,3,2,9189,9189,9191,0,2,2
2633,2,2,9191,9191,9193,0,2,0
2634,1,1,9192,9193,9194,1,2,0
2635,2,2,9194,9194,9196,0,2,0
2636,5,2,9199,9199,9201,0,2,3
2637,4,2,9203,9203,9205,0,2,2
2638,3,1,9206,9206,9207,0,1,1
2639,6,1,9212,9212,9213,0,1,5
2640,5,1,9217,9217,9218,0,1,4
2641,2,3,9219,9219,9222,0,3,1
2642,6,3,9225,9225,9228,0,3,3
2643,1,1,9226,9228,9229,2,3,0
2644,3,3,9229,9229,9232,0,3,0
2645,5,1,9234,9234,9235,0,1,2
2646,6,3,9240,9240,9243,0,3,5
2647,5,2,9245,9245,9247,0,2,2
2648,4,3,9249,9249,9252,0,3,2
2649,6,2,9255,9255,9257,0,2,3
2650,5,3,9260,9260,9263,0,3,3
2651,2,3,9262,9263,9266,1,4,0
2652,3,2,9265,9266,9268,1,3,0
2653,5,2,9270,9270,9272,0,2,2
2654,1,1,9271,9272,9273,1,2,0
2655,1,3,9272,9273,9276,1,4,0
2656,2,2,9274,9276,9278,2,4,0
2657,2,2,9276,9278,9280,2,4,0
2658,1,2,9277,9280,9282,3,5,0
2659,2,3,9279,9282,9285,3,6,0
2660,6,2,9285,9285,9287,0,2,0
2661,5,3,9290,9290,9293,0,3,3
2662,6,3,9296,9296,9299,0,3,3
2663,1,1,9297,9299,9300,2,3,0
2664,5,2,9302,9302,9304,0,2,2
2665,6,3,9308,9308,9311,0,3,4
2666,1,2,9309,9311,9313,2,4,0
2667,4,2,9313,9313,9315,0,2,0
2668,2,3,9315,9315,9318,0,3,0
2669,4,1,9319,9319,9320,0,1,1
2670,3,3,9322,9322,9325,0,3,2
2671,5,2,9327,9327,9329,0,2,2
2672,4,1,9331,9331,9332,0,1,2
2673,6,3,9337,9337,9340,0,3,5
2674,4,2,9341,9341,9343,0,2,1
2675,3,2,9344,9344,9346,0,2,1
2676,5,2,9349,9349,9351,0,2,3
2677,3,2,9352,9352,9354,0,2,1
2678,1,2,9353,9354,9356,1,3,0
2679,3,3,9356,9356,9359,0,3,0
2680,4,1,9360,9360,9361,0,1,1
2681,2,2,9362,9362,9364,0,2,1
2682,3,2,9365,9365,9367,0,2,1
2683,2,1,9367,9367,9368,0,1,0
2684,4,2,9371,9371,9373,0,2,3
2685,4,1,9375,9375,9376,0,1,2
2686,6,1,9381,9381,9382,0,1,5
2687,1,3,9382,9382,9385,0,3,0
2688,5,2,9387,9387,9389,0,2,2
2689,2,1,9389,9389,9390,0,1,0
2690,2,1,9391,9391,9392,0,1,1
2691,6,1,9397,9397,9398,0,1,5
2692,2,3,9399,9399,9402,0,3,1
2693,5,1,9404,9404,9405,0,1,2
2694,3,1,9407,9407,9408,0,1,2
2695,6,3,9413,9413,9416,0,3,5
2696,3,3,9416,9416,9419,0,3,0
2697,1,3,9417,9419,9422,2,5,0
2698,3,2,9420,9422,9424,2,4,0
2699,5,1,9425,9425,9426,0,1,1
2700,6,3,9431,9431,9434,0,3,5
2701,3,3,9434,9434,9437,0,3,0
2702,1,2,9435,9437,9439,2,4,0
2703,1,2,9436,9439,9441,3,5,0
2704,6,2,9442,9442,9444,0,2,1
2705,3,3,9445,9445,9448,0,3,1
2706,4,2,9449,9449,9451,0,2,1
2707,2,3,9451,9451,9454,0,3,0
2708,1,2,9452,9454,9456,2,4,0
2709,5,1,9457,9457,9458,0,1,1
2710,3,1,9460,9460,9461,0,1,2
2711,1,2,9461,9461,9463,0,2,0
2712,3,3,9464,9464,9467,0,3,1
2713,1,2,9465,9467,9469,2,4,0
2714,3,3,9468,9469,9472,1,4,0
2715,2,2,9470,9472,9474,2,4,0
2716,6,2,9476,9476,9478,0,2,2
2717,2,2,9478,9478,9480,0,2,0
2718,6,1,9484,9484,9485,0,1,4
2719,1,1,9485,9485,9486,0,1,0
2720,4,3,9489,9489,9492,0,3,3
2721,4,3,9493,9493,9496,0,3,1
2722,4,2,9497,9497,9499,0,2,1
2723,4,2,9501,9501,9503,0,2,2
2724,6,2,9507,9507,9509,0,2,4
2725,6,3,9513,9513,9516,0,3,4
2726,6,2,9519,9519,9521,0,2,3
2727,4,3,9523,9523,9526,0,3,2
2728,4,1,9527,9527,9528,0,1,1
2729,3,1,9530,9530,9531,0,1,2
2730,2,1,9532,9532,9533,0,1,1
2731,5,2,9537,9537,9539,0,2,4
2732,5,2,9542,9542,9544,0,2,3
2733,6,2,9548,9548,9550,0,2,4
2734,3,3,9551,9551,9554,0,3,1
2735,2,3,9553,9554,9557,1,4,0
2736,2,1,9555,9557,9558,2,3,0
2737,4,1,9559,9559,9560,0,1,1
2738,1,1,9560,9560,9561,0,1,0
2739,2,1,9562,9562,9563,0,1,1
2740,4,1,9566,9566,9567,0,1,3
2741,1,1,9567,9567,9568,0,1,0
2742,6,3,9573,9573,9576,0,3,5
2743,4,3,9577,9577,9580,0,3,1
2744,5,1,9582,9582,9583,0,1,2
2745,4,2,9586,9586,9588,0,2,3
2746,4,2,9590,9590,9592,0,2,2
2747,2,1,9592,9592,9593,0,1,0
2748,1,3,9593,9593,9596,0,3,0
2749,4,3,9597,9597,9600,0,3,1
2750,3,2,9600,9600,9602,0,2,0
2751,1,3,9601,9602,9605,1,4,0
2752,3,3,9604,9605,9608,1,4,0
2753,2,3,9606,9608,9611,2,5,0
2754,5,2,9611,9611,9613,0,2,0
2755,3,3,9614,9614,9617,0,3,1
2756,4,2,9618,9618,9620,0,2,1
2757,5,2,9623,9623,9625,0,2,3
2758,2,1,9625,9625,9626,0,1,0
2759,6,1,9631,9631,9632,0,1,5
2760,1,1,9632,9632,9633,0,1,0
2761,2,1,9634,9634,9635,0,1,1
2762,3,3,9637,9637,9640,0,3,2
2763,2,3,9639,9640,9643,1,4,0
2764,2,3,9641,9643,9646,2,5,0
2765,3,1,9644,9646,9647,2,3,0
2766,5,2,9649,9649,9651,0,2,2
2767,4,2,9653,9653,9655,0,2,2
2768,4,3,9657,9657,9660,0,3,2
2769,1,2,9658,9660,9662,2,4,0
2770,3,1,9661,9662,9663,1,2,0
2771,2,3,9663,9663,9666,0,3,0
2772,5,1,9668,9668,9669,0,1,2
2773,1,3,9669,9669,9672,0,3,0
2774,4,1,9673,9673,9674,0,1,1
2775,2,1,9675,9675,9676,0,1,1
2776,2,2,9677,9677,9679,0,2,1
2777,5,1,9682,9682,9683,0,1,3
2778,4,3,9686,9686,9689,0,3,3
2779,1,1,9687,9689,9690,2,3,0
2780,5,3,9692,9692,9695,0,3,2
2781,5,2,9697,9697,9699,0,2,2
2782,5,2,9702,9702,9704,0,2,3
2783,3,3,9705,9705,9708,0,3,1
2784,1,3,9706,9708,9711,2,5,0
2785,2,1,9708,9711,9712,3,4,0
2786,6,3,9714,9714,9717,0,3,2
2787,4,3,9718,9718,9721,0,3,1
2788,1,1,9719,9721,9722,2,3,0
2789,3,2,9722,9722,9724,0,2,0
2790,2,1,9724,9724,9725,0,1,0
2791,1,2,9725,9725,9727,0,2,0
2792,6,3,9731,9731,9734,0,3,4
2793,5,1,9736,9736,9737,0,1,2
2794,4,1,9740,9740,9741,0,1,3
2795,1,1,9741,9741,9742,0,1,0
2796,1,2,9742,9742,9744,0,2,0
2797,5,3,9747,9747,9750,0,3,3
2798,6,1,9753,9753,9754,0,1,3
2799,1,2,9754,9754,9756,0,2,0
2800,1,2,9755,9756,9758,1,3,0
2801,3,1,9758,9758,9759,0,1,0
2802,6,1,9764,9764,9765,0,1,5
2803,2,3,9766,9766,9769,0,3,1
2804,3,2,9769,9769,9771,0,2,0
2805,2,1,9771,9771,9772,0,1,0
2806,5,3,9776,9776,9779,0,3,4
2807,3,1,9779,9779,9780,0,1,0
2808,3,2,9782,9782,9784,0,2,2
2809,2,3,9784,9784,9787,0,3,0
2810,1,2,9785,9787,9789,2,4,0
2811,5,1,9790,9790,9791,0,1,1
2812,5,3,9795,9795,9798,0,3,4
2813,4,2,9799,9799,9801,0,2,1
2814,2,3,9801,9801,9804,0,3,0
2815,5,2,9806,9806,9808,0,2,2
2816,5,3,9811,9811,9814,0,3,3
2817,5,2,9816,9816,9818,0,2,2
2818,4,3,9820,9820,9823,0,3,2
2819,1,3,9821,9823,9826,2,5,0
2820,4,2,9825,9826,9828,1,3,0
2821,1,1,9826,9828,9829,2,3,0
2822,2,2,9828,9829,9831,1,3,0
2823,2,1,9830,9831,9832,1,2,0
2824,6,3,9836,9836,9839,0,3,4
2825,6,1,9842,9842,9843,0,1,3
2826,5,1,9847,9847,9848,0,1,4
2827,2,1,9849,9849,9850,0,1,1
2828,4,1,9853,9853,9854,0,1,3
2829,3,3,9856,9856,9859,0,3,2
2830,4,3,9860,9860,9863,0,3,1
2831,3,2,9863,9863,9865,0,2,0
2832,6,2,9869,9869,9871,0,2,4
2833,5,1,9874,9874,9875,0,1,3
2834,2,3,9876,9876,9879,0,3,1
2835,3,3,9879,9879,9882,0,3,0
2836,2,2,9881,9882,9884,1,3,0
2837,1,3,9882,9884,9887,2,5,0
2838,5,1,9887,9887,9888,0,1,0
2839,3,3,9890,9890,9893,0,3,2
2840,3,3,9893,9893,9896,0,3,0
2841,3,2,9896,9896,9898,0,2,0
2842,3,2,9899,9899,9901,0,2,1
2843,5,3,9904,9904,9907,0,3,3
2844,1,2,9905,9907,9909,2,4,0
2845,1,3,9906,9909,9912,3,6,0
2846,3,2,9909,9912,9914,3,5,0
2847,2,3,9911,9914,9917,3,6,0
2848,1,2,9912,9917,9919,5,7,0
2849,5,2,9917,9919,9921,2,4,0
2850,3,2,9920,9921,9923,1,3,0
2851,4,1,9924,9924,9925,0,1,1
2852,1,2,9925,9925,9927,0,2,0
2853,2,1,9927,9927,9928,0,1,0
2854,5,3,9932,9932,9935,0,3,4
2855,1,1,9933,9935,9936,2,3,0
2856,2,3,9935,9936,9939,1,4,0
2857,6,2,9941,9941,9943,0,2,2
2858,1,1,9942,9943,9944,1,2,0
2859,4,2,9946,9946,9948,0,2,2
2860,2,1,9948,9948,9949,0,1,0
2861,2,2,9950,9950,9952,0,2,1
2862,2,3,9952,9952,9955,0,3,0
2863,1,1,9953,9955,9956,2,3,0
2864,6,2,9959,9959,9961,0,2,3
2865,5,1,9964,9964,9965,0,1,3
2866,3,1,9967,9967,9968,0,1,2
2867,5,2,9972,9972,9974,0,2,4
2868,6,2,9978,9978,9980,0,2,4
2869,1,2,9979,9980,9982,1,3,0
2870,3,2,9982,9982,9984,0,2,0
2871,6,2,9988,9988,9990,0,2,4
2872,6,1,9994,9994,9995,0,1,4
2873,4,1,9998,9998,9999,0,1,3
2874,6,2,10004,10004,10006,0,2,5
2875,5,3,10009,10009,10012,0,3,3
2876,6,3,10015,10015,10018,0,3,3
2877,4,2,10019,10019,10021,0,2,1
2878,1,3,10020,10021,10024,1,4,0
2879,1,2,10021,10024,10026,3,5,0
2880,3,3,10024,10026,10029,2,5,0
2881,3,3,10027,10029,10032,2,5,0
2882,6,3,10033,10033,10036,0,3,1
2883,6,1,10039,10039,10040,0,1,3
2884,4,3,10043,10043,10046,0,3,3
2885,1,1,10044,10046,10047,2,3,0
2886,3,3,10047,10047,10050,0,3,0
2887,1,3,10048,10050,10053,2,5,0
2888,5,3,10053,10053,10056,0,3,0
2889,2,1,10055,10056,10057,1,2,0
2890,3,3,10058,10058,10061,0,3,1
2891,3,1,10061,10061,10062,0,1,0
2892,4,3,10065,10065,10068,0,3,3
2893,6,3,10071,10071,10074,0,3,3
2894,3,1,10074,10074,10075,0,1,0
2895,5,1,10079,10079,10080,0,1,4
2896,1,1,10080,10080,10081,0,1,0
2897,6,3,10086,10086,10089,0,3,5
2898,2,2,10088,10089,10091,1,3,0
2899,3,2,10091,10091,10093,0,2,0
2900,2,1,10093,10093,10094,0,1,0
2901,6,2,10099,10099,10101,0,2,5
2902,2,1,10101,10101,10102,0,1,0
2903,1,3,10102,10102,10105,0,3,0
2904,6,1,10108,10108,10109,0,1,3
2905,4,1,10112,10112,10113,0,1,3
2906,1,3,10113,10113,10116,0,3,0
2907,2,2,10115,10116,10118,1,3,0
2908,1,3,10116,10118,10121,2,5,0
2909,5,2,10121,10121,10123,0,2,0
2910,4,2,10125,10125,10127,0,2,2
2911,4,2,10129,10129,10131,0,2,2
2912,1,3,10130,10131,10134,1,4,0
2913,6,3,10136,10136,10139,0,3,2
2914,2,2,10138,10139,10141,1,3,0
2915,6,2,10144,10144,10146,0,2,3
2916,4,2,10148,10148,10150,0,2,2
2917,5,2,10153,10153,10155,0,2,3
2918,6,1,10159,10159,10160,0,1,4
2919,4,3,10163,10163,10166,0,3,3
2920,4,3,10167,10167,10170,0,3,1
2921,1,1,10168,10170,10171,2,3,0
2922,1,2,10169,10171,10173,2,4,0
2923,3,1,10172,10173,10174,1,2,0
2924,1,2,10173,10174,10176,1,3,0
2925,6,3,10179,10179,10182,0,3,3
2926,4,3,10183,10183,10186,0,3,1
2927,6,1,10189,10189,10190,0,1,3
2928,6,2,10195,10195,10197,0,2,5
2929,4,1,10199,10199,10200,0,1,2
2930,5,3,10204,10204,10207,0,3,4
2931,4,2,10208,10208,10210,0,2,1
2932,6,3,10214,10214,10217,0,3,4
2933,3,1,10217,10217,10218,0,1,0
2934,1,3,10218,10218,10221,0,3,0
2935,6,2,10224,10224,10226,0,2,3
2936,3,3,10227,10227,10230,0,3,1
2937,5,2,10232,10232,10234,0,2,2
2938,6,3,10238,10238,10241,0,3,4
2939,2,1,10240,10241,10242,1,2,0
2940,3,3,10243,10243,10246,0,3,1
2941,5,1,10248,10248,10249,0,1,2
2942,5,2,10253,10253,10255,0,2,4
2943,6,2,10259,10259,10261,0,2,4
2944,5,1,10264,10264,10265,0,1,3
2945,3,3,10267,10267,10270,0,3,2
2946,4,2,10271,10271,10273,0,2,1
2947,2,1,10273,10273,10274,0,1,0
2948,1,1,10274,10274,10275,0,1,0
2949,5,1,10279,10279,10280,0,1,4
2950,6,3,10285,10285,10288,0,3,5
2951,4,1,10289,10289,10290,0,1,1
2952,3,3,10292,10292,10295,0,3,2
2953,5,3,10297,10297,10300,0,3,2
2954,3,1,10300,10300,10301,0,1,0
2955,5,2,10305,10305,10307,0,2,4
2956,4,1,10309,10309,10310,0,1,2
2957,4,3,10313,10313,10316,0,3,3
2958,4,2,10317,10317,10319,0,2,1
2959,2,3,10319,10319,10322,0,3,0
2960,6,1,10325,10325,10326,0,1,3
2961,2,1,10327,10327,10328,0,1,1
2962,5,3,10332,10332,10335,0,3,4
2963,2,3,10334,10335,10338,1,4,0
2964,3,1,10337,10338,10339,1,2,0
2965,6,2,10343,10343,10345,0,2,4
2966,4,2,10347,10347,10349,0,2,2
2967,2,2,10349,10349,10351,0,2,0
2968,4,2,10353,10353,10355,0,2,2
2969,4,1,10357,10357,10358,0,1,2
2970,3,3,10360,10360,10363,0,3,2
2971,2,1,10362,10363,10364,1,2,0
2972,1,2,10363,10364,10366,1,3,0
2973,3,2,10366,10366,10368,0,2,0
2974,3,3,10369,10369,10372,0,3,1
2975,2,1,10371,10372,10373,1,2,0
2976,2,3,10373,10373,10376,0,3,0
2977,2,2,10375,10376,10378,1,3,0
2978,6,2,10381,10381,10383,0,2,3
2979,6,3,10387,10387,10390,0,3,4
2980,3,3,10390,10390,10393,0,3,0
2981,3,3,10393,10393,10396,0,3,0
2982,5,2,10398,10398,10400,0,2,2
2983,1,3,10399,10400,10403,1,4,0
2984,2,1,10401,10403,10404,2,3,0
2985,1,1,10402,10404,10405,2,3,0
2986,1,1,10403,10405,10406,2,3,0
2987,1,2,10404,10406,10408,2,4,0
2988,6,2,10410,10410,10412,0,2,2
2989,4,2,10414,10414,10416,0,2,2
2990,3,3,10417,10417,10420,0,3,1
2991,2,1,10419,10420,10421,1,2,0
2992,4,2,10423,10423,10425,0,2,2
2993,5,2,10428,10428,10430,0,2,3
2994,2,1,10430,10430,10431,0,1,0
2995,5,3,10435,10435,10438,0,3,4
2996,1,1,10436,10438,10439,2,3,0
2997,3,1,10439,10439,10440,0,1,0
2998,3,3,10442,10442,10445,0,3,2
2999,4,2,10446,10446,10448,0,2,1
3000,2,2,10448,10448,10450,0,2,0
3001,5,2,10453,10453,10455,0,2,3
3002,2,1,10455,10455,10456,0,1,0
3003,3,2,10458,10458,10460,0,2,2
3004,2,3,10460,10460,10463,0,3,0
3005,6,1,10466,10466,10467,0,1,3
3006,6,3,10472,10472,10475,0,3,5
3007,5,1,10477,10477,10478,0,1,2
3008,1,2,10478,10478,10480,0,2,0
3009,6,2,10484,10484,10486,0,2,4
3010,1,3,10485,10486,10489,1,4,0
3011,3,2,10488,10489,10491,1,3,0
3012,1,1,10489,10491,10492,2,3,0
3013,4,2,10493,10493,10495,0,2,1
3014,2,1,10495,10495,10496,0,1,0
3015,1,2,10496,10496,10498,0,2,0
3016,3,2,10499,10499,10501,0,2,1
3017,3,3,10502,10502,10505,0,3,1
3018,1,2,10503,10505,10507,2,4,0
3019,6,3,10509,10509,10512,0,3,2
3020,1,1,10510,10512,10513,2,3,0
3021,4,3,10514,10514,10517,0,3,1
3022,3,3,10517,10517,10520,0,3,0
3023,3,1,10520,10520,10521,0,1,0
3024,3,2,10523,10523,10525,0,2,2
3025,3,2,10526,10526,10528,0,2,1
3026,1,1,10527,10528,10529,1,2,0
3027,1,1,10528,10529,10530,1,2,0
3028,3,1,10531,10531,10532,0,1,1
3029,1,3,10532,10532,10535,0,3,0
3030,2,2,10534,10535,10537,1,3,0
3031,1,3,10535,10537,10540,2,5,0
3032,6,1,10541,10541,10542,0,1,1
3033,1,3,10542,10542,10545,0,3,0
3034,3,1,10545,10545,10546,0,1,0
3035,1,1,10546,10546,10547,0,1,0
3036,3,3,10549,10549,10552,0,3,2
3037,5,3,10554,10554,10557,0,3,2
3038,6,1,10560,10560,10561,0,1,3
3039,4,2,10564,10564,10566,0,2,3
3040,3,1,10567,10567,10568,0,1,1
3041,3,1,10570,10570,10571,0,1,2
3042,1,2,10571,10571,10573,0,2,0
3043,1,3,10572,10573,10576,1,4,0
3044,3,1,10575,10576,10577,1,2,0
3045,5,2,10580,10580,10582,0,2,3
3046,6,3,10586,10586,10589,0,3,4
3047,5,1,10591,10591,10592,0,1,2
3048,2,1,10593,10593,10594,0,1,1
3049,6,1,10599,10599,10600,0,1,5
3050,3,2,10602,10602,10604,0,2,2
3051,6,2,10608,10608,10610,0,2,4
3052,4,3,10612,10612,10615,0,3,2
3053,5,2,10617,10617,10619,0,2,2
3054,6,2,10623,10623,10625,0,2,4
3055,1,2,10624,10625,10627,1,3,0
3056,5,2,10629,10629,10631,0,2,2
3057,5,2,10634,10634,10636,0,2,3
3058,3,2,10637,10637,10639,0,2,1
3059,6,1,10643,10643,10644,0,1,4
3060,1,1,10644,10644,10645,0,1,0
3061,2,2,10646,10646,10648,0,2,1
3062,6,1,10652,10652,10653,0,1,4
3063,1,2,10653,10653,10655,0,2,0
3064,2,2,10655,10655,10657,0,2,0
3065,4,1,10659,10659,10660,0,1,2
3066,1,3,10660,10660,10663,0,3,0
3067,4,2,10664,10664,10666,0,2,1
3068,5,2,10669,10669,10671,0,2,3
3069,1,1,10670,10671,10672,1,2,0
3070,1,2,10671,10672,10674,1,3,0
3071,6,2,10677,10677,10679,0,2,3
3072,2,1,10679,10679,10680,0,1,0
3073,1,1,10680,10680,10681,0,1,0
3074,2,1,10682,10682,10683,0,1,1
3075,5,1,10687,10687,10688,0,1,4
3076,2,1,10689,10689,10690,0,1,1
3077,2,1,10691,10691,10692,0,1,1
3078,6,2,10697,10697,10699,0,2,5
3079,5,3,10702,10702,10705,0,3,3
3080,6,1,10708,10708,10709,0,1,3
3081,4,3,10712,10712,10715,0,3,3
3082,3,1,10715,10715,10716,0,1,0
3083,1,1,10716,10716,10717,0,1,0
3084,6,1,10722,10722,10723,0,1,5
3085,6,2,10728,10728,10730,0,2,5
3086,2,1,10730,10730,10731,0,1,0
3087,2,3,10732,10732,10735,0,3,1
3088,6,2,10738,10738,10740,0,2,3
3089,2,3,10740,10740,10743,0,3,0
3090,1,3,10741,10743,10746,2,5,0
3091,1,3,10742,10746,10749,4,7,0
3092,5,3,10747,10749,10752,2,5,0
3093,5,3,10752,10752,10755,0,3,0
3094,1,2,10753,10755,10757,2,4,0
3095,6,1,10759,10759,10760,0,1,2
3096,6,3,10765,10765,10768,0,3,5
3097,2,2,10767,10768,10770,1,3,0
3098,6,1,10773,10773,10774,0,1,3
3099,4,3,10777,10777,10780,0,3,3
3100,1,1,10778,10780,10781,2,3,0
3101,3,3,10781,10781,10784,0,3,0
3102,6,1,10787,10787,10788,0,1,3
3103,4,1,10791,10791,10792,0,1,3
3104,1,1,10792,10792,10793,0,1,0
3105,4,1,10796,10796,10797,0,1,3
3106,6,1,10802,10802,10803,0,1,5
3107,6,1,10808,10808,10809,0,1,5
3108,4,1,10812,10812,10813,0,1,3
3109,1,2,10813,10813,10815,0,2,0
3110,5,2,10818,10818,10820,0,2,3
3111,4,2,10822,10822,10824,0,2,2
3112,2,3,10824,10824,10827,0,3,0
3113,2,1,10826,10827,10828,1,2,0
3114,5,1,10831,10831,10832,0,1,3
3115,3,3,10834,10834,10837,0,3,2
3116,2,1,10836,10837,10838,1,2,0
3117,4,1,10840,10840,10841,0,1,2
3118,2,2,10842,10842,10844,0,2,1
3119,3,2,10845,10845,10847,0,2,1
3120,3,1,10848,10848,10849,0,1,1
3121,1,1,10849,10849,10850,0,1,0
3122,4,2,10853,10853,10855,0,2,3
3123,4,2,10857,10857,10859,0,2,2
3124,4,1,10861,10861,10862,0,1,2
3125,3,2,10864,10864,10866,0,2,2
3126,2,2,10866,10866,10868,0,2,0
3127,6,1,10872,10872,10873,0,1,4
3128,1,2,10873,10873,10875,0,2,0
3129,1,1,10874,10875,10876,1,2,0
3130,6,3,10880,10880,10883,0,3,4
3131,2,2,10882,10883,10885,1,3,0
3132,1,2,10883,10885,10887,2,4,0
3133,2,3,10885,10887,10890,2,5,0
3134,2,2,10887,10890,10892,3,5,0
3135,3,1,10890,10892,10893,2,3,0
3136,1,1,10891,10893,10894,2,3,0
3137,1,1,10892,10894,10895,2,3,0
3138,1,3,10893,10895,10898,2,5,0
3139,5,3,10898,10898,10901,0,3,0
3140,5,1,10903,10903,10904,0,1,2
3141,3,2,10906,10906,10908,0,2,2
3142,5,1,10911,10911,10912,0,1,3
3143,4,1,10915,10915,10916,0,1,3
3144,3,1,10918,10918,10919,0,1,2
3145,2,2,10920,10920,10922,0,2,1
3146,3,1,10923,10923,10924,0,1,1
3147,3,2,10926,10926,10928,0,2,2
3148,3,1,10929,10929,10930,0,1,1
3149,1,2,10930,10930,10932,0,2,0
3150,2,3,10932,10932,10935,0,3,0
3151,5,3,10937,10937,10940,0,3,2
3152,5,2,10942,10942,10944,0,2,2
3153,4,2,10946,10946,10948,0,2,2
3154,6,3,10952,10952,10955,0,3,4
3155,6,2,10958,10958,10960,0,2,3
3156,5,1,10963,10963,10964,0,1,3
3157,3,2,10966,10966,10968,0,2,2
3158,4,1,10970,10970,10971,0,1,2
3159,1,1,10971,10971,10972,0,1,0
3160,5,3,10976,10976,10979,0,3,4
3161,5,3,10981,10981,10984,0,3,2
3162,5,3,10986,10986,10989,0,3,2
3163,5,3,10991,10991,10994,0,3,2
3164,5,2,10996,10996,10998,0,2,2
3165,3,2,10999,10999,11001,0,2,1
3166,5,1,11004,11004,11005,0,1,3
3167,5,2,11009,11009,11011,0,2,4
3168,1,1,11010,11011,11012,1,2,0
3169,5,1,11015,11015,11016,0,1,3
3170,2,2,11017,11017,11019,0,2,1
3171,3,2,11020,11020,11022,0,2,1
3172,6,1,11026,11026,11027,0,1,4
3173,5,2,11031,11031,11033,0,2,4
3174,1,3,11032,11033,11036,1,4,0
3175,1,1,11033,11036,11037,3,4,0
3176,2,1,11035,11037,11038,2,3,0
3177,4,1,11039,11039,11040,0,1,1
3178,4,2,11043,11043,11045,0,2,3
3179,6,3,11049,11049,11052,0,3,4
3180,3,2,11052,11052,11054,0,2,0
3181,1,2,11053,11054,11056,1,3,0
3182,5,3,11058,11058,11061,0,3,2
3183,1,3,11059,11061,11064,2,5,0
3184,2,1,11061,11064,11065,3,4,0
3185,5,3,11066,11066,11069,0,3,1
3186,4,1,11070,11070,11071,0,1,1
3187,4,3,11074,11074,11077,0,3,3
3188,4,2,11078,11078,11080,0,2,1
3189,5,1,11083,11083,11084,0,1,3
3190,1,2,11084,11084,11086,0,2,0
3191,1,2,11085,11086,11088,1,3,0
3192,3,1,11088,11088,11089,0,1,0
3193,3,3,11091,11091,11094,0,3,2
3194,5,1,11096,11096,11097,0,1,2
3195,1,2,11097,11097,11099,0,2,0
3196,4,2,11101,11101,11103,0,2,2
3197,5,3,11106,11106,11109,0,3,3
3198,1,3,11107,11109,11112,2,5,0
3199,4,2,11111,11112,11114,1,3,0
3200,3,2,11114,11114,11116,0,2,0
3201,2,1,11116,11116,11117,0,1,0
3202,6,2,11122,11122,11124,0,2,5
3203,4,3,11126,11126,11129,0,3,2
3204,2,1,11128,11129,11130,1,2,0
3205,2,1,11130,11130,11131,0,1,0
3206,2,2,11132,11132,11134,0,2,1
3207,2,2,11134,11134,11136,0,2,0
3208,4,1,11138,11138,11139,0,1,2
3209,5,3,11143,11143,11146,0,3,4
3210,6,2,11149,11149,11151,0,2,3
3211,6,2,11155,11155,11157,0,2,4
3212,2,3,11157,11157,11160,0,3,0
3213,6,1,11163,11163,11164,0,1,3
3214,6,2,11169,11169,11171,0,2,5
3215,1,3,11170,11171,11174,1,4,0
3216,3,1,11173,11174,11175,1,2,0
3217,1,3,11174,11175,11178,1,4,0
3218,2,2,11176,11178,11180,2,4,0
3219,2,3,11178,11180,11183,2,5,0
3220,3,3,11181,11183,11186,2,5,0
3221,6,3,11187,11187,11190,0,3,1
3222,1,3,11188,11190,11193,2,5,0
3223,3,1,11191,11193,11194,2,3,0
3224,1,1,11192,11194,11195,2,3,0
3225,4,2,11196,11196,11198,0,2,1
3226,2,1,11198,11198,11199,0,1,0
3227,6,2,11204,11204,11206,0,2,5
3228,1,2,11205,11206,11208,1,3,0
3229,6,3,11211,11211,11214,0,3,3
3230,1,2,11212,11214,11216,2,4,0
3231,4,2,11216,11216,11218,0,2,0
3232,2,1,11218,11218,11219,0,1,0
3233,1,3,11219,11219,11222,0,3,0
3234,2,2,11221,11222,11224,1,3,0
3235,5,1,11226,11226,11227,0,1,2
3236,6,3,11232,11232,11235,0,3,5
3237,1,1,11233,11235,11236,2,3,0
3238,5,3,11238,11238,11241,0,3,2
3239,5,3,11243,11243,11246,0,3,2
3240,2,1,11245,11246,11247,1,2,0
3241,3,2,11248,11248,11250,0,2,1
3242,5,3,11253,11253,11256,0,3,3
3243,4,3,11257,11257,11260,0,3,1
3244,1,1,11258,11260,11261,2,3,0
3245,6,1,11264,11264,11265,0,1,3
3246,6,3,11270,11270,11273,0,3,5
3247,1,2,11271,11273,11275,2,4,0
3248,6,3,11277,11277,11280,0,3,2
3249,5,3,11282,11282,11285,0,3,2
3250,6,3,11288,11288,11291,0,3,3
3251,2,1,11290,11291,11292,1,2,0
3252,6,1,11296,11296,11297,0,1,4
3253,1,3,11297,11297,11300,0,3,0
3254,1,3,11298,11300,11303,2,5,0
3255,6,1,11304,11304,11305,0,1,1
3256,2,3,11306,11306,11309,0,3,1
3257,2,3,11308,11309,11312,1,4,0
3258,2,3,11310,11312,11315,2,5,0
3259,1,1,11311,11315,11316,4,5,0
3260,5,1,11316,11316,11317,0,1,0
3261,3,1,11319,11319,11320,0,1,2
3262,5,2,11324,11324,11326,0,2,4
3263,4,3,11328,11328,11331,0,3,2
3264,6,1,11334,11334,11335,0,1,3
3265,5,3,11339,11339,11342,0,3,4
3266,3,1,11342,11342,11343,0,1,0
3267,6,2,11348,11348,11350,0,2,5
3268,3,2,11351,11351,11353,0,2,1
3269,6,2,11357,11357,11359,0,2,4
3270,2,3,11359,11359,11362,0,3,0
3271,5,2,11364,11364,11366,0,2,2
3272,5,2,11369,11369,11371,0,2,3
3273,6,2,11375,11375,11377,0,2,4
3274,2,3,11377,11377,11380,0,3,0
3275,1,1,11378,11380,11381,2,3,0
3276,5,3,11383,11383,11386,0,3,2
3277,3,1,11386,11386,11387,0,1,0
3278,1,3,11387,11387,11390,0,3,0
3279,3,1,11390,11390,11391,0,1,0
3280,6,3,11396,11396,11399,0,3,5
3281,1,2,11397,11399,11401,2,4,0
3282,4,1,11401,11401,11402,0,1,0
3283,3,2,11404,11404,11406,0,2,2
3284,6,2,11410,11410,11412,0,2,4
3285,2,3,11412,11412,11415,0,3,0
3286,4,3,11416,11416,11419,0,3,1
3287,2,3,11418,11419,11422,1,4,0
3288,1,1,11419,11422,11423,3,4,0
3289,1,3,11420,11423,11426,3,6,0
3290,3,2,11423,11426,11428,3,5,0
3291,2,2,11425,11428,11430,3,5,0
3292,2,2,11427,11430,11432,3,5,0
3293,5,2,11432,11432,11434,0,2,0
3294,6,1,11438,11438,11439,0,1,4
3295,5,1,11443,11443,11444,0,1,4
3296,4,1,11447,11447,11448,0,1,3
3297,1,3,11448,11448,11451,0,3,0
3298,3,3,11451,11451,11454,0,3,0
3299,5,1,11456,11456,11457,0,1,2
3300,2,1,11458,11458,11459,0,1,1
3301,5,1,11463,11463,11464,0,1,4
3302,6,1,11469,11469,11470,0,1,5
3303,6,3,11475,11475,11478,0,3,5
3304,2,1,11477,11478,11479,1,2,0
3305,3,2,11480,11480,11482,0,2,1
3306,5,2,11485,11485,11487,0,2,3
3307,4,2,11489,11489,11491,0,2,2
3308,6,2,11495,11495,11497,0,2,4
3309,6,3,11501,11501,11504,0,3,4
3310,1,1,11502,11504,11505,2,3,0
3311,3,1,11505,11505,11506,0,1,0
3312,2,3,11507,11507,11510,0,3,1
3313,6,3,11513,11513,11516,0,3,3
3314,5,1,11518,11518,11519,0,1,2
3315,3,3,11521,11521,11524,0,3,2
3316,4,3,11525,11525,11528,0,3,1
3317,3,1,11528,11528,11529,0,1,0
3318,3,1,11531,11531,11532,0,1,2
3319,6,2,11537,11537,11539,0,2,5
3320,6,3,11543,11543,11546,0,3,4
3321,1,3,11544,11546,11549,2,5,0
3322,4,3,11548,11549,11552,1,4,0
3323,5,2,11553,11553,11555,0,2,1
3324,4,1,11557,11557,11558,0,1,2
3325,6,2,11563,11563,11565,0,2,5
3326,4,1,11567,11567,11568,0,1,2
3327,5,2,11572,11572,11574,0,2,4
3328,1,2,11573,11574,11576,1,3,0
3329,6,3,11579,11579,11582,0,3,3
3330,1,1,11580,11582,11583,2,3,0
3331,6,1,11586,11586,11587,0,1,3
3332,3,1,11589,11589,11590,0,1,2
3333,3,1,11592,11592,11593,0,1,2
3334,4,3,11596,11596,11599,0,3,3
3335,1,1,11597,11599,11600,2,3,0
3336,4,1,11601,11601,11602,0,1,1
3337,5,3,11606,11606,11609,0,3,4
3338,4,1,11610,11610,11611,0,1,1
3339,1,3,11611,11611,11614,0,3,0
3340,6,3,11617,11617,11620,0,3,3
3341,1,2,11618,11620,11622,2,4,0
3342,6,3,11624,11624,11627,0,3,2
3343,5,3,11629,11629,11632,0,3,2
3344,4,2,11633,11633,11635,0,2,1
3345,1,3,11634,11635,11638,1,4,0
3346,5,2,11639,11639,11641,0,2,1
3347,1,2,11640,11641,11643,1,3,0
3348,5,1,11645,11645,11646,0,1,2
3349,2,3,11647,11647,11650,0,3,1
3350,4,2,11651,11651,11653,0,2,1
3351,4,2,11655,11655,11657,0,2,2
3352,1,1,11656,11657,11658,1,2,0
3353,6,2,11662,11662,11664,0,2,4
3354,4,2,11666,11666,11668,0,2,2
3355,3,3,11669,11669,11672,0,3,1
3356,5,1,11674,11674,11675,0,1,2
3357,1,3,11675,11675,11678,0,3,0
3358,4,2,11679,11679,11681,0,2,1
3359,1,2,11680,11681,11683,1,3,0
3360,5,3,11685,11685,11688,0,3,2
3361,6,1,11691,11691,11692,0,1,3
3362,4,1,11695,11695,11696,0,1,3
3363,6,2,11701,11701,11703,0,2,5
3364,4,1,11705,11705,11706,0,1,2
3365,5,2,11710,11710,11712,0,2,4
3366,1,1,11711,11712,11713,1,2,0
3367,2,3,11713,11713,11716,0,3,0
3368,3,1,11716,11716,11717,0,1,0
3369,6,1,11722,11722,11723,0,1,5
3370,4,1,11726,11726,11727,0,1,3
3371,2,1,11728,11728,11729,0,1,1
3372,6,1,11734,11734,11735,0,1,5
3373,6,1,11740,11740,11741,0,1,5
3374,4,2,11744,11744,11746,0,2,3
3375,5,1,11749,11749,11750,0,1,3
3376,3,2,11752,11752,11754,0,2,2
3377,2,1,11754,11754,11755,0,1,0
3378,3,3,11757,11757,11760,0,3,2
3379,4,3,11761,11761,11764,0,3,1
3380,6,3,11767,11767,11770,0,3,3
3381,6,2,11773,11773,11775,0,2,3
3382,3,2,11776,11776,11778,0,2,1
3383,5,3,11781,11781,11784,0,3,3
3384,5,3,11786,11786,11789,0,3,2
3385,3,2,11789,11789,11791,0,2,0
3386,2,1,11791,11791,11792,0,1,0
3387,2,1,11793,11793,11794,0,1,1
3388,6,2,11799,11799,11801,0,2,5
3389,3,3,11802,11802,11805,0,3,1
3390,4,3,11806,11806,11809,0,3,1
3391,6,2,11812,11812,11814,0,2,3
3392,2,2,11814,11814,11816,0,2,0
3393,5,2,11819,11819,11821,0,2,3
3394,1,1,11820,11821,11822,1,2,0
3395,4,3,11824,11824,11827,0,3,2
3396,4,2,11828,11828,11830,0,2,1
3397,1,1,11829,11830,11831,1,2,0
3398,6,3,11835,11835,11838,0,3,4
3399,5,1,11840,11840,11841,0,1,2
3400,4,1,11844,11844,11845,0,1,3
3401,4,2,11848,11848,11850,0,2,3
3402,5,3,11853,11853,11856,0,3,3
3403,6,1,11859,11859,11860,0,1,3
3404,1,1,11860,11860,11861,0,1,0
3405,4,3,11864,11864,11867,0,3,3
3406,6,2,11870,11870,11872,0,2,3
3407,2,2,11872,11872,11874,0,2,0
3408,3,1,11875,11875,11876,0,1,1
3409,6,2,11881,11881,11883,0,2,5
3410,1,2,11882,11883,11885,1,3,0
3411,2,1,11884,11885,11886,1,2,0
3412,6,3,11890,11890,11893,0,3,4
3413,1,1,11891,11893,11894,2,3,0
3414,3,3,11894,11894,11897,0,3,0
3415,6,2,11900,11900,11902,0,2,3
3416,6,2,11906,11906,11908,0,2,4
3417,6,1,11912,11912,11913,0,1,4
3418,6,3,11918,11918,11921,0,3,5
3419,6,1,11924,11924,11925,0,1,3
3420,4,1,11928,11928,11929,0,1,3
3421,5,3,11933,11933,11936,0,3,4
3422,4,3,11937,11937,11940,0,3,1
3423,6,3,11943,11943,11946,0,3,3
3424,1,2,11944,11946,11948,2,4,0
3425,1,1,11945,11948,11949,3,4,0
3426,3,2,11948,11949,11951,1,3,0
3427,6,3,11954,11954,11957,0,3,3
3428,5,1,11959,11959,11960,0,1,2
3429,3,3,11962,11962,11965,0,3,2
3430,3,3,11965,11965,11968,0,3,0
3431,2,2,11967,11968,11970,1,3,0
3432,1,1,11968,11970,11971,2,3,0
3433,5,1,11973,11973,11974,0,1,2
3434,6,1,11979,11979,11980,0,1,5
3435,3,1,11982,11982,11983,0,1,2
3436,2,2,11984,11984,11986,0,2,1
3437,3,3,11987,11987,11990,0,3,1
3438,4,1,11991,11991,11992,0,1,1
3439,4,1,11995,11995,11996,0,1,3
3440,6,2,12001,12001,12003,0,2,5
3441,6,2,12007,12007,12009,0,2,4
3442,5,2,12012,12012,12014,0,2,3
3443,6,2,12018,12018,12020,0,2,4
3444,5,3,12023,12023,12026,0,3,3
3445,5,2,12028,12028,12030,0,2,2
3446,6,3,12034,12034,12037,0,3,4
3447,4,3,12038,12038,12041,0,3,1
3448,5,1,12043,12043,12044,0,1,2
3449,3,1,12046,12046,12047,0,1,2
3450,5,3,12051,12051,12054,0,3,4
3451,2,1,12053,12054,12055,1,2,0
3452,3,3,12056,12056,12059,0,3,1
3453,2,1,12058,12059,12060,1,2,0
3454,3,3,12061,12061,12064,0,3,1
3455,1,3,12062,12064,12067,2,5,0
3456,1,3,12063,12067,12070,4,7,0
3457,3,1,12066,12070,12071,4,5,0
3458,4,1,12070,12071,12072,1,2,0
3459,4,3,12074,12074,12077,0,3,2
3460,6,2,12080,12080,12082,0,2,3
3461,3,1,12083,12083,12084,0,1,1
3462,5,3,12088,12088,12091,0,3,4
3463,4,1,12092,12092,12093,0,1,1
3464,2,2,12094,12094,12096,0,2,1
3465,1,3,12095,12096,12099,1,4,0
3466,6,1,12101,12101,12102,0,1,2
3467,1,2,12102,12102,12104,0,2,0
3468,6,1,12108,12108,12109,0,1,4
3469,6,1,12114,12114,12115,0,1,5
3470,1,2,12115,12115,12117,0,2,0
3471,2,2,12117,12117,12119,0,2,0
3472,5,3,12122,12122,12125,0,3,3
3473,2,2,12124,12125,12127,1,3,0
3474,3,2,12127,12127,12129,0,2,0
3475,4,2,12131,12131,12133,0,2,2
3476,5,1,12136,12136,12137,0,1,3
3477,2,1,12138,12138,12139,0,1,1
3478,3,3,12141,12141,12144,0,3,2
3479,1,3,12142,12144,12147,2,5,0
3480,2,2,12144,12147,12149,3,5,0
3481,1,1,12145,12149,12150,4,5,0
3482,3,3,12148,12150,12153,2,5,0
3483,1,2,12149,12153,12155,4,6,0
3484,2,3,12151,12155,12158,4,7,0
3485,5,1,12156,12158,12159,2,3,0
3486,2,1,12158,12159,12160,1,2,0
3487,4,3,12162,12162,12165,0,3,2
3488,6,3,12168,12168,12171,0,3,3
3489,2,2,12170,12171,12173,1,3,0
3490,4,2,12174,12174,12176,0,2,1
3491,6,3,12180,12180,12183,0,3,4
3492,2,1,12182,12183,12184,1,2,0
3493,6,2,12188,12188,12190,0,2,4
3494,4,1,12192,12192,12193,0,1,2
3495,3,2,12195,12195,12197,0,2,2
3496,6,2,12201,12201,12203,0,2,4
3497,2,3,12203,12203,12206,0,3,0
3498,1,2,12204,12206,12208,2,4,0
3499,5,1,12209,12209,12210,0,1,1
3500,4,3,12213,12213,12216,0,3,3
3501,4,2,12217,12217,12219,0,2,1
3502,1,1,12218,12219,12220,1,2,0
3503,5,2,12223,12223,12225,0,2,3
3504,6,2,12229,12229,12231,0,2,4
3505,6,1,12235,12235,12236,0,1,4
3506,6,1,12241,12241,12242,0,1,5
3507,3,3,12244,12244,12247,0,3,2
3508,1,1,12245,12247,12248,2,3,0
3509,4,2,12249,12249,12251,0,2,1
3510,1,2,12250,12251,12253,1,3,0
3511,5,1,12255,12255,12256,0,1,2
3512,6,2,12261,12261,12263,0,2,5
3513,3,2,12264,12264,12266,0,2,1
3514,1,3,12265,12266,12269,1,4,0
3515,1,1,12266,12269,12270,3,4,0
3516,5,3,12271,12271,12274,0,3,1
3517,6,1,12277,12277,12278,0,1,3
3518,2,3,12279,12279,12282,0,3,1
3519,1,3,12280,12282,12285,2,5,0
3520,3,3,12283,12285,12288,2,5,0
3521,5,2,12288,12288,12290,0,2,0
3522,2,3,12290,12290,12293,0,3,0
3523,5,2,12295,12295,12297,0,2,2
3524,3,2,12298,12298,12300,0,2,1
3525,1,1,12299,12300,12301,1,2,0
3526,6,3,12305,12305,12308,0,3,4
3527,1,2,12306,12308,12310,2,4,0
3528,5,2,12311,12311,12313,0,2,1
3529,6,1,12317,12317,12318,0,1,4
3530,2,2,12319,12319,12321,0,2,1
3531,1,3,12320,12321,12324,1,4,0
3532,2,1,12322,12324,12325,2,3,0
3533,5,3,12327,12327,12330,0,3,2
3534,1,2,12328,12330,12332,2,4,0
3535,2,1,12330,12332,12333,2,3,0
3536,6,2,12336,12336,12338,0,2,3
3537,6,2,12342,12342,12344,0,2,4
3538,2,3,12344,12344,12347,0,3,0
3539,1,2,12345,12347,12349,2,4,0
3540,2,1,12347,12349,12350,2,3,0
3541,4,3,12351,12351,12354,0,3,1
3542,2,2,12353,12354,12356,1,3,0
3543,3,3,12356,12356,12359,0,3,0
3544,4,3,12360,12360,12363,0,3,1
3545,2,3,12362,12363,12366,1,4,0
3546,5,3,12367,12367,12370,0,3,1
3547,1,3,12368,12370,12373,2,5,0
3548,1,2,12369,12373,12375,4,6,0
3549,6,2,12375,12375,12377,0,2,0
3550,1,3,12376,12377,12380,1,4,0
3551,4,3,12380,12380,12383,0,3,0
3552,5,3,12385,12385,12388,0,3,2
3553,2,2,12387,12388,12390,1,3,0
3554,1,1,12388,12390,12391,2,3,0
3555,4,2,12392,12392,12394,0,2,1
3556,3,3,12395,12395,12398,0,3,1
3557,2,1,12397,12398,12399,1,2,0
3558,4,2,12401,12401,12403,0,2,2
3559,1,3,12402,12403,12406,1,4,0
3560,1,1,12403,12406,12407,3,4,0
3561,5,3,12408,12408,12411,0,3,1
3562,1,1,12409,12411,12412,2,3,0
3563,3,1,12412,12412,12413,0,1,0
3564,1,2,12413,12413,12415,0,2,0
3565,1,1,12414,12415,12416,1,2,0
3566,4,1,12418,12418,12419,0,1,2
3567,1,2,12419,12419,12421,0,2,0
3568,1,2,12420,12421,12423,1,3,0
3569,2,3,12422,12423,12426,1,4,0
3570,5,3,12427,12427,12430,0,3,1
3571,4,2,12431,12431,12433,0,2,1
3572,6,1,12437,12437,12438,0,1,4
3573,5,1,12442,12442,12443,0,1,4
3574,2,2,12444,12444,12446,0,2,1
3575,4,1,12448,12448,12449,0,1,2
3576,2,1,12450,12450,12451,0,1,1
3577,6,3,12456,12456,12459,0,3,5
3578,5,1,12461,12461,12462,0,1,2
3579,6,3,12467,12467,12470,0,3,5
3580,3,3,12470,12470,12473,0,3,0
3581,3,2,12473,12473,12475,0,2,0
3582,5,2,12478,12478,12480,0,2,3
3583,4,2,12482,12482,12484,0,2,2
3584,6,2,12488,12488,12490,0,2,4
3585,2,1,12490,12490,12491,0,1,0
3586,1,1,12491,12491,12492,0,1,0
3587,2,3,12493,12493,12496,0,3,1
3588,5,2,12498,12498,12500,0,2,2
3589,2,1,12500,12500,12501,0,1,0
3590,3,1,12503,12503,12504,0,1,2
3591,6,2,12509,12509,12511,0,2,5
3592,3,2,12512,12512,12514,0,2,1
3593,2,2,12514,12514,12516,0,2,0
3594,4,1,12518,12518,12519,0,1,2
3595,4,3,12522,12522,12525,0,3,3
3596,5,1,12527,12527,12528,0,1,2
3597,4,3,12531,12531,12534,0,3,3
3598,1,1,12532,12534,12535,2,3,0
3599,3,2,12535,12535,12537,0,2,0
3600,1,3,12536,12537,12540,1,4,0
3601,4,2,12540,12540,12542,0,2,0
3602,2,1,12542,12542,12543,0,1,0
3603,6,1,12548,12548,12549,0,1,5
3604,5,2,12553,12553,12555,0,2,4
3605,1,3,12554,12555,12558,1,4,0
3606,4,3,12558,12558,12561,0,3,0
3607,4,3,12562,12562,12565,0,3,1
3608,4,2,12566,12566,12568,0,2,1
3609,4,1,12570,12570,12571,0,1,2
3610,5,1,12575,12575,12576,0,1,4
3611,6,2,12581,12581,12583,0,2,5
3612,1,2,12582,12583,12585,1,3,0
3613,6,2,12588,12588,12590,0,2,3
3614,4,1,12592,12592,12593,0,1,2
3615,1,3,12593,12593,12596,0,3,0
3616,1,1,12594,12596,12597,2,3,0
3617,5,3,12599,12599,12602,0,3,2
3618,1,1,12600,12602,12603,2,3,0
3619,2,2,12602,12603,12605,1,3,0
3620,1,3,12603,12605,12608,2,5,0
3621,1,1,12604,12608,12609,4,5,0
3622,5,2,12609,12609,12611,0,2,0
3623,6,3,12615,12615,12618,0,3,4
3624,4,2,12619,12619,12621,0,2,1
3625,1,2,12620,12621,12623,1,3,0
3626,6,2,12626,12626,12628,0,2,3
3627,5,3,12631,12631,12634,0,3,3
3628,3,1,12634,12634,12635,0,1,0
3629,5,3,12639,12639,12642,0,3,4
3630,4,3,12643,12643,12646,0,3,1
3631,4,1,12647,12647,12648,0,1,1
3632,6,1,12653,12653,12654,0,1,5
3633,5,1,12658,12658,12659,0,1,4
3634,4,1,12662,12662,12663,0,1,3
3635,2,3,12664,12664,12667,0,3,1
3636,2,3,12666,12667,12670,1,4,0
3637,6,1,12672,12672,12673,0,1,2
3638,5,1,12677,12677,12678,0,1,4
3639,5,3,12682,12682,12685,0,3,4
3640,6,1,12688,12688,12689,0,1,3
3641,2,2,12690,12690,12692,0,2,1
3642,2,1,12692,12692,12693,0,1,0
3643,2,2,12694,12694,12696,0,2,1
3644,2,1,12696,12696,12697,0,1,0
3645,2,2,12698,12698,12700,0,2,1
3646,5,2,12703,12703,12705,0,2,3
3647,4,3,12707,12707,12710,0,3,2
3648,2,2,12709,12710,12712,1,3,0
3649,4,3,12713,12713,12716,0,3,1
3650,6,1,12719,12719,12720,0,1,3
3651,3,1,12722,12722,12723,0,1,2
3652,4,1,12726,12726,12727,0,1,3
3653,1,3,12727,12727,12730,0,3,0
3654,4,1,12731,12731,12732,0,1,1
3655,1,3,12732,12732,12735,0,3,0
3656,4,1,12736,12736,12737,0,1,1
3657,3,2,12739,12739,12741,0,2,2
3658,6,2,12745,12745,12747,0,2,4
3659,4,3,12749,12749,12752,0,3,2
3660,3,2,12752,12752,12754,0,2,0
3661,1,3,12753,12754,12757,1,4,0
3662,4,1,12757,12757,12758,0,1,0
3663,4,1,12761,12761,12762,0,1,3
3664,2,1,12763,12763,12764,0,1,1
3665,1,1,12764,12764,12765,0,1,0
3666,4,1,12768,12768,12769,0,1,3
3667,4,3,12772,12772,12775,0,3,3
3668,4,2,12776,12776,12778,0,2,1
3669,6,2,12782,12782,12784,0,2,4
3670,1,3,12783,12784,12787,1,4,0
3671,4,1,12787,12787,12788,0,1,0
3672,2,1,12789,12789,12790,0,1,1
3673,3,2,12792,12792,12794,0,2,2
3674,4,1,12796,12796,12797,0,1,2
3675,6,2,12802,12802,12804,0,2,5
3676,1,2,12803,12804,12806,1,3,0
3677,2,3,12805,12806,12809,1,4,0
3678,3,2,12808,12809,12811,1,3,0
3679,6,1,12814,12814,12815,0,1,3
3680,6,3,12820,12820,12823,0,3,5
3681,1,2,12821,12823,12825,2,4,0
3682,5,3,12826,12826,12829,0,3,1
3683,2,3,12828,12829,12832,1,4,0
3684,4,3,12832,12832,12835,0,3,0
3685,1,1,12833,12835,12836,2,3,0
3686,3,3,12836,12836,12839,0,3,0
3687,6,1,12842,12842,12843,0,1,3
3688,4,1,12846,12846,12847,0,1,3
3689,5,1,12851,12851,12852,0,1,4
3690,5,1,12856,12856,12857,0,1,4
3691,2,3,12858,12858,12861,0,3,1
3692,3,1,12861,12861,12862,0,1,0
3693,4,3,12865,12865,12868,0,3,3
3694,5,3,12870,12870,12873,0,3,2
3695,1,3,12871,12873,12876,2,5,0
3696,6,3,12877,12877,12880,0,3,1
3697,6,1,12883,12883,12884,0,1,3
3698,2,1,12885,12885,12886,0,1,1
3699,1,3,12886,12886,12889,0,3,0
3700,6,2,12892,12892,12894,0,2,3
3701,1,1,12893,12894,12895,1,2,0
3702,2,2,12895,12895,12897,0,2,0
3703,1,1,12896,12897,12898,1,2,0
3704,1,1,12897,12898,12899,1,2,0
3705,6,1,12903,12903,12904,0,1,4
3706,4,1,12907,12907,12908,0,1,3
3707,6,1,12913,12913,12914,0,1,5
3708,3,3,12916,12916,12919,0,3,2
3709,2,3,12918,12919,12922,1,4,0
3710,2,1,12920,12922,12923,2,3,0
3711,2,1,12922,12923,12924,1,2,0
3712,2,2,12924,12924,12926,0,2,0
3713,2,3,12926,12926,12929,0,3,0
3714,5,3,12931,12931,12934,0,3,2
3715,2,1,12933,12934,12935,1,2,0
3716,6,1,12939,12939,12940,0,1,4
3717,6,3,12945,12945,12948,0,3,5
3718,2,2,12947,12948,12950,1,3,0
3719,1,2,12948,12950,12952,2,4,0
3720,3,3,12951,12952,12955,1,4,0
3721,6,1,12957,12957,12958,0,1,2
3722,6,2,12963,12963,12965,0,2,5
3723,5,2,12968,12968,12970,0,2,3
3724,4,1,12972,12972,12973,0,1,2
3725,4,3,12976,12976,12979,0,3,3
3726,1,2,12977,12979,12981,2,4,0
3727,1,1,12978,12981,12982,3,4,0
3728,3,1,12981,12982,12983,1,2,0
3729,4,2,12985,12985,12987,0,2,2
3730,1,3,12986,12987,12990,1,4,0
3731,4,2,12990,12990,12992,0,2,0
3732,2,1,12992,12992,12993,0,1,0
3733,4,2,12996,12996,12998,0,2,3
3734,2,1,12998,12998,12999,0,1,0
3735,2,2,13000,13000,13002,0,2,1
3736,5,3,13005,13005,13008,0,3,3
3737,3,3,13008,13008,13011,0,3,0
3738,3,2,13011,13011,13013,0,2,0
3739,5,2,13016,13016,13018,0,2,3
3740,1,1,13017,13018,13019,1,2,0
3741,3,2,13020,13020,13022,0,2,1
3742,5,2,13025,13025,13027,0,2,3
3743,4,2,13029,13029,13031,0,2,2
3744,1,2,13030,13031,13033,1,3,0
3745,4,3,13034,13034,13037,0,3,1
3746,6,1,13040,13040,13041,0,1,3
3747,5,1,13045,13045,13046,0,1,4
3748,6,1,13051,13051,13052,0,1,5
3749,2,1,13053,13053,13054,0,1,1
3750,1,1,13054,13054,13055,0,1,0
3751,6,3,13060,13060,13063,0,3,5
3752,4,2,13064,13064,13066,0,2,1
3753,1,3,13065,13066,13069,1,4,0
3754,1,1,13066,13069,13070,3,4,0
3755,4,1,13070,13070,13071,0,1,0
3756,1,3,13071,13071,13074,0,3,0
3757,1,1,13072,13074,13075,2,3,0
3758,2,1,13074,13075,13076,1,2,0
3759,4,3,13078,13078,13081,0,3,2
3760,1,3,13079,13081,13084,2,5,0
3761,6,1,13085,13085,13086,0,1,1
3762,1,2,13086,13086,13088,0,2,0
3763,3,2,13089,13089,13091,0,2,1
3764,1,1,13090,13091,13092,1,2,0
3765,2,3,13092,13092,13095,0,3,0
3766,2,2,13094,13095,13097,1,3,0
3767,3,3,13097,13097,13100,0,3,0
3768,5,3,13102,13102,13105,0,3,2
3769,6,3,13108,13108,13111,0,3,3
3770,4,2,13112,13112,13114,0,2,1
3771,1,2,13113,13114,13116,1,3,0
3772,1,3,13114,13116,13119,2,5,0
3773,1,2,13115,13119,13121,4,6,0
3774,3,2,13118,13121,13123,3,5,0
3775,4,2,13122,13123,13125,1,3,0
3776,5,1,13127,13127,13128,0,1,2
3777,2,1,13129,13129,13130,0,1,1
3778,2,3,13131,13131,13134,0,3,1
3779,3,3,13134,13134,13137,0,3,0
3780,4,3,13138,13138,13141,0,3,1
3781,6,2,13144,13144,13146,0,2,3
3782,1,1,13145,13146,13147,1,2,0
3783,6,1,13151,13151,13152,0,1,4
3784,3,3,13154,13154,13157,0,3,2
3785,5,1,13159,13159,13160,0,1,2
3786,3,1,13162,13162,13163,0,1,2
3787,3,3,13165,13165,13168,0,3,2
3788,4,1,13169,13169,13170,0,1,1
3789,1,1,13170,13170,13171,0,1,0
3790,5,1,13175,13175,13176,0,1,4
3791,2,3,13177,13177,13180,0,3,1
3792,2,3,13179,13180,13183,1,4,0
3793,5,2,13184,13184,13186,0,2,1
3794,4,3,13188,13188,13191,0,3,2
3795,1,1,13189,13191,13192,2,3,0
3796,3,1,13192,13192,13193,0,1,0
3797,4,3,13196,13196,13199,0,3,3
3798,6,3,13202,13202,13205,0,3,3
3799,3,2,13205,13205,13207,0,2,0
3800,2,1,13207,13207,13208,0,1,0
3801,1,3,13208,13208,13211,0,3,0
3802,4,3,13212,13212,13215,0,3,1
3803,6,3,13218,13218,13221,0,3,3
3804,4,1,13222,13222,13223,0,1,1
3805,4,1,13226,13226,13227,0,1,3
3806,2,2,13228,13228,13230,0,2,1
3807,5,1,13233,13233,13234,0,1,3
3808,6,1,13239,13239,13240,0,1,5
3809,2,3,13241,13241,13244,0,3,1
3810,1,1,13242,13244,13245,2,3,0
3811,4,3,13246,13246,13249,0,3,1
3812,3,2,13249,13249,13251,0,2,0
3813,4,1,13253,13253,13254,0,1,2
3814,6,3,13259,13259,13262,0,3,5
3815,1,3,13260,13262,13265,2,5,0
3816,1,2,13261,13265,13267,4,6,0
3817,5,1,13266,13267,13268,1,2,0
3818,4,3,13270,13270,13273,0,3,2
3819,3,2,13273,13273,13275,0,2,0
3820,5,3,13278,13278,13281,0,3,3
3821,5,3,13283,13283,13286,0,3,2
3822,3,3,13286,13286,13289,0,3,0
3823,2,1,13288,13289,13290,1,2,0
3824,3,3,13291,13291,13294,0,3,1
3825,1,3,13292,13294,13297,2,5,0
3826,3,2,13295,13297,13299,2,4,0
3827,3,1,13298,13299,13300,1,2,0
3828,3,2,13301,13301,13303,0,2,1
3829,6,1,13307,13307,13308,0,1,4
3830,3,1,13310,13310,13311,0,1,2
3831,4,2,13314,13314,13316,0,2,3
3832,6,1,13320,13320,13321,0,1,4
3833,3,1,13323,13323,13324,0,1,2
3834,6,3,13329,13329,13332,0,3,5
3835,6,1,13335,13335,13336,0,1,3
3836,2,3,13337,13337,13340,0,3,1
3837,5,2,13342,13342,13344,0,2,2
3838,5,3,13347,13347,13350,0,3,3
3839,6,2,13353,13353,13355,0,2,3
3840,2,3,13355,13355,13358,0,3,0
3841,4,3,13359,13359,13362,0,3,1
3842,1,1,13360,13362,13363,2,3,0
3843,4,3,13364,13364,13367,0,3,1
3844,5,3,13369,13369,13372,0,3,2
3845,5,3,13374,13374,13377,0,3,2
3846,5,3,13379,13379,13382,0,3,2
3847,1,2,13380,13382,13384,2,4,0
3848,1,2,13381,13384,13386,3,5,0
3849,5,2,13386,13386,13388,0,2,0
3850,5,3,13391,13391,13394,0,3,3
3851,5,2,13396,13396,13398,0,2,2
3852,1,2,13397,13398,13400,1,3,0
3853,2,2,13399,13400,13402,1,3,0
3854,3,3,13402,13402,13405,0,3,0
3855,4,3,13406,13406,13409,0,3,1
3856,4,1,13410,13410,13411,0,1,1
3857,1,2,13411,13411,13413,0,2,0
3858,3,1,13414,13414,13415,0,1,1
3859,3,1,13417,13417,13418,0,1,2
3860,3,2,13420,13420,13422,0,2,2
3861,6,3,13426,13426,13429,0,3,4
3862,2,2,13428,13429,13431,1,3,0
3863,1,2,13429,13431,13433,2,4,0
3864,2,1,13431,13433,13434,2,3,0
3865,1,1,13432,13434,13435,2,3,0
3866,2,3,13434,13435,13438,1,4,0
3867,4,2,13438,13438,13440,0,2,0
3868,1,3,13439,13440,13443,1,4,0
3869,6,3,13445,13445,13448,0,3,2
3870,6,2,13451,13451,13453,0,2,3
3871,2,1,13453,13453,13454,0,1,0
3872,1,1,13454,13454,13455,0,1,0
3873,6,3,13460,13460,13463,0,3,5
3874,4,3,13464,13464,13467,0,3,1
3875,2,2,13466,13467,13469,1,3,0
3876,4,3,13470,13470,13473,0,3,1
3877,2,3,13472,13473,13476,1,4,0
3878,4,2,13476,13476,13478,0,2,0
3879,1,1,13477,13478,13479,1,2,0
3880,5,3,13482,13482,13485,0,3,3
3881,4,3,13486,13486,13489,0,3,1
3882,3,1,13489,13489,13490,0,1,0
3883,6,3,13495,13495,13498,0,3,5
3884,1,2,13496,13498,13500,2,4,0
3885,6,1,13502,13502,13503,0,1,2
3886,2,3,13504,13504,13507,0,3,1
3887,3,2,13507,13507,13509,0,2,0
3888,5,2,13512,13512,13514,0,2,3
3889,2,2,13514,13514,13516,0,2,0
3890,5,3,13519,13519,13522,0,3,3
3891,6,2,13525,13525,13527,0,2,3
3892,1,3,13526,13527,13530,1,4,0
3893,1,2,13527,13530,13532,3,5,0
3894,2,1,13529,13532,13533,3,4,0
3895,2,3,13531,13533,13536,2,5,0
3896,2,3,13533,13536,13539,3,6,0
3897,6,3,13539,13539,13542,0,3,0
3898,3,3,13542,13542,13545,0,3,0
3899,3,1,13545,13545,13546,0,1,0
3900,1,1,13546,13546,13547,0,1,0
3901,5,2,13551,13551,13553,0,2,4
3902,3,1,13554,13554,13555,0,1,1
3903,4,3,13558,13558,13561,0,3,3
3904,5,3,13563,13563,13566,0,3,2
3905,2,1,13565,13566,13567,1,2,0
3906,3,2,13568,13568,13570,0,2,1
3907,4,2,13572,13572,13574,0,2,2
3908,1,2,13573,13574,13576,1,3,0
3909,5,2,13578,13578,13580,0,2,2
3910,5,3,13583,13583,13586,0,3,3
3911,6,1,13589,13589,13590,0,1,3
3912,6,2,13595,13595,13597,0,2,5
3913,6,2,13601,13601,13603,0,2,4
3914,5,3,13606,13606,13609,0,3,3
3915,6,1,13612,13612,13613,0,1,3
3916,6,2,13618,13618,13620,0,2,5
3917,5,1,13623,13623,13624,0,1,3
3918,2,1,13625,13625,13626,0,1,1
3919,3,1,13628,13628,13629,0,1,2
3920,1,2,13629,13629,13631,0,2,0
3921,2,2,13631,13631,13633,0,2,0
3922,1,1,13632,13633,13634,1,2,0
3923,3,2,13635,13635,13637,0,2,1
3924,6,2,13641,13641,13643,0,2,4
3925,5,3,13646,13646,13649,0,3,3
3926,6,3,13652,13652,13655,0,3,3
3927,6,3,13658,13658,13661,0,3,3
3928,1,1,13659,13661,13662,2,3,0
3929,6,1,13665,13665,13666,0,1,3
3930,1,3,13666,13666,13669,0,3,0
3931,2,2,13668,13669,13671,1,3,0
3932,4,1,13672,13672,13673,0,1,1
3933,2,2,13674,13674,13676,0,2,1
3934,3,3,13677,13677,13680,0,3,1
3935,2,3,13679,13680,13683,1,4,0
3936,3,2,13682,13683,13685,1,3,0
3937,6,3,13688,13688,13691,0,3,3
3938,6,1,13694,13694,13695,0,1,3
3939,1,1,13695,13695,13696,0,1,0
3940,1,3,13696,13696,13699,0,3,0
3941,3,1,13699,13699,13700,0,1,0
3942,3,1,13702,13702,13703,0,1,2
3943,6,3,13708,13708,13711,0,3,5
3944,1,3,13709,13711,13714,2,5,0
3945,5,2,13714,13714,13716,0,2,0
3946,3,2,13717,13717,13719,0,2,1
3947,3,1,13720,13720,13721,0,1,1
3948,4,1,13724,13724,13725,0,1,3
3949,4,1,13728,13728,13729,0,1,3
3950,4,2,13732,13732,13734,0,2,3
3951,1,3,13733,13734,13737,1,4,0
3952,2,3,13735,13737,13740,2,5,0
3953,3,1,13738,13740,13741,2,3,0
3954,4,2,13742,13742,13744,0,2,1
3955,3,3,13745,13745,13748,0,3,1
3956,4,1,13749,13749,13750,0,1,1
3957,6,1,13755,13755,13756,0,1,5
3958,5,1,13760,13760,13761,0,1,4
3959,2,1,13762,13762,13763,0,1,1
3960,2,3,13764,13764,13767,0,3,1
3961,4,3,13768,13768,13771,0,3,1
3962,2,2,13770,13771,13773,1,3,0
3963,4,2,13774,13774,13776,0,2,1
3964,1,2,13775,13776,13778,1,3,0
3965,1,2,13776,13778,13780,2,4,0
3966,6,2,13782,13782,13784,0,2,2
3967,6,3,13788,13788,13791,0,3,4
3968,5,3,13793,13793,13796,0,3,2
3969,2,2,13795,13796,13798,1,3,0
3970,3,2,13798,13798,13800,0,2,0
3971,5,2,13803,13803,13805,0,2,3
3972,1,3,13804,13805,13808,1,4,0
3973,6,2,13810,13810,13812,0,2,2
3974,2,3,13812,13812,13815,0,3,0
3975,3,3,13815,13815,13818,0,3,0
3976,6,2,13821,13821,13823,0,2,3
3977,5,3,13826,13826,13829,0,3,3
3978,3,1,13829,13829,13830,0,1,0
3979,6,1,13835,13835,13836,0,1,5
3980,5,3,13840,13840,13843,0,3,4
3981,5,2,13845,13845,13847,0,2,2
3982,3,3,13848,13848,13851,0,3,1
3983,4,2,13852,13852,13854,0,2,1
3984,4,3,13856,13856,13859,0,3,2
3985,3,3,13859,13859,13862,0,3,0
3986,2,2,13861,13862,13864,1,3,0
3987,3,1,13864,13864,13865,0,1,0
3988,3,3,13867,13867,13870,0,3,2
3989,3,3,13870,13870,13873,0,3,0
3990,4,1,13874,13874,13875,0,1,1
3991,1,1,13875,13875,13876,0,1,0
3992,4,2,13879,13879,13881,0,2,3
3993,6,2,13885,13885,13887,0,2,4
3994,1,1,13886,13887,13888,1,2,0
3995,4,2,13890,13890,13892,0,2,2
3996,1,1,13891,13892,13893,1,2,0
3997,4,1,13895,13895,13896,0,1,2
3998,1,1,13896,13896,13897,0,1,0
3999,5,3,13901,13901,13904,0,3,4
4000,5,1,13906,13906,13907,0,1,2
4001,5,2,13911,13911,13913,0,2,4
4002,2,1,13913,13913,13914,0,1,0
4003,3,1,13916,13916,13917,0,1,2
4004,5,1,13921,13921,13922,0,1,4
4005,5,1,13926,13926,13927,0,1,4
4006,2,2,13928,13928,13930,0,2,1
4007,4,3,13932,13932,13935,0,3,2
4008,2,1,13934,13935,13936,1,2,0
4009,5,3,13939,13939,13942,0,3,3
4010,2,1,13941,13942,13943,1,2,0
4011,4,2,13945,13945,13947,0,2,2
4012,3,2,13948,13948,13950,0,2,1
4013,2,2,13950,13950,13952,0,2,0
4014,6,1,13956,13956,13957,0,1,4
4015,3,1,13959,13959,13960,0,1,2
4016,2,3,13961,13961,13964,0,3,1
4017,3,3,13964,13964,13967,0,3,0
4018,6,2,13970,13970,13972,0,2,3
4019,6,1,13976,13976,13977,0,1,4
4020,5,1,13981,13981,13982,0,1,4
4021,2,1,13983,13983,13984,0,1,1
4022,2,3,13985,13985,13988,0,3,1
4023,3,1,13988,13988,13989,0,1,0
4024,6,2,13994,13994,13996,0,2,5
4025,3,3,13997,13997,14000,0,3,1
4026,3,1,14000,14000,14001,0,1,0
4027,2,1,14002,14002,14003,0,1,1
4028,2,2,14004,14004,14006,0,2,1
4029,2,3,14006,14006,14009,0,3,0
4030,3,1,14009,14009,14010,0,1,0
4031,5,2,14014,14014,14016,0,2,4
4032,2,3,14016,14016,14019,0,3,0
4033,3,2,14019,14019,14021,0,2,0
4034,3,3,14022,14022,14025,0,3,1
4035,6,2,14028,14028,14030,0,2,3
4036,4,2,14032,14032,14034,0,2,2
4037,2,3,14034,14034,14037,0,3,0
4038,3,2,14037,14037,14039,0,2,0
4039,3,3,14040,14040,14043,0,3,1
4040,5,3,14045,14045,14048,0,3,2
4041,2,2,14047,14048,14050,1,3,0
4042,3,3,14050,14050,14053,0,3,0
4043,2,3,14052,14053,14056,1,4,0
4044,1,1,14053,14056,14057,3,4,0
4045,5,3,14058,14058,14061,0,3,1
4046,2,3,14060,14061,14064,1,4,0
4047,3,3,14063,14064,14067,1,4,0
4048,6,2,14069,14069,14071,0,2,2
4049,3,1,14072,14072,14073,0,1,1
4050,1,2,14073,14073,14075,0,2,0
4051,5,1,14078,14078,14079,0,1,3
4052,5,1,14083,14083,14084,0,1,4
4053,2,2,14085,14085,14087,0,2,1
4054,4,3,14089,14089,14092,0,3,2
4055,3,1,14092,14092,14093,0,1,0
4056,5,3,14097,14097,14100,0,3,4
4057,2,2,14099,14100,14102,1,3,0
4058,5,2,14104,14104,14106,0,2,2
4059,3,2,14107,14107,14109,0,2,1
4060,4,3,14111,14111,14114,0,3,2
4061,3,3,14114,14114,14117,0,3,0
4062,4,1,14118,14118,14119,0,1,1
4063,2,3,14120,14120,14123,0,3,1
4064,6,1,14126,14126,14127,0,1,3
4065,2,1,14128,14128,14129,0,1,1
4066,5,2,14133,14133,14135,0,2,4
4067,5,1,14138,14138,14139,0,1,3
4068,2,1,14140,14140,14141,0,1,1
4069,3,1,14143,14143,14144,0,1,2
4070,6,2,14149,14149,14151,0,2,5
4071,2,3,14151,14151,14154,0,3,0
4072,6,2,14157,14157,14159,0,2,3
4073,5,3,14162,14162,14165,0,3,3
4074,4,2,14166,14166,14168,0,2,1
4075,1,3,14167,14168,14171,1,4,0
4076,6,3,14173,14173,14176,0,3,2
4077,6,3,14179,14179,14182,0,3,3
4078,1,2,14180,14182,14184,2,4,0
4079,1,2,14181,14184,14186,3,5,0
4080,3,2,14184,14186,14188,2,4,0
4081,1,1,14185,14188,14189,3,4,0
4082,4,2,14189,14189,14191,0,2,0
4083,1,2,14190,14191,14193,1,3,0
4084,1,2,14191,14193,14195,2,4,0
4085,2,1,14193,14195,14196,2,3,0
4086,6,3,14199,14199,14202,0,3,3
4087,2,2,14201,14202,14204,1,3,0
4088,2,2,14203,14204,14206,1,3,0
4089,6,2,14209,14209,14211,0,2,3
4090,4,1,14213,14213,14214,0,1,2
4091,2,1,14215,14215,14216,0,1,1
4092,5,1,14220,14220,14221,0,1,4
4093,6,3,14226,14226,14229,0,3,5
4094,3,2,14229,14229,14231,0,2,0
4095,2,1,14231,14231,14232,0,1,0
4096,5,3,14236,14236,14239,0,3,4
4097,5,2,14241,14241,14243,0,2,2
4098,1,3,14242,14243,14246,1,4,0
4099,6,2,14248,14248,14250,0,2,2
4100,5,1,14253,14253,14254,0,1,3
4101,3,3,14256,14256,14259,0,3,2
4102,6,1,14262,14262,14263,0,1,3
4103,6,3,14268,14268,14271,0,3,5
4104,6,3,14274,14274,14277,0,3,3
4105,2,3,14276,14277,14280,1,4,0
4106,4,1,14280,14280,14281,0,1,0
4107,1,1,14281,14281,14282,0,1,0
4108,2,1,14283,14283,14284,0,1,1
4109,5,2,14288,14288,14290,0,2,4
4110,5,1,14293,14293,14294,0,1,3
4111,5,3,14298,14298,14301,0,3,4
4112,1,1,14299,14301,14302,2,3,0
4113,5,3,14304,14304,14307,0,3,2
4114,4,3,14308,14308,14311,0,3,1
4115,3,1,14311,14311,14312,0,1,0
4116,6,2,14317,14317,14319,0,2,5
4117,3,1,14320,14320,14321,0,1,1
4118,6,1,14326,14326,14327,0,1,5
4119,2,2,14328,14328,14330,0,2,1
4120,2,3,14330,14330,14333,0,3,0
4121,6,3,14336,14336,14339,0,3,3
4122,5,3,14341,14341,14344,0,3,2
4123,5,2,14346,14346,14348,0,2,2
4124,4,3,14350,14350,14353,0,3,2
4125,6,1,14356,14356,14357,0,1,3
4126,4,2,14360,14360,14362,0,2,3
4127,4,1,14364,14364,14365,0,1,2
4128,2,1,14366,14366,14367,0,1,1
4129,2,2,14368,14368,14370,0,2,1
4130,5,2,14373,14373,14375,0,2,3
4131,4,3,14377,14377,14380,0,3,2
4132,3,3,14380,14380,14383,0,3,0
4133,1,2,14381,14383,14385,2,4,0
4134,1,1,14382,14385,14386,3,4,0
4135,4,3,14386,14386,14389,0,3,0
4136,4,3,14390,14390,14393,0,3,1
4137,2,1,14392,14393,14394,1,2,0
4138,6,3,14398,14398,14401,0,3,4
4139,3,3,14401,14401,14404,0,3,0
4140,4,3,14405,14405,14408,0,3,1
4141,6,3,14411,14411,14414,0,3,3
4142,4,1,14415,14415,14416,0,1,1
4143,3,2,14418,14418,14420,0,2,2
4144,5,3,14423,14423,14426,0,3,3
4145,1,2,14424,14426,14428,2,4,0
4146,5,2,14429,14429,14431,0,2,1
4147,4,3,14433,14433,14436,0,3,2
4148,3,3,14436,14436,14439,0,3,0
4149,2,2,14438,14439,14441,1,3,0
4150,3,2,14441,14441,14443,0,2,0
4151,2,1,14443,14443,14444,0,1,0
4152,6,2,14449,14449,14451,0,2,5
4153,2,2,14451,14451,14453,0,2,0
4154,1,2,14452,14453,14455,1,3,0
4155,4,2,14456,14456,14458,0,2,1
4156,6,1,14462,14462,14463,0,1,4
4157,6,1,14468,14468,14469,0,1,5
4158,1,1,14469,14469,14470,0,1,0
4159,6,2,14475,14475,14477,0,2,5
4160,1,1,14476,14477,14478,1,2,0
4161,6,2,14482,14482,14484,0,2,4
4162,3,2,14485,14485,14487,0,2,1
4163,4,1,14489,14489,14490,0,1,2
4164,5,3,14494,14494,14497,0,3,4
4165,5,1,14499,14499,14500,0,1,2
4166,2,1,14501,14501,14502,0,1,1
4167,5,2,14506,14506,14508,0,2,4
4168,1,2,14507,14508,14510,1,3,0
4169,1,3,14508,14510,14513,2,5,0
4170,3,2,14511,14513,14515,2,4,0
4171,1,1,14512,14515,14516,3,4,0
4172,1,2,14513,14516,14518,3,5,0
4173,4,3,14517,14518,14521,1,4,0
4174,2,2,14519,14521,14523,2,4,0
4175,2,3,14521,14523,14526,2,5,0
4176,6,3,14527,14527,14530,0,3,1
4177,5,3,14532,14532,14535,0,3,2
4178,2,3,14534,14535,14538,1,4,0
4179,5,1,14539,14539,14540,0,1,1
4180,5,2,14544,14544,14546,0,2,4
4181,1,3,14545,14546,14549,1,4,0
4182,2,3,14547,14549,14552,2,5,0
4183,5,1,14552,14552,14553,0,1,0
4184,3,1,14555,14555,14556,0,1,2
4185,4,3,14559,14559,14562,0,3,3
4186,5,2,14564,14564,14566,0,2,2
4187,5,3,14569,14569,14572,0,3,3
4188,2,1,14571,14572,14573,1,2,0
4189,1,1,14572,14573,14574,1,2,0
4190,2,3,14574,14574,14577,0,3,0
4191,6,2,14580,14580,14582,0,2,3
4192,1,2,14581,14582,14584,1,3,0
4193,1,1,14582,14584,14585,2,3,0
4194,5,1,14587,14587,14588,0,1,2
4195,1,3,14588,14588,14591,0,3,0
4196,6,2,14594,14594,14596,0,2,3
4197,2,3,14596,14596,14599,0,3,0
4198,1,2,14597,14599,14601,2,4,0
4199,4,3,14601,14601,14604,0,3,0
4200,1,3,14602,14604,14607,2,5,0
4201,6,2,14608,14608,14610,0,2,1
4202,2,3,14610,14610,14613,0,3,0
4203,4,1,14614,14614,14615,0,1,1
4204,6,1,14620,14620,14621,0,1,5
4205,1,2,14621,14621,14623,0,2,0
4206,3,2,14624,14624,14626,0,2,1
4207,4,1,14628,14628,14629,0,1,2
4208,4,3,14632,14632,14635,0,3,3
4209,3,2,14635,14635,14637,0,2,0
4210,2,1,14637,14637,14638,0,1,0
4211,1,1,14638,14638,14639,0,1,0
4212,3,3,14641,14641,14644,0,3,2
4213,4,1,14645,14645,14646,0,1,1
4214,4,1,14649,14649,14650,0,1,3
4215,5,1,14654,14654,14655,0,1,4
4216,3,2,14657,14657,14659,0,2,2
4217,1,2,14658,14659,14661,1,3,0
4218,4,3,14662,14662,14665,0,3,1
4219,6,3,14668,14668,14671,0,3,3
4220,1,3,14669,14671,14674,2,5,0
4221,1,1,14670,14674,14675,4,5,0
4222,5,3,14675,14675,14678,0,3,0
4223,4,1,14679,14679,14680,0,1,1
4224,2,2,14681,14681,14683,0,2,1
4225,2,3,14683,14683,14686,0,3,0
4226,6,2,14689,14689,14691,0,2,3
4227,1,1,14690,14691,14692,1,2,0
4228,4,2,14694,14694,14696,0,2,2
4229,1,3,14695,14696,14699,1,4,0
4230,6,1,14701,14701,14702,0,1,2
4231,6,2,14707,14707,14709,0,2,5
4232,3,3,14710,14710,14713,0,3,1
4233,3,2,14713,14713,14715,0,2,0
4234,3,3,14716,14716,14719,0,3,1
4235,1,1,14717,14719,14720,2,3,0
4236,1,3,14718,14720,14723,2,5,0
4237,2,1,14720,14723,14724,3,4,0
4238,2,2,14722,14724,14726,2,4,0
4239,5,2,14727,14727,14729,0,2,1
4240,5,2,14732,14732,14734,0,2,3
4241,4,1,14736,14736,14737,0,1,2
4242,2,3,14738,14738,14741,0,3,1
4243,3,2,14741,14741,14743,0,2,0
4244,1,2,14742,14743,14745,1,3,0
4245,1,1,14743,14745,14746,2,3,0
4246,2,1,14745,14746,14747,1,2,0
4247,6,1,14751,14751,14752,0,1,4
4248,6,2,14757,14757,14759,0,2,5
4249,2,2,14759,14759,14761,0,2,0
4250,4,2,14763,14763,14765,0,2,2
4251,6,3,14769,14769,14772,0,3,4
4252,4,3,14773,14773,14776,0,3,1
4253,4,1,14777,14777,14778,0,1,1
4254,2,3,14779,14779,14782,0,3,1
4255,6,1,14785,14785,14786,0,1,3
4256,5,2,14790,14790,14792,0,2,4
4257,1,1,14791,14792,14793,1,2,0
4258,4,3,14795,14795,14798,0,3,2
4259,4,3,14799,14799,14802,0,3,1
4260,2,2,14801,14802,14804,1,3,0
4261,6,2,14807,14807,14809,0,2,3
4262,1,1,14808,14809,14810,1,2,0
4263,4,1,14812,14812,14813,0,1,2
4264,1,3,14813,14813,14816,0,3,0
4265,1,1,14814,14816,14817,2,3,0
4266,1,1,14815,14817,14818,2,3,0
4267,5,2,14820,14820,14822,0,2,2
4268,1,3,14821,14822,14825,1,4,0
4269,2,2,14823,14825,14827,2,4,0
4270,6,3,14829,14829,14832,0,3,2
4271,6,3,14835,14835,14838,0,3,3
4272,4,3,14839,14839,14842,0,3,1
4273,2,1,14841,14842,14843,1,2,0
4274,4,2,14845,14845,14847,0,2,2
4275,5,1,14850,14850,14851,0,1,3
4276,5,3,14855,14855,14858,0,3,4
4277,5,1,14860,14860,14861,0,1,2
4278,5,3,14865,14865,14868,0,3,4
4279,6,1,14871,14871,14872,0,1,3
4280,1,2,14872,14872,14874,0,2,0
4281,6,1,14878,14878,14879,0,1,4
4282,5,2,14883,14883,14885,0,2,4
4283,4,1,14887,14887,14888,0,1,2
4284,1,3,14888,14888,14891,0,3,0
4285,2,1,14890,14891,14892,1,2,0
4286,1,1,14891,14892,14893,1,2,0
4287,6,2,14897,14897,14899,0,2,4
4288,4,3,14901,14901,14904,0,3,2
4289,6,2,14907,14907,14909,0,2,3
4290,1,2,14908,14909,14911,1,3,0
4291,3,1,14911,14911,14912,0,1,0
4292,2,2,14913,14913,14915,0,2,1
4293,6,2,14919,14919,14921,0,2,4
4294,5,3,14924,14924,14927,0,3,3
4295,2,2,14926,14927,14929,1,3,0
4296,1,3,14927,14929,14932,2,5,0
4297,4,1,14931,14932,14933,1,2,0
4298,2,3,14933,14933,14936,0,3,0
4299,3,3,14936,14936,14939,0,3,0
4300,4,2,14940,14940,14942,0,2,1
4301,6,1,14946,14946,14947,0,1,4
4302,1,2,14947,14947,14949,0,2,0
4303,4,2,14951,14951,14953,0,2,2
4304,2,3,14953,14953,14956,0,3,0
4305,2,1,14955,14956,14957,1,2,0
4306,3,3,14958,14958,14961,0,3,1
4307,4,3,14962,14962,14965,0,3,1
4308,2,2,14964,14965,14967,1,3,0
4309,1,1,14965,14967,14968,2,3,0
4310,1,1,14966,14968,14969,2,3,0
4311,5,1,14971,14971,14972,0,1,2
4312,6,2,14977,14977,14979,0,2,5
4313,2,3,14979,14979,14982,0,3,0
4314,4,3,14983,14983,14986,0,3,1
4315,5,2,14988,14988,14990,0,2,2
4316,6,2,14994,14994,14996,0,2,4
4317,6,2,15000,15000,15002,0,2,4
4318,5,1,15005,15005,15006,0,1,3
4319,5,1,15010,15010,15011,0,1,4
4320,5,2,15015,15015,15017,0,2,4
4321,6,2,15021,15021,15023,0,2,4
4322,3,2,15024,15024,15026,0,2,1
4323,4,1,15028,15028,15029,0,1,2
4324,3,1,15031,15031,15032,0,1,2
4325,6,2,15037,15037,15039,0,2,5
4326,5,1,15042,15042,15043,0,1,3
4327,3,3,15045,15045,15048,0,3,2
4328,2,2,15047,15048,15050,1,3,0
4329,3,2,15050,15050,15052,0,2,0
4330,2,2,15052,15052,15054,0,2,0
4331,2,2,15054,15054,15056,0,2,0
4332,3,3,15057,15057,15060,0,3,1
4333,6,3,15063,15063,15066,0,3,3
4334,2,2,15065,15066,15068,1,3,0
4335,1,2,15066,15068,15070,2,4,0
4336,2,2,15068,15070,15072,2,4,0
4337,2,2,15070,15072,15074,2,4,0
4338,5,2,15075,15075,15077,0,2,1
4339,4,2,15079,15079,15081,0,2,2
4340,1,2,15080,15081,15083,1,3,0
4341,6,3,15086,15086,15089,0,3,3
4342,4,3,15090,15090,15093,0,3,1
4343,1,3,15091,15093,15096,2,5,0
4344,6,3,15097,15097,15100,0,3,1
4345,4,1,15101,15101,15102,0,1,1
4346,3,3,15104,15104,15107,0,3,2
4347,3,2,15107,15107,15109,0,2,0
4348,1,1,15108,15109,15110,1,2,0
4349,5,1,15113,15113,15114,0,1,3
4350,3,3,15116,15116,15119,0,3,2
4351,3,3,15119,15119,15122,0,3,0
4352,3,1,15122,15122,15123,0,1,0
4353,4,3,15126,15126,15129,0,3,3
4354,3,3,15129,15129,15132,0,3,0
4355,3,1,15132,15132,15133,0,1,0
4356,6,1,15138,15138,15139,0,1,5
4357,4,3,15142,15142,15145,0,3,3
4358,1,1,15143,15145,15146,2,3,0
4359,3,3,15146,15146,15149,0,3,0
4360,2,3,15148,15149,15152,1,4,0
4361,1,1,15149,15152,15153,3,4,0
4362,4,1,15153,15153,15154,0,1,0
4363,1,3,15154,15154,15157,0,3,0
4364,6,1,15160,15160,15161,0,1,3
4365,1,1,15161,15161,15162,0,1,0
4366,4,3,15165,15165,15168,0,3,3
4367,4,3,15169,15169,15172,0,3,1
4368,3,1,15172,15172,15173,0,1,0
4369,1,1,15173,15173,15174,0,1,0
4370,4,1,15177,15177,15178,0,1,3
4371,4,2,15181,15181,15183,0,2,3
4372,4,2,15185,15185,15187,0,2,2
4373,1,2,15186,15187,15189,1,3,0
4374,6,1,15192,15192,15193,0,1,3
4375,3,3,15195,15195,15198,0,3,2
4376,4,2,15199,15199,15201,0,2,1
4377,3,3,15202,15202,15205,0,3,1
4378,1,1,15203,15205,15206,2,3,0
4379,6,3,15209,15209,15212,0,3,3
4380,6,2,15215,15215,15217,0,2,3
4381,6,1,15221,15221,15222,0,1,4
4382,4,2,15225,15225,15227,0,2,3
4383,3,3,15228,15228,15231,0,3,1
4384,3,1,15231,15231,15232,0,1,0
4385,2,2,15233,15233,15235,0,2,1
4386,6,3,15239,15239,15242,0,3,4
4387,3,2,15242,15242,15244,0,2,0
4388,5,3,15247,15247,15250,0,3,3
4389,3,2,15250,15250,15252,0,2,0
4390,5,2,15255,15255,15257,0,2,3
4391,6,1,15261,15261,15262,0,1,4
4392,5,1,15266,15266,15267,0,1,4
4393,5,1,15271,15271,15272,0,1,4
4394,5,2,15276,15276,15278,0,2,4
4395,1,2,15277,15278,15280,1,3,0
4396,4,3,15281,15281,15284,0,3,1
4397,6,2,15287,15287,15289,0,2,3
4398,1,2,15288,15289,15291,1,3,0
4399,6,1,15294,15294,15295,0,1,3
4400,2,1,15296,15296,15297,0,1,1
4401,3,2,15299,15299,15301,0,2,2
4402,3,2,15302,15302,15304,0,2,1
4403,3,3,15305,15305,15308,0,3,1
4404,5,2,15310,15310,15312,0,2,2
4405,2,2,15312,15312,15314,0,2,0
4406,5,2,15317,15317,15319,0,2,3
4407,3,3,15320,15320,15323,0,3,1
4408,2,3,15322,15323,15326,1,4,0
4409,3,3,15325,15326,15329,1,4,0
4410,6,3,15331,15331,15334,0,3,2
4411,4,2,15335,15335,15337,0,2,1
4412,5,1,15340,15340,15341,0,1,3
4413,6,1,15346,15346,15347,0,1,5
4414,4,3,15350,15350,15353,0,3,3
4415,1,1,15351,15353,15354,2,3,0
4416,1,3,15352,15354,15357,2,5,0
4417,3,1,15355,15357,15358,2,3,0
4418,3,1,15358,15358,15359,0,1,0
4419,4,2,15362,15362,15364,0,2,3
4420,2,1,15364,15364,15365,0,1,0
4421,4,2,15368,15368,15370,0,2,3
4422,1,2,15369,15370,15372,1,3,0
4423,5,3,15374,15374,15377,0,3,2
4424,3,1,15377,15377,15378,0,1,0
4425,3,3,15380,15380,15383,0,3,2
4426,4,2,15384,15384,15386,0,2,1
4427,6,2,15390,15390,15392,0,2,4
4428,5,1,15395,15395,15396,0,1,3
4429,3,3,15398,15398,15401,0,3,2
4430,3,1,15401,15401,15402,0,1,0
4431,6,3,15407,15407,15410,0,3,5
4432,2,1,15409,15410,15411,1,2,0
4433,1,1,15410,15411,15412,1,2,0
4434,4,2,15414,15414,15416,0,2,2
4435,2,1,15416,15416,15417,0,1,0
4436,6,1,15422,15422,15423,0,1,5
4437,5,1,15427,15427,15428,0,1,4
4438,2,2,15429,15429,15431,0,2,1
4439,6,2,15435,15435,15437,0,2,4
4440,1,2,15436,15437,15439,1,3,0
4441,2,3,15438,15439,15442,1,4,0
4442,5,3,15443,15443,15446,0,3,1
4443,6,2,15449,15449,15451,0,2,3
4444,3,3,15452,15452,15455,0,3,1
4445,1,3,15453,15455,15458,2,5,0
4446,1,1,15454,15458,15459,4,5,0
4447,4,2,15458,15459,15461,1,3,0
4448,4,1,15462,15462,15463,0,1,1
4449,1,3,15463,15463,15466,0,3,0
4450,6,3,15469,15469,15472,0,3,3
4451,1,2,15470,15472,15474,2,4,0
4452,2,1,15472,15474,15475,2,3,0
4453,5,2,15477,15477,15479,0,2,2
4454,3,3,15480,15480,15483,0,3,1
4455,5,1,15485,15485,15486,0,1,2
4456,6,2,15491,15491,15493,0,2,5
4457,3,1,15494,15494,15495,0,1,1
4458,5,1,15499,15499,15500,0,1,4
4459,4,1,15503,15503,15504,0,1,3
4460,5,1,15508,15508,15509,0,1,4
4461,6,2,15514,15514,15516,0,2,5
4462,5,1,15519,15519,15520,0,1,3
4463,6,2,15525,15525,15527,0,2,5
4464,2,2,15527,15527,15529,0,2,0
4465,1,1,15528,15529,15530,1,2,0
4466,3,3,15531,15531,15534,0,3,1
4467,6,1,15537,15537,15538,0,1,3
4468,5,1,15542,15542,15543,0,1,4
4469,4,1,15546,15546,15547,0,1,3
4470,6,2,15552,15552,15554,0,2,5
4471,6,1,15558,15558,15559,0,1,4
4472,3,2,15561,15561,15563,0,2,2
4473,3,1,15564,15564,15565,0,1,1
4474,2,1,15566,15566,15567,0,1,1
4475,1,3,15567,15567,15570,0,3,0
4476,1,1,15568,15570,15571,2,3,0
4477,1,1,15569,15571,15572,2,3,0
4478,5,2,15574,15574,15576,0,2,2
4479,2,1,15576,15576,15577,0,1,0
4480,2,2,15578,15578,15580,0,2,1
4481,3,2,15581,15581,15583,0,2,1
4482,6,2,15587,15587,15589,0,2,4
4483,6,3,15593,15593,15596,0,3,4
4484,2,3,15595,15596,15599,1,4,0
4485,5,2,15600,15600,15602,0,2,1
4486,5,3,15605,15605,15608,0,3,3
4487,5,3,15610,15610,15613,0,3,2
4488,5,2,15615,15615,15617,0,2,2
4489,2,2,15617,15617,15619,0,2,0
4490,6,3,15623,15623,15626,0,3,4
4491,3,3,15626,15626,15629,0,3,0
4492,4,3,15630,15630,15633,0,3,1
4493,1,1,15631,15633,15634,2,3,0
4494,4,3,15635,15635,15638,0,3,1
4495,5,1,15640,15640,15641,0,1,2
4496,1,1,15641,15641,15642,0,1,0
4497,3,3,15644,15644,15647,0,3,2
4498,4,2,15648,15648,15650,0,2,1
4499,5,2,15653,15653,15655,0,2,3
4500,3,2,15656,15656,15658,0,2,1
4501,1,2,15657,15658,15660,1,3,0
4502,3,2,15660,15660,15662,0,2,0
4503,2,2,15662,15662,15664,0,2,0
4504,5,2,15667,15667,15669,0,2,3
4505,6,2,15673,15673,15675,0,2,4
4506,3,3,15676,15676,15679,0,3,1
4507,4,1,15680,15680,15681,0,1,1
4508,2,3,15682,15682,15685,0,3,1
4509,4,3,15686,15686,15689,0,3,1
4510,1,2,15687,15689,15691,2,4,0
4511,1,2,15688,15691,15693,3,5,0
4512,6,3,15694,15694,15697,0,3,1
4513,3,2,15697,15697,15699,0,2,0
4514,2,2,15699,15699,15701,0,2,0
4515,1,2,15700,15701,15703,1,3,0
4516,6,3,15706,15706,15709,0,3,3
4517,2,3,15708,15709,15712,1,4,0
4518,6,3,15714,15714,15717,0,3,2
4519,2,3,15716,15717,15720,1,4,0
4520,5,3,15721,15721,15724,0,3,1
4521,4,3,15725,15725,15728,0,3,1
4522,1,2,15726,15728,15730,2,4,0
4523,6,1,15732,15732,15733,0,1,2
4524,3,2,15735,15735,15737,0,2,2
4525,2,2,15737,15737,15739,0,2,0
4526,1,3,15738,15739,15742,1,4,0
4527,6,3,15744,15744,15747,0,3,2
4528,5,1,15749,15749,15750,0,1,2
4529,2,2,15751,15751,15753,0,2,1
4530,5,2,15756,15756,15758,0,2,3
4531,6,1,15762,15762,15763,0,1,4
4532,4,2,15766,15766,15768,0,2,3
4533,4,3,15770,15770,15773,0,3,2
4534,4,3,15774,15774,15777,0,3,1
4535,2,1,15776,15777,15778,1,2,0
4536,5,1,15781,15781,15782,0,1,3
4537,4,3,15785,15785,15788,0,3,3
4538,4,1,15789,15789,15790,0,1,1
4539,3,1,15792,15792,15793,0,1,2
4540,2,3,15794,15794,15797,0,3,1
4541,2,3,15796,15797,15800,1,4,0
4542,4,1,15800,15800,15801,0,1,0
4543,5,3,15805,15805,15808,0,3,4
4544,1,2,15806,15808,15810,2,4,0
4545,1,1,15807,15810,15811,3,4,0
4546,5,2,15812,15812,15814,0,2,1
4547,4,3,15816,15816,15819,0,3,2
4548,6,1,15822,15822,15823,0,1,3
4549,6,2,15828,15828,15830,0,2,5
4550,6,1,15834,15834,15835,0,1,4
4551,1,2,15835,15835,15837,0,2,0
4552,5,3,15840,15840,15843,0,3,3
4553,1,3,15841,15843,15846,2,5,0
4554,3,2,15844,15846,15848,2,4,0
4555,5,3,15849,15849,15852,0,3,1
4556,4,2,15853,15853,15855,0,2,1
4557,2,2,15855,15855,15857,0,2,0
4558,3,3,15858,15858,15861,0,3,1
4559,2,1,15860,15861,15862,1,2,0
4560,2,3,15862,15862,15865,0,3,0
4561,5,1,15867,15867,15868,0,1,2
4562,1,3,15868,15868,15871,0,3,0
4563,4,1,15872,15872,15873,0,1,1
4564,5,1,15877,15877,15878,0,1,4
4565,3,1,15880,15880,15881,0,1,2
4566,3,1,15883,15883,15884,0,1,2
4567,4,2,15887,15887,15889,0,2,3
4568,2,3,15889,15889,15892,0,3,0
4569,4,3,15893,15893,15896,0,3,1
4570,1,3,15894,15896,15899,2,5,0
4571,3,3,15897,15899,15902,2,5,0
4572,4,3,15901,15902,15905,1,4,0
4573,5,3,15906,15906,15909,0,3,1
4574,6,2,15912,15912,15914,0,2,3
4575,3,2,15915,15915,15917,0,2,1
4576,5,2,15920,15920,15922,0,2,3
4577,2,1,15922,15922,15923,0,1,0
4578,2,2,15924,15924,15926,0,2,1
4579,2,1,15926,15926,15927,0,1,0
4580,5,1,15931,15931,15932,0,1,4
4581,5,1,15936,15936,15937,0,1,4
4582,6,2,15942,15942,15944,0,2,5
4583,2,1,15944,15944,15945,0,1,0
4584,1,2,15945,15945,15947,0,2,0
4585,6,3,15951,15951,15954,0,3,4
4586,2,3,15953,15954,15957,1,4,0
4587,5,3,15958,15958,15961,0,3,1
4588,1,2,15959,15961,15963,2,4,0
4589,2,2,15961,15963,15965,2,4,0
4590,6,3,15967,15967,15970,0,3,2
4591,3,2,15970,15970,15972,0,2,0
4592,4,2,15974,15974,15976,0,2,2
4593,6,1,15980,15980,15981,0,1,4
4594,6,3,15986,15986,15989,0,3,5
4595,2,2,15988,15989,15991,1,3,0
4596,3,3,15991,15991,15994,0,3,0
4597,3,3,15994,15994,15997,0,3,0
4598,6,3,16000,16000,16003,0,3,3
4599,1,3,16001,16003,16006,2,5,0
4600,5,1,16006,16006,16007,0,1,0
4601,3,2,16009,16009,16011,0,2,2
4602,6,3,16015,16015,16018,0,3,4
4603,3,1,16018,16018,16019,0,1,0
4604,5,1,16023,16023,16024,0,1,4
4605,5,3,16028,16028,16031,0,3,4
4606,2,2,16030,16031,16033,1,3,0
4607,3,2,16033,16033,16035,0,2,0
4608,3,2,16036,16036,16038,0,2,1
4609,4,1,16040,16040,16041,0,1,2
4610,2,2,16042,16042,16044,0,2,1
4611,5,1,16047,16047,16048,0,1,3
4612,1,3,16048,16048,16051,0,3,0
4613,2,1,16050,16051,16052,1,2,0
4614,2,2,16052,16052,16054,0,2,0
4615,5,3,16057,16057,16060,0,3,3
4616,5,3,16062,16062,16065,0,3,2
4617,6,1,16068,16068,16069,0,1,3
4618,1,2,16069,16069,16071,0,2,0
4619,2,1,16071,16071,16072,0,1,0
4620,6,2,16077,16077,16079,0,2,5
4621,3,2,16080,16080,16082,0,2,1
4622,3,1,16083,16083,16084,0,1,1
4623,6,2,16089,16089,16091,0,2,5
4624,3,1,16092,16092,16093,0,1,1
4625,3,1,16095,16095,16096,0,1,2
4626,1,1,16096,16096,16097,0,1,0
4627,3,3,16099,16099,16102,0,3,2
4628,4,3,16103,16103,16106,0,3,1
4629,2,3,16105,16106,16109,1,4,0
4630,2,1,16107,16109,16110,2,3,0
4631,2,3,16109,16110,16113,1,4,0
4632,6,1,16115,16115,16116,0,1,2
4633,1,3,16116,16116,16119,0,3,0
4634,3,2,16119,16119,16121,0,2,0
4635,6,1,16125,16125,16126,0,1,4
4636,6,2,16131,16131,16133,0,2,5
4637,5,3,16136,16136,16139,0,3,3
4638,4,1,16140,16140,16141,0,1,1
4639,4,3,16144,16144,16147,0,3,3
4640,6,3,16150,16150,16153,0,3,3
4641,2,3,16152,16153,16156,1,4,0
4642,5,1,16157,16157,16158,0,1,1
4643,3,3,16160,16160,16163,0,3,2
4644,5,2,16165,16165,16167,0,2,2
4645,5,3,16170,16170,16173,0,3,3
4646,2,2,16172,16173,16175,1,3,0
4647,5,3,16177,16177,16180,0,3,2
4648,2,1,16179,16180,16181,1,2,0
4649,1,1,16180,16181,16182,1,2,0
4650,6,3,16186,16186,16189,0,3,4
4651,4,2,16190,16190,16192,0,2,1
4652,2,3,16192,16192,16195,0,3,0
4653,5,2,16197,16197,16199,0,2,2
4654,1,2,16198,16199,16201,1,3,0
4655,5,1,16203,16203,16204,0,1,2
4656,1,1,16204,16204,16205,0,1,0
4657,1,1,16205,16205,16206,0,1,0
4658,3,3,16208,16208,16211,0,3,2
4659,6,2,16214,16214,16216,0,2,3
4660,3,3,16217,16217,16220,0,3,1
4661,5,3,16222,16222,16225,0,3,2
4662,4,1,16226,16226,16227,0,1,1
4663,1,3,16227,16227,16230,0,3,0
4664,3,2,16230,16230,16232,0,2,0
4665,1,2,16231,16232,16234,1,3,0
4666,6,3,16237,16237,16240,0,3,3
4667,3,3,16240,16240,16243,0,3,0
4668,3,3,16243,16243,16246,0,3,0
4669,3,2,16246,16246,16248,0,2,0
4670,3,2,16249,16249,16251,0,2,1
4671,1,1,16250,16251,16252,1,2,0
4672,3,1,16253,16253,16254,0,1,1
4673,2,3,16255,16255,16258,0,3,1
4674,2,2,16257,16258,16260,1,3,0
4675,3,3,16260,16260,16263,0,3,0
4676,5,2,16265,16265,16267,0,2,2
4677,1,3,16266,16267,16270,1,4,0
4678,5,3,16271,16271,16274,0,3,1
4679,5,1,16276,16276,16277,0,1,2
4680,3,1,16279,16279,16280,0,1,2
4681,3,3,16282,16282,16285,0,3,2
4682,1,2,16283,16285,16287,2,4,0
4683,2,2,16285,16287,16289,2,4,0
4684,5,2,16290,16290,16292,0,2,1
4685,1,2,16291,16292,16294,1,3,0
4686,1,1,16292,16294,16295,2,3,0
4687,6,1,16298,16298,16299,0,1,3
4688,6,3,16304,16304,16307,0,3,5
4689,6,1,16310,16310,16311,0,1,3
4690,5,1,16315,16315,16316,0,1,4
4691,4,1,16319,16319,16320,0,1,3
4692,2,1,16321,16321,16322,0,1,1
4693,3,1,16324,16324,16325,0,1,2
4694,4,2,16328,16328,16330,0,2,3
4695,1,2,16329,16330,16332,1,3,0
4696,5,1,16334,16334,16335,0,1,2
4697,1,1,16335,16335,16336,0,1,0
4698,4,3,16339,16339,16342,0,3,3
4699,5,2,16344,16344,16346,0,2,2
4700,6,2,16350,16350,16352,0,2,4
4701,1,2,16351,16352,16354,1,3,0
4702,2,2,16353,16354,16356,1,3,0
4703,4,2,16357,16357,16359,0,2,1
4704,1,3,16358,16359,16362,1,4,0
4705,2,1,16360,16362,16363,2,3,0
4706,2,1,16362,16363,16364,1,2,0
4707,3,2,16365,16365,16367,0,2,1
4708,1,2,16366,16367,16369,1,3,0
4709,2,1,16368,16369,16370,1,2,0
4710,3,2,16371,16371,16373,0,2,1
4711,5,1,16376,16376,16377,0,1,3
4712,1,2,16377,16377,16379,0,2,0
4713,5,1,16382,16382,16383,0,1,3
4714,6,3,16388,16388,16391,0,3,5
4715,3,2,16391,16391,16393,0,2,0
4716,5,2,16396,16396,16398,0,2,3
4717,4,1,16400,16400,16401,0,1,2
4718,1,3,16401,16401,16404,0,3,0
4719,6,3,16407,16407,16410,0,3,3
4720,6,3,16413,16413,16416,0,3,3
4721,6,2,16419,16419,16421,0,2,3
4722,6,1,16425,16425,16426,0,1,4
4723,6,3,16431,16431,16434,0,3,5
4724,2,1,16433,16434,16435,1,2,0
4725,5,2,16438,16438,16440,0,2,3
4726,6,1,16444,16444,16445,0,1,4
4727,2,1,16446,16446,16447,0,1,1
4728,5,2,16451,16451,16453,0,2,4
4729,2,2,16453,16453,16455,0,2,0
4730,1,1,16454,16455,16456,1,2,0
4731,6,1,16460,16460,16461,0,1,4
4732,2,2,16462,16462,16464,0,2,1
4733,5,2,16467,16467,16469,0,2,3
4734,4,1,16471,16471,16472,0,1,2
4735,4,1,16475,16475,16476,0,1,3
4736,1,3,16476,16476,16479,0,3,0
4737,1,2,16477,16479,16481,2,4,0
4738,4,3,16481,16481,16484,0,3,0
4739,2,2,16483,16484,16486,1,3,0
4740,5,2,16488,16488,16490,0,2,2
4741,4,2,16492,16492,16494,0,2,2
4742,3,1,16495,16495,16496,0,1,1
4743,4,1,16499,16499,16500,0,1,3
4744,6,1,16505,16505,16506,0,1,5
4745,1,3,16506,16506,16509,0,3,0
4746,1,1,16507,16509,16510,2,3,0
4747,2,3,16509,16510,16513,1,4,0
4748,4,2,16513,16513,16515,0,2,0
4749,6,1,16519,16519,16520,0,1,4
4750,5,2,16524,16524,16526,0,2,4
4751,6,2,16530,16530,16532,0,2,4
4752,5,3,16535,16535,16538,0,3,3
4753,1,2,16536,16538,16540,2,4,0
4754,6,1,16542,16542,16543,0,1,2
4755,5,3,16547,16547,16550,0,3,4
4756,6,1,16553,16553,16554,0,1,3
4757,5,2,16558,16558,16560,0,2,4
4758,4,2,16562,16562,16564,0,2,2
4759,4,2,16566,16566,16568,0,2,2
4760,4,1,16570,16570,16571,0,1,2
4761,4,2,16574,16574,16576,0,2,3
4762,5,1,16579,16579,16580,0,1,3
4763,4,3,16583,16583,16586,0,3,3
4764,3,2,16586,16586,16588,0,2,0
4765,6,1,16592,16592,16593,0,1,4
4766,2,3,16594,16594,16597,0,3,1
4767,5,3,16599,16599,16602,0,3,2
4768,6,2,16605,16605,16607,0,2,3
4769,6,2,16611,16611,16613,0,2,4
4770,1,2,16612,16613,16615,1,3,0
4771,4,1,16616,16616,16617,0,1,1
4772,6,2,16622,16622,16624,0,2,5
4773,2,2,16624,16624,16626,0,2,0
4774,3,2,16627,16627,16629,0,2,1
4775,6,2,16633,16633,16635,0,2,4
4776,1,3,16634,16635,16638,1,4,0
4777,3,3,16637,16638,16641,1,4,0
4778,1,2,16638,16641,16643,3,5,0
4779,4,2,16642,16643,16645,1,3,0
4780,4,3,16646,16646,16649,0,3,1
4781,2,1,16648,16649,16650,1,2,0
4782,1,1,16649,16650,16651,1,2,0
4783,6,2,16655,16655,16657,0,2,4
4784,3,3,16658,16658,16661,0,3,1
4785,2,2,16660,16661,16663,1,3,0
4786,2,1,16662,16663,16664,1,2,0
4787,6,3,16668,16668,16671,0,3,4
4788,1,2,16669,16671,16673,2,4,0
4789,1,1,16670,16673,16674,3,4,0
4790,3,2,16673,16674,16676,1,3,0
4791,6,2,16679,16679,16681,0,2,3
4792,3,3,16682,16682,16685,0,3,1
4793,4,3,16686,16686,16689,0,3,1
4794,3,1,16689,16689,16690,0,1,0
4795,1,2,16690,16690,16692,0,2,0
4796,2,3,16692,16692,16695,0,3,0
4797,1,3,16693,16695,16698,2,5,0
4798,2,2,16695,16698,16700,3,5,0
4799,3,1,16698,16700,16701,2,3,0
4800,3,1,16701,16701,16702,0,1,0
4801,1,3,16702,16702,16705,0,3,0
4802,1,1,16703,16705,16706,2,3,0
4803,2,1,16705,16706,16707,1,2,0
4804,4,3,16709,16709,16712,0,3,2
4805,2,3,16711,16712,16715,1,4,0
4806,6,2,16717,16717,16719,0,2,2
4807,1,3,16718,16719,16722,1,4,0
4808,3,3,16721,16722,16725,1,4,0
4809,5,2,16726,16726,16728,0,2,1
4810,1,1,16727,16728,16729,1,2,0
4811,1,2,16728,16729,16731,1,3,0
4812,1,1,16729,16731,16732,2,3,0
4813,3,3,16732,16732,16735,0,3,0
4814,3,3,16735,16735,16738,0,3,0
4815,1,3,16736,16738,16741,2,5,0
4816,6,1,16742,16742,16743,0,1,1
4817,5,1,16747,16747,16748,0,1,4
4818,6,1,16753,16753,16754,0,1,5
4819,4,2,16757,16757,16759,0,2,3
4820,2,2,16759,16759,16761,0,2,0
4821,6,3,16765,16765,16768,0,3,4
4822,2,3,16767,16768,16771,1,4,0
4823,3,2,16770,16771,16773,1,3,0
4824,2,3,16772,16773,16776,1,4,0
4825,6,3,16778,16778,16781,0,3,2
4826,6,1,16784,16784,16785,0,1,3
4827,5,1,16789,16789,16790,0,1,4
4828,5,1,16794,16794,16795,0,1,4
4829,3,2,16797,16797,16799,0,2,2
4830,3,1,16800,16800,16801,0,1,1
4831,1,2,16801,16801,16803,0,2,0
4832,1,1,16802,16803,16804,1,2,0
4833,4,2,16806,16806,16808,0,2,2
4834,5,3,16811,16811,16814,0,3,3
4835,5,2,16816,16816,16818,0,2,2
4836,3,1,16819,16819,16820,0,1,1
4837,1,1,16820,16820,16821,0,1,0
4838,3,2,16823,16823,16825,0,2,2
4839,6,1,16829,16829,16830,0,1,4
4840,3,2,16832,16832,16834,0,2,2
4841,4,3,16836,16836,16839,0,3,2
4842,3,2,16839,16839,16841,0,2,0
4843,6,1,16845,16845,16846,0,1,4
4844,3,3,16848,16848,16851,0,3,2
4845,6,2,16854,16854,16856,0,2,3
4846,4,3,16858,16858,16861,0,3,2
4847,6,2,16864,16864,16866,0,2,3
4848,3,2,16867,16867,16869,0,2,1
4849,1,3,16868,16869,16872,1,4,0
4850,2,2,16870,16872,16874,2,4,0
4851,5,1,16875,16875,16876,0,1,1
4852,4,3,16879,16879,16882,0,3,3
4853,4,1,16883,16883,16884,0,1,1
4854,3,1,16886,16886,16887,0,1,2
4855,6,1,16892,16892,16893,0,1,5
4856,5,3,16897,16897,16900,0,3,4
4857,3,2,16900,16900,16902,0,2,0
4858,2,1,16902,16902,16903,0,1,0
4859,1,1,16903,16903,16904,0,1,0
4860,6,2,16909,16909,16911,0,2,5
4861,3,2,16912,16912,16914,0,2,1
4862,3,2,16915,16915,16917,0,2,1
4863,2,3,16917,16917,16920,0,3,0
4864,3,2,16920,16920,16922,0,2,0
4865,6,1,16926,16926,16927,0,1,4
4866,2,1,16928,16928,16929,0,1,1
4867,2,3,16930,16930,16933,0,3,1
4868,6,1,16936,16936,16937,0,1,3
4869,4,2,16940,16940,16942,0,2,3
4870,6,3,16946,16946,16949,0,3,4
4871,5,3,16951,16951,16954,0,3,2
4872,6,1,16957,16957,16958,0,1,3
4873,5,3,16962,16962,16965,0,3,4
4874,4,1,16966,16966,16967,0,1,1
4875,4,3,16970,16970,16973,0,3,3
4876,6,2,16976,16976,16978,0,2,3
4877,3,2,16979,16979,16981,0,2,1
4878,1,3,16980,16981,16984,1,4,0
4879,6,1,16986,16986,16987,0,1,2
4880,4,2,16990,16990,16992,0,2,3
4881,6,1,16996,16996,16997,0,1,4
4882,1,2,16997,16997,16999,0,2,0
4883,3,2,17000,17000,17002,0,2,1
4884,2,2,17002,17002,17004,0,2,0
4885,5,2,17007,17007,17009,0,2,3
4886,5,1,17012,17012,17013,0,1,3
4887,5,3,17017,17017,17020,0,3,4
4888,5,1,17022,17022,17023,0,1,2
4889,4,3,17026,17026,17029,0,3,3
4890,2,3,17028,17029,17032,1,4,0
4891,4,2,17032,17032,17034,0,2,0
4892,1,1,17033,17034,17035,1,2,0
4893,1,3,17034,17035,17038,1,4,0
4894,5,2,17039,17039,17041,0,2,1
4895,5,1,17044,17044,17045,0,1,3
4896,2,2,17046,17046,17048,0,2,1
4897,2,3,17048,17048,17051,0,3,0
4898,5,2,17053,17053,17055,0,2,2
4899,4,2,17057,17057,17059,0,2,2
4900,5,1,17062,17062,17063,0,1,3
4901,6,2,17068,17068,17070,0,2,5
4902,6,3,17074,17074,17077,0,3,4
4903,4,3,17078,17078,17081,0,3,1
4904,3,3,17081,17081,17084,0,3,0
4905,4,2,17085,17085,17087,0,2,1
4906,1,1,17086,17087,17088,1,2,0
4907,4,3,17090,17090,17093,0,3,2
4908,3,3,17093,17093,17096,0,3,0
4909,6,3,17099,17099,17102,0,3,3
4910,5,3,17104,17104,17107,0,3,2
4911,4,3,17108,17108,17111,0,3,1
4912,5,1,17113,17113,17114,0,1,2
4913,5,2,17118,17118,17120,0,2,4
4914,3,1,17121,17121,17122,0,1,1
4915,5,3,17126,17126,17129,0,3,4
4916,4,2,17130,17130,17132,0,2,1
4917,3,1,17133,17133,17134,0,1,1
4918,5,1,17138,17138,17139,0,1,4
4919,6,3,17144,17144,17147,0,3,5
4920,1,2,17145,17147,17149,2,4,0
4921,5,2,17150,17150,17152,0,2,1
4922,6,3,17156,17156,17159,0,3,4
4923,5,3,17161,17161,17164,0,3,2
4924,1,1,17162,17164,17165,2,3,0
4925,3,3,17165,17165,17168,0,3,0
4926,6,3,17171,17171,17174,0,3,3
4927,2,1,17173,17174,17175,1,2,0
4928,5,1,17178,17178,17179,0,1,3
4929,6,2,17184,17184,17186,0,2,5
4930,4,2,17188,17188,17190,0,2,2
4931,6,1,17194,17194,17195,0,1,4
4932,2,1,17196,17196,17197,0,1,1
4933,2,3,17198,17198,17201,0,3,1
4934,4,1,17202,17202,17203,0,1,1
4935,3,1,17205,17205,17206,0,1,2
4936,3,2,17208,17208,17210,0,2,2
4937,3,2,17211,17211,17213,0,2,1
4938,4,2,17215,17215,17217,0,2,2
4939,1,2,17216,17217,17219,1,3,0
4940,4,3,17220,17220,17223,0,3,1
4941,2,3,17222,17223,17226,1,4,0
4942,4,2,17226,17226,17228,0,2,0
4943,5,1,17231,17231,17232,0,1,3
4944,5,2,17236,17236,17238,0,2,4
4945,6,1,17242,17242,17243,0,1,4
4946,3,3,17245,17245,17248,0,3,2
4947,1,2,17246,17248,17250,2,4,0
4948,5,2,17251,17251,17253,0,2,1
4949,2,3,17253,17253,17256,0,3,0
4950,5,3,17258,17258,17261,0,3,2
4951,3,2,17261,17261,17263,0,2,0
4952,2,2,17263,17263,17265,0,2,0
4953,6,3,17269,17269,17272,0,3,4
4954,4,3,17273,17273,17276,0,3,1
4955,3,2,17276,17276,17278,0,2,0
4956,5,2,17281,17281,17283,0,2,3
4957,4,3,17285,17285,17288,0,3,2
4958,3,3,17288,17288,17291,0,3,0
4959,1,1,17289,17291,17292,2,3,0
4960,1,3,17290,17292,17295,2,5,0
4961,5,2,17295,17295,17297,0,2,0
4962,2,2,17297,17297,17299,0,2,0
4963,2,1,17299,17299,17300,0,1,0
4964,3,1,17302,17302,17303,0,1,2
4965,5,1,17307,17307,17308,0,1,4
4966,3,1,17310,17310,17311,0,1,2
4967,5,2,17315,17315,17317,0,2,4
4968,6,2,17321,17321,17323,0,2,4
4969,1,2,17322,17323,17325,1,3,0
4970,6,2,17328,17328,17330,0,2,3
4971,4,3,17332,17332,17335,0,3,2
4972,1,3,17333,17335,17338,2,5,0
4973,2,2,17335,17338,17340,3,5,0
4974,2,1,17337,17340,17341,3,4,0
4975,4,1,17341,17341,17342,0,1,0
4976,5,2,17346,17346,17348,0,2,4
4977,3,2,17349,17349,17351,0,2,1
4978,3,1,17352,17352,17353,0,1,1
4979,6,2,17358,17358,17360,0,2,5
4980,6,1,17364,17364,17365,0,1,4
4981,5,2,17369,17369,17371,0,2,4
4982,2,3,17371,17371,17374,0,3,0
4983,2,1,17373,17374,17375,1,2,0
4984,2,3,17375,17375,17378,0,3,0
4985,3,2,17378,17378,17380,0,2,0
4986,2,3,17380,17380,17383,0,3,0
4987,6,3,17386,17386,17389,0,3,3
4988,3,2,17389,17389,17391,0,2,0
4989,6,2,17395,17395,17397,0,2,4
4990,2,1,17397,17397,17398,0,1,0
4991,2,1,17399,17399,17400,0,1,1
4992,3,1,17402,17402,17403,0,1,2
4993,4,1,17406,17406,17407,0,1,3
4994,5,3,17411,17411,17414,0,3,4
4995,3,3,17414,17414,17417,0,3,0
4996,5,1,17419,17419,17420,0,1,2
4997,6,2,17425,17425,17427,0,2,5
4998,4,2,17429,17429,17431,0,2,2
4999,6,1,17435,17435,17436,0,1,4
5000,3,2,17438,17438,17440,0,2,2
5001,2,3,17440,17440,17443,0,3,0
5002,1,3,17441,17443,17446,2,5,0
5003,3,1,17444,17446,17447,2,3,0
5004,6,2,17450,17450,17452,0,2,3
5005,4,3,17454,17454,17457,0,3,2
5006,4,2,17458,17458,17460,0,2,1
5007,1,1,17459,17460,17461,1,2,0
5008,1,2,17460,17461,17463,1,3,0
5009,4,3,17464,17464,17467,0,3,1
5010,6,1,17470,17470,17471,0,1,3
5011,2,3,17472,17472,17475,0,3,1
5012,4,3,17476,17476,17479,0,3,1
5013,4,2,17480,17480,17482,0,2,1
5014,1,3,17481,17482,17485,1,4,0
5015,6,1,17487,17487,17488,0,1,2
5016,5,3,17492,17492,17495,0,3,4
5017,5,3,17497,17497,17500,0,3,2
5018,4,2,17501,17501,17503,0,2,1
5019,5,1,17506,17506,17507,0,1,3
5020,4,3,17510,17510,17513,0,3,3
5021,6,3,17516,17516,17519,0,3,3
5022,6,3,17522,17522,17525,0,3,3
5023,4,3,17526,17526,17529,0,3,1
5024,3,1,17529,17529,17530,0,1,0
5025,6,2,17535,17535,17537,0,2,5
5026,1,3,17536,17537,17540,1,4,0
5027,1,2,17537,17540,17542,3,5,0
5028,6,1,17543,17543,17544,0,1,1
5029,2,2,17545,17545,17547,0,2,1
5030,2,2,17547,17547,17549,0,2,0
5031,5,1,17552,17552,17553,0,1,3
5032,5,2,17557,17557,17559,0,2,4
5033,3,2,17560,17560,17562,0,2,1
5034,6,1,17566,17566,17567,0,1,4
5035,3,1,17569,17569,17570,0,1,2
5036,2,2,17571,17571,17573,0,2,1
5037,3,2,17574,17574,17576,0,2,1
5038,2,3,17576,17576,17579,0,3,0
5039,4,1,17580,17580,17581,0,1,1
5040,5,3,17585,17585,17588,0,3,4
5041,6,1,17591,17591,17592,0,1,3
5042,6,3,17597,17597,17600,0,3,5
5043,1,1,17598,17600,17601,2,3,0
5044,6,3,17604,17604,17607,0,3,3
5045,5,2,17609,17609,17611,0,2,2
5046,2,1,17611,17611,17612,0,1,0
5047,4,1,17615,17615,17616,0,1,3
5048,2,2,17617,17617,17619,0,2,1
5049,5,2,17622,17622,17624,0,2,3
5050,1,1,17623,17624,17625,1,2,0
5051,1,3,17624,17625,17628,1,4,0
5052,4,3,17628,17628,17631,0,3,0
5053,2,1,17630,17631,17632,1,2,0
5054,5,1,17635,17635,17636,0,1,3
5055,4,1,17639,17639,17640,0,1,3
5056,4,1,17643,17643,17644,0,1,3
5057,1,3,17644,17644,17647,0,3,0
5058,1,1,17645,17647,17648,2,3,0
5059,1,1,17646,17648,17649,2,3,0
5060,3,1,17649,17649,17650,0,1,0
5061,1,1,17650,17650,17651,0,1,0
5062,4,3,17654,17654,17657,0,3,3
5063,1,3,17655,17657,17660,2,5,0
5064,2,2,17657,17660,17662,3,5,0
5065,1,3,17658,17662,17665,4,7,0
5066,3,1,17661,17665,17666,4,5,0
5067,2,2,17663,17666,17668,3,5,0
5068,1,2,17664,17668,17670,4,6,0
5069,6,1,17670,17670,17671,0,1,0
5070,1,2,17671,17671,17673,0,2,0
5071,6,1,17677,17677,17678,0,1,4
5072,5,1,17682,17682,17683,0,1,4
5073,3,2,17685,17685,17687,0,2,2
5074,3,3,17688,17688,17691,0,3,1
5075,4,1,17692,17692,17693,0,1,1
5076,3,3,17695,17695,17698,0,3,2
5077,1,2,17696,17698,17700,2,4,0
5078,6,3,17702,17702,17705,0,3,2
5079,1,1,17703,17705,17706,2,3,0
5080,6,1,17709,17709,17710,0,1,3
5081,5,3,17714,17714,17717,0,3,4
5082,6,3,17720,17720,17723,0,3,3
5083,4,3,17724,17724,17727,0,3,1
5084,6,2,17730,17730,17732,0,2,3
5085,2,2,17732,17732,17734,0,2,0
5086,6,3,17738,17738,17741,0,3,4
5087,2,1,17740,17741,17742,1,2,0
5088,4,3,17744,17744,17747,0,3,2
5089,2,1,17746,17747,17748,1,2,0
5090,6,3,17752,17752,17755,0,3,4
5091,6,3,17758,17758,17761,0,3,3
5092,3,2,17761,17761,17763,0,2,0
5093,5,2,17766,17766,17768,0,2,3
5094,1,1,17767,17768,17769,1,2,0
5095,4,2,17771,17771,17773,0,2,2
5096,5,1,17776,17776,17777,0,1,3
5097,4,1,17780,17780,17781,0,1,3
5098,3,3,17783,17783,17786,0,3,2
5099,3,1,17786,17786,17787,0,1,0
5100,3,2,17789,17789,17791,0,2,2
5101,1,3,17790,17791,17794,1,4,0
5102,1,1,17791,17794,17795,3,4,0
5103,3,1,17794,17795,17796,1,2,0
5104,1,2,17795,17796,17798,1,3,0
5105,3,3,17798,17798,17801,0,3,0
5106,6,2,17804,17804,17806,0,2,3
5107,5,1,17809,17809,17810,0,1,3
5108,4,3,17813,17813,17816,0,3,3
5109,4,3,17817,17817,17820,0,3,1
5110,4,3,17821,17821,17824,0,3,1
5111,6,1,17827,17827,17828,0,1,3
5112,5,1,17832,17832,17833,0,1,4
5113,4,3,17836,17836,17839,0,3,3
5114,6,1,17842,17842,17843,0,1,3
5115,5,3,17847,17847,17850,0,3,4
5116,1,3,17848,17850,17853,2,5,0
5117,2,1,17850,17853,17854,3,4,0
5118,1,1,17851,17854,17855,3,4,0
5119,3,1,17854,17855,17856,1,2,0
5120,1,2,17855,17856,17858,1,3,0
5121,1,2,17856,17858,17860,2,4,0
5122,2,2,17858,17860,17862,2,4,0
5123,6,1,17864,17864,17865,0,1,2
5124,1,1,17865,17865,17866,0,1,0
5125,1,3,17866,17866,17869,0,3,0
5126,1,2,17867,17869,17871,2,4,0
5127,5,2,17872,17872,17874,0,2,1
5128,3,1,17875,17875,17876,0,1,1
5129,6,3,17881,17881,17884,0,3,5
5130,4,1,17885,17885,17886,0,1,1
5131,2,3,17887,17887,17890,0,3,1
5132,1,2,17888,17890,17892,2,4,0
5133,4,1,17892,17892,17893,0,1,0
5134,4,2,17896,17896,17898,0,2,3
5135,2,2,17898,17898,17900,0,2,0
5136,5,1,17903,17903,17904,0,1,3
5137,6,3,17909,17909,17912,0,3,5
5138,6,3,17915,17915,17918,0,3,3
5139,1,1,17916,17918,17919,2,3,0
5140,4,3,17920,17920,17923,0,3,1
5141,2,3,17922,17923,17926,1,4,0
5142,5,3,17927,17927,17930,0,3,1
5143,2,2,17929,17930,17932,1,3,0
5144,1,3,17930,17932,17935,2,5,0
5145,6,1,17936,17936,17937,0,1,1
5146,2,1,17938,17938,17939,0,1,1
5147,6,1,17944,17944,17945,0,1,5
5148,4,3,17948,17948,17951,0,3,3
5149,6,1,17954,17954,17955,0,1,3
5150,5,1,17959,17959,17960,0,1,4
5151,6,1,17965,17965,17966,0,1,5
5152,5,1,17970,17970,17971,0,1,4
5153,5,2,17975,17975,17977,0,2,4
5154,6,2,17981,17981,17983,0,2,4
5155,5,3,17986,17986,17989,0,3,3
5156,6,2,17992,17992,17994,0,2,3
5157,2,3,17994,17994,17997,0,3,0
5158,5,2,17999,17999,18001,0,2,2
5159,3,1,18002,18002,18003,0,1,1
5160,4,2,18006,18006,18008,0,2,3
5161,6,1,18012,18012,18013,0,1,4
5162,5,2,18017,18017,18019,0,2,4
5163,6,3,18023,18023,18026,0,3,4
5164,6,3,18029,18029,18032,0,3,3
5165,3,1,18032,18032,18033,0,1,0
5166,1,3,18033,18033,18036,0,3,0
5167,3,3,18036,18036,18039,0,3,0
5168,5,1,18041,18041,18042,0,1,2
5169,1,3,18042,18042,18045,0,3,0
5170,5,2,18047,18047,18049,0,2,2
5171,5,2,18052,18052,18054,0,2,3
5172,6,1,18058,18058,18059,0,1,4
5173,3,2,18061,18061,18063,0,2,2
5174,2,3,18063,18063,18066,0,3,0
5175,2,3,18065,18066,18069,1,4,0
5176,5,2,18070,18070,18072,0,2,1
5177,4,1,18074,18074,18075,0,1,2
5178,3,1,18077,18077,18078,0,1,2
5179,1,1,18078,18078,18079,0,1,0
5180,4,1,18082,18082,18083,0,1,3
5181,2,2,18084,18084,18086,0,2,1
5182,1,2,18085,18086,18088,1,3,0
5183,4,3,18089,18089,18092,0,3,1
5184,5,3,18094,18094,18097,0,3,2
5185,1,2,18095,18097,18099,2,4,0
5186,5,2,18100,18100,18102,0,2,1
5187,6,3,18106,18106,18109,0,3,4
5188,5,2,18111,18111,18113,0,2,2
5189,5,1,18116,18116,18117,0,1,3
5190,6,3,18122,18122,18125,0,3,5
5191,1,3,18123,18125,18128,2,5,0
5192,4,3,18127,18128,18131,1,4,0
5193,2,3,18129,18131,18134,2,5,0
5194,2,2,18131,18134,18136,3,5,0
5195,6,2,18137,18137,18139,0,2,1
5196,4,3,18141,18141,18144,0,3,2
5197,3,2,18144,18144,18146,0,2,0
5198,3,2,18147,18147,18149,0,2,1
5199,6,2,18153,18153,18155,0,2,4
5200,4,1,18157,18157,18158,0,1,2
5201,2,3,18159,18159,18162,0,3,1
5202,1,3,18160,18162,18165,2,5,0
5203,1,1,18161,18165,18166,4,5,0
5204,1,3,18162,18166,18169,4,7,0
5205,1,2,18163,18169,18171,6,8,0
5206,3,2,18166,18171,18173,5,7,0
5207,2,3,18168,18173,18176,5,8,0
5208,6,3,18174,18176,18179,2,5,0
5209,4,1,18178,18179,18180,1,2,0
5210,5,2,18183,18183,18185,0,2,3
5211,2,2,18185,18185,18187,0,2,0
5212,5,3,18190,18190,18193,0,3,3
5213,6,3,18196,18196,18199,0,3,3
5214,5,2,18201,18201,18203,0,2,2
5215,5,3,18206,18206,18209,0,3,3
5216,6,3,18212,18212,18215,0,3,3
5217,3,1,18215,18215,18216,0,1,0
5218,6,3,18221,18221,18224,0,3,5
5219,6,1,18227,18227,18228,0,1,3
5220,1,2,18228,18228,18230,0,2,0
5221,1,1,18229,18230,18231,1,2,0
5222,3,3,18232,18232,18235,0,3,1
5223,3,1,18235,18235,18236,0,1,0
5224,5,2,18240,18240,18242,0,2,4
5225,4,2,18244,18244,18246,0,2,2
5226,6,3,18250,18250,18253,0,3,4
5227,1,3,18251,18253,18256,2,5,0
5228,6,1,18257,18257,18258,0,1,1
5229,1,2,18258,18258,18260,0,2,0
5230,2,2,18260,18260,18262,0,2,0
5231,6,1,18266,18266,18267,0,1,4
5232,2,2,18268,18268,18270,0,2,1
5233,5,1,18273,18273,18274,0,1,3
5234,3,2,18276,18276,18278,0,2,2
5235,2,1,18278,18278,18279,0,1,0
5236,3,3,18281,18281,18284,0,3,2
5237,5,2,18286,18286,18288,0,2,2
5238,1,3,18287,18288,18291,1,4,0
5239,2,3,18289,18291,18294,2,5,0
5240,5,1,18294,18294,18295,0,1,0
5241,3,3,18297,18297,18300,0,3,2
5242,6,2,18303,18303,18305,0,2,3
5243,2,2,18305,18305,18307,0,2,0
5244,5,2,18310,18310,18312,0,2,3
5245,6,2,18316,18316,18318,0,2,4
5246,2,2,18318,18318,18320,0,2,0
5247,5,1,18323,18323,18324,0,1,3
5248,4,2,18327,18327,18329,0,2,3
5249,3,1,18330,18330,18331,0,1,1
5250,4,2,18334,18334,18336,0,2,3
5251,5,2,18339,18339,18341,0,2,3
5252,6,3,18345,18345,18348,0,3,4
5253,3,2,18348,18348,18350,0,2,0
5254,3,3,18351,18351,18354,0,3,1
5255,3,1,18354,18354,18355,0,1,0
5256,6,2,18360,18360,18362,0,2,5
5257,1,3,18361,18362,18365,1,4,0
5258,4,2,18365,18365,18367,0,2,0
5259,6,3,18371,18371,18374,0,3,4
5260,4,1,18375,18375,18376,0,1,1
5261,2,2,18377,18377,18379,0,2,1
5262,3,2,18380,18380,18382,0,2,1
5263,3,1,18383,18383,18384,0,1,1
5264,5,1,18388,18388,18389,0,1,4
5265,3,2,18391,18391,18393,0,2,2
5266,5,1,18396,18396,18397,0,1,3
5267,4,3,18400,18400,18403,0,3,3
5268,4,2,18404,18404,18406,0,2,1
5269,4,1,18408,18408,18409,0,1,2
5270,5,1,18413,18413,18414,0,1,4
5271,2,3,18415,18415,18418,0,3,1
5272,4,1,18419,18419,18420,0,1,1
5273,2,2,18421,18421,18423,0,2,1
5274,3,1,18424,18424,18425,0,1,1
5275,6,1,18430,18430,18431,0,1,5
5276,4,3,18434,18434,18437,0,3,3
5277,6,2,18440,18440,18442,0,2,3
5278,2,3,18442,18442,18445,0,3,0
5279,2,3,18444,18445,18448,1,4,0
5280,5,3,18449,18449,18452,0,3,1
5281,1,3,18450,18452,18455,2,5,0
5282,4,2,18454,18455,18457,1,3,0
5283,5,3,18459,18459,18462,0,3,2
5284,3,1,18462,18462,18463,0,1,0
5285,6,2,18468,18468,18470,0,2,5
5286,5,3,18473,18473,18476,0,3,3
5287,6,3,18479,18479,18482,0,3,3
5288,5,1,18484,18484,18485,0,1,2
5289,3,3,18487,18487,18490,0,3,2
5290,4,3,18491,18491,18494,0,3,1
5291,3,1,18494,18494,18495,0,1,0
5292,1,2,18495,18495,18497,0,2,0
5293,1,1,18496,18497,18498,1,2,0
5294,2,1,18498,18498,18499,0,1,0
5295,5,1,18503,18503,18504,0,1,4
5296,4,3,18507,18507,18510,0,3,3
5297,4,2,18511,18511,18513,0,2,1
5298,1,1,18512,18513,18514,1,2,0
5299,1,1,18513,18514,18515,1,2,0
5300,3,2,18516,18516,18518,0,2,1
5301,1,3,18517,18518,18521,1,4,0
5302,5,3,18522,18522,18525,0,3,1
5303,2,1,18524,18525,18526,1,2,0
5304,5,1,18529,18529,18530,0,1,3
5305,1,1,18530,18530,18531,0,1,0
5306,2,2,18532,18532,18534,0,2,1
5307,5,1,18537,18537,18538,0,1,3
5308,1,3,18538,18538,18541,0,3,0
5309,6,2,18544,18544,18546,0,2,3
5310,3,2,18547,18547,18549,0,2,1
5311,2,3,18549,18549,18552,0,3,0
5312,4,1,18553,18553,18554,0,1,1
5313,2,2,18555,18555,18557,0,2,1
5314,1,2,18556,18557,18559,1,3,0
5315,3,3,18559,18559,18562,0,3,0
5316,4,3,18563,18563,18566,0,3,1
5317,1,1,18564,18566,18567,2,3,0
5318,2,2,18566,18567,18569,1,3,0
5319,6,2,18572,18572,18574,0,2,3
5320,5,2,18577,18577,18579,0,2,3
5321,6,1,18583,18583,18584,0,1,4
5322,5,2,18588,18588,18590,0,2,4
5323,6,1,18594,18594,18595,0,1,4
5324,5,1,18599,18599,18600,0,1,4
5325,1,2,18600,18600,18602,0,2,0
5326,4,3,18604,18604,18607,0,3,2
5327,1,3,18605,18607,18610,2,5,0
5328,4,2,18609,18610,18612,1,3,0
5329,2,1,18611,18612,18613,1,2,0
5330,1,1,18612,18613,18614,1,2,0
5331,5,1,18617,18617,18618,0,1,3
5332,6,3,18623,18623,18626,0,3,5
5333,2,2,18625,18626,18628,1,3,0
5334,5,2,18630,18630,18632,0,2,2
5335,4,1,18634,18634,18635,0,1,2
5336,4,3,18638,18638,18641,0,3,3
5337,2,3,18640,18641,18644,1,4,0
5338,3,2,18643,18644,18646,1,3,0
5339,3,2,18646,18646,18648,0,2,0
5340,6,3,18652,18652,18655,0,3,4
5341,6,2,18658,18658,18660,0,2,3
5342,5,2,18663,18663,18665,0,2,3
5343,3,3,18666,18666,18669,0,3,1
5344,1,2,18667,18669,18671,2,4,0
5345,4,3,18671,18671,18674,0,3,0
5346,4,3,18675,18675,18678,0,3,1
5347,5,2,18680,18680,18682,0,2,2
5348,4,1,18684,18684,18685,0,1,2
5349,1,3,18685,18685,18688,0,3,0
5350,2,3,18687,18688,18691,1,4,0
5351,1,2,18688,18691,18693,3,5,0
5352,5,3,18693,18693,18696,0,3,0
5353,3,3,18696,18696,18699,0,3,0
5354,6,1,18702,18702,18703,0,1,3
5355,1,3,18703,18703,18706,0,3,0
5356,3,1,18706,18706,18707,0,1,0
5357,1,1,18707,18707,18708,0,1,0
5358,2,1,18709,18709,18710,0,1,1
5359,5,3,18714,18714,18717,0,3,4
5360,6,3,18720,18720,18723,0,3,3
5361,1,1,18721,18723,18724,2,3,0
5362,1,3,18722,18724,18727,2,5,0
5363,2,2,18724,18727,18729,3,5,0
5364,3,3,18727,18729,18732,2,5,0
5365,2,3,18729,18732,18735,3,6,0
5366,4,1,18733,18735,18736,2,3,0
5367,6,3,18739,18739,18742,0,3,3
5368,2,2,18741,18742,18744,1,3,0
5369,6,3,18747,18747,18750,0,3,3
5370,5,3,18752,18752,18755,0,3,2
5371,1,3,18753,18755,18758,2,5,0
5372,4,2,18757,18758,18760,1,3,0
5373,2,1,18759,18760,18761,1,2,0
5374,6,2,18765,18765,18767,0,2,4
5375,4,3,18769,18769,18772,0,3,2
5376,1,2,18770,18772,18774,2,4,0
5377,5,3,18775,18775,18778,0,3,1
5378,4,1,18779,18779,18780,0,1,1
5379,5,1,18784,18784,18785,0,1,4
5380,1,1,18785,18785,18786,0,1,0
5381,2,1,18787,18787,18788,0,1,1
5382,6,3,18793,18793,18796,0,3,5
5383,3,2,18796,18796,18798,0,2,0
5384,6,3,18802,18802,18805,0,3,4
5385,3,2,18805,18805,18807,0,2,0
5386,4,2,18809,18809,18811,0,2,2
5387,5,2,18814,18814,18816,0,2,3
5388,2,2,18816,18816,18818,0,2,0
5389,2,2,18818,18818,18820,0,2,0
5390,5,2,18823,18823,18825,0,2,3
5391,6,1,18829,18829,18830,0,1,4
5392,1,2,18830,18830,18832,0,2,0
5393,5,2,18835,18835,18837,0,2,3
5394,3,1,18838,18838,18839,0,1,1
5395,3,2,18841,18841,18843,0,2,2
5396,5,3,18846,18846,18849,0,3,3
5397,4,1,18850,18850,18851,0,1,1
5398,5,2,18855,18855,18857,0,2,4
5399,3,2,18858,18858,18860,0,2,1
5400,2,3,18860,18860,18863,0,3,0
5401,4,2,18864,18864,18866,0,2,1
5402,2,1,18866,18866,18867,0,1,0
5403,4,1,18870,18870,18871,0,1,3
5404,4,1,18874,18874,18875,0,1,3
5405,1,3,18875,18875,18878,0,3,0
5406,6,1,18881,18881,18882,0,1,3
5407,1,1,18882,18882,18883,0,1,0
5408,6,2,18888,18888,18890,0,2,5
5409,2,3,18890,18890,18893,0,3,0
5410,3,3,18893,18893,18896,0,3,0
5411,5,3,18898,18898,18901,0,3,2
5412,4,1,18902,18902,18903,0,1,1
5413,3,2,18905,18905,18907,0,2,2
5414,1,1,18906,18907,18908,1,2,0
5415,2,3,18908,18908,18911,0,3,0
5416,6,3,18914,18914,18917,0,3,3
5417,6,3,18920,18920,18923,0,3,3
5418,4,2,18924,18924,18926,0,2,1
5419,1,1,18925,18926,18927,1,2,0
5420,1,1,18926,18927,18928,1,2,0
5421,1,2,18927,18928,18930,1,3,0
5422,3,3,18930,18930,18933,0,3,0
5423,5,2,18935,18935,18937,0,2,2
5424,4,2,18939,18939,18941,0,2,2
5425,3,3,18942,18942,18945,0,3,1
5426,3,2,18945,18945,18947,0,2,0
5427,1,2,18946,18947,18949,1,3,0
5428,3,3,18949,18949,18952,0,3,0
5429,5,3,18954,18954,18957,0,3,2
5430,3,1,18957,18957,18958,0,1,0
5431,5,2,18962,18962,18964,0,2,4
5432,6,1,18968,18968,18969,0,1,4
5433,4,1,18972,18972,18973,0,1,3
5434,1,1,18973,18973,18974,0,1,0
5435,4,2,18977,18977,18979,0,2,3
5436,5,1,18982,18982,18983,0,1,3
5437,4,1,18986,18986,18987,0,1,3
5438,1,2,18987,18987,18989,0,2,0
5439,4,1,18991,18991,18992,0,1,2
5440,5,1,18996,18996,18997,0,1,4
5441,4,2,19000,19000,19002,0,2,3
5442,4,1,19004,19004,19005,0,1,2
5443,2,3,19006,19006,19009,0,3,1
5444,6,3,19012,19012,19015,0,3,3
5445,2,3,19014,19015,19018,1,4,0
5446,6,2,19020,19020,19022,0,2,2
5447,4,1,19024,19024,19025,0,1,2
5448,4,2,19028,19028,19030,0,2,3
5449,2,2,19030,19030,19032,0,2,0
5450,3,3,19033,19033,19036,0,3,1
5451,1,1,19034,19036,19037,2,3,0
5452,6,1,19040,19040,19041,0,1,3
5453,6,1,19046,19046,19047,0,1,5
5454,2,1,19048,19048,19049,0,1,1
5455,4,3,19052,19052,19055,0,3,3
5456,4,3,19056,19056,19059,0,3,1
5457,5,2,19061,19061,19063,0,2,2
5458,3,2,19064,19064,19066,0,2,1
5459,4,2,19068,19068,19070,0,2,2
5460,2,2,19070,19070,19072,0,2,0
5461,6,1,19076,19076,19077,0,1,4
5462,5,3,19081,19081,19084,0,3,4
5463,5,1,19086,19086,19087,0,1,2
5464,5,2,19091,19091,19093,0,2,4
5465,1,1,19092,19093,19094,1,2,0
5466,1,2,19093,19094,19096,1,3,0
5467,4,2,19097,19097,19099,0,2,1
5468,6,2,19103,19103,19105,0,2,4
5469,3,2,19106,19106,19108,0,2,1
5470,1,2,19107,19108,19110,1,3,0
5471,4,2,19111,19111,19113,0,2,1
5472,2,1,19113,19113,19114,0,1,0
5473,3,2,19116,19116,19118,0,2,2
5474,2,3,19118,19118,19121,0,3,0
5475,4,1,19122,19122,19123,0,1,1
5476,4,2,19126,19126,19128,0,2,3
5477,6,1,19132,19132,19133,0,1,4
5478,5,2,19137,19137,19139,0,2,4
5479,4,3,19141,19141,19144,0,3,2
5480,2,3,19143,19144,19147,1,4,0
5481,4,3,19147,19147,19150,0,3,0
5482,6,1,19153,19153,19154,0,1,3
5483,4,1,19157,19157,19158,0,1,3
5484,3,2,19160,19160,19162,0,2,2
5485,5,2,19165,19165,19167,0,2,3
5486,6,1,19171,19171,19172,0,1,4
5487,6,1,19177,19177,19178,0,1,5
5488,1,1,19178,19178,19179,0,1,0
5489,6,3,19184,19184,19187,0,3,5
5490,6,3,19190,19190,19193,0,3,3
5491,3,1,19193,19193,19194,0,1,0
5492,1,1,19194,19194,19195,0,1,0
5493,4,1,19198,19198,19199,0,1,3
5494,4,1,19202,19202,19203,0,1,3
5495,5,2,19207,19207,19209,0,2,4
5496,4,1,19211,19211,19212,0,1,2
5497,3,1,19214,19214,19215,0,1,2
5498,6,3,19220,19220,19223,0,3,5
5499,1,1,19221,19223,19224,2,3,0
5500,4,1,19225,19225,19226,0,1,1
5501,1,1,19226,19226,19227,0,1,0
5502,3,3,19229,19229,19232,0,3,2
5503,5,1,19234,19234,19235,0,1,2
5504,1,3,19235,19235,19238,0,3,0
5505,3,1,19238,19238,19239,0,1,0
5506,4,2,19242,19242,19244,0,2,3
5507,6,3,19248,19248,19251,0,3,4
5508,5,1,19253,19253,19254,0,1,2
5509,5,3,19258,19258,19261,0,3,4
5510,6,1,19264,19264,19265,0,1,3
5511,6,2,19270,19270,19272,0,2,5
5512,4,1,19274,19274,19275,0,1,2
5513,2,2,19276,19276,19278,0,2,1
5514,5,1,19281,19281,19282,0,1,3
5515,3,3,19284,19284,19287,0,3,2
5516,4,3,19288,19288,19291,0,3,1
5517,3,2,19291,19291,19293,0,2,0
5518,6,2,19297,19297,19299,0,2,4
5519,2,1,19299,19299,19300,0,1,0
5520,3,3,19302,19302,19305,0,3,2
5521,3,1,19305,19305,19306,0,1,0
5522,3,3,19308,19308,19311,0,3,2
5523,3,3,19311,19311,19314,0,3,0
5524,6,2,19317,19317,19319,0,2,3
5525,4,2,19321,19321,19323,0,2,2
5526,2,2,19323,19323,19325,0,2,0
5527,4,3,19327,19327,19330,0,3,2
5528,4,3,19331,19331,19334,0,3,1
5529,2,3,19333,19334,19337,1,4,0
5530,2,2,19335,19337,19339,2,4,0
5531,2,3,19337,19339,19342,2,5,0
5532,4,1,19341,19342,19343,1,2,0
5533,5,3,19346,19346,19349,0,3,3
5534,2,3,19348,19349,19352,1,4,0
5535,2,3,19350,19352,19355,2,5,0
5536,2,3,19352,19355,19358,3,6,0
5537,3,2,19355,19358,19360,3,5,0
5538,6,3,19361,19361,19364,0,3,1
5539,1,3,19362,19364,19367,2,5,0
5540,4,3,19366,19367,19370,1,4,0
5541,3,2,19369,19370,19372,1,3,0
5542,3,2,19372,19372,19374,0,2,0
5543,5,3,19377,19377,19380,0,3,3
5544,5,3,19382,19382,19385,0,3,2
5545,1,2,19383,19385,19387,2,4,0
5546,5,2,19388,19388,19390,0,2,1
5547,1,2,19389,19390,19392,1,3,0
5548,6,3,19395,19395,19398,0,3,3
5549,1,2,19396,19398,19400,2,4,0
5550,3,3,19399,19400,19403,1,4,0
5551,3,1,19402,19403,19404,1,2,0
5552,5,3,19407,19407,19410,0,3,3
5553,1,3,19408,19410,19413,2,5,0
5554,6,2,19414,19414,19416,0,2,1
5555,2,2,19416,19416,19418,0,2,0
5556,3,3,19419,19419,19422,0,3,1
5557,6,2,19425,19425,19427,0,2,3
5558,5,1,19430,19430,19431,0,1,3
5559,2,3,19432,19432,19435,0,3,1
5560,1,1,19433,19435,19436,2,3,0
5561,5,1,19438,19438,19439,0,1,2
5562,1,2,19439,19439,19441,0,2,0
5563,5,3,19444,19444,19447,0,3,3
5564,2,1,19446,19447,19448,1,2,0
5565,4,1,19450,19450,19451,0,1,2
5566,5,1,19455,19455,19456,0,1,4
5567,1,3,19456,19456,19459,0,3,0
5568,4,1,19460,19460,19461,0,1,1
5569,6,1,19466,19466,19467,0,1,5
5570,5,2,19471,19471,19473,0,2,4
5571,4,1,19475,19475,19476,0,1,2
5572,4,2,19479,19479,19481,0,2,3
5573,5,3,19484,19484,19487,0,3,3
5574,3,3,19487,19487,19490,0,3,0
5575,4,2,19491,19491,19493,0,2,1
5576,3,3,19494,19494,19497,0,3,1
5577,1,3,19495,19497,19500,2,5,0
5578,2,2,19497,19500,19502,3,5,0
5579,3,1,19500,19502,19503,2,3,0
5580,6,2,19506,19506,19508,0,2,3
5581,2,3,19508,19508,19511,0,3,0
5582,5,3,19513,19513,19516,0,3,2
5583,5,2,19518,19518,19520,0,2,2
5584,2,1,19520,19520,19521,0,1,0
5585,3,3,19523,19523,19526,0,3,2
5586,2,3,19525,19526,19529,1,4,0
5587,1,3,19526,19529,19532,3,6,0
5588,3,1,19529,19532,19533,3,4,0
5589,2,3,19531,19533,19536,2,5,0
5590,6,2,19537,19537,19539,0,2,1
5591,4,2,19541,19541,19543,0,2,2
5592,1,1,19542,19543,19544,1,2,0
5593,6,1,19548,19548,19549,0,1,4
5594,5,1,19553,19553,19554,0,1,4
5595,1,3,19554,19554,19557,0,3,0
5596,1,3,19555,19557,19560,2,5,0
5597,5,1,19560,19560,19561,0,1,0
5598,3,2,19563,19563,19565,0,2,2
5599,6,1,19569,19569,19570,0,1,4
5600,5,1,19574,19574,19575,0,1,4
5601,2,2,19576,19576,19578,0,2,1
5602,6,2,19582,19582,19584,0,2,4
5603,1,1,19583,19584,19585,1,2,0
5604,6,1,19589,19589,19590,0,1,4
5605,5,3,19594,19594,19597,0,3,4
5606,5,1,19599,19599,19600,0,1,2
5607,6,2,19605,19605,19607,0,2,5
5608,4,1,19609,19609,19610,0,1,2
5609,1,2,19610,19610,19612,0,2,0
5610,1,3,19611,19612,19615,1,4,0
5611,3,1,19614,19615,19616,1,2,0
5612,3,1,19617,19617,19618,0,1,1
5613,1,3,19618,19618,19621,0,3,0
5614,5,1,19623,19623,19624,0,1,2
5615,6,1,19629,19629,19630,0,1,5
5616,2,2,19631,19631,19633,0,2,1
5617,1,2,19632,19633,19635,1,3,0
5618,1,2,19633,19635,19637,2,4,0
5619,6,2,19639,19639,19641,0,2,2
5620,3,1,19642,19642,19643,0,1,1
5621,3,1,19645,19645,19646,0,1,2
5622,4,1,19649,19649,19650,0,1,3
5623,1,3,19650,19650,19653,0,3,0
5624,6,3,19656,19656,19659,0,3,3
5625,2,3,19658,19659,19662,1,4,0
5626,2,3,19660,19662,19665,2,5,0
5627,6,1,19666,19666,19667,0,1,1
5628,2,2,19668,19668,19670,0,2,1
5629,2,1,19670,19670,19671,0,1,0
5630,5,2,19675,19675,19677,0,2,4
5631,1,2,19676,19677,19679,1,3,0
5632,3,3,19679,19679,19682,0,3,0
5633,1,1,19680,19682,19683,2,3,0
5634,2,2,19682,19683,19685,1,3,0
5635,5,3,19687,19687,19690,0,3,2
5636,2,2,19689,19690,19692,1,3,0
5637,2,3,19691,19692,19695,1,4,0
5638,3,2,19694,19695,19697,1,3,0
5639,1,3,19695,19697,19700,2,5,0
5640,5,2,19700,19700,19702,0,2,0
5641,1,1,19701,19702,19703,1,2,0
5642,1,1,19702,19703,19704,1,2,0
5643,1,3,19703,19704,19707,1,4,0
5644,2,2,19705,19707,19709,2,4,0
5645,1,1,19706,19709,19710,3,4,0
5646,3,2,19709,19710,19712,1,3,0
5647,3,1,19712,19712,19713,0,1,0
5648,3,2,19715,19715,19717,0,2,2
5649,6,1,19721,19721,19722,0,1,4
5650,6,2,19727,19727,19729,0,2,5
5651,1,1,19728,19729,19730,1,2,0
5652,5,1,19733,19733,19734,0,1,3
5653,2,3,19735,19735,19738,0,3,1
5654,3,3,19738,19738,19741,0,3,0
5655,2,2,19740,19741,19743,1,3,0
5656,4,2,19744,19744,19746,0,2,1
5657,2,2,19746,19746,19748,0,2,0
5658,6,2,19752,19752,19754,0,2,4
5659,6,1,19758,19758,19759,0,1,4
5660,2,1,19760,19760,19761,0,1,1
5661,6,1,19766,19766,19767,0,1,5
5662,1,1,19767,19767,19768,0,1,0
5663,6,3,19773,19773,19776,0,3,5
5664,2,3,19775,19776,19779,1,4,0
5665,4,2,19779,19779,19781,0,2,0
5666,1,1,19780,19781,19782,1,2,0
5667,4,3,19784,19784,19787,0,3,2
5668,2,2,19786,19787,19789,1,3,0
5669,5,1,19791,19791,19792,0,1,2
5670,1,3,19792,19792,19795,0,3,0
5671,6,1,19798,19798,19799,0,1,3
5672,6,2,19804,19804,19806,0,2,5
5673,4,1,19808,19808,19809,0,1,2
5674,5,3,19813,19813,19816,0,3,4
5675,3,3,19816,19816,19819,0,3,0
5676,1,1,19817,19819,19820,2,3,0
5677,1,3,19818,19820,19823,2,5,0
5678,3,2,19821,19823,19825,2,4,0
5679,2,1,19823,19825,19826,2,3,0
5680,2,1,19825,19826,19827,1,2,0
5681,2,1,19827,19827,19828,0,1,0
5682,6,1,19833,19833,19834,0,1,5
5683,1,1,19834,19834,19835,0,1,0
5684,5,1,19839,19839,19840,0,1,4
5685,1,1,19840,19840,19841,0,1,0
5686,6,2,19846,19846,19848,0,2,5
5687,4,2,19850,19850,19852,0,2,2
5688,3,3,19853,19853,19856,0,3,1
5689,2,2,19855,19856,19858,1,3,0
5690,2,3,19857,19858,19861,1,4,0
5691,4,3,19861,19861,19864,0,3,0
5692,2,3,19863,19864,19867,1,4,0
5693,5,2,19868,19868,19870,0,2,1
5694,6,1,19874,19874,19875,0,1,4
5695,3,1,19877,19877,19878,0,1,2
5696,4,3,19881,19881,19884,0,3,3
5697,3,1,19884,19884,19885,0,1,0
5698,3,2,19887,19887,19889,0,2,2
5699,6,1,19893,19893,19894,0,1,4
5700,1,1,19894,19894,19895,0,1,0
5701,5,2,19899,19899,19901,0,2,4
5702,3,1,19902,19902,19903,0,1,1
5703,5,3,19907,19907,19910,0,3,4
5704,1,2,19908,19910,19912,2,4,0
5705,2,3,19910,19912,19915,2,5,0
5706,6,1,19916,19916,19917,0,1,1
5707,2,3,19918,19918,19921,0,3,1
5708,2,3,19920,19921,19924,1,4,0
5709,4,3,19924,19924,19927,0,3,0
5710,6,3,19930,19930,19933,0,3,3
5711,2,3,19932,19933,19936,1,4,0
5712,5,3,19937,19937,19940,0,3,1
5713,6,2,19943,19943,19945,0,2,3
5714,2,2,19945,19945,19947,0,2,0
5715,3,3,19948,19948,19951,0,3,1
5716,2,1,19950,19951,19952,1,2,0
5717,2,1,19952,19952,19953,0,1,0
5718,5,3,19957,19957,19960,0,3,4
5719,1,3,19958,19960,19963,2,5,0
5720,4,3,19962,19963,19966,1,4,0
5721,4,3,19966,19966,19969,0,3,0
5722,5,2,19971,19971,19973,0,2,2
5723,1,3,19972,19973,19976,1,4,0
5724,1,3,19973,19976,19979,3,6,0
5725,6,2,19979,19979,19981,0,2,0
5726,2,2,19981,19981,19983,0,2,0
5727,6,1,19987,19987,19988,0,1,4
5728,1,1,19988,19988,19989,0,1,0
5729,1,3,19989,19989,19992,0,3,0
5730,3,1,19992,19992,19993,0,1,0
5731,1,2,19993,19993,19995,0,2,0
5732,4,2,19997,19997,19999,0,2,2
5733,5,1,20002,20002,20003,0,1,3
5734,4,2,20006,20006,20008,0,2,3
5735,3,2,20009,20009,20011,0,2,1
5736,1,1,20010,20011,20012,1,2,0
5737,3,3,20013,20013,20016,0,3,1
5738,1,1,20014,20016,20017,2,3,0
5739,4,3,20018,20018,20021,0,3,1
5740,5,2,20023,20023,20025,0,2,2
5741,5,1,20028,20028,20029,0,1,3
5742,4,1,20032,20032,20033,0,1,3
5743,4,3,20036,20036,20039,0,3,3
5744,4,1,20040,20040,20041,0,1,1
5745,3,1,20043,20043,20044,0,1,2
5746,3,2,20046,20046,20048,0,2,2
5747,1,1,20047,20048,20049,1,2,0
5748,6,2,20053,20053,20055,0,2,4
5749,4,2,20057,20057,20059,0,2,2
5750,5,2,20062,20062,20064,0,2,3
5751,6,1,20068,20068,20069,0,1,4
5752,1,1,20069,20069,20070,0,1,0
5753,3,1,20072,20072,20073,0,1,2
5754,3,3,20075,20075,20078,0,3,2
5755,5,1,20080,20080,20081,0,1,2
5756,5,2,20085,20085,20087,0,2,4
5757,5,2,20090,20090,20092,0,2,3
5758,3,1,20093,20093,20094,0,1,1
5759,5,2,20098,20098,20100,0,2,4
5760,5,1,20103,20103,20104,0,1,3
5761,1,2,20104,20104,20106,0,2,0
5762,5,1,20109,20109,20110,0,1,3
5763,6,1,20115,20115,20116,0,1,5
5764,6,2,20121,20121,20123,0,2,5
5765,6,1,20127,20127,20128,0,1,4
5766,4,3,20131,20131,20134,0,3,3
5767,4,3,20135,20135,20138,0,3,1
5768,5,3,20140,20140,20143,0,3,2
5769,4,1,20144,20144,20145,0,1,1
5770,6,3,20150,20150,20153,0,3,5
5771,2,1,20152,20153,20154,1,2,0
5772,6,3,20158,20158,20161,0,3,4
5773,2,3,20160,20161,20164,1,4,0
5774,6,3,20166,20166,20169,0,3,2
5775,3,3,20169,20169,20172,0,3,0
5776,4,2,20173,20173,20175,0,2,1
5777,1,1,20174,20175,20176,1,2,0
5778,6,1,20180,20180,20181,0,1,4
5779,3,1,20183,20183,20184,0,1,2
5780,1,1,20184,20184,20185,0,1,0
5781,3,2,20187,20187,20189,0,2,2
5782,2,1,20189,20189,20190,0,1,0
5783,4,3,20193,20193,20196,0,3,3
5784,1,3,20194,20196,20199,2,5,0
5785,4,3,20198,20199,20202,1,4,0
5786,3,1,20201,20202,20203,1,2,0
5787,4,2,20205,20205,20207,0,2,2
5788,4,3,20209,20209,20212,0,3,2
5789,6,3,20215,20215,20218,0,3,3
5790,5,3,20220,20220,20223,0,3,2
5791,4,1,20224,20224,20225,0,1,1
5792,4,1,20228,20228,20229,0,1,3
5793,5,3,20233,20233,20236,0,3,4
5794,6,2,20239,20239,20241,0,2,3
5795,5,3,20244,20244,20247,0,3,3
5796,4,2,20248,20248,20250,0,2,1
5797,4,2,20252,20252,20254,0,2,2
5798,5,2,20257,20257,20259,0,2,3
5799,3,2,20260,20260,20262,0,2,1
5800,4,1,20264,20264,20265,0,1,2
5801,3,2,20267,20267,20269,0,2,2
5802,5,2,20272,20272,20274,0,2,3
5803,1,2,20273,20274,20276,1,3,0
5804,6,1,20279,20279,20280,0,1,3
5805,1,1,20280,20280,20281,0,1,0
5806,6,3,20286,20286,20289,0,3,5
5807,5,3,20291,20291,20294,0,3,2
5808,3,3,20294,20294,20297,0,3,0
5809,2,1,20296,20297,20298,1,2,0
5810,4,3,20300,20300,20303,0,3,2
5811,6,3,20306,20306,20309,0,3,3
5812,4,2,20310,20310,20312,0,2,1
5813,6,1,20316,20316,20317,0,1,4
5814,4,2,20320,20320,20322,0,2,3
5815,6,1,20326,20326,20327,0,1,4
5816,1,2,20327,20327,20329,0,2,0
5817,1,2,20328,20329,20331,1,3,0
5818,2,1,20330,20331,20332,1,2,0
5819,2,1,20332,20332,20333,0,1,0
5820,6,1,20338,20338,20339,0,1,5
5821,2,2,20340,20340,20342,0,2,1
5822,6,2,20346,20346,20348,0,2,4
5823,2,3,20348,20348,20351,0,3,0
5824,6,1,20354,20354,20355,0,1,3
5825,4,1,20358,20358,20359,0,1,3
5826,2,1,20360,20360,20361,0,1,1
5827,1,3,20361,20361,20364,0,3,0
5828,3,3,20364,20364,20367,0,3,0
5829,6,1,20370,20370,20371,0,1,3
5830,6,1,20376,20376,20377,0,1,5
5831,3,1,20379,20379,20380,0,1,2
5832,3,2,20382,20382,20384,0,2,2
5833,4,2,20386,20386,20388,0,2,2
5834,2,1,20388,20388,20389,0,1,0
5835,4,3,20392,20392,20395,0,3,3
5836,4,2,20396,20396,20398,0,2,1
5837,6,2,20402,20402,20404,0,2,4
5838,4,2,20406,20406,20408,0,2,2
5839,5,3,20411,20411,20414,0,3,3
5840,1,2,20412,20414,20416,2,4,0
5841,5,2,20417,20417,20419,0,2,1
5842,4,2,20421,20421,20423,0,2,2
5843,2,3,20423,20423,20426,0,3,0
5844,3,2,20426,20426,20428,0,2,0
5845,5,3,20431,20431,20434,0,3,3
5846,3,3,20434,20434,20437,0,3,0
5847,1,1,20435,20437,20438,2,3,0
5848,4,2,20439,20439,20441,0,2,1
5849,1,1,20440,20441,20442,1,2,0
5850,1,1,20441,20442,20443,1,2,0
5851,6,1,20447,20447,20448,0,1,4
5852,6,3,20453,20453,20456,0,3,5
5853,4,2,20457,20457,20459,0,2,1
5854,5,3,20462,20462,20465,0,3,3
5855,4,3,20466,20466,20469,0,3,1
5856,5,2,20471,20471,20473,0,2,2
5857,1,1,20472,20473,20474,1,2,0
5858,3,1,20475,20475,20476,0,1,1
5859,1,1,20476,20476,20477,0,1,0
5860,3,1,20479,20479,20480,0,1,2
5861,2,1,20481,20481,20482,0,1,1
5862,4,3,20485,20485,20488,0,3,3
5863,3,2,20488,20488,20490,0,2,0
5864,6,1,20494,20494,20495,0,1,4
5865,2,1,20496,20496,20497,0,1,1
5866,4,1,20500,20500,20501,0,1,3
5867,1,2,20501,20501,20503,0,2,0
5868,1,2,20502,20503,20505,1,3,0
5869,4,3,20506,20506,20509,0,3,1
5870,2,2,20508,20509,20511,1,3,0
5871,3,1,20511,20511,20512,0,1,0
5872,6,2,20517,20517,20519,0,2,5
5873,4,1,20521,20521,20522,0,1,2
5874,3,3,20524,20524,20527,0,3,2
5875,6,1,20530,20530,20531,0,1,3
5876,6,1,20536,20536,20537,0,1,5
5877,1,3,20537,20537,20540,0,3,0
5878,3,1,20540,20540,20541,0,1,0
5879,5,3,20545,20545,20548,0,3,4
5880,4,1,20549,20549,20550,0,1,1
5881,2,3,20551,20551,20554,0,3,1
5882,3,3,20554,20554,20557,0,3,0
5883,4,3,20558,20558,20561,0,3,1
5884,4,2,20562,20562,20564,0,2,1
5885,1,1,20563,20564,20565,1,2,0
5886,6,3,20569,20569,20572,0,3,4
5887,5,2,20574,20574,20576,0,2,2
5888,6,3,20580,20580,20583,0,3,4
5889,4,1,20584,20584,20585,0,1,1
5890,5,3,20589,20589,20592,0,3,4
5891,6,2,20595,20595,20597,0,2,3
5892,1,1,20596,20597,20598,1,2,0
5893,3,3,20599,20599,20602,0,3,1
5894,5,1,20604,20604,20605,0,1,2
5895,6,1,20610,20610,20611,0,1,5
5896,1,3,20611,20611,20614,0,3,0
5897,2,3,20613,20614,20617,1,4,0
5898,5,2,20618,20618,20620,0,2,1
5899,5,2,20623,20623,20625,0,2,3
5900,4,2,20627,20627,20629,0,2,2
5901,3,1,20630,20630,20631,0,1,1
5902,4,1,20634,20634,20635,0,1,3
5903,5,1,20639,20639,20640,0,1,4
5904,3,2,20642,20642,20644,0,2,2
5905,1,1,20643,20644,20645,1,2,0
5906,3,3,20646,20646,20649,0,3,1
5907,6,1,20652,20652,20653,0,1,3
5908,3,2,20655,20655,20657,0,2,2
5909,5,1,20660,20660,20661,0,1,3
5910,6,2,20666,20666,20668,0,2,5
5911,1,2,20667,20668,20670,1,3,0
5912,1,2,20668,20670,20672,2,4,0
5913,5,2,20673,20673,20675,0,2,1
5914,3,2,20676,20676,20678,0,2,1
5915,2,3,20678,20678,20681,0,3,0
5916,1,3,20679,20681,20684,2,5,0
5917,6,1,20685,20685,20686,0,1,1
5918,6,2,20691,20691,20693,0,2,5
5919,3,2,20694,20694,20696,0,2,1
5920,4,1,20698,20698,20699,0,1,2
5921,6,3,20704,20704,20707,0,3,5
5922,5,2,20709,20709,20711,0,2,2
5923,3,1,20712,20712,20713,0,1,1
5924,1,3,20713,20713,20716,0,3,0
5925,4,2,20717,20717,20719,0,2,1
5926,2,3,20719,20719,20722,0,3,0
5927,4,3,20723,20723,20726,0,3,1
5928,5,2,20728,20728,20730,0,2,2
5929,4,2,20732,20732,20734,0,2,2
5930,4,3,20736,20736,20739,0,3,2
5931,6,2,20742,20742,20744,0,2,3
5932,1,3,20743,20744,20747,1,4,0
5933,1,3,20744,20747,20750,3,6,0
5934,3,2,20747,20750,20752,3,5,0
5935,6,2,20753,20753,20755,0,2,1
5936,2,3,20755,20755,20758,0,3,0
5937,1,2,20756,20758,20760,2,4,0
5938,5,1,20761,20761,20762,0,1,1
5939,1,1,20762,20762,20763,0,1,0
5940,1,2,20763,20763,20765,0,2,0
5941,4,1,20767,20767,20768,0,1,2
5942,1,3,20768,20768,20771,0,3,0
5943,4,3,20772,20772,20775,0,3,1
5944,6,1,20778,20778,20779,0,1,3
5945,6,1,20784,20784,20785,0,1,5
5946,6,3,20790,20790,20793,0,3,5
5947,4,1,20794,20794,20795,0,1,1
5948,1,3,20795,20795,20798,0,3,0
5949,6,3,20801,20801,20804,0,3,3
5950,5,3,20806,20806,20809,0,3,2
5951,4,1,20810,20810,20811,0,1,1
5952,1,2,20811,20811,20813,0,2,0
5953,2,1,20813,20813,20814,0,1,0
5954,1,1,20814,20814,20815,0,1,0
5955,2,3,20816,20816,20819,0,3,1
5956,1,2,20817,20819,20821,2,4,0
5957,3,2,20820,20821,20823,1,3,0
5958,6,1,20826,20826,20827,0,1,3
5959,6,3,20832,20832,20835,0,3,5
5960,3,3,20835,20835,20838,0,3,0
5961,2,3,20837,20838,20841,1,4,0
5962,3,1,20840,20841,20842,1,2,0
5963,3,2,20843,20843,20845,0,2,1
5964,5,3,20848,20848,20851,0,3,3
5965,1,1,20849,20851,20852,2,3,0
5966,5,3,20854,20854,20857,0,3,2
5967,4,1,20858,20858,20859,0,1,1
5968,6,3,20864,20864,20867,0,3,5
5969,5,1,20869,20869,20870,0,1,2
5970,2,3,20871,20871,20874,0,3,1
5971,5,2,20876,20876,20878,0,2,2
5972,2,2,20878,20878,20880,0,2,0
5973,6,3,20884,20884,20887,0,3,4
5974,3,3,20887,20887,20890,0,3,0
5975,3,2,20890,20890,20892,0,2,0
5976,4,3,20894,20894,20897,0,3,2
5977,4,1,20898,20898,20899,0,1,1
5978,4,3,20902,20902,20905,0,3,3
5979,1,2,20903,20905,20907,2,4,0
5980,5,3,20908,20908,20911,0,3,1
5981,5,1,20913,20913,20914,0,1,2
5982,2,1,20915,20915,20916,0,1,1
5983,2,2,20917,20917,20919,0,2,1
5984,3,1,20920,20920,20921,0,1,1
5985,3,2,20923,20923,20925,0,2,2
5986,3,1,20926,20926,20927,0,1,1
5987,5,2,20931,20931,20933,0,2,4
5988,6,3,20937,20937,20940,0,3,4
5989,2,3,20939,20940,20943,1,4,0
5990,6,1,20945,20945,20946,0,1,2
5991,3,1,20948,20948,20949,0,1,2
5992,4,3,20952,20952,20955,0,3,3
5993,3,3,20955,20955,20958,0,3,0
5994,6,3,20961,20961,20964,0,3,3
5995,5,3,20966,20966,20969,0,3,2
5996,6,2,20972,20972,20974,0,2,3
5997,5,2,20977,20977,20979,0,2,3
5998,5,3,20982,20982,20985,0,3,3
5999,4,3,20986,20986,20989,0,3,1
6000,6,3,20992,20992,20995,0,3,3
6001,3,3,20995,20995,20998,0,3,0
6002,5,2,21000,21000,21002,0,2,2
6003,6,1,21006,21006,21007,0,1,4
6004,1,1,21007,21007,21008,0,1,0
6005,4,1,21011,21011,21012,0,1,3
6006,1,2,21012,21012,21014,0,2,0
6007,5,2,21017,21017,21019,0,2,3
6008,2,2,21019,21019,21021,0,2,0
6009,4,3,21023,21023,21026,0,3,2
6010,5,3,21028,21028,21031,0,3,2
6011,4,1,21032,21032,21033,0,1,1
6012,2,2,21034,21034,21036,0,2,1
6013,1,1,21035,21036,21037,1,2,0
6014,4,2,21039,21039,21041,0,2,2
6015,2,1,21041,21041,21042,0,1,0
6016,1,1,21042,21042,21043,0,1,0
6017,6,2,21048,21048,21050,0,2,5
6018,6,1,21054,21054,21055,0,1,4
6019,3,2,21057,21057,21059,0,2,2
6020,3,1,21060,21060,21061,0,1,1
6021,2,1,21062,21062,21063,0,1,1
6022,5,1,21067,21067,21068,0,1,4
6023,2,3,21069,21069,21072,0,3,1
6024,4,1,21073,21073,21074,0,1,1
6025,2,3,21075,21075,21078,0,3,1
6026,4,3,21079,21079,21082,0,3,1
6027,5,2,21084,21084,21086,0,2,2
6028,6,2,21090,21090,21092,0,2,4
6029,3,2,21093,21093,21095,0,2,1
6030,5,1,21098,21098,21099,0,1,3
6031,2,1,21100,21100,21101,0,1,1
6032,6,1,21106,21106,21107,0,1,5
6033,4,3,21110,21110,21113,0,3,3
6034,2,2,21112,21113,21115,1,3,0
6035,2,2,21114,21115,21117,1,3,0
6036,3,3,21117,21117,21120,0,3,0
6037,4,2,21121,21121,21123,0,2,1
6038,4,3,21125,21125,21128,0,3,2
6039,4,2,21129,21129,21131,0,2,1
6040,6,1,21135,21135,21136,0,1,4
6041,5,3,21140,21140,21143,0,3,4
6042,4,2,21144,21144,21146,0,2,1
6043,5,1,21149,21149,21150,0,1,3
6044,4,3,21153,21153,21156,0,3,3
6045,5,1,21158,21158,21159,0,1,2
6046,5,3,21163,21163,21166,0,3,4
6047,3,1,21166,21166,21167,0,1,0
6048,6,3,21172,21172,21175,0,3,5
6049,5,3,21177,21177,21180,0,3,2
6050,3,2,21180,21180,21182,0,2,0
6051,4,1,21184,21184,21185,0,1,2
6052,5,1,21189,21189,21190,0,1,4
6053,3,2,21192,21192,21194,0,2,2
6054,2,1,21194,21194,21195,0,1,0
6055,5,3,21199,21199,21202,0,3,4
6056,5,3,21204,21204,21207,0,3,2
6057,2,3,21206,21207,21210,1,4,0
6058,6,2,21212,21212,21214,0,2,2
6059,6,1,21218,21218,21219,0,1,4
6060,6,2,21224,21224,21226,0,2,5
6061,4,1,21228,21228,21229,0,1,2
6062,4,1,21232,21232,21233,0,1,3
6063,1,3,21233,21233,21236,0,3,0
6064,2,1,21235,21236,21237,1,2,0
6065,1,3,21236,21237,21240,1,4,0
6066,5,2,21241,21241,21243,0,2,1
6067,6,2,21247,21247,21249,0,2,4
6068,4,3,21251,21251,21254,0,3,2
6069,4,1,21255,21255,21256,0,1,1
6070,2,2,21257,21257,21259,0,2,1
6071,4,1,21261,21261,21262,0,1,2
6072,5,1,21266,21266,21267,0,1,4
6073,2,3,21268,21268,21271,0,3,1
6074,2,3,21270,21271,21274,1,4,0
6075,2,3,21272,21274,21277,2,5,0
6076,4,3,21276,21277,21280,1,4,0
6077,4,3,21280,21280,21283,0,3,0
6078,1,1,21281,21283,21284,2,3,0
6079,6,2,21287,21287,21289,0,2,3
6080,4,2,21291,21291,21293,0,2,2
6081,4,2,21295,21295,21297,0,2,2
6082,2,1,21297,21297,21298,0,1,0
6083,3,2,21300,21300,21302,0,2,2
6084,1,3,21301,21302,21305,1,4,0
6085,2,2,21303,21305,21307,2,4,0
6086,3,1,21306,21307,21308,1,2,0
6087,4,2,21310,21310,21312,0,2,2
6088,3,1,21313,21313,21314,0,1,1
6089,4,3,21317,21317,21320,0,3,3
6090,2,3,21319,21320,21323,1,4,0
6091,5,3,21324,21324,21327,0,3,1
6092,3,2,21327,21327,21329,0,2,0
6093,1,2,21328,21329,21331,1,3,0
6094,5,1,21333,21333,21334,0,1,2
6095,6,1,21339,21339,21340,0,1,5
6096,3,3,21342,21342,21345,0,3,2
6097,2,2,21344,21345,21347,1,3,0
6098,6,3,21350,21350,21353,0,3,3
6099,1,3,21351,21353,21356,2,5,0
6100,1,2,21352,21356,21358,4,6,0
6101,3,2,21355,21358,21360,3,5,0
6102,4,3,21359,21360,21363,1,4,0
6103,2,3,21361,21363,21366,2,5,0
6104,6,1,21367,21367,21368,0,1,1
6105,4,1,21371,21371,21372,0,1,3
6106,4,3,21375,21375,21378,0,3,3
6107,1,2,21376,21378,21380,2,4,0
6108,6,3,21382,21382,21385,0,3,2
6109,6,3,21388,21388,21391,0,3,3
6110,1,1,21389,21391,21392,2,3,0
6111,2,2,21391,21392,21394,1,3,0
6112,6,3,21397,21397,21400,0,3,3
6113,4,3,21401,21401,21404,0,3,1
6114,1,3,21402,21404,21407,2,5,0
6115,2,1,21404,21407,21408,3,4,0
6116,3,2,21407,21408,21410,1,3,0
6117,5,1,21412,21412,21413,0,1,2
6118,6,3,21418,21418,21421,0,3,5
6119,1,1,21419,21421,21422,2,3,0
6120,4,1,21423,21423,21424,0,1,1
6121,4,2,21427,21427,21429,0,2,3
6122,5,1,21432,21432,21433,0,1,3
6123,1,2,21433,21433,21435,0,2,0
6124,5,1,21438,21438,21439,0,1,3
6125,3,3,21441,21441,21444,0,3,2
6126,5,3,21446,21446,21449,0,3,2
6127,2,2,21448,21449,21451,1,3,0
6128,4,2,21452,21452,21454,0,2,1
6129,5,1,21457,21457,21458,0,1,3
6130,3,1,21460,21460,21461,0,1,2
6131,5,1,21465,21465,21466,0,1,4
6132,4,2,21469,21469,21471,0,2,3
6133,3,3,21472,21472,21475,0,3,1
6134,2,3,21474,21475,21478,1,4,0
6135,3,2,21477,21478,21480,1,3,0
6136,5,3,21482,21482,21485,0,3,2
6137,5,1,21487,21487,21488,0,1,2
6138,6,1,21493,21493,21494,0,1,5
6139,1,3,21494,21494,21497,0,3,0
6140,6,2,21500,21500,21502,0,2,3
6141,5,1,21505,21505,21506,0,1,3
6142,4,1,21509,21509,21510,0,1,3
6143,5,3,21514,21514,21517,0,3,4
6144,1,3,21515,21517,21520,2,5,0
6145,6,1,21521,21521,21522,0,1,1
6146,4,3,21525,21525,21528,0,3,3
6147,1,3,21526,21528,21531,2,5,0
6148,1,1,21527,21531,21532,4,5,0
6149,2,1,21529,21532,21533,3,4,0
6150,1,3,21530,21533,21536,3,6,0
6151,6,3,21536,21536,21539,0,3,0
6152,4,2,21540,21540,21542,0,2,1
6153,4,2,21544,21544,21546,0,2,2
6154,6,1,21550,21550,21551,0,1,4
6155,3,2,21553,21553,21555,0,2,2
6156,5,2,21558,21558,21560,0,2,3
6157,2,3,21560,21560,21563,0,3,0
6158,1,1,21561,21563,21564,2,3,0
6159,2,2,21563,21564,21566,1,3,0
6160,1,3,21564,21566,21569,2,5,0
6161,2,2,21566,21569,21571,3,5,0
6162,3,3,21569,21571,21574,2,5,0
6163,3,3,21572,21574,21577,2,5,0
6164,1,1,21573,21577,21578,4,5,0
6165,5,1,21578,21578,21579,0,1,0
6166,6,2,21584,21584,21586,0,2,5
6167,3,3,21587,21587,21590,0,3,1
6168,4,1,21591,21591,21592,0,1,1
6169,4,1,21595,21595,21596,0,1,3
6170,5,1,21600,21600,21601,0,1,4
6171,4,1,21604,21604,21605,0,1,3
6172,6,3,21610,21610,21613,0,3,5
6173,3,1,21613,21613,21614,0,1,0
6174,4,1,21617,21617,21618,0,1,3
6175,1,3,21618,21618,21621,0,3,0
6176,5,2,21623,21623,21625,0,2,2
6177,4,2,21627,21627,21629,0,2,2
6178,5,2,21632,21632,21634,0,2,3
6179,6,2,21638,21638,21640,0,2,4
6180,1,3,21639,21640,21643,1,4,0
6181,4,2,21643,21643,21645,0,2,0
6182,5,3,21648,21648,21651,0,3,3
6183,3,3,21651,21651,21654,0,3,0
6184,3,2,21654,21654,21656,0,2,0
6185,4,3,21658,21658,21661,0,3,2
6186,5,3,21663,21663,21666,0,3,2
6187,6,2,21669,21669,21671,0,2,3
6188,3,2,21672,21672,21674,0,2,1
6189,6,1,21678,21678,21679,0,1,4
6190,4,2,21682,21682,21684,0,2,3
6191,5,1,21687,21687,21688,0,1,3
6192,6,3,21693,21693,21696,0,3,5
6193,2,3,21695,21696,21699,1,4,0
6194,3,2,21698,21699,21701,1,3,0
6195,2,1,21700,21701,21702,1,2,0
6196,4,2,21704,21704,21706,0,2,2
6197,5,3,21709,21709,21712,0,3,3
6198,4,2,21713,21713,21715,0,2,1
6199,4,3,21717,21717,21720,0,3,2
6200,5,3,21722,21722,21725,0,3,2
6201,1,2,21723,21725,21727,2,4,0
6202,1,3,21724,21727,21730,3,6,0
6203,2,3,21726,21730,21733,4,7,0
6204,4,1,21730,21733,21734,3,4,0
6205,6,1,21736,21736,21737,0,1,2
6206,2,2,21738,21738,21740,0,2,1
6207,5,2,21743,21743,21745,0,2,3
6208,5,1,21748,21748,21749,0,1,3
6209,3,3,21751,21751,21754,0,3,2
6210,4,1,21755,21755,21756,0,1,1
6211,6,2,21761,21761,21763,0,2,5
6212,4,3,21765,21765,21768,0,3,2
6213,4,1,21769,21769,21770,0,1,1
6214,4,1,21773,21773,21774,0,1,3
6215,5,3,21778,21778,21781,0,3,4
6216,2,3,21780,21781,21784,1,4,0
6217,4,3,21784,21784,21787,0,3,0
6218,3,2,21787,21787,21789,0,2,0
6219,6,3,21793,21793,21796,0,3,4
6220,4,2,21797,21797,21799,0,2,1
6221,5,1,21802,21802,21803,0,1,3
6222,1,3,21803,21803,21806,0,3,0
6223,5,2,21808,21808,21810,0,2,2
6224,3,2,21811,21811,21813,0,2,1
6225,1,2,21812,21813,21815,1,3,0
6226,3,2,21815,21815,21817,0,2,0
6227,2,2,21817,21817,21819,0,2,0
6228,4,2,21821,21821,21823,0,2,2
6229,6,3,21827,21827,21830,0,3,4
6230,5,1,21832,21832,21833,0,1,2
6231,5,3,21837,21837,21840,0,3,4
6232,2,1,21839,21840,21841,1,2,0
6233,1,2,21840,21841,21843,1,3,0
6234,2,3,21842,21843,21846,1,4,0
6235,2,2,21844,21846,21848,2,4,0
6236,6,2,21850,21850,21852,0,2,2
6237,6,3,21856,21856,21859,0,3,4
6238,3,1,21859,21859,21860,0,1,0
6239,5,1,21864,21864,21865,0,1,4
6240,5,1,21869,21869,21870,0,1,4
6241,5,1,21874,21874,21875,0,1,4
6242,1,1,21875,21875,21876,0,1,0
6243,2,1,21877,21877,21878,0,1,1
6244,4,2,21881,21881,21883,0,2,3
6245,4,2,21885,21885,21887,0,2,2
6246,2,2,21887,21887,21889,0,2,0
6247,5,3,21892,21892,21895,0,3,3
6248,1,1,21893,21895,21896,2,3,0
6249,1,3,21894,21896,21899,2,5,0
6250,5,2,21899,21899,21901,0,2,0
6251,5,2,21904,21904,21906,0,2,3
6252,4,2,21908,21908,21910,0,2,2
6253,5,1,21913,21913,21914,0,1,3
6254,3,1,21916,21916,21917,0,1,2
6255,3,3,21919,21919,21922,0,3,2
6256,4,3,21923,21923,21926,0,3,1
6257,4,3,21927,21927,21930,0,3,1
6258,4,2,21931,21931,21933,0,2,1
6259,3,3,21934,21934,21937,0,3,1
6260,1,2,21935,21937,21939,2,4,0
6261,6,3,21941,21941,21944,0,3,2
6262,1,3,21942,21944,21947,2,5,0
6263,5,1,21947,21947,21948,0,1,0
6264,1,3,21948,21948,21951,0,3,0
6265,1,3,21949,21951,21954,2,5,0
6266,1,3,21950,21954,21957,4,7,0
6267,4,1,21954,21957,21958,3,4,0
6268,3,2,21957,21958,21960,1,3,0
6269,2,1,21959,21960,21961,1,2,0
6270,6,2,21965,21965,21967,0,2,4
6271,6,1,21971,21971,21972,0,1,4
6272,5,1,21976,21976,21977,0,1,4
6273,3,2,21979,21979,21981,0,2,2
6274,5,1,21984,21984,21985,0,1,3
6275,1,1,21985,21985,21986,0,1,0
6276,4,3,21989,21989,21992,0,3,3
6277,1,3,21990,21992,21995,2,5,0
6278,2,1,21992,21995,21996,3,4,0
6279,6,3,21998,21998,22001,0,3,2
6280,1,1,21999,22001,22002,2,3,0
6281,5,3,22004,22004,22007,0,3,2
6282,4,2,22008,22008,22010,0,2,1
6283,1,2,22009,22010,22012,1,3,0
6284,5,2,22014,22014,22016,0,2,2
6285,4,2,22018,22018,22020,0,2,2
6286,6,1,22024,22024,22025,0,1,4
6287,6,2,22030,22030,22032,0,2,5
6288,6,3,22036,22036,22039,0,3,4
6289,2,3,22038,22039,22042,1,4,0
6290,4,2,22042,22042,22044,0,2,0
6291,4,3,22046,22046,22049,0,3,2
6292,1,3,22047,22049,22052,2,5,0
6293,4,1,22051,22052,22053,1,2,0
6294,5,3,22056,22056,22059,0,3,3
6295,1,2,22057,22059,22061,2,4,0
6296,3,2,22060,22061,22063,1,3,0
6297,6,3,22066,22066,22069,0,3,3
6298,6,3,22072,22072,22075,0,3,3
6299,1,2,22073,22075,22077,2,4,0
6300,1,1,22074,22077,22078,3,4,0
6301,2,2,22076,22078,22080,2,4,0
6302,1,1,22077,22080,22081,3,4,0
6303,4,2,22081,22081,22083,0,2,0
6304,1,3,22082,22083,22086,1,4,0
6305,3,2,22085,22086,22088,1,3,0
6306,3,2,22088,22088,22090,0,2,0
6307,4,2,22092,22092,22094,0,2,2
6308,6,1,22098,22098,22099,0,1,4
6309,1,1,22099,22099,22100,0,1,0
6310,5,2,22104,22104,22106,0,2,4
6311,1,1,22105,22106,22107,1,2,0
6312,5,1,22110,22110,22111,0,1,3
6313,5,2,22115,22115,22117,0,2,4
6314,3,3,22118,22118,22121,0,3,1
6315,3,2,22121,22121,22123,0,2,0
6316,6,2,22127,22127,22129,0,2,4
6317,5,1,22132,22132,22133,0,1,3
6318,1,3,22133,22133,22136,0,3,0
6319,1,3,22134,22136,22139,2,5,0
6320,5,2,22139,22139,22141,0,2,0
6321,1,1,22140,22141,22142,1,2,0
6322,2,1,22142,22142,22143,0,1,0
6323,3,2,22145,22145,22147,0,2,2
6324,5,1,22150,22150,22151,0,1,3
6325,2,3,22152,22152,22155,0,3,1
6326,5,3,22157,22157,22160,0,3,2
6327,2,2,22159,22160,22162,1,3,0
6328,3,2,22162,22162,22164,0,2,0
6329,3,3,22165,22165,22168,0,3,1
6330,6,2,22171,22171,22173,0,2,3
6331,1,2,22172,22173,22175,1,3,0
6332,1,3,22173,22175,22178,2,5,0
6333,2,1,22175,22178,22179,3,4,0
6334,1,2,22176,22179,22181,3,5,0
6335,2,1,22178,22181,22182,3,4,0
6336,2,3,22180,22182,22185,2,5,0
6337,5,3,22185,22185,22188,0,3,0
6338,3,2,22188,22188,22190,0,2,0
6339,1,2,22189,22190,22192,1,3,0
6340,4,2,22193,22193,22195,0,2,1
6341,3,1,22196,22196,22197,0,1,1
6342,1,1,22197,22197,22198,0,1,0
6343,1,3,22198,22198,22201,0,3,0
6344,5,3,22203,22203,22206,0,3,2
6345,5,1,22208,22208,22209,0,1,2
6346,1,2,22209,22209,22211,0,2,0
6347,2,1,22211,22211,22212,0,1,0
6348,4,1,22215,22215,22216,0,1,3
6349,6,2,22221,22221,22223,0,2,5
6350,4,3,22225,22225,22228,0,3,2
6351,3,3,22228,22228,22231,0,3,0
6352,3,1,22231,22231,22232,0,1,0
6353,3,2,22234,22234,22236,0,2,2
6354,1,1,22235,22236,22237,1,2,0
6355,4,3,22239,22239,22242,0,3,2
6356,4,3,22243,22243,22246,0,3,1
6357,3,3,22246,22246,22249,0,3,0
6358,5,3,22251,22251,22254,0,3,2
6359,5,2,22256,22256,22258,0,2,2
6360,1,2,22257,22258,22260,1,3,0
6361,2,2,22259,22260,22262,1,3,0
6362,5,2,22264,22264,22266,0,2,2
6363,3,1,22267,22267,22268,0,1,1
6364,4,2,22271,22271,22273,0,2,3
6365,4,2,22275,22275,22277,0,2,2
6366,1,2,22276,22277,22279,1,3,0
6367,1,1,22277,22279,22280,2,3,0
6368,4,2,22281,22281,22283,0,2,1
6369,1,3,22282,22283,22286,1,4,0
6370,2,2,22284,22286,22288,2,4,0
6371,2,1,22286,22288,22289,2,3,0
6372,3,3,22289,22289,22292,0,3,0
6373,6,2,22295,22295,22297,0,2,3
6374,4,1,22299,22299,22300,0,1,2
6375,3,2,22302,22302,22304,0,2,2
6376,1,1,22303,22304,22305,1,2,0
6377,1,2,22304,22305,22307,1,3,0
6378,6,3,22310,22310,22313,0,3,3
6379,6,3,22316,22316,22319,0,3,3
6380,5,1,22321,22321,22322,0,1,2
6381,3,3,22324,22324,22327,0,3,2
6382,2,1,22326,22327,22328,1,2,0
6383,4,2,22330,22330,22332,0,2,2
6384,5,1,22335,22335,22336,0,1,3
6385,5,2,22340,22340,22342,0,2,4
6386,4,3,22344,22344,22347,0,3,2
6387,2,2,22346,22347,22349,1,3,0
6388,2,3,22348,22349,22352,1,4,0
6389,6,1,22354,22354,22355,0,1,2
6390,1,1,22355,22355,22356,0,1,0
6391,4,3,22359,22359,22362,0,3,3
6392,2,1,22361,22362,22363,1,2,0
6393,4,1,22365,22365,22366,0,1,2
6394,4,3,22369,22369,22372,0,3,3
6395,5,1,22374,22374,22375,0,1,2
6396,4,3,22378,22378,22381,0,3,3
6397,6,3,22384,22384,22387,0,3,3
6398,3,2,22387,22387,22389,0,2,0
6399,2,3,22389,22389,22392,0,3,0
6400,4,2,22393,22393,22395,0,2,1
6401,5,3,22398,22398,22401,0,3,3
6402,1,2,22399,22401,22403,2,4,0
6403,3,1,22402,22403,22404,1,2,0
6404,2,3,22404,22404,22407,0,3,0
6405,3,3,22407,22407,22410,0,3,0
6406,3,2,22410,22410,22412,0,2,0
6407,1,2,22411,22412,22414,1,3,0
6408,2,3,22413,22414,22417,1,4,0
6409,3,2,22416,22417,22419,1,3,0
6410,6,1,22422,22422,22423,0,1,3
6411,6,1,22428,22428,22429,0,1,5
6412,1,1,22429,22429,22430,0,1,0
6413,1,3,22430,22430,22433,0,3,0
6414,6,3,22436,22436,22439,0,3,3
6415,5,1,22441,22441,22442,0,1,2
6416,6,1,22447,22447,22448,0,1,5
6417,3,1,22450,22450,22451,0,1,2
6418,5,3,22455,22455,22458,0,3,4
6419,3,1,22458,22458,22459,0,1,0
6420,5,1,22463,22463,22464,0,1,4
6421,3,1,22466,22466,22467,0,1,2
6422,3,2,22469,22469,22471,0,2,2
6423,5,3,22474,22474,22477,0,3,3
6424,5,3,22479,22479,22482,0,3,2
6425,4,3,22483,22483,22486,0,3,1
6426,4,3,22487,22487,22490,0,3,1
6427,1,2,22488,22490,22492,2,4,0
6428,4,3,22492,22492,22495,0,3,0
6429,1,1,22493,22495,22496,2,3,0
6430,6,1,22499,22499,22500,0,1,3
6431,5,3,22504,22504,22507,0,3,4
6432,6,1,22510,22510,22511,0,1,3
6433,6,1,22516,22516,22517,0,1,5
6434,2,3,22518,22518,22521,0,3,1
6435,2,2,22520,22521,22523,1,3,0
6436,6,3,22526,22526,22529,0,3,3
6437,3,2,22529,22529,22531,0,2,0
6438,5,2,22534,22534,22536,0,2,3
6439,5,1,22539,22539,22540,0,1,3
6440,3,1,22542,22542,22543,0,1,2
6441,1,2,22543,22543,22545,0,2,0
6442,6,3,22549,22549,22552,0,3,4
6443,4,2,22553,22553,22555,0,2,1
6444,4,1,22557,22557,22558,0,1,2
6445,4,1,22561,22561,22562,0,1,3
6446,2,3,22563,22563,22566,0,3,1
6447,5,2,22568,22568,22570,0,2,2
6448,4,2,22572,22572,22574,0,2,2
6449,5,1,22577,22577,22578,0,1,3
6450,4,1,22581,22581,22582,0,1,3
6451,5,1,22586,22586,22587,0,1,4
6452,3,3,22589,22589,22592,0,3,2
6453,5,1,22594,22594,22595,0,1,2
6454,3,3,22597,22597,22600,0,3,2
6455,1,1,22598,22600,22601,2,3,0
6456,3,3,22601,22601,22604,0,3,0
6457,4,3,22605,22605,22608,0,3,1
6458,5,1,22610,22610,22611,0,1,2
6459,2,2,22612,22612,22614,0,2,1
6460,3,3,22615,22615,22618,0,3,1
6461,6,3,22621,22621,22624,0,3,3
6462,3,3,22624,22624,22627,0,3,0
6463,2,1,22626,22627,22628,1,2,0
6464,3,3,22629,22629,22632,0,3,1
6465,4,1,22633,22633,22634,0,1,1
6466,3,2,22636,22636,22638,0,2,2
6467,2,1,22638,22638,22639,0,1,0
6468,4,1,22642,22642,22643,0,1,3
6469,1,1,22643,22643,22644,0,1,0
6470,5,3,22648,22648,22651,0,3,4
6471,3,1,22651,22651,22652,0,1,0
6472,2,1,22653,22653,22654,0,1,1
6473,1,1,22654,22654,22655,0,1,0
6474,1,2,22655,22655,22657,0,2,0
6475,6,3,22661,22661,22664,0,3,4
6476,2,3,22663,22664,22667,1,4,0
6477,4,2,22667,22667,22669,0,2,0
6478,6,1,22673,22673,22674,0,1,4
6479,4,3,22677,22677,22680,0,3,3
6480,4,2,22681,22681,22683,0,2,1
6481,2,1,22683,22683,22684,0,1,0
6482,6,3,22689,22689,22692,0,3,5
6483,1,1,22690,22692,22693,2,3,0
6484,3,3,22693,22693,22696,0,3,0
6485,5,2,22698,22698,22700,0,2,2
6486,5,3,22703,22703,22706,0,3,3
6487,4,2,22707,22707,22709,0,2,1
6488,4,1,22711,22711,22712,0,1,2
6489,6,3,22717,22717,22720,0,3,5
6490,3,1,22720,22720,22721,0,1,0
6491,5,3,22725,22725,22728,0,3,4
6492,3,2,22728,22728,22730,0,2,0
6493,6,3,22734,22734,22737,0,3,4
6494,5,3,22739,22739,22742,0,3,2
6495,4,2,22743,22743,22745,0,2,1
6496,4,1,22747,22747,22748,0,1,2
6497,5,1,22752,22752,22753,0,1,4
6498,6,1,22758,22758,22759,0,1,5
6499,2,2,22760,22760,22762,0,2,1
6500,1,1,22761,22762,22763,1,2,0
6501,4,1,22765,22765,22766,0,1,2
6502,1,3,22766,22766,22769,0,3,0
6503,4,3,22770,22770,22773,0,3,1
6504,4,3,22774,22774,22777,0,3,1
6505,2,3,22776,22777,22780,1,4,0
6506,6,2,22782,22782,22784,0,2,2
6507,2,3,22784,22784,22787,0,3,0
6508,2,1,22786,22787,22788,1,2,0
6509,5,2,22791,22791,22793,0,2,3
6510,4,1,22795,22795,22796,0,1,2
6511,3,1,22798,22798,22799,0,1,2
6512,6,1,22804,22804,22805,0,1,5
6513,4,2,22808,22808,22810,0,2,3
6514,4,3,22812,22812,22815,0,3,2
6515,4,3,22816,22816,22819,0,3,1
6516,6,1,22822,22822,22823,0,1,3
6517,6,2,22828,22828,22830,0,2,5
6518,5,1,22833,22833,22834,0,1,3
6519,4,2,22837,22837,22839,0,2,3
6520,5,2,22842,22842,22844,0,2,3
6521,6,1,22848,22848,22849,0,1,4
6522,6,2,22854,22854,22856,0,2,5
6523,3,3,22857,22857,22860,0,3,1
6524,1,1,22858,22860,22861,2,3,0
6525,2,2,22860,22861,22863,1,3,0
6526,3,3,22863,22863,22866,0,3,0
6527,3,1,22866,22866,22867,0,1,0
6528,6,2,22872,22872,22874,0,2,5
6529,5,2,22877,22877,22879,0,2,3
6530,1,1,22878,22879,22880,1,2,0
6531,4,2,22882,22882,22884,0,2,2
6532,4,2,22886,22886,22888,0,2,2
6533,4,3,22890,22890,22893,0,3,2
6534,4,3,22894,22894,22897,0,3,1
6535,1,2,22895,22897,22899,2,4,0
6536,3,1,22898,22899,22900,1,2,0
6537,1,1,22899,22900,22901,1,2,0
6538,3,3,22902,22902,22905,0,3,1
6539,2,2,22904,22905,22907,1,3,0
6540,4,2,22908,22908,22910,0,2,1
6541,1,1,22909,22910,22911,1,2,0
6542,4,3,22913,22913,22916,0,3,2
6543,6,2,22919,22919,22921,0,2,3
6544,5,1,22924,22924,22925,0,1,3
6545,6,1,22930,22930,22931,0,1,5
6546,6,2,22936,22936,22938,0,2,5
6547,2,3,22938,22938,22941,0,3,0
6548,5,2,22943,22943,22945,0,2,2
6549,5,3,22948,22948,22951,0,3,3
6550,4,2,22952,22952,22954,0,2,1
6551,6,2,22958,22958,22960,0,2,4
6552,5,3,22963,22963,22966,0,3,3
6553,5,1,22968,22968,22969,0,1,2
6554,2,1,22970,22970,22971,0,1,1
6555,1,1,22971,22971,22972,0,1,0
6556,1,1,22972,22972,22973,0,1,0
6557,5,3,22977,22977,22980,0,3,4
6558,1,2,22978,22980,22982,2,4,0
6559,1,2,22979,22982,22984,3,5,0
6560,5,2,22984,22984,22986,0,2,0
6561,5,1,22989,22989,22990,0,1,3
6562,5,3,22994,22994,22997,0,3,4
6563,3,1,22997,22997,22998,0,1,0
6564,6,2,23003,23003,23005,0,2,5
6565,1,2,23004,23005,23007,1,3,0
6566,1,3,23005,23007,23010,2,5,0
6567,6,2,23011,23011,23013,0,2,1
6568,4,1,23015,23015,23016,0,1,2
6569,3,3,23018,23018,23021,0,3,2
6570,2,1,23020,23021,23022,1,2,0
6571,4,2,23024,23024,23026,0,2,2
6572,3,2,23027,23027,23029,0,2,1
6573,5,3,23032,23032,23035,0,3,3
6574,3,3,23035,23035,23038,0,3,0
6575,2,3,23037,23038,23041,1,4,0
6576,3,2,23040,23041,23043,1,3,0
6577,4,3,23044,23044,23047,0,3,1
6578,1,3,23045,23047,23050,2,5,0
6579,5,2,23050,23050,23052,0,2,0
6580,6,1,23056,23056,23057,0,1,4
6581,1,2,23057,23057,23059,0,2,0
6582,3,2,23060,23060,23062,0,2,1
6583,1,1,23061,23062,23063,1,2,0
6584,3,2,23064,23064,23066,0,2,1
6585,6,2,23070,23070,23072,0,2,4
6586,3,2,23073,23073,23075,0,2,1
6587,1,2,23074,23075,23077,1,3,0
6588,5,2,23079,23079,23081,0,2,2
6589,1,3,23080,23081,23084,1,4,0
6590,3,1,23083,23084,23085,1,2,0
6591,5,1,23088,23088,23089,0,1,3
6592,3,3,23091,23091,23094,0,3,2
6593,1,3,23092,23094,23097,2,5,0
6594,2,3,23094,23097,23100,3,6,0
6595,3,3,23097,23100,23103,3,6,0
6596,2,3,23099,23103,23106,4,7,0
6597,4,1,23103,23106,23107,3,4,0
6598,5,2,23108,23108,23110,0,2,1
6599,1,2,23109,23110,23112,1,3,0
6600,6,3,23115,23115,23118,0,3,3
6601,5,3,23120,23120,23123,0,3,2
6602,3,2,23123,23123,23125,0,2,0
6603,1,2,23124,23125,23127,1,3,0
6604,5,1,23129,23129,23130,0,1,2
6605,4,2,23133,23133,23135,0,2,3
6606,5,1,23138,23138,23139,0,1,3
6607,5,2,23143,23143,23145,0,2,4
6608,4,3,23147,23147,23150,0,3,2
6609,3,2,23150,23150,23152,0,2,0
6610,6,1,23156,23156,23157,0,1,4
6611,1,2,23157,23157,23159,0,2,0
6612,3,3,23160,23160,23163,0,3,1
6613,3,3,23163,23163,23166,0,3,0
6614,6,3,23169,23169,23172,0,3,3
6615,5,1,23174,23174,23175,0,1,2
6616,6,1,23180,23180,23181,0,1,5
6617,5,1,23185,23185,23186,0,1,4
6618,3,2,23188,23188,23190,0,2,2
6619,5,2,23193,23193,23195,0,2,3
6620,3,3,23196,23196,23199,0,3,1
6621,3,2,23199,23199,23201,0,2,0
6622,3,2,23202,23202,23204,0,2,1
6623,5,1,23207,23207,23208,0,1,3
6624,4,1,23211,23211,23212,0,1,3
6625,6,1,23217,23217,23218,0,1,5
6626,1,3,23218,23218,23221,0,3,0
6627,5,3,23223,23223,23226,0,3,2
6628,5,2,23228,23228,23230,0,2,2
6629,4,3,23232,23232,23235,0,3,2
6630,2,1,23234,23235,23236,1,2,0
6631,1,3,23235,23236,23239,1,4,0
6632,6,1,23241,23241,23242,0,1,2
6633,4,3,23245,23245,23248,0,3,3
6634,1,3,23246,23248,23251,2,5,0
6635,2,1,23248,23251,23252,3,4,0
6636,6,1,23254,23254,23255,0,1,2
6637,4,2,23258,23258,23260,0,2,3
6638,2,2,23260,23260,23262,0,2,0
6639,1,3,23261,23262,23265,1,4,0
6640,2,1,23263,23265,23266,2,3,0
6641,5,1,23268,23268,23269,0,1,2
6642,5,3,23273,23273,23276,0,3,4
6643,3,2,23276,23276,23278,0,2,0
6644,3,3,23279,23279,23282,0,3,1
6645,1,3,23280,23282,23285,2,5,0
6646,4,1,23284,23285,23286,1,2,0
6647,2,2,23286,23286,23288,0,2,0
6648,3,1,23289,23289,23290,0,1,1
6649,6,1,23295,23295,23296,0,1,5
6650,5,1,23300,23300,23301,0,1,4
6651,6,2,23306,23306,23308,0,2,5
6652,5,2,23311,23311,23313,0,2,3
6653,5,1,23316,23316,23317,0,1,3
6654,2,3,23318,23318,23321,0,3,1
6655,6,2,23324,23324,23326,0,2,3
6656,3,3,23327,23327,23330,0,3,1
6657,4,3,23331,23331,23334,0,3,1
6658,3,1,23334,23334,23335,0,1,0
6659,2,1,23336,23336,23337,0,1,1
6660,1,1,23337,23337,23338,0,1,0
6661,1,3,23338,23338,23341,0,3,0
6662,5,3,23343,23343,23346,0,3,2
6663,2,1,23345,23346,23347,1,2,0
6664,6,3,23351,23351,23354,0,3,4
6665,1,1,23352,23354,23355,2,3,0
6666,3,1,23355,23355,23356,0,1,0
6667,2,3,23357,23357,23360,0,3,1
6668,6,3,23363,23363,23366,0,3,3
6669,5,1,23368,23368,23369,0,1,2
6670,3,2,23371,23371,23373,0,2,2
6671,4,1,23375,23375,23376,0,1,2
6672,1,3,23376,23376,23379,0,3,0
6673,3,3,23379,23379,23382,0,3,0
6674,6,3,23385,23385,23388,0,3,3
6675,6,1,23391,23391,23392,0,1,3
6676,1,2,23392,23392,23394,0,2,0
6677,3,2,23395,23395,23397,0,2,1
6678,4,2,23399,23399,23401,0,2,2
6679,5,3,23404,23404,23407,0,3,3
6680,2,2,23406,23407,23409,1,3,0
6681,6,1,23412,23412,23413,0,1,3
6682,3,3,23415,23415,23418,0,3,2
6683,5,2,23420,23420,23422,0,2,2
6684,4,1,23424,23424,23425,0,1,2
6685,5,3,23429,23429,23432,0,3,4
6686,6,3,23435,23435,23438,0,3,3
6687,3,1,23438,23438,23439,0,1,0
6688,4,2,23442,23442,23444,0,2,3
6689,6,1,23448,23448,23449,0,1,4
6690,5,2,23453,23453,23455,0,2,4
6691,1,3,23454,23455,23458,1,4,0
6692,3,2,23457,23458,23460,1,3,0
6693,6,2,23463,23463,23465,0,2,3
6694,6,3,23469,23469,23472,0,3,4
6695,3,3,23472,23472,23475,0,3,0
6696,5,3,23477,23477,23480,0,3,2
6697,2,1,23479,23480,23481,1,2,0
6698,1,3,23480,23481,23484,1,4,0
6699,3,1,23483,23484,23485,1,2,0
6700,1,1,23484,23485,23486,1,2,0
6701,4,1,23488,23488,23489,0,1,2
6702,4,1,23492,23492,23493,0,1,3
6703,1,2,23493,23493,23495,0,2,0
6704,6,2,23499,23499,23501,0,2,4
6705,5,2,23504,23504,23506,0,2,3
6706,4,3,23508,23508,23511,0,3,2
6707,2,3,23510,23511,23514,1,4,0
6708,2,3,23512,23514,23517,2,5,0
6709,3,3,23515,23517,23520,2,5,0
6710,3,2,23518,23520,23522,2,4,0
6711,5,2,23523,23523,23525,0,2,1
6712,1,2,23524,23525,23527,1,3,0
6713,2,1,23526,23527,23528,1,2,0
6714,5,1,23531,23531,23532,0,1,3
6715,3,2,23534,23534,23536,0,2,2
6716,2,1,23536,23536,23537,0,1,0
6717,1,3,23537,23537,23540,0,3,0
6718,4,3,23541,23541,23544,0,3,1
6719,1,3,23542,23544,23547,2,5,0
6720,1,3,23543,23547,23550,4,7,0
6721,1,1,23544,23550,23551,6,7,0
6722,4,3,23548,23551,23554,3,6,0
6723,1,3,23549,23554,23557,5,8,0
6724,2,1,23551,23557,23558,6,7,0
6725,2,3,23553,23558,23561,5,8,0
6726,4,2,23557,23561,23563,4,6,0
6727,2,2,23559,23563,23565,4,6,0
6728,3,2,23562,23565,23567,3,5,0
6729,3,2,23565,23567,23569,2,4,0
6730,3,2,23568,23569,23571,1,3,0
6731,1,3,23569,23571,23574,2,5,0
6732,1,3,23570,23574,23577,4,7,0
6733,2,2,23572,23577,23579,5,7,0
6734,5,3,23577,23579,23582,2,5,0
6735,4,1,23581,23582,23583,1,2,0
6736,4,1,23585,23585,23586,0,1,2
6737,3,2,23588,23588,23590,0,2,2
6738,2,3,23590,23590,23593,0,3,0
6739,3,2,23593,23593,23595,0,2,0
6740,6,2,23599,23599,23601,0,2,4
6741,6,2,23605,23605,23607,0,2,4
6742,6,2,23611,23611,23613,0,2,4
6743,3,2,23614,23614,23616,0,2,1
6744,6,3,23620,23620,23623,0,3,4
6745,4,3,23624,23624,23627,0,3,1
6746,4,3,23628,23628,23631,0,3,1
6747,5,1,23633,23633,23634,0,1,2
6748,5,2,23638,23638,23640,0,2,4
6749,5,2,23643,23643,23645,0,2,3
6750,3,1,23646,23646,23647,0,1,1
6751,3,1,23649,23649,23650,0,1,2
6752,4,2,23653,23653,23655,0,2,3
6753,3,1,23656,23656,23657,0,1,1
6754,1,1,23657,23657,23658,0,1,0
6755,3,2,23660,23660,23662,0,2,2
6756,3,1,23663,23663,23664,0,1,1
6757,6,1,23669,23669,23670,0,1,5
6758,1,3,23670,23670,23673,0,3,0
6759,5,2,23675,23675,23677,0,2,2
6760,2,1,23677,23677,23678,0,1,0
6761,3,3,23680,23680,23683,0,3,2
6762,5,1,23685,23685,23686,0,1,2
6763,5,2,23690,23690,23692,0,2,4
6764,3,1,23693,23693,23694,0,1,1
6765,1,1,23694,23694,23695,0,1,0
6766,3,3,23697,23697,23700,0,3,2
6767,6,2,23703,23703,23705,0,2,3
6768,6,2,23709,23709,23711,0,2,4
6769,5,3,23714,23714,23717,0,3,3
6770,1,2,23715,23717,23719,2,4,0
6771,5,2,23720,23720,23722,0,2,1
6772,6,1,23726,23726,23727,0,1,4
6773,6,1,23732,23732,23733,0,1,5
6774,1,3,23733,23733,23736,0,3,0
6775,4,2,23737,23737,23739,0,2,1
6776,5,2,23742,23742,23744,0,2,3
6777,1,1,23743,23744,23745,1,2,0
6778,2,2,23745,23745,23747,0,2,0
6779,2,2,23747,23747,23749,0,2,0
6780,1,3,23748,23749,23752,1,4,0
6781,3,2,23751,23752,23754,1,3,0
6782,2,3,23753,23754,23757,1,4,0
6783,2,1,23755,23757,23758,2,3,0
6784,3,1,23758,23758,23759,0,1,0
6785,4,1,23762,23762,23763,0,1,3
6786,3,2,23765,23765,23767,0,2,2
6787,3,1,23768,23768,23769,0,1,1
6788,1,2,23769,23769,23771,0,2,0
6789,3,2,23772,23772,23774,0,2,1
6790,4,3,23776,23776,23779,0,3,2
6791,6,2,23782,23782,23784,0,2,3
6792,4,3,23786,23786,23789,0,3,2
6793,5,3,23791,23791,23794,0,3,2
6794,6,1,23797,23797,23798,0,1,3
6795,2,1,23799,23799,23800,0,1,1
6796,2,2,23801,23801,23803,0,2,1
6797,3,1,23804,23804,23805,0,1,1
6798,6,3,23810,23810,23813,0,3,5
6799,3,2,23813,23813,23815,0,2,0
6800,5,1,23818,23818,23819,0,1,3
6801,6,3,23824,23824,23827,0,3,5
6802,2,1,23826,23827,23828,1,2,0
6803,2,2,23828,23828,23830,0,2,0
6804,3,1,23831,23831,23832,0,1,1
6805,2,1,23833,23833,23834,0,1,1
6806,5,1,23838,23838,23839,0,1,4
6807,4,3,23842,23842,23845,0,3,3
6808,5,1,23847,23847,23848,0,1,2
6809,4,2,23851,23851,23853,0,2,3
6810,5,3,23856,23856,23859,0,3,3
6811,5,2,23861,23861,23863,0,2,2
6812,4,1,23865,23865,23866,0,1,2
6813,2,3,23867,23867,23870,0,3,1
6814,5,3,23872,23872,23875,0,3,2
6815,3,2,23875,23875,23877,0,2,0
6816,4,2,23879,23879,23881,0,2,2
6817,3,1,23882,23882,23883,0,1,1
6818,3,3,23885,23885,23888,0,3,2
6819,5,1,23890,23890,23891,0,1,2
6820,6,2,23896,23896,23898,0,2,5
6821,2,2,23898,23898,23900,0,2,0
6822,3,2,23901,23901,23903,0,2,1
6823,3,2,23904,23904,23906,0,2,1
6824,5,1,23909,23909,23910,0,1,3
6825,5,1,23914,23914,23915,0,1,4
6826,1,2,23915,23915,23917,0,2,0
6827,2,3,23917,23917,23920,0,3,0
6828,6,2,23923,23923,23925,0,2,3
6829,2,3,23925,23925,23928,0,3,0
6830,4,1,23929,23929,23930,0,1,1
6831,4,3,23933,23933,23936,0,3,3
6832,2,1,23935,23936,23937,1,2,0
6833,3,1,23938,23938,23939,0,1,1
6834,6,1,23944,23944,23945,0,1,5
6835,4,3,23948,23948,23951,0,3,3
6836,2,2,23950,23951,23953,1,3,0
6837,2,1,23952,23953,23954,1,2,0
6838,5,2,23957,23957,23959,0,2,3
6839,4,2,23961,23961,23963,0,2,2
6840,3,3,23964,23964,23967,0,3,1
6841,4,3,23968,23968,23971,0,3,1
6842,6,2,23974,23974,23976,0,2,3
6843,1,3,23975,23976,23979,1,4,0
6844,1,3,23976,23979,23982,3,6,0
6845,2,3,23978,23982,23985,4,7,0
6846,4,2,23982,23985,23987,3,5,0
6847,1,1,23983,23987,23988,4,5,0
6848,4,3,23987,23988,23991,1,4,0
6849,3,1,23990,23991,23992,1,2,0
6850,3,3,23993,23993,23996,0,3,1
6851,2,3,23995,23996,23999,1,4,0
6852,6,2,24001,24001,24003,0,2,2
6853,1,1,24002,24003,24004,1,2,0
6854,6,1,24008,24008,24009,0,1,4
6855,1,1,24009,24009,24010,0,1,0
6856,6,1,24015,24015,24016,0,1,5
6857,3,2,24018,24018,24020,0,2,2
6858,6,1,24024,24024,24025,0,1,4
6859,1,2,24025,24025,24027,0,2,0
6860,5,2,24030,24030,24032,0,2,3
6861,5,3,24035,24035,24038,0,3,3
6862,4,2,24039,24039,24041,0,2,1
6863,2,2,24041,24041,24043,0,2,0
6864,4,3,24045,24045,24048,0,3,2
6865,5,3,24050,24050,24053,0,3,2
6866,6,2,24056,24056,24058,0,2,3
6867,5,1,24061,24061,24062,0,1,3
6868,3,3,24064,24064,24067,0,3,2
6869,1,1,24065,24067,24068,2,3,0
6870,3,1,24068,24068,24069,0,1,0
6871,1,2,24069,24069,24071,0,2,0
6872,2,1,24071,24071,24072,0,1,0
6873,5,1,24076,24076,24077,0,1,4
6874,1,1,24077,24077,24078,0,1,0
6875,3,2,24080,24080,24082,0,2,2
6876,2,3,24082,24082,24085,0,3,0
6877,4,2,24086,24086,24088,0,2,1
6878,1,2,24087,24088,24090,1,3,0
6879,2,1,24089,24090,24091,1,2,0
6880,1,3,24090,24091,24094,1,4,0
6881,1,2,24091,24094,24096,3,5,0
6882,2,3,24093,24096,24099,3,6,0
6883,1,3,24094,24099,24102,5,8,0
6884,3,3,24097,24102,24105,5,8,0
6885,4,2,24101,24105,24107,4,6,0
6886,2,3,24103,24107,24110,4,7,0
6887,2,3,24105,24110,24113,5,8,0
6888,3,1,24108,24113,24114,5,6,0
6889,2,1,24110,24114,24115,4,5,0
6890,3,3,24113,24115,24118,2,5,0
6891,3,1,24116,24118,24119,2,3,0
6892,4,2,24120,24120,24122,0,2,1
6893,6,2,24126,24126,24128,0,2,4
6894,4,1,24130,24130,24131,0,1,2
6895,5,3,24135,24135,24138,0,3,4
6896,3,1,24138,24138,24139,0,1,0
6897,5,3,24143,24143,24146,0,3,4
6898,5,1,24148,24148,24149,0,1,2
6899,2,2,24150,24150,24152,0,2,1
6900,4,1,24154,24154,24155,0,1,2
6901,4,3,24158,24158,24161,0,3,3
6902,3,2,24161,24161,24163,0,2,0
6903,6,1,24167,24167,24168,0,1,4
6904,5,3,24172,24172,24175,0,3,4
6905,1,3,24173,24175,24178,2,5,0
6906,2,2,24175,24178,24180,3,5,0
6907,1,3,24176,24180,24183,4,7,0
6908,1,1,24177,24183,24184,6,7,0
6909,4,2,24181,24184,24186,3,5,0
6910,6,1,24187,24187,24188,0,1,1
6911,5,1,24192,24192,24193,0,1,4
6912,4,3,24196,24196,24199,0,3,3
6913,4,3,24200,24200,24203,0,3,1
6914,3,1,24203,24203,24204,0,1,0
6915,3,2,24206,24206,24208,0,2,2
6916,4,3,24210,24210,24213,0,3,2
6917,1,1,24211,24213,24214,2,3,0
6918,1,1,24212,24214,24215,2,3,0
6919,2,2,24214,24215,24217,1,3,0
6920,3,2,24217,24217,24219,0,2,0
6921,5,3,24222,24222,24225,0,3,3
6922,1,2,24223,24225,24227,2,4,0
6923,1,3,24224,24227,24230,3,6,0
6924,1,1,24225,24230,24231,5,6,0
6925,5,1,24230,24231,24232,1,2,0
6926,2,1,24232,24232,24233,0,1,0
6927,5,3,24237,24237,24240,0,3,4
6928,2,3,24239,24240,24243,1,4,0
6929,4,2,24243,24243,24245,0,2,0
6930,5,3,24248,24248,24251,0,3,3
6931,6,1,24254,24254,24255,0,1,3
6932,5,3,24259,24259,24262,0,3,4
6933,3,3,24262,24262,24265,0,3,0
6934,5,3,24267,24267,24270,0,3,2
6935,4,1,24271,24271,24272,0,1,1
6936,6,2,24277,24277,24279,0,2,5
6937,2,3,24279,24279,24282,0,3,0
6938,6,1,24285,24285,24286,0,1,3
6939,6,3,24291,24291,24294,0,3,5
6940,3,3,24294,24294,24297,0,3,0
6941,4,2,24298,24298,24300,0,2,1
6942,4,2,24302,24302,24304,0,2,2
6943,5,3,24307,24307,24310,0,3,3
6944,2,1,24309,24310,24311,1,2,0
6945,3,2,24312,24312,24314,0,2,1
6946,1,1,24313,24314,24315,1,2,0
6947,4,3,24317,24317,24320,0,3,2
6948,4,3,24321,24321,24324,0,3,1
6949,1,3,24322,24324,24327,2,5,0
6950,1,3,24323,24327,24330,4,7,0
6951,5,3,24328,24330,24333,2,5,0
6952,1,1,24329,24333,24334,4,5,0
6953,6,2,24335,24335,24337,0,2,1
6954,6,3,24341,24341,24344,0,3,4
6955,3,1,24344,24344,24345,0,1,0
6956,5,2,24349,24349,24351,0,2,4
6957,5,2,24354,24354,24356,0,2,3
6958,4,3,24358,24358,24361,0,3,2
6959,3,3,24361,24361,24364,0,3,0
6960,3,3,24364,24364,24367,0,3,0
6961,1,3,24365,24367,24370,2,5,0
6962,4,1,24369,24370,24371,1,2,0
6963,4,3,24373,24373,24376,0,3,2
6964,4,3,24377,24377,24380,0,3,1
6965,6,2,24383,24383,24385,0,2,3
6966,2,3,24385,24385,24388,0,3,0
6967,2,3,24387,24388,24391,1,4,0
6968,1,3,24388,24391,24394,3,6,0
6969,3,1,24391,24394,24395,3,4,0
6970,5,2,24396,24396,24398,0,2,1
6971,6,2,24402,24402,24404,0,2,4
6972,4,3,24406,24406,24409,0,3,2
6973,5,2,24411,24411,24413,0,2,2
6974,5,1,24416,24416,24417,0,1,3
6975,6,2,24422,24422,24424,0,2,5
6976,4,2,24426,24426,24428,0,2,2
6977,5,1,24431,24431,24432,0,1,3
6978,4,2,24435,24435,24437,0,2,3
6979,3,2,24438,24438,24440,0,2,1
6980,5,2,24443,24443,24445,0,2,3
6981,3,3,24446,24446,24449,0,3,1
6982,1,2,24447,24449,24451,2,4,0
6983,4,3,24451,24451,24454,0,3,0
6984,5,1,24456,24456,24457,0,1,2
6985,6,2,24462,24462,24464,0,2,5
6986,4,3,24466,24466,24469,0,3,2
6987,3,2,24469,24469,24471,0,2,0
6988,4,2,24473,24473,24475,0,2,2
6989,2,3,24475,24475,24478,0,3,0
6990,2,3,24477,24478,24481,1,4,0
6991,2,1,24479,24481,24482,2,3,0
6992,3,3,24482,24482,24485,0,3,0
6993,6,3,24488,24488,24491,0,3,3
6994,6,1,24494,24494,24495,0,1,3
6995,4,3,24498,24498,24501,0,3,3
6996,1,3,24499,24501,24504,2,5,0
6997,2,2,24501,24504,24506,3,5,0
6998,5,3,24506,24506,24509,0,3,0
6999,1,2,24507,24509,24511,2,4,0
7000,3,3,24510,24511,24514,1,4,0
7001,1,3,24511,24514,24517,3,6,0
7002,5,3,24516,24517,24520,1,4,0
7003,6,2,24522,24522,24524,0,2,2
7004,6,2,24528,24528,24530,0,2,4
7005,5,3,24533,24533,24536,0,3,3
7006,4,2,24537,24537,24539,0,2,1
7007,5,3,24542,24542,24545,0,3,3
7008,6,3,24548,24548,24551,0,3,3
7009,1,1,24549,24551,24552,2,3,0
7010,2,2,24551,24552,24554,1,3,0
7011,1,1,24552,24554,24555,2,3,0
7012,5,2,24557,24557,24559,0,2,2
7013,1,3,24558,24559,24562,1,4,0
7014,4,2,24562,24562,24564,0,2,0
7015,4,3,24566,24566,24569,0,3,2
7016,5,1,24571,24571,24572,0,1,2
7017,4,1,24575,24575,24576,0,1,3
7018,5,3,24580,24580,24583,0,3,4
7019,3,2,24583,24583,24585,0,2,0
7020,1,3,24584,24585,24588,1,4,0
7021,1,2,24585,24588,24590,3,5,0
7022,4,3,24589,24590,24593,1,4,0
7023,6,1,24595,24595,24596,0,1,2
7024,6,3,24601,24601,24604,0,3,5
7025,6,1,24607,24607,24608,0,1,3
7026,6,1,24613,24613,24614,0,1,5
7027,6,2,24619,24619,24621,0,2,5
7028,3,1,24622,24622,24623,0,1,1
7029,2,1,24624,24624,24625,0,1,1
7030,3,1,24627,24627,24628,0,1,2
7031,5,3,24632,24632,24635,0,3,4
7032,4,2,24636,24636,24638,0,2,1
7033,1,2,24637,24638,24640,1,3,0
7034,3,2,24640,24640,24642,0,2,0
7035,5,1,24645,24645,24646,0,1,3
7036,2,3,24647,24647,24650,0,3,1
7037,5,3,24652,24652,24655,0,3,2
7038,4,3,24656,24656,24659,0,3,1
7039,2,3,24658,24659,24662,1,4,0
7040,4,3,24662,24662,24665,0,3,0
7041,2,2,24664,24665,24667,1,3,0
7042,6,2,24670,24670,24672,0,2,3
7043,3,1,24673,24673,24674,0,1,1
7044,1,1,24674,24674,24675,0,1,0
7045,3,1,24677,24677,24678,0,1,2
7046,2,1,24679,24679,24680,0,1,1
7047,6,1,24685,24685,24686,0,1,5
7048,6,3,24691,24691,24694,0,3,5
7049,3,2,24694,24694,24696,0,2,0
7050,3,1,24697,24697,24698,0,1,1
7051,6,2,24703,24703,24705,0,2,5
7052,3,3,24706,24706,24709,0,3,1
7053,5,2,24711,24711,24713,0,2,2
7054,1,2,24712,24713,24715,1,3,0
7055,5,1,24717,24717,24718,0,1,2
7056,1,3,24718,24718,24721,0,3,0
7057,6,2,24724,24724,24726,0,2,3
7058,6,1,24730,24730,24731,0,1,4
7059,1,2,24731,24731,24733,0,2,0
7060,5,2,24736,24736,24738,0,2,3
7061,6,3,24742,24742,24745,0,3,4
7062,5,3,24747,24747,24750,0,3,2
7063,3,3,24750,24750,24753,0,3,0
7064,4,1,24754,24754,24755,0,1,1
7065,1,3,24755,24755,24758,0,3,0
7066,5,3,24760,24760,24763,0,3,2
7067,5,2,24765,24765,24767,0,2,2
7068,1,3,24766,24767,24770,1,4,0
7069,5,1,24771,24771,24772,0,1,1
7070,1,3,24772,24772,24775,0,3,0
7071,2,2,24774,24775,24777,1,3,0
7072,1,1,24775,24777,24778,2,3,0
7073,1,1,24776,24778,24779,2,3,0
7074,2,3,24778,24779,24782,1,4,0
7075,1,1,24779,24782,24783,3,4,0
7076,5,2,24784,24784,24786,0,2,1
7077,1,3,24785,24786,24789,1,4,0
7078,3,3,24788,24789,24792,1,4,0
7079,5,3,24793,24793,24796,0,3,1
7080,3,1,24796,24796,24797,0,1,0
7081,3,3,24799,24799,24802,0,3,2
7082,4,1,24803,24803,24804,0,1,1
7083,3,1,24806,24806,24807,0,1,2
7084,2,1,24808,24808,24809,0,1,1
7085,5,3,24813,24813,24816,0,3,4
7086,6,2,24819,24819,24821,0,2,3
7087,4,2,24823,24823,24825,0,2,2
7088,5,1,24828,24828,24829,0,1,3
7089,1,2,24829,24829,24831,0,2,0
7090,6,3,24835,24835,24838,0,3,4
7091,2,1,24837,24838,24839,1,2,0
7092,5,3,24842,24842,24845,0,3,3
7093,1,2,24843,24845,24847,2,4,0
7094,5,1,24848,24848,24849,0,1,1
7095,1,3,24849,24849,24852,0,3,0
7096,5,3,24854,24854,24857,0,3,2
7097,6,1,24860,24860,24861,0,1,3
7098,2,3,24862,24862,24865,0,3,1
7099,5,3,24867,24867,24870,0,3,2
7100,3,2,24870,24870,24872,0,2,0
7101,4,3,24874,24874,24877,0,3,2
7102,1,2,24875,24877,24879,2,4,0
7103,5,3,24880,24880,24883,0,3,1
7104,2,3,24882,24883,24886,1,4,0
7105,4,2,24886,24886,24888,0,2,0
7106,2,2,24888,24888,24890,0,2,0
7107,1,3,24889,24890,24893,1,4,0
7108,2,2,24891,24893,24895,2,4,0
7109,5,1,24896,24896,24897,0,1,1
7110,4,1,24900,24900,24901,0,1,3
7111,6,2,24906,24906,24908,0,2,5
7112,4,1,24910,24910,24911,0,1,2
7113,3,2,24913,24913,24915,0,2,2
7114,2,3,24915,24915,24918,0,3,0
7115,6,3,24921,24921,24924,0,3,3
7116,5,3,24926,24926,24929,0,3,2
7117,4,2,24930,24930,24932,0,2,1
7118,1,3,24931,24932,24935,1,4,0
7119,4,2,24935,24935,24937,0,2,0
7120,6,1,24941,24941,24942,0,1,4
7121,2,2,24943,24943,24945,0,2,1
7122,4,2,24947,24947,24949,0,2,2
7123,2,2,24949,24949,24951,0,2,0
7124,4,3,24953,24953,24956,0,3,2
7125,3,3,24956,24956,24959,0,3,0
7126,5,1,24961,24961,24962,0,1,2
7127,1,2,24962,24962,24964,0,2,0
7128,1,1,24963,24964,24965,1,2,0
7129,3,1,24966,24966,24967,0,1,1
7130,3,2,24969,24969,24971,0,2,2
7131,1,3,24970,24971,24974,1,4,0
7132,6,1,24976,24976,24977,0,1,2
7133,3,1,24979,24979,24980,0,1,2
7134,2,2,24981,24981,24983,0,2,1
7135,3,1,24984,24984,24985,0,1,1
7136,2,3,24986,24986,24989,0,3,1
7137,5,3,24991,24991,24994,0,3,2
7138,5,2,24996,24996,24998,0,2,2
7139,6,3,25002,25002,25005,0,3,4
7140,1,1,25003,25005,25006,2,3,0
7141,6,1,25009,25009,25010,0,1,3
7142,5,3,25014,25014,25017,0,3,4
7143,3,3,25017,25017,25020,0,3,0
7144,6,2,25023,25023,25025,0,2,3
7145,1,3,25024,25025,25028,1,4,0
7146,6,1,25030,25030,25031,0,1,2
7147,2,3,25032,25032,25035,0,3,1
7148,2,1,25034,25035,25036,1,2,0
7149,6,1,25040,25040,25041,0,1,4
7150,2,1,25042,25042,25043,0,1,1
7151,4,2,25046,25046,25048,0,2,3
7152,2,3,25048,25048,25051,0,3,0
7153,3,1,25051,25051,25052,0,1,0
7154,3,2,25054,25054,25056,0,2,2
7155,2,3,25056,25056,25059,0,3,0
7156,1,1,25057,25059,25060,2,3,0
7157,2,3,25059,25060,25063,1,4,0
7158,1,1,25060,25063,25064,3,4,0
7159,3,2,25063,25064,25066,1,3,0
7160,4,2,25067,25067,25069,0,2,1
7161,6,1,25073,25073,25074,0,1,4
7162,4,2,25077,25077,25079,0,2,3
7163,6,2,25083,25083,25085,0,2,4
7164,2,3,25085,25085,25088,0,3,0
7165,6,1,25091,25091,25092,0,1,3
7166,6,2,25097,25097,25099,0,2,5
7167,3,1,25100,25100,25101,0,1,1
7168,6,3,25106,25106,25109,0,3,5
7169,5,1,25111,25111,25112,0,1,2
7170,5,3,25116,25116,25119,0,3,4
7171,2,2,25118,25119,25121,1,3,0
7172,2,1,25120,25121,25122,1,2,0
7173,2,3,25122,25122,25125,0,3,0
7174,4,1,25126,25126,25127,0,1,1
7175,2,1,25128,25128,25129,0,1,1
7176,1,3,25129,25129,25132,0,3,0
7177,6,2,25135,25135,25137,0,2,3
7178,6,3,25141,25141,25144,0,3,4
7179,3,1,25144,25144,25145,0,1,0
7180,4,2,25148,25148,25150,0,2,3
7181,6,3,25154,25154,25157,0,3,4
7182,3,1,25157,25157,25158,0,1,0
7183,3,1,25160,25160,25161,0,1,2
7184,3,2,25163,25163,25165,0,2,2
7185,6,2,25169,25169,25171,0,2,4
7186,1,1,25170,25171,25172,1,2,0
7187,2,3,25172,25172,25175,0,3,0
7188,6,2,25178,25178,25180,0,2,3
7189,6,2,25184,25184,25186,0,2,4
7190,3,3,25187,25187,25190,0,3,1
7191,2,1,25189,25190,25191,1,2,0
7192,4,1,25193,25193,25194,0,1,2
7193,1,2,25194,25194,25196,0,2,0
7194,2,2,25196,25196,25198,0,2,0
7195,4,2,25200,25200,25202,0,2,2
7196,3,3,25203,25203,25206,0,3,1
7197,4,2,25207,25207,25209,0,2,1
7198,6,1,25213,25213,25214,0,1,4
7199,2,2,25215,25215,25217,0,2,1
7200,1,3,25216,25217,25220,1,4,0
7201,5,2,25221,25221,25223,0,2,1
7202,5,2,25226,25226,25228,0,2,3
7203,1,2,25227,25228,25230,1,3,0
7204,5,1,25232,25232,25233,0,1,2
7205,1,3,25233,25233,25236,0,3,0
7206,4,3,25237,25237,25240,0,3,1
7207,3,2,25240,25240,25242,0,2,0
7208,6,2,25246,25246,25248,0,2,4
7209,2,2,25248,25248,25250,0,2,0
7210,1,3,25249,25250,25253,1,4,0
7211,1,1,25250,25253,25254,3,4,0
7212,1,2,25251,25254,25256,3,5,0
7213,3,1,25254,25256,25257,2,3,0
7214,5,2,25259,25259,25261,0,2,2
7215,5,3,25264,25264,25267,0,3,3
7216,3,3,25267,25267,25270,0,3,0
7217,1,2,25268,25270,25272,2,4,0
7218,6,1,25274,25274,25275,0,1,2
7219,4,3,25278,25278,25281,0,3,3
7220,6,1,25284,25284,25285,0,1,3
7221,2,1,25286,25286,25287,0,1,1
7222,3,1,25289,25289,25290,0,1,2
7223,5,1,25294,25294,25295,0,1,4
7224,4,1,25298,25298,25299,0,1,3
7225,5,1,25303,25303,25304,0,1,4
7226,3,2,25306,25306,25308,0,2,2
7227,1,3,25307,25308,25311,1,4,0
7228,3,2,25310,25311,25313,1,3,0
7229,6,1,25316,25316,25317,0,1,3
7230,1,3,25317,25317,25320,0,3,0
7231,4,2,25321,25321,25323,0,2,1
7232,3,2,25324,25324,25326,0,2,1
7233,2,2,25326,25326,25328,0,2,0
7234,4,2,25330,25330,25332,0,2,2
7235,5,2,25335,25335,25337,0,2,3
7236,3,1,25338,25338,25339,0,1,1
7237,6,3,25344,25344,25347,0,3,5
7238,2,1,25346,25347,25348,1,2,0
7239,5,2,25351,25351,25353,0,2,3
7240,2,1,25353,25353,25354,0,1,0
7241,1,2,25354,25354,25356,0,2,0
7242,1,3,25355,25356,25359,1,4,0
7243,5,2,25360,25360,25362,0,2,1
7244,3,1,25363,25363,25364,0,1,1
7245,1,3,25364,25364,25367,0,3,0
7246,6,2,25370,25370,25372,0,2,3
7247,2,3,25372,25372,25375,0,3,0
7248,4,2,25376,25376,25378,0,2,1
7249,6,3,25382,25382,25385,0,3,4
7250,5,1,25387,25387,25388,0,1,2
7251,2,3,25389,25389,25392,0,3,1
7252,5,3,25394,25394,25397,0,3,2
7253,5,3,25399,25399,25402,0,3,2
7254,5,3,25404,25404,25407,0,3,2
7255,1,3,25405,25407,25410,2,5,0
7256,2,2,25407,25410,25412,3,5,0
7257,6,3,25413,25413,25416,0,3,1
7258,6,2,25419,25419,25421,0,2,3
7259,6,1,25425,25425,25426,0,1,4
7260,6,3,25431,25431,25434,0,3,5
7261,6,2,25437,25437,25439,0,2,3
7262,4,1,25441,25441,25442,0,1,2
7263,5,1,25446,25446,25447,0,1,4
7264,5,1,25451,25451,25452,0,1,4
7265,4,2,25455,25455,25457,0,2,3
7266,2,3,25457,25457,25460,0,3,0
7267,5,3,25462,25462,25465,0,3,2
7268,1,2,25463,25465,25467,2,4,0
7269,3,2,25466,25467,25469,1,3,0
7270,2,3,25468,25469,25472,1,4,0
7271,3,3,25471,25472,25475,1,4,0
7272,3,1,25474,25475,25476,1,2,0
7273,3,2,25477,25477,25479,0,2,1
7274,1,1,25478,25479,25480,1,2,0
7275,2,3,25480,25480,25483,0,3,0
7276,2,2,25482,25483,25485,1,3,0
7277,5,2,25487,25487,25489,0,2,2
7278,5,1,25492,25492,25493,0,1,3
7279,3,2,25495,25495,25497,0,2,2
7280,5,1,25500,25500,25501,0,1,3
7281,5,2,25505,25505,25507,0,2,4
7282,4,3,25509,25509,25512,0,3,2
7283,4,3,25513,25513,25516,0,3,1
7284,4,2,25517,25517,25519,0,2,1
7285,1,1,25518,25519,25520,1,2,0
7286,1,2,25519,25520,25522,1,3,0
7287,1,2,25520,25522,25524,2,4,0
7288,3,2,25523,25524,25526,1,3,0
7289,4,2,25527,25527,25529,0,2,1
7290,5,3,25532,25532,25535,0,3,3
7291,2,1,25534,25535,25536,1,2,0
7292,5,1,25539,25539,25540,0,1,3
7293,1,1,25540,25540,25541,0,1,0
7294,1,2,25541,25541,25543,0,2,0
7295,4,3,25545,25545,25548,0,3,2
7296,2,2,25547,25548,25550,1,3,0
7297,5,3,25552,25552,25555,0,3,2
7298,5,1,25557,25557,25558,0,1,2
7299,2,2,25559,25559,25561,0,2,1
7300,3,2,25562,25562,25564,0,2,1
7301,4,1,25566,25566,25567,0,1,2
7302,3,2,25569,25569,25571,0,2,2
7303,5,2,25574,25574,25576,0,2,3
7304,1,1,25575,25576,25577,1,2,0
7305,1,1,25576,25577,25578,1,2,0
7306,6,1,25582,25582,25583,0,1,4
7307,6,1,25588,25588,25589,0,1,5
7308,1,1,25589,25589,25590,0,1,0
7309,6,3,25595,25595,25598,0,3,5
7310,2,2,25597,25598,25600,1,3,0
7311,4,1,25601,25601,25602,0,1,1
7312,1,3,25602,25602,25605,0,3,0
7313,2,2,25604,25605,25607,1,3,0
7314,1,2,25605,25607,25609,2,4,0
7315,3,1,25608,25609,25610,1,2,0
7316,3,1,25611,25611,25612,0,1,1
7317,5,1,25616,25616,25617,0,1,4
7318,4,1,25620,25620,25621,0,1,3
7319,6,1,25626,25626,25627,0,1,5
7320,1,3,25627,25627,25630,0,3,0
7321,4,1,25631,25631,25632,0,1,1
7322,6,2,25637,25637,25639,0,2,5
7323,2,2,25639,25639,25641,0,2,0
7324,6,2,25645,25645,25647,0,2,4
7325,6,3,25651,25651,25654,0,3,4
7326,2,2,25653,25654,25656,1,3,0
7327,4,1,25657,25657,25658,0,1,1
7328,1,1,25658,25658,25659,0,1,0
7329,3,2,25661,25661,25663,0,2,2
7330,1,2,25662,25663,25665,1,3,0
7331,6,2,25668,25668,25670,0,2,3
7332,1,3,25669,25670,25673,1,4,0
7333,5,2,25674,25674,25676,0,2,1
7334,5,1,25679,25679,25680,0,1,3
7335,6,1,25685,25685,25686,0,1,5
7336,1,2,25686,25686,25688,0,2,0
7337,1,2,25687,25688,25690,1,3,0
7338,2,3,25689,25690,25693,1,4,0
7339,4,1,25693,25693,25694,0,1,0
7340,3,2,25696,25696,25698,0,2,2
7341,6,1,25702,25702,25703,0,1,4
7342,4,2,25706,25706,25708,0,2,3
7343,2,3,25708,25708,25711,0,3,0
7344,3,1,25711,25711,25712,0,1,0
7345,4,1,25715,25715,25716,0,1,3
7346,4,2,25719,25719,25721,0,2,3
7347,6,1,25725,25725,25726,0,1,4
7348,4,3,25729,25729,25732,0,3,3
7349,1,1,25730,25732,25733,2,3,0
7350,3,3,25733,25733,25736,0,3,0
7351,3,2,25736,25736,25738,0,2,0
7352,3,3,25739,25739,25742,0,3,1
7353,4,2,25743,25743,25745,0,2,1
7354,6,3,25749,25749,25752,0,3,4
7355,5,3,25754,25754,25757,0,3,2
7356,2,1,25756,25757,25758,1,2,0
7357,4,3,25760,25760,25763,0,3,2
7358,1,2,25761,25763,25765,2,4,0
7359,6,3,25767,25767,25770,0,3,2
7360,6,3,25773,25773,25776,0,3,3
7361,6,2,25779,25779,25781,0,2,3
7362,2,3,25781,25781,25784,0,3,0
7363,3,2,25784,25784,25786,0,2,0
7364,1,3,25785,25786,25789,1,4,0
7365,6,3,25791,25791,25794,0,3,2
7366,5,1,25796,25796,25797,0,1,2
7367,6,3,25802,25802,25805,0,3,5
7368,5,1,25807,25807,25808,0,1,2
7369,3,1,25810,25810,25811,0,1,2
7370,5,3,25815,25815,25818,0,3,4
7371,3,2,25818,25818,25820,0,2,0
7372,3,3,25821,25821,25824,0,3,1
7373,1,3,25822,25824,25827,2,5,0
7374,3,1,25825,25827,25828,2,3,0
7375,3,2,25828,25828,25830,0,2,0
7376,2,2,25830,25830,25832,0,2,0
7377,3,3,25833,25833,25836,0,3,1
7378,2,2,25835,25836,25838,1,3,0
7379,3,2,25838,25838,25840,0,2,0
7380,3,2,25841,25841,25843,0,2,1
7381,1,1,25842,25843,25844,1,2,0
7382,3,2,25845,25845,25847,0,2,1
7383,1,2,25846,25847,25849,1,3,0
7384,2,3,25848,25849,25852,1,4,0
7385,3,2,25851,25852,25854,1,3,0
7386,4,1,25855,25855,25856,0,1,1
7387,4,3,25859,25859,25862,0,3,3
7388,5,3,25864,25864,25867,0,3,2
7389,6,1,25870,25870,25871,0,1,3
7390,6,3,25876,25876,25879,0,3,5
7391,1,1,25877,25879,25880,2,3,0
7392,4,2,25881,25881,25883,0,2,1
7393,6,2,25887,25887,25889,0,2,4
7394,2,3,25889,25889,25892,0,3,0
7395,3,3,25892,25892,25895,0,3,0
7396,4,3,25896,25896,25899,0,3,1
7397,4,1,25900,25900,25901,0,1,1
7398,2,2,25902,25902,25904,0,2,1
7399,2,1,25904,25904,25905,0,1,0
7400,3,3,25907,25907,25910,0,3,2
7401,5,1,25912,25912,25913,0,1,2
7402,4,1,25916,25916,25917,0,1,3
7403,4,3,25920,25920,25923,0,3,3
7404,2,1,25922,25923,25924,1,2,0
7405,2,3,25924,25924,25927,0,3,0
7406,1,2,25925,25927,25929,2,4,0
7407,3,2,25928,25929,25931,1,3,0
7408,6,2,25934,25934,25936,0,2,3
7409,6,3,25940,25940,25943,0,3,4
7410,1,1,25941,25943,25944,2,3,0
7411,4,1,25945,25945,25946,0,1,1
7412,4,2,25949,25949,25951,0,2,3
7413,1,1,25950,25951,25952,1,2,0
7414,6,3,25956,25956,25959,0,3,4
7415,1,1,25957,25959,25960,2,3,0
7416,1,2,25958,25960,25962,2,4,0
7417,4,2,25962,25962,25964,0,2,0
7418,4,1,25966,25966,25967,0,1,2
7419,6,1,25972,25972,25973,0,1,5
7420,3,2,25975,25975,25977,0,2,2
7421,1,1,25976,25977,25978,1,2,0
7422,5,3,25981,25981,25984,0,3,3
7423,3,3,25984,25984,25987,0,3,0
7424,2,2,25986,25987,25989,1,3,0
7425,5,1,25991,25991,25992,0,1,2
7426,5,2,25996,25996,25998,0,2,4
7427,1,1,25997,25998,25999,1,2,0
7428,5,2,26002,26002,26004,0,2,3
7429,1,3,26003,26004,26007,1,4,0
7430,3,3,26006,26007,26010,1,4,0
7431,4,1,26010,26010,26011,0,1,0
7432,1,2,26011,26011,26013,0,2,0
7433,6,2,26017,26017,26019,0,2,4
7434,5,1,26022,26022,26023,0,1,3
7435,3,1,26025,26025,26026,0,1,2
7436,6,1,26031,26031,26032,0,1,5
7437,6,2,26037,26037,26039,0,2,5
7438,6,1,26043,26043,26044,0,1,4
7439,2,2,26045,26045,26047,0,2,1
7440,6,2,26051,26051,26053,0,2,4
7441,6,2,26057,26057,26059,0,2,4
7442,6,1,26063,26063,26064,0,1,4
7443,6,3,26069,26069,26072,0,3,5
7444,4,3,26073,26073,26076,0,3,1
7445,4,3,26077,26077,26080,0,3,1
7446,4,2,26081,26081,26083,0,2,1
7447,4,3,26085,26085,26088,0,3,2
7448,3,2,26088,26088,26090,0,2,0
7449,3,3,26091,26091,26094,0,3,1
7450,6,2,26097,26097,26099,0,2,3
7451,1,3,26098,26099,26102,1,4,0
7452,4,1,26102,26102,26103,0,1,0
7453,3,1,26105,26105,26106,0,1,2
7454,5,2,26110,26110,26112,0,2,4
7455,2,1,26112,26112,26113,0,1,0
7456,2,1,26114,26114,26115,0,1,1
7457,5,1,26119,26119,26120,0,1,4
7458,2,1,26121,26121,26122,0,1,1
7459,3,3,26124,26124,26127,0,3,2
7460,5,2,26129,26129,26131,0,2,2
7461,3,3,26132,26132,26135,0,3,1
7462,2,1,26134,26135,26136,1,2,0
7463,5,2,26139,26139,26141,0,2,3
7464,3,2,26142,26142,26144,0,2,1
7465,4,2,26146,26146,26148,0,2,2
7466,4,2,26150,26150,26152,0,2,2
7467,3,3,26153,26153,26156,0,3,1
7468,3,2,26156,26156,26158,0,2,0
7469,1,2,26157,26158,26160,1,3,0
7470,6,3,26163,26163,26166,0,3,3
7471,1,2,26164,26166,26168,2,4,0
7472,5,3,26169,26169,26172,0,3,1
7473,2,1,26171,26172,26173,1,2,0
7474,1,3,26172,26173,26176,1,4,0
7475,5,2,26177,26177,26179,0,2,1
7476,1,2,26178,26179,26181,1,3,0
7477,5,2,26183,26183,26185,0,2,2
7478,2,1,26185,26185,26186,0,1,0
7479,3,1,26188,26188,26189,0,1,2
7480,3,1,26191,26191,26192,0,1,2
7481,2,2,26193,26193,26195,0,2,1
7482,4,2,26197,26197,26199,0,2,2
7483,2,1,26199,26199,26200,0,1,0
7484,2,1,26201,26201,26202,0,1,1
7485,2,3,26203,26203,26206,0,3,1
7486,6,1,26209,26209,26210,0,1,3
7487,4,3,26213,26213,26216,0,3,3
7488,1,3,26214,26216,26219,2,5,0
7489,6,1,26220,26220,26221,0,1,1
7490,2,2,26222,26222,26224,0,2,1
7491,2,2,26224,26224,26226,0,2,0
7492,5,2,26229,26229,26231,0,2,3
7493,2,2,26231,26231,26233,0,2,0
7494,1,2,26232,26233,26235,1,3,0
7495,3,3,26235,26235,26238,0,3,0
7496,6,2,26241,26241,26243,0,2,3
7497,1,3,26242,26243,26246,1,4,0
7498,3,3,26245,26246,26249,1,4,0
7499,1,2,26246,26249,26251,3,5,0
7500,2,1,26248,26251,26252,3,4,0
7501,2,1,26250,26252,26253,2,3,0
7502,4,1,26254,26254,26255,0,1,1
7503,6,2,26260,26260,26262,0,2,5
7504,1,3,26261,26262,26265,1,4,0
7505,3,1,26264,26265,26266,1,2,0
7506,5,1,26269,26269,26270,0,1,3
7507,5,3,26274,26274,26277,0,3,4
7508,6,3,26280,26280,26283,0,3,3
7509,5,2,26285,26285,26287,0,2,2
7510,3,3,26288,26288,26291,0,3,1
7511,2,3,26290,26291,26294,1,4,0
7512,2,1,26292,26294,26295,2,3,0
7513,6,2,26298,26298,26300,0,2,3
7514,5,3,26303,26303,26306,0,3,3
7515,5,1,26308,26308,26309,0,1,2
7516,5,1,26313,26313,26314,0,1,4
7517,2,2,26315,26315,26317,0,2,1
7518,5,2,26320,26320,26322,0,2,3
7519,2,3,26322,26322,26325,0,3,0
7520,3,1,26325,26325,26326,0,1,0
7521,4,3,26329,26329,26332,0,3,3
7522,4,3,26333,26333,26336,0,3,1
7523,6,3,26339,26339,26342,0,3,3
7524,2,3,26341,26342,26345,1,4,0
7525,2,2,26343,26345,26347,2,4,0
7526,6,3,26349,26349,26352,0,3,2
7527,3,1,26352,26352,26353,0,1,0
7528,2,1,26354,26354,26355,0,1,1
7529,4,2,26358,26358,26360,0,2,3
7530,2,1,26360,26360,26361,0,1,0
7531,4,3,26364,26364,26367,0,3,3
7532,5,2,26369,26369,26371,0,2,2
7533,4,2,26373,26373,26375,0,2,2
7534,4,1,26377,26377,26378,0,1,2
7535,2,1,26379,26379,26380,0,1,1
7536,2,2,26381,26381,26383,0,2,1
7537,4,1,26385,26385,26386,0,1,2
7538,6,2,26391,26391,26393,0,2,5
7539,5,2,26396,26396,26398,0,2,3
7540,3,2,26399,26399,26401,0,2,1
7541,6,1,26405,26405,26406,0,1,4
7542,6,3,26411,26411,26414,0,3,5
7543,5,3,26416,26416,26419,0,3,2
7544,1,3,26417,26419,26422,2,5,0
7545,6,1,26423,26423,26424,0,1,1
7546,4,3,26427,26427,26430,0,3,3
7547,2,1,26429,26430,26431,1,2,0
7548,6,3,26435,26435,26438,0,3,4
7549,2,3,26437,26438,26441,1,4,0
7550,5,2,26442,26442,26444,0,2,1
7551,1,1,26443,26444,26445,1,2,0
7552,6,1,26449,26449,26450,0,1,4
7553,6,3,26455,26455,26458,0,3,5
7554,2,2,26457,26458,26460,1,3,0
7555,5,1,26462,26462,26463,0,1,2
7556,6,1,26468,26468,26469,0,1,5
7557,2,2,26470,26470,26472,0,2,1
7558,2,3,26472,26472,26475,0,3,0
7559,3,3,26475,26475,26478,0,3,0
7560,3,1,26478,26478,26479,0,1,0
7561,2,2,26480,26480,26482,0,2,1
7562,3,3,26483,26483,26486,0,3,1
7563,2,2,26485,26486,26488,1,3,0
7564,4,3,26489,26489,26492,0,3,1
7565,5,2,26494,26494,26496,0,2,2
7566,5,2,26499,26499,26501,0,2,3
7567,2,3,26501,26501,26504,0,3,0
7568,5,1,26506,26506,26507,0,1,2
7569,2,1,26508,26508,26509,0,1,1
7570,4,2,26512,26512,26514,0,2,3
7571,2,2,26514,26514,26516,0,2,0
7572,6,2,26520,26520,26522,0,2,4
7573,5,3,26525,26525,26528,0,3,3
7574,2,1,26527,26528,26529,1,2,0
7575,4,1,26531,26531,26532,0,1,2
7576,2,3,26533,26533,26536,0,3,1
7577,5,2,26538,26538,26540,0,2,2
7578,3,3,26541,26541,26544,0,3,1
7579,6,2,26547,26547,26549,0,2,3
7580,3,1,26550,26550,26551,0,1,1
7581,6,3,26556,26556,26559,0,3,5
7582,5,1,26561,26561,26562,0,1,2
7583,3,2,26564,26564,26566,0,2,2
7584,3,1,26567,26567,26568,0,1,1
7585,2,2,26569,26569,26571,0,2,1
7586,2,2,26571,26571,26573,0,2,0
7587,2,1,26573,26573,26574,0,1,0
7588,1,3,26574,26574,26577,0,3,0
7589,5,3,26579,26579,26582,0,3,2
7590,2,2,26581,26582,26584,1,3,0
7591,1,3,26582,26584,26587,2,5,0
7592,3,1,26585,26587,26588,2,3,0
7593,3,3,26588,26588,26591,0,3,0
7594,2,1,26590,26591,26592,1,2,0
7595,3,3,26593,26593,26596,0,3,1
7596,3,2,26596,26596,26598,0,2,0
7597,4,1,26600,26600,26601,0,1,2
7598,1,3,26601,26601,26604,0,3,0
7599,6,3,26607,26607,26610,0,3,3
7600,2,1,26609,26610,26611,1,2,0
7601,6,3,26615,26615,26618,0,3,4
7602,1,1,26616,26618,26619,2,3,0
7603,4,1,26620,26620,26621,0,1,1
7604,2,3,26622,26622,26625,0,3,1
7605,3,1,26625,26625,26626,0,1,0
7606,1,3,26626,26626,26629,0,3,0
7607,1,1,26627,26629,26630,2,3,0
7608,2,1,26629,26630,26631,1,2,0
7609,2,3,26631,26631,26634,0,3,0
7610,1,1,26632,26634,26635,2,3,0
7611,1,1,26633,26635,26636,2,3,0
7612,1,3,26634,26636,26639,2,5,0
7613,4,3,26638,26639,26642,1,4,0
7614,5,2,26643,26643,26645,0,2,1
7615,1,1,26644,26645,26646,1,2,0
7616,1,2,26645,26646,26648,1,3,0
7617,1,3,26646,26648,26651,2,5,0
7618,2,3,26648,26651,26654,3,6,0
7619,6,2,26654,26654,26656,0,2,0
7620,1,3,26655,26656,26659,1,4,0
7621,6,2,26661,26661,26663,0,2,2
7622,6,3,26667,26667,26670,0,3,4
7623,3,1,26670,26670,26671,0,1,0
7624,3,3,26673,26673,26676,0,3,2
7625,3,1,26676,26676,26677,0,1,0
7626,3,3,26679,26679,26682,0,3,2
7627,5,1,26684,26684,26685,0,1,2
7628,3,2,26687,26687,26689,0,2,2
7629,4,3,26691,26691,26694,0,3,2
7630,4,2,26695,26695,26697,0,2,1
7631,1,3,26696,26697,26700,1,4,0
7632,1,1,26697,26700,26701,3,4,0
7633,1,1,26698,26701,26702,3,4,0
7634,6,1,26704,26704,26705,0,1,2
7635,2,1,26706,26706,26707,0,1,1
7636,1,3,26707,26707,26710,0,3,0
7637,1,3,26708,26710,26713,2,5,0
7638,2,3,26710,26713,26716,3,6,0
7639,5,2,26715,26716,26718,1,3,0
7640,6,2,26721,26721,26723,0,2,3
7641,2,3,26723,26723,26726,0,3,0
7642,5,3,26728,26728,26731,0,3,2
7643,1,1,26729,26731,26732,2,3,0
7644,5,3,26734,26734,26737,0,3,2
7645,5,1,26739,26739,26740,0,1,2
7646,5,1,26744,26744,26745,0,1,4
7647,2,2,26746,26746,26748,0,2,1
7648,2,2,26748,26748,26750,0,2,0
7649,3,2,26751,26751,26753,0,2,1
7650,5,2,26756,26756,26758,0,2,3
7651,1,2,26757,26758,26760,1,3,0
7652,3,3,26760,26760,26763,0,3,0
7653,2,2,26762,26763,26765,1,3,0
7654,3,3,26765,26765,26768,0,3,0
7655,4,1,26769,26769,26770,0,1,1
7656,3,3,26772,26772,26775,0,3,2
7657,5,3,26777,26777,26780,0,3,2
7658,6,1,26783,26783,26784,0,1,3
7659,5,2,26788,26788,26790,0,2,4
7660,6,1,26794,26794,26795,0,1,4
7661,2,2,26796,26796,26798,0,2,1
7662,2,2,26798,26798,26800,0,2,0
7663,1,3,26799,26800,26803,1,4,0
7664,1,1,26800,26803,26804,3,4,0
7665,5,3,26805,26805,26808,0,3,1
7666,3,2,26808,26808,26810,0,2,0
7667,4,2,26812,26812,26814,0,2,2
7668,1,1,26813,26814,26815,1,2,0
7669,3,2,26816,26816,26818,0,2,1
7670,4,1,26820,26820,26821,0,1,2
7671,1,2,26821,26821,26823,0,2,0
7672,5,2,26826,26826,26828,0,2,3
7673,4,2,26830,26830,26832,0,2,2
7674,3,1,26833,26833,26834,0,1,1
7675,4,1,26837,26837,26838,0,1,3
7676,6,1,26843,26843,26844,0,1,5
7677,4,2,26847,26847,26849,0,2,3
7678,6,1,26853,26853,26854,0,1,4
7679,5,3,26858,26858,26861,0,3,4
7680,5,1,26863,26863,26864,0,1,2
7681,2,2,26865,26865,26867,0,2,1
7682,4,1,26869,26869,26870,0,1,2
7683,5,1,26874,26874,26875,0,1,4
7684,6,3,26880,26880,26883,0,3,5
7685,3,2,26883,26883,26885,0,2,0
7686,6,2,26889,26889,26891,0,2,4
7687,1,3,26890,26891,26894,1,4,0
7688,2,2,26892,26894,26896,2,4,0
7689,6,2,26898,26898,26900,0,2,2
7690,4,1,26902,26902,26903,0,1,2
7691,5,1,26907,26907,26908,0,1,4
7692,6,1,26913,26913,26914,0,1,5
7693,4,1,26917,26917,26918,0,1,3
7694,1,2,26918,26918,26920,0,2,0
7695,6,1,26924,26924,26925,0,1,4
7696,3,2,26927,26927,26929,0,2,2
7697,6,3,26933,26933,26936,0,3,4
7698,6,3,26939,26939,26942,0,3,3
7699,3,1,26942,26942,26943,0,1,0
7700,4,3,26946,26946,26949,0,3,3
7701,4,3,26950,26950,26953,0,3,1
7702,5,1,26955,26955,26956,0,1,2
7703,3,1,26958,26958,26959,0,1,2
7704,5,2,26963,26963,26965,0,2,4
7705,5,3,26968,26968,26971,0,3,3
7706,4,1,26972,26972,26973,0,1,1
7707,5,2,26977,26977,26979,0,2,4
7708,3,3,26980,26980,26983,0,3,1
7709,1,2,26981,26983,26985,2,4,0
7710,3,2,26984,26985,26987,1,3,0
7711,6,3,26990,26990,26993,0,3,3
7712,1,3,26991,26993,26996,2,5,0
7713,1,3,26992,26996,26999,4,7,0
7714,5,3,26997,26999,27002,2,5,0
7715,1,2,26998,27002,27004,4,6,0
7716,4,1,27002,27004,27005,2,3,0
7717,4,3,27006,27006,27009,0,3,1
7718,4,2,27010,27010,27012,0,2,1
7719,4,1,27014,27014,27015,0,1,2
7720,2,1,27016,27016,27017,0,1,1
7721,4,2,27020,27020,27022,0,2,3
7722,6,1,27026,27026,27027,0,1,4
7723,1,3,27027,27027,27030,0,3,0
7724,6,3,27033,27033,27036,0,3,3
7725,4,2,27037,27037,27039,0,2,1
7726,6,3,27043,27043,27046,0,3,4
7727,3,1,27046,27046,27047,0,1,0
7728,2,3,27048,27048,27051,0,3,1
7729,5,2,27053,27053,27055,0,2,2
7730,5,1,27058,27058,27059,0,1,3
7731,4,3,27062,27062,27065,0,3,3
7732,3,3,27065,27065,27068,0,3,0
7733,1,3,27066,27068,27071,2,5,0
7734,2,3,27068,27071,27074,3,6,0
7735,2,2,27070,27074,27076,4,6,0
7736,3,1,27073,27076,27077,3,4,0
7737,1,1,27074,27077,27078,3,4,0
7738,5,3,27079,27079,27082,0,3,1
7739,6,3,27085,27085,27088,0,3,3
7740,5,3,27090,27090,27093,0,3,2
7741,5,1,27095,27095,27096,0,1,2
7742,6,3,27101,27101,27104,0,3,5
7743,3,3,27104,27104,27107,0,3,0
7744,3,3,27107,27107,27110,0,3,0
7745,2,3,27109,27110,27113,1,4,0
7746,4,2,27113,27113,27115,0,2,0
7747,4,3,27117,27117,27120,0,3,2
7748,5,3,27122,27122,27125,0,3,2
7749,6,3,27128,27128,27131,0,3,3
7750,4,2,27132,27132,27134,0,2,1
7751,5,2,27137,27137,27139,0,2,3
7752,2,3,27139,27139,27142,0,3,0
7753,4,1,27143,27143,27144,0,1,1
7754,5,1,27148,27148,27149,0,1,4
7755,6,3,27154,27154,27157,0,3,5
7756,1,3,27155,27157,27160,2,5,0
7757,6,1,27161,27161,27162,0,1,1
7758,1,2,27162,27162,27164,0,2,0
7759,4,1,27166,27166,27167,0,1,2
7760,5,3,27171,27171,27174,0,3,4
7761,1,1,27172,27174,27175,2,3,0
7762,4,1,27176,27176,27177,0,1,1
7763,6,1,27182,27182,27183,0,1,5
7764,5,3,27187,27187,27190,0,3,4
7765,2,2,27189,27190,27192,1,3,0
7766,2,2,27191,27192,27194,1,3,0
7767,1,2,27192,27194,27196,2,4,0
7768,4,2,27196,27196,27198,0,2,0
7769,2,3,27198,27198,27201,0,3,0
7770,3,1,27201,27201,27202,0,1,0
7771,1,2,27202,27202,27204,0,2,0
7772,1,3,27203,27204,27207,1,4,0
7773,2,2,27205,27207,27209,2,4,0
7774,1,3,27206,27209,27212,3,6,0
7775,5,3,27211,27212,27215,1,4,0
7776,1,2,27212,27215,27217,3,5,0
7777,5,3,27217,27217,27220,0,3,0
7778,4,3,27221,27221,27224,0,3,1
7779,5,1,27226,27226,27227,0,1,2
7780,1,2,27227,27227,27229,0,2,0
7781,1,3,27228,27229,27232,1,4,0
7782,4,3,27232,27232,27235,0,3,0
7783,2,3,27234,27235,27238,1,4,0
7784,4,1,27238,27238,27239,0,1,0
7785,4,2,27242,27242,27244,0,2,3
7786,5,3,27247,27247,27250,0,3,3
7787,1,3,27248,27250,27253,2,5,0
7788,4,2,27252,27253,27255,1,3,0
7789,4,3,27256,27256,27259,0,3,1
7790,5,2,27261,27261,27263,0,2,2
7791,6,2,27267,27267,27269,0,2,4
7792,6,3,27273,27273,27276,0,3,4
7793,4,1,27277,27277,27278,0,1,1
7794,6,2,27283,27283,27285,0,2,5
7795,4,3,27287,27287,27290,0,3,2
7796,1,2,27288,27290,27292,2,4,0
7797,4,2,27292,27292,27294,0,2,0
7798,2,3,27294,27294,27297,0,3,0
7799,6,1,27300,27300,27301,0,1,3
7800,5,1,27305,27305,27306,0,1,4
7801,6,1,27311,27311,27312,0,1,5
7802,6,1,27317,27317,27318,0,1,5
7803,6,3,27323,27323,27326,0,3,5
7804,1,2,27324,27326,27328,2,4,0
7805,1,1,27325,27328,27329,3,4,0
7806,2,3,27327,27329,27332,2,5,0
7807,1,1,27328,27332,27333,4,5,0
7808,5,1,27333,27333,27334,0,1,0
7809,5,3,27338,27338,27341,0,3,4
7810,1,1,27339,27341,27342,2,3,0
7811,1,1,27340,27342,27343,2,3,0
7812,4,1,27344,27344,27345,0,1,1
7813,2,1,27346,27346,27347,0,1,1
7814,2,3,27348,27348,27351,0,3,1
7815,6,3,27354,27354,27357,0,3,3
7816,1,2,27355,27357,27359,2,4,0
7817,4,3,27359,27359,27362,0,3,0
7818,5,2,27364,27364,27366,0,2,2
7819,1,1,27365,27366,27367,1,2,0
7820,1,3,27366,27367,27370,1,4,0
7821,2,1,27368,27370,27371,2,3,0
7822,5,2,27373,27373,27375,0,2,2
7823,1,2,27374,27375,27377,1,3,0
7824,5,2,27379,27379,27381,0,2,2
7825,3,2,27382,27382,27384,0,2,1
7826,2,1,27384,27384,27385,0,1,0
7827,6,3,27390,27390,27393,0,3,5
7828,1,2,27391,27393,27395,2,4,0
7829,2,2,27393,27395,27397,2,4,0
7830,5,2,27398,27398,27400,0,2,1
7831,4,2,27402,27402,27404,0,2,2
7832,1,2,27403,27404,27406,1,3,0
7833,4,2,27407,27407,27409,0,2,1
7834,2,3,27409,27409,27412,0,3,0
7835,3,1,27412,27412,27413,0,1,0
7836,3,2,27415,27415,27417,0,2,2
7837,3,1,27418,27418,27419,0,1,1
7838,3,1,27421,27421,27422,0,1,2
7839,6,2,27427,27427,27429,0,2,5
7840,2,1,27429,27429,27430,0,1,0
7841,2,2,27431,27431,27433,0,2,1
7842,2,3,27433,27433,27436,0,3,0
7843,4,3,27437,27437,27440,0,3,1
7844,6,2,27443,27443,27445,0,2,3
7845,1,2,27444,27445,27447,1,3,0
7846,5,1,27449,27449,27450,0,1,2
7847,4,3,27453,27453,27456,0,3,3
7848,4,3,27457,27457,27460,0,3,1
7849,3,3,27460,27460,27463,0,3,0
7850,5,2,27465,27465,27467,0,2,2
7851,4,1,27469,27469,27470,0,1,2
7852,2,3,27471,27471,27474,0,3,1
7853,5,3,27476,27476,27479,0,3,2
7854,1,2,27477,27479,27481,2,4,0
7855,4,1,27481,27481,27482,0,1,0
7856,3,2,27484,27484,27486,0,2,2
7857,5,2,27489,27489,27491,0,2,3
7858,5,2,27494,27494,27496,0,2,3
7859,6,1,27500,27500,27501,0,1,4
7860,4,3,27504,27504,27507,0,3,3
7861,5,1,27509,27509,27510,0,1,2
7862,2,2,27511,27511,27513,0,2,1
7863,4,2,27515,27515,27517,0,2,2
7864,3,1,27518,27518,27519,0,1,1
7865,2,3,27520,27520,27523,0,3,1
7866,3,1,27523,27523,27524,0,1,0
7867,1,1,27524,27524,27525,0,1,0
7868,5,3,27529,27529,27532,0,3,4
7869,2,3,27531,27532,27535,1,4,0
7870,1,2,27532,27535,27537,3,5,0
7871,3,2,27535,27537,27539,2,4,0
7872,3,1,27538,27539,27540,1,2,0
7873,5,3,27543,27543,27546,0,3,3
7874,2,3,27545,27546,27549,1,4,0
7875,3,3,27548,27549,27552,1,4,0
7876,3,2,27551,27552,27554,1,3,0
7877,1,2,27552,27554,27556,2,4,0
7878,1,1,27553,27556,27557,3,4,0
7879,4,2,27557,27557,27559,0,2,0
7880,3,3,27560,27560,27563,0,3,1
7881,4,3,27564,27564,27567,0,3,1
7882,3,1,27567,27567,27568,0,1,0
7883,2,2,27569,27569,27571,0,2,1
7884,6,1,27575,27575,27576,0,1,4
7885,4,1,27579,27579,27580,0,1,3
7886,6,1,27585,27585,27586,0,1,5
7887,2,3,27587,27587,27590,0,3,1
7888,4,3,27591,27591,27594,0,3,1
7889,1,3,27592,27594,27597,2,5,0
7890,3,2,27595,27597,27599,2,4,0
7891,1,1,27596,27599,27600,3,4,0
7892,1,2,27597,27600,27602,3,5,0
7893,4,1,27601,27602,27603,1,2,0
7894,4,1,27605,27605,27606,0,1,2
7895,6,1,27611,27611,27612,0,1,5
7896,1,1,27612,27612,27613,0,1,0
7897,1,1,27613,27613,27614,0,1,0
7898,3,1,27616,27616,27617,0,1,2
7899,3,3,27619,27619,27622,0,3,2
7900,6,1,27625,27625,27626,0,1,3
7901,1,2,27626,27626,27628,0,2,0
7902,6,1,27632,27632,27633,0,1,4
7903,4,3,27636,27636,27639,0,3,3
7904,3,3,27639,27639,27642,0,3,0
7905,3,3,27642,27642,27645,0,3,0
7906,5,3,27647,27647,27650,0,3,2
7907,6,2,27653,27653,27655,0,2,3
7908,5,1,27658,27658,27659,0,1,3
7909,1,2,27659,27659,27661,0,2,0
7910,6,1,27665,27665,27666,0,1,4
7911,4,1,27669,27669,27670,0,1,3
7912,5,3,27674,27674,27677,0,3,4
7913,6,1,27680,27680,27681,0,1,3
7914,3,3,27683,27683,27686,0,3,2
7915,4,2,27687,27687,27689,0,2,1
7916,3,3,27690,27690,27693,0,3,1
7917,2,2,27692,27693,27695,1,3,0
7918,5,3,27697,27697,27700,0,3,2
7919,5,1,27702,27702,27703,0,1,2
7920,1,1,27703,27703,27704,0,1,0
7921,4,2,27707,27707,27709,0,2,3
7922,5,2,27712,27712,27714,0,2,3
7923,1,2,27713,27714,27716,1,3,0
7924,5,1,27718,27718,27719,0,1,2
7925,2,1,27720,27720,27721,0,1,1
7926,4,1,27724,27724,27725,0,1,3
7927,5,3,27729,27729,27732,0,3,4
7928,2,3,27731,27732,27735,1,4,0
7929,2,3,27733,27735,27738,2,5,0
7930,1,3,27734,27738,27741,4,7,0
7931,2,1,27736,27741,27742,5,6,0
7932,3,3,27739,27742,27745,3,6,0
7933,3,1,27742,27745,27746,3,4,0
7934,6,3,27748,27748,27751,0,3,2
7935,1,1,27749,27751,27752,2,3,0
7936,1,1,27750,27752,27753,2,3,0
7937,5,3,27755,27755,27758,0,3,2
7938,2,1,27757,27758,27759,1,2,0
7939,2,1,27759,27759,27760,0,1,0
7940,5,2,27764,27764,27766,0,2,4
7941,4,3,27768,27768,27771,0,3,2
7942,6,1,27774,27774,27775,0,1,3
7943,2,3,27776,27776,27779,0,3,1
7944,1,1,27777,27779,27780,2,3,0
7945,4,2,27781,27781,27783,0,2,1
7946,3,2,27784,27784,27786,0,2,1
7947,2,1,27786,27786,27787,0,1,0
7948,1,1,27787,27787,27788,0,1,0
7949,4,1,27791,27791,27792,0,1,3
7950,5,3,27796,27796,27799,0,3,4
7951,3,3,27799,27799,27802,0,3,0
7952,2,2,27801,27802,27804,1,3,0
7953,3,3,27804,27804,27807,0,3,0
7954,5,1,27809,27809,27810,0,1,2
7955,2,1,27811,27811,27812,0,1,1
7956,1,1,27812,27812,27813,0,1,0
7957,4,3,27816,27816,27819,0,3,3
7958,6,2,27822,27822,27824,0,2,3
7959,6,2,27828,27828,27830,0,2,4
7960,2,1,27830,27830,27831,0,1,0
7961,6,2,27836,27836,27838,0,2,5
7962,5,3,27841,27841,27844,0,3,3
7963,3,2,27844,27844,27846,0,2,0
7964,2,2,27846,27846,27848,0,2,0
7965,4,2,27850,27850,27852,0,2,2
7966,1,2,27851,27852,27854,1,3,0
7967,6,3,27857,27857,27860,0,3,3
7968,6,3,27863,27863,27866,0,3,3
7969,4,3,27867,27867,27870,0,3,1
7970,1,3,27868,27870,27873,2,5,0
7971,3,2,27871,27873,27875,2,4,0
7972,3,3,27874,27875,27878,1,4,0
7973,3,2,27877,27878,27880,1,3,0
7974,4,1,27881,27881,27882,0,1,1
7975,5,2,27886,27886,27888,0,2,4
7976,2,1,27888,27888,27889,0,1,0
7977,2,1,27890,27890,27891,0,1,1
7978,3,2,27893,27893,27895,0,2,2
7979,5,1,27898,27898,27899,0,1,3
7980,2,2,27900,27900,27902,0,2,1
7981,2,2,27902,27902,27904,0,2,0
7982,6,2,27908,27908,27910,0,2,4
7983,4,1,27912,27912,27913,0,1,2
7984,6,2,27918,27918,27920,0,2,5
7985,1,3,27919,27920,27923,1,4,0
7986,6,2,27925,27925,27927,0,2,2
7987,5,2,27930,27930,27932,0,2,3
7988,2,3,27932,27932,27935,0,3,0
7989,6,2,27938,27938,27940,0,2,3
7990,6,3,27944,27944,27947,0,3,4
7991,3,3,27947,27947,27950,0,3,0
7992,4,1,27951,27951,27952,0,1,1
7993,5,1,27956,27956,27957,0,1,4
7994,2,1,27958,27958,27959,0,1,1
7995,1,1,27959,27959,27960,0,1,0
7996,5,2,27964,27964,27966,0,2,4
7997,1,2,27965,27966,27968,1,3,0
7998,5,1,27970,27970,27971,0,1,2
7999,6,3,27976,27976,27979,0,3,5
8000,4,2,27980,27980,27982,0,2,1
8001,1,2,27981,27982,27984,1,3,0
8002,4,1,27985,27985,27986,0,1,1
8003,3,2,27988,27988,27990,0,2,2
8004,2,1,27990,27990,27991,0,1,0
8005,5,1,27995,27995,27996,0,1,4
8006,2,2,27997,27997,27999,0,2,1
8007,6,3,28003,28003,28006,0,3,4
8008,1,1,28004,28006,28007,2,3,0
8009,3,2,28007,28007,28009,0,2,0
8010,1,2,28008,28009,28011,1,3,0
8011,6,2,28014,28014,28016,0,2,3
8012,2,3,28016,28016,28019,0,3,0
8013,4,2,28020,28020,28022,0,2,1
8014,1,3,28021,28022,28025,1,4,0
8015,2,2,28023,28025,28027,2,4,0
8016,3,3,28026,28027,28030,1,4,0
8017,3,1,28029,28030,28031,1,2,0
8018,5,3,28034,28034,28037,0,3,3
8019,1,3,28035,28037,28040,2,5,0
8020,3,1,28038,28040,28041,2,3,0
8021,6,3,28044,28044,28047,0,3,3
8022,2,2,28046,28047,28049,1,3,0
8023,2,1,28048,28049,28050,1,2,0
8024,2,2,28050,28050,28052,0,2,0
8025,5,3,28055,28055,28058,0,3,3
8026,6,3,28061,28061,28064,0,3,3
8027,4,3,28065,28065,28068,0,3,1
8028,6,3,28071,28071,28074,0,3,3
8029,1,3,28072,28074,28077,2,5,0
8030,3,2,28075,28077,28079,2,4,0
8031,2,2,28077,28079,28081,2,4,0
8032,2,2,28079,28081,28083,2,4,0
8033,1,1,28080,28083,28084,3,4,0
8034,5,2,28085,28085,28087,0,2,1
8035,5,1,28090,28090,28091,0,1,3
8036,3,2,28093,28093,28095,0,2,2
8037,6,1,28099,28099,28100,0,1,4
8038,1,3,28100,28100,28103,0,3,0
8039,3,3,28103,28103,28106,0,3,0
8040,2,1,28105,28106,28107,1,2,0
8041,4,1,28109,28109,28110,0,1,2
8042,3,2,28112,28112,28114,0,2,2
8043,5,2,28117,28117,28119,0,2,3
8044,6,3,28123,28123,28126,0,3,4
8045,5,3,28128,28128,28131,0,3,2
8046,5,3,28133,28133,28136,0,3,2
8047,4,2,28137,28137,28139,0,2,1
8048,4,3,28141,28141,28144,0,3,2
8049,6,1,28147,28147,28148,0,1,3
8050,3,3,28150,28150,28153,0,3,2
8051,5,2,28155,28155,28157,0,2,2
8052,3,3,28158,28158,28161,0,3,1
8053,4,3,28162,28162,28165,0,3,1
8054,2,1,28164,28165,28166,1,2,0
8055,3,3,28167,28167,28170,0,3,1
8056,1,2,28168,28170,28172,2,4,0
8057,4,2,28172,28172,28174,0,2,0
8058,6,1,28178,28178,28179,0,1,4
8059,2,3,28180,28180,28183,0,3,1
8060,4,2,28184,28184,28186,0,2,1
8061,5,1,28189,28189,28190,0,1,3
8062,3,3,28192,28192,28195,0,3,2
8063,6,1,28198,28198,28199,0,1,3
8064,5,1,28203,28203,28204,0,1,4
8065,2,3,28205,28205,28208,0,3,1
8066,6,3,28211,28211,28214,0,3,3
8067,6,2,28217,28217,28219,0,2,3
8068,4,1,28221,28221,28222,0,1,2
8069,4,2,28225,28225,28227,0,2,3
8070,4,1,28229,28229,28230,0,1,2
8071,3,1,28232,28232,28233,0,1,2
8072,2,2,28234,28234,28236,0,2,1
8073,3,1,28237,28237,28238,0,1,1
8074,4,2,28241,28241,28243,0,2,3
8075,6,3,28247,28247,28250,0,3,4
8076,5,1,28252,28252,28253,0,1,2
8077,3,1,28255,28255,28256,0,1,2
8078,6,3,28261,28261,28264,0,3,5
8079,6,2,28267,28267,28269,0,2,3
8080,3,1,28270,28270,28271,0,1,1
8081,1,3,28271,28271,28274,0,3,0
8082,5,3,28276,28276,28279,0,3,2
8083,1,3,28277,28279,28282,2,5,0
8084,6,3,28283,28283,28286,0,3,1
8085,4,2,28287,28287,28289,0,2,1
8086,4,1,28291,28291,28292,0,1,2
8087,6,1,28297,28297,28298,0,1,5
8088,5,1,28302,28302,28303,0,1,4
8089,6,2,28308,28308,28310,0,2,5
8090,6,1,28314,28314,28315,0,1,4
8091,1,3,28315,28315,28318,0,3,0
8092,4,1,28319,28319,28320,0,1,1
8093,1,1,28320,28320,28321,0,1,0
8094,5,3,28325,28325,28328,0,3,4
8095,3,1,28328,28328,28329,0,1,0
8096,6,2,28334,28334,28336,0,2,5
8097,4,1,28338,28338,28339,0,1,2
8098,1,2,28339,28339,28341,0,2,0
8099,5,3,28344,28344,28347,0,3,3
8100,2,2,28346,28347,28349,1,3,0
8101,6,2,28352,28352,28354,0,2,3
8102,6,3,28358,28358,28361,0,3,4
8103,3,2,28361,28361,28363,0,2,0
8104,4,2,28365,28365,28367,0,2,2
8105,1,1,28366,28367,28368,1,2,0
8106,1,1,28367,28368,28369,1,2,0
8107,3,1,28370,28370,28371,0,1,1
8108,2,3,28372,28372,28375,0,3,1
8109,2,2,28374,28375,28377,1,3,0
8110,5,2,28379,28379,28381,0,2,2
8111,2,2,28381,28381,28383,0,2,0
8112,1,3,28382,28383,28386,1,4,0
8113,3,1,28385,28386,28387,1,2,0
8114,4,3,28389,28389,28392,0,3,2
8115,1,3,28390,28392,28395,2,5,0
8116,5,2,28395,28395,28397,0,2,0
8117,2,3,28397,28397,28400,0,3,0
8118,4,1,28401,28401,28402,0,1,1
8119,5,3,28406,28406,28409,0,3,4
8120,6,2,28412,28412,28414,0,2,3
8121,4,3,28416,28416,28419,0,3,2
8122,3,3,28419,28419,28422,0,3,0
8123,1,3,28420,28422,28425,2,5,0
8124,6,2,28426,28426,28428,0,2,1
8125,5,3,28431,28431,28434,0,3,3
8126,4,1,28435,28435,28436,0,1,1
8127,5,3,28440,28440,28443,0,3,4
8128,6,1,28446,28446,28447,0,1,3
8129,2,2,28448,28448,28450,0,2,1
8130,2,1,28450,28450,28451,0,1,0
8131,5,2,28455,28455,28457,0,2,4
8132,1,2,28456,28457,28459,1,3,0
8133,2,3,28458,28459,28462,1,4,0
8134,5,1,28463,28463,28464,0,1,1
8135,4,3,28467,28467,28470,0,3,3
8136,5,3,28472,28472,28475,0,3,2
8137,6,1,28478,28478,28479,0,1,3
8138,5,2,28483,28483,28485,0,2,4
8139,6,3,28489,28489,28492,0,3,4
8140,6,1,28495,28495,28496,0,1,3
8141,1,3,28496,28496,28499,0,3,0
8142,6,1,28502,28502,28503,0,1,3
8143,1,3,28503,28503,28506,0,3,0
8144,4,2,28507,28507,28509,0,2,1
8145,5,2,28512,28512,28514,0,2,3
8146,1,3,28513,28514,28517,1,4,0
8147,1,1,28514,28517,28518,3,4,0
8148,3,1,28517,28518,28519,1,2,0
8149,6,2,28523,28523,28525,0,2,4
8150,6,3,28529,28529,28532,0,3,4
8151,6,2,28535,28535,28537,0,2,3
8152,5,1,28540,28540,28541,0,1,3
8153,4,3,28544,28544,28547,0,3,3
8154,2,1,28546,28547,28548,1,2,0
8155,6,1,28552,28552,28553,0,1,4
8156,6,3,28558,28558,28561,0,3,5
8157,2,3,28560,28561,28564,1,4,0
8158,3,3,28563,28564,28567,1,4,0
8159,5,1,28568,28568,28569,0,1,1
8160,6,1,28574,28574,28575,0,1,5
8161,4,3,28578,28578,28581,0,3,3
8162,4,2,28582,28582,28584,0,2,1
8163,6,1,28588,28588,28589,0,1,4
8164,5,3,28593,28593,28596,0,3,4
8165,4,3,28597,28597,28600,0,3,1
8166,4,1,28601,28601,28602,0,1,1
8167,2,1,28603,28603,28604,0,1,1
8168,2,1,28605,28605,28606,0,1,1
8169,5,2,28610,28610,28612,0,2,4
8170,6,1,28616,28616,28617,0,1,4
8171,2,2,28618,28618,28620,0,2,1
8172,5,2,28623,28623,28625,0,2,3
8173,4,1,28627,28627,28628,0,1,2
8174,1,3,28628,28628,28631,0,3,0
8175,2,3,28630,28631,28634,1,4,0
8176,1,2,28631,28634,28636,3,5,0
8177,4,1,28635,28636,28637,1,2,0
8178,5,1,28640,28640,28641,0,1,3
8179,4,3,28644,28644,28647,0,3,3
8180,1,3,28645,28647,28650,2,5,0
8181,6,3,28651,28651,28654,0,3,1
8182,4,2,28655,28655,28657,0,2,1
8183,2,1,28657,28657,28658,0,1,0
8184,4,2,28661,28661,28663,0,2,3
8185,5,3,28666,28666,28669,0,3,3
8186,5,2,28671,28671,28673,0,2,2
8187,4,1,28675,28675,28676,0,1,2
8188,2,1,28677,28677,28678,0,1,1
8189,1,1,28678,28678,28679,0,1,0
8190,4,3,28682,28682,28685,0,3,3
8191,3,3,28685,28685,28688,0,3,0
8192,3,2,28688,28688,28690,0,2,0
8193,2,2,28690,28690,28692,0,2,0
8194,3,3,28693,28693,28696,0,3,1
8195,3,2,28696,28696,28698,0,2,0
8196,5,1,28701,28701,28702,0,1,3
8197,6,1,28707,28707,28708,0,1,5
8198,4,1,28711,28711,28712,0,1,3
8199,5,1,28716,28716,28717,0,1,4
8200,5,3,28721,28721,28724,0,3,4
8201,4,2,28725,28725,28727,0,2,1
8202,1,3,28726,28727,28730,1,4,0
8203,4,2,28730,28730,28732,0,2,0
8204,2,2,28732,28732,28734,0,2,0
8205,6,3,28738,28738,28741,0,3,4
8206,2,1,28740,28741,28742,1,2,0
8207,3,1,28743,28743,28744,0,1,1
8208,1,2,28744,28744,28746,0,2,0
8209,4,1,28748,28748,28749,0,1,2
8210,5,1,28753,28753,28754,0,1,4
8211,1,3,28754,28754,28757,0,3,0
8212,4,1,28758,28758,28759,0,1,1
8213,5,1,28763,28763,28764,0,1,4
8214,5,2,28768,28768,28770,0,2,4
8215,2,3,28770,28770,28773,0,3,0
8216,6,1,28776,28776,28777,0,1,3
8217,2,2,28778,28778,28780,0,2,1
8218,6,1,28784,28784,28785,0,1,4
8219,6,2,28790,28790,28792,0,2,5
8220,2,1,28792,28792,28793,0,1,0
8221,6,1,28798,28798,28799,0,1,5
8222,1,3,28799,28799,28802,0,3,0
8223,2,3,28801,28802,28805,1,4,0
8224,2,1,28803,28805,28806,2,3,0
8225,1,1,28804,28806,28807,2,3,0
8226,6,2,28810,28810,28812,0,2,3
8227,3,3,28813,28813,28816,0,3,1
8228,3,3,28816,28816,28819,0,3,0
8229,3,2,28819,28819,28821,0,2,0
8230,6,3,28825,28825,28828,0,3,4
8231,1,3,28826,28828,28831,2,5,0
8232,2,2,28828,28831,28833,3,5,0
8233,4,2,28832,28833,28835,1,3,0
8234,3,2,28835,28835,28837,0,2,0
8235,3,2,28838,28838,28840,0,2,1
8236,4,2,28842,28842,28844,0,2,2
8237,2,3,28844,28844,28847,0,3,0
8238,1,1,28845,28847,28848,2,3,0
8239,2,2,28847,28848,28850,1,3,0
8240,3,1,28850,28850,28851,0,1,0
8241,4,2,28854,28854,28856,0,2,3
8242,3,2,28857,28857,28859,0,2,1
8243,3,1,28860,28860,28861,0,1,1
8244,2,3,28862,28862,28865,0,3,1
8245,5,1,28867,28867,28868,0,1,2
8246,6,3,28873,28873,28876,0,3,5
8247,2,2,28875,28876,28878,1,3,0
8248,3,3,28878,28878,28881,0,3,0
8249,2,3,28880,28881,28884,1,4,0
8250,4,1,28884,28884,28885,0,1,0
8251,1,3,28885,28885,28888,0,3,0
8252,1,1,28886,28888,28889,2,3,0
8253,4,1,28890,28890,28891,0,1,1
8254,4,1,28894,28894,28895,0,1,3
8255,5,3,28899,28899,28902,0,3,4
8256,5,3,28904,28904,28907,0,3,2
8257,1,3,28905,28907,28910,2,5,0
8258,3,1,28908,28910,28911,2,3,0
8259,2,3,28910,28911,28914,1,4,0
8260,5,3,28915,28915,28918,0,3,1
8261,4,3,28919,28919,28922,0,3,1
8262,1,1,28920,28922,28923,2,3,0
8263,4,3,28924,28924,28927,0,3,1
8264,4,2,28928,28928,28930,0,2,1
8265,2,3,28930,28930,28933,0,3,0
8266,5,1,28935,28935,28936,0,1,2
8267,5,1,28940,28940,28941,0,1,4
8268,2,1,28942,28942,28943,0,1,1
8269,2,1,28944,28944,28945,0,1,1
8270,5,3,28949,28949,28952,0,3,4
8271,6,3,28955,28955,28958,0,3,3
8272,5,1,28960,28960,28961,0,1,2
8273,1,1,28961,28961,28962,0,1,0
8274,2,3,28963,28963,28966,0,3,1
8275,4,3,28967,28967,28970,0,3,1
8276,3,3,28970,28970,28973,0,3,0
8277,1,3,28971,28973,28976,2,5,0
8278,3,1,28974,28976,28977,2,3,0
8279,3,1,28977,28977,28978,0,1,0
8280,4,3,28981,28981,28984,0,3,3
8281,5,3,28986,28986,28989,0,3,2
8282,3,2,28989,28989,28991,0,2,0
8283,3,2,28992,28992,28994,0,2,1
8284,3,1,28995,28995,28996,0,1,1
8285,4,2,28999,28999,29001,0,2,3
8286,4,3,29003,29003,29006,0,3,2
8287,2,1,29005,29006,29007,1,2,0
8288,2,3,29007,29007,29010,0,3,0
8289,4,1,29011,29011,29012,0,1,1
8290,2,2,29013,29013,29015,0,2,1
8291,2,1,29015,29015,29016,0,1,0
8292,1,1,29016,29016,29017,0,1,0
8293,4,1,29020,29020,29021,0,1,3
8294,1,3,29021,29021,29024,0,3,0
8295,3,1,29024,29024,29025,0,1,0
8296,4,2,29028,29028,29030,0,2,3
8297,6,2,29034,29034,29036,0,2,4
8298,3,1,29037,29037,29038,0,1,1
8299,6,3,29043,29043,29046,0,3,5
8300,5,2,29048,29048,29050,0,2,2
8301,6,1,29054,29054,29055,0,1,4
8302,5,1,29059,29059,29060,0,1,4
8303,2,1,29061,29061,29062,0,1,1
8304,1,2,29062,29062,29064,0,2,0
8305,6,1,29068,29068,29069,0,1,4
8306,6,1,29074,29074,29075,0,1,5
8307,3,1,29077,29077,29078,0,1,2
8308,4,2,29081,29081,29083,0,2,3
8309,6,3,29087,29087,29090,0,3,4
8310,3,1,29090,29090,29091,0,1,0
8311,2,1,29092,29092,29093,0,1,1
8312,3,3,29095,29095,29098,0,3,2
8313,4,2,29099,29099,29101,0,2,1
8314,6,2,29105,29105,29107,0,2,4
8315,5,3,29110,29110,29113,0,3,3
8316,2,1,29112,29113,29114,1,2,0
8317,1,3,29113,29114,29117,1,4,0
8318,4,3,29117,29117,29120,0,3,0
8319,5,2,29122,29122,29124,0,2,2
8320,2,3,29124,29124,29127,0,3,0
8321,3,1,29127,29127,29128,0,1,0
8322,5,2,29132,29132,29134,0,2,4
8323,3,1,29135,29135,29136,0,1,1
8324,3,1,29138,29138,29139,0,1,2
8325,5,3,29143,29143,29146,0,3,4
8326,6,2,29149,29149,29151,0,2,3
8327,3,2,29152,29152,29154,0,2,1
8328,5,2,29157,29157,29159,0,2,3
8329,4,2,29161,29161,29163,0,2,2
8330,4,1,29165,29165,29166,0,1,2
8331,3,3,29168,29168,29171,0,3,2
8332,4,1,29172,29172,29173,0,1,1
8333,2,3,29174,29174,29177,0,3,1
8334,6,2,29180,29180,29182,0,2,3
8335,6,1,29186,29186,29187,0,1,4
8336,2,2,29188,29188,29190,0,2,1
8337,6,2,29194,29194,29196,0,2,4
8338,2,1,29196,29196,29197,0,1,0
8339,3,3,29199,29199,29202,0,3,2
8340,3,1,29202,29202,29203,0,1,0
8341,6,1,29208,29208,29209,0,1,5
8342,4,2,29212,29212,29214,0,2,3
8343,1,1,29213,29214,29215,1,2,0
8344,1,2,29214,29215,29217,1,3,0
8345,3,1,29217,29217,29218,0,1,0
8346,2,3,29219,29219,29222,0,3,1
8347,2,2,29221,29222,29224,1,3,0
8348,1,3,29222,29224,29227,2,5,0
8349,1,3,29223,29227,29230,4,7,0
8350,5,3,29228,29230,29233,2,5,0
8351,4,2,29232,29233,29235,1,3,0
8352,1,2,29233,29235,29237,2,4,0
8353,3,2,29236,29237,29239,1,3,0
8354,1,3,29237,29239,29242,2,5,0
8355,5,2,29242,29242,29244,0,2,0
8356,5,2,29247,29247,29249,0,2,3
8357,1,3,29248,29249,29252,1,4,0
8358,5,3,29253,29253,29256,0,3,1
8359,3,3,29256,29256,29259,0,3,0
8360,6,3,29262,29262,29265,0,3,3
8361,4,1,29266,29266,29267,0,1,1
8362,1,2,29267,29267,29269,0,2,0
8363,2,1,29269,29269,29270,0,1,0
8364,2,3,29271,29271,29274,0,3,1
8365,4,1,29275,29275,29276,0,1,1
8366,2,1,29277,29277,29278,0,1,1
8367,5,1,29282,29282,29283,0,1,4
8368,3,3,29285,29285,29288,0,3,2
8369,1,1,29286,29288,29289,2,3,0
8370,6,1,29292,29292,29293,0,1,3
8371,2,1,29294,29294,29295,0,1,1
8372,6,1,29300,29300,29301,0,1,5
8373,3,1,29303,29303,29304,0,1,2
8374,5,2,29308,29308,29310,0,2,4
8375,6,3,29314,29314,29317,0,3,4
8376,6,3,29320,29320,29323,0,3,3
8377,1,1,29321,29323,29324,2,3,0
8378,1,3,29322,29324,29327,2,5,0
8379,4,1,29326,29327,29328,1,2,0
8380,3,1,29329,29329,29330,0,1,1
8381,4,1,29333,29333,29334,0,1,3
8382,2,2,29335,29335,29337,0,2,1
8383,1,1,29336,29337,29338,1,2,0
8384,2,1,29338,29338,29339,0,1,0
8385,1,2,29339,29339,29341,0,2,0
8386,6,1,29345,29345,29346,0,1,4
8387,2,2,29347,29347,29349,0,2,1
8388,2,3,29349,29349,29352,0,3,0
8389,4,1,29353,29353,29354,0,1,1
8390,5,3,29358,29358,29361,0,3,4
8391,1,1,29359,29361,29362,2,3,0
8392,1,2,29360,29362,29364,2,4,0
8393,1,1,29361,29364,29365,3,4,0
8394,4,1,29365,29365,29366,0,1,0
8395,3,2,29368,29368,29370,0,2,2
8396,5,3,29373,29373,29376,0,3,3
8397,3,2,29376,29376,29378,0,2,0
8398,5,1,29381,29381,29382,0,1,3
8399,3,2,29384,29384,29386,0,2,2
8400,5,3,29389,29389,29392,0,3,3
8401,6,3,29395,29395,29398,0,3,3
8402,5,3,29400,29400,29403,0,3,2
8403,4,2,29404,29404,29406,0,2,1
8404,4,2,29408,29408,29410,0,2,2
8405,3,2,29411,29411,29413,0,2,1
8406,2,2,29413,29413,29415,0,2,0
8407,5,2,29418,29418,29420,0,2,3
8408,5,2,29423,29423,29425,0,2,3
8409,3,3,29426,29426,29429,0,3,1
8410,3,2,29429,29429,29431,0,2,0
8411,6,1,29435,29435,29436,0,1,4
8412,2,2,29437,29437,29439,0,2,1
8413,2,3,29439,29439,29442,0,3,0
8414,3,1,29442,29442,29443,0,1,0
8415,2,3,29444,29444,29447,0,3,1
8416,5,2,29449,29449,29451,0,2,2
8417,6,1,29455,29455,29456,0,1,4
8418,1,2,29456,29456,29458,0,2,0
8419,2,2,29458,29458,29460,0,2,0
8420,6,3,29464,29464,29467,0,3,4
8421,2,3,29466,29467,29470,1,4,0
8422,2,3,29468,29470,29473,2,5,0
8423,4,1,29472,29473,29474,1,2,0
8424,6,2,29478,29478,29480,0,2,4
8425,5,3,29483,29483,29486,0,3,3
8426,3,2,29486,29486,29488,0,2,0
8427,4,2,29490,29490,29492,0,2,2
8428,6,3,29496,29496,29499,0,3,4
8429,4,3,29500,29500,29503,0,3,1
8430,1,3,29501,29503,29506,2,5,0
8431,4,2,29505,29506,29508,1,3,0
8432,4,2,29509,29509,29511,0,2,1
8433,3,1,29512,29512,29513,0,1,1
8434,3,2,29515,29515,29517,0,2,2
8435,5,3,29520,29520,29523,0,3,3
8436,1,2,29521,29523,29525,2,4,0
8437,5,2,29526,29526,29528,0,2,1
8438,4,2,29530,29530,29532,0,2,2
8439,1,1,29531,29532,29533,1,2,0
8440,3,2,29534,29534,29536,0,2,1
8441,6,2,29540,29540,29542,0,2,4
8442,2,1,29542,29542,29543,0,1,0
8443,1,1,29543,29543,29544,0,1,0
8444,1,1,29544,29544,29545,0,1,0
8445,1,1,29545,29545,29546,0,1,0
8446,4,3,29549,29549,29552,0,3,3
8447,5,3,29554,29554,29557,0,3,2
8448,6,2,29560,29560,29562,0,2,3
8449,1,3,29561,29562,29565,1,4,0
8450,5,1,29566,29566,29567,0,1,1
8451,6,2,29572,29572,29574,0,2,5
8452,6,2,29578,29578,29580,0,2,4
8453,5,1,29583,29583,29584,0,1,3
8454,5,2,29588,29588,29590,0,2,4
8455,6,2,29594,29594,29596,0,2,4
8456,1,2,29595,29596,29598,1,3,0
8457,4,1,29599,29599,29600,0,1,1
8458,2,1,29601,29601,29602,0,1,1
8459,5,1,29606,29606,29607,0,1,4
8460,3,1,29609,29609,29610,0,1,2
8461,2,3,29611,29611,29614,0,3,1
8462,2,1,29613,29614,29615,1,2,0
8463,6,1,29619,29619,29620,0,1,4
8464,5,2,29624,29624,29626,0,2,4
8465,6,1,29630,29630,29631,0,1,4
8466,3,1,29633,29633,29634,0,1,2
8467,2,1,29635,29635,29636,0,1,1
8468,2,2,29637,29637,29639,0,2,1
8469,5,2,29642,29642,29644,0,2,3
8470,4,3,29646,29646,29649,0,3,2
8471,3,3,29649,29649,29652,0,3,0
8472,4,1,29653,29653,29654,0,1,1
8473,6,3,29659,29659,29662,0,3,5
8474,6,2,29665,29665,29667,0,2,3
8475,6,2,29671,29671,29673,0,2,4
8476,3,1,29674,29674,29675,0,1,1
8477,2,1,29676,29676,29677,0,1,1
8478,6,3,29682,29682,29685,0,3,5
8479,2,1,29684,29685,29686,1,2,0
8480,6,1,29690,29690,29691,0,1,4
8481,1,1,29691,29691,29692,0,1,0
8482,5,1,29696,29696,29697,0,1,4
8483,1,3,29697,29697,29700,0,3,0
8484,6,1,29703,29703,29704,0,1,3
8485,4,1,29707,29707,29708,0,1,3
8486,1,3,29708,29708,29711,0,3,0
8487,4,1,29712,29712,29713,0,1,1
8488,1,2,29713,29713,29715,0,2,0
8489,2,3,29715,29715,29718,0,3,0
8490,1,2,29716,29718,29720,2,4,0
8491,2,2,29718,29720,29722,2,4,0
8492,2,1,29720,29722,29723,2,3,0
8493,5,1,29725,29725,29726,0,1,2
8494,3,2,29728,29728,29730,0,2,2
8495,2,1,29730,29730,29731,0,1,0
8496,5,2,29735,29735,29737,0,2,4
8497,2,3,29737,29737,29740,0,3,0
8498,1,1,29738,29740,29741,2,3,0
8499,2,2,29740,29741,29743,1,3,0
8500,2,2,29742,29743,29745,1,3,0
8501,1,1,29743,29745,29746,2,3,0
8502,3,2,29746,29746,29748,0,2,0
8503,4,3,29750,29750,29753,0,3,2
8504,6,2,29756,29756,29758,0,2,3
8505,3,3,29759,29759,29762,0,3,1
8506,5,2,29764,29764,29766,0,2,2
8507,1,1,29765,29766,29767,1,2,0
8508,1,2,29766,29767,29769,1,3,0
8509,4,3,29770,29770,29773,0,3,1
8510,1,1,29771,29773,29774,2,3,0
8511,6,1,29777,29777,29778,0,1,3
8512,4,3,29781,29781,29784,0,3,3
8513,5,2,29786,29786,29788,0,2,2
8514,2,1,29788,29788,29789,0,1,0
8515,4,2,29792,29792,29794,0,2,3
8516,4,1,29796,29796,29797,0,1,2
8517,3,3,29799,29799,29802,0,3,2
8518,2,3,29801,29802,29805,1,4,0
8519,6,3,29807,29807,29810,0,3,2
8520,6,3,29813,29813,29816,0,3,3
8521,5,1,29818,29818,29819,0,1,2
8522,2,1,29820,29820,29821,0,1,1
8523,1,3,29821,29821,29824,0,3,0
8524,3,1,29824,29824,29825,0,1,0
8525,6,2,29830,29830,29832,0,2,5
8526,3,2,29833,29833,29835,0,2,1
8527,4,1,29837,29837,29838,0,1,2
8528,2,1,29839,29839,29840,0,1,1
8529,5,1,29844,29844,29845,0,1,4
8530,3,3,29847,29847,29850,0,3,2
8531,6,1,29853,29853,29854,0,1,3
8532,2,1,29855,29855,29856,0,1,1
8533,1,2,29856,29856,29858,0,2,0
8534,4,2,29860,29860,29862,0,2,2
8535,3,3,29863,29863,29866,0,3,1
8536,5,3,29868,29868,29871,0,3,2
8537,2,3,29870,29871,29874,1,4,0
8538,4,1,29874,29874,29875,0,1,0
8539,2,2,29876,29876,29878,0,2,1
8540,5,2,29881,29881,29883,0,2,3
8541,2,1,29883,29883,29884,0,1,0
8542,6,1,29889,29889,29890,0,1,5
8543,5,1,29894,29894,29895,0,1,4
8544,5,2,29899,29899,29901,0,2,4
8545,4,1,29903,29903,29904,0,1,2
8546,6,3,29909,29909,29912,0,3,5
8547,6,1,29915,29915,29916,0,1,3
8548,6,2,29921,29921,29923,0,2,5
8549,5,3,29926,29926,29929,0,3,3
8550,3,2,29929,29929,29931,0,2,0
8551,3,1,29932,29932,29933,0,1,1
8552,5,1,29937,29937,29938,0,1,4
8553,2,1,29939,29939,29940,0,1,1
8554,2,2,29941,29941,29943,0,2,1
8555,5,3,29946,29946,29949,0,3,3
8556,6,2,29952,29952,29954,0,2,3
8557,4,3,29956,29956,29959,0,3,2
8558,6,1,29962,29962,29963,0,1,3
8559,5,2,29967,29967,29969,0,2,4
8560,2,3,29969,29969,29972,0,3,0
8561,5,1,29974,29974,29975,0,1,2
8562,3,3,29977,29977,29980,0,3,2
8563,1,1,29978,29980,29981,2,3,0
8564,5,1,29983,29983,29984,0,1,2
8565,6,2,29989,29989,29991,0,2,5
8566,5,1,29994,29994,29995,0,1,3
8567,3,1,29997,29997,29998,0,1,2
8568,4,1,30001,30001,30002,0,1,3
8569,2,1,30003,30003,30004,0,1,1
8570,6,3,30009,30009,30012,0,3,5
8571,6,2,30015,30015,30017,0,2,3
8572,6,1,30021,30021,30022,0,1,4
8573,1,2,30022,30022,30024,0,2,0
8574,6,2,30028,30028,30030,0,2,4
8575,6,2,30034,30034,30036,0,2,4
8576,5,2,30039,30039,30041,0,2,3
8577,6,2,30045,30045,30047,0,2,4
8578,6,3,30051,30051,30054,0,3,4
8579,3,1,30054,30054,30055,0,1,0
8580,6,2,30060,30060,30062,0,2,5
8581,1,3,30061,30062,30065,1,4,0
8582,3,3,30064,30065,30068,1,4,0
8583,2,3,30066,30068,30071,2,5,0
8584,4,2,30070,30071,30073,1,3,0
8585,4,3,30074,30074,30077,0,3,1
8586,4,3,30078,30078,30081,0,3,1
8587,5,1,30083,30083,30084,0,1,2
8588,6,1,30089,30089,30090,0,1,5
8589,5,2,30094,30094,30096,0,2,4
8590,6,1,30100,30100,30101,0,1,4
8591,3,2,30103,30103,30105,0,2,2
8592,5,2,30108,30108,30110,0,2,3
8593,5,2,30113,30113,30115,0,2,3
8594,5,3,30118,30118,30121,0,3,3
8595,2,2,30120,30121,30123,1,3,0
8596,2,3,30122,30123,30126,1,4,0
8597,3,2,30125,30126,30128,1,3,0
8598,4,2,30129,30129,30131,0,2,1
8599,5,2,30134,30134,30136,0,2,3
8600,1,1,30135,30136,30137,1,2,0
8601,1,3,30136,30137,30140,1,4,0
8602,2,2,30138,30140,30142,2,4,0
8603,1,3,30139,30142,30145,3,6,0
8604,2,3,30141,30145,30148,4,7,0
8605,6,3,30147,30148,30151,1,4,0
8606,5,3,30152,30152,30155,0,3,1
8607,2,2,30154,30155,30157,1,3,0
8608,6,3,30160,30160,30163,0,3,3
8609,2,3,30162,30163,30166,1,4,0
8610,1,1,30163,30166,30167,3,4,0
8611,1,3,30164,30167,30170,3,6,0
8612,4,1,30168,30170,30171,2,3,0
8613,2,3,30170,30171,30174,1,4,0
8614,5,2,30175,30175,30177,0,2,1
8615,1,3,30176,30177,30180,1,4,0
8616,5,3,30181,30181,30184,0,3,1
8617,2,1,30183,30184,30185,1,2,0
8618,6,2,30189,30189,30191,0,2,4
8619,6,1,30195,30195,30196,0,1,4
8620,4,1,30199,30199,30200,0,1,3
8621,3,3,30202,30202,30205,0,3,2
8622,4,3,30206,30206,30209,0,3,1
8623,3,1,30209,30209,30210,0,1,0
8624,6,3,30215,30215,30218,0,3,5
8625,1,3,30216,30218,30221,2,5,0
8626,6,3,30222,30222,30225,0,3,1
8627,4,2,30226,30226,30228,0,2,1
8628,1,2,30227,30228,30230,1,3,0
8629,4,2,30231,30231,30233,0,2,1
8630,5,2,30236,30236,30238,0,2,3
8631,5,1,30241,30241,30242,0,1,3
8632,1,2,30242,30242,30244,0,2,0
8633,3,3,30245,30245,30248,0,3,1
8634,3,3,30248,30248,30251,0,3,0
8635,1,3,30249,30251,30254,2,5,0
8636,1,2,30250,30254,30256,4,6,0
8637,2,2,30252,30256,30258,4,6,0
8638,4,2,30256,30258,30260,2,4,0
8639,1,3,30257,30260,30263,3,6,0
8640,5,1,30262,30263,30264,1,2,0
8641,6,3,30268,30268,30271,0,3,4
8642,2,1,30270,30271,30272,1,2,0
8643,6,3,30276,30276,30279,0,3,4
8644,3,3,30279,30279,30282,0,3,0
8645,5,2,30284,30284,30286,0,2,2
8646,3,1,30287,30287,30288,0,1,1
8647,5,2,30292,30292,30294,0,2,4
8648,4,2,30296,30296,30298,0,2,2
8649,1,3,30297,30298,30301,1,4,0
8650,2,3,30299,30301,30304,2,5,0
8651,4,1,30303,30304,30305,1,2,0
8652,6,3,30309,30309,30312,0,3,4
8653,5,2,30314,30314,30316,0,2,2
8654,1,1,30315,30316,30317,1,2,0
8655,5,1,30320,30320,30321,0,1,3
8656,5,1,30325,30325,30326,0,1,4
8657,3,2,30328,30328,30330,0,2,2
8658,2,2,30330,30330,30332,0,2,0
8659,5,1,30335,30335,30336,0,1,3
8660,1,2,30336,30336,30338,0,2,0
8661,6,1,30342,30342,30343,0,1,4
8662,1,1,30343,30343,30344,0,1,0
8663,2,2,30345,30345,30347,0,2,1
8664,4,2,30349,30349,30351,0,2,2
8665,2,2,30351,30351,30353,0,2,0
8666,6,3,30357,30357,30360,0,3,4
8667,2,3,30359,30360,30363,1,4,0
8668,3,3,30362,30363,30366,1,4,0
8669,3,1,30365,30366,30367,1,2,0
8670,6,3,30371,30371,30374,0,3,4
8671,2,3,30373,30374,30377,1,4,0
8672,3,2,30376,30377,30379,1,3,0
8673,5,2,30381,30381,30383,0,2,2
8674,4,1,30385,30385,30386,0,1,2
8675,2,3,30387,30387,30390,0,3,1
8676,1,2,30388,30390,30392,2,4,0
8677,6,1,30394,30394,30395,0,1,2
8678,3,3,30397,30397,30400,0,3,2
8679,4,2,30401,30401,30403,0,2,1
8680,6,1,30407,30407,30408,0,1,4
8681,2,2,30409,30409,30411,0,2,1
8682,6,2,30415,30415,30417,0,2,4
8683,4,2,30419,30419,30421,0,2,2
8684,6,1,30425,30425,30426,0,1,4
8685,2,1,30427,30427,30428,0,1,1
8686,2,1,30429,30429,30430,0,1,1
8687,6,1,30435,30435,30436,0,1,5
8688,2,2,30437,30437,30439,0,2,1
8689,5,2,30442,30442,30444,0,2,3
8690,1,3,30443,30444,30447,1,4,0
8691,5,1,30448,30448,30449,0,1,1
8692,5,3,30453,30453,30456,0,3,4
8693,3,3,30456,30456,30459,0,3,0
8694,3,3,30459,30459,30462,0,3,0
8695,1,2,30460,30462,30464,2,4,0
8696,5,3,30465,30465,30468,0,3,1
8697,6,2,30471,30471,30473,0,2,3
8698,5,2,30476,30476,30478,0,2,3
8699,5,3,30481,30481,30484,0,3,3
8700,6,1,30487,30487,30488,0,1,3
8701,6,1,30493,30493,30494,0,1,5
8702,5,3,30498,30498,30501,0,3,4
8703,1,2,30499,30501,30503,2,4,0
8704,4,1,30503,30503,30504,0,1,0
8705,3,1,30506,30506,30507,0,1,2
8706,6,3,30512,30512,30515,0,3,5
8707,1,3,30513,30515,30518,2,5,0
8708,2,1,30515,30518,30519,3,4,0
8709,5,3,30520,30520,30523,0,3,1
8710,4,2,30524,30524,30526,0,2,1
8711,6,2,30530,30530,30532,0,2,4
8712,3,1,30533,30533,30534,0,1,1
8713,3,1,30536,30536,30537,0,1,2
8714,3,1,30539,30539,30540,0,1,2
8715,3,1,30542,30542,30543,0,1,2
8716,2,2,30544,30544,30546,0,2,1
8717,4,2,30548,30548,30550,0,2,2
8718,5,2,30553,30553,30555,0,2,3
8719,5,3,30558,30558,30561,0,3,3
8720,4,3,30562,30562,30565,0,3,1
8721,6,2,30568,30568,30570,0,2,3
8722,5,2,30573,30573,30575,0,2,3
8723,6,1,30579,30579,30580,0,1,4
8724,3,2,30582,30582,30584,0,2,2
8725,4,1,30586,30586,30587,0,1,2
8726,6,2,30592,30592,30594,0,2,5
8727,2,3,30594,30594,30597,0,3,0
8728,4,3,30598,30598,30601,0,3,1
8729,5,1,30603,30603,30604,0,1,2
8730,2,1,30605,30605,30606,0,1,1
8731,1,3,30606,30606,30609,0,3,0
8732,5,3,30611,30611,30614,0,3,2
8733,2,3,30613,30614,30617,1,4,0
8734,1,2,30614,30617,30619,3,5,0
8735,5,1,30619,30619,30620,0,1,0
8736,4,2,30623,30623,30625,0,2,3
8737,6,1,30629,30629,30630,0,1,4
8738,2,2,30631,30631,30633,0,2,1
8739,6,2,30637,30637,30639,0,2,4
8740,2,2,30639,30639,30641,0,2,0
8741,3,3,30642,30642,30645,0,3,1
8742,6,3,30648,30648,30651,0,3,3
8743,6,3,30654,30654,30657,0,3,3
8744,5,1,30659,30659,30660,0,1,2
8745,2,1,30661,30661,30662,0,1,1
8746,3,3,30664,30664,30667,0,3,2
8747,2,1,30666,30667,30668,1,2,0
8748,2,3,30668,30668,30671,0,3,0
8749,2,3,30670,30671,30674,1,4,0
8750,5,3,30675,30675,30678,0,3,1
8751,5,2,30680,30680,30682,0,2,2
8752,2,3,30682,30682,30685,0,3,0
8753,2,1,30684,30685,30686,1,2,0
8754,5,2,30689,30689,30691,0,2,3
8755,6,3,30695,30695,30698,0,3,4
8756,1,1,30696,30698,30699,2,3,0
8757,6,1,30702,30702,30703,0,1,3
8758,4,3,30706,30706,30709,0,3,3
8759,1,1,30707,30709,30710,2,3,0
8760,4,1,30711,30711,30712,0,1,1
8761,4,2,30715,30715,30717,0,2,3
8762,2,3,30717,30717,30720,0,3,0
8763,6,3,30723,30723,30726,0,3,3
8764,6,2,30729,30729,30731,0,2,3
8765,1,3,30730,30731,30734,1,4,0
8766,6,1,30736,30736,30737,0,1,2
8767,1,3,30737,30737,30740,0,3,0
8768,3,1,30740,30740,30741,0,1,0
8769,4,3,30744,30744,30747,0,3,3
8770,2,3,30746,30747,30750,1,4,0
8771,3,3,30749,30750,30753,1,4,0
8772,3,1,30752,30753,30754,1,2,0
8773,5,3,30757,30757,30760,0,3,3
8774,4,3,30761,30761,30764,0,3,1
8775,1,3,30762,30764,30767,2,5,0
8776,2,2,30764,30767,30769,3,5,0
8777,4,2,30768,30769,30771,1,3,0
8778,5,3,30773,30773,30776,0,3,2
8779,2,1,30775,30776,30777,1,2,0
8780,5,2,30780,30780,30782,0,2,3
8781,2,2,30782,30782,30784,0,2,0
8782,2,1,30784,30784,30785,0,1,0
8783,5,1,30789,30789,30790,0,1,4
8784,1,3,30790,30790,30793,0,3,0
8785,1,2,30791,30793,30795,2,4,0
8786,2,3,30793,30795,30798,2,5,0
8787,6,2,30799,30799,30801,0,2,1
8788,1,1,30800,30801,30802,1,2,0
8789,6,3,30806,30806,30809,0,3,4
8790,2,2,30808,30809,30811,1,3,0
8791,1,1,30809,30811,30812,2,3,0
8792,5,1,30814,30814,30815,0,1,2
8793,1,1,30815,30815,30816,0,1,0
8794,6,2,30821,30821,30823,0,2,5
8795,6,2,30827,30827,30829,0,2,4
8796,4,3,30831,30831,30834,0,3,2
8797,1,1,30832,30834,30835,2,3,0
8798,3,1,30835,30835,30836,0,1,0
8799,2,1,30837,30837,30838,0,1,1
8800,3,2,30840,30840,30842,0,2,2
8801,2,1,30842,30842,30843,0,1,0
8802,5,2,30847,30847,30849,0,2,4
8803,1,1,30848,30849,30850,1,2,0
8804,6,2,30854,30854,30856,0,2,4
8805,1,2,30855,30856,30858,1,3,0
8806,3,2,30858,30858,30860,0,2,0
8807,1,1,30859,30860,30861,1,2,0
8808,4,3,30863,30863,30866,0,3,2
8809,3,1,30866,30866,30867,0,1,0
8810,5,1,30871,30871,30872,0,1,4
8811,1,3,30872,30872,30875,0,3,0
8812,5,1,30877,30877,30878,0,1,2
8813,5,2,30882,30882,30884,0,2,4
8814,3,2,30885,30885,30887,0,2,1
8815,5,2,30890,30890,30892,0,2,3
8816,2,1,30892,30892,30893,0,1,0
8817,6,3,30898,30898,30901,0,3,5
8818,1,1,30899,30901,30902,2,3,0
8819,6,2,30905,30905,30907,0,2,3
8820,4,3,30909,30909,30912,0,3,2
8821,3,1,30912,30912,30913,0,1,0
8822,3,3,30915,30915,30918,0,3,2
8823,4,1,30919,30919,30920,0,1,1
8824,5,1,30924,30924,30925,0,1,4
8825,3,2,30927,30927,30929,0,2,2
8826,5,3,30932,30932,30935,0,3,3
8827,6,2,30938,30938,30940,0,2,3
8828,5,1,30943,30943,30944,0,1,3
8829,4,3,30947,30947,30950,0,3,3
8830,6,2,30953,30953,30955,0,2,3
8831,1,3,30954,30955,30958,1,4,0
8832,4,3,30958,30958,30961,0,3,0
8833,5,2,30963,30963,30965,0,2,2
8834,2,2,30965,30965,30967,0,2,0
8835,6,1,30971,30971,30972,0,1,4
8836,2,2,30973,30973,30975,0,2,1
8837,6,2,30979,30979,30981,0,2,4
8838,1,1,30980,30981,30982,1,2,0
8839,5,1,30985,30985,30986,0,1,3
8840,6,1,30991,30991,30992,0,1,5
8841,3,3,30994,30994,30997,0,3,2
8842,6,3,31000,31000,31003,0,3,3
8843,1,3,31001,31003,31006,2,5,0
8844,5,1,31006,31006,31007,0,1,0
8845,3,1,31009,31009,31010,0,1,2
8846,6,1,31015,31015,31016,0,1,5
8847,6,3,31021,31021,31024,0,3,5
8848,1,2,31022,31024,31026,2,4,0
8849,4,2,31026,31026,31028,0,2,0
8850,1,2,31027,31028,31030,1,3,0
8851,4,1,31031,31031,31032,0,1,1
8852,1,3,31032,31032,31035,0,3,0
8853,2,1,31034,31035,31036,1,2,0
8854,5,2,31039,31039,31041,0,2,3
8855,1,2,31040,31041,31043,1,3,0
8856,4,2,31044,31044,31046,0,2,1
8857,5,3,31049,31049,31052,0,3,3
8858,5,1,31054,31054,31055,0,1,2
8859,4,3,31058,31058,31061,0,3,3
8860,3,2,31061,31061,31063,0,2,0
8861,3,1,31064,31064,31065,0,1,1
8862,5,2,31069,31069,31071,0,2,4
8863,2,1,31071,31071,31072,0,1,0
8864,1,3,31072,31072,31075,0,3,0
8865,1,3,31073,31075,31078,2,5,0
8866,4,2,31077,31078,31080,1,3,0
8867,1,1,31078,31080,31081,2,3,0
8868,4,3,31082,31082,31085,0,3,1
8869,1,1,31083,31085,31086,2,3,0
8870,4,2,31087,31087,31089,0,2,1
8871,6,1,31093,31093,31094,0,1,4
8872,2,1,31095,31095,31096,0,1,1
8873,2,2,31097,31097,31099,0,2,1
8874,5,2,31102,31102,31104,0,2,3
8875,4,3,31106,31106,31109,0,3,2
8876,3,1,31109,31109,31110,0,1,0
8877,1,2,31110,31110,31112,0,2,0
8878,3,3,31113,31113,31116,0,3,1
8879,6,1,31119,31119,31120,0,1,3
8880,5,1,31124,31124,31125,0,1,4
8881,1,2,31125,31125,31127,0,2,0
8882,2,1,31127,31127,31128,0,1,0
8883,1,2,31128,31128,31130,0,2,0
8884,3,3,31131,31131,31134,0,3,1
8885,1,2,31132,31134,31136,2,4,0
8886,2,1,31134,31136,31137,2,3,0
8887,2,3,31136,31137,31140,1,4,0
8888,6,3,31142,31142,31145,0,3,2
8889,6,1,31148,31148,31149,0,1,3
8890,1,2,31149,31149,31151,0,2,0
8891,1,3,31150,31151,31154,1,4,0
8892,6,2,31156,31156,31158,0,2,2
8893,2,3,31158,31158,31161,0,3,0
8894,2,1,31160,31161,31162,1,2,0
8895,2,3,31162,31162,31165,0,3,0
8896,6,1,31168,31168,31169,0,1,3
8897,1,3,31169,31169,31172,0,3,0
8898,1,3,31170,31172,31175,2,5,0
8899,2,2,31172,31175,31177,3,5,0
8900,2,2,31174,31177,31179,3,5,0
8901,3,2,31177,31179,31181,2,4,0
8902,6,2,31183,31183,31185,0,2,2
8903,5,1,31188,31188,31189,0,1,3
8904,4,3,31192,31192,31195,0,3,3
8905,3,3,31195,31195,31198,0,3,0
8906,1,3,31196,31198,31201,2,5,0
8907,4,3,31200,31201,31204,1,4,0
8908,6,1,31206,31206,31207,0,1,2
8909,5,1,31211,31211,31212,0,1,4
8910,4,1,31215,31215,31216,0,1,3
8911,4,3,31219,31219,31222,0,3,3
8912,5,1,31224,31224,31225,0,1,2
8913,5,2,31229,31229,31231,0,2,4
8914,6,1,31235,31235,31236,0,1,4
8915,3,3,31238,31238,31241,0,3,2
8916,1,2,31239,31241,31243,2,4,0
8917,2,1,31241,31243,31244,2,3,0
8918,6,2,31247,31247,31249,0,2,3
8919,5,3,31252,31252,31255,0,3,3
8920,3,1,31255,31255,31256,0,1,0
8921,1,3,31256,31256,31259,0,3,0
8922,5,3,31261,31261,31264,0,3,2
8923,1,3,31262,31264,31267,2,5,0
8924,1,1,31263,31267,31268,4,5,0
8925,5,1,31268,31268,31269,0,1,0
8926,2,1,31270,31270,31271,0,1,1
8927,1,2,31271,31271,31273,0,2,0
8928,1,3,31272,31273,31276,1,4,0
8929,4,1,31276,31276,31277,0,1,0
8930,5,2,31281,31281,31283,0,2,4
8931,4,1,31285,31285,31286,0,1,2
8932,1,2,31286,31286,31288,0,2,0
8933,3,1,31289,31289,31290,0,1,1
8934,6,3,31295,31295,31298,0,3,5
8935,1,2,31296,31298,31300,2,4,0
8936,4,3,31300,31300,31303,0,3,0
8937,4,2,31304,31304,31306,0,2,1
8938,4,2,31308,31308,31310,0,2,2
8939,6,3,31314,31314,31317,0,3,4
8940,2,2,31316,31317,31319,1,3,0
8941,5,2,31321,31321,31323,0,2,2
8942,3,1,31324,31324,31325,0,1,1
8943,6,3,31330,31330,31333,0,3,5
8944,6,2,31336,31336,31338,0,2,3
8945,4,2,31340,31340,31342,0,2,2
8946,1,3,31341,31342,31345,1,4,0
8947,4,1,31345,31345,31346,0,1,0
8948,6,1,31351,31351,31352,0,1,5
8949,1,1,31352,31352,31353,0,1,0
8950,6,3,31358,31358,31361,0,3,5
8951,5,2,31363,31363,31365,0,2,2
8952,1,3,31364,31365,31368,1,4,0
8953,5,3,31369,31369,31372,0,3,1
8954,5,1,31374,31374,31375,0,1,2
8955,1,2,31375,31375,31377,0,2,0
8956,4,2,31379,31379,31381,0,2,2
8957,5,1,31384,31384,31385,0,1,3
8958,1,3,31385,31385,31388,0,3,0
8959,6,1,31391,31391,31392,0,1,3
8960,4,2,31395,31395,31397,0,2,3
8961,4,1,31399,31399,31400,0,1,2
8962,4,3,31403,31403,31406,0,3,3
8963,4,3,31407,31407,31410,0,3,1
8964,2,1,31409,31410,31411,1,2,0
8965,6,3,31415,31415,31418,0,3,4
8966,6,3,31421,31421,31424,0,3,3
8967,4,3,31425,31425,31428,0,3,1
8968,1,2,31426,31428,31430,2,4,0
8969,6,1,31432,31432,31433,0,1,2
8970,1,2,31433,31433,31435,0,2,0
8971,6,3,31439,31439,31442,0,3,4
8972,3,3,31442,31442,31445,0,3,0
8973,4,1,31446,31446,31447,0,1,1
8974,2,2,31448,31448,31450,0,2,1
8975,4,3,31452,31452,31455,0,3,2
8976,1,3,31453,31455,31458,2,5,0
8977,2,1,31455,31458,31459,3,4,0
8978,4,2,31459,31459,31461,0,2,0
8979,4,3,31463,31463,31466,0,3,2
8980,4,1,31467,31467,31468,0,1,1
8981,6,1,31473,31473,31474,0,1,5
8982,3,3,31476,31476,31479,0,3,2
8983,1,3,31477,31479,31482,2,5,0
8984,6,2,31483,31483,31485,0,2,1
8985,6,2,31489,31489,31491,0,2,4
8986,4,3,31493,31493,31496,0,3,2
8987,6,2,31499,31499,31501,0,2,3
8988,1,2,31500,31501,31503,1,3,0
8989,2,3,31502,31503,31506,1,4,0
8990,5,3,31507,31507,31510,0,3,1
8991,4,2,31511,31511,31513,0,2,1
8992,1,1,31512,31513,31514,1,2,0
8993,6,3,31518,31518,31521,0,3,4
8994,6,3,31524,31524,31527,0,3,3
8995,1,1,31525,31527,31528,2,3,0
8996,2,2,31527,31528,31530,1,3,0
8997,4,2,31531,31531,31533,0,2,1
8998,5,3,31536,31536,31539,0,3,3
8999,6,2,31542,31542,31544,0,2,3
9000,5,2,31547,31547,31549,0,2,3
9001,6,1,31553,31553,31554,0,1,4
9002,2,2,31555,31555,31557,0,2,1
9003,4,1,31559,31559,31560,0,1,2
9004,6,2,31565,31565,31567,0,2,5
9005,6,1,31571,31571,31572,0,1,4
9006,5,2,31576,31576,31578,0,2,4
9007,2,3,31578,31578,31581,0,3,0
9008,4,3,31582,31582,31585,0,3,1
9009,3,1,31585,31585,31586,0,1,0
9010,6,3,31591,31591,31594,0,3,5
9011,4,3,31595,31595,31598,0,3,1
9012,3,2,31598,31598,31600,0,2,0
9013,4,2,31602,31602,31604,0,2,2
9014,4,1,31606,31606,31607,0,1,2
9015,6,2,31612,31612,31614,0,2,5
9016,5,2,31617,31617,31619,0,2,3
9017,1,2,31618,31619,31621,1,3,0
9018,4,1,31622,31622,31623,0,1,1
9019,1,2,31623,31623,31625,0,2,0
9020,2,3,31625,31625,31628,0,3,0
9021,2,3,31627,31628,31631,1,4,0
9022,1,3,31628,31631,31634,3,6,0
9023,6,2,31634,31634,31636,0,2,0
9024,4,3,31638,31638,31641,0,3,2
9025,1,1,31639,31641,31642,2,3,0
9026,5,1,31644,31644,31645,0,1,2
9027,2,1,31646,31646,31647,0,1,1
9028,4,3,31650,31650,31653,0,3,3
9029,1,1,31651,31653,31654,2,3,0
9030,2,2,31653,31654,31656,1,3,0
9031,2,3,31655,31656,31659,1,4,0
9032,4,2,31659,31659,31661,0,2,0
9033,3,2,31662,31662,31664,0,2,1
9034,2,1,31664,31664,31665,0,1,0
9035,4,1,31668,31668,31669,0,1,3
9036,2,2,31670,31670,31672,0,2,1
9037,3,3,31673,31673,31676,0,3,1
9038,1,3,31674,31676,31679,2,5,0
9039,2,1,31676,31679,31680,3,4,0
9040,4,2,31680,31680,31682,0,2,0
9041,2,3,31682,31682,31685,0,3,0
9042,1,2,31683,31685,31687,2,4,0
9043,3,3,31686,31687,31690,1,4,0
9044,6,3,31692,31692,31695,0,3,2
9045,5,2,31697,31697,31699,0,2,2
9046,6,2,31703,31703,31705,0,2,4
9047,4,3,31707,31707,31710,0,3,2
9048,5,1,31712,31712,31713,0,1,2
9049,1,3,31713,31713,31716,0,3,0
9050,3,1,31716,31716,31717,0,1,0
9051,4,3,31720,31720,31723,0,3,3
9052,2,3,31722,31723,31726,1,4,0
9053,5,2,31727,31727,31729,0,2,1
9054,6,1,31733,31733,31734,0,1,4
9055,5,2,31738,31738,31740,0,2,4
9056,3,3,31741,31741,31744,0,3,1
9057,2,3,31743,31744,31747,1,4,0
9058,6,2,31749,31749,31751,0,2,2
9059,5,3,31754,31754,31757,0,3,3
9060,2,1,31756,31757,31758,1,2,0
9061,1,1,31757,31758,31759,1,2,0
9062,3,3,31760,31760,31763,0,3,1
9063,3,2,31763,31763,31765,0,2,0
9064,2,2,31765,31765,31767,0,2,0
9065,1,1,31766,31767,31768,1,2,0
9066,1,1,31767,31768,31769,1,2,0
9067,3,1,31770,31770,31771,0,1,1
9068,5,1,31775,31775,31776,0,1,4
9069,4,3,31779,31779,31782,0,3,3
9070,2,1,31781,31782,31783,1,2,0
9071,5,2,31786,31786,31788,0,2,3
9072,5,1,31791,31791,31792,0,1,3
9073,6,1,31797,31797,31798,0,1,5
9074,4,2,31801,31801,31803,0,2,3
9075,4,1,31805,31805,31806,0,1,2
9076,3,1,31808,31808,31809,0,1,2
9077,6,3,31814,31814,31817,0,3,5
9078,1,3,31815,31817,31820,2,5,0
9079,3,3,31818,31820,31823,2,5,0
9080,3,1,31821,31823,31824,2,3,0
9081,1,3,31822,31824,31827,2,5,0
9082,4,3,31826,31827,31830,1,4,0
9083,6,3,31832,31832,31835,0,3,2
9084,6,1,31838,31838,31839,0,1,3
9085,4,1,31842,31842,31843,0,1,3
9086,3,3,31845,31845,31848,0,3,2
9087,4,2,31849,31849,31851,0,2,1
9088,6,2,31855,31855,31857,0,2,4
9089,4,3,31859,31859,31862,0,3,2
9090,1,1,31860,31862,31863,2,3,0
9091,5,3,31865,31865,31868,0,3,2
9092,5,3,31870,31870,31873,0,3,2
9093,2,1,31872,31873,31874,1,2,0
9094,2,2,31874,31874,31876,0,2,0
9095,4,2,31878,31878,31880,0,2,2
9096,5,3,31883,31883,31886,0,3,3
9097,1,2,31884,31886,31888,2,4,0
9098,3,2,31887,31888,31890,1,3,0
9099,5,1,31892,31892,31893,0,1,2
9100,4,2,31896,31896,31898,0,2,3
9101,6,2,31902,31902,31904,0,2,4
9102,5,1,31907,31907,31908,0,1,3
9103,5,3,31912,31912,31915,0,3,4
9104,3,3,31915,31915,31918,0,3,0
9105,2,3,31917,31918,31921,1,4,0
9106,1,1,31918,31921,31922,3,4,0
9107,5,2,31923,31923,31925,0,2,1
9108,4,1,31927,31927,31928,0,1,2
9109,6,3,31933,31933,31936,0,3,5
9110,6,1,31939,31939,31940,0,1,3
9111,5,3,31944,31944,31947,0,3,4
9112,4,3,31948,31948,31951,0,3,1
9113,4,1,31952,31952,31953,0,1,1
9114,1,1,31953,31953,31954,0,1,0
9115,5,1,31958,31958,31959,0,1,4
9116,5,3,31963,31963,31966,0,3,4
9117,2,2,31965,31966,31968,1,3,0
9118,6,2,31971,31971,31973,0,2,3
9119,6,2,31977,31977,31979,0,2,4
9120,1,1,31978,31979,31980,1,2,0
9121,1,1,31979,31980,31981,1,2,0
9122,4,2,31983,31983,31985,0,2,2
9123,4,3,31987,31987,31990,0,3,2
9124,4,3,31991,31991,31994,0,3,1
9125,6,1,31997,31997,31998,0,1,3
9126,2,3,31999,31999,32002,0,3,1
9127,3,3,32002,32002,32005,0,3,0
9128,2,2,32004,32005,32007,1,3,0
9129,6,1,32010,32010,32011,0,1,3
9130,2,3,32012,32012,32015,0,3,1
9131,4,1,32016,32016,32017,0,1,1
9132,2,3,32018,32018,32021,0,3,1
9133,3,1,32021,32021,32022,0,1,0
9134,6,1,32027,32027,32028,0,1,5
9135,6,2,32033,32033,32035,0,2,5
9136,6,2,32039,32039,32041,0,2,4
9137,2,3,32041,32041,32044,0,3,0
9138,4,3,32045,32045,32048,0,3,1
9139,3,1,32048,32048,32049,0,1,0
9140,3,1,32051,32051,32052,0,1,2
9141,2,2,32053,32053,32055,0,2,1
9142,1,2,32054,32055,32057,1,3,0
9143,6,2,32060,32060,32062,0,2,3
9144,4,1,32064,32064,32065,0,1,2
9145,3,3,32067,32067,32070,0,3,2
9146,5,1,32072,32072,32073,0,1,2
9147,6,2,32078,32078,32080,0,2,5
9148,3,2,32081,32081,32083,0,2,1
9149,2,3,32083,32083,32086,0,3,0
9150,1,1,32084,32086,32087,2,3,0
9151,6,2,32090,32090,32092,0,2,3
9152,5,3,32095,32095,32098,0,3,3
9153,2,3,32097,32098,32101,1,4,0
9154,4,2,32101,32101,32103,0,2,0
9155,6,3,32107,32107,32110,0,3,4
9156,5,1,32112,32112,32113,0,1,2
9157,2,3,32114,32114,32117,0,3,1
9158,6,3,32120,32120,32123,0,3,3
9159,6,2,32126,32126,32128,0,2,3
9160,1,1,32127,32128,32129,1,2,0
9161,4,3,32131,32131,32134,0,3,2
9162,3,1,32134,32134,32135,0,1,0
9163,6,3,32140,32140,32143,0,3,5
9164,5,3,32145,32145,32148,0,3,2
9165,1,1,32146,32148,32149,2,3,0
9166,5,2,32151,32151,32153,0,2,2
9167,4,2,32155,32155,32157,0,2,2
9168,4,2,32159,32159,32161,0,2,2
9169,6,1,32165,32165,32166,0,1,4
9170,4,3,32169,32169,32172,0,3,3
9171,3,1,32172,32172,32173,0,1,0
9172,6,1,32178,32178,32179,0,1,5
9173,2,1,32180,32180,32181,0,1,1
9174,2,2,32182,32182,32184,0,2,1
9175,2,3,32184,32184,32187,0,3,0
9176,4,3,32188,32188,32191,0,3,1
9177,4,3,32192,32192,32195,0,3,1
9178,4,2,32196,32196,32198,0,2,1
9179,2,2,32198,32198,32200,0,2,0
9180,6,3,32204,32204,32207,0,3,4
9181,5,2,32209,32209,32211,0,2,2
9182,6,1,32215,32215,32216,0,1,4
9183,6,3,32221,32221,32224,0,3,5
9184,6,1,32227,32227,32228,0,1,3
9185,5,1,32232,32232,32233,0,1,4
9186,6,2,32238,32238,32240,0,2,5
9187,2,1,32240,32240,32241,0,1,0
9188,4,2,32244,32244,32246,0,2,3
9189,4,1,32248,32248,32249,0,1,2
9190,2,2,32250,32250,32252,0,2,1
9191,4,1,32254,32254,32255,0,1,2
9192,6,3,32260,32260,32263,0,3,5
9193,3,1,32263,32263,32264,0,1,0
9194,2,3,32265,32265,32268,0,3,1
9195,3,3,32268,32268,32271,0,3,0
9196,5,3,32273,32273,32276,0,3,2
9197,1,3,32274,32276,32279,2,5,0
9198,3,1,32277,32279,32280,2,3,0
9199,2,3,32279,32280,32283,1,4,0
9200,4,1,32283,32283,32284,0,1,0
9201,4,2,32287,32287,32289,0,2,3
9202,4,3,32291,32291,32294,0,3,2
9203,4,1,32295,32295,32296,0,1,1
9204,1,3,32296,32296,32299,0,3,0
9205,6,2,32302,32302,32304,0,2,3
9206,6,1,32308,32308,32309,0,1,4
9207,1,2,32309,32309,32311,0,2,0
9208,5,3,32314,32314,32317,0,3,3
9209,3,1,32317,32317,32318,0,1,0
9210,6,3,32323,32323,32326,0,3,5
9211,6,2,32329,32329,32331,0,2,3
9212,5,1,32334,32334,32335,0,1,3
9213,1,3,32335,32335,32338,0,3,0
9214,1,3,32336,32338,32341,2,5,0
9215,4,1,32340,32341,32342,1,2,0
9216,5,2,32345,32345,32347,0,2,3
9217,1,1,32346,32347,32348,1,2,0
9218,2,2,32348,32348,32350,0,2,0
9219,5,1,32353,32353,32354,0,1,3
9220,6,3,32359,32359,32362,0,3,5
9221,1,3,32360,32362,32365,2,5,0
9222,4,2,32364,32365,32367,1,3,0
9223,5,1,32369,32369,32370,0,1,2
9224,6,1,32375,32375,32376,0,1,5
9225,6,2,32381,32381,32383,0,2,5
9226,5,3,32386,32386,32389,0,3,3
9227,5,1,32391,32391,32392,0,1,2
9228,6,3,32397,32397,32400,0,3,5
9229,6,2,32403,32403,32405,0,2,3
9230,4,3,32407,32407,32410,0,3,2
9231,6,2,32413,32413,32415,0,2,3
9232,5,3,32418,32418,32421,0,3,3
9233,1,3,32419,32421,32424,2,5,0
9234,4,3,32423,32424,32427,1,4,0
9235,3,2,32426,32427,32429,1,3,0
9236,3,1,32429,32429,32430,0,1,0
9237,2,2,32431,32431,32433,0,2,1
9238,6,2,32437,32437,32439,0,2,4
9239,6,2,32443,32443,32445,0,2,4
9240,2,3,32445,32445,32448,0,3,0
9241,5,1,32450,32450,32451,0,1,2
9242,1,2,32451,32451,32453,0,2,0
9243,3,2,32454,32454,32456,0,2,1
9244,5,1,32459,32459,32460,0,1,3
9245,5,2,32464,32464,32466,0,2,4
9246,3,3,32467,32467,32470,0,3,1
9247,6,3,32473,32473,32476,0,3,3
9248,2,1,32475,32476,32477,1,2,0
9249,5,3,32480,32480,32483,0,3,3
9250,3,3,32483,32483,32486,0,3,0
9251,5,2,32488,32488,32490,0,2,2
9252,3,1,32491,32491,32492,0,1,1
9253,2,3,32493,32493,32496,0,3,1
9254,2,1,32495,32496,32497,1,2,0
9255,5,1,32500,32500,32501,0,1,3
9256,3,1,32503,32503,32504,0,1,2
9257,2,2,32505,32505,32507,0,2,1
9258,4,2,32509,32509,32511,0,2,2
9259,6,2,32515,32515,32517,0,2,4
9260,3,1,32518,32518,32519,0,1,1
9261,2,1,32520,32520,32521,0,1,1
9262,2,3,32522,32522,32525,0,3,1
9263,1,1,32523,32525,32526,2,3,0
9264,3,3,32526,32526,32529,0,3,0
9265,2,3,32528,32529,32532,1,4,0
9266,1,3,32529,32532,32535,3,6,0
9267,5,1,32534,32535,32536,1,2,0
9268,2,1,32536,32536,32537,0,1,0
9269,6,2,32542,32542,32544,0,2,5
9270,2,1,32544,32544,32545,0,1,0
9271,6,2,32550,32550,32552,0,2,5
9272,3,3,32553,32553,32556,0,3,1
9273,1,3,32554,32556,32559,2,5,0
9274,3,1,32557,32559,32560,2,3,0
9275,5,2,32562,32562,32564,0,2,2
9276,4,2,32566,32566,32568,0,2,2
9277,2,1,32568,32568,32569,0,1,0
9278,6,1,32574,32574,32575,0,1,5
9279,5,1,32579,32579,32580,0,1,4
9280,4,2,32583,32583,32585,0,2,3
9281,4,1,32587,32587,32588,0,1,2
9282,6,3,32593,32593,32596,0,3,5
9283,2,3,32595,32596,32599,1,4,0
9284,1,1,32596,32599,32600,3,4,0
9285,1,2,32597,32600,32602,3,5,0
9286,2,2,32599,32602,32604,3,5,0
9287,2,1,32601,32604,32605,3,4,0
9288,5,1,32606,32606,32607,0,1,1
9289,1,1,32607,32607,32608,0,1,0
9290,5,3,32612,32612,32615,0,3,4
9291,1,2,32613,32615,32617,2,4,0
9292,6,1,32619,32619,32620,0,1,2
9293,4,2,32623,32623,32625,0,2,3
9294,5,3,32628,32628,32631,0,3,3
9295,2,2,32630,32631,32633,1,3,0
9296,3,2,32633,32633,32635,0,2,0
9297,1,2,32634,32635,32637,1,3,0
9298,5,2,32639,32639,32641,0,2,2
9299,1,2,32640,32641,32643,1,3,0
9300,5,3,32645,32645,32648,0,3,2
9301,5,2,32650,32650,32652,0,2,2
9302,3,1,32653,32653,32654,0,1,1
9303,5,1,32658,32658,32659,0,1,4
9304,2,3,32660,32660,32663,0,3,1
9305,3,3,32663,32663,32666,0,3,0
9306,6,2,32669,32669,32671,0,2,3
9307,2,2,32671,32671,32673,0,2,0
9308,4,2,32675,32675,32677,0,2,2
9309,6,2,32681,32681,32683,0,2,4
9310,4,2,32685,32685,32687,0,2,2
9311,2,2,32687,32687,32689,0,2,0
9312,1,1,32688,32689,32690,1,2,0
9313,4,1,32692,32692,32693,0,1,2
9314,5,1,32697,32697,32698,0,1,4
9315,2,3,32699,32699,32702,0,3,1
9316,2,1,32701,32702,32703,1,2,0
9317,5,2,32706,32706,32708,0,2,3
9318,3,3,32709,32709,32712,0,3,1
9319,3,3,32712,32712,32715,0,3,0
9320,5,2,32717,32717,32719,0,2,2
9321,1,1,32718,32719,32720,1,2,0
9322,4,1,32722,32722,32723,0,1,2
9323,1,2,32723,32723,32725,0,2,0
9324,1,2,32724,32725,32727,1,3,0
9325,4,2,32728,32728,32730,0,2,1
9326,4,3,32732,32732,32735,0,3,2
9327,2,2,32734,32735,32737,1,3,0
9328,1,3,32735,32737,32740,2,5,0
9329,5,1,32740,32740,32741,0,1,0
9330,6,2,32746,32746,32748,0,2,5
9331,6,2,32752,32752,32754,0,2,4
9332,1,1,32753,32754,32755,1,2,0
9333,6,2,32759,32759,32761,0,2,4
9334,5,2,32764,32764,32766,0,2,3
9335,2,2,32766,32766,32768,0,2,0
9336,5,2,32771,32771,32773,0,2,3
9337,3,2,32774,32774,32776,0,2,1
9338,4,3,32778,32778,32781,0,3,2
9339,2,1,32780,32781,32782,1,2,0
9340,1,1,32781,32782,32783,1,2,0
9341,3,1,32784,32784,32785,0,1,1
9342,1,2,32785,32785,32787,0,2,0
9343,5,1,32790,32790,32791,0,1,3
9344,5,3,32795,32795,32798,0,3,4
9345,3,1,32798,32798,32799,0,1,0
9346,6,3,32804,32804,32807,0,3,5
9347,4,1,32808,32808,32809,0,1,1
9348,1,2,32809,32809,32811,0,2,0
9349,5,1,32814,32814,32815,0,1,3
9350,5,3,32819,32819,32822,0,3,4
9351,1,2,32820,32822,32824,2,4,0
9352,6,3,32826,32826,32829,0,3,2
9353,6,1,32832,32832,32833,0,1,3
9354,6,1,32838,32838,32839,0,1,5
9355,1,2,32839,32839,32841,0,2,0
9356,6,1,32845,32845,32846,0,1,4
9357,5,2,32850,32850,32852,0,2,4
9358,2,1,32852,32852,32853,0,1,0
9359,3,2,32855,32855,32857,0,2,2
9360,6,3,32861,32861,32864,0,3,4
9361,5,2,32866,32866,32868,0,2,2
9362,6,1,32872,32872,32873,0,1,4
9363,2,2,32874,32874,32876,0,2,1
9364,2,2,32876,32876,32878,0,2,0
9365,2,3,32878,32878,32881,0,3,0
9366,1,2,32879,32881,32883,2,4,0
9367,3,3,32882,32883,32886,1,4,0
9368,1,3,32883,32886,32889,3,6,0
9369,4,2,32887,32889,32891,2,4,0
9370,4,3,32891,32891,32894,0,3,0
9371,1,1,32892,32894,32895,2,3,0
9372,6,1,32898,32898,32899,0,1,3
9373,5,3,32903,32903,32906,0,3,4
9374,6,2,32909,32909,32911,0,2,3
9375,1,1,32910,32911,32912,1,2,0
9376,2,1,32912,32912,32913,0,1,0
9377,5,1,32917,32917,32918,0,1,4
9378,2,2,32919,32919,32921,0,2,1
9379,2,1,32921,32921,32922,0,1,0
9380,2,1,32923,32923,32924,0,1,1
9381,5,1,32928,32928,32929,0,1,4
9382,1,3,32929,32929,32932,0,3,0
9383,4,3,32933,32933,32936,0,3,1
9384,4,1,32937,32937,32938,0,1,1
9385,1,2,32938,32938,32940,0,2,0
9386,2,1,32940,32940,32941,0,1,0
9387,2,3,32942,32942,32945,0,3,1
9388,3,2,32945,32945,32947,0,2,0
9389,2,1,32947,32947,32948,0,1,0
9390,1,2,32948,32948,32950,0,2,0
9391,1,1,32949,32950,32951,1,2,0
9392,4,1,32953,32953,32954,0,1,2
9393,1,2,32954,32954,32956,0,2,0
9394,3,1,32957,32957,32958,0,1,1
9395,3,3,32960,32960,32963,0,3,2
9396,5,3,32965,32965,32968,0,3,2
9397,2,3,32967,32968,32971,1,4,0
9398,2,2,32969,32971,32973,2,4,0
9399,6,1,32975,32975,32976,0,1,2
9400,6,1,32981,32981,32982,0,1,5
9401,6,3,32987,32987,32990,0,3,5
9402,5,2,32992,32992,32994,0,2,2
9403,2,3,32994,32994,32997,0,3,0
9404,6,1,33000,33000,33001,0,1,3
9405,1,1,33001,33001,33002,0,1,0
9406,1,1,33002,33002,33003,0,1,0
9407,5,3,33007,33007,33010,0,3,4
9408,2,1,33009,33010,33011,1,2,0
9409,6,3,33015,33015,33018,0,3,4
9410,2,3,33017,33018,33021,1,4,0
9411,5,3,33022,33022,33025,0,3,1
9412,1,3,33023,33025,33028,2,5,0
9413,1,1,33024,33028,33029,4,5,0
9414,5,1,33029,33029,33030,0,1,0
9415,1,2,33030,33030,33032,0,2,0
9416,2,1,33032,33032,33033,0,1,0
9417,4,3,33036,33036,33039,0,3,3
9418,4,1,33040,33040,33041,0,1,1
9419,3,3,33043,33043,33046,0,3,2
9420,2,3,33045,33046,33049,1,4,0
9421,2,2,33047,33049,33051,2,4,0
9422,5,2,33052,33052,33054,0,2,1
9423,4,1,33056,33056,33057,0,1,2
9424,3,3,33059,33059,33062,0,3,2
9425,3,1,33062,33062,33063,0,1,0
9426,2,1,33064,33064,33065,0,1,1
9427,6,3,33070,33070,33073,0,3,5
9428,4,1,33074,33074,33075,0,1,1
9429,5,3,33079,33079,33082,0,3,4
9430,5,2,33084,33084,33086,0,2,2
9431,5,1,33089,33089,33090,0,1,3
9432,2,2,33091,33091,33093,0,2,1
9433,3,1,33094,33094,33095,0,1,1
9434,6,1,33100,33100,33101,0,1,5
9435,6,2,33106,33106,33108,0,2,5
9436,4,3,33110,33110,33113,0,3,2
9437,2,3,33112,33113,33116,1,4,0
9438,5,2,33117,33117,33119,0,2,1
9439,2,3,33119,33119,33122,0,3,0
9440,6,1,33125,33125,33126,0,1,3
9441,6,1,33131,33131,33132,0,1,5
9442,1,3,33132,33132,33135,0,3,0
9443,5,3,33137,33137,33140,0,3,2
9444,4,3,33141,33141,33144,0,3,1
9445,1,3,33142,33144,33147,2,5,0
9446,4,1,33146,33147,33148,1,2,0
9447,4,2,33150,33150,33152,0,2,2
9448,6,2,33156,33156,33158,0,2,4
9449,6,2,33162,33162,33164,0,2,4
9450,5,2,33167,33167,33169,0,2,3
9451,5,2,33172,33172,33174,0,2,3
9452,3,3,33175,33175,33178,0,3,1
9453,4,1,33179,33179,33180,0,1,1
9454,6,2,33185,33185,33187,0,2,5
9455,1,2,33186,33187,33189,1,3,0
9456,6,1,33192,33192,33193,0,1,3
9457,1,2,33193,33193,33195,0,2,0
9458,2,2,33195,33195,33197,0,2,0
9459,2,1,33197,33197,33198,0,1,0
9460,1,3,33198,33198,33201,0,3,0
9461,3,2,33201,33201,33203,0,2,0
9462,6,1,33207,33207,33208,0,1,4
9463,5,2,33212,33212,33214,0,2,4
9464,3,2,33215,33215,33217,0,2,1
9465,2,2,33217,33217,33219,0,2,0
9466,2,2,33219,33219,33221,0,2,0
9467,1,1,33220,33221,33222,1,2,0
9468,2,2,33222,33222,33224,0,2,0
9469,3,2,33225,33225,33227,0,2,1
9470,6,2,33231,33231,33233,0,2,4
9471,3,2,33234,33234,33236,0,2,1
9472,2,1,33236,33236,33237,0,1,0
9473,2,3,33238,33238,33241,0,3,1
9474,3,2,33241,33241,33243,0,2,0
9475,3,2,33244,33244,33246,0,2,1
9476,5,2,33249,33249,33251,0,2,3
9477,3,2,33252,33252,33254,0,2,1
9478,5,1,33257,33257,33258,0,1,3
9479,1,2,33258,33258,33260,0,2,0
9480,4,2,33262,33262,33264,0,2,2
9481,5,1,33267,33267,33268,0,1,3
9482,2,2,33269,33269,33271,0,2,1
9483,1,3,33270,33271,33274,1,4,0
9484,1,2,33271,33274,33276,3,5,0
9485,3,2,33274,33276,33278,2,4,0
9486,5,2,33279,33279,33281,0,2,1
9487,3,2,33282,33282,33284,0,2,1
9488,2,3,33284,33284,33287,0,3,0
9489,4,1,33288,33288,33289,0,1,1
9490,4,1,33292,33292,33293,0,1,3
9491,3,3,33295,33295,33298,0,3,2
9492,2,1,33297,33298,33299,1,2,0
9493,1,1,33298,33299,33300,1,2,0
9494,5,2,33303,33303,33305,0,2,3
9495,5,2,33308,33308,33310,0,2,3
9496,2,3,33310,33310,33313,0,3,0
9497,5,1,33315,33315,33316,0,1,2
9498,4,3,33319,33319,33322,0,3,3
9499,2,1,33321,33322,33323,1,2,0
9500,2,2,33323,33323,33325,0,2,0
9501,1,2,33324,33325,33327,1,3,0
9502,6,3,33330,33330,33333,0,3,3
9503,1,1,33331,33333,33334,2,3,0
9504,6,3,33337,33337,33340,0,3,3
9505,4,3,33341,33341,33344,0,3,1
9506,3,2,33344,33344,33346,0,2,0
9507,4,3,33348,33348,33351,0,3,2
9508,4,1,33352,33352,33353,0,1,1
9509,3,2,33355,33355,33357,0,2,2
9510,5,1,33360,33360,33361,0,1,3
9511,4,3,33364,33364,33367,0,3,3
9512,4,2,33368,33368,33370,0,2,1
9513,3,1,33371,33371,33372,0,1,1
9514,2,2,33373,33373,33375,0,2,1
9515,2,2,33375,33375,33377,0,2,0
9516,4,3,33379,33379,33382,0,3,2
9517,1,2,33380,33382,33384,2,4,0
9518,5,2,33385,33385,33387,0,2,1
9519,1,2,33386,33387,33389,1,3,0
9520,3,1,33389,33389,33390,0,1,0
9521,3,2,33392,33392,33394,0,2,2
9522,5,2,33397,33397,33399,0,2,3
9523,4,2,33401,33401,33403,0,2,2
9524,6,2,33407,33407,33409,0,2,4
9525,1,2,33408,33409,33411,1,3,0
9526,4,1,33412,33412,33413,0,1,1
9527,6,1,33418,33418,33419,0,1,5
9528,2,3,33420,33420,33423,0,3,1
9529,6,3,33426,33426,33429,0,3,3
9530,4,2,33430,33430,33432,0,2,1
9531,6,1,33436,33436,33437,0,1,4
9532,4,2,33440,33440,33442,0,2,3
9533,4,2,33444,33444,33446,0,2,2
9534,2,3,33446,33446,33449,0,3,0
9535,4,1,33450,33450,33451,0,1,1
9536,4,1,33454,33454,33455,0,1,3
9537,3,3,33457,33457,33460,0,3,2
9538,6,2,33463,33463,33465,0,2,3
9539,2,1,33465,33465,33466,0,1,0
9540,4,1,33469,33469,33470,0,1,3
9541,2,1,33471,33471,33472,0,1,1
9542,3,3,33474,33474,33477,0,3,2
9543,4,1,33478,33478,33479,0,1,1
9544,5,2,33483,33483,33485,0,2,4
9545,4,3,33487,33487,33490,0,3,2
9546,2,3,33489,33490,33493,1,4,0
9547,2,1,33491,33493,33494,2,3,0
9548,5,1,33496,33496,33497,0,1,2
9549,6,1,33502,33502,33503,0,1,5
9550,2,2,33504,33504,33506,0,2,1
9551,2,3,33506,33506,33509,0,3,0
9552,4,2,33510,33510,33512,0,2,1
9553,2,2,33512,33512,33514,0,2,0
9554,1,3,33513,33514,33517,1,4,0
9555,6,3,33519,33519,33522,0,3,2
9556,6,1,33525,33525,33526,0,1,3
9557,3,2,33528,33528,33530,0,2,2
9558,3,3,33531,33531,33534,0,3,1
9559,3,1,33534,33534,33535,0,1,0
9560,2,1,33536,33536,33537,0,1,1
9561,1,1,33537,33537,33538,0,1,0
9562,6,3,33543,33543,33546,0,3,5
9563,4,3,33547,33547,33550,0,3,1
9564,6,3,33553,33553,33556,0,3,3
9565,4,1,33557,33557,33558,0,1,1
9566,5,1,33562,33562,33563,0,1,4
9567,2,1,33564,33564,33565,0,1,1
9568,3,3,33567,33567,33570,0,3,2
9569,2,3,33569,33570,33573,1,4,0
9570,3,3,33572,33573,33576,1,4,0
9571,4,1,33576,33576,33577,0,1,0
9572,6,1,33582,33582,33583,0,1,5
9573,3,2,33585,33585,33587,0,2,2
9574,4,2,33589,33589,33591,0,2,2
9575,2,1,33591,33591,33592,0,1,0
9576,3,2,33594,33594,33596,0,2,2
9577,2,2,33596,33596,33598,0,2,0
9578,3,1,33599,33599,33600,0,1,1
9579,1,3,33600,33600,33603,0,3,0
9580,4,2,33604,33604,33606,0,2,1
9581,6,1,33610,33610,33611,0,1,4
9582,5,2,33615,33615,33617,0,2,4
9583,5,3,33620,33620,33623,0,3,3
9584,4,2,33624,33624,33626,0,2,1
9585,5,1,33629,33629,33630,0,1,3
9586,4,1,33633,33633,33634,0,1,3
9587,6,3,33639,33639,33642,0,3,5
9588,6,3,33645,33645,33648,0,3,3
9589,6,3,33651,33651,33654,0,3,3
9590,1,3,33652,33654,33657,2,5,0
9591,6,2,33658,33658,33660,0,2,1
9592,2,1,33660,33660,33661,0,1,0
9593,6,3,33666,33666,33669,0,3,5
9594,1,3,33667,33669,33672,2,5,0
9595,2,3,33669,33672,33675,3,6,0
9596,2,1,33671,33675,33676,4,5,0
9597,5,2,33676,33676,33678,0,2,0
9598,4,1,33680,33680,33681,0,1,2
9599,5,3,33685,33685,33688,0,3,4
9600,4,1,33689,33689,33690,0,1,1
9601,4,2,33693,33693,33695,0,2,3
9602,4,2,33697,33697,33699,0,2,2
9603,5,3,33702,33702,33705,0,3,3
9604,1,3,33703,33705,33708,2,5,0
9605,5,3,33708,33708,33711,0,3,0
9606,1,1,33709,33711,33712,2,3,0
9607,6,3,33715,33715,33718,0,3,3
9608,3,2,33718,33718,33720,0,2,0
9609,1,2,33719,33720,33722,1,3,0
9610,5,1,33724,33724,33725,0,1,2
9611,2,2,33726,33726,33728,0,2,1
9612,4,2,33730,33730,33732,0,2,2
9613,2,3,33732,33732,33735,0,3,0
9614,2,2,33734,33735,33737,1,3,0
9615,5,2,33739,33739,33741,0,2,2
9616,2,1,33741,33741,33742,0,1,0
9617,6,3,33747,33747,33750,0,3,5
9618,4,2,33751,33751,33753,0,2,1
9619,1,2,33752,33753,33755,1,3,0
9620,6,2,33758,33758,33760,0,2,3
9621,6,1,33764,33764,33765,0,1,4
9622,1,3,33765,33765,33768,0,3,0
9623,5,2,33770,33770,33772,0,2,2
9624,4,3,33774,33774,33777,0,3,2
9625,3,3,33777,33777,33780,0,3,0
9626,6,2,33783,33783,33785,0,2,3
9627,2,3,33785,33785,33788,0,3,0
9628,1,2,33786,33788,33790,2,4,0
9629,4,2,33790,33790,33792,0,2,0
9630,5,2,33795,33795,33797,0,2,3
9631,1,3,33796,33797,33800,1,4,0
9632,1,1,33797,33800,33801,3,4,0
9633,6,2,33803,33803,33805,0,2,2
9634,2,2,33805,33805,33807,0,2,0
9635,4,1,33809,33809,33810,0,1,2
9636,6,1,33815,33815,33816,0,1,5
9637,3,3,33818,33818,33821,0,3,2
9638,5,3,33823,33823,33826,0,3,2
9639,4,1,33827,33827,33828,0,1,1
9640,6,2,33833,33833,33835,0,2,5
9641,5,3,33838,33838,33841,0,3,3
9642,2,3,33840,33841,33844,1,4,0
9643,5,1,33845,33845,33846,0,1,1
9644,6,2,33851,33851,33853,0,2,5
9645,5,3,33856,33856,33859,0,3,3
9646,4,2,33860,33860,33862,0,2,1
9647,5,3,33865,33865,33868,0,3,3
9648,2,2,33867,33868,33870,1,3,0
9649,1,1,33868,33870,33871,2,3,0
9650,1,2,33869,33871,33873,2,4,0
9651,1,3,33870,33873,33876,3,6,0
9652,4,1,33874,33876,33877,2,3,0
9653,2,1,33876,33877,33878,1,2,0
9654,1,3,33877,33878,33881,1,4,0
9655,4,3,33881,33881,33884,0,3,0
9656,2,3,33883,33884,33887,1,4,0
9657,6,1,33889,33889,33890,0,1,2
9658,1,1,33890,33890,33891,0,1,0
9659,4,3,33894,33894,33897,0,3,3
9660,6,1,33900,33900,33901,0,1,3
9661,4,2,33904,33904,33906,0,2,3
9662,2,1,33906,33906,33907,0,1,0
9663,4,1,33910,33910,33911,0,1,3
9664,2,3,33912,33912,33915,0,3,1
9665,5,1,33917,33917,33918,0,1,2
9666,3,1,33920,33920,33921,0,1,2
9667,2,3,33922,33922,33925,0,3,1
9668,3,3,33925,33925,33928,0,3,0
9669,4,2,33929,33929,33931,0,2,1
9670,4,2,33933,33933,33935,0,2,2
9671,5,3,33938,33938,33941,0,3,3
9672,1,3,33939,33941,33944,2,5,0
9673,5,2,33944,33944,33946,0,2,0
9674,4,1,33948,33948,33949,0,1,2
9675,5,1,33953,33953,33954,0,1,4
9676,1,1,33954,33954,33955,0,1,0
9677,6,2,33960,33960,33962,0,2,5
9678,3,2,33963,33963,33965,0,2,1
9679,4,3,33967,33967,33970,0,3,2
9680,4,2,33971,33971,33973,0,2,1
9681,4,1,33975,33975,33976,0,1,2
9682,4,3,33979,33979,33982,0,3,3
9683,1,1,33980,33982,33983,2,3,0
9684,3,3,33983,33983,33986,0,3,0
9685,5,1,33988,33988,33989,0,1,2
9686,4,3,33992,33992,33995,0,3,3
9687,5,1,33997,33997,33998,0,1,2
9688,6,2,34003,34003,34005,0,2,5
9689,1,3,34004,34005,34008,1,4,0
9690,2,2,34006,34008,34010,2,4,0
9691,2,3,34008,34010,34013,2,5,0
9692,2,2,34010,34013,34015,3,5,0
9693,1,2,34011,34015,34017,4,6,0
9694,2,3,34013,34017,34020,4,7,0
9695,1,2,34014,34020,34022,6,8,0
9696,6,3,34020,34022,34025,2,5,0
9697,4,2,34024,34025,34027,1,3,0
9698,1,1,34025,34027,34028,2,3,0
9699,3,1,34028,34028,34029,0,1,0
9700,5,3,34033,34033,34036,0,3,4
9701,5,2,34038,34038,34040,0,2,2
9702,4,3,34042,34042,34045,0,3,2
9703,2,1,34044,34045,34046,1,2,0
9704,5,1,34049,34049,34050,0,1,3
9705,3,2,34052,34052,34054,0,2,2
9706,6,1,34058,34058,34059,0,1,4
9707,4,3,34062,34062,34065,0,3,3
9708,5,1,34067,34067,34068,0,1,2
9709,6,2,34073,34073,34075,0,2,5
9710,3,3,34076,34076,34079,0,3,1
9711,5,2,34081,34081,34083,0,2,2
9712,3,1,34084,34084,34085,0,1,1
9713,1,1,34085,34085,34086,0,1,0
9714,2,2,34087,34087,34089,0,2,1
9715,4,3,34091,34091,34094,0,3,2
9716,6,3,34097,34097,34100,0,3,3
9717,2,2,34099,34100,34102,1,3,0
9718,1,1,34100,34102,34103,2,3,0
9719,6,2,34106,34106,34108,0,2,3
9720,5,3,34111,34111,34114,0,3,3
9721,5,3,34116,34116,34119,0,3,2
9722,4,2,34120,34120,34122,0,2,1
9723,5,3,34125,34125,34128,0,3,3
9724,3,2,34128,34128,34130,0,2,0
9725,6,2,34134,34134,34136,0,2,4
9726,3,1,34137,34137,34138,0,1,1
9727,5,3,34142,34142,34145,0,3,4
9728,1,2,34143,34145,34147,2,4,0
9729,1,3,34144,34147,34150,3,6,0
9730,5,1,34149,34150,34151,1,2,0
9731,3,3,34152,34152,34155,0,3,1
9732,4,3,34156,34156,34159,0,3,1
9733,6,2,34162,34162,34164,0,2,3
9734,5,1,34167,34167,34168,0,1,3
9735,5,1,34172,34172,34173,0,1,4
9736,1,3,34173,34173,34176,0,3,0
9737,3,1,34176,34176,34177,0,1,0
9738,5,2,34181,34181,34183,0,2,4
9739,6,2,34187,34187,34189,0,2,4
9740,5,2,34192,34192,34194,0,2,3
9741,4,1,34196,34196,34197,0,1,2
9742,2,1,34198,34198,34199,0,1,1
9743,4,2,34202,34202,34204,0,2,3
9744,3,2,34205,34205,34207,0,2,1
9745,1,3,34206,34207,34210,1,4,0
9746,4,3,34210,34210,34213,0,3,0
9747,5,1,34215,34215,34216,0,1,2
9748,2,3,34217,34217,34220,0,3,1
9749,5,3,34222,34222,34225,0,3,2
9750,2,2,34224,34225,34227,1,3,0
9751,5,2,34229,34229,34231,0,2,2
9752,5,1,34234,34234,34235,0,1,3
9753,3,1,34237,34237,34238,0,1,2
9754,2,2,34239,34239,34241,0,2,1
9755,2,1,34241,34241,34242,0,1,0
9756,4,2,34245,34245,34247,0,2,3
9757,5,3,34250,34250,34253,0,3,3
9758,6,1,34256,34256,34257,0,1,3
9759,5,3,34261,34261,34264,0,3,4
9760,3,1,34264,34264,34265,0,1,0
9761,6,2,34270,34270,34272,0,2,5
9762,3,2,34273,34273,34275,0,2,1
9763,4,1,34277,34277,34278,0,1,2
9764,6,3,34283,34283,34286,0,3,5
9765,2,3,34285,34286,34289,1,4,0
9766,6,3,34291,34291,34294,0,3,2
9767,2,1,34293,34294,34295,1,2,0
9768,2,1,34295,34295,34296,0,1,0
9769,3,2,34298,34298,34300,0,2,2
9770,4,3,34302,34302,34305,0,3,2
9771,1,2,34303,34305,34307,2,4,0
9772,4,3,34307,34307,34310,0,3,0
9773,1,3,34308,34310,34313,2,5,0
9774,6,1,34314,34314,34315,0,1,1
9775,2,2,34316,34316,34318,0,2,1
9776,5,1,34321,34321,34322,0,1,3
9777,3,3,34324,34324,34327,0,3,2
9778,3,1,34327,34327,34328,0,1,0
9779,2,1,34329,34329,34330,0,1,1
9780,1,2,34330,34330,34332,0,2,0
9781,2,3,34332,34332,34335,0,3,0
9782,5,3,34337,34337,34340,0,3,2
9783,1,3,34338,34340,34343,2,5,0
9784,3,2,34341,34343,34345,2,4,0
9785,3,1,34344,34345,34346,1,2,0
9786,5,2,34349,34349,34351,0,2,3
9787,2,1,34351,34351,34352,0,1,0
9788,1,3,34352,34352,34355,0,3,0
9789,4,2,34356,34356,34358,0,2,1
9790,2,2,34358,34358,34360,0,2,0
9791,3,1,34361,34361,34362,0,1,1
9792,5,3,34366,34366,34369,0,3,4
9793,3,3,34369,34369,34372,0,3,0
9794,1,2,34370,34372,34374,2,4,0
9795,5,3,34375,34375,34378,0,3,1
9796,6,3,34381,34381,34384,0,3,3
9797,2,2,34383,34384,34386,1,3,0
9798,6,2,34389,34389,34391,0,2,3
9799,2,2,34391,34391,34393,0,2,0
9800,3,1,34394,34394,34395,0,1,1
9801,5,3,34399,34399,34402,0,3,4
9802,2,2,34401,34402,34404,1,3,0
9803,4,2,34405,34405,34407,0,2,1
9804,1,1,34406,34407,34408,1,2,0
9805,2,1,34408,34408,34409,0,1,0
9806,4,2,34412,34412,34414,0,2,3
9807,6,2,34418,34418,34420,0,2,4
9808,2,2,34420,34420,34422,0,2,0
9809,3,1,34423,34423,34424,0,1,1
9810,5,1,34428,34428,34429,0,1,4
9811,6,3,34434,34434,34437,0,3,5
9812,5,1,34439,34439,34440,0,1,2
9813,5,1,34444,34444,34445,0,1,4
9814,3,3,34447,34447,34450,0,3,2
9815,1,3,34448,34450,34453,2,5,0
9816,3,3,34451,34453,34456,2,5,0
9817,3,3,34454,34456,34459,2,5,0
9818,3,2,34457,34459,34461,2,4,0
9819,3,1,34460,34461,34462,1,2,0
9820,6,1,34466,34466,34467,0,1,4
9821,4,1,34470,34470,34471,0,1,3
9822,3,2,34473,34473,34475,0,2,2
9823,1,2,34474,34475,34477,1,3,0
9824,4,3,34478,34478,34481,0,3,1
9825,3,1,34481,34481,34482,0,1,0
9826,5,3,34486,34486,34489,0,3,4
9827,4,2,34490,34490,34492,0,2,1
9828,5,2,34495,34495,34497,0,2,3
9829,4,1,34499,34499,34500,0,1,2
9830,5,1,34504,34504,34505,0,1,4
9831,2,3,34506,34506,34509,0,3,1
9832,1,2,34507,34509,34511,2,4,0
9833,3,3,34510,34511,34514,1,4,0
9834,4,3,34514,34514,34517,0,3,0
9835,2,2,34516,34517,34519,1,3,0
9836,1,3,34517,34519,34522,2,5,0
9837,2,1,34519,34522,34523,3,4,0
9838,1,1,34520,34523,34524,3,4,0
9839,4,2,34524,34524,34526,0,2,0
9840,6,2,34530,34530,34532,0,2,4
9841,6,2,34536,34536,34538,0,2,4
9842,5,1,34541,34541,34542,0,1,3
9843,1,3,34542,34542,34545,0,3,0
9844,2,2,34544,34545,34547,1,3,0
9845,1,2,34545,34547,34549,2,4,0
9846,6,2,34551,34551,34553,0,2,2
9847,5,3,34556,34556,34559,0,3,3
9848,6,1,34562,34562,34563,0,1,3
9849,5,2,34567,34567,34569,0,2,4
9850,5,1,34572,34572,34573,0,1,3
9851,3,2,34575,34575,34577,0,2,2
9852,5,1,34580,34580,34581,0,1,3
9853,6,3,34586,34586,34589,0,3,5
9854,2,2,34588,34589,34591,1,3,0
9855,4,3,34592,34592,34595,0,3,1
9856,2,2,34594,34595,34597,1,3,0
9857,5,3,34599,34599,34602,0,3,2
9858,2,3,34601,34602,34605,1,4,0
9859,1,1,34602,34605,34606,3,4,0
9860,3,1,34605,34606,34607,1,2,0
9861,1,1,34606,34607,34608,1,2,0
9862,4,3,34610,34610,34613,0,3,2
9863,3,2,34613,34613,34615,0,2,0
9864,2,1,34615,34615,34616,0,1,0
9865,5,1,34620,34620,34621,0,1,4
9866,5,2,34625,34625,34627,0,2,4
9867,3,2,34628,34628,34630,0,2,1
9868,5,1,34633,34633,34634,0,1,3
9869,6,2,34639,34639,34641,0,2,5
9870,3,3,34642,34642,34645,0,3,1
9871,3,2,34645,34645,34647,0,2,0
9872,1,3,34646,34647,34650,1,4,0
9873,5,1,34651,34651,34652,0,1,1
9874,6,2,34657,34657,34659,0,2,5
9875,1,3,34658,34659,34662,1,4,0
9876,1,1,34659,34662,34663,3,4,0
9877,1,2,34660,34663,34665,3,5,0
9878,4,1,34664,34665,34666,1,2,0
9879,5,1,34669,34669,34670,0,1,3
9880,5,3,34674,34674,34677,0,3,4
9881,3,1,34677,34677,34678,0,1,0
9882,4,1,34681,34681,34682,0,1,3
9883,6,2,34687,34687,34689,0,2,5
9884,6,2,34693,34693,34695,0,2,4
9885,2,1,34695,34695,34696,0,1,0
9886,5,3,34700,34700,34703,0,3,4
9887,1,3,34701,34703,34706,2,5,0
9888,6,1,34707,34707,34708,0,1,1
9889,4,2,34711,34711,34713,0,2,3
9890,3,1,34714,34714,34715,0,1,1
9891,5,1,34719,34719,34720,0,1,4
9892,4,2,34723,34723,34725,0,2,3
9893,3,2,34726,34726,34728,0,2,1
9894,6,2,34732,34732,34734,0,2,4
9895,3,1,34735,34735,34736,0,1,1
9896,5,3,34740,34740,34743,0,3,4
9897,5,2,34745,34745,34747,0,2,2
9898,4,3,34749,34749,34752,0,3,2
9899,1,3,34750,34752,34755,2,5,0
9900,4,3,34754,34755,34758,1,4,0
9901,1,2,34755,34758,34760,3,5,0
9902,1,1,34756,34760,34761,4,5,0
9903,1,1,34757,34761,34762,4,5,0
9904,4,2,34761,34762,34764,1,3,0
9905,5,1,34766,34766,34767,0,1,2
9906,2,1,34768,34768,34769,0,1,1
9907,2,3,34770,34770,34773,0,3,1
9908,1,2,34771,34773,34775,2,4,0
9909,6,1,34777,34777,34778,0,1,2
9910,4,3,34781,34781,34784,0,3,3
9911,6,3,34787,34787,34790,0,3,3
9912,3,2,34790,34790,34792,0,2,0
9913,2,2,34792,34792,34794,0,2,0
9914,2,2,34794,34794,34796,0,2,0
9915,2,2,34796,34796,34798,0,2,0
9916,4,2,34800,34800,34802,0,2,2
9917,3,3,34803,34803,34806,0,3,1
9918,6,1,34809,34809,34810,0,1,3
9919,2,1,34811,34811,34812,0,1,1
9920,2,1,34813,34813,34814,0,1,1
9921,3,2,34816,34816,34818,0,2,2
9922,5,1,34821,34821,34822,0,1,3
9923,6,1,34827,34827,34828,0,1,5
9924,4,1,34831,34831,34832,0,1,3
9925,6,1,34837,34837,34838,0,1,5
9926,1,2,34838,34838,34840,0,2,0
9927,4,3,34842,34842,34845,0,3,2
9928,5,2,34847,34847,34849,0,2,2
9929,4,2,34851,34851,34853,0,2,2
9930,5,3,34856,34856,34859,0,3,3
9931,5,1,34861,34861,34862,0,1,2
9932,6,2,34867,34867,34869,0,2,5
9933,3,3,34870,34870,34873,0,3,1
9934,2,1,34872,34873,34874,1,2,0
9935,1,1,34873,34874,34875,1,2,0
9936,3,3,34876,34876,34879,0,3,1
9937,1,3,34877,34879,34882,2,5,0
9938,4,2,34881,34882,34884,1,3,0
9939,5,1,34886,34886,34887,0,1,2
9940,5,3,34891,34891,34894,0,3,4
9941,4,1,34895,34895,34896,0,1,1
9942,3,3,34898,34898,34901,0,3,2
9943,5,1,34903,34903,34904,0,1,2
9944,3,1,34906,34906,34907,0,1,2
9945,5,3,34911,34911,34914,0,3,4
9946,6,2,34917,34917,34919,0,2,3
9947,4,3,34921,34921,34924,0,3,2
9948,6,2,34927,34927,34929,0,2,3
9949,2,1,34929,34929,34930,0,1,0
9950,2,1,34931,34931,34932,0,1,1
9951,5,2,34936,34936,34938,0,2,4
9952,5,2,34941,34941,34943,0,2,3
9953,4,2,34945,34945,34947,0,2,2
9954,1,2,34946,34947,34949,1,3,0
9955,3,3,34949,34949,34952,0,3,0
9956,5,1,34954,34954,34955,0,1,2
9957,5,3,34959,34959,34962,0,3,4
9958,5,3,34964,34964,34967,0,3,2
9959,3,3,34967,34967,34970,0,3,0
9960,5,1,34972,34972,34973,0,1,2
9961,6,2,34978,34978,34980,0,2,5
9962,2,3,34980,34980,34983,0,3,0
9963,4,1,34984,34984,34985,0,1,1
9964,2,2,34986,34986,34988,0,2,1
9965,4,1,34990,34990,34991,0,1,2
9966,3,3,34993,34993,34996,0,3,2
9967,3,3,34996,34996,34999,0,3,0
9968,6,2,35002,35002,35004,0,2,3
9969,5,3,35007,35007,35010,0,3,3
9970,6,2,35013,35013,35015,0,2,3
9971,4,1,35017,35017,35018,0,1,2
9972,5,1,35022,35022,35023,0,1,4
9973,5,2,35027,35027,35029,0,2,4
9974,2,2,35029,35029,35031,0,2,0
9975,1,3,35030,35031,35034,1,4,0
9976,5,2,35035,35035,35037,0,2,1
9977,1,3,35036,35037,35040,1,4,0
9978,1,2,35037,35040,35042,3,5,0
9979,1,2,35038,35042,35044,4,6,0
9980,2,3,35040,35044,35047,4,7,0
9981,3,1,35043,35047,35048,4,5,0
9982,3,3,35046,35048,35051,2,5,0
9983,1,3,35047,35051,35054,4,7,0
9984,6,1,35053,35054,35055,1,2,0
9985,5,2,35058,35058,35060,0,2,3
9986,5,1,35063,35063,35064,0,1,3
9987,4,1,35067,35067,35068,0,1,3
9988,5,3,35072,35072,35075,0,3,4
9989,1,1,35073,35075,35076,2,3,0
9990,6,1,35079,35079,35080,0,1,3
9991,2,2,35081,35081,35083,0,2,1
9992,2,2,35083,35083,35085,0,2,0
9993,4,1,35087,35087,35088,0,1,2
9994,4,1,35091,35091,35092,0,1,3
9995,5,1,35096,35096,35097,0,1,4
9996,2,1,35098,35098,35099,0,1,1
9997,3,1,35101,35101,35102,0,1,2
9998,5,3,35106,35106,35109,0,3,4
9999,3,2,35109,35109,35111,0,2,0
10000,6,3,35115,35115,35118,0,3,4
10001,1,1,35116,35118,35119,2,3,0
10002,5,3,35121,35121,35124,0,3,2
10003,6,2,35127,35127,35129,0,2,3
10004,6,3,35133,35133,35136,0,3,4
10005,3,2,35136,35136,35138,0,2,0
10006,4,2,35140,35140,35142,0,2,2
10007,4,2,35144,35144,35146,0,2,2
10008,6,1,35150,35150,35151,0,1,4
10009,3,3,35153,35153,35156,0,3,2
10010,3,2,35156,35156,35158,0,2,0
10011,2,3,35158,35158,35161,0,3,0
10012,2,1,35160,35161,35162,1,2,0
10013,5,3,35165,35165,35168,0,3,3
10014,6,2,35171,35171,35173,0,2,3
10015,4,2,35175,35175,35177,0,2,2
10016,6,1,35181,35181,35182,0,1,4
10017,6,2,35187,35187,35189,0,2,5
10018,4,2,35191,35191,35193,0,2,2
10019,2,3,35193,35193,35196,0,3,0
10020,2,2,35195,35196,35198,1,3,0
10021,3,2,35198,35198,35200,0,2,0
10022,2,1,35200,35200,35201,0,1,0
10023,6,2,35206,35206,35208,0,2,5
10024,5,1,35211,35211,35212,0,1,3
10025,2,2,35213,35213,35215,0,2,1
10026,5,2,35218,35218,35220,0,2,3
10027,2,2,35220,35220,35222,0,2,0
10028,1,2,35221,35222,35224,1,3,0
10029,3,1,35224,35224,35225,0,1,0
10030,5,3,35229,35229,35232,0,3,4
10031,5,3,35234,35234,35237,0,3,2
10032,1,3,35235,35237,35240,2,5,0
10033,6,1,35241,35241,35242,0,1,1
10034,4,1,35245,35245,35246,0,1,3
10035,5,2,35250,35250,35252,0,2,4
10036,2,3,35252,35252,35255,0,3,0
10037,6,1,35258,35258,35259,0,1,3
10038,3,1,35261,35261,35262,0,1,2
10039,2,1,35263,35263,35264,0,1,1
10040,4,2,35267,35267,35269,0,2,3
10041,3,2,35270,35270,35272,0,2,1
10042,1,2,35271,35272,35274,1,3,0
10043,5,2,35276,35276,35278,0,2,2
10044,1,2,35277,35278,35280,1,3,0
10045,6,3,35283,35283,35286,0,3,3
10046,5,2,35288,35288,35290,0,2,2
10047,5,1,35293,35293,35294,0,1,3
10048,1,2,35294,35294,35296,0,2,0
10049,1,2,35295,35296,35298,1,3,0
10050,4,3,35299,35299,35302,0,3,1
10051,1,2,35300,35302,35304,2,4,0
10052,2,2,35302,35304,35306,2,4,0
10053,5,2,35307,35307,35309,0,2,1
10054,1,3,35308,35309,35312,1,4,0
10055,3,1,35311,35312,35313,1,2,0
10056,6,1,35317,35317,35318,0,1,4
10057,1,3,35318,35318,35321,0,3,0
10058,3,3,35321,35321,35324,0,3,0
10059,3,3,35324,35324,35327,0,3,0
10060,6,1,35330,35330,35331,0,1,3
10061,5,2,35335,35335,35337,0,2,4
10062,4,2,35339,35339,35341,0,2,2
10063,4,3,35343,35343,35346,0,3,2
10064,3,1,35346,35346,35347,0,1,0
10065,6,3,35352,35352,35355,0,3,5
10066,2,2,35354,35355,35357,1,3,0
10067,6,3,35360,35360,35363,0,3,3
10068,5,3,35365,35365,35368,0,3,2
10069,5,2,35370,35370,35372,0,2,2
10070,5,3,35375,35375,35378,0,3,3
10071,3,3,35378,35378,35381,0,3,0
10072,2,1,35380,35381,35382,1,2,0
10073,2,1,35382,35382,35383,0,1,0
10074,4,2,35386,35386,35388,0,2,3
10075,5,3,35391,35391,35394,0,3,3
10076,6,1,35397,35397,35398,0,1,3
10077,5,1,35402,35402,35403,0,1,4
10078,3,1,35405,35405,35406,0,1,2
10079,4,3,35409,35409,35412,0,3,3
10080,5,3,35414,35414,35417,0,3,2
10081,2,2,35416,35417,35419,1,3,0
10082,1,2,35417,35419,35421,2,4,0
10083,3,2,35420,35421,35423,1,3,0
10084,4,3,35424,35424,35427,0,3,1
10085,2,3,35426,35427,35430,1,4,0
10086,3,2,35429,35430,35432,1,3,0
10087,3,3,35432,35432,35435,0,3,0
10088,6,1,35438,35438,35439,0,1,3
10089,5,2,35443,35443,35445,0,2,4
10090,1,2,35444,35445,35447,1,3,0
10091,2,1,35446,35447,35448,1,2,0
10092,3,2,35449,35449,35451,0,2,1
10093,6,3,35455,35455,35458,0,3,4
10094,1,2,35456,35458,35460,2,4,0
10095,3,3,35459,35460,35463,1,4,0
10096,2,1,35461,35463,35464,2,3,0
10097,3,2,35464,35464,35466,0,2,0
10098,6,2,35470,35470,35472,0,2,4
10099,6,1,35476,35476,35477,0,1,4
10100,5,2,35481,35481,35483,0,2,4
10101,3,3,35484,35484,35487,0,3,1
10102,1,1,35485,35487,35488,2,3,0
10103,4,2,35489,35489,35491,0,2,1
10104,3,3,35492,35492,35495,0,3,1
10105,4,2,35496,35496,35498,0,2,1
10106,4,1,35500,35500,35501,0,1,2
10107,4,3,35504,35504,35507,0,3,3
10108,1,2,35505,35507,35509,2,4,0
10109,1,3,35506,35509,35512,3,6,0
10110,4,3,35510,35512,35515,2,5,0
10111,4,2,35514,35515,35517,1,3,0
10112,6,1,35520,35520,35521,0,1,3
10113,3,2,35523,35523,35525,0,2,2
10114,2,3,35525,35525,35528,0,3,0
10115,4,1,35529,35529,35530,0,1,1
10116,2,2,35531,35531,35533,0,2,1
10117,1,2,35532,35533,35535,1,3,0
10118,6,2,35538,35538,35540,0,2,3
10119,1,1,35539,35540,35541,1,2,0
10120,5,2,35544,35544,35546,0,2,3
10121,3,1,35547,35547,35548,0,1,1
10122,2,3,35549,35549,35552,0,3,1
10123,2,1,35551,35552,35553,1,2,0
10124,1,2,35552,35553,35555,1,3,0
10125,2,3,35554,35555,35558,1,4,0
10126,6,1,35560,35560,35561,0,1,2
10127,2,1,35562,35562,35563,0,1,1
10128,6,1,35568,35568,35569,0,1,5
10129,2,1,35570,35570,35571,0,1,1
10130,3,3,35573,35573,35576,0,3,2
10131,2,1,35575,35576,35577,1,2,0
10132,4,1,35579,35579,35580,0,1,2
10133,6,2,35585,35585,35587,0,2,5
10134,2,2,35587,35587,35589,0,2,0
10135,1,3,35588,35589,35592,1,4,0
10136,3,3,35591,35592,35595,1,4,0
10137,4,2,35595,35595,35597,0,2,0
10138,3,2,35598,35598,35600,0,2,1
10139,1,2,35599,35600,35602,1,3,0
10140,5,2,35604,35604,35606,0,2,2
10141,5,3,35609,35609,35612,0,3,3
10142,2,2,35611,35612,35614,1,3,0
10143,2,2,35613,35614,35616,1,3,0
10144,3,3,35616,35616,35619,0,3,0
10145,5,1,35621,35621,35622,0,1,2
10146,5,1,35626,35626,35627,0,1,4
10147,4,2,35630,35630,35632,0,2,3
10148,3,2,35633,35633,35635,0,2,1
10149,5,1,35638,35638,35639,0,1,3
10150,5,1,35643,35643,35644,0,1,4
10151,2,3,35645,35645,35648,0,3,1
10152,3,2,35648,35648,35650,0,2,0
10153,2,2,35650,35650,35652,0,2,0
10154,3,3,35653,35653,35656,0,3,1
10155,5,2,35658,35658,35660,0,2,2
10156,6,1,35664,35664,35665,0,1,4
10157,5,3,35669,35669,35672,0,3,4
10158,2,2,35671,35672,35674,1,3,0
10159,2,2,35673,35674,35676,1,3,0
10160,5,3,35678,35678,35681,0,3,2
10161,2,3,35680,35681,35684,1,4,0
10162,6,2,35686,35686,35688,0,2,2
10163,5,2,35691,35691,35693,0,2,3
10164,6,2,35697,35697,35699,0,2,4
10165,4,3,35701,35701,35704,0,3,2
10166,1,1,35702,35704,35705,2,3,0
10167,4,3,35706,35706,35709,0,3,1
10168,4,2,35710,35710,35712,0,2,1
10169,2,3,35712,35712,35715,0,3,0
10170,3,2,35715,35715,35717,0,2,0
10171,4,1,35719,35719,35720,0,1,2
10172,6,1,35725,35725,35726,0,1,5
10173,6,1,35731,35731,35732,0,1,5
10174,3,2,35734,35734,35736,0,2,2
10175,4,3,35738,35738,35741,0,3,2
10176,6,3,35744,35744,35747,0,3,3
10177,3,3,35747,35747,35750,0,3,0
10178,2,1,35749,35750,35751,1,2,0
10179,2,3,35751,35751,35754,0,3,0
10180,5,2,35756,35756,35758,0,2,2
10181,3,3,35759,35759,35762,0,3,1
10182,5,3,35764,35764,35767,0,3,2
10183,2,1,35766,35767,35768,1,2,0
10184,2,3,35768,35768,35771,0,3,0
10185,5,1,35773,35773,35774,0,1,2
10186,4,3,35777,35777,35780,0,3,3
10187,6,1,35783,35783,35784,0,1,3
10188,1,2,35784,35784,35786,0,2,0
10189,3,3,35787,35787,35790,0,3,1
10190,6,1,35793,35793,35794,0,1,3
10191,5,2,35798,35798,35800,0,2,4
10192,4,2,35802,35802,35804,0,2,2
10193,2,1,35804,35804,35805,0,1,0
10194,6,2,35810,35810,35812,0,2,5
10195,6,1,35816,35816,35817,0,1,4
10196,3,1,35819,35819,35820,0,1,2
10197,3,2,35822,35822,35824,0,2,2
10198,6,1,35828,35828,35829,0,1,4
10199,3,1,35831,35831,35832,0,1,2
10200,3,1,35834,35834,35835,0,1,2
10201,5,2,35839,35839,35841,0,2,4
10202,1,3,35840,35841,35844,1,4,0
10203,4,3,35844,35844,35847,0,3,0
10204,5,2,35849,35849,35851,0,2,2
10205,4,2,35853,35853,35855,0,2,2
10206,6,3,35859,35859,35862,0,3,4
10207,1,2,35860,35862,35864,2,4,0
10208,6,3,35866,35866,35869,0,3,2
10209,6,3,35872,35872,35875,0,3,3
10210,1,1,35873,35875,35876,2,3,0
10211,3,3,35876,35876,35879,0,3,0
10212,3,1,35879,35879,35880,0,1,0
10213,3,2,35882,35882,35884,0,2,2
10214,3,3,35885,35885,35888,0,3,1
10215,2,2,35887,35888,35890,1,3,0
10216,2,1,35889,35890,35891,1,2,0
10217,3,3,35892,35892,35895,0,3,1
10218,4,3,35896,35896,35899,0,3,1
10219,2,3,35898,35899,35902,1,4,0
10220,1,3,35899,35902,35905,3,6,0
10221,2,3,35901,35905,35908,4,7,0
10222,3,1,35904,35908,35909,4,5,0
10223,6,3,35910,35910,35913,0,3,1
10224,1,2,35911,35913,35915,2,4,0
10225,1,3,35912,35915,35918,3,6,0
10226,5,2,35917,35918,35920,1,3,0
10227,1,3,35918,35920,35923,2,5,0
10228,4,1,35922,35923,35924,1,2,0
10229,6,3,35928,35928,35931,0,3,4
10230,4,3,35932,35932,35935,0,3,1
10231,6,3,35938,35938,35941,0,3,3
10232,3,1,35941,35941,35942,0,1,0
10233,5,3,35946,35946,35949,0,3,4
10234,3,3,35949,35949,35952,0,3,0
10235,5,2,35954,35954,35956,0,2,2
10236,2,3,35956,35956,35959,0,3,0
10237,1,1,35957,35959,35960,2,3,0
10238,5,3,35962,35962,35965,0,3,2
10239,2,2,35964,35965,35967,1,3,0
10240,2,1,35966,35967,35968,1,2,0
10241,2,3,35968,35968,35971,0,3,0
10242,3,2,35971,35971,35973,0,2,0
10243,6,2,35977,35977,35979,0,2,4
10244,3,2,35980,35980,35982,0,2,1
10245,1,2,35981,35982,35984,1,3,0
10246,3,1,35984,35984,35985,0,1,0
10247,3,2,35987,35987,35989,0,2,2
10248,6,3,35993,35993,35996,0,3,4
10249,2,1,35995,35996,35997,1,2,0
10250,4,1,35999,35999,36000,0,1,2
10251,4,1,36003,36003,36004,0,1,3
10252,4,3,36007,36007,36010,0,3,3
10253,3,3,36010,36010,36013,0,3,0
10254,3,1,36013,36013,36014,0,1,0
10255,5,3,36018,36018,36021,0,3,4
10256,4,1,36022,36022,36023,0,1,1
10257,3,1,36025,36025,36026,0,1,2
10258,5,2,36030,36030,36032,0,2,4
10259,6,3,36036,36036,36039,0,3,4
10260,5,3,36041,36041,36044,0,3,2
10261,6,3,36047,36047,36050,0,3,3
10262,5,2,36052,36052,36054,0,2,2
10263,5,1,36057,36057,36058,0,1,3
10264,3,2,36060,36060,36062,0,2,2
10265,6,3,36066,36066,36069,0,3,4
10266,2,2,36068,36069,36071,1,3,0
10267,5,2,36073,36073,36075,0,2,2
10268,5,2,36078,36078,36080,0,2,3
10269,5,3,36083,36083,36086,0,3,3
10270,5,3,36088,36088,36091,0,3,2
10271,4,1,36092,36092,36093,0,1,1
10272,4,2,36096,36096,36098,0,2,3
10273,5,1,36101,36101,36102,0,1,3
10274,5,1,36106,36106,36107,0,1,4
10275,2,2,36108,36108,36110,0,2,1
10276,6,1,36114,36114,36115,0,1,4
10277,4,2,36118,36118,36120,0,2,3
10278,3,3,36121,36121,36124,0,3,1
10279,5,2,36126,36126,36128,0,2,2
10280,3,3,36129,36129,36132,0,3,1
10281,6,1,36135,36135,36136,0,1,3
10282,6,1,36141,36141,36142,0,1,5
10283,6,2,36147,36147,36149,0,2,5
10284,3,1,36150,36150,36151,0,1,1
10285,5,2,36155,36155,36157,0,2,4
10286,5,2,36160,36160,36162,0,2,3
10287,2,2,36162,36162,36164,0,2,0
10288,4,2,36166,36166,36168,0,2,2
10289,4,1,36170,36170,36171,0,1,2
10290,2,2,36172,36172,36174,0,2,1
10291,6,3,36178,36178,36181,0,3,4
10292,6,2,36184,36184,36186,0,2,3
10293,2,2,36186,36186,36188,0,2,0
10294,3,2,36189,36189,36191,0,2,1
10295,5,1,36194,36194,36195,0,1,3
10296,4,3,36198,36198,36201,0,3,3
10297,5,2,36203,36203,36205,0,2,2
10298,2,2,36205,36205,36207,0,2,0
10299,3,3,36208,36208,36211,0,3,1
10300,4,3,36212,36212,36215,0,3,1
10301,5,1,36217,36217,36218,0,1,2
10302,2,3,36219,36219,36222,0,3,1
10303,3,3,36222,36222,36225,0,3,0
10304,3,1,36225,36225,36226,0,1,0
10305,3,3,36228,36228,36231,0,3,2
10306,1,2,36229,36231,36233,2,4,0
10307,6,2,36235,36235,36237,0,2,2
10308,6,1,36241,36241,36242,0,1,4
10309,6,2,36247,36247,36249,0,2,5
10310,5,2,36252,36252,36254,0,2,3
10311,3,2,36255,36255,36257,0,2,1
10312,6,2,36261,36261,36263,0,2,4
10313,2,1,36263,36263,36264,0,1,0
10314,1,2,36264,36264,36266,0,2,0
10315,4,1,36268,36268,36269,0,1,2
10316,1,2,36269,36269,36271,0,2,0
10317,4,2,36273,36273,36275,0,2,2
10318,2,3,36275,36275,36278,0,3,0
10319,1,2,36276,36278,36280,2,4,0
10320,3,3,36279,36280,36283,1,4,0
10321,5,3,36284,36284,36287,0,3,1
10322,6,3,36290,36290,36293,0,3,3
10323,4,1,36294,36294,36295,0,1,1
10324,4,3,36298,36298,36301,0,3,3
10325,2,1,36300,36301,36302,1,2,0
10326,1,1,36301,36302,36303,1,2,0
10327,2,1,36303,36303,36304,0,1,0
10328,2,3,36305,36305,36308,0,3,1
10329,2,1,36307,36308,36309,1,2,0
10330,4,3,36311,36311,36314,0,3,2
10331,4,3,36315,36315,36318,0,3,1
10332,4,2,36319,36319,36321,0,2,1
10333,3,2,36322,36322,36324,0,2,1
10334,2,1,36324,36324,36325,0,1,0
10335,6,1,36330,36330,36331,0,1,5
10336,1,3,36331,36331,36334,0,3,0
10337,3,1,36334,36334,36335,0,1,0
10338,2,1,36336,36336,36337,0,1,1
10339,6,1,36342,36342,36343,0,1,5
10340,5,1,36347,36347,36348,0,1,4
10341,2,1,36349,36349,36350,0,1,1
10342,4,2,36353,36353,36355,0,2,3
10343,3,1,36356,36356,36357,0,1,1
10344,2,2,36358,36358,36360,0,2,1
10345,3,2,36361,36361,36363,0,2,1
10346,1,1,36362,36363,36364,1,2,0
10347,3,2,36365,36365,36367,0,2,1
10348,2,2,36367,36367,36369,0,2,0
10349,4,2,36371,36371,36373,0,2,2
10350,1,1,36372,36373,36374,1,2,0
10351,2,2,36374,36374,36376,0,2,0
10352,1,3,36375,36376,36379,1,4,0
10353,5,2,36380,36380,36382,0,2,1
10354,4,1,36384,36384,36385,0,1,2
10355,6,2,36390,36390,36392,0,2,5
10356,1,3,36391,36392,36395,1,4,0
10357,5,3,36396,36396,36399,0,3,1
10358,5,2,36401,36401,36403,0,2,2
10359,3,3,36404,36404,36407,0,3,1
10360,3,1,36407,36407,36408,0,1,0
10361,5,2,36412,36412,36414,0,2,4
10362,4,2,36416,36416,36418,0,2,2
10363,1,2,36417,36418,36420,1,3,0
10364,4,2,36421,36421,36423,0,2,1
10365,1,2,36422,36423,36425,1,3,0
10366,3,3,36425,36425,36428,0,3,0
10367,5,1,36430,36430,36431,0,1,2
10368,2,3,36432,36432,36435,0,3,1
10369,5,3,36437,36437,36440,0,3,2
10370,5,1,36442,36442,36443,0,1,2
10371,3,3,36445,36445,36448,0,3,2
10372,1,2,36446,36448,36450,2,4,0
10373,3,2,36449,36450,36452,1,3,0
10374,6,3,36455,36455,36458,0,3,3
10375,4,3,36459,36459,36462,0,3,1
10376,4,1,36463,36463,36464,0,1,1
10377,6,3,36469,36469,36472,0,3,5
10378,2,3,36471,36472,36475,1,4,0
10379,6,2,36477,36477,36479,0,2,2
10380,4,1,36481,36481,36482,0,1,2
10381,2,1,36483,36483,36484,0,1,1
10382,5,3,36488,36488,36491,0,3,4
10383,4,3,36492,36492,36495,0,3,1
10384,3,2,36495,36495,36497,0,2,0
10385,1,1,36496,36497,36498,1,2,0
10386,6,2,36502,36502,36504,0,2,4
10387,2,3,36504,36504,36507,0,3,0
10388,3,1,36507,36507,36508,0,1,0
10389,3,1,36510,36510,36511,0,1,2
10390,2,2,36512,36512,36514,0,2,1
10391,3,2,36515,36515,36517,0,2,1
10392,4,3,36519,36519,36522,0,3,2
10393,6,1,36525,36525,36526,0,1,3
10394,2,1,36527,36527,36528,0,1,1
10395,5,2,36532,36532,36534,0,2,4
10396,6,3,36538,36538,36541,0,3,4
10397,4,3,36542,36542,36545,0,3,1
10398,1,1,36543,36545,36546,2,3,0
10399,5,3,36548,36548,36551,0,3,2
10400,2,2,36550,36551,36553,1,3,0
10401,1,1,36551,36553,36554,2,3,0
10402,4,3,36555,36555,36558,0,3,1
10403,3,2,36558,36558,36560,0,2,0
10404,4,3,36562,36562,36565,0,3,2
10405,1,2,36563,36565,36567,2,4,0
10406,5,2,36568,36568,36570,0,2,1
10407,2,1,36570,36570,36571,0,1,0
10408,2,1,36572,36572,36573,0,1,1
10409,4,2,36576,36576,36578,0,2,3
10410,5,2,36581,36581,36583,0,2,3
10411,6,1,36587,36587,36588,0,1,4
10412,4,3,36591,36591,36594,0,3,3
10413,6,1,36597,36597,36598,0,1,3
10414,3,2,36600,36600,36602,0,2,2
10415,5,3,36605,36605,36608,0,3,3
10416,4,2,36609,36609,36611,0,2,1
10417,5,2,36614,36614,36616,0,2,3
10418,4,3,36618,36618,36621,0,3,2
10419,2,1,36620,36621,36622,1,2,0
10420,3,2,36623,36623,36625,0,2,1
10421,3,3,36626,36626,36629,0,3,1
10422,1,1,36627,36629,36630,2,3,0
10423,4,3,36631,36631,36634,0,3,1
10424,4,1,36635,36635,36636,0,1,1
10425,5,3,36640,36640,36643,0,3,4
10426,4,3,36644,36644,36647,0,3,1
10427,3,3,36647,36647,36650,0,3,0
10428,3,1,36650,36650,36651,0,1,0
10429,4,3,36654,36654,36657,0,3,3
10430,3,3,36657,36657,36660,0,3,0
10431,2,2,36659,36660,36662,1,3,0
10432,6,1,36665,36665,36666,0,1,3
10433,6,3,36671,36671,36674,0,3,5
10434,3,2,36674,36674,36676,0,2,0
10435,4,2,36678,36678,36680,0,2,2
10436,4,2,36682,36682,36684,0,2,2
10437,2,2,36684,36684,36686,0,2,0
10438,4,1,36688,36688,36689,0,1,2
10439,2,2,36690,36690,36692,0,2,1
10440,4,1,36694,36694,36695,0,1,2
10441,4,3,36698,36698,36701,0,3,3
10442,5,1,36703,36703,36704,0,1,2
10443,6,2,36709,36709,36711,0,2,5
10444,2,1,36711,36711,36712,0,1,0
10445,5,3,36716,36716,36719,0,3,4
10446,1,3,36717,36719,36722,2,5,0
10447,4,3,36721,36722,36725,1,4,0
10448,6,1,36727,36727,36728,0,1,2
10449,5,3,36732,36732,36735,0,3,4
10450,5,2,36737,36737,36739,0,2,2
10451,4,2,36741,36741,36743,0,2,2
10452,3,2,36744,36744,36746,0,2,1
10453,3,1,36747,36747,36748,0,1,1
10454,2,3,36749,36749,36752,0,3,1
10455,1,1,36750,36752,36753,2,3,0
10456,4,3,36754,36754,36757,0,3,1
10457,4,1,36758,36758,36759,0,1,1
10458,5,1,36763,36763,36764,0,1,4
10459,6,2,36769,36769,36771,0,2,5
10460,2,3,36771,36771,36774,0,3,0
10461,2,3,36773,36774,36777,1,4,0
10462,4,3,36777,36777,36780,0,3,0
10463,3,1,36780,36780,36781,0,1,0
10464,5,3,36785,36785,36788,0,3,4
10465,5,2,36790,36790,36792,0,2,2
10466,5,2,36795,36795,36797,0,2,3
10467,2,3,36797,36797,36800,0,3,0
10468,6,3,36803,36803,36806,0,3,3
10469,1,3,36804,36806,36809,2,5,0
10470,6,1,36810,36810,36811,0,1,1
10471,6,1,36816,36816,36817,0,1,5
10472,2,3,36818,36818,36821,0,3,1
10473,2,3,36820,36821,36824,1,4,0
10474,1,3,36821,36824,36827,3,6,0
10475,3,3,36824,36827,36830,3,6,0
10476,5,3,36829,36830,36833,1,4,0
10477,4,2,36833,36833,36835,0,2,0
10478,1,3,36834,36835,36838,1,4,0
10479,3,1,36837,36838,36839,1,2,0
10480,3,2,36840,36840,36842,0,2,1
10481,2,2,36842,36842,36844,0,2,0
10482,6,1,36848,36848,36849,0,1,4
10483,2,3,36850,36850,36853,0,3,1
10484,4,2,36854,36854,36856,0,2,1
10485,2,1,36856,36856,36857,0,1,0
10486,4,1,36860,36860,36861,0,1,3
10487,4,2,36864,36864,36866,0,2,3
10488,1,1,36865,36866,36867,1,2,0
10489,6,3,36871,36871,36874,0,3,4
10490,3,2,36874,36874,36876,0,2,0
10491,6,2,36880,36880,36882,0,2,4
10492,3,2,36883,36883,36885,0,2,1
10493,3,3,36886,36886,36889,0,3,1
10494,2,1,36888,36889,36890,1,2,0
10495,1,1,36889,36890,36891,1,2,0
10496,2,2,36891,36891,36893,0,2,0
10497,5,3,36896,36896,36899,0,3,3
10498,2,1,36898,36899,36900,1,2,0
10499,3,3,36901,36901,36904,0,3,1
10500,1,1,36902,36904,36905,2,3,0
10501,3,3,36905,36905,36908,0,3,0
10502,3,1,36908,36908,36909,0,1,0
10503,3,1,36911,36911,36912,0,1,2
10504,1,3,36912,36912,36915,0,3,0
10505,4,2,36916,36916,36918,0,2,1
10506,6,3,36922,36922,36925,0,3,4
10507,6,2,36928,36928,36930,0,2,3
10508,1,2,36929,36930,36932,1,3,0
10509,4,2,36933,36933,36935,0,2,1
10510,2,2,36935,36935,36937,0,2,0
10511,2,3,36937,36937,36940,0,3,0
10512,3,2,36940,36940,36942,0,2,0
10513,1,1,36941,36942,36943,1,2,0
10514,5,3,36946,36946,36949,0,3,3
10515,1,3,36947,36949,36952,2,5,0
10516,5,3,36952,36952,36955,0,3,0
10517,4,2,36956,36956,36958,0,2,1
10518,3,2,36959,36959,36961,0,2,1
10519,3,3,36962,36962,36965,0,3,1
10520,6,2,36968,36968,36970,0,2,3
10521,5,1,36973,36973,36974,0,1,3
10522,4,3,36977,36977,36980,0,3,3
10523,4,3,36981,36981,36984,0,3,1
10524,1,3,36982,36984,36987,2,5,0
10525,6,2,36988,36988,36990,0,2,1
10526,6,3,36994,36994,36997,0,3,4
10527,4,2,36998,36998,37000,0,2,1
10528,2,1,37000,37000,37001,0,1,0
10529,3,1,37003,37003,37004,0,1,2
10530,4,3,37007,37007,37010,0,3,3
10531,6,2,37013,37013,37015,0,2,3
10532,6,1,37019,37019,37020,0,1,4
10533,2,2,37021,37021,37023,0,2,1
10534,2,1,37023,37023,37024,0,1,0
10535,6,1,37029,37029,37030,0,1,5
10536,6,2,37035,37035,37037,0,2,5
10537,5,3,37040,37040,37043,0,3,3
10538,1,3,37041,37043,37046,2,5,0
10539,6,3,37047,37047,37050,0,3,1
10540,2,2,37049,37050,37052,1,3,0
10541,1,2,37050,37052,37054,2,4,0
10542,2,3,37052,37054,37057,2,5,0
10543,4,3,37056,37057,37060,1,4,0
10544,2,1,37058,37060,37061,2,3,0
10545,3,3,37061,37061,37064,0,3,0
10546,4,1,37065,37065,37066,0,1,1
10547,2,1,37067,37067,37068,0,1,1
10548,1,3,37068,37068,37071,0,3,0
10549,1,2,37069,37071,37073,2,4,0
10550,1,1,37070,37073,37074,3,4,0
10551,2,2,37072,37074,37076,2,4,0
10552,1,1,37073,37076,37077,3,4,0
10553,6,2,37079,37079,37081,0,2,2
10554,2,2,37081,37081,37083,0,2,0
10555,1,1,37082,37083,37084,1,2,0
10556,4,1,37086,37086,37087,0,1,2
10557,1,1,37087,37087,37088,0,1,0
10558,3,2,37090,37090,37092,0,2,2
10559,5,3,37095,37095,37098,0,3,3
10560,3,1,37098,37098,37099,0,1,0
10561,4,3,37102,37102,37105,0,3,3
10562,6,3,37108,37108,37111,0,3,3
10563,5,3,37113,37113,37116,0,3,2
10564,3,2,37116,37116,37118,0,2,0
10565,5,3,37121,37121,37124,0,3,3
10566,4,1,37125,37125,37126,0,1,1
10567,6,2,37131,37131,37133,0,2,5
10568,6,2,37137,37137,37139,0,2,4
10569,1,1,37138,37139,37140,1,2,0
10570,1,3,37139,37140,37143,1,4,0
10571,1,2,37140,37143,37145,3,5,0
10572,5,1,37145,37145,37146,0,1,0
10573,5,3,37150,37150,37153,0,3,4
10574,4,1,37154,37154,37155,0,1,1
10575,2,2,37156,37156,37158,0,2,1
10576,2,1,37158,37158,37159,0,1,0
10577,1,3,37159,37159,37162,0,3,0
10578,1,2,37160,37162,37164,2,4,0
10579,6,1,37166,37166,37167,0,1,2
10580,5,3,37171,37171,37174,0,3,4
10581,4,2,37175,37175,37177,0,2,1
10582,1,2,37176,37177,37179,1,3,0
10583,4,3,37180,37180,37183,0,3,1
10584,6,3,37186,37186,37189,0,3,3
10585,3,3,37189,37189,37192,0,3,0
10586,3,3,37192,37192,37195,0,3,0
10587,2,1,37194,37195,37196,1,2,0
10588,2,1,37196,37196,37197,0,1,0
10589,3,1,37199,37199,37200,0,1,2
10590,2,3,37201,37201,37204,0,3,1
10591,5,3,37206,37206,37209,0,3,2
10592,1,3,37207,37209,37212,2,5,0
10593,5,1,37212,37212,37213,0,1,0
10594,3,2,37215,37215,37217,0,2,2
10595,1,1,37216,37217,37218,1,2,0
10596,1,1,37217,37218,37219,1,2,0
10597,1,3,37218,37219,37222,1,4,0
10598,3,3,37221,37222,37225,1,4,0
10599,2,3,37223,37225,37228,2,5,0
10600,4,2,37227,37228,37230,1,3,0
10601,4,3,37231,37231,37234,0,3,1
10602,6,3,37237,37237,37240,0,3,3
10603,4,3,37241,37241,37244,0,3,1
10604,2,1,37243,37244,37245,1,2,0
10605,6,2,37249,37249,37251,0,2,4
10606,5,2,37254,37254,37256,0,2,3
10607,4,1,37258,37258,37259,0,1,2
10608,5,1,37263,37263,37264,0,1,4
10609,2,2,37265,37265,37267,0,2,1
10610,3,3,37268,37268,37271,0,3,1
10611,5,3,37273,37273,37276,0,3,2
10612,6,1,37279,37279,37280,0,1,3
10613,1,2,37280,37280,37282,0,2,0
10614,5,1,37285,37285,37286,0,1,3
10615,6,3,37291,37291,37294,0,3,5
10616,4,2,37295,37295,37297,0,2,1
10617,6,3,37301,37301,37304,0,3,4
10618,3,2,37304,37304,37306,0,2,0
10619,3,1,37307,37307,37308,0,1,1
10620,3,3,37310,37310,37313,0,3,2
10621,2,1,37312,37313,37314,1,2,0
10622,6,1,37318,37318,37319,0,1,4
10623,6,3,37324,37324,37327,0,3,5
10624,1,1,37325,37327,37328,2,3,0
10625,2,2,37327,37328,37330,1,3,0
10626,3,3,37330,37330,37333,0,3,0
10627,1,3,37331,37333,37336,2,5,0
10628,4,3,37335,37336,37339,1,4,0
10629,4,3,37339,37339,37342,0,3,0
10630,4,1,37343,37343,37344,0,1,1
10631,6,3,37349,37349,37352,0,3,5
10632,4,3,37353,37353,37356,0,3,1
10633,1,1,37354,37356,37357,2,3,0
10634,4,3,37358,37358,37361,0,3,1
10635,3,3,37361,37361,37364,0,3,0
10636,1,3,37362,37364,37367,2,5,0
10637,3,1,37365,37367,37368,2,3,0
10638,6,1,37371,37371,37372,0,1,3
10639,1,1,37372,37372,37373,0,1,0
10640,4,2,37376,37376,37378,0,2,3
10641,4,1,37380,37380,37381,0,1,2
10642,3,3,37383,37383,37386,0,3,2
10643,6,1,37389,37389,37390,0,1,3
10644,6,2,37395,37395,37397,0,2,5
10645,6,2,37401,37401,37403,0,2,4
10646,3,1,37404,37404,37405,0,1,1
10647,4,3,37408,37408,37411,0,3,3
10648,1,3,37409,37411,37414,2,5,0
10649,3,1,37412,37414,37415,2,3,0
10650,4,1,37416,37416,37417,0,1,1
10651,1,3,37417,37417,37420,0,3,0
10652,3,3,37420,37420,37423,0,3,0
10653,5,1,37425,37425,37426,0,1,2
10654,6,1,37431,37431,37432,0,1,5
10655,6,2,37437,37437,37439,0,2,5
10656,3,3,37440,37440,37443,0,3,1
10657,6,1,37446,37446,37447,0,1,3
10658,1,1,37447,37447,37448,0,1,0
10659,3,3,37450,37450,37453,0,3,2
10660,1,3,37451,37453,37456,2,5,0
10661,6,1,37457,37457,37458,0,1,1
10662,4,1,37461,37461,37462,0,1,3
10663,1,1,37462,37462,37463,0,1,0
10664,1,3,37463,37463,37466,0,3,0
10665,5,1,37468,37468,37469,0,1,2
10666,6,1,37474,37474,37475,0,1,5
10667,2,3,37476,37476,37479,0,3,1
10668,1,2,37477,37479,37481,2,4,0
10669,4,2,37481,37481,37483,0,2,0
10670,4,2,37485,37485,37487,0,2,2
10671,4,1,37489,37489,37490,0,1,2
10672,3,3,37492,37492,37495,0,3,2
10673,3,2,37495,37495,37497,0,2,0
10674,3,3,37498,37498,37501,0,3,1
10675,2,2,37500,37501,37503,1,3,0
10676,1,1,37501,37503,37504,2,3,0
10677,6,1,37507,37507,37508,0,1,3
10678,3,3,37510,37510,37513,0,3,2
10679,6,3,37516,37516,37519,0,3,3
10680,4,2,37520,37520,37522,0,2,1
10681,2,3,37522,37522,37525,0,3,0
10682,3,3,37525,37525,37528,0,3,0
10683,3,2,37528,37528,37530,0,2,0
10684,1,3,37529,37530,37533,1,4,0
10685,4,3,37533,37533,37536,0,3,0
10686,1,2,37534,37536,37538,2,4,0
10687,4,1,37538,37538,37539,0,1,0
10688,3,1,37541,37541,37542,0,1,2
10689,4,1,37545,37545,37546,0,1,3
10690,6,3,37551,37551,37554,0,3,5
10691,5,1,37556,37556,37557,0,1,2
10692,2,3,37558,37558,37561,0,3,1
10693,3,3,37561,37561,37564,0,3,0
10694,5,2,37566,37566,37568,0,2,2
10695,4,3,37570,37570,37573,0,3,2
10696,4,2,37574,37574,37576,0,2,1
10697,5,2,37579,37579,37581,0,2,3
10698,2,1,37581,37581,37582,0,1,0
10699,2,2,37583,37583,37585,0,2,1
10700,4,2,37587,37587,37589,0,2,2
10701,6,3,37593,37593,37596,0,3,4
10702,6,1,37599,37599,37600,0,1,3
10703,2,3,37601,37601,37604,0,3,1
10704,4,3,37605,37605,37608,0,3,1
10705,3,3,37608,37608,37611,0,3,0
10706,2,3,37610,37611,37614,1,4,0
10707,1,2,37611,37614,37616,3,5,0
10708,6,2,37617,37617,37619,0,2,1
10709,4,2,37621,37621,37623,0,2,2
10710,5,2,37626,37626,37628,0,2,3
10711,1,1,37627,37628,37629,1,2,0
10712,3,3,37630,37630,37633,0,3,1
10713,4,1,37634,37634,37635,0,1,1
10714,6,3,37640,37640,37643,0,3,5
10715,6,3,37646,37646,37649,0,3,3
10716,2,3,37648,37649,37652,1,4,0
10717,4,3,37652,37652,37655,0,3,0
10718,6,2,37658,37658,37660,0,2,3
10719,5,1,37663,37663,37664,0,1,3
10720,5,3,37668,37668,37671,0,3,4
10721,2,1,37670,37671,37672,1,2,0
10722,5,1,37675,37675,37676,0,1,3
10723,6,1,37681,37681,37682,0,1,5
10724,4,1,37685,37685,37686,0,1,3
10725,6,2,37691,37691,37693,0,2,5
10726,6,2,37697,37697,37699,0,2,4
10727,3,2,37700,37700,37702,0,2,1
10728,6,3,37706,37706,37709,0,3,4
10729,3,3,37709,37709,37712,0,3,0
10730,5,1,37714,37714,37715,0,1,2
10731,4,1,37718,37718,37719,0,1,3
10732,3,3,37721,37721,37724,0,3,2
10733,2,2,37723,37724,37726,1,3,0
10734,6,1,37729,37729,37730,0,1,3
10735,4,1,37733,37733,37734,0,1,3
10736,3,3,37736,37736,37739,0,3,2
10737,4,3,37740,37740,37743,0,3,1
10738,4,2,37744,37744,37746,0,2,1
10739,4,3,37748,37748,37751,0,3,2
10740,1,3,37749,37751,37754,2,5,0
10741,1,2,37750,37754,37756,4,6,0
10742,4,3,37754,37756,37759,2,5,0
10743,5,1,37759,37759,37760,0,1,0
10744,3,2,37762,37762,37764,0,2,2
10745,3,2,37765,37765,37767,0,2,1
10746,2,2,37767,37767,37769,0,2,0
10747,1,2,37768,37769,37771,1,3,0
10748,5,1,37773,37773,37774,0,1,2
10749,1,3,37774,37774,37777,0,3,0
10750,3,1,37777,37777,37778,0,1,0
10751,4,3,37781,37781,37784,0,3,3
10752,6,3,37787,37787,37790,0,3,3
10753,4,3,37791,37791,37794,0,3,1
10754,6,2,37797,37797,37799,0,2,3
10755,1,1,37798,37799,37800,1,2,0
10756,1,2,37799,37800,37802,1,3,0
10757,4,2,37803,37803,37805,0,2,1
10758,5,3,37808,37808,37811,0,3,3
10759,6,3,37814,37814,37817,0,3,3
10760,3,2,37817,37817,37819,0,2,0
10761,3,1,37820,37820,37821,0,1,1
10762,5,1,37825,37825,37826,0,1,4
10763,3,1,37828,37828,37829,0,1,2
10764,4,3,37832,37832,37835,0,3,3
10765,4,3,37836,37836,37839,0,3,1
10766,2,1,37838,37839,37840,1,2,0
10767,3,3,37841,37841,37844,0,3,1
10768,4,3,37845,37845,37848,0,3,1
10769,1,1,37846,37848,37849,2,3,0
10770,3,2,37849,37849,37851,0,2,0
10771,1,1,37850,37851,37852,1,2,0
10772,2,3,37852,37852,37855,0,3,0
10773,2,3,37854,37855,37858,1,4,0
10774,5,2,37859,37859,37861,0,2,1
10775,5,3,37864,37864,37867,0,3,3
10776,2,1,37866,37867,37868,1,2,0
10777,6,3,37872,37872,37875,0,3,4
10778,2,3,37874,37875,37878,1,4,0
10779,6,2,37880,37880,37882,0,2,2
10780,3,2,37883,37883,37885,0,2,1
10781,4,3,37887,37887,37890,0,3,2
10782,4,3,37891,37891,37894,0,3,1
10783,5,1,37896,37896,37897,0,1,2
10784,5,1,37901,37901,37902,0,1,4
10785,1,2,37902,37902,37904,0,2,0
10786,5,3,37907,37907,37910,0,3,3
10787,5,3,37912,37912,37915,0,3,2
10788,6,1,37918,37918,37919,0,1,3
10789,1,2,37919,37919,37921,0,2,0
10790,3,3,37922,37922,37925,0,3,1
10791,4,3,37926,37926,37929,0,3,1
10792,1,1,37927,37929,37930,2,3,0
10793,2,1,37929,37930,37931,1,2,0
10794,3,3,37932,37932,37935,0,3,1
10795,5,2,37937,37937,37939,0,2,2
10796,5,1,37942,37942,37943,0,1,3
10797,5,2,37947,37947,37949,0,2,4
10798,4,2,37951,37951,37953,0,2,2
10799,4,3,37955,37955,37958,0,3,2
10800,6,1,37961,37961,37962,0,1,3
10801,4,1,37965,37965,37966,0,1,3
10802,3,3,37968,37968,37971,0,3,2
10803,2,2,37970,37971,37973,1,3,0
10804,3,3,37973,37973,37976,0,3,0
10805,2,3,37975,37976,37979,1,4,0
10806,5,3,37980,37980,37983,0,3,1
10807,4,3,37984,37984,37987,0,3,1
10808,3,2,37987,37987,37989,0,2,0
10809,2,3,37989,37989,37992,0,3,0
10810,4,1,37993,37993,37994,0,1,1
10811,3,3,37996,37996,37999,0,3,2
10812,6,3,38002,38002,38005,0,3,3
10813,5,2,38007,38007,38009,0,2,2
10814,4,1,38011,38011,38012,0,1,2
10815,3,1,38014,38014,38015,0,1,2
10816,5,1,38019,38019,38020,0,1,4
10817,5,3,38024,38024,38027,0,3,4
10818,5,3,38029,38029,38032,0,3,2
10819,1,2,38030,38032,38034,2,4,0
10820,1,1,38031,38034,38035,3,4,0
10821,6,3,38037,38037,38040,0,3,2
10822,5,2,38042,38042,38044,0,2,2
10823,1,1,38043,38044,38045,1,2,0
10824,5,1,38048,38048,38049,0,1,3
10825,4,1,38052,38052,38053,0,1,3
10826,6,2,38058,38058,38060,0,2,5
10827,5,2,38063,38063,38065,0,2,3
10828,1,2,38064,38065,38067,1,3,0
10829,6,2,38070,38070,38072,0,2,3
10830,5,2,38075,38075,38077,0,2,3
10831,6,1,38081,38081,38082,0,1,4
10832,2,3,38083,38083,38086,0,3,1
10833,5,2,38088,38088,38090,0,2,2
10834,1,3,38089,38090,38093,1,4,0
10835,1,2,38090,38093,38095,3,5,0
10836,1,3,38091,38095,38098,4,7,0
10837,6,3,38097,38098,38101,1,4,0
10838,3,3,38100,38101,38104,1,4,0
10839,5,3,38105,38105,38108,0,3,1
10840,2,3,38107,38108,38111,1,4,0
10841,4,3,38111,38111,38114,0,3,0
10842,6,2,38117,38117,38119,0,2,3
10843,5,1,38122,38122,38123,0,1,3
10844,5,2,38127,38127,38129,0,2,4
10845,4,3,38131,38131,38134,0,3,2
10846,3,1,38134,38134,38135,0,1,0
10847,2,1,38136,38136,38137,0,1,1
10848,3,1,38139,38139,38140,0,1,2
10849,2,2,38141,38141,38143,0,2,1
10850,3,2,38144,38144,38146,0,2,1
10851,2,2,38146,38146,38148,0,2,0
10852,2,1,38148,38148,38149,0,1,0
10853,5,3,38153,38153,38156,0,3,4
10854,2,1,38155,38156,38157,1,2,0
10855,6,1,38161,38161,38162,0,1,4
10856,4,3,38165,38165,38168,0,3,3
10857,2,1,38167,38168,38169,1,2,0
10858,1,3,38168,38169,38172,1,4,0
10859,2,3,38170,38172,38175,2,5,0
10860,6,2,38176,38176,38178,0,2,1
10861,3,3,38179,38179,38182,0,3,1
10862,5,3,38184,38184,38187,0,3,2
10863,1,2,38185,38187,38189,2,4,0
10864,2,2,38187,38189,38191,2,4,0
10865,4,2,38191,38191,38193,0,2,0
10866,5,3,38196,38196,38199,0,3,3
10867,6,2,38202,38202,38204,0,2,3
10868,1,1,38203,38204,38205,1,2,0
10869,2,1,38205,38205,38206,0,1,0
10870,3,3,38208,38208,38211,0,3,2
10871,3,2,38211,38211,38213,0,2,0
10872,4,2,38215,38215,38217,0,2,2
10873,3,1,38218,38218,38219,0,1,1
10874,2,1,38220,38220,38221,0,1,1
10875,2,2,38222,38222,38224,0,2,1
10876,2,1,38224,38224,38225,0,1,0
10877,4,1,38228,38228,38229,0,1,3
10878,1,2,38229,38229,38231,0,2,0
10879,1,3,38230,38231,38234,1,4,0
10880,4,2,38234,38234,38236,0,2,0
10881,4,1,38238,38238,38239,0,1,2
10882,6,2,38244,38244,38246,0,2,5
10883,5,2,38249,38249,38251,0,2,3
10884,6,3,38255,38255,38258,0,3,4
10885,4,1,38259,38259,38260,0,1,1
10886,6,1,38265,38265,38266,0,1,5
10887,4,3,38269,38269,38272,0,3,3
10888,6,3,38275,38275,38278,0,3,3
10889,6,3,38281,38281,38284,0,3,3
10890,1,1,38282,38284,38285,2,3,0
10891,6,3,38288,38288,38291,0,3,3
10892,5,2,38293,38293,38295,0,2,2
10893,5,3,38298,38298,38301,0,3,3
10894,3,2,38301,38301,38303,0,2,0
10895,5,2,38306,38306,38308,0,2,3
10896,2,3,38308,38308,38311,0,3,0
10897,6,1,38314,38314,38315,0,1,3
10898,2,2,38316,38316,38318,0,2,1
10899,3,3,38319,38319,38322,0,3,1
10900,2,1,38321,38322,38323,1,2,0
10901,2,3,38323,38323,38326,0,3,0
10902,1,2,38324,38326,38328,2,4,0
10903,6,3,38330,38330,38333,0,3,2
10904,4,3,38334,38334,38337,0,3,1
10905,3,2,38337,38337,38339,0,2,0
10906,6,1,38343,38343,38344,0,1,4
10907,5,2,38348,38348,38350,0,2,4
10908,5,2,38353,38353,38355,0,2,3
10909,2,3,38355,38355,38358,0,3,0
10910,1,2,38356,38358,38360,2,4,0
10911,3,2,38359,38360,38362,1,3,0
10912,3,3,38362,38362,38365,0,3,0
10913,2,2,38364,38365,38367,1,3,0
10914,5,3,38369,38369,38372,0,3,2
10915,2,2,38371,38372,38374,1,3,0
10916,6,3,38377,38377,38380,0,3,3
10917,6,3,38383,38383,38386,0,3,3
10918,1,2,38384,38386,38388,2,4,0
10919,4,1,38388,38388,38389,0,1,0
10920,1,1,38389,38389,38390,0,1,0
10921,5,2,38394,38394,38396,0,2,4
10922,6,2,38400,38400,38402,0,2,4
10923,4,3,38404,38404,38407,0,3,2
10924,1,3,38405,38407,38410,2,5,0
10925,5,1,38410,38410,38411,0,1,0
10926,3,2,38413,38413,38415,0,2,2
10927,2,2,38415,38415,38417,0,2,0
10928,5,3,38420,38420,38423,0,3,3
10929,2,3,38422,38423,38426,1,4,0
10930,3,3,38425,38426,38429,1,4,0
10931,6,2,38431,38431,38433,0,2,2
10932,5,2,38436,38436,38438,0,2,3
10933,6,1,38442,38442,38443,0,1,4
10934,3,3,38445,38445,38448,0,3,2
10935,5,2,38450,38450,38452,0,2,2
10936,1,1,38451,38452,38453,1,2,0
10937,2,2,38453,38453,38455,0,2,0
10938,4,3,38457,38457,38460,0,3,2
10939,4,1,38461,38461,38462,0,1,1
10940,4,1,38465,38465,38466,0,1,3
10941,4,1,38469,38469,38470,0,1,3
10942,3,3,38472,38472,38475,0,3,2
10943,3,3,38475,38475,38478,0,3,0
10944,3,1,38478,38478,38479,0,1,0
10945,1,3,38479,38479,38482,0,3,0
10946,3,1,38482,38482,38483,0,1,0
10947,6,3,38488,38488,38491,0,3,5
10948,5,2,38493,38493,38495,0,2,2
10949,2,3,38495,38495,38498,0,3,0
10950,4,1,38499,38499,38500,0,1,1
10951,1,1,38500,38500,38501,0,1,0
10952,5,2,38505,38505,38507,0,2,4
10953,5,3,38510,38510,38513,0,3,3
10954,3,2,38513,38513,38515,0,2,0
10955,4,1,38517,38517,38518,0,1,2
10956,1,3,38518,38518,38521,0,3,0
10957,2,3,38520,38521,38524,1,4,0
10958,6,3,38526,38526,38529,0,3,2
10959,2,3,38528,38529,38532,1,4,0
10960,1,3,38529,38532,38535,3,6,0
10961,6,1,38535,38535,38536,0,1,0
10962,4,1,38539,38539,38540,0,1,3
10963,2,1,38541,38541,38542,0,1,1
10964,6,2,38547,38547,38549,0,2,5
10965,5,3,38552,38552,38555,0,3,3
10966,2,2,38554,38555,38557,1,3,0
10967,4,1,38558,38558,38559,0,1,1
10968,4,2,38562,38562,38564,0,2,3
10969,3,2,38565,38565,38567,0,2,1
10970,6,2,38571,38571,38573,0,2,4
10971,4,3,38575,38575,38578,0,3,2
10972,2,1,38577,38578,38579,1,2,0
10973,5,3,38582,38582,38585,0,3,3
10974,6,1,38588,38588,38589,0,1,3
10975,1,2,38589,38589,38591,0,2,0
10976,3,3,38592,38592,38595,0,3,1
10977,2,1,38594,38595,38596,1,2,0
10978,5,3,38599,38599,38602,0,3,3
10979,3,3,38602,38602,38605,0,3,0
10980,5,3,38607,38607,38610,0,3,2
10981,4,3,38611,38611,38614,0,3,1
10982,1,1,38612,38614,38615,2,3,0
10983,1,3,38613,38615,38618,2,5,0
10984,4,3,38617,38618,38621,1,4,0
10985,5,1,38622,38622,38623,0,1,1
10986,3,1,38625,38625,38626,0,1,2
10987,1,3,38626,38626,38629,0,3,0
10988,5,3,38631,38631,38634,0,3,2
10989,1,2,38632,38634,38636,2,4,0
10990,1,1,38633,38636,38637,3,4,0
10991,1,1,38634,38637,38638,3,4,0
10992,5,2,38639,38639,38641,0,2,1
10993,4,2,38643,38643,38645,0,2,2
10994,4,3,38647,38647,38650,0,3,2
10995,5,3,38652,38652,38655,0,3,2
10996,1,2,38653,38655,38657,2,4,0
10997,5,1,38658,38658,38659,0,1,1
10998,5,1,38663,38663,38664,0,1,4
10999,4,1,38667,38667,38668,0,1,3
11000,2,2,38669,38669,38671,0,2,1
11001,4,3,38673,38673,38676,0,3,2
11002,4,1,38677,38677,38678,0,1,1
11003,2,1,38679,38679,38680,0,1,1
11004,6,3,38685,38685,38688,0,3,5
11005,5,3,38690,38690,38693,0,3,2
11006,5,3,38695,38695,38698,0,3,2
11007,6,3,38701,38701,38704,0,3,3
11008,5,1,38706,38706,38707,0,1,2
11009,5,2,38711,38711,38713,0,2,4
11010,5,3,38716,38716,38719,0,3,3
11011,5,1,38721,38721,38722,0,1,2
11012,2,1,38723,38723,38724,0,1,1
11013,2,2,38725,38725,38727,0,2,1
11014,3,3,38728,38728,38731,0,3,1
11015,4,1,38732,38732,38733,0,1,1
11016,6,3,38738,38738,38741,0,3,5
11017,3,2,38741,38741,38743,0,2,0
11018,6,1,38747,38747,38748,0,1,4
11019,6,3,38753,38753,38756,0,3,5
11020,4,1,38757,38757,38758,0,1,1
11021,5,3,38762,38762,38765,0,3,4
11022,5,2,38767,38767,38769,0,2,2
11023,5,2,38772,38772,38774,0,2,3
11024,5,2,38777,38777,38779,0,2,3
11025,5,2,38782,38782,38784,0,2,3
11026,4,3,38786,38786,38789,0,3,2
11027,2,3,38788,38789,38792,1,4,0
11028,6,1,38794,38794,38795,0,1,2
11029,1,1,38795,38795,38796,0,1,0
11030,5,3,38800,38800,38803,0,3,4
11031,1,1,38801,38803,38804,2,3,0
11032,5,1,38806,38806,38807,0,1,2
11033,2,2,38808,38808,38810,0,2,1
11034,3,2,38811,38811,38813,0,2,1
11035,6,3,38817,38817,38820,0,3,4
11036,5,1,38822,38822,38823,0,1,2
11037,2,2,38824,38824,38826,0,2,1
11038,2,3,38826,38826,38829,0,3,0
11039,3,3,38829,38829,38832,0,3,0
11040,3,3,38832,38832,38835,0,3,0
11041,5,2,38837,38837,38839,0,2,2
11042,3,3,38840,38840,38843,0,3,1
11043,4,3,38844,38844,38847,0,3,1
11044,2,2,38846,38847,38849,1,3,0
11045,2,1,38848,38849,38850,1,2,0
11046,1,3,38849,38850,38853,1,4,0
11047,1,2,38850,38853,38855,3,5,0
11048,6,3,38856,38856,38859,0,3,1
11049,3,3,38859,38859,38862,0,3,0
11050,2,3,38861,38862,38865,1,4,0
11051,6,2,38867,38867,38869,0,2,2
11052,5,2,38872,38872,38874,0,2,3
11053,5,1,38877,38877,38878,0,1,3
11054,3,1,38880,38880,38881,0,1,2
11055,3,1,38883,38883,38884,0,1,2
11056,3,2,38886,38886,38888,0,2,2
11057,5,2,38891,38891,38893,0,2,3
11058,5,1,38896,38896,38897,0,1,3
11059,3,1,38899,38899,38900,0,1,2
11060,3,3,38902,38902,38905,0,3,2
11061,1,3,38903,38905,38908,2,5,0
11062,1,2,38904,38908,38910,4,6,0
11063,2,2,38906,38910,38912,4,6,0
11064,3,2,38909,38912,38914,3,5,0
11065,5,1,38914,38914,38915,0,1,0
11066,6,3,38920,38920,38923,0,3,5
11067,3,3,38923,38923,38926,0,3,0
11068,6,2,38929,38929,38931,0,2,3
11069,4,1,38933,38933,38934,0,1,2
11070,6,2,38939,38939,38941,0,2,5
11071,2,3,38941,38941,38944,0,3,0
11072,2,2,38943,38944,38946,1,3,0
11073,2,1,38945,38946,38947,1,2,0
11074,3,3,38948,38948,38951,0,3,1
11075,2,1,38950,38951,38952,1,2,0
11076,5,1,38955,38955,38956,0,1,3
11077,3,3,38958,38958,38961,0,3,2
11078,3,1,38961,38961,38962,0,1,0
11079,6,3,38967,38967,38970,0,3,5
11080,1,1,38968,38970,38971,2,3,0
11081,2,1,38970,38971,38972,1,2,0
11082,2,3,38972,38972,38975,0,3,0
11083,4,2,38976,38976,38978,0,2,1
11084,6,1,38982,38982,38983,0,1,4
11085,5,1,38987,38987,38988,0,1,4
11086,5,1,38992,38992,38993,0,1,4
11087,2,1,38994,38994,38995,0,1,1
11088,4,3,38998,38998,39001,0,3,3
11089,5,3,39003,39003,39006,0,3,2
11090,6,2,39009,39009,39011,0,2,3
11091,1,2,39010,39011,39013,1,3,0
11092,3,3,39013,39013,39016,0,3,0
11093,6,3,39019,39019,39022,0,3,3
11094,2,1,39021,39022,39023,1,2,0
11095,4,2,39025,39025,39027,0,2,2
11096,1,2,39026,39027,39029,1,3,0
11097,6,2,39032,39032,39034,0,2,3
11098,6,2,39038,39038,39040,0,2,4
11099,3,3,39041,39041,39044,0,3,1
11100,4,2,39045,39045,39047,0,2,1
11101,1,2,39046,39047,39049,1,3,0
11102,4,2,39050,39050,39052,0,2,1
11103,4,1,39054,39054,39055,0,1,2
11104,5,1,39059,39059,39060,0,1,4
11105,2,3,39061,39061,39064,0,3,1
11106,1,2,39062,39064,39066,2,4,0
11107,4,1,39066,39066,39067,0,1,0
11108,2,3,39068,39068,39071,0,3,1
11109,5,2,39073,39073,39075,0,2,2
11110,2,1,39075,39075,39076,0,1,0
11111,5,2,39080,39080,39082,0,2,4
11112,2,3,39082,39082,39085,0,3,0
11113,1,1,39083,39085,39086,2,3,0
11114,1,1,39084,39086,39087,2,3,0
11115,3,2,39087,39087,39089,0,2,0
11116,1,3,39088,39089,39092,1,4,0
11117,3,1,39091,39092,39093,1,2,0
11118,3,2,39094,39094,39096,0,2,1
11119,5,2,39099,39099,39101,0,2,3
11120,4,3,39103,39103,39106,0,3,2
11121,6,1,39109,39109,39110,0,1,3
11122,6,1,39115,39115,39116,0,1,5
11123,3,1,39118,39118,39119,0,1,2
11124,4,2,39122,39122,39124,0,2,3
11125,3,1,39125,39125,39126,0,1,1
11126,3,3,39128,39128,39131,0,3,2
11127,1,1,39129,39131,39132,2,3,0
11128,3,1,39132,39132,39133,0,1,0
11129,6,3,39138,39138,39141,0,3,5
11130,2,3,39140,39141,39144,1,4,0
11131,2,2,39142,39144,39146,2,4,0
11132,5,3,39147,39147,39150,0,3,1
11133,2,2,39149,39150,39152,1,3,0
11134,6,2,39155,39155,39157,0,2,3
11135,4,3,39159,39159,39162,0,3,2
11136,1,2,39160,39162,39164,2,4,0
11137,4,2,39164,39164,39166,0,2,0
11138,2,3,39166,39166,39169,0,3,0
11139,4,1,39170,39170,39171,0,1,1
11140,2,1,39172,39172,39173,0,1,1
11141,4,3,39176,39176,39179,0,3,3
11142,5,2,39181,39181,39183,0,2,2
11143,1,2,39182,39183,39185,1,3,0
11144,5,3,39187,39187,39190,0,3,2
11145,3,3,39190,39190,39193,0,3,0
11146,6,2,39196,39196,39198,0,2,3
11147,1,3,39197,39198,39201,1,4,0
11148,6,2,39203,39203,39205,0,2,2
11149,2,1,39205,39205,39206,0,1,0
11150,6,2,39211,39211,39213,0,2,5
11151,6,3,39217,39217,39220,0,3,4
11152,4,1,39221,39221,39222,0,1,1
11153,5,1,39226,39226,39227,0,1,4
11154,5,3,39231,39231,39234,0,3,4
11155,4,3,39235,39235,39238,0,3,1
11156,1,2,39236,39238,39240,2,4,0
11157,1,1,39237,39240,39241,3,4,0
11158,3,3,39240,39241,39244,1,4,0
11159,3,1,39243,39244,39245,1,2,0
11160,3,2,39246,39246,39248,0,2,1
11161,3,2,39249,39249,39251,0,2,1
11162,1,3,39250,39251,39254,1,4,0
11163,6,2,39256,39256,39258,0,2,2
11164,1,3,39257,39258,39261,1,4,0
11165,5,2,39262,39262,39264,0,2,1
11166,1,1,39263,39264,39265,1,2,0
11167,5,3,39268,39268,39271,0,3,3
11168,5,2,39273,39273,39275,0,2,2
11169,2,2,39275,39275,39277,0,2,0
11170,4,2,39279,39279,39281,0,2,2
11171,6,1,39285,39285,39286,0,1,4
11172,6,1,39291,39291,39292,0,1,5
11173,4,3,39295,39295,39298,0,3,3
11174,4,1,39299,39299,39300,0,1,1
11175,4,1,39303,39303,39304,0,1,3
11176,2,3,39305,39305,39308,0,3,1
11177,6,2,39311,39311,39313,0,2,3
11178,2,1,39313,39313,39314,0,1,0
11179,2,1,39315,39315,39316,0,1,1
11180,6,3,39321,39321,39324,0,3,5
11181,3,3,39324,39324,39327,0,3,0
11182,6,2,39330,39330,39332,0,2,3
11183,5,3,39335,39335,39338,0,3,3
11184,6,3,39341,39341,39344,0,3,3
11185,1,2,39342,39344,39346,2,4,0
11186,3,3,39345,39346,39349,1,4,0
11187,5,1,39350,39350,39351,0,1,1
11188,3,1,39353,39353,39354,0,1,2
11189,6,3,39359,39359,39362,0,3,5
11190,6,1,39365,39365,39366,0,1,3
11191,1,2,39366,39366,39368,0,2,0
11192,5,3,39371,39371,39374,0,3,3
11193,6,3,39377,39377,39380,0,3,3
11194,3,3,39380,39380,39383,0,3,0
11195,1,2,39381,39383,39385,2,4,0
11196,6,3,39387,39387,39390,0,3,2
11197,3,3,39390,39390,39393,0,3,0
11198,4,3,39394,39394,39397,0,3,1
11199,4,3,39398,39398,39401,0,3,1
11200,6,1,39404,39404,39405,0,1,3
11201,6,3,39410,39410,39413,0,3,5
11202,2,2,39412,39413,39415,1,3,0
11203,3,3,39415,39415,39418,0,3,0
11204,4,3,39419,39419,39422,0,3,1
11205,2,2,39421,39422,39424,1,3,0
11206,1,1,39422,39424,39425,2,3,0
11207,3,3,39425,39425,39428,0,3,0
11208,5,2,39430,39430,39432,0,2,2
11209,6,3,39436,39436,39439,0,3,4
11210,1,1,39437,39439,39440,2,3,0
11211,3,2,39440,39440,39442,0,2,0
11212,6,1,39446,39446,39447,0,1,4
11213,3,3,39449,39449,39452,0,3,2
11214,5,1,39454,39454,39455,0,1,2
11215,6,2,39460,39460,39462,0,2,5
11216,5,1,39465,39465,39466,0,1,3
11217,2,1,39467,39467,39468,0,1,1
11218,2,1,39469,39469,39470,0,1,1
11219,3,1,39472,39472,39473,0,1,2
11220,3,3,39475,39475,39478,0,3,2
11221,2,2,39477,39478,39480,1,3,0
11222,4,1,39481,39481,39482,0,1,1
11223,4,1,39485,39485,39486,0,1,3
11224,5,2,39490,39490,39492,0,2,4
11225,2,3,39492,39492,39495,0,3,0
11226,3,2,39495,39495,39497,0,2,0
11227,4,3,39499,39499,39502,0,3,2
11228,2,2,39501,39502,39504,1,3,0
11229,2,3,39503,39504,39507,1,4,0
11230,5,3,39508,39508,39511,0,3,1
11231,1,1,39509,39511,39512,2,3,0
11232,5,2,39514,39514,39516,0,2,2
11233,3,3,39517,39517,39520,0,3,1
11234,3,2,39520,39520,39522,0,2,0
11235,4,1,39524,39524,39525,0,1,2
11236,3,1,39527,39527,39528,0,1,2
11237,4,1,39531,39531,39532,0,1,3
11238,1,1,39532,39532,39533,0,1,0
11239,2,1,39534,39534,39535,0,1,1
11240,2,2,39536,39536,39538,0,2,1
11241,2,2,39538,39538,39540,0,2,0
11242,6,1,39544,39544,39545,0,1,4
11243,4,1,39548,39548,39549,0,1,3
11244,3,3,39551,39551,39554,0,3,2
11245,4,3,39555,39555,39558,0,3,1
11246,3,2,39558,39558,39560,0,2,0
11247,4,2,39562,39562,39564,0,2,2
11248,2,2,39564,39564,39566,0,2,0
11249,5,1,39569,39569,39570,0,1,3
11250,2,3,39571,39571,39574,0,3,1
11251,4,1,39575,39575,39576,0,1,1
11252,5,1,39580,39580,39581,0,1,4
11253,3,1,39583,39583,39584,0,1,2
11254,1,1,39584,39584,39585,0,1,0
11255,2,2,39586,39586,39588,0,2,1
11256,3,3,39589,39589,39592,0,3,1
11257,4,1,39593,39593,39594,0,1,1
11258,6,3,39599,39599,39602,0,3,5
11259,6,1,39605,39605,39606,0,1,3
11260,3,1,39608,39608,39609,0,1,2
11261,1,2,39609,39609,39611,0,2,0
11262,3,3,39612,39612,39615,0,3,1
11263,5,1,39617,39617,39618,0,1,2
11264,3,2,39620,39620,39622,0,2,2
11265,3,3,39623,39623,39626,0,3,1
11266,1,3,39624,39626,39629,2,5,0
11267,6,1,39630,39630,39631,0,1,1
11268,3,3,39633,39633,39636,0,3,2
11269,6,1,39639,39639,39640,0,1,3
11270,6,2,39645,39645,39647,0,2,5
11271,6,3,39651,39651,39654,0,3,4
11272,5,1,39656,39656,39657,0,1,2
11273,3,2,39659,39659,39661,0,2,2
11274,1,3,39660,39661,39664,1,4,0
11275,5,3,39665,39665,39668,0,3,1
11276,1,1,39666,39668,39669,2,3,0
11277,3,3,39669,39669,39672,0,3,0
11278,6,1,39675,39675,39676,0,1,3
11279,3,3,39678,39678,39681,0,3,2
11280,3,1,39681,39681,39682,0,1,0
11281,5,1,39686,39686,39687,0,1,4
11282,6,1,39692,39692,39693,0,1,5
11283,6,3,39698,39698,39701,0,3,5
11284,4,2,39702,39702,39704,0,2,1
11285,3,1,39705,39705,39706,0,1,1
11286,1,2,39706,39706,39708,0,2,0
11287,3,1,39709,39709,39710,0,1,1
11288,5,1,39714,39714,39715,0,1,4
11289,6,1,39720,39720,39721,0,1,5
11290,3,1,39723,39723,39724,0,1,2
11291,4,2,39727,39727,39729,0,2,3
11292,5,3,39732,39732,39735,0,3,3
11293,3,2,39735,39735,39737,0,2,0
11294,2,1,39737,39737,39738,0,1,0
11295,2,1,39739,39739,39740,0,1,1
11296,6,2,39745,39745,39747,0,2,5
11297,3,3,39748,39748,39751,0,3,1
11298,6,2,39754,39754,39756,0,2,3
11299,2,3,39756,39756,39759,0,3,0
11300,5,2,39761,39761,39763,0,2,2
11301,5,1,39766,39766,39767,0,1,3
11302,2,3,39768,39768,39771,0,3,1
11303,5,3,39773,39773,39776,0,3,2
11304,5,2,39778,39778,39780,0,2,2
11305,5,2,39783,39783,39785,0,2,3
11306,5,2,39788,39788,39790,0,2,3
11307,6,3,39794,39794,39797,0,3,4
11308,3,3,39797,39797,39800,0,3,0
11309,6,3,39803,39803,39806,0,3,3
11310,6,1,39809,39809,39810,0,1,3
11311,5,1,39814,39814,39815,0,1,4
11312,2,2,39816,39816,39818,0,2,1
11313,1,2,39817,39818,39820,1,3,0
11314,1,1,39818,39820,39821,2,3,0
11315,3,1,39821,39821,39822,0,1,0
11316,1,1,39822,39822,39823,0,1,0
11317,6,2,39828,39828,39830,0,2,5
11318,4,3,39832,39832,39835,0,3,2
11319,3,2,39835,39835,39837,0,2,0
11320,4,3,39839,39839,39842,0,3,2
11321,3,1,39842,39842,39843,0,1,0
11322,2,2,39844,39844,39846,0,2,1
11323,2,3,39846,39846,39849,0,3,0
11324,5,2,39851,39851,39853,0,2,2
11325,1,3,39852,39853,39856,1,4,0
11326,2,3,39854,39856,39859,2,5,0
11327,5,2,39859,39859,39861,0,2,0
11328,6,1,39865,39865,39866,0,1,4
11329,4,2,39869,39869,39871,0,2,3
11330,4,1,39873,39873,39874,0,1,2
11331,6,3,39879,39879,39882,0,3,5
11332,1,1,39880,39882,39883,2,3,0
11333,1,2,39881,39883,39885,2,4,0
11334,1,1,39882,39885,39886,3,4,0
11335,2,2,39884,39886,39888,2,4,0
11336,2,3,39886,39888,39891,2,5,0
11337,1,2,39887,39891,39893,4,6,0
11338,3,2,39890,39893,39895,3,5,0
11339,5,2,39895,39895,39897,0,2,0
11340,1,3,39896,39897,39900,1,4,0
11341,2,2,39898,39900,39902,2,4,0
11342,4,3,39902,39902,39905,0,3,0
11343,2,1,39904,39905,39906,1,2,0
11344,3,1,39907,39907,39908,0,1,1
11345,2,2,39909,39909,39911,0,2,1
11346,3,3,39912,39912,39915,0,3,1
11347,2,3,39914,39915,39918,1,4,0
11348,6,1,39920,39920,39921,0,1,2
11349,2,2,39922,39922,39924,0,2,1
11350,6,3,39928,39928,39931,0,3,4
11351,2,3,39930,39931,39934,1,4,0
11352,1,3,39931,39934,39937,3,6,0
11353,2,1,39933,39937,39938,4,5,0
11354,3,2,39936,39938,39940,2,4,0
11355,1,2,39937,39940,39942,3,5,0
11356,2,3,39939,39942,39945,3,6,0
11357,3,3,39942,39945,39948,3,6,0
11358,5,2,39947,39948,39950,1,3,0
11359,5,2,39952,39952,39954,0,2,2
11360,6,3,39958,39958,39961,0,3,4
11361,6,1,39964,39964,39965,0,1,3
11362,3,2,39967,39967,39969,0,2,2
11363,5,2,39972,39972,39974,0,2,3
11364,6,3,39978,39978,39981,0,3,4
11365,6,1,39984,39984,39985,0,1,3
11366,2,3,39986,39986,39989,0,3,1
11367,4,2,39990,39990,39992,0,2,1
11368,3,1,39993,39993,39994,0,1,1
11369,6,2,39999,39999,40001,0,2,5
11370,1,1,40000,40001,40002,1,2,0
11371,5,3,40005,40005,40008,0,3,3
11372,3,3,40008,40008,40011,0,3,0
11373,2,2,40010,40011,40013,1,3,0
11374,3,3,40013,40013,40016,0,3,0
11375,6,3,40019,40019,40022,0,3,3
11376,5,2,40024,40024,40026,0,2,2
11377,2,2,40026,40026,40028,0,2,0
11378,2,3,40028,40028,40031,0,3,0
11379,3,3,40031,40031,40034,0,3,0
11380,6,2,40037,40037,40039,0,2,3
11381,3,2,40040,40040,40042,0,2,1
11382,2,3,40042,40042,40045,0,3,0
11383,3,2,40045,40045,40047,0,2,0
11384,5,3,40050,40050,40053,0,3,3
11385,2,2,40052,40053,40055,1,3,0
11386,3,2,40055,40055,40057,0,2,0
11387,1,2,40056,40057,40059,1,3,0
11388,3,2,40059,40059,40061,0,2,0
11389,6,3,40065,40065,40068,0,3,4
11390,3,2,40068,40068,40070,0,2,0
11391,5,1,40073,40073,40074,0,1,3
11392,4,1,40077,40077,40078,0,1,3
11393,2,3,40079,40079,40082,0,3,1
11394,1,1,40080,40082,40083,2,3,0
11395,5,2,40085,40085,40087,0,2,2
11396,6,3,40091,40091,40094,0,3,4
11397,1,3,40092,40094,40097,2,5,0
11398,2,3,40094,40097,40100,3,6,0
11399,5,3,40099,40100,40103,1,4,0
11400,2,2,40101,40103,40105,2,4,0
11401,6,1,40107,40107,40108,0,1,2
11402,2,1,40109,40109,40110,0,1,1
11403,4,1,40113,40113,40114,0,1,3
11404,3,3,40116,40116,40119,0,3,2
11405,2,2,40118,40119,40121,1,3,0
11406,6,2,40124,40124,40126,0,2,3
11407,4,2,40128,40128,40130,0,2,2
11408,6,3,40134,40134,40137,0,3,4
11409,1,2,40135,40137,40139,2,4,0
11410,6,1,40141,40141,40142,0,1,2
11411,3,1,40144,40144,40145,0,1,2
11412,3,2,40147,40147,40149,0,2,2
11413,1,3,40148,40149,40152,1,4,0
11414,3,3,40151,40152,40155,1,4,0
11415,2,3,40153,40155,40158,2,5,0
11416,2,1,40155,40158,40159,3,4,0
11417,1,3,40156,40159,40162,3,6,0
11418,3,3,40159,40162,40165,3,6,0
11419,2,1,40161,40165,40166,4,5,0
11420,5,3,40166,40166,40169,0,3,0
11421,5,1,40171,40171,40172,0,1,2
11422,2,1,40173,40173,40174,0,1,1
11423,5,2,40178,40178,40180,0,2,4
11424,5,2,40183,40183,40185,0,2,3
11425,5,3,40188,40188,40191,0,3,3
11426,5,3,40193,40193,40196,0,3,2
11427,6,1,40199,40199,40200,0,1,3
11428,6,3,40205,40205,40208,0,3,5
11429,6,2,40211,40211,40213,0,2,3
11430,4,3,40215,40215,40218,0,3,2
11431,5,3,40220,40220,40223,0,3,2
11432,6,3,40226,40226,40229,0,3,3
11433,4,3,40230,40230,40233,0,3,1
11434,5,1,40235,40235,40236,0,1,2
11435,4,1,40239,40239,40240,0,1,3
11436,6,2,40245,40245,40247,0,2,5
11437,6,3,40251,40251,40254,0,3,4
11438,6,3,40257,40257,40260,0,3,3
11439,4,3,40261,40261,40264,0,3,1
11440,6,2,40267,40267,40269,0,2,3
11441,1,1,40268,40269,40270,1,2,0
11442,3,3,40271,40271,40274,0,3,1
11443,3,3,40274,40274,40277,0,3,0
11444,4,1,40278,40278,40279,0,1,1
11445,3,3,40281,40281,40284,0,3,2
11446,4,2,40285,40285,40287,0,2,1
11447,4,1,40289,40289,40290,0,1,2
11448,2,2,40291,40291,40293,0,2,1
11449,5,2,40296,40296,40298,0,2,3
11450,1,1,40297,40298,40299,1,2,0
11451,3,1,40300,40300,40301,0,1,1
11452,2,3,40302,40302,40305,0,3,1
11453,4,3,40306,40306,40309,0,3,1
11454,1,3,40307,40309,40312,2,5,0
11455,6,3,40313,40313,40316,0,3,1
11456,6,2,40319,40319,40321,0,2,3
11457,6,3,40325,40325,40328,0,3,4
11458,3,2,40328,40328,40330,0,2,0
11459,3,3,40331,40331,40334,0,3,1
11460,4,3,40335,40335,40338,0,3,1
11461,1,3,40336,40338,40341,2,5,0
11462,5,3,40341,40341,40344,0,3,0
11463,3,3,40344,40344,40347,0,3,0
11464,1,2,40345,40347,40349,2,4,0
11465,5,2,40350,40350,40352,0,2,1
11466,4,1,40354,40354,40355,0,1,2
11467,6,1,40360,40360,40361,0,1,5
11468,1,2,40361,40361,40363,0,2,0
11469,2,3,40363,40363,40366,0,3,0
11470,2,2,40365,40366,40368,1,3,0
11471,1,2,40366,40368,40370,2,4,0
11472,2,2,40368,40370,40372,2,4,0
11473,4,1,40372,40372,40373,0,1,0
11474,3,2,40375,40375,40377,0,2,2
11475,4,2,40379,40379,40381,0,2,2
11476,4,2,40383,40383,40385,0,2,2
11477,3,1,40386,40386,40387,0,1,1
11478,5,2,40391,40391,40393,0,2,4
11479,5,3,40396,40396,40399,0,3,3
11480,2,1,40398,40399,40400,1,2,0
11481,4,2,40402,40402,40404,0,2,2
11482,5,2,40407,40407,40409,0,2,3
11483,1,2,40408,40409,40411,1,3,0
11484,3,3,40411,40411,40414,0,3,0
11485,6,2,40417,40417,40419,0,2,3
11486,4,3,40421,40421,40424,0,3,2
11487,6,1,40427,40427,40428,0,1,3
11488,4,1,40431,40431,40432,0,1,3
11489,6,2,40437,40437,40439,0,2,5
11490,4,3,40441,40441,40444,0,3,2
11491,2,3,40443,40444,40447,1,4,0
11492,4,1,40447,40447,40448,0,1,0
11493,4,1,40451,40451,40452,0,1,3
11494,1,1,40452,40452,40453,0,1,0
11495,4,1,40456,40456,40457,0,1,3
11496,5,2,40461,40461,40463,0,2,4
11497,2,3,40463,40463,40466,0,3,0
11498,1,3,40464,40466,40469,2,5,0
11499,5,3,40469,40469,40472,0,3,0
11500,2,2,40471,40472,40474,1,3,0
11501,2,1,40473,40474,40475,1,2,0
11502,2,3,40475,40475,40478,0,3,0
11503,2,1,40477,40478,40479,1,2,0
11504,3,2,40480,40480,40482,0,2,1
11505,2,3,40482,40482,40485,0,3,0
11506,5,2,40487,40487,40489,0,2,2
11507,3,1,40490,40490,40491,0,1,1
11508,2,3,40492,40492,40495,0,3,1
11509,1,3,40493,40495,40498,2,5,0
11510,5,3,40498,40498,40501,0,3,0
11511,5,1,40503,40503,40504,0,1,2
11512,6,1,40509,40509,40510,0,1,5
11513,1,3,40510,40510,40513,0,3,0
11514,2,3,40512,40513,40516,1,4,0
11515,5,2,40517,40517,40519,0,2,1
11516,5,2,40522,40522,40524,0,2,3
11517,2,3,40524,40524,40527,0,3,0
11518,6,1,40530,40530,40531,0,1,3
11519,5,1,40535,40535,40536,0,1,4
11520,1,1,40536,40536,40537,0,1,0
11521,2,3,40538,40538,40541,0,3,1
11522,6,3,40544,40544,40547,0,3,3
11523,2,3,40546,40547,40550,1,4,0
11524,2,3,40548,40550,40553,2,5,0
11525,6,2,40554,40554,40556,0,2,1
11526,1,3,40555,40556,40559,1,4,0
11527,3,1,40558,40559,40560,1,2,0
11528,1,3,40559,40560,40563,1,4,0
11529,1,2,40560,40563,40565,3,5,0
11530,3,2,40563,40565,40567,2,4,0
11531,1,3,40564,40567,40570,3,6,0
11532,5,1,40569,40570,40571,1,2,0
11533,2,1,40571,40571,40572,0,1,0
11534,2,1,40573,40573,40574,0,1,1
11535,3,1,40576,40576,40577,0,1,2
11536,5,1,40581,40581,40582,0,1,4
11537,1,1,40582,40582,40583,0,1,0
11538,3,2,40585,40585,40587,0,2,2
11539,6,1,40591,40591,40592,0,1,4
11540,3,1,40594,40594,40595,0,1,2
11541,5,2,40599,40599,40601,0,2,4
11542,5,3,40604,40604,40607,0,3,3
11543,2,3,40606,40607,40610,1,4,0
11544,6,2,40612,40612,40614,0,2,2
11545,2,3,40614,40614,40617,0,3,0
11546,3,1,40617,40617,40618,0,1,0
11547,5,1,40622,40622,40623,0,1,4
11548,2,3,40624,40624,40627,0,3,1
11549,2,3,40626,40627,40630,1,4,0
11550,4,1,40630,40630,40631,0,1,0
11551,5,3,40635,40635,40638,0,3,4
11552,3,1,40638,40638,40639,0,1,0
11553,2,2,40640,40640,40642,0,2,1
11554,1,3,40641,40642,40645,1,4,0
11555,6,1,40647,40647,40648,0,1,2
11556,2,1,40649,40649,40650,0,1,1
11557,4,2,40653,40653,40655,0,2,3
11558,1,1,40654,40655,40656,1,2,0
11559,5,2,40659,40659,40661,0,2,3
11560,5,1,40664,40664,40665,0,1,3
11561,1,1,40665,40665,40666,0,1,0
11562,4,1,40669,40669,40670,0,1,3
11563,6,1,40675,40675,40676,0,1,5
11564,4,1,40679,40679,40680,0,1,3
11565,6,1,40685,40685,40686,0,1,5
11566,6,3,40691,40691,40694,0,3,5
11567,5,2,40696,40696,40698,0,2,2
11568,3,1,40699,40699,40700,0,1,1
11569,5,2,40704,40704,40706,0,2,4
11570,6,2,40710,40710,40712,0,2,4
11571,2,1,40712,40712,40713,0,1,0
11572,3,1,40715,40715,40716,0,1,2
11573,2,2,40717,40717,40719,0,2,1
11574,5,3,40722,40722,40725,0,3,3
11575,2,2,40724,40725,40727,1,3,0
11576,6,2,40730,40730,40732,0,2,3
11577,3,2,40733,40733,40735,0,2,1
11578,3,1,40736,40736,40737,0,1,1
11579,1,1,40737,40737,40738,0,1,0
11580,6,1,40743,40743,40744,0,1,5
11581,2,2,40745,40745,40747,0,2,1
11582,4,2,40749,40749,40751,0,2,2
11583,1,2,40750,40751,40753,1,3,0
11584,4,1,40754,40754,40755,0,1,1
11585,6,2,40760,40760,40762,0,2,5
11586,1,2,40761,40762,40764,1,3,0
11587,2,1,40763,40764,40765,1,2,0
11588,4,2,40767,40767,40769,0,2,2
11589,5,3,40772,40772,40775,0,3,3
11590,3,2,40775,40775,40777,0,2,0
11591,1,3,40776,40777,40780,1,4,0
11592,4,2,40780,40780,40782,0,2,0
11593,5,1,40785,40785,40786,0,1,3
11594,1,2,40786,40786,40788,0,2,0
11595,6,3,40792,40792,40795,0,3,4
11596,2,2,40794,40795,40797,1,3,0
11597,1,3,40795,40797,40800,2,5,0
11598,5,1,40800,40800,40801,0,1,0
11599,1,2,40801,40801,40803,0,2,0
11600,1,1,40802,40803,40804,1,2,0
11601,4,1,40806,40806,40807,0,1,2
11602,1,1,40807,40807,40808,0,1,0
11603,2,3,40809,40809,40812,0,3,1
11604,6,1,40815,40815,40816,0,1,3
11605,3,2,40818,40818,40820,0,2,2
11606,1,1,40819,40820,40821,1,2,0
11607,2,1,40821,40821,40822,0,1,0
11608,2,1,40823,40823,40824,0,1,1
11609,4,3,40827,40827,40830,0,3,3
11610,5,2,40832,40832,40834,0,2,2
11611,4,1,40836,40836,40837,0,1,2
11612,1,2,40837,40837,40839,0,2,0
11613,4,2,40841,40841,40843,0,2,2
11614,6,3,40847,40847,40850,0,3,4
11615,4,1,40851,40851,40852,0,1,1
11616,6,3,40857,40857,40860,0,3,5
11617,4,3,40861,40861,40864,0,3,1
11618,6,1,40867,40867,40868,0,1,3
11619,2,1,40869,40869,40870,0,1,1
11620,3,3,40872,40872,40875,0,3,2
11621,5,1,40877,40877,40878,0,1,2
11622,1,3,40878,40878,40881,0,3,0
11623,3,1,40881,40881,40882,0,1,0
11624,4,1,40885,40885,40886,0,1,3
11625,2,3,40887,40887,40890,0,3,1
11626,4,2,40891,40891,40893,0,2,1
11627,6,1,40897,40897,40898,0,1,4
11628,1,3,40898,40898,40901,0,3,0
11629,5,2,40903,40903,40905,0,2,2
11630,1,1,40904,40905,40906,1,2,0
11631,3,1,40907,40907,40908,0,1,1
11632,4,1,40911,40911,40912,0,1,3
11633,2,1,40913,40913,40914,0,1,1
11634,5,1,40918,40918,40919,0,1,4
11635,1,1,40919,40919,40920,0,1,0
11636,2,1,40921,40921,40922,0,1,1
11637,4,3,40925,40925,40928,0,3,3
11638,4,3,40929,40929,40932,0,3,1
11639,4,2,40933,40933,40935,0,2,1
11640,1,1,40934,40935,40936,1,2,0
11641,4,1,40938,40938,40939,0,1,2
11642,1,1,40939,40939,40940,0,1,0
11643,2,1,40941,40941,40942,0,1,1
11644,5,2,40946,40946,40948,0,2,4
11645,5,3,40951,40951,40954,0,3,3
11646,4,1,40955,40955,40956,0,1,1
11647,6,3,40961,40961,40964,0,3,5
11648,1,1,40962,40964,40965,2,3,0
11649,1,1,40963,40965,40966,2,3,0
11650,5,1,40968,40968,40969,0,1,2
11651,5,3,40973,40973,40976,0,3,4
11652,6,3,40979,40979,40982,0,3,3
11653,1,3,40980,40982,40985,2,5,0
11654,4,3,40984,40985,40988,1,4,0
11655,6,2,40990,40990,40992,0,2,2
11656,1,1,40991,40992,40993,1,2,0
11657,6,1,40997,40997,40998,0,1,4
11658,5,3,41002,41002,41005,0,3,4
11659,4,3,41006,41006,41009,0,3,1
11660,5,3,41011,41011,41014,0,3,2
11661,6,3,41017,41017,41020,0,3,3
11662,5,3,41022,41022,41025,0,3,2
11663,5,2,41027,41027,41029,0,2,2
11664,2,3,41029,41029,41032,0,3,0
11665,4,1,41033,41033,41034,0,1,1
11666,5,1,41038,41038,41039,0,1,4
11667,4,1,41042,41042,41043,0,1,3
11668,1,3,41043,41043,41046,0,3,0
11669,5,1,41048,41048,41049,0,1,2
11670,2,1,41050,41050,41051,0,1,1
11671,3,3,41053,41053,41056,0,3,2
11672,6,1,41059,41059,41060,0,1,3
11673,1,2,41060,41060,41062,0,2,0
11674,4,3,41064,41064,41067,0,3,2
11675,3,3,41067,41067,41070,0,3,0
11676,4,2,41071,41071,41073,0,2,1
11677,1,1,41072,41073,41074,1,2,0
11678,6,3,41078,41078,41081,0,3,4
11679,5,2,41083,41083,41085,0,2,2
11680,5,1,41088,41088,41089,0,1,3
11681,3,2,41091,41091,41093,0,2,2
11682,2,3,41093,41093,41096,0,3,0
11683,6,3,41099,41099,41102,0,3,3
11684,5,3,41104,41104,41107,0,3,2
11685,1,1,41105,41107,41108,2,3,0
11686,2,1,41107,41108,41109,1,2,0
11687,3,3,41110,41110,41113,0,3,1
11688,6,2,41116,41116,41118,0,2,3
11689,3,2,41119,41119,41121,0,2,1
11690,5,2,41124,41124,41126,0,2,3
11691,4,1,41128,41128,41129,0,1,2
11692,4,2,41132,41132,41134,0,2,3
11693,1,1,41133,41134,41135,1,2,0
11694,6,2,41139,41139,41141,0,2,4
11695,4,3,41143,41143,41146,0,3,2
11696,6,3,41149,41149,41152,0,3,3
11697,2,1,41151,41152,41153,1,2,0
11698,1,2,41152,41153,41155,1,3,0
11699,1,1,41153,41155,41156,2,3,0
11700,6,1,41159,41159,41160,0,1,3
11701,2,1,41161,41161,41162,0,1,1
11702,3,1,41164,41164,41165,0,1,2
11703,3,3,41167,41167,41170,0,3,2
11704,1,3,41168,41170,41173,2,5,0
11705,3,3,41171,41173,41176,2,5,0
11706,2,1,41173,41176,41177,3,4,0
11707,2,3,41175,41177,41180,2,5,0
11708,2,3,41177,41180,41183,3,6,0
11709,3,1,41180,41183,41184,3,4,0
11710,5,2,41185,41185,41187,0,2,1
11711,5,1,41190,41190,41191,0,1,3
11712,4,3,41194,41194,41197,0,3,3
11713,2,1,41196,41197,41198,1,2,0
11714,6,1,41202,41202,41203,0,1,4
11715,2,1,41204,41204,41205,0,1,1
11716,3,3,41207,41207,41210,0,3,2
11717,1,3,41208,41210,41213,2,5,0
11718,6,1,41214,41214,41215,0,1,1
11719,3,2,41217,41217,41219,0,2,2
11720,5,3,41222,41222,41225,0,3,3
11721,4,2,41226,41226,41228,0,2,1
11722,2,1,41228,41228,41229,0,1,0
11723,4,2,41232,41232,41234,0,2,3
11724,6,2,41238,41238,41240,0,2,4
11725,3,2,41241,41241,41243,0,2,1
11726,3,1,41244,41244,41245,0,1,1
11727,3,3,41247,41247,41250,0,3,2
11728,5,3,41252,41252,41255,0,3,2
11729,1,1,41253,41255,41256,2,3,0
11730,5,3,41258,41258,41261,0,3,2
11731,2,3,41260,41261,41264,1,4,0
11732,5,1,41265,41265,41266,0,1,1
11733,5,3,41270,41270,41273,0,3,4
11734,3,3,41273,41273,41276,0,3,0
11735,2,2,41275,41276,41278,1,3,0
11736,3,1,41278,41278,41279,0,1,0
11737,3,3,41281,41281,41284,0,3,2
11738,2,2,41283,41284,41286,1,3,0
11739,6,1,41289,41289,41290,0,1,3
11740,1,1,41290,41290,41291,0,1,0
11741,3,1,41293,41293,41294,0,1,2
11742,3,3,41296,41296,41299,0,3,2
11743,4,2,41300,41300,41302,0,2,1
11744,3,2,41303,41303,41305,0,2,1
11745,2,1,41305,41305,41306,0,1,0
11746,3,3,41308,41308,41311,0,3,2
11747,5,3,41313,41313,41316,0,3,2
11748,5,3,41318,41318,41321,0,3,2
11749,1,1,41319,41321,41322,2,3,0
11750,2,1,41321,41322,41323,1,2,0
11751,1,2,41322,41323,41325,1,3,0
11752,4,2,41326,41326,41328,0,2,1
11753,3,1,41329,41329,41330,0,1,1
11754,6,3,41335,41335,41338,0,3,5
11755,6,1,41341,41341,41342,0,1,3
11756,3,2,41344,41344,41346,0,2,2
11757,4,3,41348,41348,41351,0,3,2
11758,5,1,41353,41353,41354,0,1,2
11759,3,1,41356,41356,41357,0,1,2
11760,5,3,41361,41361,41364,0,3,4
11761,4,2,41365,41365,41367,0,2,1
11762,3,2,41368,41368,41370,0,2,1
11763,4,1,41372,41372,41373,0,1,2
11764,6,2,41378,41378,41380,0,2,5
11765,1,2,41379,41380,41382,1,3,0
11766,5,3,41384,41384,41387,0,3,2
11767,2,1,41386,41387,41388,1,2,0
11768,6,1,41392,41392,41393,0,1,4
11769,5,3,41397,41397,41400,0,3,4
11770,1,3,41398,41400,41403,2,5,0
11771,2,3,41400,41403,41406,3,6,0
11772,4,3,41404,41406,41409,2,5,0
11773,4,1,41408,41409,41410,1,2,0
11774,2,1,41410,41410,41411,0,1,0
11775,6,3,41416,41416,41419,0,3,5
11776,2,1,41418,41419,41420,1,2,0
11777,3,3,41421,41421,41424,0,3,1
11778,2,1,41423,41424,41425,1,2,0
11779,5,1,41428,41428,41429,0,1,3
11780,3,3,41431,41431,41434,0,3,2
11781,3,2,41434,41434,41436,0,2,0
11782,3,3,41437,41437,41440,0,3,1
11783,4,1,41441,41441,41442,0,1,1
11784,6,2,41447,41447,41449,0,2,5
11785,5,2,41452,41452,41454,0,2,3
11786,1,2,41453,41454,41456,1,3,0
11787,1,1,41454,41456,41457,2,3,0
11788,1,3,41455,41457,41460,2,5,0
11789,6,3,41461,41461,41464,0,3,1
11790,6,1,41467,41467,41468,0,1,3
11791,2,1,41469,41469,41470,0,1,1
11792,4,1,41473,41473,41474,0,1,3
11793,5,1,41478,41478,41479,0,1,4
11794,1,1,41479,41479,41480,0,1,0
11795,1,3,41480,41480,41483,0,3,0
11796,5,3,41485,41485,41488,0,3,2
11797,4,2,41489,41489,41491,0,2,1
11798,3,2,41492,41492,41494,0,2,1
11799,1,2,41493,41494,41496,1,3,0
11800,5,1,41498,41498,41499,0,1,2
11801,4,3,41502,41502,41505,0,3,3
11802,3,2,41505,41505,41507,0,2,0
11803,2,1,41507,41507,41508,0,1,0
11804,1,1,41508,41508,41509,0,1,0
11805,1,2,41509,41509,41511,0,2,0
11806,4,2,41513,41513,41515,0,2,2
11807,2,2,41515,41515,41517,0,2,0
11808,3,3,41518,41518,41521,0,3,1
11809,4,1,41522,41522,41523,0,1,1
11810,4,3,41526,41526,41529,0,3,3
11811,1,3,41527,41529,41532,2,5,0
11812,2,2,41529,41532,41534,3,5,0
11813,5,2,41534,41534,41536,0,2,0
11814,3,1,41537,41537,41538,0,1,1
11815,4,3,41541,41541,41544,0,3,3
11816,1,2,41542,41544,41546,2,4,0
11817,1,1,41543,41546,41547,3,4,0
11818,1,1,41544,41547,41548,3,4,0
11819,1,3,41545,41548,41551,3,6,0
11820,3,3,41548,41551,41554,3,6,0
11821,5,3,41553,41554,41557,1,4,0
11822,6,3,41559,41559,41562,0,3,2
11823,4,1,41563,41563,41564,0,1,1
11824,2,3,41565,41565,41568,0,3,1
11825,2,3,41567,41568,41571,1,4,0
11826,1,1,41568,41571,41572,3,4,0
11827,6,3,41574,41574,41577,0,3,2
11828,2,1,41576,41577,41578,1,2,0
11829,4,3,41580,41580,41583,0,3,2
11830,1,2,41581,41583,41585,2,4,0
11831,6,3,41587,41587,41590,0,3,2
11832,2,1,41589,41590,41591,1,2,0
11833,2,1,41591,41591,41592,0,1,0
11834,4,2,41595,41595,41597,0,2,3
11835,2,2,41597,41597,41599,0,2,0
11836,5,1,41602,41602,41603,0,1,3
11837,5,2,41607,41607,41609,0,2,4
11838,6,1,41613,41613,41614,0,1,4
11839,4,3,41617,41617,41620,0,3,3
11840,2,2,41619,41620,41622,1,3,0
11841,6,1,41625,41625,41626,0,1,3
11842,4,3,41629,41629,41632,0,3,3
11843,3,1,41632,41632,41633,0,1,0
11844,3,2,41635,41635,41637,0,2,2
11845,4,2,41639,41639,41641,0,2,2
11846,3,1,41642,41642,41643,0,1,1
11847,5,2,41647,41647,41649,0,2,4
11848,5,3,41652,41652,41655,0,3,3
11849,3,3,41655,41655,41658,0,3,0
11850,2,1,41657,41658,41659,1,2,0
11851,6,2,41663,41663,41665,0,2,4
11852,2,1,41665,41665,41666,0,1,0
11853,5,1,41670,41670,41671,0,1,4
11854,5,1,41675,41675,41676,0,1,4
11855,4,2,41679,41679,41681,0,2,3
11856,1,3,41680,41681,41684,1,4,0
11857,3,1,41683,41684,41685,1,2,0
11858,2,3,41685,41685,41688,0,3,0
11859,3,2,41688,41688,41690,0,2,0
11860,6,3,41694,41694,41697,0,3,4
11861,3,3,41697,41697,41700,0,3,0
11862,5,2,41702,41702,41704,0,2,2
11863,6,3,41708,41708,41711,0,3,4
11864,3,1,41711,41711,41712,0,1,0
11865,2,2,41713,41713,41715,0,2,1
11866,6,3,41719,41719,41722,0,3,4
11867,5,2,41724,41724,41726,0,2,2
11868,5,1,41729,41729,41730,0,1,3
11869,1,3,41730,41730,41733,0,3,0
11870,1,2,41731,41733,41735,2,4,0
11871,5,3,41736,41736,41739,0,3,1
11872,2,3,41738,41739,41742,1,4,0
11873,2,1,41740,41742,41743,2,3,0
11874,2,2,41742,41743,41745,1,3,0
11875,2,2,41744,41745,41747,1,3,0
11876,4,3,41748,41748,41751,0,3,1
11877,2,3,41750,41751,41754,1,4,0
11878,1,2,41751,41754,41756,3,5,0
11879,4,1,41755,41756,41757,1,2,0
11880,1,2,41756,41757,41759,1,3,0
11881,2,2,41758,41759,41761,1,3,0
11882,4,3,41762,41762,41765,0,3,1
11883,2,3,41764,41765,41768,1,4,0
11884,5,2,41769,41769,41771,0,2,1
11885,1,1,41770,41771,41772,1,2,0
11886,3,2,41773,41773,41775,0,2,1
11887,3,2,41776,41776,41778,0,2,1
11888,3,3,41779,41779,41782,0,3,1
11889,3,1,41782,41782,41783,0,1,0
11890,2,2,41784,41784,41786,0,2,1
11891,4,1,41788,41788,41789,0,1,2
11892,6,1,41794,41794,41795,0,1,5
11893,1,3,41795,41795,41798,0,3,0
11894,6,3,41801,41801,41804,0,3,3
11895,2,3,41803,41804,41807,1,4,0
11896,1,1,41804,41807,41808,3,4,0
11897,2,3,41806,41808,41811,2,5,0
11898,5,3,41811,41811,41814,0,3,0
11899,6,3,41817,41817,41820,0,3,3
11900,5,3,41822,41822,41825,0,3,2
11901,6,1,41828,41828,41829,0,1,3
11902,1,1,41829,41829,41830,0,1,0
11903,1,1,41830,41830,41831,0,1,0
11904,1,3,41831,41831,41834,0,3,0
11905,2,1,41833,41834,41835,1,2,0
11906,6,1,41839,41839,41840,0,1,4
11907,6,2,41845,41845,41847,0,2,5
11908,5,1,41850,41850,41851,0,1,3
11909,1,1,41851,41851,41852,0,1,0
11910,6,2,41857,41857,41859,0,2,5
11911,5,3,41862,41862,41865,0,3,3
11912,5,3,41867,41867,41870,0,3,2
11913,3,1,41870,41870,41871,0,1,0
11914,1,2,41871,41871,41873,0,2,0
11915,5,1,41876,41876,41877,0,1,3
11916,3,3,41879,41879,41882,0,3,2
11917,3,1,41882,41882,41883,0,1,0
11918,2,3,41884,41884,41887,0,3,1
11919,4,1,41888,41888,41889,0,1,1
11920,6,3,41894,41894,41897,0,3,5
11921,5,2,41899,41899,41901,0,2,2
11922,1,1,41900,41901,41902,1,2,0
11923,6,3,41906,41906,41909,0,3,4
11924,6,2,41912,41912,41914,0,2,3
11925,2,2,41914,41914,41916,0,2,0
11926,4,1,41918,41918,41919,0,1,2
11927,5,3,41923,41923,41926,0,3,4
11928,3,2,41926,41926,41928,0,2,0
11929,1,3,41927,41928,41931,1,4,0
11930,5,3,41932,41932,41935,0,3,1
11931,1,1,41933,41935,41936,2,3,0
11932,3,3,41936,41936,41939,0,3,0
11933,3,2,41939,41939,41941,0,2,0
11934,1,3,41940,41941,41944,1,4,0
11935,4,3,41944,41944,41947,0,3,0
11936,3,2,41947,41947,41949,0,2,0
11937,4,2,41951,41951,41953,0,2,2
11938,2,2,41953,41953,41955,0,2,0
11939,6,3,41959,41959,41962,0,3,4
11940,3,2,41962,41962,41964,0,2,0
11941,5,3,41967,41967,41970,0,3,3
11942,1,1,41968,41970,41971,2,3,0
11943,2,3,41970,41971,41974,1,4,0
11944,2,1,41972,41974,41975,2,3,0
11945,1,3,41973,41975,41978,2,5,0
11946,1,1,41974,41978,41979,4,5,0
11947,6,1,41980,41980,41981,0,1,1
11948,5,1,41985,41985,41986,0,1,4
11949,3,1,41988,41988,41989,0,1,2
11950,5,1,41993,41993,41994,0,1,4
11951,2,1,41995,41995,41996,0,1,1
11952,2,2,41997,41997,41999,0,2,1
11953,5,1,42002,42002,42003,0,1,3
11954,1,1,42003,42003,42004,0,1,0
11955,2,3,42005,42005,42008,0,3,1
11956,1,3,42006,42008,42011,2,5,0
11957,5,1,42011,42011,42012,0,1,0
11958,6,2,42017,42017,42019,0,2,5
11959,5,2,42022,42022,42024,0,2,3
11960,6,3,42028,42028,42031,0,3,4
11961,6,3,42034,42034,42037,0,3,3
11962,2,3,42036,42037,42040,1,4,0
11963,2,1,42038,42040,42041,2,3,0
11964,3,3,42041,42041,42044,0,3,0
11965,3,3,42044,42044,42047,0,3,0
11966,2,2,42046,42047,42049,1,3,0
11967,5,2,42051,42051,42053,0,2,2
11968,4,3,42055,42055,42058,0,3,2
11969,4,2,42059,42059,42061,0,2,1
11970,3,3,42062,42062,42065,0,3,1
11971,2,3,42064,42065,42068,1,4,0
11972,4,3,42068,42068,42071,0,3,0
11973,6,1,42074,42074,42075,0,1,3
11974,3,3,42077,42077,42080,0,3,2
11975,2,1,42079,42080,42081,1,2,0
11976,5,2,42084,42084,42086,0,2,3
11977,6,2,42090,42090,42092,0,2,4
11978,6,3,42096,42096,42099,0,3,4
11979,2,2,42098,42099,42101,1,3,0
11980,2,2,42100,42101,42103,1,3,0
11981,6,1,42106,42106,42107,0,1,3
11982,4,1,42110,42110,42111,0,1,3
11983,1,2,42111,42111,42113,0,2,0
11984,1,1,42112,42113,42114,1,2,0
11985,2,2,42114,42114,42116,0,2,0
11986,5,1,42119,42119,42120,0,1,3
11987,3,3,42122,42122,42125,0,3,2
11988,4,3,42126,42126,42129,0,3,1
11989,1,3,42127,42129,42132,2,5,0
11990,1,3,42128,42132,42135,4,7,0
11991,1,1,42129,42135,42136,6,7,0
11992,4,3,42133,42136,42139,3,6,0
11993,2,3,42135,42139,42142,4,7,0
11994,1,3,42136,42142,42145,6,9,0
11995,3,3,42139,42145,42148,6,9,0
11996,1,1,42140,42148,42149,8,9,0
11997,1,1,42141,42149,42150,8,9,0
11998,1,1,42142,42150,42151,8,9,0
11999,5,3,42147,42151,42154,4,7,0
12000,4,1,42151,42154,42155,3,4,0
12001,2,2,42153,42155,42157,2,4,0
12002,3,2,42156,42157,42159,1,3,0
12003,5,1,42161,42161,42162,0,1,2
12004,2,1,42163,42163,42164,0,1,1
12005,3,1,42166,42166,42167,0,1,2
12006,6,2,42172,42172,42174,0,2,5
12007,5,3,42177,42177,42180,0,3,3
12008,1,1,42178,42180,42181,2,3,0
12009,1,2,42179,42181,42183,2,4,0
12010,6,1,42185,42185,42186,0,1,2
12011,3,2,42188,42188,42190,0,2,2
12012,5,1,42193,42193,42194,0,1,3
12013,4,2,42197,42197,42199,0,2,3
12014,4,2,42201,42201,42203,0,2,2
12015,5,1,42206,42206,42207,0,1,3
12016,6,1,42212,42212,42213,0,1,5
12017,6,3,42218,42218,42221,0,3,5
12018,1,3,42219,42221,42224,2,5,0
12019,4,1,42223,42224,42225,1,2,0
12020,5,1,42228,42228,42229,0,1,3
12021,3,1,42231,42231,42232,0,1,2
12022,4,2,42235,42235,42237,0,2,3
12023,5,3,42240,42240,42243,0,3,3
12024,5,2,42245,42245,42247,0,2,2
12025,4,2,42249,42249,42251,0,2,2
12026,5,2,42254,42254,42256,0,2,3
12027,5,3,42259,42259,42262,0,3,3
12028,1,1,42260,42262,42263,2,3,0
12029,2,3,42262,42263,42266,1,4,0
12030,2,1,42264,42266,42267,2,3,0
12031,3,2,42267,42267,42269,0,2,0
12032,5,1,42272,42272,42273,0,1,3
12033,2,3,42274,42274,42277,0,3,1
12034,3,3,42277,42277,42280,0,3,0
12035,4,3,42281,42281,42284,0,3,1
12036,5,2,42286,42286,42288,0,2,2
12037,2,3,42288,42288,42291,0,3,0
12038,4,1,42292,42292,42293,0,1,1
12039,1,1,42293,42293,42294,0,1,0
12040,1,1,42294,42294,42295,0,1,0
12041,3,1,42297,42297,42298,0,1,2
12042,3,2,42300,42300,42302,0,2,2
12043,5,1,42305,42305,42306,0,1,3
12044,5,1,42310,42310,42311,0,1,4
12045,4,3,42314,42314,42317,0,3,3
12046,1,2,42315,42317,42319,2,4,0
12047,6,2,42321,42321,42323,0,2,2
12048,6,1,42327,42327,42328,0,1,4
12049,4,1,42331,42331,42332,0,1,3
12050,1,3,42332,42332,42335,0,3,0
12051,1,3,42333,42335,42338,2,5,0
12052,4,1,42337,42338,42339,1,2,0
12053,4,1,42341,42341,42342,0,1,2
12054,1,2,42342,42342,42344,0,2,0
12055,5,3,42347,42347,42350,0,3,3
12056,5,1,42352,42352,42353,0,1,2
12057,2,2,42354,42354,42356,0,2,1
12058,2,1,42356,42356,42357,0,1,0
12059,4,1,42360,42360,42361,0,1,3
12060,5,3,42365,42365,42368,0,3,4
12061,6,1,42371,42371,42372,0,1,3
12062,2,2,42373,42373,42375,0,2,1
12063,6,3,42379,42379,42382,0,3,4
12064,6,1,42385,42385,42386,0,1,3
12065,5,2,42390,42390,42392,0,2,4
12066,4,1,42394,42394,42395,0,1,2
12067,5,2,42399,42399,42401,0,2,4
12068,3,1,42402,42402,42403,0,1,1
12069,2,1,42404,42404,42405,0,1,1
12070,4,1,42408,42408,42409,0,1,3
12071,6,3,42414,42414,42417,0,3,5
12072,1,2,42415,42417,42419,2,4,0
12073,2,2,42417,42419,42421,2,4,0
12074,2,3,42419,42421,42424,2,5,0
12075,5,2,42424,42424,42426,0,2,0
12076,1,3,42425,42426,42429,1,4,0
12077,6,1,42431,42431,42432,0,1,2
12078,5,2,42436,42436,42438,0,2,4
12079,5,2,42441,42441,42443,0,2,3
12080,4,1,42445,42445,42446,0,1,2
12081,4,3,42449,42449,42452,0,3,3
12082,1,2,42450,42452,42454,2,4,0
12083,1,1,42451,42454,42455,3,4,0
12084,1,3,42452,42455,42458,3,6,0
12085,5,2,42457,42458,42460,1,3,0
12086,1,2,42458,42460,42462,2,4,0
12087,4,3,42462,42462,42465,0,3,0
12088,6,1,42468,42468,42469,0,1,3
12089,1,3,42469,42469,42472,0,3,0
12090,1,2,42470,42472,42474,2,4,0
12091,4,3,42474,42474,42477,0,3,0
12092,5,1,42479,42479,42480,0,1,2
12093,4,3,42483,42483,42486,0,3,3
12094,4,1,42487,42487,42488,0,1,1
12095,2,3,42489,42489,42492,0,3,1
12096,2,1,42491,42492,42493,1,2,0
12097,2,3,42493,42493,42496,0,3,0
12098,4,1,42497,42497,42498,0,1,1
12099,1,1,42498,42498,42499,0,1,0
12100,5,1,42503,42503,42504,0,1,4
12101,6,1,42509,42509,42510,0,1,5
12102,6,3,42515,42515,42518,0,3,5
12103,4,2,42519,42519,42521,0,2,1
12104,2,1,42521,42521,42522,0,1,0
12105,3,3,42524,42524,42527,0,3,2
12106,4,1,42528,42528,42529,0,1,1
12107,3,2,42531,42531,42533,0,2,2
12108,2,1,42533,42533,42534,0,1,0
12109,1,2,42534,42534,42536,0,2,0
12110,5,2,42539,42539,42541,0,2,3
12111,5,2,42544,42544,42546,0,2,3
12112,4,3,42548,42548,42551,0,3,2
12113,6,2,42554,42554,42556,0,2,3
12114,5,2,42559,42559,42561,0,2,3
12115,6,1,42565,42565,42566,0,1,4
12116,1,3,42566,42566,42569,0,3,0
12117,4,2,42570,42570,42572,0,2,1
12118,1,3,42571,42572,42575,1,4,0
12119,1,2,42572,42575,42577,3,5,0
12120,3,2,42575,42577,42579,2,4,0
12121,3,3,42578,42579,42582,1,4,0
12122,4,1,42582,42582,42583,0,1,0
12123,6,1,42588,42588,42589,0,1,5
12124,4,2,42592,42592,42594,0,2,3
12125,6,3,42598,42598,42601,0,3,4
12126,6,3,42604,42604,42607,0,3,3
12127,1,2,42605,42607,42609,2,4,0
12128,4,1,42609,42609,42610,0,1,0
12129,2,3,42611,42611,42614,0,3,1
12130,6,1,42617,42617,42618,0,1,3
12131,1,2,42618,42618,42620,0,2,0
12132,2,2,42620,42620,42622,0,2,0
12133,5,3,42625,42625,42628,0,3,3
12134,2,3,42627,42628,42631,1,4,0
12135,6,3,42633,42633,42636,0,3,2
12136,5,3,42638,42638,42641,0,3,2
12137,4,2,42642,42642,42644,0,2,1
12138,2,2,42644,42644,42646,0,2,0
12139,6,1,42650,42650,42651,0,1,4
12140,2,3,42652,42652,42655,0,3,1
12141,2,2,42654,42655,42657,1,3,0
12142,6,3,42660,42660,42663,0,3,3
12143,5,3,42665,42665,42668,0,3,2
12144,2,1,42667,42668,42669,1,2,0
12145,6,3,42673,42673,42676,0,3,4
12146,1,1,42674,42676,42677,2,3,0
12147,2,2,42676,42677,42679,1,3,0
12148,4,3,42680,42680,42683,0,3,1
12149,2,1,42682,42683,42684,1,2,0
12150,4,2,42686,42686,42688,0,2,2
12151,5,1,42691,42691,42692,0,1,3
12152,1,2,42692,42692,42694,0,2,0
12153,6,1,42698,42698,42699,0,1,4
12154,4,1,42702,42702,42703,0,1,3
12155,6,1,42708,42708,42709,0,1,5
12156,2,1,42710,42710,42711,0,1,1
12157,3,1,42713,42713,42714,0,1,2
12158,2,3,42715,42715,42718,0,3,1
12159,1,3,42716,42718,42721,2,5,0
12160,4,2,42720,42721,42723,1,3,0
12161,5,1,42725,42725,42726,0,1,2
12162,2,3,42727,42727,42730,0,3,1
12163,3,3,42730,42730,42733,0,3,0
12164,2,2,42732,42733,42735,1,3,0
12165,5,1,42737,42737,42738,0,1,2
12166,3,2,42740,42740,42742,0,2,2
12167,6,1,42746,42746,42747,0,1,4
12168,1,1,42747,42747,42748,0,1,0
12169,2,1,42749,42749,42750,0,1,1
12170,4,1,42753,42753,42754,0,1,3
12171,3,3,42756,42756,42759,0,3,2
12172,4,3,42760,42760,42763,0,3,1
12173,3,2,42763,42763,42765,0,2,0
12174,4,1,42767,42767,42768,0,1,2
12175,1,3,42768,42768,42771,0,3,0
12176,2,2,42770,42771,42773,1,3,0
12177,4,3,42774,42774,42777,0,3,1
12178,6,2,42780,42780,42782,0,2,3
12179,4,3,42784,42784,42787,0,3,2
12180,6,2,42790,42790,42792,0,2,3
12181,1,3,42791,42792,42795,1,4,0
12182,2,1,42793,42795,42796,2,3,0
12183,5,2,42798,42798,42800,0,2,2
12184,3,2,42801,42801,42803,0,2,1
12185,5,2,42806,42806,42808,0,2,3
12186,4,2,42810,42810,42812,0,2,2
12187,2,1,42812,42812,42813,0,1,0
12188,4,1,42816,42816,42817,0,1,3
12189,2,3,42818,42818,42821,0,3,1
12190,5,1,42823,42823,42824,0,1,2
12191,3,2,42826,42826,42828,0,2,2
12192,2,1,42828,42828,42829,0,1,0
12193,1,3,42829,42829,42832,0,3,0
12194,1,3,42830,42832,42835,2,5,0
12195,4,1,42834,42835,42836,1,2,0
12196,5,3,42839,42839,42842,0,3,3
12197,2,1,42841,42842,42843,1,2,0
12198,6,1,42847,42847,42848,0,1,4
12199,1,3,42848,42848,42851,0,3,0
12200,3,2,42851,42851,42853,0,2,0
12201,4,2,42855,42855,42857,0,2,2
12202,2,1,42857,42857,42858,0,1,0
12203,6,3,42863,42863,42866,0,3,5
12204,2,2,42865,42866,42868,1,3,0
12205,3,3,42868,42868,42871,0,3,0
12206,5,3,42873,42873,42876,0,3,2
12207,1,3,42874,42876,42879,2,5,0
12208,1,1,42875,42879,42880,4,5,0
12209,6,1,42881,42881,42882,0,1,1
12210,4,2,42885,42885,42887,0,2,3
12211,2,2,42887,42887,42889,0,2,0
12212,1,3,42888,42889,42892,1,4,0
12213,2,3,42890,42892,42895,2,5,0
12214,6,2,42896,42896,42898,0,2,1
12215,5,3,42901,42901,42904,0,3,3
12216,1,2,42902,42904,42906,2,4,0
12217,3,2,42905,42906,42908,1,3,0
12218,4,1,42909,42909,42910,0,1,1
12219,3,3,42912,42912,42915,0,3,2
12220,2,2,42914,42915,42917,1,3,0
12221,5,2,42919,42919,42921,0,2,2
12222,5,3,42924,42924,42927,0,3,3
12223,1,2,42925,42927,42929,2,4,0
12224,4,1,42929,42929,42930,0,1,0
12225,2,1,42931,42931,42932,0,1,1
12226,4,1,42935,42935,42936,0,1,3
12227,6,1,42941,42941,42942,0,1,5
12228,5,2,42946,42946,42948,0,2,4
12229,5,2,42951,42951,42953,0,2,3
12230,5,1,42956,42956,42957,0,1,3
12231,4,1,42960,42960,42961,0,1,3
12232,4,1,42964,42964,42965,0,1,3
12233,4,1,42968,42968,42969,0,1,3
12234,5,3,42973,42973,42976,0,3,4
12235,2,3,42975,42976,42979,1,4,0
12236,4,3,42979,42979,42982,0,3,0
12237,4,1,42983,42983,42984,0,1,1
12238,6,1,42989,42989,42990,0,1,5
12239,3,3,42992,42992,42995,0,3,2
12240,5,2,42997,42997,42999,0,2,2
12241,1,1,42998,42999,43000,1,2,0
12242,5,2,43003,43003,43005,0,2,3
12243,5,1,43008,43008,43009,0,1,3
12244,6,1,43014,43014,43015,0,1,5
12245,6,2,43020,43020,43022,0,2,5
12246,2,1,43022,43022,43023,0,1,0
12247,3,1,43025,43025,43026,0,1,2
12248,2,3,43027,43027,43030,0,3,1
12249,4,1,43031,43031,43032,0,1,1
12250,5,1,43036,43036,43037,0,1,4
12251,5,1,43041,43041,43042,0,1,4
12252,4,1,43045,43045,43046,0,1,3
12253,3,1,43048,43048,43049,0,1,2
12254,5,1,43053,43053,43054,0,1,4
12255,3,3,43056,43056,43059,0,3,2
12256,4,1,43060,43060,43061,0,1,1
12257,2,1,43062,43062,43063,0,1,1
12258,5,2,43067,43067,43069,0,2,4
12259,4,3,43071,43071,43074,0,3,2
12260,2,1,43073,43074,43075,1,2,0
12261,4,2,43077,43077,43079,0,2,2
12262,4,1,43081,43081,43082,0,1,2
12263,3,1,43084,43084,43085,0,1,2
12264,1,2,43085,43085,43087,0,2,0
12265,6,1,43091,43091,43092,0,1,4
12266,1,2,43092,43092,43094,0,2,0
12267,5,2,43097,43097,43099,0,2,3
12268,1,2,43098,43099,43101,1,3,0
12269,2,1,43100,43101,43102,1,2,0
12270,4,3,43104,43104,43107,0,3,2
12271,6,1,43110,43110,43111,0,1,3
12272,2,1,43112,43112,43113,0,1,1
12273,2,3,43114,43114,43117,0,3,1
12274,5,2,43119,43119,43121,0,2,2
12275,1,2,43120,43121,43123,1,3,0
12276,4,3,43124,43124,43127,0,3,1
12277,1,1,43125,43127,43128,2,3,0
12278,4,3,43129,43129,43132,0,3,1
12279,4,1,43133,43133,43134,0,1,1
12280,3,1,43136,43136,43137,0,1,2
12281,6,2,43142,43142,43144,0,2,5
12282,6,3,43148,43148,43151,0,3,4
12283,1,1,43149,43151,43152,2,3,0
12284,1,2,43150,43152,43154,2,4,0
12285,5,3,43155,43155,43158,0,3,1
12286,2,1,43157,43158,43159,1,2,0
12287,4,3,43161,43161,43164,0,3,2
12288,3,1,43164,43164,43165,0,1,0
12289,3,1,43167,43167,43168,0,1,2
12290,4,1,43171,43171,43172,0,1,3
12291,4,3,43175,43175,43178,0,3,3
12292,6,1,43181,43181,43182,0,1,3
12293,1,3,43182,43182,43185,0,3,0
12294,5,1,43187,43187,43188,0,1,2
12295,2,1,43189,43189,43190,0,1,1
12296,2,3,43191,43191,43194,0,3,1
12297,4,3,43195,43195,43198,0,3,1
12298,5,3,43200,43200,43203,0,3,2
12299,3,2,43203,43203,43205,0,2,0
12300,4,1,43207,43207,43208,0,1,2
12301,2,2,43209,43209,43211,0,2,1
12302,6,3,43215,43215,43218,0,3,4
12303,5,1,43220,43220,43221,0,1,2
12304,2,1,43222,43222,43223,0,1,1
12305,3,2,43225,43225,43227,0,2,2
12306,4,1,43229,43229,43230,0,1,2
12307,2,1,43231,43231,43232,0,1,1
12308,1,1,43232,43232,43233,0,1,0
12309,2,3,43234,43234,43237,0,3,1
12310,2,1,43236,43237,43238,1,2,0
12311,4,2,43240,43240,43242,0,2,2
12312,4,3,43244,43244,43247,0,3,2
12313,1,2,43245,43247,43249,2,4,0
12314,3,1,43248,43249,43250,1,2,0
12315,4,1,43252,43252,43253,0,1,2
12316,2,3,43254,43254,43257,0,3,1
12317,3,1,43257,43257,43258,0,1,0
12318,6,2,43263,43263,43265,0,2,5
12319,2,3,43265,43265,43268,0,3,0
12320,1,1,43266,43268,43269,2,3,0
12321,6,3,43272,43272,43275,0,3,3
12322,2,1,43274,43275,43276,1,2,0
12323,5,2,43279,43279,43281,0,2,3
12324,2,2,43281,43281,43283,0,2,0
12325,6,1,43287,43287,43288,0,1,4
12326,1,2,43288,43288,43290,0,2,0
12327,3,2,43291,43291,43293,0,2,1
12328,6,3,43297,43297,43300,0,3,4
12329,4,3,43301,43301,43304,0,3,1
12330,5,1,43306,43306,43307,0,1,2
12331,5,3,43311,43311,43314,0,3,4
12332,4,1,43315,43315,43316,0,1,1
12333,4,1,43319,43319,43320,0,1,3
12334,6,3,43325,43325,43328,0,3,5
12335,6,3,43331,43331,43334,0,3,3
12336,5,3,43336,43336,43339,0,3,2
12337,1,3,43337,43339,43342,2,5,0
12338,3,2,43340,43342,43344,2,4,0
12339,4,2,43344,43344,43346,0,2,0
12340,6,2,43350,43350,43352,0,2,4
12341,3,1,43353,43353,43354,0,1,1
12342,1,1,43354,43354,43355,0,1,0
12343,5,3,43359,43359,43362,0,3,4
12344,5,1,43364,43364,43365,0,1,2
12345,6,1,43370,43370,43371,0,1,5
12346,4,3,43374,43374,43377,0,3,3
12347,6,3,43380,43380,43383,0,3,3
12348,6,3,43386,43386,43389,0,3,3
12349,2,2,43388,43389,43391,1,3,0
12350,3,1,43391,43391,43392,0,1,0
12351,6,3,43397,43397,43400,0,3,5
12352,5,3,43402,43402,43405,0,3,2
12353,6,3,43408,43408,43411,0,3,3
12354,4,2,43412,43412,43414,0,2,1
12355,3,2,43415,43415,43417,0,2,1
12356,3,1,43418,43418,43419,0,1,1
12357,6,1,43424,43424,43425,0,1,5
12358,1,2,43425,43425,43427,0,2,0
12359,1,3,43426,43427,43430,1,4,0
12360,1,2,43427,43430,43432,3,5,0
12361,4,2,43431,43432,43434,1,3,0
12362,6,1,43437,43437,43438,0,1,3
12363,1,3,43438,43438,43441,0,3,0
12364,2,2,43440,43441,43443,1,3,0
12365,2,2,43442,43443,43445,1,3,0
12366,3,1,43445,43445,43446,0,1,0
12367,1,3,43446,43446,43449,0,3,0
12368,1,2,43447,43449,43451,2,4,0
12369,1,2,43448,43451,43453,3,5,0
12370,5,3,43453,43453,43456,0,3,0
12371,2,2,43455,43456,43458,1,3,0
12372,5,3,43460,43460,43463,0,3,2
12373,1,1,43461,43463,43464,2,3,0
12374,6,1,43467,43467,43468,0,1,3
12375,6,2,43473,43473,43475,0,2,5
12376,3,1,43476,43476,43477,0,1,1
12377,4,2,43480,43480,43482,0,2,3
12378,6,2,43486,43486,43488,0,2,4
12379,4,1,43490,43490,43491,0,1,2
12380,3,2,43493,43493,43495,0,2,2
12381,1,1,43494,43495,43496,1,2,0
12382,6,3,43500,43500,43503,0,3,4
12383,5,2,43505,43505,43507,0,2,2
12384,4,1,43509,43509,43510,0,1,2
12385,3,2,43512,43512,43514,0,2,2
12386,2,3,43514,43514,43517,0,3,0
12387,5,2,43519,43519,43521,0,2,2
12388,6,3,43525,43525,43528,0,3,4
12389,5,1,43530,43530,43531,0,1,2
12390,6,1,43536,43536,43537,0,1,5
12391,1,2,43537,43537,43539,0,2,0
12392,5,3,43542,43542,43545,0,3,3
12393,2,2,43544,43545,43547,1,3,0
12394,1,3,43545,43547,43550,2,5,0
12395,5,1,43550,43550,43551,0,1,0
12396,3,1,43553,43553,43554,0,1,2
12397,2,2,43555,43555,43557,0,2,1
12398,3,3,43558,43558,43561,0,3,1
12399,3,2,43561,43561,43563,0,2,0
12400,5,3,43566,43566,43569,0,3,3
12401,2,1,43568,43569,43570,1,2,0
12402,2,2,43570,43570,43572,0,2,0
12403,2,3,43572,43572,43575,0,3,0
12404,3,2,43575,43575,43577,0,2,0
12405,3,1,43578,43578,43579,0,1,1
12406,1,2,43579,43579,43581,0,2,0
12407,1,2,43580,43581,43583,1,3,0
12408,5,3,43585,43585,43588,0,3,2
12409,3,3,43588,43588,43591,0,3,0
12410,4,2,43592,43592,43594,0,2,1
12411,1,1,43593,43594,43595,1,2,0
12412,3,2,43596,43596,43598,0,2,1
12413,4,1,43600,43600,43601,0,1,2
12414,5,3,43605,43605,43608,0,3,4
12415,2,3,43607,43608,43611,1,4,0
12416,3,2,43610,43611,43613,1,3,0
12417,3,3,43613,43613,43616,0,3,0
12418,3,3,43616,43616,43619,0,3,0
12419,1,1,43617,43619,43620,2,3,0
12420,4,1,43621,43621,43622,0,1,1
12421,6,1,43627,43627,43628,0,1,5
12422,2,3,43629,43629,43632,0,3,1
12423,4,2,43633,43633,43635,0,2,1
12424,5,1,43638,43638,43639,0,1,3
12425,1,1,43639,43639,43640,0,1,0
12426,1,1,43640,43640,43641,0,1,0
12427,6,3,43646,43646,43649,0,3,5
12428,1,2,43647,43649,43651,2,4,0
12429,5,1,43652,43652,43653,0,1,1
12430,3,3,43655,43655,43658,0,3,2
12431,5,3,43660,43660,43663,0,3,2
12432,6,3,43666,43666,43669,0,3,3
12433,6,2,43672,43672,43674,0,2,3
12434,2,3,43674,43674,43677,0,3,0
12435,2,1,43676,43677,43678,1,2,0
12436,4,3,43680,43680,43683,0,3,2
12437,1,3,43681,43683,43686,2,5,0
12438,4,2,43685,43686,43688,1,3,0
12439,1,1,43686,43688,43689,2,3,0
12440,5,2,43691,43691,43693,0,2,2
12441,6,1,43697,43697,43698,0,1,4
12442,5,3,43702,43702,43705,0,3,4
12443,5,1,43707,43707,43708,0,1,2
12444,1,3,43708,43708,43711,0,3,0
12445,1,2,43709,43711,43713,2,4,0
12446,2,1,43711,43713,43714,2,3,0
12447,3,2,43714,43714,43716,0,2,0
12448,4,3,43718,43718,43721,0,3,2
12449,1,3,43719,43721,43724,2,5,0
12450,5,3,43724,43724,43727,0,3,0
12451,3,2,43727,43727,43729,0,2,0
12452,1,3,43728,43729,43732,1,4,0
12453,3,2,43731,43732,43734,1,3,0
12454,6,2,43737,43737,43739,0,2,3
12455,3,1,43740,43740,43741,0,1,1
12456,4,3,43744,43744,43747,0,3,3
12457,3,3,43747,43747,43750,0,3,0
12458,2,1,43749,43750,43751,1,2,0
12459,1,1,43750,43751,43752,1,2,0
12460,3,2,43753,43753,43755,0,2,1
12461,2,3,43755,43755,43758,0,3,0
12462,4,2,43759,43759,43761,0,2,1
12463,2,3,43761,43761,43764,0,3,0
12464,3,2,43764,43764,43766,0,2,0
12465,5,1,43769,43769,43770,0,1,3
12466,6,1,43775,43775,43776,0,1,5
12467,5,1,43780,43780,43781,0,1,4
12468,3,1,43783,43783,43784,0,1,2
12469,2,3,43785,43785,43788,0,3,1
12470,5,1,43790,43790,43791,0,1,2
12471,6,2,43796,43796,43798,0,2,5
12472,1,1,43797,43798,43799,1,2,0
12473,1,3,43798,43799,43802,1,4,0
12474,6,1,43804,43804,43805,0,1,2
12475,5,2,43809,43809,43811,0,2,4
12476,1,1,43810,43811,43812,1,2,0
12477,1,3,43811,43812,43815,1,4,0
12478,1,2,43812,43815,43817,3,5,0
12479,5,1,43817,43817,43818,0,1,0
12480,3,3,43820,43820,43823,0,3,2
12481,6,3,43826,43826,43829,0,3,3
12482,1,3,43827,43829,43832,2,5,0
12483,6,3,43833,43833,43836,0,3,1
12484,1,2,43834,43836,43838,2,4,0
12485,5,2,43839,43839,43841,0,2,1
12486,2,2,43841,43841,43843,0,2,0
12487,3,3,43844,43844,43847,0,3,1
12488,2,2,43846,43847,43849,1,3,0
12489,5,2,43851,43851,43853,0,2,2
12490,1,2,43852,43853,43855,1,3,0
12491,4,1,43856,43856,43857,0,1,1
12492,5,1,43861,43861,43862,0,1,4
12493,1,1,43862,43862,43863,0,1,0
12494,5,2,43867,43867,43869,0,2,4
12495,5,1,43872,43872,43873,0,1,3
12496,4,3,43876,43876,43879,0,3,3
12497,2,3,43878,43879,43882,1,4,0
12498,2,3,43880,43882,43885,2,5,0
12499,4,2,43884,43885,43887,1,3,0
12500,4,1,43888,43888,43889,0,1,1
12501,3,3,43891,43891,43894,0,3,2
12502,3,2,43894,43894,43896,0,2,0
12503,6,2,43900,43900,43902,0,2,4
12504,3,1,43903,43903,43904,0,1,1
12505,6,2,43909,43909,43911,0,2,5
12506,4,3,43913,43913,43916,0,3,2
12507,5,3,43918,43918,43921,0,3,2
12508,5,3,43923,43923,43926,0,3,2
12509,1,2,43924,43926,43928,2,4,0
12510,3,3,43927,43928,43931,1,4,0
12511,5,3,43932,43932,43935,0,3,1
12512,2,2,43934,43935,43937,1,3,0
12513,5,1,43939,43939,43940,0,1,2
12514,6,2,43945,43945,43947,0,2,5
12515,4,1,43949,43949,43950,0,1,2
12516,5,3,43954,43954,43957,0,3,4
12517,2,1,43956,43957,43958,1,2,0
12518,6,3,43962,43962,43965,0,3,4
12519,1,1,43963,43965,43966,2,3,0
12520,6,1,43969,43969,43970,0,1,3
12521,2,2,43971,43971,43973,0,2,1
12522,4,2,43975,43975,43977,0,2,2
12523,4,3,43979,43979,43982,0,3,2
12524,3,1,43982,43982,43983,0,1,0
12525,2,1,43984,43984,43985,0,1,1
12526,6,3,43990,43990,43993,0,3,5
12527,6,1,43996,43996,43997,0,1,3
12528,5,3,44001,44001,44004,0,3,4
12529,1,1,44002,44004,44005,2,3,0
12530,2,2,44004,44005,44007,1,3,0
12531,2,3,44006,44007,44010,1,4,0
12532,1,3,44007,44010,44013,3,6,0
12533,3,3,44010,44013,44016,3,6,0
12534,3,3,44013,44016,44019,3,6,0
12535,4,2,44017,44019,44021,2,4,0
12536,5,1,44022,44022,44023,0,1,1
12537,3,3,44025,44025,44028,0,3,2
12538,6,3,44031,44031,44034,0,3,3
12539,2,2,44033,44034,44036,1,3,0
12540,6,3,44039,44039,44042,0,3,3
12541,3,2,44042,44042,44044,0,2,0
12542,5,1,44047,44047,44048,0,1,3
12543,2,3,44049,44049,44052,0,3,1
12544,5,1,44054,44054,44055,0,1,2
12545,3,1,44057,44057,44058,0,1,2
12546,3,3,44060,44060,44063,0,3,2
12547,6,1,44066,44066,44067,0,1,3
12548,4,1,44070,44070,44071,0,1,3
12549,5,2,44075,44075,44077,0,2,4
12550,1,1,44076,44077,44078,1,2,0
12551,1,1,44077,44078,44079,1,2,0
12552,2,2,44079,44079,44081,0,2,0
12553,3,1,44082,44082,44083,0,1,1
12554,5,1,44087,44087,44088,0,1,4
12555,6,3,44093,44093,44096,0,3,5
12556,1,3,44094,44096,44099,2,5,0
12557,4,3,44098,44099,44102,1,4,0
12558,2,3,44100,44102,44105,2,5,0
12559,3,2,44103,44105,44107,2,4,0
12560,2,2,44105,44107,44109,2,4,0
12561,6,2,44111,44111,44113,0,2,2
12562,1,2,44112,44113,44115,1,3,0
12563,2,1,44114,44115,44116,1,2,0
12564,3,3,44117,44117,44120,0,3,1
12565,1,1,44118,44120,44121,2,3,0
12566,2,3,44120,44121,44124,1,4,0
12567,5,1,44125,44125,44126,0,1,1
12568,4,2,44129,44129,44131,0,2,3
12569,2,3,44131,44131,44134,0,3,0
12570,2,2,44133,44134,44136,1,3,0
12571,5,1,44138,44138,44139,0,1,2
12572,3,1,44141,44141,44142,0,1,2
12573,5,1,44146,44146,44147,0,1,4
12574,2,2,44148,44148,44150,0,2,1
12575,5,3,44153,44153,44156,0,3,3
12576,5,3,44158,44158,44161,0,3,2
12577,6,1,44164,44164,44165,0,1,3
12578,2,1,44166,44166,44167,0,1,1
12579,3,3,44169,44169,44172,0,3,2
12580,3,2,44172,44172,44174,0,2,0
12581,5,1,44177,44177,44178,0,1,3
12582,2,3,44179,44179,44182,0,3,1
12583,3,3,44182,44182,44185,0,3,0
12584,1,3,44183,44185,44188,2,5,0
12585,4,3,44187,44188,44191,1,4,0
12586,4,2,44191,44191,44193,0,2,0
12587,6,2,44197,44197,44199,0,2,4
12588,5,3,44202,44202,44205,0,3,3
12589,1,2,44203,44205,44207,2,4,0
12590,1,1,44204,44207,44208,3,4,0
12591,6,1,44210,44210,44211,0,1,2
12592,2,1,44212,44212,44213,0,1,1
12593,4,3,44216,44216,44219,0,3,3
12594,6,1,44222,44222,44223,0,1,3
12595,3,3,44225,44225,44228,0,3,2
12596,6,1,44231,44231,44232,0,1,3
12597,5,2,44236,44236,44238,0,2,4
12598,2,3,44238,44238,44241,0,3,0
12599,4,1,44242,44242,44243,0,1,1
12600,2,2,44244,44244,44246,0,2,1
12601,4,1,44248,44248,44249,0,1,2
12602,4,2,44252,44252,44254,0,2,3
12603,6,3,44258,44258,44261,0,3,4
12604,5,1,44263,44263,44264,0,1,2
12605,5,1,44268,44268,44269,0,1,4
12606,1,2,44269,44269,44271,0,2,0
12607,1,3,44270,44271,44274,1,4,0
12608,1,3,44271,44274,44277,3,6,0
12609,6,2,44277,44277,44279,0,2,0
12610,5,1,44282,44282,44283,0,1,3
12611,4,2,44286,44286,44288,0,2,3
12612,1,1,44287,44288,44289,1,2,0
12613,6,1,44293,44293,44294,0,1,4
12614,5,3,44298,44298,44301,0,3,4
12615,3,2,44301,44301,44303,0,2,0
12616,6,3,44307,44307,44310,0,3,4
12617,1,1,44308,44310,44311,2,3,0
12618,3,3,44311,44311,44314,0,3,0
12619,2,2,44313,44314,44316,1,3,0
12620,3,1,44316,44316,44317,0,1,0
12621,3,2,44319,44319,44321,0,2,2
12622,6,2,44325,44325,44327,0,2,4
12623,2,1,44327,44327,44328,0,1,0
12624,1,2,44328,44328,44330,0,2,0
12625,5,2,44333,44333,44335,0,2,3
12626,3,1,44336,44336,44337,0,1,1
12627,2,2,44338,44338,44340,0,2,1
12628,1,3,44339,44340,44343,1,4,0
12629,3,3,44342,44343,44346,1,4,0
12630,1,3,44343,44346,44349,3,6,0
12631,6,3,44349,44349,44352,0,3,0
12632,1,1,44350,44352,44353,2,3,0
12633,3,3,44353,44353,44356,0,3,0
12634,4,3,44357,44357,44360,0,3,1
12635,3,1,44360,44360,44361,0,1,0
12636,3,3,44363,44363,44366,0,3,2
12637,1,1,44364,44366,44367,2,3,0
12638,6,3,44370,44370,44373,0,3,3
12639,4,3,44374,44374,44377,0,3,1
12640,5,2,44379,44379,44381,0,2,2
12641,6,2,44385,44385,44387,0,2,4
12642,1,2,44386,44387,44389,1,3,0
12643,6,1,44392,44392,44393,0,1,3
12644,5,2,44397,44397,44399,0,2,4
12645,6,3,44403,44403,44406,0,3,4
12646,3,1,44406,44406,44407,0,1,0
12647,1,1,44407,44407,44408,0,1,0
12648,6,1,44413,44413,44414,0,1,5
12649,6,2,44419,44419,44421,0,2,5
12650,2,3,44421,44421,44424,0,3,0
12651,3,3,44424,44424,44427,0,3,0
12652,2,2,44426,44427,44429,1,3,0
12653,3,3,44429,44429,44432,0,3,0
12654,5,1,44434,44434,44435,0,1,2
12655,1,1,44435,44435,44436,0,1,0
12656,5,2,44440,44440,44442,0,2,4
12657,6,1,44446,44446,44447,0,1,4
12658,4,1,44450,44450,44451,0,1,3
12659,6,1,44456,44456,44457,0,1,5
12660,6,2,44462,44462,44464,0,2,5
12661,1,3,44463,44464,44467,1,4,0
12662,1,2,44464,44467,44469,3,5,0
12663,3,2,44467,44469,44471,2,4,0
12664,1,1,44468,44471,44472,3,4,0
12665,5,2,44473,44473,44475,0,2,1
12666,3,1,44476,44476,44477,0,1,1
12667,3,1,44479,44479,44480,0,1,2
12668,3,1,44482,44482,44483,0,1,2
12669,1,3,44483,44483,44486,0,3,0
12670,3,2,44486,44486,44488,0,2,0
12671,3,1,44489,44489,44490,0,1,1
12672,1,3,44490,44490,44493,0,3,0
12673,1,3,44491,44493,44496,2,5,0
12674,5,3,44496,44496,44499,0,3,0
12675,1,3,44497,44499,44502,2,5,0
12676,3,3,44500,44502,44505,2,5,0
12677,3,2,44503,44505,44507,2,4,0
12678,4,1,44507,44507,44508,0,1,0
12679,1,3,44508,44508,44511,0,3,0
12680,5,2,44513,44513,44515,0,2,2
12681,6,3,44519,44519,44522,0,3,4
12682,2,1,44521,44522,44523,1,2,0
12683,6,3,44527,44527,44530,0,3,4
12684,1,2,44528,44530,44532,2,4,0
12685,3,2,44531,44532,44534,1,3,0
12686,1,1,44532,44534,44535,2,3,0
12687,5,2,44537,44537,44539,0,2,2
12688,1,1,44538,44539,44540,1,2,0
12689,1,1,44539,44540,44541,1,2,0
12690,3,3,44542,44542,44545,0,3,1
12691,3,2,44545,44545,44547,0,2,0
12692,2,1,44547,44547,44548,0,1,0
12693,3,2,44550,44550,44552,0,2,2
12694,2,1,44552,44552,44553,0,1,0
12695,5,1,44557,44557,44558,0,1,4
12696,4,2,44561,44561,44563,0,2,3
12697,1,2,44562,44563,44565,1,3,0
12698,4,2,44566,44566,44568,0,2,1
12699,1,1,44567,44568,44569,1,2,0
12700,4,2,44571,44571,44573,0,2,2
12701,3,1,44574,44574,44575,0,1,1
12702,6,3,44580,44580,44583,0,3,5
12703,6,1,44586,44586,44587,0,1,3
12704,3,2,44589,44589,44591,0,2,2
12705,1,2,44590,44591,44593,1,3,0
12706,5,3,44595,44595,44598,0,3,2
12707,3,1,44598,44598,44599,0,1,0
12708,3,1,44601,44601,44602,0,1,2
12709,3,2,44604,44604,44606,0,2,2
12710,2,1,44606,44606,44607,0,1,0
12711,5,3,44611,44611,44614,0,3,4
12712,2,2,44613,44614,44616,1,3,0
12713,5,2,44618,44618,44620,0,2,2
12714,1,2,44619,44620,44622,1,3,0
12715,3,3,44622,44622,44625,0,3,0
12716,1,1,44623,44625,44626,2,3,0
12717,6,3,44629,44629,44632,0,3,3
12718,6,2,44635,44635,44637,0,2,3
12719,4,3,44639,44639,44642,0,3,2
12720,1,3,44640,44642,44645,2,5,0
12721,6,1,44646,44646,44647,0,1,1
12722,6,2,44652,44652,44654,0,2,5
12723,2,3,44654,44654,44657,0,3,0
12724,5,2,44659,44659,44661,0,2,2
12725,3,3,44662,44662,44665,0,3,1
12726,6,3,44668,44668,44671,0,3,3
12727,4,1,44672,44672,44673,0,1,1
12728,1,3,44673,44673,44676,0,3,0
12729,3,3,44676,44676,44679,0,3,0
12730,2,1,44678,44679,44680,1,2,0
12731,2,3,44680,44680,44683,0,3,0
12732,4,3,44684,44684,44687,0,3,1
12733,4,3,44688,44688,44691,0,3,1
12734,2,2,44690,44691,44693,1,3,0
12735,6,2,44696,44696,44698,0,2,3
12736,1,1,44697,44698,44699,1,2,0
12737,4,3,44701,44701,44704,0,3,2
12738,5,2,44706,44706,44708,0,2,2
12739,6,3,44712,44712,44715,0,3,4
12740,5,1,44717,44717,44718,0,1,2
12741,5,1,44722,44722,44723,0,1,4
12742,5,2,44727,44727,44729,0,2,4
12743,1,1,44728,44729,44730,1,2,0
12744,3,1,44731,44731,44732,0,1,1
12745,4,3,44735,44735,44738,0,3,3
12746,6,2,44741,44741,44743,0,2,3
12747,2,3,44743,44743,44746,0,3,0
12748,3,2,44746,44746,44748,0,2,0
12749,3,3,44749,44749,44752,0,3,1
12750,5,1,44754,44754,44755,0,1,2
12751,3,3,44757,44757,44760,0,3,2
12752,3,2,44760,44760,44762,0,2,0
12753,2,3,44762,44762,44765,0,3,0
12754,5,3,44767,44767,44770,0,3,2
12755,4,3,44771,44771,44774,0,3,1
12756,3,2,44774,44774,44776,0,2,0
12757,4,1,44778,44778,44779,0,1,2
12758,2,2,44780,44780,44782,0,2,1
12759,6,3,44786,44786,44789,0,3,4
12760,4,1,44790,44790,44791,0,1,1
12761,4,2,44794,44794,44796,0,2,3
12762,4,1,44798,44798,44799,0,1,2
12763,4,2,44802,44802,44804,0,2,3
12764,6,1,44808,44808,44809,0,1,4
12765,3,2,44811,44811,44813,0,2,2
12766,6,1,44817,44817,44818,0,1,4
12767,3,3,44820,44820,44823,0,3,2
12768,4,1,44824,44824,44825,0,1,1
12769,1,2,44825,44825,44827,0,2,0
12770,5,2,44830,44830,44832,0,2,3
12771,5,3,44835,44835,44838,0,3,3
12772,6,1,44841,44841,44842,0,1,3
12773,2,1,44843,44843,44844,0,1,1
12774,5,1,44848,44848,44849,0,1,4
12775,1,3,44849,44849,44852,0,3,0
12776,3,3,44852,44852,44855,0,3,0
12777,2,3,44854,44855,44858,1,4,0
12778,2,2,44856,44858,44860,2,4,0
12779,5,3,44861,44861,44864,0,3,1
12780,1,3,44862,44864,44867,2,5,0
12781,5,1,44867,44867,44868,0,1,0
12782,3,3,44870,44870,44873,0,3,2
12783,4,3,44874,44874,44877,0,3,1
12784,4,3,44878,44878,44881,0,3,1
12785,1,2,44879,44881,44883,2,4,0
12786,3,3,44882,44883,44886,1,4,0
12787,3,1,44885,44886,44887,1,2,0
12788,1,3,44886,44887,44890,1,4,0
12789,6,3,44892,44892,44895,0,3,2
12790,4,2,44896,44896,44898,0,2,1
12791,4,3,44900,44900,44903,0,3,2
12792,6,2,44906,44906,44908,0,2,3
12793,4,3,44910,44910,44913,0,3,2
12794,5,3,44915,44915,44918,0,3,2
12795,5,3,44920,44920,44923,0,3,2
12796,6,1,44926,44926,44927,0,1,3
12797,2,3,44928,44928,44931,0,3,1
12798,5,2,44933,44933,44935,0,2,2
12799,3,3,44936,44936,44939,0,3,1
12800,2,2,44938,44939,44941,1,3,0
12801,6,1,44944,44944,44945,0,1,3
12802,4,2,44948,44948,44950,0,2,3
12803,6,1,44954,44954,44955,0,1,4
12804,6,2,44960,44960,44962,0,2,5
12805,3,2,44963,44963,44965,0,2,1
12806,5,2,44968,44968,44970,0,2,3
12807,2,2,44970,44970,44972,0,2,0
12808,1,1,44971,44972,44973,1,2,0
12809,5,3,44976,44976,44979,0,3,3
12810,5,2,44981,44981,44983,0,2,2
12811,2,1,44983,44983,44984,0,1,0
12812,6,1,44989,44989,44990,0,1,5
12813,6,2,44995,44995,44997,0,2,5
12814,6,3,45001,45001,45004,0,3,4
12815,4,2,45005,45005,45007,0,2,1
12816,3,1,45008,45008,45009,0,1,1
12817,5,3,45013,45013,45016,0,3,4
12818,5,2,45018,45018,45020,0,2,2
12819,5,3,45023,45023,45026,0,3,3
12820,6,2,45029,45029,45031,0,2,3
12821,5,1,45034,45034,45035,0,1,3
12822,4,3,45038,45038,45041,0,3,3
12823,2,2,45040,45041,45043,1,3,0
12824,6,3,45046,45046,45049,0,3,3
12825,3,3,45049,45049,45052,0,3,0
12826,2,2,45051,45052,45054,1,3,0
12827,4,3,45055,45055,45058,0,3,1
12828,1,2,45056,45058,45060,2,4,0
12829,2,3,45058,45060,45063,2,5,0
12830,3,1,45061,45063,45064,2,3,0
12831,4,2,45065,45065,45067,0,2,1
12832,5,1,45070,45070,45071,0,1,3
12833,2,3,45072,45072,45075,0,3,1
12834,6,1,45078,45078,45079,0,1,3
12835,2,3,45080,45080,45083,0,3,1
12836,2,2,45082,45083,45085,1,3,0
12837,5,3,45087,45087,45090,0,3,2
12838,1,2,45088,45090,45092,2,4,0
12839,3,1,45091,45092,45093,1,2,0
12840,5,2,45096,45096,45098,0,2,3
12841,6,3,45102,45102,45105,0,3,4
12842,1,3,45103,45105,45108,2,5,0
12843,2,2,45105,45108,45110,3,5,0
12844,6,3,45111,45111,45114,0,3,1
12845,4,2,45115,45115,45117,0,2,1
12846,5,2,45120,45120,45122,0,2,3
12847,3,3,45123,45123,45126,0,3,1
12848,2,1,45125,45126,45127,1,2,0
12849,6,1,45131,45131,45132,0,1,4
12850,5,3,45136,45136,45139,0,3,4
12851,2,2,45138,45139,45141,1,3,0
12852,5,3,45143,45143,45146,0,3,2
12853,6,2,45149,45149,45151,0,2,3
12854,4,2,45153,45153,45155,0,2,2
12855,4,3,45157,45157,45160,0,3,2
12856,5,1,45162,45162,45163,0,1,2
12857,3,3,45165,45165,45168,0,3,2
12858,2,2,45167,45168,45170,1,3,0
12859,1,3,45168,45170,45173,2,5,0
12860,6,3,45174,45174,45177,0,3,1
12861,4,1,45178,45178,45179,0,1,1
12862,2,1,45180,45180,45181,0,1,1
12863,3,3,45183,45183,45186,0,3,2
12864,6,1,45189,45189,45190,0,1,3
12865,4,1,45193,45193,45194,0,1,3
12866,3,2,45196,45196,45198,0,2,2
12867,2,1,45198,45198,45199,0,1,0
12868,4,3,45202,45202,45205,0,3,3
12869,6,2,45208,45208,45210,0,2,3
12870,3,1,45211,45211,45212,0,1,1
12871,2,3,45213,45213,45216,0,3,1
12872,5,3,45218,45218,45221,0,3,2
12873,6,1,45224,45224,45225,0,1,3
12874,1,3,45225,45225,45228,0,3,0
12875,6,3,45231,45231,45234,0,3,3
12876,4,2,45235,45235,45237,0,2,1
12877,6,1,45241,45241,45242,0,1,4
12878,2,1,45243,45243,45244,0,1,1
12879,4,3,45247,45247,45250,0,3,3
12880,5,3,45252,45252,45255,0,3,2
12881,6,2,45258,45258,45260,0,2,3
12882,2,3,45260,45260,45263,0,3,0
12883,1,3,45261,45263,45266,2,5,0
12884,6,3,45267,45267,45270,0,3,1
12885,4,2,45271,45271,45273,0,2,1
12886,5,2,45276,45276,45278,0,2,3
12887,5,2,45281,45281,45283,0,2,3
12888,2,2,45283,45283,45285,0,2,0
12889,4,3,45287,45287,45290,0,3,2
12890,2,2,45289,45290,45292,1,3,0
12891,4,3,45293,45293,45296,0,3,1
12892,2,2,45295,45296,45298,1,3,0
12893,4,1,45299,45299,45300,0,1,1
12894,3,3,45302,45302,45305,0,3,2
12895,6,3,45308,45308,45311,0,3,3
12896,1,2,45309,45311,45313,2,4,0
12897,1,2,45310,45313,45315,3,5,0
12898,3,1,45313,45315,45316,2,3,0
12899,3,1,45316,45316,45317,0,1,0
12900,3,1,45319,45319,45320,0,1,2
12901,3,3,45322,45322,45325,0,3,2
12902,5,3,45327,45327,45330,0,3,2
12903,6,3,45333,45333,45336,0,3,3
12904,1,2,45334,45336,45338,2,4,0
12905,6,1,45340,45340,45341,0,1,2
12906,2,1,45342,45342,45343,0,1,1
12907,2,3,45344,45344,45347,0,3,1
12908,5,2,45349,45349,45351,0,2,2
12909,5,1,45354,45354,45355,0,1,3
12910,5,1,45359,45359,45360,0,1,4
12911,6,1,45365,45365,45366,0,1,5
12912,5,3,45370,45370,45373,0,3,4
12913,4,1,45374,45374,45375,0,1,1
12914,3,3,45377,45377,45380,0,3,2
12915,4,3,45381,45381,45384,0,3,1
12916,1,2,45382,45384,45386,2,4,0
12917,6,1,45388,45388,45389,0,1,2
12918,6,2,45394,45394,45396,0,2,5
12919,3,3,45397,45397,45400,0,3,1
12920,3,1,45400,45400,45401,0,1,0
12921,2,2,45402,45402,45404,0,2,1
12922,2,3,45404,45404,45407,0,3,0
12923,1,2,45405,45407,45409,2,4,0
12924,6,2,45411,45411,45413,0,2,2
12925,3,3,45414,45414,45417,0,3,1
12926,5,3,45419,45419,45422,0,3,2
12927,6,1,45425,45425,45426,0,1,3
12928,6,3,45431,45431,45434,0,3,5
12929,1,3,45432,45434,45437,2,5,0
12930,3,1,45435,45437,45438,2,3,0
12931,5,1,45440,45440,45441,0,1,2
12932,1,1,45441,45441,45442,0,1,0
12933,6,1,45447,45447,45448,0,1,5
12934,5,1,45452,45452,45453,0,1,4
12935,6,1,45458,45458,45459,0,1,5
12936,4,3,45462,45462,45465,0,3,3
12937,1,1,45463,45465,45466,2,3,0
12938,2,2,45465,45466,45468,1,3,0
12939,2,3,45467,45468,45471,1,4,0
12940,3,1,45470,45471,45472,1,2,0
12941,5,2,45475,45475,45477,0,2,3
12942,3,2,45478,45478,45480,0,2,1
12943,4,3,45482,45482,45485,0,3,2
12944,6,2,45488,45488,45490,0,2,3
12945,4,1,45492,45492,45493,0,1,2
12946,3,1,45495,45495,45496,0,1,2
12947,5,2,45500,45500,45502,0,2,4
12948,3,3,45503,45503,45506,0,3,1
12949,3,3,45506,45506,45509,0,3,0
12950,3,1,45509,45509,45510,0,1,0
12951,5,1,45514,45514,45515,0,1,4
12952,1,3,45515,45515,45518,0,3,0
12953,3,2,45518,45518,45520,0,2,0
12954,6,3,45524,45524,45527,0,3,4
12955,1,2,45525,45527,45529,2,4,0
12956,1,2,45526,45529,45531,3,5,0
12957,5,1,45531,45531,45532,0,1,0
12958,2,3,45533,45533,45536,0,3,1
12959,1,3,45534,45536,45539,2,5,0
12960,5,2,45539,45539,45541,0,2,0
12961,4,3,45543,45543,45546,0,3,2
12962,5,3,45548,45548,45551,0,3,2
12963,1,3,45549,45551,45554,2,5,0
12964,6,3,45555,45555,45558,0,3,1
12965,2,1,45557,45558,45559,1,2,0
12966,1,1,45558,45559,45560,1,2,0
12967,5,2,45563,45563,45565,0,2,3
12968,6,2,45569,45569,45571,0,2,4
12969,1,3,45570,45571,45574,1,4,0
12970,2,2,45572,45574,45576,2,4,0
12971,5,3,45577,45577,45580,0,3,1
12972,2,2,45579,45580,45582,1,3,0
12973,5,1,45584,45584,45585,0,1,2
12974,2,2,45586,45586,45588,0,2,1
12975,5,1,45591,45591,45592,0,1,3
12976,4,2,45595,45595,45597,0,2,3
12977,6,1,45601,45601,45602,0,1,4
12978,3,2,45604,45604,45606,0,2,2
12979,1,2,45605,45606,45608,1,3,0
12980,3,3,45608,45608,45611,0,3,0
12981,1,3,45609,45611,45614,2,5,0
12982,5,3,45614,45614,45617,0,3,0
12983,2,1,45616,45617,45618,1,2,0
12984,4,2,45620,45620,45622,0,2,2
12985,4,3,45624,45624,45627,0,3,2
12986,6,2,45630,45630,45632,0,2,3
12987,3,3,45633,45633,45636,0,3,1
12988,4,3,45637,45637,45640,0,3,1
12989,2,1,45639,45640,45641,1,2,0
12990,1,2,45640,45641,45643,1,3,0
12991,2,3,45642,45643,45646,1,4,0
12992,2,3,45644,45646,45649,2,5,0
12993,3,1,45647,45649,45650,2,3,0
12994,2,2,45649,45650,45652,1,3,0
12995,5,1,45654,45654,45655,0,1,2
12996,4,3,45658,45658,45661,0,3,3
12997,5,3,45663,45663,45666,0,3,2
12998,6,3,45669,45669,45672,0,3,3
12999,3,3,45672,45672,45675,0,3,0
13000,2,3,45674,45675,45678,1,4,0
13001,5,2,45679,45679,45681,0,2,1
13002,3,3,45682,45682,45685,0,3,1
13003,6,2,45688,45688,45690,0,2,3
13004,6,1,45694,45694,45695,0,1,4
13005,4,2,45698,45698,45700,0,2,3
13006,2,1,45700,45700,45701,0,1,0
13007,1,2,45701,45701,45703,0,2,0
13008,4,3,45705,45705,45708,0,3,2
13009,1,3,45706,45708,45711,2,5,0
13010,5,2,45711,45711,45713,0,2,0
13011,5,3,45716,45716,45719,0,3,3
13012,3,3,45719,45719,45722,0,3,0
13013,5,2,45724,45724,45726,0,2,2
13014,6,3,45730,45730,45733,0,3,4
13015,5,3,45735,45735,45738,0,3,2
13016,3,1,45738,45738,45739,0,1,0
13017,1,1,45739,45739,45740,0,1,0
13018,4,1,45743,45743,45744,0,1,3
13019,1,1,45744,45744,45745,0,1,0
13020,6,1,45750,45750,45751,0,1,5
13021,4,2,45754,45754,45756,0,2,3
13022,4,2,45758,45758,45760,0,2,2
13023,4,1,45762,45762,45763,0,1,2
13024,2,1,45764,45764,45765,0,1,1
13025,4,1,45768,45768,45769,0,1,3
13026,6,3,45774,45774,45777,0,3,5
13027,1,2,45775,45777,45779,2,4,0
13028,3,3,45778,45779,45782,1,4,0
13029,6,3,45784,45784,45787,0,3,2
13030,6,1,45790,45790,45791,0,1,3
13031,1,1,45791,45791,45792,0,1,0
13032,5,1,45796,45796,45797,0,1,4
13033,3,2,45799,45799,45801,0,2,2
13034,4,1,45803,45803,45804,0,1,2
13035,5,3,45808,45808,45811,0,3,4
13036,6,2,45814,45814,45816,0,2,3
13037,1,2,45815,45816,45818,1,3,0
13038,2,3,45817,45818,45821,1,4,0
13039,2,2,45819,45821,45823,2,4,0
13040,2,2,45821,45823,45825,2,4,0
13041,3,3,45824,45825,45828,1,4,0
13042,5,3,45829,45829,45832,0,3,1
13043,4,1,45833,45833,45834,0,1,1
13044,6,3,45839,45839,45842,0,3,5
13045,5,3,45844,45844,45847,0,3,2
13046,2,1,45846,45847,45848,1,2,0
13047,5,2,45851,45851,45853,0,2,3
13048,5,3,45856,45856,45859,0,3,3
13049,4,3,45860,45860,45863,0,3,1
13050,6,3,45866,45866,45869,0,3,3
13051,4,1,45870,45870,45871,0,1,1
13052,4,1,45874,45874,45875,0,1,3
13053,4,3,45878,45878,45881,0,3,3
13054,6,3,45884,45884,45887,0,3,3
13055,4,1,45888,45888,45889,0,1,1
13056,4,2,45892,45892,45894,0,2,3
13057,1,1,45893,45894,45895,1,2,0
13058,5,1,45898,45898,45899,0,1,3
13059,4,3,45902,45902,45905,0,3,3
13060,2,2,45904,45905,45907,1,3,0
13061,3,1,45907,45907,45908,0,1,0
13062,4,3,45911,45911,45914,0,3,3
13063,5,1,45916,45916,45917,0,1,2
13064,5,1,45921,45921,45922,0,1,4
13065,2,3,45923,45923,45926,0,3,1
13066,2,1,45925,45926,45927,1,2,0
13067,5,1,45930,45930,45931,0,1,3
13068,6,2,45936,45936,45938,0,2,5
13069,1,1,45937,45938,45939,1,2,0
13070,6,1,45943,45943,45944,0,1,4
13071,1,3,45944,45944,45947,0,3,0
13072,2,2,45946,45947,45949,1,3,0
13073,2,1,45948,45949,45950,1,2,0
13074,4,3,45952,45952,45955,0,3,2
13075,1,1,45953,45955,45956,2,3,0
13076,5,1,45958,45958,45959,0,1,2
13077,2,1,45960,45960,45961,0,1,1
13078,1,2,45961,45961,45963,0,2,0
13079,6,1,45967,45967,45968,0,1,4
13080,6,2,45973,45973,45975,0,2,5
13081,4,1,45977,45977,45978,0,1,2
13082,2,1,45979,45979,45980,0,1,1
13083,5,3,45984,45984,45987,0,3,4
13084,2,1,45986,45987,45988,1,2,0
13085,6,3,45992,45992,45995,0,3,4
13086,5,3,45997,45997,46000,0,3,2
13087,3,2,46000,46000,46002,0,2,0
13088,2,3,46002,46002,46005,0,3,0
13089,5,1,46007,46007,46008,0,1,2
13090,1,2,46008,46008,46010,0,2,0
13091,6,2,46014,46014,46016,0,2,4
13092,5,1,46019,46019,46020,0,1,3
13093,4,3,46023,46023,46026,0,3,3
13094,3,3,46026,46026,46029,0,3,0
13095,3,1,46029,46029,46030,0,1,0
13096,6,1,46035,46035,46036,0,1,5
13097,5,1,46040,46040,46041,0,1,4
13098,6,1,46046,46046,46047,0,1,5
13099,1,1,46047,46047,46048,0,1,0
13100,3,1,46050,46050,46051,0,1,2
13101,2,1,46052,46052,46053,0,1,1
13102,1,2,46053,46053,46055,0,2,0
13103,5,2,46058,46058,46060,0,2,3
13104,5,2,46063,46063,46065,0,2,3
13105,3,3,46066,46066,46069,0,3,1
13106,5,2,46071,46071,46073,0,2,2
13107,4,3,46075,46075,46078,0,3,2
13108,6,2,46081,46081,46083,0,2,3
13109,4,1,46085,46085,46086,0,1,2
13110,6,1,46091,46091,46092,0,1,5
13111,1,3,46092,46092,46095,0,3,0
13112,1,1,46093,46095,46096,2,3,0
13113,4,1,46097,46097,46098,0,1,1
13114,3,1,46100,46100,46101,0,1,2
13115,6,2,46106,46106,46108,0,2,5
13116,6,3,46112,46112,46115,0,3,4
13117,5,2,46117,46117,46119,0,2,2
13118,5,2,46122,46122,46124,0,2,3
13119,3,3,46125,46125,46128,0,3,1
13120,1,1,46126,46128,46129,2,3,0
13121,5,3,46131,46131,46134,0,3,2
13122,6,2,46137,46137,46139,0,2,3
13123,2,1,46139,46139,46140,0,1,0
13124,2,1,46141,46141,46142,0,1,1
13125,3,1,46144,46144,46145,0,1,2
13126,6,1,46150,46150,46151,0,1,5
13127,2,2,46152,46152,46154,0,2,1
13128,2,2,46154,46154,46156,0,2,0
13129,2,3,46156,46156,46159,0,3,0
13130,2,3,46158,46159,46162,1,4,0
13131,6,2,46164,46164,46166,0,2,2
13132,5,1,46169,46169,46170,0,1,3
13133,5,2,46174,46174,46176,0,2,4
13134,5,3,46179,46179,46182,0,3,3
13135,6,2,46185,46185,46187,0,2,3
13136,5,1,46190,46190,46191,0,1,3
13137,1,2,46191,46191,46193,0,2,0
13138,1,1,46192,46193,46194,1,2,0
13139,3,3,46195,46195,46198,0,3,1
13140,1,3,46196,46198,46201,2,5,0
13141,1,3,46197,46201,46204,4,7,0
13142,1,3,46198,46204,46207,6,9,0
13143,3,2,46201,46207,46209,6,8,0
13144,3,2,46204,46209,46211,5,7,0
13145,3,3,46207,46211,46214,4,7,0
13146,4,3,46211,46214,46217,3,6,0
13147,1,1,46212,46217,46218,5,6,0
13148,3,3,46215,46218,46221,3,6,0
13149,5,3,46220,46221,46224,1,4,0
13150,5,3,46225,46225,46228,0,3,1
13151,5,2,46230,46230,46232,0,2,2
13152,1,2,46231,46232,46234,1,3,0
13153,4,2,46235,46235,46237,0,2,1
13154,1,1,46236,46237,46238,1,2,0
13155,4,3,46240,46240,46243,0,3,2
13156,1,3,46241,46243,46246,2,5,0
13157,2,2,46243,46246,46248,3,5,0
13158,5,1,46248,46248,46249,0,1,0
13159,6,1,46254,46254,46255,0,1,5
13160,1,3,46255,46255,46258,0,3,0
13161,3,1,46258,46258,46259,0,1,0
13162,1,1,46259,46259,46260,0,1,0
13163,2,1,46261,46261,46262,0,1,1
13164,4,3,46265,46265,46268,0,3,3
13165,2,1,46267,46268,46269,1,2,0
13166,4,3,46271,46271,46274,0,3,2
13167,1,2,46272,46274,46276,2,4,0
13168,4,3,46276,46276,46279,0,3,0
13169,1,1,46277,46279,46280,2,3,0
13170,3,1,46280,46280,46281,0,1,0
13171,6,1,46286,46286,46287,0,1,5
13172,3,3,46289,46289,46292,0,3,2
13173,4,1,46293,46293,46294,0,1,1
13174,6,1,46299,46299,46300,0,1,5
13175,6,1,46305,46305,46306,0,1,5
13176,6,2,46311,46311,46313,0,2,5
13177,4,2,46315,46315,46317,0,2,2
13178,6,3,46321,46321,46324,0,3,4
13179,4,3,46325,46325,46328,0,3,1
13180,6,1,46331,46331,46332,0,1,3
13181,1,2,46332,46332,46334,0,2,0
13182,6,2,46338,46338,46340,0,2,4
13183,3,2,46341,46341,46343,0,2,1
13184,3,2,46344,46344,46346,0,2,1
13185,4,1,46348,46348,46349,0,1,2
13186,1,1,46349,46349,46350,0,1,0
13187,4,3,46353,46353,46356,0,3,3
13188,1,3,46354,46356,46359,2,5,0
13189,3,3,46357,46359,46362,2,5,0
13190,2,3,46359,46362,46365,3,6,0
13191,4,1,46363,46365,46366,2,3,0
13192,5,2,46368,46368,46370,0,2,2
13193,6,1,46374,46374,46375,0,1,4
13194,4,3,46378,46378,46381,0,3,3
13195,1,2,46379,46381,46383,2,4,0
13196,5,3,46384,46384,46387,0,3,1
13197,1,3,46385,46387,46390,2,5,0
13198,2,3,46387,46390,46393,3,6,0
13199,2,3,46389,46393,46396,4,7,0
13200,3,3,46392,46396,46399,4,7,0
13201,5,3,46397,46399,46402,2,5,0
13202,6,2,46403,46403,46405,0,2,1
13203,2,1,46405,46405,46406,0,1,0
13204,1,2,46406,46406,46408,0,2,0
13205,3,3,46409,46409,46412,0,3,1
13206,2,2,46411,46412,46414,1,3,0
13207,1,1,46412,46414,46415,2,3,0
13208,1,3,46413,46415,46418,2,5,0
13209,6,3,46419,46419,46422,0,3,1
13210,4,2,46423,46423,46425,0,2,1
13211,1,3,46424,46425,46428,1,4,0
13212,6,2,46430,46430,46432,0,2,2
13213,2,2,46432,46432,46434,0,2,0
13214,6,3,46438,46438,46441,0,3,4
13215,1,1,46439,46441,46442,2,3,0
13216,1,3,46440,46442,46445,2,5,0
13217,5,3,46445,46445,46448,0,3,0
13218,4,1,46449,46449,46450,0,1,1
13219,5,2,46454,46454,46456,0,2,4
13220,2,3,46456,46456,46459,0,3,0
13221,6,1,46462,46462,46463,0,1,3
13222,4,2,46466,46466,46468,0,2,3
13223,5,3,46471,46471,46474,0,3,3
13224,3,1,46474,46474,46475,0,1,0
13225,1,1,46475,46475,46476,0,1,0
13226,6,1,46481,46481,46482,0,1,5
13227,3,3,46484,46484,46487,0,3,2
13228,3,3,46487,46487,46490,0,3,0
13229,5,2,46492,46492,46494,0,2,2
13230,1,3,46493,46494,46497,1,4,0
13231,4,2,46497,46497,46499,0,2,0
13232,4,1,46501,46501,46502,0,1,2
13233,4,2,46505,46505,46507,0,2,3
13234,5,3,46510,46510,46513,0,3,3
13235,3,1,46513,46513,46514,0,1,0
13236,5,3,46518,46518,46521,0,3,4
13237,5,2,46523,46523,46525,0,2,2
13238,5,3,46528,46528,46531,0,3,3
13239,5,2,46533,46533,46535,0,2,2
13240,6,1,46539,46539,46540,0,1,4
13241,2,1,46541,46541,46542,0,1,1
13242,6,2,46547,46547,46549,0,2,5
13243,1,2,46548,46549,46551,1,3,0
13244,4,2,46552,46552,46554,0,2,1
13245,5,2,46557,46557,46559,0,2,3
13246,4,3,46561,46561,46564,0,3,2
13247,2,1,46563,46564,46565,1,2,0
13248,1,2,46564,46565,46567,1,3,0
13249,6,2,46570,46570,46572,0,2,3
13250,1,1,46571,46572,46573,1,2,0
13251,3,1,46574,46574,46575,0,1,1
13252,4,1,46578,46578,46579,0,1,3
13253,3,3,46581,46581,46584,0,3,2
13254,1,1,46582,46584,46585,2,3,0
13255,3,2,46585,46585,46587,0,2,0
13256,1,3,46586,46587,46590,1,4,0
13257,1,3,46587,46590,46593,3,6,0
13258,1,3,46588,46593,46596,5,8,0
13259,2,3,46590,46596,46599,6,9,0
13260,4,1,46594,46599,46600,5,6,0
13261,3,2,46597,46600,46602,3,5,0
13262,3,2,46600,46602,46604,2,4,0
13263,3,2,46603,46604,46606,1,3,0
13264,3,3,46606,46606,46609,0,3,0
13265,1,2,46607,46609,46611,2,4,0
13266,3,1,46610,46611,46612,1,2,0
13267,2,3,46612,46612,46615,0,3,0
13268,2,1,46614,46615,46616,1,2,0
13269,5,3,46619,46619,46622,0,3,3
13270,1,3,46620,46622,46625,2,5,0
13271,3,2,46623,46625,46627,2,4,0
13272,1,1,46624,46627,46628,3,4,0
13273,2,1,46626,46628,46629,2,3,0
13274,2,1,46628,46629,46630,1,2,0
13275,6,3,46634,46634,46637,0,3,4
13276,6,3,46640,46640,46643,0,3,3
13277,3,3,46643,46643,46646,0,3,0
13278,5,1,46648,46648,46649,0,1,2
13279,5,3,46653,46653,46656,0,3,4
13280,1,2,46654,46656,46658,2,4,0
13281,5,3,46659,46659,46662,0,3,1
13282,2,1,46661,46662,46663,1,2,0
13283,5,3,46666,46666,46669,0,3,3
13284,1,2,46667,46669,46671,2,4,0
13285,6,3,46673,46673,46676,0,3,2
13286,4,3,46677,46677,46680,0,3,1
13287,5,3,46682,46682,46685,0,3,2
13288,6,2,46688,46688,46690,0,2,3
13289,1,2,46689,46690,46692,1,3,0
13290,6,3,46695,46695,46698,0,3,3
13291,1,3,46696,46698,46701,2,5,0
13292,6,2,46702,46702,46704,0,2,1
13293,5,2,46707,46707,46709,0,2,3
13294,3,1,46710,46710,46711,0,1,1
13295,1,2,46711,46711,46713,0,2,0
13296,1,3,46712,46713,46716,1,4,0
13297,1,1,46713,46716,46717,3,4,0
13298,4,1,46717,46717,46718,0,1,0
13299,4,3,46721,46721,46724,0,3,3
13300,3,2,46724,46724,46726,0,2,0
13301,2,1,46726,46726,46727,0,1,0
13302,1,1,46727,46727,46728,0,1,0
13303,4,2,46731,46731,46733,0,2,3
13304,3,2,46734,46734,46736,0,2,1
13305,6,3,46740,46740,46743,0,3,4
13306,1,1,46741,46743,46744,2,3,0
13307,1,2,46742,46744,46746,2,4,0
13308,1,3,46743,46746,46749,3,6,0
13309,5,3,46748,46749,46752,1,4,0
13310,5,2,46753,46753,46755,0,2,1
13311,6,1,46759,46759,46760,0,1,4
13312,4,2,46763,46763,46765,0,2,3
13313,2,1,46765,46765,46766,0,1,0
13314,4,1,46769,46769,46770,0,1,3
13315,1,2,46770,46770,46772,0,2,0
13316,3,2,46773,46773,46775,0,2,1
13317,1,3,46774,46775,46778,1,4,0
13318,1,3,46775,46778,46781,3,6,0
13319,1,3,46776,46781,46784,5,8,0
13320,1,2,46777,46784,46786,7,9,0
13321,5,1,46782,46786,46787,4,5,0
13322,5,1,46787,46787,46788,0,1,0
13323,5,2,46792,46792,46794,0,2,4
13324,6,1,46798,46798,46799,0,1,4
13325,5,1,46803,46803,46804,0,1,4
13326,5,3,46808,46808,46811,0,3,4
13327,1,3,46809,46811,46814,2,5,0
13328,1,3,46810,46814,46817,4,7,0
13329,5,2,46815,46817,46819,2,4,0
13330,4,1,46819,46819,46820,0,1,0
13331,3,2,46822,46822,46824,0,2,2
13332,2,3,46824,46824,46827,0,3,0
13333,3,1,46827,46827,46828,0,1,0
13334,6,2,46833,46833,46835,0,2,5
13335,5,2,46838,46838,46840,0,2,3
13336,2,2,46840,46840,46842,0,2,0
13337,4,2,46844,46844,46846,0,2,2
13338,4,2,46848,46848,46850,0,2,2
13339,3,3,46851,46851,46854,0,3,1
13340,1,1,46852,46854,46855,2,3,0
13341,3,1,46855,46855,46856,0,1,0
13342,3,3,46858,46858,46861,0,3,2
13343,4,2,46862,46862,46864,0,2,1
13344,4,2,46866,46866,46868,0,2,2
13345,6,3,46872,46872,46875,0,3,4
13346,4,2,46876,46876,46878,0,2,1
13347,1,2,46877,46878,46880,1,3,0
13348,6,3,46883,46883,46886,0,3,3
13349,2,3,46885,46886,46889,1,4,0
13350,5,2,46890,46890,46892,0,2,1
13351,3,1,46893,46893,46894,0,1,1
13352,4,3,46897,46897,46900,0,3,3
13353,6,2,46903,46903,46905,0,2,3
13354,1,3,46904,46905,46908,1,4,0
13355,6,1,46910,46910,46911,0,1,2
13356,2,2,46912,46912,46914,0,2,1
13357,5,2,46917,46917,46919,0,2,3
13358,2,1,46919,46919,46920,0,1,0
13359,5,1,46924,46924,46925,0,1,4
13360,2,3,46926,46926,46929,0,3,1
13361,1,3,46927,46929,46932,2,5,0
13362,6,2,46933,46933,46935,0,2,1
13363,2,2,46935,46935,46937,0,2,0
13364,1,2,46936,46937,46939,1,3,0
13365,1,2,46937,46939,46941,2,4,0
13366,6,1,46943,46943,46944,0,1,2
13367,4,1,46947,46947,46948,0,1,3
13368,2,3,46949,46949,46952,0,3,1
13369,6,2,46955,46955,46957,0,2,3
13370,5,2,46960,46960,46962,0,2,3
13371,2,2,46962,46962,46964,0,2,0
13372,4,1,46966,46966,46967,0,1,2
13373,1,3,46967,46967,46970,0,3,0
13374,2,1,46969,46970,46971,1,2,0
13375,5,1,46974,46974,46975,0,1,3
13376,3,3,46977,46977,46980,0,3,2
13377,6,3,46983,46983,46986,0,3,3
13378,4,1,46987,46987,46988,0,1,1
13379,5,1,46992,46992,46993,0,1,4
13380,3,1,46995,46995,46996,0,1,2
13381,2,2,46997,46997,46999,0,2,1
13382,2,2,46999,46999,47001,0,2,0
13383,5,1,47004,47004,47005,0,1,3
13384,6,3,47010,47010,47013,0,3,5
13385,1,2,47011,47013,47015,2,4,0
13386,3,2,47014,47015,47017,1,3,0
13387,5,3,47019,47019,47022,0,3,2
13388,4,2,47023,47023,47025,0,2,1
13389,5,1,47028,47028,47029,0,1,3
13390,4,3,47032,47032,47035,0,3,3
13391,1,2,47033,47035,47037,2,4,0
13392,1,2,47034,47037,47039,3,5,0
13393,2,3,47036,47039,47042,3,6,0
13394,6,3,47042,47042,47045,0,3,0
13395,2,2,47044,47045,47047,1,3,0
13396,4,2,47048,47048,47050,0,2,1
13397,2,2,47050,47050,47052,0,2,0
13398,1,1,47051,47052,47053,1,2,0
13399,4,3,47055,47055,47058,0,3,2
13400,3,2,47058,47058,47060,0,2,0
13401,5,2,47063,47063,47065,0,2,3
13402,2,1,47065,47065,47066,0,1,0
13403,3,1,47068,47068,47069,0,1,2
13404,5,2,47073,47073,47075,0,2,4
13405,2,2,47075,47075,47077,0,2,0
13406,2,3,47077,47077,47080,0,3,0
13407,4,2,47081,47081,47083,0,2,1
13408,2,3,47083,47083,47086,0,3,0
13409,5,2,47088,47088,47090,0,2,2
13410,1,3,47089,47090,47093,1,4,0
13411,5,3,47094,47094,47097,0,3,1
13412,2,2,47096,47097,47099,1,3,0
13413,6,1,47102,47102,47103,0,1,3
13414,4,1,47106,47106,47107,0,1,3
13415,6,1,47112,47112,47113,0,1,5
13416,2,1,47114,47114,47115,0,1,1
13417,6,2,47120,47120,47122,0,2,5
13418,2,1,47122,47122,47123,0,1,0
13419,1,2,47123,47123,47125,0,2,0
13420,2,3,47125,47125,47128,0,3,0
13421,4,3,47129,47129,47132,0,3,1
13422,6,2,47135,47135,47137,0,2,3
13423,3,2,47138,47138,47140,0,2,1
13424,1,1,47139,47140,47141,1,2,0
13425,6,2,47145,47145,47147,0,2,4
13426,2,2,47147,47147,47149,0,2,0
13427,4,3,47151,47151,47154,0,3,2
13428,1,1,47152,47154,47155,2,3,0
13429,3,2,47155,47155,47157,0,2,0
13430,1,3,47156,47157,47160,1,4,0
13431,1,1,47157,47160,47161,3,4,0
13432,1,3,47158,47161,47164,3,6,0
13433,1,3,47159,47164,47167,5,8,0
13434,5,1,47164,47167,47168,3,4,0
13435,3,2,47167,47168,47170,1,3,0
13436,1,2,47168,47170,47172,2,4,0
13437,6,3,47174,47174,47177,0,3,2
13438,2,1,47176,47177,47178,1,2,0
13439,6,1,47182,47182,47183,0,1,4
13440,6,3,47188,47188,47191,0,3,5
13441,4,2,47192,47192,47194,0,2,1
13442,1,2,47193,47194,47196,1,3,0
13443,1,2,47194,47196,47198,2,4,0
13444,5,3,47199,47199,47202,0,3,1
13445,4,2,47203,47203,47205,0,2,1
13446,4,2,47207,47207,47209,0,2,2
13447,6,1,47213,47213,47214,0,1,4
13448,5,2,47218,47218,47220,0,2,4
13449,6,2,47224,47224,47226,0,2,4
13450,1,3,47225,47226,47229,1,4,0
13451,6,3,47231,47231,47234,0,3,2
13452,6,2,47237,47237,47239,0,2,3
13453,3,3,47240,47240,47243,0,3,1
13454,3,1,47243,47243,47244,0,1,0
13455,2,2,47245,47245,47247,0,2,1
13456,3,3,47248,47248,47251,0,3,1
13457,2,1,47250,47251,47252,1,2,0
13458,4,2,47254,47254,47256,0,2,2
13459,3,2,47257,47257,47259,0,2,1
13460,1,3,47258,47259,47262,1,4,0
13461,6,3,47264,47264,47267,0,3,2
13462,1,2,47265,47267,47269,2,4,0
13463,2,2,47267,47269,47271,2,4,0
13464,4,1,47271,47271,47272,0,1,0
13465,5,2,47276,47276,47278,0,2,4
13466,2,2,47278,47278,47280,0,2,0
13467,4,2,47282,47282,47284,0,2,2
13468,4,1,47286,47286,47287,0,1,2
13469,5,2,47291,47291,47293,0,2,4
13470,2,2,47293,47293,47295,0,2,0
13471,1,1,47294,47295,47296,1,2,0
13472,4,3,47298,47298,47301,0,3,2
13473,6,2,47304,47304,47306,0,2,3
13474,2,2,47306,47306,47308,0,2,0
13475,6,2,47312,47312,47314,0,2,4
13476,4,1,47316,47316,47317,0,1,2
13477,6,1,47322,47322,47323,0,1,5
13478,3,1,47325,47325,47326,0,1,2
13479,6,3,47331,47331,47334,0,3,5
13480,1,1,47332,47334,47335,2,3,0
13481,5,3,47337,47337,47340,0,3,2
13482,4,3,47341,47341,47344,0,3,1
13483,2,2,47343,47344,47346,1,3,0
13484,5,3,47348,47348,47351,0,3,2
13485,2,1,47350,47351,47352,1,2,0
13486,1,2,47351,47352,47354,1,3,0
13487,3,2,47354,47354,47356,0,2,0
13488,2,2,47356,47356,47358,0,2,0
13489,6,3,47362,47362,47365,0,3,4
13490,5,2,47367,47367,47369,0,2,2
13491,2,3,47369,47369,47372,0,3,0
13492,5,3,47374,47374,47377,0,3,2
13493,2,3,47376,47377,47380,1,4,0
13494,5,2,47381,47381,47383,0,2,1
13495,6,1,47387,47387,47388,0,1,4
13496,6,3,47393,47393,47396,0,3,5
13497,4,2,47397,47397,47399,0,2,1
13498,6,3,47403,47403,47406,0,3,4
13499,5,3,47408,47408,47411,0,3,2
13500,6,1,47414,47414,47415,0,1,3
13501,2,1,47416,47416,47417,0,1,1
13502,3,3,47419,47419,47422,0,3,2
13503,6,2,47425,47425,47427,0,2,3
13504,2,3,47427,47427,47430,0,3,0
13505,5,3,47432,47432,47435,0,3,2
13506,3,3,47435,47435,47438,0,3,0
13507,1,1,47436,47438,47439,2,3,0
13508,6,1,47442,47442,47443,0,1,3
13509,3,1,47445,47445,47446,0,1,2
13510,5,3,47450,47450,47453,0,3,4
13511,3,3,47453,47453,47456,0,3,0
13512,5,1,47458,47458,47459,0,1,2
13513,5,2,47463,47463,47465,0,2,4
13514,2,1,47465,47465,47466,0,1,0
13515,2,3,47467,47467,47470,0,3,1
13516,4,2,47471,47471,47473,0,2,1
13517,4,3,47475,47475,47478,0,3,2
13518,3,2,47478,47478,47480,0,2,0
13519,6,3,47484,47484,47487,0,3,4
13520,1,2,47485,47487,47489,2,4,0
13521,1,1,47486,47489,47490,3,4,0
13522,5,2,47491,47491,47493,0,2,1
13523,4,3,47495,47495,47498,0,3,2
13524,2,2,47497,47498,47500,1,3,0
13525,3,3,47500,47500,47503,0,3,0
13526,2,2,47502,47503,47505,1,3,0
13527,1,1,47503,47505,47506,2,3,0
13528,3,1,47506,47506,47507,0,1,0
13529,6,3,47512,47512,47515,0,3,5
13530,5,3,47517,47517,47520,0,3,2
13531,5,2,47522,47522,47524,0,2,2
13532,5,3,47527,47527,47530,0,3,3
13533,5,2,47532,47532,47534,0,2,2
13534,2,2,47534,47534,47536,0,2,0
13535,4,3,47538,47538,47541,0,3,2
13536,1,2,47539,47541,47543,2,4,0
13537,1,3,47540,47543,47546,3,6,0
13538,1,2,47541,47546,47548,5,7,0
13539,4,3,47545,47548,47551,3,6,0
13540,4,1,47549,47551,47552,2,3,0
13541,4,1,47553,47553,47554,0,1,1
13542,2,3,47555,47555,47558,0,3,1
13543,6,2,47561,47561,47563,0,2,3
13544,6,1,47567,47567,47568,0,1,4
13545,1,3,47568,47568,47571,0,3,0
13546,2,3,47570,47571,47574,1,4,0
13547,6,1,47576,47576,47577,0,1,2
13548,2,1,47578,47578,47579,0,1,1
13549,2,1,47580,47580,47581,0,1,1
13550,6,1,47586,47586,47587,0,1,5
13551,2,2,47588,47588,47590,0,2,1
13552,5,3,47593,47593,47596,0,3,3
13553,5,3,47598,47598,47601,0,3,2
13554,1,3,47599,47601,47604,2,5,0
13555,6,1,47605,47605,47606,0,1,1
13556,1,3,47606,47606,47609,0,3,0
13557,6,3,47612,47612,47615,0,3,3
13558,5,1,47617,47617,47618,0,1,2
13559,3,3,47620,47620,47623,0,3,2
13560,5,3,47625,47625,47628,0,3,2
13561,3,3,47628,47628,47631,0,3,0
13562,5,1,47633,47633,47634,0,1,2
13563,3,1,47636,47636,47637,0,1,2
13564,6,2,47642,47642,47644,0,2,5
13565,5,2,47647,47647,47649,0,2,3
13566,4,3,47651,47651,47654,0,3,2
13567,1,3,47652,47654,47657,2,5,0
13568,4,3,47656,47657,47660,1,4,0
13569,3,2,47659,47660,47662,1,3,0
13570,4,2,47663,47663,47665,0,2,1
13571,2,1,47665,47665,47666,0,1,0
13572,6,3,47671,47671,47674,0,3,5
13573,3,1,47674,47674,47675,0,1,0
13574,6,3,47680,47680,47683,0,3,5
13575,1,3,47681,47683,47686,2,5,0
13576,1,1,47682,47686,47687,4,5,0
13577,5,2,47687,47687,47689,0,2,0
13578,5,3,47692,47692,47695,0,3,3
13579,2,2,47694,47695,47697,1,3,0
13580,6,2,47700,47700,47702,0,2,3
13581,6,2,47706,47706,47708,0,2,4
13582,1,1,47707,47708,47709,1,2,0
13583,5,2,47712,47712,47714,0,2,3
13584,1,1,47713,47714,47715,1,2,0
13585,5,3,47718,47718,47721,0,3,3
13586,5,2,47723,47723,47725,0,2,2
13587,5,1,47728,47728,47729,0,1,3
13588,1,3,47729,47729,47732,0,3,0
13589,4,1,47733,47733,47734,0,1,1
13590,1,2,47734,47734,47736,0,2,0
13591,6,2,47740,47740,47742,0,2,4
13592,3,3,47743,47743,47746,0,3,1
13593,3,2,47746,47746,47748,0,2,0
13594,2,2,47748,47748,47750,0,2,0
13595,3,3,47751,47751,47754,0,3,1
13596,4,2,47755,47755,47757,0,2,1
13597,6,3,47761,47761,47764,0,3,4
13598,3,2,47764,47764,47766,0,2,0
13599,2,1,47766,47766,47767,0,1,0
13600,3,1,47769,47769,47770,0,1,2
13601,5,1,47774,47774,47775,0,1,4
13602,3,3,47777,47777,47780,0,3,2
13603,2,3,47779,47780,47783,1,4,0
13604,2,1,47781,47783,47784,2,3,0
13605,5,2,47786,47786,47788,0,2,2
13606,3,3,47789,47789,47792,0,3,1
13607,4,3,47793,47793,47796,0,3,1
13608,2,3,47795,47796,47799,1,4,0
13609,1,3,47796,47799,47802,3,6,0
13610,4,2,47800,47802,47804,2,4,0
13611,1,1,47801,47804,47805,3,4,0
13612,3,1,47804,47805,47806,1,2,0
13613,1,2,47805,47806,47808,1,3,0
13614,2,1,47807,47808,47809,1,2,0
13615,6,2,47813,47813,47815,0,2,4
13616,5,1,47818,47818,47819,0,1,3
13617,2,3,47820,47820,47823,0,3,1
13618,4,3,47824,47824,47827,0,3,1
13619,5,2,47829,47829,47831,0,2,2
13620,2,1,47831,47831,47832,0,1,0
13621,1,3,47832,47832,47835,0,3,0
13622,6,3,47838,47838,47841,0,3,3
13623,4,2,47842,47842,47844,0,2,1
13624,4,1,47846,47846,47847,0,1,2
13625,3,1,47849,47849,47850,0,1,2
13626,4,2,47853,47853,47855,0,2,3
13627,5,1,47858,47858,47859,0,1,3
13628,4,2,47862,47862,47864,0,2,3
13629,3,1,47865,47865,47866,0,1,1
13630,5,2,47870,47870,47872,0,2,4
13631,4,1,47874,47874,47875,0,1,2
13632,6,1,47880,47880,47881,0,1,5
13633,2,2,47882,47882,47884,0,2,1
13634,3,3,47885,47885,47888,0,3,1
13635,2,3,47887,47888,47891,1,4,0
13636,5,1,47892,47892,47893,0,1,1
13637,5,1,47897,47897,47898,0,1,4
13638,3,3,47900,47900,47903,0,3,2
13639,2,1,47902,47903,47904,1,2,0
13640,1,2,47903,47904,47906,1,3,0
13641,5,1,47908,47908,47909,0,1,2
13642,1,3,47909,47909,47912,0,3,0
13643,6,2,47915,47915,47917,0,2,3
13644,6,3,47921,47921,47924,0,3,4
13645,6,2,47927,47927,47929,0,2,3
13646,2,3,47929,47929,47932,0,3,0
13647,1,1,47930,47932,47933,2,3,0
13648,1,1,47931,47933,47934,2,3,0
13649,6,1,47937,47937,47938,0,1,3
13650,4,2,47941,47941,47943,0,2,3
13651,1,1,47942,47943,47944,1,2,0
13652,3,1,47945,47945,47946,0,1,1
13653,3,2,47948,47948,47950,0,2,2
13654,6,1,47954,47954,47955,0,1,4
13655,3,3,47957,47957,47960,0,3,2
13656,6,1,47963,47963,47964,0,1,3
13657,3,2,47966,47966,47968,0,2,2
13658,5,2,47971,47971,47973,0,2,3
13659,2,1,47973,47973,47974,0,1,0
13660,3,3,47976,47976,47979,0,3,2
13661,6,3,47982,47982,47985,0,3,3
13662,5,1,47987,47987,47988,0,1,2
13663,6,1,47993,47993,47994,0,1,5
13664,6,2,47999,47999,48001,0,2,5
13665,6,1,48005,48005,48006,0,1,4
13666,5,1,48010,48010,48011,0,1,4
13667,2,3,48012,48012,48015,0,3,1
13668,5,2,48017,48017,48019,0,2,2
13669,4,1,48021,48021,48022,0,1,2
13670,6,3,48027,48027,48030,0,3,5
13671,3,1,48030,48030,48031,0,1,0
13672,1,3,48031,48031,48034,0,3,0
13673,5,1,48036,48036,48037,0,1,2
13674,2,2,48038,48038,48040,0,2,1
13675,3,3,48041,48041,48044,0,3,1
13676,4,2,48045,48045,48047,0,2,1
13677,5,3,48050,48050,48053,0,3,3
13678,6,1,48056,48056,48057,0,1,3
13679,4,1,48060,48060,48061,0,1,3
13680,3,1,48063,48063,48064,0,1,2
13681,5,2,48068,48068,48070,0,2,4
13682,1,3,48069,48070,48073,1,4,0
13683,5,2,48074,48074,48076,0,2,1
13684,2,1,48076,48076,48077,0,1,0
13685,4,1,48080,48080,48081,0,1,3
13686,1,3,48081,48081,48084,0,3,0
13687,5,1,48086,48086,48087,0,1,2
13688,4,1,48090,48090,48091,0,1,3
13689,1,3,48091,48091,48094,0,3,0
13690,5,2,48096,48096,48098,0,2,2
13691,4,2,48100,48100,48102,0,2,2
13692,2,1,48102,48102,48103,0,1,0
13693,1,3,48103,48103,48106,0,3,0
13694,3,2,48106,48106,48108,0,2,0
13695,4,3,48110,48110,48113,0,3,2
13696,5,3,48115,48115,48118,0,3,2
13697,2,3,48117,48118,48121,1,4,0
13698,1,3,48118,48121,48124,3,6,0
13699,1,3,48119,48124,48127,5,8,0
13700,3,3,48122,48127,48130,5,8,0
13701,2,2,48124,48130,48132,6,8,0
13702,3,3,48127,48132,48135,5,8,0
13703,5,3,48132,48135,48138,3,6,0
13704,6,2,48138,48138,48140,0,2,0
13705,1,1,48139,48140,48141,1,2,0
13706,6,3,48145,48145,48148,0,3,4
13707,1,1,48146,48148,48149,2,3,0
13708,6,1,48152,48152,48153,0,1,3
13709,2,2,48154,48154,48156,0,2,1
13710,3,1,48157,48157,48158,0,1,1
13711,5,3,48162,48162,48165,0,3,4
13712,3,1,48165,48165,48166,0,1,0
13713,5,2,48170,48170,48172,0,2,4
13714,1,1,48171,48172,48173,1,2,0
13715,3,2,48174,48174,48176,0,2,1
13716,4,3,48178,48178,48181,0,3,2
13717,2,1,48180,48181,48182,1,2,0
13718,3,3,48183,48183,48186,0,3,1
13719,6,3,48189,48189,48192,0,3,3
13720,2,1,48191,48192,48193,1,2,0
13721,4,2,48195,48195,48197,0,2,2
13722,3,1,48198,48198,48199,0,1,1
13723,2,1,48200,48200,48201,0,1,1
13724,6,3,48206,48206,48209,0,3,5
13725,2,2,48208,48209,48211,1,3,0
13726,3,2,48211,48211,48213,0,2,0
13727,3,3,48214,48214,48217,0,3,1
13728,2,3,48216,48217,48220,1,4,0
13729,3,2,48219,48220,48222,1,3,0
13730,2,2,48221,48222,48224,1,3,0
13731,5,3,48226,48226,48229,0,3,2
13732,3,2,48229,48229,48231,0,2,0
13733,3,1,48232,48232,48233,0,1,1
13734,1,1,48233,48233,48234,0,1,0
13735,6,2,48239,48239,48241,0,2,5
13736,1,3,48240,48241,48244,1,4,0
13737,2,1,48242,48244,48245,2,3,0
13738,6,3,48248,48248,48251,0,3,3
13739,6,2,48254,48254,48256,0,2,3
13740,1,3,48255,48256,48259,1,4,0
13741,6,2,48261,48261,48263,0,2,2
13742,5,2,48266,48266,48268,0,2,3
13743,5,2,48271,48271,48273,0,2,3
13744,5,2,48276,48276,48278,0,2,3
13745,3,2,48279,48279,48281,0,2,1
13746,4,2,48283,48283,48285,0,2,2
13747,2,2,48285,48285,48287,0,2,0
13748,4,3,48289,48289,48292,0,3,2
13749,6,1,48295,48295,48296,0,1,3
13750,4,3,48299,48299,48302,0,3,3
13751,2,1,48301,48302,48303,1,2,0
13752,3,3,48304,48304,48307,0,3,1
13753,3,2,48307,48307,48309,0,2,0
13754,1,1,48308,48309,48310,1,2,0
13755,4,1,48312,48312,48313,0,1,2
13756,5,1,48317,48317,48318,0,1,4
13757,1,2,48318,48318,48320,0,2,0
13758,2,2,48320,48320,48322,0,2,0
13759,5,2,48325,48325,48327,0,2,3
13760,6,2,48331,48331,48333,0,2,4
13761,6,1,48337,48337,48338,0,1,4
13762,4,2,48341,48341,48343,0,2,3
13763,2,1,48343,48343,48344,0,1,0
13764,6,2,48349,48349,48351,0,2,5
13765,1,1,48350,48351,48352,1,2,0
13766,4,2,48354,48354,48356,0,2,2
13767,1,3,48355,48356,48359,1,4,0
13768,5,1,48360,48360,48361,0,1,1
13769,6,3,48366,48366,48369,0,3,5
13770,1,2,48367,48369,48371,2,4,0
13771,2,2,48369,48371,48373,2,4,0
13772,4,2,48373,48373,48375,0,2,0
13773,3,3,48376,48376,48379,0,3,1
13774,6,1,48382,48382,48383,0,1,3
13775,4,3,48386,48386,48389,0,3,3
13776,5,3,48391,48391,48394,0,3,2
13777,1,3,48392,48394,48397,2,5,0
13778,5,1,48397,48397,48398,0,1,0
13779,2,2,48399,48399,48401,0,2,1
13780,4,2,48403,48403,48405,0,2,2
13781,3,2,48406,48406,48408,0,2,1
13782,6,2,48412,48412,48414,0,2,4
13783,3,3,48415,48415,48418,0,3,1
13784,2,3,48417,48418,48421,1,4,0
13785,4,3,48421,48421,48424,0,3,0
13786,2,3,48423,48424,48427,1,4,0
13787,1,3,48424,48427,48430,3,6,0
13788,5,3,48429,48430,48433,1,4,0
13789,5,3,48434,48434,48437,0,3,1
13790,1,2,48435,48437,48439,2,4,0
13791,1,1,48436,48439,48440,3,4,0
13792,6,1,48442,48442,48443,0,1,2
13793,4,1,48446,48446,48447,0,1,3
13794,5,3,48451,48451,48454,0,3,4
13795,2,3,48453,48454,48457,1,4,0
13796,6,2,48459,48459,48461,0,2,2
13797,2,3,48461,48461,48464,0,3,0
13798,5,1,48466,48466,48467,0,1,2
13799,3,3,48469,48469,48472,0,3,2
13800,1,3,48470,48472,48475,2,5,0
13801,6,2,48476,48476,48478,0,2,1
13802,6,2,48482,48482,48484,0,2,4
13803,3,2,48485,48485,48487,0,2,1
13804,1,2,48486,48487,48489,1,3,0
13805,6,1,48492,48492,48493,0,1,3
13806,1,1,48493,48493,48494,0,1,0
13807,2,3,48495,48495,48498,0,3,1
13808,2,2,48497,48498,48500,1,3,0
13809,2,3,48499,48500,48503,1,4,0
13810,4,1,48503,48503,48504,0,1,0
13811,1,2,48504,48504,48506,0,2,0
13812,3,1,48507,48507,48508,0,1,1
13813,2,2,48509,48509,48511,0,2,1
13814,1,1,48510,48511,48512,1,2,0
13815,6,2,48516,48516,48518,0,2,4
13816,6,1,48522,48522,48523,0,1,4
13817,3,3,48525,48525,48528,0,3,2
13818,3,2,48528,48528,48530,0,2,0
13819,1,1,48529,48530,48531,1,2,0
13820,4,3,48533,48533,48536,0,3,2
13821,2,1,48535,48536,48537,1,2,0
13822,2,1,48537,48537,48538,0,1,0
13823,4,3,48541,48541,48544,0,3,3
13824,4,3,48545,48545,48548,0,3,1
13825,6,1,48551,48551,48552,0,1,3
13826,4,2,48555,48555,48557,0,2,3
13827,5,1,48560,48560,48561,0,1,3
13828,4,1,48564,48564,48565,0,1,3
13829,6,1,48570,48570,48571,0,1,5
13830,2,1,48572,48572,48573,0,1,1
13831,1,3,48573,48573,48576,0,3,0
13832,3,3,48576,48576,48579,0,3,0
13833,1,1,48577,48579,48580,2,3,0
13834,2,2,48579,48580,48582,1,3,0
13835,3,2,48582,48582,48584,0,2,0
13836,2,1,48584,48584,48585,0,1,0
13837,5,1,48589,48589,48590,0,1,4
13838,1,2,48590,48590,48592,0,2,0
13839,3,2,48593,48593,48595,0,2,1
13840,3,2,48596,48596,48598,0,2,1
13841,1,2,48597,48598,48600,1,3,0
13842,6,1,48603,48603,48604,0,1,3
13843,1,1,48604,48604,48605,0,1,0
13844,2,3,48606,48606,48609,0,3,1
13845,6,3,48612,48612,48615,0,3,3
13846,3,2,48615,48615,48617,0,2,0
13847,4,2,48619,48619,48621,0,2,2
13848,4,1,48623,48623,48624,0,1,2
13849,4,1,48627,48627,48628,0,1,3
13850,5,2,48632,48632,48634,0,2,4
13851,4,1,48636,48636,48637,0,1,2
13852,3,2,48639,48639,48641,0,2,2
13853,4,3,48643,48643,48646,0,3,2
13854,5,2,48648,48648,48650,0,2,2
13855,6,2,48654,48654,48656,0,2,4
13856,2,3,48656,48656,48659,0,3,0
13857,4,2,48660,48660,48662,0,2,1
13858,5,3,48665,48665,48668,0,3,3
13859,1,1,48666,48668,48669,2,3,0
13860,3,1,48669,48669,48670,0,1,0
13861,6,3,48675,48675,48678,0,3,5
13862,6,1,48681,48681,48682,0,1,3
13863,1,2,48682,48682,48684,0,2,0
13864,6,3,48688,48688,48691,0,3,4
13865,4,3,48692,48692,48695,0,3,1
13866,5,2,48697,48697,48699,0,2,2
13867,3,3,48700,48700,48703,0,3,1
13868,4,1,48704,48704,48705,0,1,1
13869,4,2,48708,48708,48710,0,2,3
13870,2,1,48710,48710,48711,0,1,0
13871,5,1,48715,48715,48716,0,1,4
13872,2,2,48717,48717,48719,0,2,1
13873,4,3,48721,48721,48724,0,3,2
13874,6,3,48727,48727,48730,0,3,3
13875,3,3,48730,48730,48733,0,3,0
13876,2,3,48732,48733,48736,1,4,0
13877,2,3,48734,48736,48739,2,5,0
13878,6,2,48740,48740,48742,0,2,1
13879,3,1,48743,48743,48744,0,1,1
13880,5,3,48748,48748,48751,0,3,4
13881,6,1,48754,48754,48755,0,1,3
13882,6,2,48760,48760,48762,0,2,5
13883,4,2,48764,48764,48766,0,2,2
13884,6,1,48770,48770,48771,0,1,4
13885,4,1,48774,48774,48775,0,1,3
13886,3,3,48777,48777,48780,0,3,2
13887,1,3,48778,48780,48783,2,5,0
13888,1,1,48779,48783,48784,4,5,0
13889,1,1,48780,48784,48785,4,5,0
13890,2,1,48782,48785,48786,3,4,0
13891,5,3,48787,48787,48790,0,3,1
13892,1,1,48788,48790,48791,2,3,0
13893,6,2,48794,48794,48796,0,2,3
13894,4,3,48798,48798,48801,0,3,2
13895,3,2,48801,48801,48803,0,2,0
13896,6,3,48807,48807,48810,0,3,4
13897,1,2,48808,48810,48812,2,4,0
13898,2,2,48810,48812,48814,2,4,0
13899,5,3,48815,48815,48818,0,3,1
13900,5,1,48820,48820,48821,0,1,2
13901,2,2,48822,48822,48824,0,2,1
13902,6,2,48828,48828,48830,0,2,4
13903,5,1,48833,48833,48834,0,1,3
13904,6,3,48839,48839,48842,0,3,5
13905,3,3,48842,48842,48845,0,3,0
13906,1,1,48843,48845,48846,2,3,0
13907,5,2,48848,48848,48850,0,2,2
13908,5,2,48853,48853,48855,0,2,3
13909,6,3,48859,48859,48862,0,3,4
13910,5,2,48864,48864,48866,0,2,2
13911,2,1,48866,48866,48867,0,1,0
13912,3,2,48869,48869,48871,0,2,2
13913,5,1,48874,48874,48875,0,1,3
13914,2,3,48876,48876,48879,0,3,1
13915,3,3,48879,48879,48882,0,3,0
13916,2,1,48881,48882,48883,1,2,0
13917,6,1,48887,48887,48888,0,1,4
13918,4,1,48891,48891,48892,0,1,3
13919,1,2,48892,48892,48894,0,2,0
13920,3,1,48895,48895,48896,0,1,1
13921,2,2,48897,48897,48899,0,2,1
13922,4,3,48901,48901,48904,0,3,2
13923,2,3,48903,48904,48907,1,4,0
13924,3,3,48906,48907,48910,1,4,0
13925,5,1,48911,48911,48912,0,1,1
13926,5,3,48916,48916,48919,0,3,4
13927,6,3,48922,48922,48925,0,3,3
13928,4,1,48926,48926,48927,0,1,1
13929,3,3,48929,48929,48932,0,3,2
13930,4,3,48933,48933,48936,0,3,1
13931,5,1,48938,48938,48939,0,1,2
13932,4,1,48942,48942,48943,0,1,3
13933,1,1,48943,48943,48944,0,1,0
13934,1,3,48944,48944,48947,0,3,0
13935,4,2,48948,48948,48950,0,2,1
13936,2,2,48950,48950,48952,0,2,0
13937,5,1,48955,48955,48956,0,1,3
13938,1,3,48956,48956,48959,0,3,0
13939,5,1,48961,48961,48962,0,1,2
13940,5,3,48966,48966,48969,0,3,4
13941,2,3,48968,48969,48972,1,4,0
13942,6,1,48974,48974,48975,0,1,2
13943,6,2,48980,48980,48982,0,2,5
13944,4,3,48984,48984,48987,0,3,2
13945,2,1,48986,48987,48988,1,2,0
13946,5,1,48991,48991,48992,0,1,3
13947,1,1,48992,48992,48993,0,1,0
13948,6,2,48998,48998,49000,0,2,5
13949,2,2,49000,49000,49002,0,2,0
13950,5,1,49005,49005,49006,0,1,3
13951,2,3,49007,49007,49010,0,3,1
13952,1,1,49008,49010,49011,2,3,0
13953,3,1,49011,49011,49012,0,1,0
13954,6,2,49017,49017,49019,0,2,5
13955,1,1,49018,49019,49020,1,2,0
13956,6,1,49024,49024,49025,0,1,4
13957,6,3,49030,49030,49033,0,3,5
13958,4,2,49034,49034,49036,0,2,1
13959,4,2,49038,49038,49040,0,2,2
13960,4,3,49042,49042,49045,0,3,2
13961,6,2,49048,49048,49050,0,2,3
13962,6,1,49054,49054,49055,0,1,4
13963,1,3,49055,49055,49058,0,3,0
13964,3,3,49058,49058,49061,0,3,0
13965,4,1,49062,49062,49063,0,1,1
13966,4,1,49066,49066,49067,0,1,3
13967,1,3,49067,49067,49070,0,3,0
13968,1,2,49068,49070,49072,2,4,0
13969,3,3,49071,49072,49075,1,4,0
13970,2,1,49073,49075,49076,2,3,0
13971,5,1,49078,49078,49079,0,1,2
13972,6,1,49084,49084,49085,0,1,5
13973,1,1,49085,49085,49086,0,1,0
13974,6,2,49091,49091,49093,0,2,5
13975,3,1,49094,49094,49095,0,1,1
13976,5,1,49099,49099,49100,0,1,4
13977,2,2,49101,49101,49103,0,2,1
13978,3,1,49104,49104,49105,0,1,1
13979,2,1,49106,49106,49107,0,1,1
13980,5,2,49111,49111,49113,0,2,4
13981,3,1,49114,49114,49115,0,1,1
13982,6,1,49120,49120,49121,0,1,5
13983,5,1,49125,49125,49126,0,1,4
13984,6,3,49131,49131,49134,0,3,5
13985,3,2,49134,49134,49136,0,2,0
13986,1,3,49135,49136,49139,1,4,0
13987,6,1,49141,49141,49142,0,1,2
13988,1,1,49142,49142,49143,0,1,0
13989,5,1,49147,49147,49148,0,1,4
13990,5,3,49152,49152,49155,0,3,4
13991,3,3,49155,49155,49158,0,3,0
13992,1,2,49156,49158,49160,2,4,0
13993,6,3,49162,49162,49165,0,3,2
13994,1,2,49163,49165,49167,2,4,0
13995,1,1,49164,49167,49168,3,4,0
13996,3,2,49167,49168,49170,1,3,0
13997,6,3,49173,49173,49176,0,3,3
13998,2,1,49175,49176,49177,1,2,0
13999,2,1,49177,49177,49178,0,1,0
14000,3,2,49180,49180,49182,0,2,2
14001,6,1,49186,49186,49187,0,1,4
14002,3,2,49189,49189,49191,0,2,2
14003,4,1,49193,49193,49194,0,1,2
14004,5,2,49198,49198,49200,0,2,4
14005,3,1,49201,49201,49202,0,1,1
14006,3,3,49204,49204,49207,0,3,2
14007,2,1,49206,49207,49208,1,2,0
14008,3,3,49209,49209,49212,0,3,1
14009,5,2,49214,49214,49216,0,2,2
14010,2,2,49216,49216,49218,0,2,0
14011,5,3,49221,49221,49224,0,3,3
14012,2,1,49223,49224,49225,1,2,0
14013,6,2,49229,49229,49231,0,2,4
14014,4,1,49233,49233,49234,0,1,2
14015,2,3,49235,49235,49238,0,3,1
14016,1,2,49236,49238,49240,2,4,0
14017,6,2,49242,49242,49244,0,2,2
14018,5,2,49247,49247,49249,0,2,3
14019,1,1,49248,49249,49250,1,2,0
14020,2,3,49250,49250,49253,0,3,0
14021,4,1,49254,49254,49255,0,1,1
14022,2,1,49256,49256,49257,0,1,1
14023,1,3,49257,49257,49260,0,3,0
14024,3,1,49260,49260,49261,0,1,0
14025,2,1,49262,49262,49263,0,1,1
14026,3,1,49265,49265,49266,0,1,2
14027,5,2,49270,49270,49272,0,2,4
14028,6,1,49276,49276,49277,0,1,4
14029,1,3,49277,49277,49280,0,3,0
14030,4,2,49281,49281,49283,0,2,1
14031,5,2,49286,49286,49288,0,2,3
14032,1,1,49287,49288,49289,1,2,0
14033,5,1,49292,49292,49293,0,1,3
14034,6,2,49298,49298,49300,0,2,5
14035,1,1,49299,49300,49301,1,2,0
14036,1,1,49300,49301,49302,1,2,0
14037,6,1,49306,49306,49307,0,1,4
14038,4,1,49310,49310,49311,0,1,3
14039,6,2,49316,49316,49318,0,2,5
14040,5,1,49321,49321,49322,0,1,3
14041,3,1,49324,49324,49325,0,1,2
14042,2,2,49326,49326,49328,0,2,1
14043,4,2,49330,49330,49332,0,2,2
14044,3,3,49333,49333,49336,0,3,1
14045,2,2,49335,49336,49338,1,3,0
14046,4,3,49339,49339,49342,0,3,1
14047,6,3,49345,49345,49348,0,3,3
14048,4,2,49349,49349,49351,0,2,1
14049,2,2,49351,49351,49353,0,2,0
14050,1,3,49352,49353,49356,1,4,0
14051,3,2,49355,49356,49358,1,3,0
14052,6,1,49361,49361,49362,0,1,3
14053,6,1,49367,49367,49368,0,1,5
14054,3,3,49370,49370,49373,0,3,2
14055,5,3,49375,49375,49378,0,3,2
14056,4,3,49379,49379,49382,0,3,1
14057,1,1,49380,49382,49383,2,3,0
14058,2,2,49382,49383,49385,1,3,0
14059,5,3,49387,49387,49390,0,3,2
14060,2,1,49389,49390,49391,1,2,0
14061,6,1,49395,49395,49396,0,1,4
14062,2,1,49397,49397,49398,0,1,1
14063,2,1,49399,49399,49400,0,1,1
14064,4,3,49403,49403,49406,0,3,3
14065,4,2,49407,49407,49409,0,2,1
14066,3,1,49410,49410,49411,0,1,1
14067,3,1,49413,49413,49414,0,1,2
14068,6,1,49419,49419,49420,0,1,5
14069,5,3,49424,49424,49427,0,3,4
14070,2,1,49426,49427,49428,1,2,0
14071,4,1,49430,49430,49431,0,1,2
14072,1,2,49431,49431,49433,0,2,0
14073,2,2,49433,49433,49435,0,2,0
14074,5,2,49438,49438,49440,0,2,3
14075,5,3,49443,49443,49446,0,3,3
14076,4,1,49447,49447,49448,0,1,1
14077,1,3,49448,49448,49451,0,3,0
14078,1,1,49449,49451,49452,2,3,0
14079,6,1,49455,49455,49456,0,1,3
14080,4,3,49459,49459,49462,0,3,3
14081,6,1,49465,49465,49466,0,1,3
14082,4,3,49469,49469,49472,0,3,3
14083,6,1,49475,49475,49476,0,1,3
14084,3,1,49478,49478,49479,0,1,2
14085,5,1,49483,49483,49484,0,1,4
14086,2,1,49485,49485,49486,0,1,1
14087,3,1,49488,49488,49489,0,1,2
14088,3,3,49491,49491,49494,0,3,2
14089,5,2,49496,49496,49498,0,2,2
14090,1,1,49497,49498,49499,1,2,0
14091,4,1,49501,49501,49502,0,1,2
14092,1,1,49502,49502,49503,0,1,0
14093,2,2,49504,49504,49506,0,2,1
14094,5,1,49509,49509,49510,0,1,3
14095,2,1,49511,49511,49512,0,1,1
14096,1,3,49512,49512,49515,0,3,0
14097,4,2,49516,49516,49518,0,2,1
14098,3,1,49519,49519,49520,0,1,1
14099,2,1,49521,49521,49522,0,1,1
14100,2,2,49523,49523,49525,0,2,1
14101,2,2,49525,49525,49527,0,2,0
14102,3,1,49528,49528,49529,0,1,1
14103,3,2,49531,49531,49533,0,2,2
14104,3,2,49534,49534,49536,0,2,1
14105,2,2,49536,49536,49538,0,2,0
14106,5,2,49541,49541,49543,0,2,3
14107,5,2,49546,49546,49548,0,2,3
14108,3,2,49549,49549,49551,0,2,1
14109,4,2,49553,49553,49555,0,2,2
14110,1,2,49554,49555,49557,1,3,0
14111,2,1,49556,49557,49558,1,2,0
14112,3,3,49559,49559,49562,0,3,1
14113,3,2,49562,49562,49564,0,2,0
14114,1,1,49563,49564,49565,1,2,0
14115,6,1,49569,49569,49570,0,1,4
14116,2,3,49571,49571,49574,0,3,1
14117,2,1,49573,49574,49575,1,2,0
14118,2,2,49575,49575,49577,0,2,0
14119,6,1,49581,49581,49582,0,1,4
14120,1,1,49582,49582,49583,0,1,0
14121,5,1,49587,49587,49588,0,1,4
14122,2,3,49589,49589,49592,0,3,1
14123,1,1,49590,49592,49593,2,3,0
14124,6,1,49596,49596,49597,0,1,3
14125,5,1,49601,49601,49602,0,1,4
14126,4,3,49605,49605,49608,0,3,3
14127,2,3,49607,49608,49611,1,4,0
14128,6,1,49613,49613,49614,0,1,2
14129,1,3,49614,49614,49617,0,3,0
14130,6,3,49620,49620,49623,0,3,3
14131,1,1,49621,49623,49624,2,3,0
14132,6,2,49627,49627,49629,0,2,3
14133,6,2,49633,49633,49635,0,2,4
14134,4,2,49637,49637,49639,0,2,2
14135,2,3,49639,49639,49642,0,3,0
14136,3,3,49642,49642,49645,0,3,0
14137,5,1,49647,49647,49648,0,1,2
14138,6,3,49653,49653,49656,0,3,5
14139,4,1,49657,49657,49658,0,1,1
14140,4,1,49661,49661,49662,0,1,3
14141,6,1,49667,49667,49668,0,1,5
14142,1,1,49668,49668,49669,0,1,0
14143,1,2,49669,49669,49671,0,2,0
14144,4,3,49673,49673,49676,0,3,2
14145,4,1,49677,49677,49678,0,1,1
14146,3,2,49680,49680,49682,0,2,2
14147,1,1,49681,49682,49683,1,2,0
14148,2,2,49683,49683,49685,0,2,0
14149,3,3,49686,49686,49689,0,3,1
14150,5,3,49691,49691,49694,0,3,2
14151,4,1,49695,49695,49696,0,1,1
14152,3,3,49698,49698,49701,0,3,2
14153,2,2,49700,49701,49703,1,3,0
14154,4,3,49704,49704,49707,0,3,1
14155,3,2,49707,49707,49709,0,2,0
14156,6,1,49713,49713,49714,0,1,4
14157,5,1,49718,49718,49719,0,1,4
14158,5,2,49723,49723,49725,0,2,4
14159,6,1,49729,49729,49730,0,1,4
14160,5,3,49734,49734,49737,0,3,4
14161,6,3,49740,49740,49743,0,3,3
14162,2,3,49742,49743,49746,1,4,0
14163,5,2,49747,49747,49749,0,2,1
14164,2,3,49749,49749,49752,0,3,0
14165,2,2,49751,49752,49754,1,3,0
14166,3,1,49754,49754,49755,0,1,0
14167,2,3,49756,49756,49759,0,3,1
14168,6,2,49762,49762,49764,0,2,3
14169,2,3,49764,49764,49767,0,3,0
14170,4,3,49768,49768,49771,0,3,1
14171,3,2,49771,49771,49773,0,2,0
14172,3,2,49774,49774,49776,0,2,1
14173,3,2,49777,49777,49779,0,2,1
14174,2,3,49779,49779,49782,0,3,0
14175,3,2,49782,49782,49784,0,2,0
14176,1,3,49783,49784,49787,1,4,0
14177,4,1,49787,49787,49788,0,1,0
14178,3,1,49790,49790,49791,0,1,2
14179,2,3,49792,49792,49795,0,3,1
14180,5,2,49797,49797,49799,0,2,2
14181,3,2,49800,49800,49802,0,2,1
14182,1,2,49801,49802,49804,1,3,0
14183,1,1,49802,49804,49805,2,3,0
14184,2,2,49804,49805,49807,1,3,0
14185,2,1,49806,49807,49808,1,2,0
14186,4,3,49810,49810,49813,0,3,2
14187,2,3,49812,49813,49816,1,4,0
14188,3,2,49815,49816,49818,1,3,0
14189,6,3,49821,49821,49824,0,3,3
14190,1,2,49822,49824,49826,2,4,0
14191,2,2,49824,49826,49828,2,4,0
14192,5,3,49829,49829,49832,0,3,1
14193,6,3,49835,49835,49838,0,3,3
14194,2,1,49837,49838,49839,1,2,0
14195,1,1,49838,49839,49840,1,2,0
14196,3,1,49841,49841,49842,0,1,1
14197,4,2,49845,49845,49847,0,2,3
14198,2,3,49847,49847,49850,0,3,0
14199,4,1,49851,49851,49852,0,1,1
14200,2,2,49853,49853,49855,0,2,1
14201,1,2,49854,49855,49857,1,3,0
14202,1,3,49855,49857,49860,2,5,0
14203,1,2,49856,49860,49862,4,6,0
14204,3,3,49859,49862,49865,3,6,0
14205,6,2,49865,49865,49867,0,2,0
14206,6,3,49871,49871,49874,0,3,4
14207,3,1,49874,49874,49875,0,1,0
14208,3,1,49877,49877,49878,0,1,2
14209,3,1,49880,49880,49881,0,1,2
14210,3,2,49883,49883,49885,0,2,2
14211,3,1,49886,49886,49887,0,1,1
14212,6,1,49892,49892,49893,0,1,5
14213,1,1,49893,49893,49894,0,1,0
14214,2,2,49895,49895,49897,0,2,1
14215,2,3,49897,49897,49900,0,3,0
14216,2,2,49899,49900,49902,1,3,0
14217,5,3,49904,49904,49907,0,3,2
14218,4,1,49908,49908,49909,0,1,1
14219,3,2,49911,49911,49913,0,2,2
14220,6,1,49917,49917,49918,0,1,4
14221,4,3,49921,49921,49924,0,3,3
14222,2,3,49923,49924,49927,1,4,0
14223,5,1,49928,49928,49929,0,1,1
14224,6,3,49934,49934,49937,0,3,5
14225,2,2,49936,49937,49939,1,3,0
14226,5,2,49941,49941,49943,0,2,2
14227,2,3,49943,49943,49946,0,3,0
14228,2,2,49945,49946,49948,1,3,0
14229,3,1,49948,49948,49949,0,1,0
14230,5,1,49953,49953,49954,0,1,4
14231,6,3,49959,49959,49962,0,3,5
14232,1,1,49960,49962,49963,2,3,0
14233,1,3,49961,49963,49966,2,5,0
14234,2,1,49963,49966,49967,3,4,0
14235,3,3,49966,49967,49970,1,4,0
14236,4,3,49970,49970,49973,0,3,0
14237,2,2,49972,49973,49975,1,3,0
14238,4,1,49976,49976,49977,0,1,1
14239,4,2,49980,49980,49982,0,2,3
14240,6,2,49986,49986,49988,0,2,4
14241,5,3,49991,49991,49994,0,3,3
14242,5,2,49996,49996,49998,0,2,2
14243,3,1,49999,49999,50000,0,1,1
14244,5,3,50004,50004,50007,0,3,4
14245,4,3,50008,50008,50011,0,3,1
14246,1,1,50009,50011,50012,2,3,0
14247,4,3,50013,50013,50016,0,3,1
14248,4,1,50017,50017,50018,0,1,1
14249,1,3,50018,50018,50021,0,3,0
14250,5,1,50023,50023,50024,0,1,2
14251,4,3,50027,50027,50030,0,3,3
14252,3,1,50030,50030,50031,0,1,0
14253,2,1,50032,50032,50033,0,1,1
14254,3,1,50035,50035,50036,0,1,2
14255,5,1,50040,50040,50041,0,1,4
14256,2,2,50042,50042,50044,0,2,1
14257,4,2,50046,50046,50048,0,2,2
14258,3,3,50049,50049,50052,0,3,1
14259,3,2,50052,50052,50054,0,2,0
14260,6,1,50058,50058,50059,0,1,4
14261,5,2,50063,50063,50065,0,2,4
14262,1,3,50064,50065,50068,1,4,0
14263,4,3,50068,50068,50071,0,3,0
14264,4,1,50072,50072,50073,0,1,1
14265,5,2,50077,50077,50079,0,2,4
14266,6,2,50083,50083,50085,0,2,4
14267,3,1,50086,50086,50087,0,1,1
14268,2,3,50088,50088,50091,0,3,1
14269,1,1,50089,50091,50092,2,3,0
14270,1,2,50090,50092,50094,2,4,0
14271,4,2,50094,50094,50096,0,2,0
14272,3,1,50097,50097,50098,0,1,1
14273,2,2,50099,50099,50101,0,2,1
14274,6,2,50105,50105,50107,0,2,4
14275,4,1,50109,50109,50110,0,1,2
14276,5,3,50114,50114,50117,0,3,4
14277,6,2,50120,50120,50122,0,2,3
14278,4,3,50124,50124,50127,0,3,2
14279,5,2,50129,50129,50131,0,2,2
14280,3,3,50132,50132,50135,0,3,1
14281,3,3,50135,50135,50138,0,3,0
14282,2,2,50137,50138,50140,1,3,0
14283,4,1,50141,50141,50142,0,1,1
14284,1,3,50142,50142,50145,0,3,0
14285,6,2,50148,50148,50150,0,2,3
14286,4,2,50152,50152,50154,0,2,2
14287,6,1,50158,50158,50159,0,1,4
14288,6,3,50164,50164,50167,0,3,5
14289,5,2,50169,50169,50171,0,2,2
14290,4,3,50173,50173,50176,0,3,2
14291,6,1,50179,50179,50180,0,1,3
14292,4,2,50183,50183,50185,0,2,3
14293,2,2,50185,50185,50187,0,2,0
14294,3,2,50188,50188,50190,0,2,1
14295,2,2,50190,50190,50192,0,2,0
14296,2,1,50192,50192,50193,0,1,0
14297,2,2,50194,50194,50196,0,2,1
14298,2,3,50196,50196,50199,0,3,0
14299,5,1,50201,50201,50202,0,1,2
14300,6,3,50207,50207,50210,0,3,5
14301,1,1,50208,50210,50211,2,3,0
14302,4,2,50212,50212,50214,0,2,1
14303,2,2,50214,50214,50216,0,2,0
14304,6,2,50220,50220,50222,0,2,4
14305,3,1,50223,50223,50224,0,1,1
14306,6,3,50229,50229,50232,0,3,5
14307,3,2,50232,50232,50234,0,2,0
14308,5,2,50237,50237,50239,0,2,3
14309,2,1,50239,50239,50240,0,1,0
14310,6,3,50245,50245,50248,0,3,5
14311,1,2,50246,50248,50250,2,4,0
14312,1,2,50247,50250,50252,3,5,0
14313,5,2,50252,50252,50254,0,2,0
14314,3,3,50255,50255,50258,0,3,1
14315,5,3,50260,50260,50263,0,3,2
14316,3,1,50263,50263,50264,0,1,0
14317,5,3,50268,50268,50271,0,3,4
14318,4,3,50272,50272,50275,0,3,1
14319,1,2,50273,50275,50277,2,4,0
14320,5,3,50278,50278,50281,0,3,1
14321,1,2,50279,50281,50283,2,4,0
14322,5,3,50284,50284,50287,0,3,1
14323,4,1,50288,50288,50289,0,1,1
14324,3,3,50291,50291,50294,0,3,2
14325,6,3,50297,50297,50300,0,3,3
14326,2,3,50299,50300,50303,1,4,0
14327,6,3,50305,50305,50308,0,3,2
14328,3,2,50308,50308,50310,0,2,0
14329,1,1,50309,50310,50311,1,2,0
14330,4,2,50313,50313,50315,0,2,2
14331,5,2,50318,50318,50320,0,2,3
14332,5,1,50323,50323,50324,0,1,3
14333,3,1,50326,50326,50327,0,1,2
14334,5,1,50331,50331,50332,0,1,4
14335,1,2,50332,50332,50334,0,2,0
14336,3,2,50335,50335,50337,0,2,1
14337,3,3,50338,50338,50341,0,3,1
14338,2,3,50340,50341,50344,1,4,0
14339,3,1,50343,50344,50345,1,2,0
14340,5,2,50348,50348,50350,0,2,3
14341,6,1,50354,50354,50355,0,1,4
14342,2,2,50356,50356,50358,0,2,1
14343,4,1,50360,50360,50361,0,1,2
14344,5,1,50365,50365,50366,0,1,4
14345,1,3,50366,50366,50369,0,3,0
14346,1,2,50367,50369,50371,2,4,0
14347,5,1,50372,50372,50373,0,1,1
14348,4,1,50376,50376,50377,0,1,3
14349,2,2,50378,50378,50380,0,2,1
14350,4,3,50382,50382,50385,0,3,2
14351,6,3,50388,50388,50391,0,3,3
14352,3,1,50391,50391,50392,0,1,0
14353,4,3,50395,50395,50398,0,3,3
14354,4,2,50399,50399,50401,0,2,1
14355,3,2,50402,50402,50404,0,2,1
14356,5,3,50407,50407,50410,0,3,3
14357,2,1,50409,50410,50411,1,2,0
14358,1,1,50410,50411,50412,1,2,0
14359,6,1,50416,50416,50417,0,1,4
14360,6,3,50422,50422,50425,0,3,5
14361,2,2,50424,50425,50427,1,3,0
14362,5,3,50429,50429,50432,0,3,2
14363,6,1,50435,50435,50436,0,1,3
14364,1,3,50436,50436,50439,0,3,0
14365,1,3,50437,50439,50442,2,5,0
14366,5,2,50442,50442,50444,0,2,0
14367,1,2,50443,50444,50446,1,3,0
14368,2,3,50445,50446,50449,1,4,0
14369,5,3,50450,50450,50453,0,3,1
14370,1,1,50451,50453,50454,2,3,0
14371,6,2,50457,50457,50459,0,2,3
14372,4,1,50461,50461,50462,0,1,2
14373,5,1,50466,50466,50467,0,1,4
14374,5,3,50471,50471,50474,0,3,4
14375,1,3,50472,50474,50477,2,5,0
14376,3,2,50475,50477,50479,2,4,0
14377,5,3,50480,50480,50483,0,3,1
14378,5,3,50485,50485,50488,0,3,2
14379,6,3,50491,50491,50494,0,3,3
14380,1,3,50492,50494,50497,2,5,0
14381,6,1,50498,50498,50499,0,1,1
14382,5,3,50503,50503,50506,0,3,4
14383,3,2,50506,50506,50508,0,2,0
14384,3,2,50509,50509,50511,0,2,1
14385,1,2,50510,50511,50513,1,3,0
14386,1,1,50511,50513,50514,2,3,0
14387,4,2,50515,50515,50517,0,2,1
14388,2,2,50517,50517,50519,0,2,0
14389,2,2,50519,50519,50521,0,2,0
14390,1,3,50520,50521,50524,1,4,0
14391,6,3,50526,50526,50529,0,3,2
14392,3,1,50529,50529,50530,0,1,0
14393,2,1,50531,50531,50532,0,1,1
14394,2,3,50533,50533,50536,0,3,1
14395,4,3,50537,50537,50540,0,3,1
14396,5,2,50542,50542,50544,0,2,2
14397,6,2,50548,50548,50550,0,2,4
14398,1,3,50549,50550,50553,1,4,0
14399,5,2,50554,50554,50556,0,2,1
14400,2,1,50556,50556,50557,0,1,0
14401,2,1,50558,50558,50559,0,1,1
14402,4,2,50562,50562,50564,0,2,3
14403,2,2,50564,50564,50566,0,2,0
14404,1,1,50565,50566,50567,1,2,0
14405,4,1,50569,50569,50570,0,1,2
14406,2,2,50571,50571,50573,0,2,1
14407,4,3,50575,50575,50578,0,3,2
14408,5,3,50580,50580,50583,0,3,2
14409,2,2,50582,50583,50585,1,3,0
14410,6,1,50588,50588,50589,0,1,3
14411,4,1,50592,50592,50593,0,1,3
14412,1,1,50593,50593,50594,0,1,0
14413,5,1,50598,50598,50599,0,1,4
14414,2,3,50600,50600,50603,0,3,1
14415,1,2,50601,50603,50605,2,4,0
14416,4,1,50605,50605,50606,0,1,0
14417,5,2,50610,50610,50612,0,2,4
14418,4,1,50614,50614,50615,0,1,2
14419,2,3,50616,50616,50619,0,3,1
14420,5,3,50621,50621,50624,0,3,2
14421,5,1,50626,50626,50627,0,1,2
14422,1,3,50627,50627,50630,0,3,0
14423,3,2,50630,50630,50632,0,2,0
14424,4,1,50634,50634,50635,0,1,2
14425,4,1,50638,50638,50639,0,1,3
14426,6,1,50644,50644,50645,0,1,5
14427,1,2,50645,50645,50647,0,2,0
14428,5,1,50650,50650,50651,0,1,3
14429,6,3,50656,50656,50659,0,3,5
14430,4,2,50660,50660,50662,0,2,1
14431,3,1,50663,50663,50664,0,1,1
14432,2,1,50665,50665,50666,0,1,1
14433,1,2,50666,50666,50668,0,2,0
14434,6,2,50672,50672,50674,0,2,4
14435,3,1,50675,50675,50676,0,1,1
14436,3,1,50678,50678,50679,0,1,2
14437,5,1,50683,50683,50684,0,1,4
14438,2,3,50685,50685,50688,0,3,1
14439,6,2,50691,50691,50693,0,2,3
14440,2,3,50693,50693,50696,0,3,0
14441,2,2,50695,50696,50698,1,3,0
14442,2,1,50697,50698,50699,1,2,0
14443,1,3,50698,50699,50702,1,4,0
14444,5,2,50703,50703,50705,0,2,1
14445,2,2,50705,50705,50707,0,2,0
14446,6,3,50711,50711,50714,0,3,4
14447,4,3,50715,50715,50718,0,3,1
14448,6,3,50721,50721,50724,0,3,3
14449,1,2,50722,50724,50726,2,4,0
14450,6,2,50728,50728,50730,0,2,2
14451,3,1,50731,50731,50732,0,1,1
14452,5,1,50736,50736,50737,0,1,4
14453,6,3,50742,50742,50745,0,3,5
14454,1,1,50743,50745,50746,2,3,0
14455,5,1,50748,50748,50749,0,1,2
14456,1,3,50749,50749,50752,0,3,0
14457,3,2,50752,50752,50754,0,2,0
14458,4,1,50756,50756,50757,0,1,2
14459,4,3,50760,50760,50763,0,3,3
14460,4,3,50764,50764,50767,0,3,1
14461,5,1,50769,50769,50770,0,1,2
14462,2,2,50771,50771,50773,0,2,1
14463,5,2,50776,50776,50778,0,2,3
14464,2,3,50778,50778,50781,0,3,0
14465,1,1,50779,50781,50782,2,3,0
14466,1,1,50780,50782,50783,2,3,0
14467,2,2,50782,50783,50785,1,3,0
14468,5,1,50787,50787,50788,0,1,2
14469,5,3,50792,50792,50795,0,3,4
14470,5,2,50797,50797,50799,0,2,2
14471,2,3,50799,50799,50802,0,3,0
14472,5,1,50804,50804,50805,0,1,2
14473,1,3,50805,50805,50808,0,3,0
14474,2,2,50807,50808,50810,1,3,0
14475,4,3,50811,50811,50814,0,3,1
14476,4,3,50815,50815,50818,0,3,1
14477,5,2,50820,50820,50822,0,2,2
14478,6,3,50826,50826,50829,0,3,4
14479,4,2,50830,50830,50832,0,2,1
14480,3,1,50833,50833,50834,0,1,1
14481,2,1,50835,50835,50836,0,1,1
14482,2,2,50837,50837,50839,0,2,1
14483,4,3,50841,50841,50844,0,3,2
14484,4,2,50845,50845,50847,0,2,1
14485,4,1,50849,50849,50850,0,1,2
14486,5,3,50854,50854,50857,0,3,4
14487,4,1,50858,50858,50859,0,1,1
14488,3,1,50861,50861,50862,0,1,2
14489,6,2,50867,50867,50869,0,2,5
14490,3,1,50870,50870,50871,0,1,1
14491,4,2,50874,50874,50876,0,2,3
14492,3,3,50877,50877,50880,0,3,1
14493,6,2,50883,50883,50885,0,2,3
14494,6,3,50889,50889,50892,0,3,4
14495,4,2,50893,50893,50895,0,2,1
14496,1,3,50894,50895,50898,1,4,0
14497,4,1,50898,50898,50899,0,1,0
14498,6,3,50904,50904,50907,0,3,5
14499,3,3,50907,50907,50910,0,3,0
14500,1,3,50908,50910,50913,2,5,0
14501,5,3,50913,50913,50916,0,3,0
14502,6,1,50919,50919,50920,0,1,3
14503,2,3,50921,50921,50924,0,3,1
14504,3,2,50924,50924,50926,0,2,0
14505,2,2,50926,50926,50928,0,2,0
14506,1,1,50927,50928,50929,1,2,0
14507,3,1,50930,50930,50931,0,1,1
14508,3,1,50933,50933,50934,0,1,2
14509,2,3,50935,50935,50938,0,3,1
14510,1,1,50936,50938,50939,2,3,0
14511,2,3,50938,50939,50942,1,4,0
14512,1,1,50939,50942,50943,3,4,0
14513,5,1,50944,50944,50945,0,1,1
14514,1,3,50945,50945,50948,0,3,0
14515,3,2,50948,50948,50950,0,2,0
14516,5,2,50953,50953,50955,0,2,3
14517,3,2,50956,50956,50958,0,2,1
14518,4,1,50960,50960,50961,0,1,2
14519,2,1,50962,50962,50963,0,1,1
14520,1,2,50963,50963,50965,0,2,0
14521,3,3,50966,50966,50969,0,3,1
14522,6,1,50972,50972,50973,0,1,3
14523,2,3,50974,50974,50977,0,3,1
14524,1,3,50975,50977,50980,2,5,0
14525,6,3,50981,50981,50984,0,3,1
14526,6,3,50987,50987,50990,0,3,3
14527,3,1,50990,50990,50991,0,1,0
14528,1,3,50991,50991,50994,0,3,0
14529,5,3,50996,50996,50999,0,3,2
14530,4,2,51000,51000,51002,0,2,1
14531,4,1,51004,51004,51005,0,1,2
14532,3,1,51007,51007,51008,0,1,2
14533,2,3,51009,51009,51012,0,3,1
14534,2,3,51011,51012,51015,1,4,0
14535,5,1,51016,51016,51017,0,1,1
14536,3,3,51019,51019,51022,0,3,2
14537,5,3,51024,51024,51027,0,3,2
14538,3,2,51027,51027,51029,0,2,0
14539,1,1,51028,51029,51030,1,2,0
14540,1,1,51029,51030,51031,1,2,0
14541,3,1,51032,51032,51033,0,1,1
14542,1,2,51033,51033,51035,0,2,0
14543,4,1,51037,51037,51038,0,1,2
14544,3,3,51040,51040,51043,0,3,2
14545,4,3,51044,51044,51047,0,3,1
14546,3,1,51047,51047,51048,0,1,0
14547,5,2,51052,51052,51054,0,2,4
14548,2,2,51054,51054,51056,0,2,0
14549,2,1,51056,51056,51057,0,1,0
14550,3,2,51059,51059,51061,0,2,2
14551,3,3,51062,51062,51065,0,3,1
14552,2,2,51064,51065,51067,1,3,0
14553,4,3,51068,51068,51071,0,3,1
14554,2,3,51070,51071,51074,1,4,0
14555,4,1,51074,51074,51075,0,1,0
14556,1,3,51075,51075,51078,0,3,0
14557,5,3,51080,51080,51083,0,3,2
14558,3,1,51083,51083,51084,0,1,0
14559,5,3,51088,51088,51091,0,3,4
14560,5,2,51093,51093,51095,0,2,2
14561,5,1,51098,51098,51099,0,1,3
14562,6,3,51104,51104,51107,0,3,5
14563,1,1,51105,51107,51108,2,3,0
14564,6,2,51111,51111,51113,0,2,3
14565,6,2,51117,51117,51119,0,2,4
14566,2,1,51119,51119,51120,0,1,0
14567,1,2,51120,51120,51122,0,2,0
14568,5,2,51125,51125,51127,0,2,3
14569,6,2,51131,51131,51133,0,2,4
14570,1,3,51132,51133,51136,1,4,0
14571,5,1,51137,51137,51138,0,1,1
14572,4,3,51141,51141,51144,0,3,3
14573,1,3,51142,51144,51147,2,5,0
14574,2,3,51144,51147,51150,3,6,0
14575,5,1,51149,51150,51151,1,2,0
14576,3,1,51152,51152,51153,0,1,1
14577,2,2,51154,51154,51156,0,2,1
14578,4,3,51158,51158,51161,0,3,2
14579,3,1,51161,51161,51162,0,1,0
14580,1,3,51162,51162,51165,0,3,0
14581,4,2,51166,51166,51168,0,2,1
14582,4,2,51170,51170,51172,0,2,2
14583,5,1,51175,51175,51176,0,1,3
14584,1,1,51176,51176,51177,0,1,0
14585,2,2,51178,51178,51180,0,2,1
14586,6,3,51184,51184,51187,0,3,4
14587,6,3,51190,51190,51193,0,3,3
14588,6,1,51196,51196,51197,0,1,3
14589,5,3,51201,51201,51204,0,3,4
14590,3,2,51204,51204,51206,0,2,0
14591,1,2,51205,51206,51208,1,3,0
14592,1,1,51206,51208,51209,2,3,0
14593,6,3,51212,51212,51215,0,3,3
14594,2,3,51214,51215,51218,1,4,0
14595,6,1,51220,51220,51221,0,1,2
14596,1,3,51221,51221,51224,0,3,0
14597,3,3,51224,51224,51227,0,3,0
14598,3,1,51227,51227,51228,0,1,0
14599,4,2,51231,51231,51233,0,2,3
14600,2,3,51233,51233,51236,0,3,0
14601,3,3,51236,51236,51239,0,3,0
14602,6,2,51242,51242,51244,0,2,3
14603,5,2,51247,51247,51249,0,2,3
14604,5,1,51252,51252,51253,0,1,3
14605,3,2,51255,51255,51257,0,2,2
14606,1,2,51256,51257,51259,1,3,0
14607,4,1,51260,51260,51261,0,1,1
14608,4,1,51264,51264,51265,0,1,3
14609,1,2,51265,51265,51267,0,2,0
14610,5,3,51270,51270,51273,0,3,3
14611,6,3,51276,51276,51279,0,3,3
14612,2,1,51278,51279,51280,1,2,0
14613,4,1,51282,51282,51283,0,1,2
14614,5,3,51287,51287,51290,0,3,4
14615,5,2,51292,51292,51294,0,2,2
14616,1,2,51293,51294,51296,1,3,0
14617,1,1,51294,51296,51297,2,3,0
14618,6,2,51300,51300,51302,0,2,3
14619,5,1,51305,51305,51306,0,1,3
14620,5,1,51310,51310,51311,0,1,4
14621,6,3,51316,51316,51319,0,3,5
14622,4,3,51320,51320,51323,0,3,1
14623,1,2,51321,51323,51325,2,4,0
14624,4,2,51325,51325,51327,0,2,0
14625,2,1,51327,51327,51328,0,1,0
14626,2,1,51329,51329,51330,0,1,1
14627,2,1,51331,51331,51332,0,1,1
14628,4,3,51335,51335,51338,0,3,3
14629,5,1,51340,51340,51341,0,1,2
14630,3,1,51343,51343,51344,0,1,2
14631,4,2,51347,51347,51349,0,2,3
14632,2,3,51349,51349,51352,0,3,0
14633,4,2,51353,51353,51355,0,2,1
14634,3,1,51356,51356,51357,0,1,1
14635,4,2,51360,51360,51362,0,2,3
14636,2,3,51362,51362,51365,0,3,0
14637,3,2,51365,51365,51367,0,2,0
14638,1,1,51366,51367,51368,1,2,0
14639,1,3,51367,51368,51371,1,4,0
14640,2,1,51369,51371,51372,2,3,0
14641,6,3,51375,51375,51378,0,3,3
14642,5,1,51380,51380,51381,0,1,2
14643,4,1,51384,51384,51385,0,1,3
14644,4,1,51388,51388,51389,0,1,3
14645,6,1,51394,51394,51395,0,1,5
14646,2,3,51396,51396,51399,0,3,1
14647,2,1,51398,51399,51400,1,2,0
14648,2,1,51400,51400,51401,0,1,0
14649,1,1,51401,51401,51402,0,1,0
14650,3,3,51404,51404,51407,0,3,2
14651,6,2,51410,51410,51412,0,2,3
14652,6,2,51416,51416,51418,0,2,4
14653,3,3,51419,51419,51422,0,3,1
14654,2,1,51421,51422,51423,1,2,0
14655,2,3,51423,51423,51426,0,3,0
14656,5,3,51428,51428,51431,0,3,2
14657,3,2,51431,51431,51433,0,2,0
14658,1,2,51432,51433,51435,1,3,0
14659,2,1,51434,51435,51436,1,2,0
14660,2,2,51436,51436,51438,0,2,0
14661,3,2,51439,51439,51441,0,2,1
14662,4,3,51443,51443,51446,0,3,2
14663,4,1,51447,51447,51448,0,1,1
14664,5,3,51452,51452,51455,0,3,4
14665,5,1,51457,51457,51458,0,1,2
14666,4,1,51461,51461,51462,0,1,3
14667,2,1,51463,51463,51464,0,1,1
14668,2,1,51465,51465,51466,0,1,1
14669,6,2,51471,51471,51473,0,2,5
14670,6,1,51477,51477,51478,0,1,4
14671,6,1,51483,51483,51484,0,1,5
14672,3,2,51486,51486,51488,0,2,2
14673,5,1,51491,51491,51492,0,1,3
14674,1,3,51492,51492,51495,0,3,0
14675,2,2,51494,51495,51497,1,3,0
14676,5,3,51499,51499,51502,0,3,2
14677,2,1,51501,51502,51503,1,2,0
14678,1,2,51502,51503,51505,1,3,0
14679,5,1,51507,51507,51508,0,1,2
14680,5,2,51512,51512,51514,0,2,4
14681,1,3,51513,51514,51517,1,4,0
14682,6,3,51519,51519,51522,0,3,2
14683,1,1,51520,51522,51523,2,3,0
14684,3,1,51523,51523,51524,0,1,0
14685,4,1,51527,51527,51528,0,1,3
14686,6,2,51533,51533,51535,0,2,5
14687,3,1,51536,51536,51537,0,1,1
14688,2,3,51538,51538,51541,0,3,1
14689,5,1,51543,51543,51544,0,1,2
14690,3,2,51546,51546,51548,0,2,2
14691,4,3,51550,51550,51553,0,3,2
14692,4,2,51554,51554,51556,0,2,1
14693,3,1,51557,51557,51558,0,1,1
14694,6,2,51563,51563,51565,0,2,5
14695,6,2,51569,51569,51571,0,2,4
14696,3,2,51572,51572,51574,0,2,1
14697,2,3,51574,51574,51577,0,3,0
14698,1,3,51575,51577,51580,2,5,0
14699,3,2,51578,51580,51582,2,4,0
14700,1,3,51579,51582,51585,3,6,0
14701,4,3,51583,51585,51588,2,5,0
14702,2,1,51585,51588,51589,3,4,0
14703,4,3,51589,51589,51592,0,3,0
14704,4,2,51593,51593,51595,0,2,1
14705,5,2,51598,51598,51600,0,2,3
14706,3,1,51601,51601,51602,0,1,1
14707,3,3,51604,51604,51607,0,3,2
14708,4,1,51608,51608,51609,0,1,1
14709,6,2,51614,51614,51616,0,2,5
14710,3,3,51617,51617,51620,0,3,1
14711,4,3,51621,51621,51624,0,3,1
14712,6,3,51627,51627,51630,0,3,3
14713,3,1,51630,51630,51631,0,1,0
14714,5,1,51635,51635,51636,0,1,4
14715,3,1,51638,51638,51639,0,1,2
14716,1,2,51639,51639,51641,0,2,0
14717,6,3,51645,51645,51648,0,3,4
14718,1,2,51646,51648,51650,2,4,0
14719,1,2,51647,51650,51652,3,5,0
14720,2,3,51649,51652,51655,3,6,0
14721,2,2,51651,51655,51657,4,6,0
14722,1,1,51652,51657,51658,5,6,0
14723,2,3,51654,51658,51661,4,7,0
14724,5,2,51659,51661,51663,2,4,0
14725,3,2,51662,51663,51665,1,3,0
14726,1,1,51663,51665,51666,2,3,0
14727,2,1,51665,51666,51667,1,2,0
14728,3,2,51668,51668,51670,0,2,1
14729,2,1,51670,51670,51671,0,1,0
14730,6,3,51676,51676,51679,0,3,5
14731,5,2,51681,51681,51683,0,2,2
14732,3,2,51684,51684,51686,0,2,1
14733,2,3,51686,51686,51689,0,3,0
14734,2,1,51688,51689,51690,1,2,0
14735,1,3,51689,51690,51693,1,4,0
14736,5,2,51694,51694,51696,0,2,1
14737,6,2,51700,51700,51702,0,2,4
14738,4,2,51704,51704,51706,0,2,2
14739,1,1,51705,51706,51707,1,2,0
14740,6,2,51711,51711,51713,0,2,4
14741,4,2,51715,51715,51717,0,2,2
14742,5,2,51720,51720,51722,0,2,3
14743,1,1,51721,51722,51723,1,2,0
14744,6,3,51727,51727,51730,0,3,4
14745,4,2,51731,51731,51733,0,2,1
14746,3,3,51734,51734,51737,0,3,1
14747,5,3,51739,51739,51742,0,3,2
14748,4,3,51743,51743,51746,0,3,1
14749,2,1,51745,51746,51747,1,2,0
14750,4,3,51749,51749,51752,0,3,2
14751,3,2,51752,51752,51754,0,2,0
14752,2,3,51754,51754,51757,0,3,0
14753,5,2,51759,51759,51761,0,2,2
14754,5,2,51764,51764,51766,0,2,3
14755,3,1,51767,51767,51768,0,1,1
14756,2,1,51769,51769,51770,0,1,1
14757,4,2,51773,51773,51775,0,2,3
14758,1,3,51774,51775,51778,1,4,0
14759,5,1,51779,51779,51780,0,1,1
14760,6,1,51785,51785,51786,0,1,5
14761,3,2,51788,51788,51790,0,2,2
14762,2,2,51790,51790,51792,0,2,0
14763,6,3,51796,51796,51799,0,3,4
14764,1,3,51797,51799,51802,2,5,0
14765,4,1,51801,51802,51803,1,2,0
14766,1,1,51802,51803,51804,1,2,0
14767,1,2,51803,51804,51806,1,3,0
14768,4,2,51807,51807,51809,0,2,1
14769,4,1,51811,51811,51812,0,1,2
14770,1,1,51812,51812,51813,0,1,0
14771,1,2,51813,51813,51815,0,2,0
14772,2,3,51815,51815,51818,0,3,0
14773,2,1,51817,51818,51819,1,2,0
14774,5,2,51822,51822,51824,0,2,3
14775,4,2,51826,51826,51828,0,2,2
14776,2,1,51828,51828,51829,0,1,0
14777,1,1,51829,51829,51830,0,1,0
14778,1,2,51830,51830,51832,0,2,0
14779,6,1,51836,51836,51837,0,1,4
14780,4,2,51840,51840,51842,0,2,3
14781,3,1,51843,51843,51844,0,1,1
14782,4,1,51847,51847,51848,0,1,3
14783,6,1,51853,51853,51854,0,1,5
14784,1,3,51854,51854,51857,0,3,0
14785,2,2,51856,51857,51859,1,3,0
14786,6,2,51862,51862,51864,0,2,3
14787,3,2,51865,51865,51867,0,2,1
14788,3,2,51868,51868,51870,0,2,1
14789,6,2,51874,51874,51876,0,2,4
14790,6,2,51880,51880,51882,0,2,4
14791,4,2,51884,51884,51886,0,2,2
14792,6,2,51890,51890,51892,0,2,4
14793,3,1,51893,51893,51894,0,1,1
14794,3,2,51896,51896,51898,0,2,2
14795,6,2,51902,51902,51904,0,2,4
14796,5,1,51907,51907,51908,0,1,3
14797,4,1,51911,51911,51912,0,1,3
14798,1,2,51912,51912,51914,0,2,0
14799,1,2,51913,51914,51916,1,3,0
14800,1,1,51914,51916,51917,2,3,0
14801,4,1,51918,51918,51919,0,1,1
14802,3,1,51921,51921,51922,0,1,2
14803,6,2,51927,51927,51929,0,2,5
14804,4,2,51931,51931,51933,0,2,2
14805,1,2,51932,51933,51935,1,3,0
14806,1,1,51933,51935,51936,2,3,0
14807,4,2,51937,51937,51939,0,2,1
14808,1,1,51938,51939,51940,1,2,0
14809,3,2,51941,51941,51943,0,2,1
14810,1,2,51942,51943,51945,1,3,0
14811,4,2,51946,51946,51948,0,2,1
14812,6,2,51952,51952,51954,0,2,4
14813,5,2,51957,51957,51959,0,2,3
14814,1,1,51958,51959,51960,1,2,0
14815,5,1,51963,51963,51964,0,1,3
14816,3,2,51966,51966,51968,0,2,2
14817,5,1,51971,51971,51972,0,1,3
14818,1,1,51972,51972,51973,0,1,0
14819,2,3,51974,51974,51977,0,3,1
14820,1,3,51975,51977,51980,2,5,0
14821,1,1,51976,51980,51981,4,5,0
14822,4,3,51980,51981,51984,1,4,0
14823,2,3,51982,51984,51987,2,5,0
14824,1,2,51983,51987,51989,4,6,0
14825,3,2,51986,51989,51991,3,5,0
14826,4,2,51990,51991,51993,1,3,0
14827,6,2,51996,51996,51998,0,2,3
14828,3,1,51999,51999,52000,0,1,1
14829,3,3,52002,52002,52005,0,3,2
14830,1,1,52003,52005,52006,2,3,0
14831,4,3,52007,52007,52010,0,3,1
14832,5,3,52012,52012,52015,0,3,2
14833,3,1,52015,52015,52016,0,1,0
14834,4,1,52019,52019,52020,0,1,3
14835,1,2,52020,52020,52022,0,2,0
14836,3,2,52023,52023,52025,0,2,1
14837,3,1,52026,52026,52027,0,1,1
14838,6,3,52032,52032,52035,0,3,5
14839,2,3,52034,52035,52038,1,4,0
14840,3,3,52037,52038,52041,1,4,0
14841,2,1,52039,52041,52042,2,3,0
14842,5,3,52044,52044,52047,0,3,2
14843,5,1,52049,52049,52050,0,1,2
14844,2,3,52051,52051,52054,0,3,1
14845,5,3,52056,52056,52059,0,3,2
14846,6,2,52062,52062,52064,0,2,3
14847,4,2,52066,52066,52068,0,2,2
14848,4,2,52070,52070,52072,0,2,2
14849,6,3,52076,52076,52079,0,3,4
14850,6,2,52082,52082,52084,0,2,3
14851,3,1,52085,52085,52086,0,1,1
14852,4,1,52089,52089,52090,0,1,3
14853,2,2,52091,52091,52093,0,2,1
14854,6,3,52097,52097,52100,0,3,4
14855,1,3,52098,52100,52103,2,5,0
14856,6,2,52104,52104,52106,0,2,1
14857,1,2,52105,52106,52108,1,3,0
14858,6,3,52111,52111,52114,0,3,3
14859,6,1,52117,52117,52118,0,1,3
14860,4,1,52121,52121,52122,0,1,3
14861,3,1,52124,52124,52125,0,1,2
14862,2,2,52126,52126,52128,0,2,1
14863,6,2,52132,52132,52134,0,2,4
14864,3,3,52135,52135,52138,0,3,1
14865,6,2,52141,52141,52143,0,2,3
14866,1,3,52142,52143,52146,1,4,0
14867,2,2,52144,52146,52148,2,4,0
14868,5,3,52149,52149,52152,0,3,1
14869,3,1,52152,52152,52153,0,1,0
14870,3,2,52155,52155,52157,0,2,2
14871,4,2,52159,52159,52161,0,2,2
14872,3,1,52162,52162,52163,0,1,1
14873,5,3,52167,52167,52170,0,3,4
14874,5,1,52172,52172,52173,0,1,2
14875,4,3,52176,52176,52179,0,3,3
14876,3,3,52179,52179,52182,0,3,0
14877,2,1,52181,52182,52183,1,2,0
14878,3,1,52184,52184,52185,0,1,1
14879,5,2,52189,52189,52191,0,2,4
14880,3,2,52192,52192,52194,0,2,1
14881,6,1,52198,52198,52199,0,1,4
14882,3,1,52201,52201,52202,0,1,2
14883,5,2,52206,52206,52208,0,2,4
14884,1,2,52207,52208,52210,1,3,0
14885,1,3,52208,52210,52213,2,5,0
14886,2,3,52210,52213,52216,3,6,0
14887,5,2,52215,52216,52218,1,3,0
14888,5,2,52220,52220,52222,0,2,2
14889,2,1,52222,52222,52223,0,1,0
14890,2,3,52224,52224,52227,0,3,1
14891,4,2,52228,52228,52230,0,2,1
14892,6,3,52234,52234,52237,0,3,4
14893,6,1,52240,52240,52241,0,1,3
14894,5,3,52245,52245,52248,0,3,4
14895,5,3,52250,52250,52253,0,3,2
14896,3,1,52253,52253,52254,0,1,0
14897,6,1,52259,52259,52260,0,1,5
14898,1,2,52260,52260,52262,0,2,0
14899,6,2,52266,52266,52268,0,2,4
14900,4,2,52270,52270,52272,0,2,2
14901,2,3,52272,52272,52275,0,3,0
14902,2,3,52274,52275,52278,1,4,0
14903,4,2,52278,52278,52280,0,2,0
14904,6,2,52284,52284,52286,0,2,4
14905,2,2,52286,52286,52288,0,2,0
14906,5,1,52291,52291,52292,0,1,3
14907,4,3,52295,52295,52298,0,3,3
14908,6,3,52301,52301,52304,0,3,3
14909,3,3,52304,52304,52307,0,3,0
14910,5,2,52309,52309,52311,0,2,2
14911,5,2,52314,52314,52316,0,2,3
14912,1,3,52315,52316,52319,1,4,0
14913,5,1,52320,52320,52321,0,1,1
14914,4,3,52324,52324,52327,0,3,3
14915,6,1,52330,52330,52331,0,1,3
14916,3,1,52333,52333,52334,0,1,2
14917,3,1,52336,52336,52337,0,1,2
14918,3,1,52339,52339,52340,0,1,2
14919,2,3,52341,52341,52344,0,3,1
14920,3,2,52344,52344,52346,0,2,0
14921,1,1,52345,52346,52347,1,2,0
14922,5,3,52350,52350,52353,0,3,3
14923,3,3,52353,52353,52356,0,3,0
14924,5,1,52358,52358,52359,0,1,2
14925,4,1,52362,52362,52363,0,1,3
14926,2,2,52364,52364,52366,0,2,1
14927,1,3,52365,52366,52369,1,4,0
14928,4,2,52369,52369,52371,0,2,0
14929,6,1,52375,52375,52376,0,1,4
14930,5,1,52380,52380,52381,0,1,4
14931,5,1,52385,52385,52386,0,1,4
14932,3,1,52388,52388,52389,0,1,2
14933,6,3,52394,52394,52397,0,3,5
14934,4,3,52398,52398,52401,0,3,1
14935,3,2,52401,52401,52403,0,2,0
14936,3,1,52404,52404,52405,0,1,1
14937,4,2,52408,52408,52410,0,2,3
14938,4,3,52412,52412,52415,0,3,2
14939,1,1,52413,52415,52416,2,3,0
14940,4,1,52417,52417,52418,0,1,1
14941,2,2,52419,52419,52421,0,2,1
14942,4,2,52423,52423,52425,0,2,2
14943,1,3,52424,52425,52428,1,4,0
14944,1,3,52425,52428,52431,3,6,0
14945,1,2,52426,52431,52433,5,7,0
14946,4,2,52430,52433,52435,3,5,0
14947,1,3,52431,52435,52438,4,7,0
14948,3,1,52434,52438,52439,4,5,0
14949,5,3,52439,52439,52442,0,3,0
14950,1,2,52440,52442,52444,2,4,0
14951,2,3,52442,52444,52447,2,5,0
14952,2,1,52444,52447,52448,3,4,0
14953,3,3,52447,52448,52451,1,4,0
14954,5,1,52452,52452,52453,0,1,1
14955,1,3,52453,52453,52456,0,3,0
14956,2,3,52455,52456,52459,1,4,0
14957,1,3,52456,52459,52462,3,6,0
14958,1,3,52457,52462,52465,5,8,0
14959,2,2,52459,52465,52467,6,8,0
14960,5,1,52464,52467,52468,3,4,0
14961,6,1,52470,52470,52471,0,1,2
14962,2,3,52472,52472,52475,0,3,1
14963,6,3,52478,52478,52481,0,3,3
14964,4,3,52482,52482,52485,0,3,1
14965,5,2,52487,52487,52489,0,2,2
14966,4,2,52491,52491,52493,0,2,2
14967,1,3,52492,52493,52496,1,4,0
14968,6,2,52498,52498,52500,0,2,2
14969,6,3,52504,52504,52507,0,3,4
14970,3,1,52507,52507,52508,0,1,0
14971,2,3,52509,52509,52512,0,3,1
14972,4,2,52513,52513,52515,0,2,1
14973,5,1,52518,52518,52519,0,1,3
14974,6,1,52524,52524,52525,0,1,5
14975,2,2,52526,52526,52528,0,2,1
14976,1,1,52527,52528,52529,1,2,0
14977,4,1,52531,52531,52532,0,1,2
14978,5,1,52536,52536,52537,0,1,4
14979,6,1,52542,52542,52543,0,1,5
14980,4,1,52546,52546,52547,0,1,3
14981,4,3,52550,52550,52553,0,3,3
14982,1,3,52551,52553,52556,2,5,0
14983,1,2,52552,52556,52558,4,6,0
14984,3,1,52555,52558,52559,3,4,0
14985,4,2,52559,52559,52561,0,2,0
14986,5,3,52564,52564,52567,0,3,3
14987,3,3,52567,52567,52570,0,3,0
14988,3,3,52570,52570,52573,0,3,0
14989,3,2,52573,52573,52575,0,2,0
14990,1,1,52574,52575,52576,1,2,0
14991,1,2,52575,52576,52578,1,3,0
14992,6,1,52581,52581,52582,0,1,3
14993,5,1,52586,52586,52587,0,1,4
14994,6,2,52592,52592,52594,0,2,5
14995,1,3,52593,52594,52597,1,4,0
14996,6,3,52599,52599,52602,0,3,2
14997,5,1,52604,52604,52605,0,1,2
14998,4,1,52608,52608,52609,0,1,3
14999,3,1,52611,52611,52612,0,1,2
15000,2,2,52613,52613,52615,0,2,1
15001,3,2,52616,52616,52618,0,2,1
15002,5,1,52621,52621,52622,0,1,3
15003,6,2,52627,52627,52629,0,2,5
15004,2,2,52629,52629,52631,0,2,0
15005,4,2,52633,52633,52635,0,2,2
15006,6,3,52639,52639,52642,0,3,4
15007,3,3,52642,52642,52645,0,3,0
15008,3,3,52645,52645,52648,0,3,0
15009,4,2,52649,52649,52651,0,2,1
15010,2,1,52651,52651,52652,0,1,0
15011,1,3,52652,52652,52655,0,3,0
15012,5,1,52657,52657,52658,0,1,2
15013,2,3,52659,52659,52662,0,3,1
15014,1,2,52660,52662,52664,2,4,0
15015,3,1,52663,52664,52665,1,2,0
15016,6,2,52669,52669,52671,0,2,4
15017,6,3,52675,52675,52678,0,3,4
15018,4,1,52679,52679,52680,0,1,1
15019,5,3,52684,52684,52687,0,3,4
15020,2,1,52686,52687,52688,1,2,0
15021,3,1,52689,52689,52690,0,1,1
15022,6,3,52695,52695,52698,0,3,5
15023,2,2,52697,52698,52700,1,3,0
15024,1,3,52698,52700,52703,2,5,0
15025,4,3,52702,52703,52706,1,4,0
15026,4,2,52706,52706,52708,0,2,0
15027,1,2,52707,52708,52710,1,3,0
15028,6,2,52713,52713,52715,0,2,3
15029,2,3,52715,52715,52718,0,3,0
15030,2,3,52717,52718,52721,1,4,0
15031,1,3,52718,52721,52724,3,6,0
15032,4,2,52722,52724,52726,2,4,0
15033,3,2,52725,52726,52728,1,3,0
15034,3,3,52728,52728,52731,0,3,0
15035,3,3,52731,52731,52734,0,3,0
15036,6,2,52737,52737,52739,0,2,3
15037,2,3,52739,52739,52742,0,3,0
15038,3,3,52742,52742,52745,0,3,0
15039,2,1,52744,52745,52746,1,2,0
15040,4,3,52748,52748,52751,0,3,2
15041,4,1,52752,52752,52753,0,1,1
15042,3,2,52755,52755,52757,0,2,2
15043,3,3,52758,52758,52761,0,3,1
15044,1,1,52759,52761,52762,2,3,0
15045,2,3,52761,52762,52765,1,4,0
15046,3,2,52764,52765,52767,1,3,0
15047,3,3,52767,52767,52770,0,3,0
15048,3,3,52770,52770,52773,0,3,0
15049,5,3,52775,52775,52778,0,3,2
15050,3,3,52778,52778,52781,0,3,0
15051,1,1,52779,52781,52782,2,3,0
15052,3,2,52782,52782,52784,0,2,0
15053,6,1,52788,52788,52789,0,1,4
15054,6,1,52794,52794,52795,0,1,5
15055,1,3,52795,52795,52798,0,3,0
15056,5,3,52800,52800,52803,0,3,2
15057,6,1,52806,52806,52807,0,1,3
15058,4,2,52810,52810,52812,0,2,3
15059,3,3,52813,52813,52816,0,3,1
15060,6,1,52819,52819,52820,0,1,3
15061,3,3,52822,52822,52825,0,3,2
15062,5,3,52827,52827,52830,0,3,2
15063,4,2,52831,52831,52833,0,2,1
15064,3,3,52834,52834,52837,0,3,1
15065,6,2,52840,52840,52842,0,2,3
15066,1,3,52841,52842,52845,1,4,0
15067,6,2,52847,52847,52849,0,2,2
15068,5,3,52852,52852,52855,0,3,3
15069,4,3,52856,52856,52859,0,3,1
15070,6,1,52862,52862,52863,0,1,3
15071,2,2,52864,52864,52866,0,2,1
15072,3,2,52867,52867,52869,0,2,1
15073,6,2,52873,52873,52875,0,2,4
15074,4,2,52877,52877,52879,0,2,2
15075,4,1,52881,52881,52882,0,1,2
15076,1,2,52882,52882,52884,0,2,0
15077,5,3,52887,52887,52890,0,3,3
15078,4,2,52891,52891,52893,0,2,1
15079,5,2,52896,52896,52898,0,2,3
15080,3,1,52899,52899,52900,0,1,1
15081,3,2,52902,52902,52904,0,2,2
15082,4,2,52906,52906,52908,0,2,2
15083,3,2,52909,52909,52911,0,2,1
15084,5,3,52914,52914,52917,0,3,3
15085,6,1,52920,52920,52921,0,1,3
15086,4,3,52924,52924,52927,0,3,3
15087,4,2,52928,52928,52930,0,2,1
15088,3,1,52931,52931,52932,0,1,1
15089,1,3,52932,52932,52935,0,3,0
15090,1,2,52933,52935,52937,2,4,0
15091,4,3,52937,52937,52940,0,3,0
15092,6,1,52943,52943,52944,0,1,3
15093,2,1,52945,52945,52946,0,1,1
15094,5,2,52950,52950,52952,0,2,4
15095,5,3,52955,52955,52958,0,3,3
15096,3,1,52958,52958,52959,0,1,0
15097,5,2,52963,52963,52965,0,2,4
15098,1,1,52964,52965,52966,1,2,0
15099,5,1,52969,52969,52970,0,1,3
15100,5,3,52974,52974,52977,0,3,4
15101,3,3,52977,52977,52980,0,3,0
15102,4,1,52981,52981,52982,0,1,1
15103,4,1,52985,52985,52986,0,1,3
15104,4,2,52989,52989,52991,0,2,3
15105,2,3,52991,52991,52994,0,3,0
15106,6,1,52997,52997,52998,0,1,3
15107,3,2,53000,53000,53002,0,2,2
15108,2,2,53002,53002,53004,0,2,0
15109,6,2,53008,53008,53010,0,2,4
15110,3,1,53011,53011,53012,0,1,1
15111,4,1,53015,53015,53016,0,1,3
15112,5,2,53020,53020,53022,0,2,4
15113,4,1,53024,53024,53025,0,1,2
15114,2,3,53026,53026,53029,0,3,1
15115,3,3,53029,53029,53032,0,3,0
15116,1,2,53030,53032,53034,2,4,0
15117,3,1,53033,53034,53035,1,2,0
15118,3,1,53036,53036,53037,0,1,1
15119,4,1,53040,53040,53041,0,1,3
15120,2,1,53042,53042,53043,0,1,1
15121,4,3,53046,53046,53049,0,3,3
15122,1,2,53047,53049,53051,2,4,0
15123,1,3,53048,53051,53054,3,6,0
15124,1,1,53049,53054,53055,5,6,0
15125,3,2,53052,53055,53057,3,5,0
15126,6,1,53058,53058,53059,0,1,1
15127,5,3,53063,53063,53066,0,3,4
15128,3,3,53066,53066,53069,0,3,0
15129,5,3,53071,53071,53074,0,3,2
15130,4,2,53075,53075,53077,0,2,1
15131,6,3,53081,53081,53084,0,3,4
15132,5,1,53086,53086,53087,0,1,2
15133,6,2,53092,53092,53094,0,2,5
15134,6,2,53098,53098,53100,0,2,4
15135,2,2,53100,53100,53102,0,2,0
15136,3,3,53103,53103,53106,0,3,1
15137,6,3,53109,53109,53112,0,3,3
15138,6,2,53115,53115,53117,0,2,3
15139,2,3,53117,53117,53120,0,3,0
15140,1,3,53118,53120,53123,2,5,0
15141,3,1,53121,53123,53124,2,3,0
15142,4,1,53125,53125,53126,0,1,1
15143,2,1,53127,53127,53128,0,1,1
15144,3,3,53130,53130,53133,0,3,2
15145,3,3,53133,53133,53136,0,3,0
15146,6,1,53139,53139,53140,0,1,3
15147,1,3,53140,53140,53143,0,3,0
15148,6,3,53146,53146,53149,0,3,3
15149,6,1,53152,53152,53153,0,1,3
15150,1,1,53153,53153,53154,0,1,0
15151,5,2,53158,53158,53160,0,2,4
15152,6,3,53164,53164,53167,0,3,4
15153,4,3,53168,53168,53171,0,3,1
15154,4,2,53172,53172,53174,0,2,1
15155,1,1,53173,53174,53175,1,2,0
15156,5,3,53178,53178,53181,0,3,3
15157,4,3,53182,53182,53185,0,3,1
15158,3,3,53185,53185,53188,0,3,0
15159,6,3,53191,53191,53194,0,3,3
15160,6,2,53197,53197,53199,0,2,3
15161,1,3,53198,53199,53202,1,4,0
15162,5,2,53203,53203,53205,0,2,1
15163,3,3,53206,53206,53209,0,3,1
15164,2,1,53208,53209,53210,1,2,0
15165,4,3,53212,53212,53215,0,3,2
15166,3,2,53215,53215,53217,0,2,0
15167,3,2,53218,53218,53220,0,2,1
15168,4,3,53222,53222,53225,0,3,2
15169,6,3,53228,53228,53231,0,3,3
15170,3,1,53231,53231,53232,0,1,0
15171,3,2,53234,53234,53236,0,2,2
15172,5,2,53239,53239,53241,0,2,3
15173,4,1,53243,53243,53244,0,1,2
15174,5,3,53248,53248,53251,0,3,4
15175,5,2,53253,53253,53255,0,2,2
15176,4,3,53257,53257,53260,0,3,2
15177,1,2,53258,53260,53262,2,4,0
15178,1,1,53259,53262,53263,3,4,0
15179,2,3,53261,53263,53266,2,5,0
15180,1,1,53262,53266,53267,4,5,0
15181,5,3,53267,53267,53270,0,3,0
15182,4,2,53271,53271,53273,0,2,1
15183,1,2,53272,53273,53275,1,3,0
15184,3,1,53275,53275,53276,0,1,0
15185,4,2,53279,53279,53281,0,2,3
15186,5,2,53284,53284,53286,0,2,3
15187,4,3,53288,53288,53291,0,3,2
15188,2,1,53290,53291,53292,1,2,0
15189,5,2,53295,53295,53297,0,2,3
15190,3,1,53298,53298,53299,0,1,1
15191,3,3,53301,53301,53304,0,3,2
15192,4,2,53305,53305,53307,0,2,1
15193,3,2,53308,53308,53310,0,2,1
15194,5,1,53313,53313,53314,0,1,3
15195,6,2,53319,53319,53321,0,2,5
15196,2,1,53321,53321,53322,0,1,0
15197,4,3,53325,53325,53328,0,3,3
15198,4,2,53329,53329,53331,0,2,1
15199,4,3,53333,53333,53336,0,3,2
15200,5,3,53338,53338,53341,0,3,2
15201,1,3,53339,53341,53344,2,5,0
15202,4,2,53343,53344,53346,1,3,0
15203,3,3,53346,53346,53349,0,3,0
15204,2,2,53348,53349,53351,1,3,0
15205,6,1,53354,53354,53355,0,1,3
15206,1,2,53355,53355,53357,0,2,0
15207,5,3,53360,53360,53363,0,3,3
15208,3,1,53363,53363,53364,0,1,0
15209,5,3,53368,53368,53371,0,3,4
15210,3,1,53371,53371,53372,0,1,0
15211,6,3,53377,53377,53380,0,3,5
15212,6,2,53383,53383,53385,0,2,3
15213,1,3,53384,53385,53388,1,4,0
15214,3,3,53387,53388,53391,1,4,0
15215,3,3,53390,53391,53394,1,4,0
15216,6,1,53396,53396,53397,0,1,2
15217,4,2,53400,53400,53402,0,2,3
15218,2,3,53402,53402,53405,0,3,0
15219,6,1,53408,53408,53409,0,1,3
15220,6,2,53414,53414,53416,0,2,5
15221,4,1,53418,53418,53419,0,1,2
15222,6,1,53424,53424,53425,0,1,5
15223,2,2,53426,53426,53428,0,2,1
15224,1,2,53427,53428,53430,1,3,0
15225,4,2,53431,53431,53433,0,2,1
15226,6,3,53437,53437,53440,0,3,4
15227,4,3,53441,53441,53444,0,3,1
15228,4,3,53445,53445,53448,0,3,1
15229,1,3,53446,53448,53451,2,5,0
15230,2,1,53448,53451,53452,3,4,0
15231,2,1,53450,53452,53453,2,3,0
15232,3,1,53453,53453,53454,0,1,0
15233,3,2,53456,53456,53458,0,2,2
15234,1,3,53457,53458,53461,1,4,0
15235,2,2,53459,53461,53463,2,4,0
15236,4,3,53463,53463,53466,0,3,0
15237,4,3,53467,53467,53470,0,3,1
15238,1,2,53468,53470,53472,2,4,0
15239,5,3,53473,53473,53476,0,3,1
15240,6,2,53479,53479,53481,0,2,3
15241,4,1,53483,53483,53484,0,1,2
15242,6,1,53489,53489,53490,0,1,5
15243,6,3,53495,53495,53498,0,3,5
15244,1,3,53496,53498,53501,2,5,0
15245,4,2,53500,53501,53503,1,3,0
15246,6,2,53506,53506,53508,0,2,3
15247,6,1,53512,53512,53513,0,1,4
15248,4,2,53516,53516,53518,0,2,3
15249,4,3,53520,53520,53523,0,3,2
15250,5,3,53525,53525,53528,0,3,2
15251,5,1,53530,53530,53531,0,1,2
15252,6,3,53536,53536,53539,0,3,5
15253,4,3,53540,53540,53543,0,3,1
15254,6,1,53546,53546,53547,0,1,3
15255,2,3,53548,53548,53551,0,3,1
15256,4,1,53552,53552,53553,0,1,1
15257,6,3,53558,53558,53561,0,3,5
15258,3,1,53561,53561,53562,0,1,0
15259,1,3,53562,53562,53565,0,3,0
15260,4,1,53566,53566,53567,0,1,1
15261,6,3,53572,53572,53575,0,3,5
15262,5,1,53577,53577,53578,0,1,2
15263,5,2,53582,53582,53584,0,2,4
15264,6,3,53588,53588,53591,0,3,4
15265,2,2,53590,53591,53593,1,3,0
15266,6,1,53596,53596,53597,0,1,3
15267,5,3,53601,53601,53604,0,3,4
15268,1,2,53602,53604,53606,2,4,0
15269,5,1,53607,53607,53608,0,1,1
15270,6,3,53613,53613,53616,0,3,5
15271,1,1,53614,53616,53617,2,3,0
15272,5,3,53619,53619,53622,0,3,2
15273,4,3,53623,53623,53626,0,3,1
15274,6,2,53629,53629,53631,0,2,3
15275,1,3,53630,53631,53634,1,4,0
15276,4,1,53634,53634,53635,0,1,0
15277,5,1,53639,53639,53640,0,1,4
15278,1,3,53640,53640,53643,0,3,0
15279,3,2,53643,53643,53645,0,2,0
15280,1,1,53644,53645,53646,1,2,0
15281,3,1,53647,53647,53648,0,1,1
15282,2,1,53649,53649,53650,0,1,1
15283,6,2,53655,53655,53657,0,2,5
15284,6,3,53661,53661,53664,0,3,4
15285,2,1,53663,53664,53665,1,2,0
15286,1,1,53664,53665,53666,1,2,0
15287,1,1,53665,53666,53667,1,2,0
15288,4,3,53669,53669,53672,0,3,2
15289,5,3,53674,53674,53677,0,3,2
15290,3,2,53677,53677,53679,0,2,0
15291,6,1,53683,53683,53684,0,1,4
15292,4,1,53687,53687,53688,0,1,3
15293,3,2,53690,53690,53692,0,2,2
15294,3,3,53693,53693,53696,0,3,1
15295,5,3,53698,53698,53701,0,3,2
15296,2,3,53700,53701,53704,1,4,0
15297,2,3,53702,53704,53707,2,5,0
15298,2,1,53704,53707,53708,3,4,0
15299,4,3,53708,53708,53711,0,3,0
15300,6,2,53714,53714,53716,0,2,3
15301,4,3,53718,53718,53721,0,3,2
15302,1,2,53719,53721,53723,2,4,0
15303,1,2,53720,53723,53725,3,5,0
15304,4,3,53724,53725,53728,1,4,0
15305,2,1,53726,53728,53729,2,3,0
15306,1,3,53727,53729,53732,2,5,0
15307,1,2,53728,53732,53734,4,6,0
15308,3,3,53731,53734,53737,3,6,0
15309,3,3,53734,53737,53740,3,6,0
15310,4,2,53738,53740,53742,2,4,0
15311,3,3,53741,53742,53745,1,4,0
15312,4,2,53745,53745,53747,0,2,0
15313,5,1,53750,53750,53751,0,1,3
15314,5,2,53755,53755,53757,0,2,4
15315,2,2,53757,53757,53759,0,2,0
15316,4,3,53761,53761,53764,0,3,2
15317,5,1,53766,53766,53767,0,1,2
15318,4,2,53770,53770,53772,0,2,3
15319,6,3,53776,53776,53779,0,3,4
15320,6,3,53782,53782,53785,0,3,3
15321,1,1,53783,53785,53786,2,3,0
15322,2,1,53785,53786,53787,1,2,0
15323,6,2,53791,53791,53793,0,2,4
15324,2,3,53793,53793,53796,0,3,0
15325,4,3,53797,53797,53800,0,3,1
15326,4,2,53801,53801,53803,0,2,1
15327,3,2,53804,53804,53806,0,2,1
15328,1,1,53805,53806,53807,1,2,0
15329,1,3,53806,53807,53810,1,4,0
15330,3,2,53809,53810,53812,1,3,0
15331,3,1,53812,53812,53813,0,1,0
15332,2,1,53814,53814,53815,0,1,1
15333,5,3,53819,53819,53822,0,3,4
15334,1,3,53820,53822,53825,2,5,0
15335,4,2,53824,53825,53827,1,3,0
15336,4,2,53828,53828,53830,0,2,1
15337,1,1,53829,53830,53831,1,2,0
15338,2,2,53831,53831,53833,0,2,0
15339,2,1,53833,53833,53834,0,1,0
15340,5,2,53838,53838,53840,0,2,4
15341,6,2,53844,53844,53846,0,2,4
15342,2,3,53846,53846,53849,0,3,0
15343,4,1,53850,53850,53851,0,1,1
15344,4,2,53854,53854,53856,0,2,3
15345,6,3,53860,53860,53863,0,3,4
15346,5,1,53865,53865,53866,0,1,2
15347,3,2,53868,53868,53870,0,2,2
15348,2,2,53870,53870,53872,0,2,0
15349,2,2,53872,53872,53874,0,2,0
15350,3,2,53875,53875,53877,0,2,1
15351,2,1,53877,53877,53878,0,1,0
15352,6,3,53883,53883,53886,0,3,5
15353,1,1,53884,53886,53887,2,3,0
15354,5,1,53889,53889,53890,0,1,2
15355,6,3,53895,53895,53898,0,3,5
15356,2,1,53897,53898,53899,1,2,0
15357,3,1,53900,53900,53901,0,1,1
15358,5,3,53905,53905,53908,0,3,4
15359,2,3,53907,53908,53911,1,4,0
15360,1,2,53908,53911,53913,3,5,0
15361,2,2,53910,53913,53915,3,5,0
15362,3,3,53913,53915,53918,2,5,0
15363,2,3,53915,53918,53921,3,6,0
15364,4,3,53919,53921,53924,2,5,0
15365,4,3,53923,53924,53927,1,4,0
15366,5,1,53928,53928,53929,0,1,1
15367,2,3,53930,53930,53933,0,3,1
15368,5,1,53935,53935,53936,0,1,2
15369,4,3,53939,53939,53942,0,3,3
15370,1,3,53940,53942,53945,2,5,0
15371,2,3,53942,53945,53948,3,6,0
15372,6,3,53948,53948,53951,0,3,0
15373,5,1,53953,53953,53954,0,1,2
15374,4,1,53957,53957,53958,0,1,3
15375,6,2,53963,53963,53965,0,2,5
15376,6,2,53969,53969,53971,0,2,4
15377,6,1,53975,53975,53976,0,1,4
15378,5,1,53980,53980,53981,0,1,4
15379,4,1,53984,53984,53985,0,1,3
15380,3,1,53987,53987,53988,0,1,2
15381,1,2,53988,53988,53990,0,2,0
15382,3,2,53991,53991,53993,0,2,1
15383,3,1,53994,53994,53995,0,1,1
15384,1,2,53995,53995,53997,0,2,0
15385,4,2,53999,53999,54001,0,2,2
15386,2,1,54001,54001,54002,0,1,0
15387,3,1,54004,54004,54005,0,1,2
15388,3,2,54007,54007,54009,0,2,2
15389,6,2,54013,54013,54015,0,2,4
15390,4,2,54017,54017,54019,0,2,2
15391,6,1,54023,54023,54024,0,1,4
15392,4,1,54027,54027,54028,0,1,3
15393,6,3,54033,54033,54036,0,3,5
15394,3,3,54036,54036,54039,0,3,0
15395,4,1,54040,54040,54041,0,1,1
15396,1,2,54041,54041,54043,0,2,0
15397,5,1,54046,54046,54047,0,1,3
15398,5,3,54051,54051,54054,0,3,4
15399,5,3,54056,54056,54059,0,3,2
15400,1,2,54057,54059,54061,2,4,0
15401,3,2,54060,54061,54063,1,3,0
15402,4,1,54064,54064,54065,0,1,1
15403,4,2,54068,54068,54070,0,2,3
15404,6,3,54074,54074,54077,0,3,4
15405,4,3,54078,54078,54081,0,3,1
15406,5,1,54083,54083,54084,0,1,2
15407,4,2,54087,54087,54089,0,2,3
15408,3,2,54090,54090,54092,0,2,1
15409,1,1,54091,54092,54093,1,2,0
15410,5,3,54096,54096,54099,0,3,3
15411,1,2,54097,54099,54101,2,4,0
15412,3,3,54100,54101,54104,1,4,0
15413,6,1,54106,54106,54107,0,1,2
15414,5,3,54111,54111,54114,0,3,4
15415,1,3,54112,54114,54117,2,5,0
15416,2,3,54114,54117,54120,3,6,0
15417,3,3,54117,54120,54123,3,6,0
15418,1,2,54118,54123,54125,5,7,0
15419,3,3,54121,54125,54128,4,7,0
15420,1,2,54122,54128,54130,6,8,0
15421,2,3,54124,54130,54133,6,9,0
15422,1,1,54125,54133,54134,8,9,0
15423,4,3,54129,54134,54137,5,8,0
15424,5,2,54134,54137,54139,3,5,0
15425,4,2,54138,54139,54141,1,3,0
15426,2,3,54140,54141,54144,1,4,0
15427,2,1,54142,54144,54145,2,3,0
15428,4,3,54146,54146,54149,0,3,1
15429,4,3,54150,54150,54153,0,3,1
15430,5,2,54155,54155,54157,0,2,2
15431,2,1,54157,54157,54158,0,1,0
15432,6,3,54163,54163,54166,0,3,5
15433,6,3,54169,54169,54172,0,3,3
15434,2,3,54171,54172,54175,1,4,0
15435,5,1,54176,54176,54177,0,1,1
15436,6,1,54182,54182,54183,0,1,5
15437,1,3,54183,54183,54186,0,3,0
15438,4,2,54187,54187,54189,0,2,1
15439,2,3,54189,54189,54192,0,3,0
15440,5,2,54194,54194,54196,0,2,2
15441,1,3,54195,54196,54199,1,4,0
15442,4,1,54199,54199,54200,0,1,0
15443,6,1,54205,54205,54206,0,1,5
15444,5,1,54210,54210,54211,0,1,4
15445,4,3,54214,54214,54217,0,3,3
15446,2,2,54216,54217,54219,1,3,0
15447,2,3,54218,54219,54222,1,4,0
15448,1,1,54219,54222,54223,3,4,0
15449,1,3,54220,54223,54226,3,6,0
15450,3,2,54223,54226,54228,3,5,0
15451,6,2,54229,54229,54231,0,2,1
15452,2,1,54231,54231,54232,0,1,0
15453,2,2,54233,54233,54235,0,2,1
15454,4,2,54237,54237,54239,0,2,2
15455,3,1,54240,54240,54241,0,1,1
15456,3,3,54243,54243,54246,0,3,2
15457,5,2,54248,54248,54250,0,2,2
15458,6,3,54254,54254,54257,0,3,4
15459,5,2,54259,54259,54261,0,2,2
15460,5,1,54264,54264,54265,0,1,3
15461,4,3,54268,54268,54271,0,3,3
15462,2,3,54270,54271,54274,1,4,0
15463,2,1,54272,54274,54275,2,3,0
15464,6,1,54278,54278,54279,0,1,3
15465,4,1,54282,54282,54283,0,1,3
15466,5,1,54287,54287,54288,0,1,4
15467,3,1,54290,54290,54291,0,1,2
15468,2,2,54292,54292,54294,0,2,1
15469,4,3,54296,54296,54299,0,3,2
15470,1,1,54297,54299,54300,2,3,0
15471,2,1,54299,54300,54301,1,2,0
15472,6,1,54305,54305,54306,0,1,4
15473,4,1,54309,54309,54310,0,1,3
15474,6,1,54315,54315,54316,0,1,5
15475,2,2,54317,54317,54319,0,2,1
15476,5,2,54322,54322,54324,0,2,3
15477,4,2,54326,54326,54328,0,2,2
15478,3,1,54329,54329,54330,0,1,1
15479,1,1,54330,54330,54331,0,1,0
15480,2,3,54332,54332,54335,0,3,1
15481,5,2,54337,54337,54339,0,2,2
15482,5,1,54342,54342,54343,0,1,3
15483,4,2,54346,54346,54348,0,2,3
15484,6,1,54352,54352,54353,0,1,4
15485,3,2,54355,54355,54357,0,2,2
15486,5,1,54360,54360,54361,0,1,3
15487,1,3,54361,54361,54364,0,3,0
15488,6,3,54367,54367,54370,0,3,3
15489,1,3,54368,54370,54373,2,5,0
15490,6,1,54374,54374,54375,0,1,1
15491,4,2,54378,54378,54380,0,2,3
15492,1,1,54379,54380,54381,1,2,0
15493,6,1,54385,54385,54386,0,1,4
15494,6,2,54391,54391,54393,0,2,5
15495,4,3,54395,54395,54398,0,3,2
15496,5,2,54400,54400,54402,0,2,2
15497,3,3,54403,54403,54406,0,3,1
15498,5,3,54408,54408,54411,0,3,2
15499,1,1,54409,54411,54412,2,3,0
15500,5,1,54414,54414,54415,0,1,2
15501,5,3,54419,54419,54422,0,3,4
15502,2,2,54421,54422,54424,1,3,0
15503,5,1,54426,54426,54427,0,1,2
15504,4,2,54430,54430,54432,0,2,3
15505,4,2,54434,54434,54436,0,2,2
15506,3,1,54437,54437,54438,0,1,1
15507,4,1,54441,54441,54442,0,1,3
15508,4,3,54445,54445,54448,0,3,3
15509,6,3,54451,54451,54454,0,3,3
15510,2,3,54453,54454,54457,1,4,0
15511,2,3,54455,54457,54460,2,5,0
15512,4,2,54459,54460,54462,1,3,0
15513,1,1,54460,54462,54463,2,3,0
15514,1,1,54461,54463,54464,2,3,0
15515,4,2,54465,54465,54467,0,2,1
15516,1,3,54466,54467,54470,1,4,0
15517,6,1,54472,54472,54473,0,1,2
15518,3,2,54475,54475,54477,0,2,2
15519,1,3,54476,54477,54480,1,4,0
15520,2,3,54478,54480,54483,2,5,0
15521,5,3,54483,54483,54486,0,3,0
15522,2,2,54485,54486,54488,1,3,0
15523,3,2,54488,54488,54490,0,2,0
15524,2,1,54490,54490,54491,0,1,0
15525,1,2,54491,54491,54493,0,2,0
15526,4,3,54495,54495,54498,0,3,2
15527,5,2,54500,54500,54502,0,2,2
15528,1,2,54501,54502,54504,1,3,0
15529,3,3,54504,54504,54507,0,3,0
15530,2,3,54506,54507,54510,1,4,0
15531,4,3,54510,54510,54513,0,3,0
15532,5,2,54515,54515,54517,0,2,2
15533,6,3,54521,54521,54524,0,3,4
15534,1,2,54522,54524,54526,2,4,0
15535,1,2,54523,54526,54528,3,5,0
15536,2,3,54525,54528,54531,3,6,0
15537,2,2,54527,54531,54533,4,6,0
15538,5,2,54532,54533,54535,1,3,0
15539,3,3,54535,54535,54538,0,3,0
15540,3,3,54538,54538,54541,0,3,0
15541,3,1,54541,54541,54542,0,1,0
15542,4,2,54545,54545,54547,0,2,3
15543,3,3,54548,54548,54551,0,3,1
15544,1,1,54549,54551,54552,2,3,0
15545,3,1,54552,54552,54553,0,1,0
15546,1,3,54553,54553,54556,0,3,0
15547,5,3,54558,54558,54561,0,3,2
15548,6,1,54564,54564,54565,0,1,3
15549,1,2,54565,54565,54567,0,2,0
15550,6,2,54571,54571,54573,0,2,4
15551,3,2,54574,54574,54576,0,2,1
15552,6,1,54580,54580,54581,0,1,4
15553,6,1,54586,54586,54587,0,1,5
15554,5,3,54591,54591,54594,0,3,4
15555,1,1,54592,54594,54595,2,3,0
15556,3,3,54595,54595,54598,0,3,0
15557,6,2,54601,54601,54603,0,2,3
15558,4,1,54605,54605,54606,0,1,2
15559,1,2,54606,54606,54608,0,2,0
15560,6,2,54612,54612,54614,0,2,4
15561,3,2,54615,54615,54617,0,2,1
15562,1,1,54616,54617,54618,1,2,0
15563,6,2,54622,54622,54624,0,2,4
15564,1,2,54623,54624,54626,1,3,0
15565,4,1,54627,54627,54628,0,1,1
15566,2,2,54629,54629,54631,0,2,1
15567,5,1,54634,54634,54635,0,1,3
15568,4,1,54638,54638,54639,0,1,3
15569,6,2,54644,54644,54646,0,2,5
15570,2,1,54646,54646,54647,0,1,0
15571,3,3,54649,54649,54652,0,3,2
15572,2,1,54651,54652,54653,1,2,0
15573,3,3,54654,54654,54657,0,3,1
15574,6,1,54660,54660,54661,0,1,3
15575,5,2,54665,54665,54667,0,2,4
15576,1,3,54666,54667,54670,1,4,0
15577,6,2,54672,54672,54674,0,2,2
15578,2,2,54674,54674,54676,0,2,0
15579,1,2,54675,54676,54678,1,3,0
15580,6,1,54681,54681,54682,0,1,3
15581,2,2,54683,54683,54685,0,2,1
15582,6,1,54689,54689,54690,0,1,4
15583,2,2,54691,54691,54693,0,2,1
15584,1,1,54692,54693,54694,1,2,0
15585,4,2,54696,54696,54698,0,2,2
15586,4,1,54700,54700,54701,0,1,2
15587,1,3,54701,54701,54704,0,3,0
15588,6,3,54707,54707,54710,0,3,3
15589,6,1,54713,54713,54714,0,1,3
15590,5,1,54718,54718,54719,0,1,4
15591,4,1,54722,54722,54723,0,1,3
15592,5,2,54727,54727,54729,0,2,4
15593,6,1,54733,54733,54734,0,1,4
15594,1,3,54734,54734,54737,0,3,0
15595,3,2,54737,54737,54739,0,2,0
15596,2,1,54739,54739,54740,0,1,0
15597,5,1,54744,54744,54745,0,1,4
15598,2,1,54746,54746,54747,0,1,1
15599,4,3,54750,54750,54753,0,3,3
15600,2,3,54752,54753,54756,1,4,0
15601,1,1,54753,54756,54757,3,4,0
15602,2,2,54755,54757,54759,2,4,0
15603,2,3,54757,54759,54762,2,5,0
15604,6,1,54763,54763,54764,0,1,1
15605,6,2,54769,54769,54771,0,2,5
15606,3,2,54772,54772,54774,0,2,1
15607,6,1,54778,54778,54779,0,1,4
15608,6,1,54784,54784,54785,0,1,5
15609,5,1,54789,54789,54790,0,1,4
15610,6,1,54795,54795,54796,0,1,5
15611,5,1,54800,54800,54801,0,1,4
15612,6,2,54806,54806,54808,0,2,5
15613,1,1,54807,54808,54809,1,2,0
15614,2,2,54809,54809,54811,0,2,0
15615,4,3,54813,54813,54816,0,3,2
15616,4,3,54817,54817,54820,0,3,1
15617,2,3,54819,54820,54823,1,4,0
15618,2,3,54821,54823,54826,2,5,0
15619,2,1,54823,54826,54827,3,4,0
15620,4,3,54827,54827,54830,0,3,0
15621,2,2,54829,54830,54832,1,3,0
15622,2,3,54831,54832,54835,1,4,0
15623,6,2,54837,54837,54839,0,2,2
15624,5,2,54842,54842,54844,0,2,3
15625,2,2,54844,54844,54846,0,2,0
15626,4,2,54848,54848,54850,0,2,2
15627,6,1,54854,54854,54855,0,1,4
15628,2,2,54856,54856,54858,0,2,1
15629,6,2,54862,54862,54864,0,2,4
15630,1,3,54863,54864,54867,1,4,0
15631,5,3,54868,54868,54871,0,3,1
15632,5,3,54873,54873,54876,0,3,2
15633,5,3,54878,54878,54881,0,3,2
15634,6,1,54884,54884,54885,0,1,3
15635,5,3,54889,54889,54892,0,3,4
15636,2,2,54891,54892,54894,1,3,0
15637,4,3,54895,54895,54898,0,3,1
15638,3,2,54898,54898,54900,0,2,0
15639,1,2,54899,54900,54902,1,3,0
15640,4,1,54903,54903,54904,0,1,1
15641,3,3,54906,54906,54909,0,3,2
15642,1,1,54907,54909,54910,2,3,0
15643,1,1,54908,54910,54911,2,3,0
15644,2,1,54910,54911,54912,1,2,0
15645,3,1,54913,54913,54914,0,1,1
15646,4,3,54917,54917,54920,0,3,3
15647,2,1,54919,54920,54921,1,2,0
15648,1,3,54920,54921,54924,1,4,0
15649,4,3,54924,54924,54927,0,3,0
15650,5,1,54929,54929,54930,0,1,2
15651,5,2,54934,54934,54936,0,2,4
15652,4,1,54938,54938,54939,0,1,2
15653,2,2,54940,54940,54942,0,2,1
15654,5,3,54945,54945,54948,0,3,3
15655,3,3,54948,54948,54951,0,3,0
15656,6,2,54954,54954,54956,0,2,3
15657,2,2,54956,54956,54958,0,2,0
15658,6,1,54962,54962,54963,0,1,4
15659,1,3,54963,54963,54966,0,3,0
15660,1,1,54964,54966,54967,2,3,0
15661,5,2,54969,54969,54971,0,2,2
15662,2,2,54971,54971,54973,0,2,0
15663,6,2,54977,54977,54979,0,2,4
15664,3,3,54980,54980,54983,0,3,1
15665,1,2,54981,54983,54985,2,4,0
15666,4,1,54985,54985,54986,0,1,0
15667,2,3,54987,54987,54990,0,3,1
15668,2,1,54989,54990,54991,1,2,0
15669,6,1,54995,54995,54996,0,1,4
15670,4,3,54999,54999,55002,0,3,3
15671,6,3,55005,55005,55008,0,3,3
15672,6,1,55011,55011,55012,0,1,3
15673,6,1,55017,55017,55018,0,1,5
15674,4,1,55021,55021,55022,0,1,3
15675,2,2,55023,55023,55025,0,2,1
15676,6,3,55029,55029,55032,0,3,4
15677,6,1,55035,55035,55036,0,1,3
15678,6,3,55041,55041,55044,0,3,5
15679,4,1,55045,55045,55046,0,1,1
15680,3,3,55048,55048,55051,0,3,2
15681,6,3,55054,55054,55057,0,3,3
15682,2,2,55056,55057,55059,1,3,0
15683,6,1,55062,55062,55063,0,1,3
15684,1,3,55063,55063,55066,0,3,0
15685,3,2,55066,55066,55068,0,2,0
15686,4,3,55070,55070,55073,0,3,2
15687,4,2,55074,55074,55076,0,2,1
15688,2,1,55076,55076,55077,0,1,0
15689,2,2,55078,55078,55080,0,2,1
15690,3,1,55081,55081,55082,0,1,1
15691,6,2,55087,55087,55089,0,2,5
15692,5,3,55092,55092,55095,0,3,3
15693,5,2,55097,55097,55099,0,2,2
15694,5,1,55102,55102,55103,0,1,3
15695,3,1,55105,55105,55106,0,1,2
15696,5,2,55110,55110,55112,0,2,4
15697,1,2,55111,55112,55114,1,3,0
15698,2,2,55113,55114,55116,1,3,0
15699,6,3,55119,55119,55122,0,3,3
15700,5,1,55124,55124,55125,0,1,2
15701,2,2,55126,55126,55128,0,2,1
15702,1,3,55127,55128,55131,1,4,0
15703,6,3,55133,55133,55136,0,3,2
15704,6,1,55139,55139,55140,0,1,3
15705,6,1,55145,55145,55146,0,1,5
15706,5,3,55150,55150,55153,0,3,4
15707,1,3,55151,55153,55156,2,5,0
15708,2,2,55153,55156,55158,3,5,0
15709,6,3,55159,55159,55162,0,3,1
15710,1,3,55160,55162,55165,2,5,0
15711,1,2,55161,55165,55167,4,6,0
15712,1,1,55162,55167,55168,5,6,0
15713,5,1,55167,55168,55169,1,2,0
15714,6,2,55173,55173,55175,0,2,4
15715,1,2,55174,55175,55177,1,3,0
15716,1,3,55175,55177,55180,2,5,0
15717,3,3,55178,55180,55183,2,5,0
15718,2,1,55180,55183,55184,3,4,0
15719,2,2,55182,55184,55186,2,4,0
15720,4,3,55186,55186,55189,0,3,0
15721,1,1,55187,55189,55190,2,3,0
15722,4,1,55191,55191,55192,0,1,1
15723,1,3,55192,55192,55195,0,3,0
15724,3,3,55195,55195,55198,0,3,0
15725,4,3,55199,55199,55202,0,3,1
15726,5,3,55204,55204,55207,0,3,2
15727,6,1,55210,55210,55211,0,1,3
15728,5,2,55215,55215,55217,0,2,4
15729,4,1,55219,55219,55220,0,1,2
15730,5,2,55224,55224,55226,0,2,4
15731,2,1,55226,55226,55227,0,1,0
15732,5,2,55231,55231,55233,0,2,4
15733,6,2,55237,55237,55239,0,2,4
15734,5,3,55242,55242,55245,0,3,3
15735,3,2,55245,55245,55247,0,2,0
15736,6,1,55251,55251,55252,0,1,4
15737,6,1,55257,55257,55258,0,1,5
15738,2,2,55259,55259,55261,0,2,1
15739,6,1,55265,55265,55266,0,1,4
15740,4,2,55269,55269,55271,0,2,3
15741,6,3,55275,55275,55278,0,3,4
15742,3,2,55278,55278,55280,0,2,0
15743,6,3,55284,55284,55287,0,3,4
15744,4,3,55288,55288,55291,0,3,1
15745,6,3,55294,55294,55297,0,3,3
15746,2,2,55296,55297,55299,1,3,0
15747,1,1,55297,55299,55300,2,3,0
15748,1,1,55298,55300,55301,2,3,0
15749,3,2,55301,55301,55303,0,2,0
15750,3,2,55304,55304,55306,0,2,1
15751,6,3,55310,55310,55313,0,3,4
15752,1,3,55311,55313,55316,2,5,0
15753,2,2,55313,55316,55318,3,5,0
15754,2,2,55315,55318,55320,3,5,0
15755,2,1,55317,55320,55321,3,4,0
15756,6,3,55323,55323,55326,0,3,2
15757,1,3,55324,55326,55329,2,5,0
15758,6,1,55330,55330,55331,0,1,1
15759,2,2,55332,55332,55334,0,2,1
15760,1,1,55333,55334,55335,1,2,0
15761,6,3,55339,55339,55342,0,3,4
15762,2,2,55341,55342,55344,1,3,0
15763,5,1,55346,55346,55347,0,1,2
15764,1,1,55347,55347,55348,0,1,0
15765,1,1,55348,55348,55349,0,1,0
15766,2,1,55350,55350,55351,0,1,1
15767,4,2,55354,55354,55356,0,2,3
15768,1,2,55355,55356,55358,1,3,0
15769,2,3,55357,55358,55361,1,4,0
15770,1,2,55358,55361,55363,3,5,0
15771,6,1,55364,55364,55365,0,1,1
15772,6,1,55370,55370,55371,0,1,5
15773,3,3,55373,55373,55376,0,3,2
15774,6,2,55379,55379,55381,0,2,3
15775,6,2,55385,55385,55387,0,2,4
15776,4,3,55389,55389,55392,0,3,2
15777,4,2,55393,55393,55395,0,2,1
15778,3,1,55396,55396,55397,0,1,1
15779,3,1,55399,55399,55400,0,1,2
15780,3,3,55402,55402,55405,0,3,2
15781,6,1,55408,55408,55409,0,1,3
15782,5,1,55413,55413,55414,0,1,4
15783,1,2,55414,55414,55416,0,2,0
15784,3,2,55417,55417,55419,0,2,1
15785,6,3,55423,55423,55426,0,3,4
15786,2,3,55425,55426,55429,1,4,0
15787,3,2,55428,55429,55431,1,3,0
15788,1,3,55429,55431,55434,2,5,0
15789,2,1,55431,55434,55435,3,4,0
15790,1,3,55432,55435,55438,3,6,0
15791,6,1,55438,55438,55439,0,1,0
15792,6,3,55444,55444,55447,0,3,5
15793,3,3,55447,55447,55450,0,3,0
15794,6,3,55453,55453,55456,0,3,3
15795,1,3,55454,55456,55459,2,5,0
15796,2,1,55456,55459,55460,3,4,0
15797,3,1,55459,55460,55461,1,2,0
15798,6,3,55465,55465,55468,0,3,4
15799,6,3,55471,55471,55474,0,3,3
15800,3,3,55474,55474,55477,0,3,0
15801,1,3,55475,55477,55480,2,5,0
15802,4,2,55479,55480,55482,1,3,0
15803,5,1,55484,55484,55485,0,1,2
15804,3,1,55487,55487,55488,0,1,2
15805,5,1,55492,55492,55493,0,1,4
15806,4,3,55496,55496,55499,0,3,3
15807,2,1,55498,55499,55500,1,2,0
15808,5,1,55503,55503,55504,0,1,3
15809,2,2,55505,55505,55507,0,2,1
15810,6,3,55511,55511,55514,0,3,4
15811,2,1,55513,55514,55515,1,2,0
15812,6,1,55519,55519,55520,0,1,4
15813,4,2,55523,55523,55525,0,2,3
15814,6,1,55529,55529,55530,0,1,4
15815,4,2,55533,55533,55535,0,2,3
15816,3,3,55536,55536,55539,0,3,1
15817,2,2,55538,55539,55541,1,3,0
15818,2,1,55540,55541,55542,1,2,0
15819,2,3,55542,55542,55545,0,3,0
15820,1,3,55543,55545,55548,2,5,0
15821,4,1,55547,55548,55549,1,2,0
15822,6,2,55553,55553,55555,0,2,4
15823,6,1,55559,55559,55560,0,1,4
15824,6,3,55565,55565,55568,0,3,5
15825,2,1,55567,55568,55569,1,2,0
15826,6,1,55573,55573,55574,0,1,4
15827,6,2,55579,55579,55581,0,2,5
15828,6,3,55585,55585,55588,0,3,4
15829,6,3,55591,55591,55594,0,3,3
15830,5,3,55596,55596,55599,0,3,2
15831,1,3,55597,55599,55602,2,5,0
15832,1,2,55598,55602,55604,4,6,0
15833,2,2,55600,55604,55606,4,6,0
15834,4,3,55604,55606,55609,2,5,0
15835,2,3,55606,55609,55612,3,6,0
15836,1,1,55607,55612,55613,5,6,0
15837,1,2,55608,55613,55615,5,7,0
15838,4,1,55612,55615,55616,3,4,0
15839,4,3,55616,55616,55619,0,3,0
15840,2,3,55618,55619,55622,1,4,0
15841,1,3,55619,55622,55625,3,6,0
15842,1,3,55620,55625,55628,5,8,0
15843,1,3,55621,55628,55631,7,10,0
15844,5,1,55626,55631,55632,5,6,0
15845,5,2,55631,55632,55634,1,3,0
15846,2,1,55633,55634,55635,1,2,0
15847,3,3,55636,55636,55639,0,3,1
15848,3,1,55639,55639,55640,0,1,0
15849,4,1,55643,55643,55644,0,1,3
15850,3,1,55646,55646,55647,0,1,2
15851,4,2,55650,55650,55652,0,2,3
15852,3,2,55653,55653,55655,0,2,1
15853,4,3,55657,55657,55660,0,3,2
15854,4,2,55661,55661,55663,0,2,1
15855,5,1,55666,55666,55667,0,1,3
15856,5,3,55671,55671,55674,0,3,4
15857,5,3,55676,55676,55679,0,3,2
15858,1,1,55677,55679,55680,2,3,0
15859,5,1,55682,55682,55683,0,1,2
15860,4,3,55686,55686,55689,0,3,3
15861,6,3,55692,55692,55695,0,3,3
15862,4,1,55696,55696,55697,0,1,1
15863,6,3,55702,55702,55705,0,3,5
15864,6,1,55708,55708,55709,0,1,3
15865,4,3,55712,55712,55715,0,3,3
15866,6,3,55718,55718,55721,0,3,3
15867,2,1,55720,55721,55722,1,2,0
15868,2,3,55722,55722,55725,0,3,0
15869,3,2,55725,55725,55727,0,2,0
15870,3,1,55728,55728,55729,0,1,1
15871,4,2,55732,55732,55734,0,2,3
15872,5,2,55737,55737,55739,0,2,3
15873,4,1,55741,55741,55742,0,1,2
15874,1,2,55742,55742,55744,0,2,0
15875,6,1,55748,55748,55749,0,1,4
15876,1,2,55749,55749,55751,0,2,0
15877,6,2,55755,55755,55757,0,2,4
15878,2,3,55757,55757,55760,0,3,0
15879,1,1,55758,55760,55761,2,3,0
15880,4,2,55762,55762,55764,0,2,1
15881,6,3,55768,55768,55771,0,3,4
15882,2,3,55770,55771,55774,1,4,0
15883,3,3,55773,55774,55777,1,4,0
15884,5,1,55778,55778,55779,0,1,1
15885,2,2,55780,55780,55782,0,2,1
15886,2,3,55782,55782,55785,0,3,0
15887,4,1,55786,55786,55787,0,1,1
15888,4,2,55790,55790,55792,0,2,3
15889,1,2,55791,55792,55794,1,3,0
15890,1,3,55792,55794,55797,2,5,0
15891,5,1,55797,55797,55798,0,1,0
15892,5,1,55802,55802,55803,0,1,4
15893,1,2,55803,55803,55805,0,2,0
15894,3,3,55806,55806,55809,0,3,1
15895,5,2,55811,55811,55813,0,2,2
15896,5,3,55816,55816,55819,0,3,3
15897,1,2,55817,55819,55821,2,4,0
15898,1,3,55818,55821,55824,3,6,0
15899,2,3,55820,55824,55827,4,7,0
15900,1,3,55821,55827,55830,6,9,0
15901,4,2,55825,55830,55832,5,7,0
15902,4,2,55829,55832,55834,3,5,0
15903,1,1,55830,55834,55835,4,5,0
15904,1,3,55831,55835,55838,4,7,0
15905,3,1,55834,55838,55839,4,5,0
15906,1,2,55835,55839,55841,4,6,0
15907,4,1,55839,55841,55842,2,3,0
15908,6,2,55845,55845,55847,0,2,3
15909,5,2,55850,55850,55852,0,2,3
15910,5,1,55855,55855,55856,0,1,3
15911,4,1,55859,55859,55860,0,1,3
15912,1,1,55860,55860,55861,0,1,0
15913,3,3,55863,55863,55866,0,3,2
15914,4,2,55867,55867,55869,0,2,1
15915,4,2,55871,55871,55873,0,2,2
15916,2,2,55873,55873,55875,0,2,0
15917,5,2,55878,55878,55880,0,2,3
15918,5,1,55883,55883,55884,0,1,3
15919,3,1,55886,55886,55887,0,1,2
15920,1,2,55887,55887,55889,0,2,0
15921,6,3,55893,55893,55896,0,3,4
15922,3,3,55896,55896,55899,0,3,0
15923,1,1,55897,55899,55900,2,3,0
15924,3,3,55900,55900,55903,0,3,0
15925,6,2,55906,55906,55908,0,2,3
15926,6,1,55912,55912,55913,0,1,4
15927,4,3,55916,55916,55919,0,3,3
15928,1,3,55917,55919,55922,2,5,0
15929,6,1,55923,55923,55924,0,1,1
15930,1,3,55924,55924,55927,0,3,0
15931,5,2,55929,55929,55931,0,2,2
15932,2,3,55931,55931,55934,0,3,0
15933,2,3,55933,55934,55937,1,4,0
15934,1,2,55934,55937,55939,3,5,0
15935,6,2,55940,55940,55942,0,2,1
15936,2,3,55942,55942,55945,0,3,0
15937,4,1,55946,55946,55947,0,1,1
15938,4,1,55950,55950,55951,0,1,3
15939,2,1,55952,55952,55953,0,1,1
15940,3,1,55955,55955,55956,0,1,2
15941,1,3,55956,55956,55959,0,3,0
15942,3,1,55959,55959,55960,0,1,0
15943,6,1,55965,55965,55966,0,1,5
15944,2,2,55967,55967,55969,0,2,1
15945,1,1,55968,55969,55970,1,2,0
15946,4,2,55972,55972,55974,0,2,2
15947,1,2,55973,55974,55976,1,3,0
15948,2,2,55975,55976,55978,1,3,0
15949,5,1,55980,55980,55981,0,1,2
15950,3,3,55983,55983,55986,0,3,2
15951,1,2,55984,55986,55988,2,4,0
15952,2,1,55986,55988,55989,2,3,0
15953,3,3,55989,55989,55992,0,3,0
15954,3,2,55992,55992,55994,0,2,0
15955,1,2,55993,55994,55996,1,3,0
15956,1,1,55994,55996,55997,2,3,0
15957,5,3,55999,55999,56002,0,3,2
15958,6,3,56005,56005,56008,0,3,3
15959,2,2,56007,56008,56010,1,3,0
15960,1,2,56008,56010,56012,2,4,0
15961,3,1,56011,56012,56013,1,2,0
15962,2,3,56013,56013,56016,0,3,0
15963,4,2,56017,56017,56019,0,2,1
15964,5,1,56022,56022,56023,0,1,3
15965,6,2,56028,56028,56030,0,2,5
15966,5,2,56033,56033,56035,0,2,3
15967,3,2,56036,56036,56038,0,2,1
15968,2,1,56038,56038,56039,0,1,0
15969,2,1,56040,56040,56041,0,1,1
15970,2,2,56042,56042,56044,0,2,1
15971,5,1,56047,56047,56048,0,1,3
15972,4,1,56051,56051,56052,0,1,3
15973,4,1,56055,56055,56056,0,1,3
15974,2,1,56057,56057,56058,0,1,1
15975,6,1,56063,56063,56064,0,1,5
15976,5,1,56068,56068,56069,0,1,4
15977,3,3,56071,56071,56074,0,3,2
15978,6,3,56077,56077,56080,0,3,3
15979,3,2,56080,56080,56082,0,2,0
15980,4,2,56084,56084,56086,0,2,2
15981,2,1,56086,56086,56087,0,1,0
15982,5,2,56091,56091,56093,0,2,4
15983,1,3,56092,56093,56096,1,4,0
15984,3,3,56095,56096,56099,1,4,0
15985,6,2,56101,56101,56103,0,2,2
15986,3,1,56104,56104,56105,0,1,1
15987,1,3,56105,56105,56108,0,3,0
15988,1,1,56106,56108,56109,2,3,0
15989,5,1,56111,56111,56112,0,1,2
15990,6,2,56117,56117,56119,0,2,5
15991,2,1,56119,56119,56120,0,1,0
15992,4,1,56123,56123,56124,0,1,3
15993,5,2,56128,56128,56130,0,2,4
15994,2,3,56130,56130,56133,0,3,0
15995,6,3,56136,56136,56139,0,3,3
15996,4,3,56140,56140,56143,0,3,1
15997,4,3,56144,56144,56147,0,3,1
15998,3,2,56147,56147,56149,0,2,0
15999,6,2,56153,56153,56155,0,2,4
16000,2,1,56155,56155,56156,0,1,0
16001,6,1,56161,56161,56162,0,1,5
16002,3,3,56164,56164,56167,0,3,2
16003,6,3,56170,56170,56173,0,3,3
16004,2,1,56172,56173,56174,1,2,0
16005,5,2,56177,56177,56179,0,2,3
16006,2,1,56179,56179,56180,0,1,0
16007,2,3,56181,56181,56184,0,3,1
16008,3,1,56184,56184,56185,0,1,0
16009,4,2,56188,56188,56190,0,2,3
16010,1,2,56189,56190,56192,1,3,0
16011,4,1,56193,56193,56194,0,1,1
16012,3,2,56196,56196,56198,0,2,2
16013,5,2,56201,56201,56203,0,2,3
16014,3,1,56204,56204,56205,0,1,1
16015,3,1,56207,56207,56208,0,1,2
16016,2,3,56209,56209,56212,0,3,1
16017,3,2,56212,56212,56214,0,2,0
16018,3,3,56215,56215,56218,0,3,1
16019,3,1,56218,56218,56219,0,1,0
16020,1,3,56219,56219,56222,0,3,0
16021,3,2,56222,56222,56224,0,2,0
16022,1,3,56223,56224,56227,1,4,0
16023,6,1,56229,56229,56230,0,1,2
16024,6,3,56235,56235,56238,0,3,5
16025,1,1,56236,56238,56239,2,3,0
16026,1,1,56237,56239,56240,2,3,0
16027,2,3,56239,56240,56243,1,4,0
16028,2,3,56241,56243,56246,2,5,0
16029,3,1,56244,56246,56247,2,3,0
16030,6,1,56250,56250,56251,0,1,3
16031,4,2,56254,56254,56256,0,2,3
16032,4,2,56258,56258,56260,0,2,2
16033,4,2,56262,56262,56264,0,2,2
16034,5,2,56267,56267,56269,0,2,3
16035,5,2,56272,56272,56274,0,2,3
16036,5,1,56277,56277,56278,0,1,3
16037,5,2,56282,56282,56284,0,2,4
16038,5,3,56287,56287,56290,0,3,3
16039,6,2,56293,56293,56295,0,2,3
16040,2,2,56295,56295,56297,0,2,0
16041,1,3,56296,56297,56300,1,4,0
16042,3,3,56299,56300,56303,1,4,0
16043,2,1,56301,56303,56304,2,3,0
16044,3,3,56304,56304,56307,0,3,0
16045,2,3,56306,56307,56310,1,4,0
16046,6,2,56312,56312,56314,0,2,2
16047,1,2,56313,56314,56316,1,3,0
16048,2,3,56315,56316,56319,1,4,0
16049,4,1,56319,56319,56320,0,1,0
16050,3,3,56322,56322,56325,0,3,2
16051,2,3,56324,56325,56328,1,4,0
16052,4,2,56328,56328,56330,0,2,0
16053,1,3,56329,56330,56333,1,4,0
16054,4,2,56333,56333,56335,0,2,0
16055,2,2,56335,56335,56337,0,2,0
16056,3,1,56338,56338,56339,0,1,1
16057,4,3,56342,56342,56345,0,3,3
16058,1,3,56343,56345,56348,2,5,0
16059,2,1,56345,56348,56349,3,4,0
16060,3,2,56348,56349,56351,1,3,0
16061,4,1,56352,56352,56353,0,1,1
16062,3,3,56355,56355,56358,0,3,2
16063,6,2,56361,56361,56363,0,2,3
16064,3,3,56364,56364,56367,0,3,1
16065,4,2,56368,56368,56370,0,2,1
16066,2,1,56370,56370,56371,0,1,0
16067,3,1,56373,56373,56374,0,1,2
16068,6,2,56379,56379,56381,0,2,5
16069,2,1,56381,56381,56382,0,1,0
16070,3,1,56384,56384,56385,0,1,2
16071,2,3,56386,56386,56389,0,3,1
16072,4,2,56390,56390,56392,0,2,1
16073,1,1,56391,56392,56393,1,2,0
16074,4,1,56395,56395,56396,0,1,2
16075,3,2,56398,56398,56400,0,2,2
16076,6,3,56404,56404,56407,0,3,4
16077,6,3,56410,56410,56413,0,3,3
16078,1,3,56411,56413,56416,2,5,0
16079,1,3,56412,56416,56419,4,7,0
16080,1,1,56413,56419,56420,6,7,0
16081,3,1,56416,56420,56421,4,5,0
16082,5,2,56421,56421,56423,0,2,0
16083,2,1,56423,56423,56424,0,1,0
16084,3,3,56426,56426,56429,0,3,2
16085,6,1,56432,56432,56433,0,1,3
16086,3,2,56435,56435,56437,0,2,2
16087,4,3,56439,56439,56442,0,3,2
16088,6,3,56445,56445,56448,0,3,3
16089,4,3,56449,56449,56452,0,3,1
16090,1,3,56450,56452,56455,2,5,0
16091,6,2,56456,56456,56458,0,2,1
16092,5,1,56461,56461,56462,0,1,3
16093,6,3,56467,56467,56470,0,3,5
16094,6,3,56473,56473,56476,0,3,3
16095,5,3,56478,56478,56481,0,3,2
16096,5,2,56483,56483,56485,0,2,2
16097,2,2,56485,56485,56487,0,2,0
16098,4,1,56489,56489,56490,0,1,2
16099,1,3,56490,56490,56493,0,3,0
16100,3,3,56493,56493,56496,0,3,0
16101,6,1,56499,56499,56500,0,1,3
16102,4,3,56503,56503,56506,0,3,3
16103,5,2,56508,56508,56510,0,2,2
16104,2,2,56510,56510,56512,0,2,0
16105,5,1,56515,56515,56516,0,1,3
16106,4,2,56519,56519,56521,0,2,3
16107,1,1,56520,56521,56522,1,2,0
16108,1,2,56521,56522,56524,1,3,0
16109,4,3,56525,56525,56528,0,3,1
16110,1,1,56526,56528,56529,2,3,0
16111,2,2,56528,56529,56531,1,3,0
16112,1,1,56529,56531,56532,2,3,0
16113,3,1,56532,56532,56533,0,1,0
16114,4,2,56536,56536,56538,0,2,3
16115,3,1,56539,56539,56540,0,1,1
16116,6,1,56545,56545,56546,0,1,5
16117,4,3,56549,56549,56552,0,3,3
16118,2,3,56551,56552,56555,1,4,0
16119,6,3,56557,56557,56560,0,3,2
16120,6,2,56563,56563,56565,0,2,3
16121,2,3,56565,56565,56568,0,3,0
16122,6,1,56571,56571,56572,0,1,3
16123,6,3,56577,56577,56580,0,3,5
16124,2,1,56579,56580,56581,1,2,0
16125,4,2,56583,56583,56585,0,2,2
16126,1,2,56584,56585,56587,1,3,0
16127,6,1,56590,56590,56591,0,1,3
16128,2,3,56592,56592,56595,0,3,1
16129,2,3,56594,56595,56598,1,4,0
16130,5,3,56599,56599,56602,0,3,1
16131,4,3,56603,56603,56606,0,3,1
16132,2,1,56605,56606,56607,1,2,0
16133,5,2,56610,56610,56612,0,2,3
16134,2,2,56612,56612,56614,0,2,0
16135,6,1,56618,56618,56619,0,1,4
16136,6,3,56624,56624,56627,0,3,5
16137,4,2,56628,56628,56630,0,2,1
16138,6,1,56634,56634,56635,0,1,4
16139,2,2,56636,56636,56638,0,2,1
16140,2,1,56638,56638,56639,0,1,0
16141,1,2,56639,56639,56641,0,2,0
16142,5,1,56644,56644,56645,0,1,3
16143,1,3,56645,56645,56648,0,3,0
16144,1,1,56646,56648,56649,2,3,0
16145,2,2,56648,56649,56651,1,3,0
16146,1,3,56649,56651,56654,2,5,0
16147,1,3,56650,56654,56657,4,7,0
16148,5,2,56655,56657,56659,2,4,0
16149,4,3,56659,56659,56662,0,3,0
16150,3,1,56662,56662,56663,0,1,0
16151,3,2,56665,56665,56667,0,2,2
16152,5,1,56670,56670,56671,0,1,3
16153,1,3,56671,56671,56674,0,3,0
16154,1,3,56672,56674,56677,2,5,0
16155,6,2,56678,56678,56680,0,2,1
16156,3,3,56681,56681,56684,0,3,1
16157,5,1,56686,56686,56687,0,1,2
16158,6,1,56692,56692,56693,0,1,5
16159,1,2,56693,56693,56695,0,2,0
16160,5,1,56698,56698,56699,0,1,3
16161,6,3,56704,56704,56707,0,3,5
16162,1,2,56705,56707,56709,2,4,0
16163,4,1,56709,56709,56710,0,1,0
16164,2,3,56711,56711,56714,0,3,1
16165,5,2,56716,56716,56718,0,2,2
16166,4,1,56720,56720,56721,0,1,2
16167,4,3,56724,56724,56727,0,3,3
16168,6,2,56730,56730,56732,0,2,3
16169,6,1,56736,56736,56737,0,1,4
16170,4,3,56740,56740,56743,0,3,3
16171,2,3,56742,56743,56746,1,4,0
16172,2,2,56744,56746,56748,2,4,0
16173,6,2,56750,56750,56752,0,2,2
16174,4,3,56754,56754,56757,0,3,2
16175,6,1,56760,56760,56761,0,1,3
16176,5,2,56765,56765,56767,0,2,4
16177,1,3,56766,56767,56770,1,4,0
16178,4,3,56770,56770,56773,0,3,0
16179,4,1,56774,56774,56775,0,1,1
16180,2,3,56776,56776,56779,0,3,1
16181,1,3,56777,56779,56782,2,5,0
16182,3,3,56780,56782,56785,2,5,0
16183,4,1,56784,56785,56786,1,2,0
16184,4,2,56788,56788,56790,0,2,2
16185,4,3,56792,56792,56795,0,3,2
16186,5,2,56797,56797,56799,0,2,2
16187,3,3,56800,56800,56803,0,3,1
16188,3,2,56803,56803,56805,0,2,0
16189,1,3,56804,56805,56808,1,4,0
16190,5,3,56809,56809,56812,0,3,1
16191,1,2,56810,56812,56814,2,4,0
16192,5,2,56815,56815,56817,0,2,1
16193,2,2,56817,56817,56819,0,2,0
16194,1,3,56818,56819,56822,1,4,0
16195,2,3,56820,56822,56825,2,5,0
16196,3,2,56823,56825,56827,2,4,0
16197,2,2,56825,56827,56829,2,4,0
16198,5,1,56830,56830,56831,0,1,1
16199,2,3,56832,56832,56835,0,3,1
16200,2,1,56834,56835,56836,1,2,0
16201,2,2,56836,56836,56838,0,2,0
16202,4,1,56840,56840,56841,0,1,2
16203,1,1,56841,56841,56842,0,1,0
16204,4,3,56845,56845,56848,0,3,3
16205,5,1,56850,56850,56851,0,1,2
16206,3,2,56853,56853,56855,0,2,2
16207,5,3,56858,56858,56861,0,3,3
16208,6,1,56864,56864,56865,0,1,3
16209,5,2,56869,56869,56871,0,2,4
16210,2,2,56871,56871,56873,0,2,0
16211,6,2,56877,56877,56879,0,2,4
16212,5,1,56882,56882,56883,0,1,3
16213,6,2,56888,56888,56890,0,2,5
16214,6,2,56894,56894,56896,0,2,4
16215,2,1,56896,56896,56897,0,1,0
16216,5,3,56901,56901,56904,0,3,4
16217,3,1,56904,56904,56905,0,1,0
16218,3,1,56907,56907,56908,0,1,2
16219,6,1,56913,56913,56914,0,1,5
16220,1,1,56914,56914,56915,0,1,0
16221,3,2,56917,56917,56919,0,2,2
16222,3,3,56920,56920,56923,0,3,1
16223,1,1,56921,56923,56924,2,3,0
16224,5,3,56926,56926,56929,0,3,2
16225,2,2,56928,56929,56931,1,3,0
16226,5,1,56933,56933,56934,0,1,2
16227,3,1,56936,56936,56937,0,1,2
16228,3,1,56939,56939,56940,0,1,2
16229,1,3,56940,56940,56943,0,3,0
16230,1,2,56941,56943,56945,2,4,0
16231,1,1,56942,56945,56946,3,4,0
16232,2,1,56944,56946,56947,2,3,0
16233,1,2,56945,56947,56949,2,4,0
16234,6,1,56951,56951,56952,0,1,2
16235,2,2,56953,56953,56955,0,2,1
16236,1,2,56954,56955,56957,1,3,0
16237,1,2,56955,56957,56959,2,4,0
16238,6,3,56961,56961,56964,0,3,2
16239,3,2,56964,56964,56966,0,2,0
16240,1,2,56965,56966,56968,1,3,0
16241,3,1,56968,56968,56969,0,1,0
16242,2,2,56970,56970,56972,0,2,1
16243,2,1,56972,56972,56973,0,1,0
16244,2,3,56974,56974,56977,0,3,1
16245,4,3,56978,56978,56981,0,3,1
16246,1,2,56979,56981,56983,2,4,0
16247,6,2,56985,56985,56987,0,2,2
16248,6,3,56991,56991,56994,0,3,4
16249,2,3,56993,56994,56997,1,4,0
16250,4,2,56997,56997,56999,0,2,0
16251,4,2,57001,57001,57003,0,2,2
16252,4,3,57005,57005,57008,0,3,2
16253,3,3,57008,57008,57011,0,3,0
16254,6,2,57014,57014,57016,0,2,3
16255,6,3,57020,57020,57023,0,3,4
16256,2,3,57022,57023,57026,1,4,0
16257,2,2,57024,57026,57028,2,4,0
16258,5,3,57029,57029,57032,0,3,1
16259,3,2,57032,57032,57034,0,2,0
16260,5,1,57037,57037,57038,0,1,3
16261,2,3,57039,57039,57042,0,3,1
16262,2,2,57041,57042,57044,1,3,0
16263,1,2,57042,57044,57046,2,4,0
16264,3,3,57045,57046,57049,1,4,0
16265,1,3,57046,57049,57052,3,6,0
16266,1,3,57047,57052,57055,5,8,0
16267,1,1,57048,57055,57056,7,8,0
16268,1,1,57049,57056,57057,7,8,0
16269,5,3,57054,57057,57060,3,6,0
16270,5,2,57059,57060,57062,1,3,0
16271,2,3,57061,57062,57065,1,4,0
16272,6,3,57067,57067,57070,0,3,2
16273,2,2,57069,57070,57072,1,3,0
16274,4,1,57073,57073,57074,0,1,1
16275,1,3,57074,57074,57077,0,3,0
16276,2,2,57076,57077,57079,1,3,0
16277,1,3,57077,57079,57082,2,5,0
16278,3,3,57080,57082,57085,2,5,0
16279,3,2,57083,57085,57087,2,4,0
16280,5,3,57088,57088,57091,0,3,1
16281,3,3,57091,57091,57094,0,3,0
16282,3,3,57094,57094,57097,0,3,0
16283,4,2,57098,57098,57100,0,2,1
16284,6,2,57104,57104,57106,0,2,4
16285,4,3,57108,57108,57111,0,3,2
16286,6,3,57114,57114,57117,0,3,3
16287,5,2,57119,57119,57121,0,2,2
16288,6,3,57125,57125,57128,0,3,4
16289,4,3,57129,57129,57132,0,3,1
16290,1,3,57130,57132,57135,2,5,0
16291,5,1,57135,57135,57136,0,1,0
16292,5,2,57140,57140,57142,0,2,4
16293,4,3,57144,57144,57147,0,3,2
16294,5,3,57149,57149,57152,0,3,2
16295,1,1,57150,57152,57153,2,3,0
16296,4,1,57154,57154,57155,0,1,1
16297,5,2,57159,57159,57161,0,2,4
16298,6,1,57165,57165,57166,0,1,4
16299,6,1,57171,57171,57172,0,1,5
16300,2,1,57173,57173,57174,0,1,1
16301,4,3,57177,57177,57180,0,3,3
16302,1,2,57178,57180,57182,2,4,0
16303,6,3,57184,57184,57187,0,3,2
16304,6,2,57190,57190,57192,0,2,3
16305,4,3,57194,57194,57197,0,3,2
16306,3,3,57197,57197,57200,0,3,0
16307,3,3,57200,57200,57203,0,3,0
16308,4,2,57204,57204,57206,0,2,1
16309,2,3,57206,57206,57209,0,3,0
16310,5,3,57211,57211,57214,0,3,2
16311,1,3,57212,57214,57217,2,5,0
16312,4,1,57216,57217,57218,1,2,0
16313,1,2,57217,57218,57220,1,3,0
16314,3,2,57220,57220,57222,0,2,0
16315,1,3,57221,57222,57225,1,4,0
16316,2,1,57223,57225,57226,2,3,0
16317,4,2,57227,57227,57229,0,2,1
16318,5,3,57232,57232,57235,0,3,3
16319,4,3,57236,57236,57239,0,3,1
16320,4,1,57240,57240,57241,0,1,1
16321,3,2,57243,57243,57245,0,2,2
16322,6,1,57249,57249,57250,0,1,4
16323,6,3,57255,57255,57258,0,3,5
16324,6,3,57261,57261,57264,0,3,3
16325,5,1,57266,57266,57267,0,1,2
16326,6,1,57272,57272,57273,0,1,5
16327,3,1,57275,57275,57276,0,1,2
16328,2,3,57277,57277,57280,0,3,1
16329,2,3,57279,57280,57283,1,4,0
16330,2,2,57281,57283,57285,2,4,0
16331,6,2,57287,57287,57289,0,2,2
16332,1,2,57288,57289,57291,1,3,0
16333,5,1,57293,57293,57294,0,1,2
16334,5,1,57298,57298,57299,0,1,4
16335,6,1,57304,57304,57305,0,1,5
16336,5,2,57309,57309,57311,0,2,4
16337,5,3,57314,57314,57317,0,3,3
16338,4,2,57318,57318,57320,0,2,1
16339,6,2,57324,57324,57326,0,2,4
16340,3,1,57327,57327,57328,0,1,1
16341,3,1,57330,57330,57331,0,1,2
16342,5,1,57335,57335,57336,0,1,4
16343,4,3,57339,57339,57342,0,3,3
16344,2,1,57341,57342,57343,1,2,0
16345,4,3,57345,57345,57348,0,3,2
16346,3,3,57348,57348,57351,0,3,0
16347,6,2,57354,57354,57356,0,2,3
16348,3,3,57357,57357,57360,0,3,1
16349,2,2,57359,57360,57362,1,3,0
16350,1,1,57360,57362,57363,2,3,0
16351,2,2,57362,57363,57365,1,3,0
16352,5,2,57367,57367,57369,0,2,2
16353,2,1,57369,57369,57370,0,1,0
16354,2,1,57371,57371,57372,0,1,1
16355,6,3,57377,57377,57380,0,3,5
16356,3,1,57380,57380,57381,0,1,0
16357,3,2,57383,57383,57385,0,2,2
16358,5,1,57388,57388,57389,0,1,3
16359,5,2,57393,57393,57395,0,2,4
16360,1,3,57394,57395,57398,1,4,0
16361,2,2,57396,57398,57400,2,4,0
16362,5,2,57401,57401,57403,0,2,1
16363,1,3,57402,57403,57406,1,4,0
16364,1,2,57403,57406,57408,3,5,0
16365,3,3,57406,57408,57411,2,5,0
16366,4,2,57410,57411,57413,1,3,0
16367,2,3,57412,57413,57416,1,4,0
16368,4,3,57416,57416,57419,0,3,0
16369,2,1,57418,57419,57420,1,2,0
16370,5,1,57423,57423,57424,0,1,3
16371,4,3,57427,57427,57430,0,3,3
16372,2,3,57429,57430,57433,1,4,0
16373,4,1,57433,57433,57434,0,1,0
16374,1,1,57434,57434,57435,0,1,0
16375,3,3,57437,57437,57440,0,3,2
16376,5,2,57442,57442,57444,0,2,2
16377,1,1,57443,57444,57445,1,2,0
16378,1,3,57444,57445,57448,1,4,0
16379,3,3,57447,57448,57451,1,4,0
16380,4,1,57451,57451,57452,0,1,0
16381,5,1,57456,57456,57457,0,1,4
16382,1,2,57457,57457,57459,0,2,0
16383,2,3,57459,57459,57462,0,3,0
16384,4,3,57463,57463,57466,0,3,1
16385,5,2,57468,57468,57470,0,2,2
16386,2,3,57470,57470,57473,0,3,0
16387,3,3,57473,57473,57476,0,3,0
16388,4,1,57477,57477,57478,0,1,1
16389,5,3,57482,57482,57485,0,3,4
16390,4,1,57486,57486,57487,0,1,1
16391,1,3,57487,57487,57490,0,3,0
16392,5,2,57492,57492,57494,0,2,2
16393,3,1,57495,57495,57496,0,1,1
16394,4,3,57499,57499,57502,0,3,3
16395,6,2,57505,57505,57507,0,2,3
16396,6,1,57511,57511,57512,0,1,4
16397,5,3,57516,57516,57519,0,3,4
16398,2,2,57518,57519,57521,1,3,0
16399,2,1,57520,57521,57522,1,2,0
16400,3,3,57523,57523,57526,0,3,1
16401,2,1,57525,57526,57527,1,2,0
16402,2,3,57527,57527,57530,0,3,0
16403,3,3,57530,57530,57533,0,3,0
16404,2,3,57532,57533,57536,1,4,0
16405,4,2,57536,57536,57538,0,2,0
16406,5,2,57541,57541,57543,0,2,3
16407,3,2,57544,57544,57546,0,2,1
16408,2,1,57546,57546,57547,0,1,0
16409,2,2,57548,57548,57550,0,2,1
16410,1,3,57549,57550,57553,1,4,0
16411,3,3,57552,57553,57556,1,4,0
16412,4,1,57556,57556,57557,0,1,0
16413,1,3,57557,57557,57560,0,3,0
16414,3,1,57560,57560,57561,0,1,0
16415,1,3,57561,57561,57564,0,3,0
16416,3,3,57564,57564,57567,0,3,0
16417,1,3,57565,57567,57570,2,5,0
16418,4,2,57569,57570,57572,1,3,0
16419,3,1,57572,57572,57573,0,1,0
16420,3,3,57575,57575,57578,0,3,2
16421,2,1,57577,57578,57579,1,2,0
16422,5,1,57582,57582,57583,0,1,3
16423,2,3,57584,57584,57587,0,3,1
16424,3,2,57587,57587,57589,0,2,0
16425,2,1,57589,57589,57590,0,1,0
16426,6,3,57595,57595,57598,0,3,5
16427,2,3,57597,57598,57601,1,4,0
16428,5,3,57602,57602,57605,0,3,1
16429,4,3,57606,57606,57609,0,3,1
16430,5,1,57611,57611,57612,0,1,2
16431,6,3,57617,57617,57620,0,3,5
16432,4,3,57621,57621,57624,0,3,1
16433,5,1,57626,57626,57627,0,1,2
16434,6,3,57632,57632,57635,0,3,5
16435,5,3,57637,57637,57640,0,3,2
16436,5,3,57642,57642,57645,0,3,2
16437,1,3,57643,57645,57648,2,5,0
16438,4,1,57647,57648,57649,1,2,0
16439,3,1,57650,57650,57651,0,1,1
16440,3,1,57653,57653,57654,0,1,2
16441,2,1,57655,57655,57656,0,1,1
16442,2,3,57657,57657,57660,0,3,1
16443,3,3,57660,57660,57663,0,3,0
16444,3,2,57663,57663,57665,0,2,0
16445,1,2,57664,57665,57667,1,3,0
16446,2,2,57666,57667,57669,1,3,0
16447,1,2,57667,57669,57671,2,4,0
16448,3,3,57670,57671,57674,1,4,0
16449,2,3,57672,57674,57677,2,5,0
16450,2,1,57674,57677,57678,3,4,0
16451,4,3,57678,57678,57681,0,3,0
16452,5,1,57683,57683,57684,0,1,2
16453,4,3,57687,57687,57690,0,3,3
16454,6,1,57693,57693,57694,0,1,3
16455,1,3,57694,57694,57697,0,3,0
16456,6,3,57700,57700,57703,0,3,3
16457,6,2,57706,57706,57708,0,2,3
16458,4,3,57710,57710,57713,0,3,2
16459,2,1,57712,57713,57714,1,2,0
16460,1,2,57713,57714,57716,1,3,0
16461,2,3,57715,57716,57719,1,4,0
16462,1,3,57716,57719,57722,3,6,0
16463,4,3,57720,57722,57725,2,5,0
16464,6,1,57726,57726,57727,0,1,1
16465,5,2,57731,57731,57733,0,2,4
16466,3,3,57734,57734,57737,0,3,1
16467,6,2,57740,57740,57742,0,2,3
16468,2,2,57742,57742,57744,0,2,0
16469,2,2,57744,57744,57746,0,2,0
16470,1,2,57745,57746,57748,1,3,0
16471,3,1,57748,57748,57749,0,1,0
16472,6,1,57754,57754,57755,0,1,5
16473,3,3,57757,57757,57760,0,3,2
16474,6,1,57763,57763,57764,0,1,3
16475,1,1,57764,57764,57765,0,1,0
16476,6,1,57770,57770,57771,0,1,5
16477,6,3,57776,57776,57779,0,3,5
16478,3,3,57779,57779,57782,0,3,0
16479,5,3,57784,57784,57787,0,3,2
16480,4,3,57788,57788,57791,0,3,1
16481,6,1,57794,57794,57795,0,1,3
16482,5,2,57799,57799,57801,0,2,4
16483,4,1,57803,57803,57804,0,1,2
16484,3,2,57806,57806,57808,0,2,2
16485,1,1,57807,57808,57809,1,2,0
16486,6,1,57813,57813,57814,0,1,4
16487,3,2,57816,57816,57818,0,2,2
16488,4,3,57820,57820,57823,0,3,2
16489,5,1,57825,57825,57826,0,1,2
16490,6,3,57831,57831,57834,0,3,5
16491,2,3,57833,57834,57837,1,4,0
16492,2,3,57835,57837,57840,2,5,0
16493,5,3,57840,57840,57843,0,3,0
16494,5,1,57845,57845,57846,0,1,2
16495,5,1,57850,57850,57851,0,1,4
16496,2,2,57852,57852,57854,0,2,1
16497,4,3,57856,57856,57859,0,3,2
16498,4,3,57860,57860,57863,0,3,1
16499,6,1,57866,57866,57867,0,1,3
16500,5,2,57871,57871,57873,0,2,4
16501,3,2,57874,57874,57876,0,2,1
16502,5,3,57879,57879,57882,0,3,3
16503,5,1,57884,57884,57885,0,1,2
16504,6,1,57890,57890,57891,0,1,5
16505,3,3,57893,57893,57896,0,3,2
16506,5,1,57898,57898,57899,0,1,2
16507,6,1,57904,57904,57905,0,1,5
16508,6,1,57910,57910,57911,0,1,5
16509,1,1,57911,57911,57912,0,1,0
16510,3,2,57914,57914,57916,0,2,2
16511,1,1,57915,57916,57917,1,2,0
16512,3,1,57918,57918,57919,0,1,1
16513,3,3,57921,57921,57924,0,3,2
16514,6,1,57927,57927,57928,0,1,3
16515,6,3,57933,57933,57936,0,3,5
16516,4,2,57937,57937,57939,0,2,1
16517,6,1,57943,57943,57944,0,1,4
16518,5,2,57948,57948,57950,0,2,4
16519,2,2,57950,57950,57952,0,2,0
16520,4,1,57954,57954,57955,0,1,2
16521,1,1,57955,57955,57956,0,1,0
16522,6,3,57961,57961,57964,0,3,5
16523,5,3,57966,57966,57969,0,3,2
16524,6,3,57972,57972,57975,0,3,3
16525,1,2,57973,57975,57977,2,4,0
16526,2,3,57975,57977,57980,2,5,0
16527,2,3,57977,57980,57983,3,6,0
16528,4,1,57981,57983,57984,2,3,0
16529,4,2,57985,57985,57987,0,2,1
16530,2,1,57987,57987,57988,0,1,0
16531,5,1,57992,57992,57993,0,1,4
16532,3,2,57995,57995,57997,0,2,2
16533,2,2,57997,57997,57999,0,2,0
16534,6,3,58003,58003,58006,0,3,4
16535,3,1,58006,58006,58007,0,1,0
16536,1,2,58007,58007,58009,0,2,0
16537,4,2,58011,58011,58013,0,2,2
16538,6,2,58017,58017,58019,0,2,4
16539,5,1,58022,58022,58023,0,1,3
16540,6,1,58028,58028,58029,0,1,5
16541,5,3,58033,58033,58036,0,3,4
16542,2,1,58035,58036,58037,1,2,0
16543,2,2,58037,58037,58039,0,2,0
16544,1,3,58038,58039,58042,1,4,0
16545,5,2,58043,58043,58045,0,2,1
16546,2,2,58045,58045,58047,0,2,0
16547,3,3,58048,58048,58051,0,3,1
16548,3,2,58051,58051,58053,0,2,0
16549,6,2,58057,58057,58059,0,2,4
16550,4,1,58061,58061,58062,0,1,2
16551,6,2,58067,58067,58069,0,2,5
16552,5,3,58072,58072,58075,0,3,3
16553,3,3,58075,58075,58078,0,3,0
16554,3,2,58078,58078,58080,0,2,0
16555,1,2,58079,58080,58082,1,3,0
16556,4,3,58083,58083,58086,0,3,1
16557,4,1,58087,58087,58088,0,1,1
16558,6,1,58093,58093,58094,0,1,5
16559,5,2,58098,58098,58100,0,2,4
16560,6,3,58104,58104,58107,0,3,4
16561,6,3,58110,58110,58113,0,3,3
16562,5,1,58115,58115,58116,0,1,2
16563,5,3,58120,58120,58123,0,3,4
16564,1,2,58121,58123,58125,2,4,0
16565,1,1,58122,58125,58126,3,4,0
16566,4,3,58126,58126,58129,0,3,0
16567,1,3,58127,58129,58132,2,5,0
16568,3,1,58130,58132,58133,2,3,0
16569,3,1,58133,58133,58134,0,1,0
16570,6,1,58139,58139,58140,0,1,5
16571,3,3,58142,58142,58145,0,3,2
16572,6,1,58148,58148,58149,0,1,3
16573,4,2,58152,58152,58154,0,2,3
16574,5,1,58157,58157,58158,0,1,3
16575,1,2,58158,58158,58160,0,2,0
16576,3,1,58161,58161,58162,0,1,1
16577,6,3,58167,58167,58170,0,3,5
16578,4,1,58171,58171,58172,0,1,1
16579,2,3,58173,58173,58176,0,3,1
16580,6,3,58179,58179,58182,0,3,3
16581,4,3,58183,58183,58186,0,3,1
16582,5,3,58188,58188,58191,0,3,2
16583,6,3,58194,58194,58197,0,3,3
16584,5,1,58199,58199,58200,0,1,2
16585,3,1,58202,58202,58203,0,1,2
16586,5,3,58207,58207,58210,0,3,4
16587,5,3,58212,58212,58215,0,3,2
16588,1,3,58213,58215,58218,2,5,0
16589,6,3,58219,58219,58222,0,3,1
16590,2,1,58221,58222,58223,1,2,0
16591,6,1,58227,58227,58228,0,1,4
16592,2,3,58229,58229,58232,0,3,1
16593,3,3,58232,58232,58235,0,3,0
16594,3,2,58235,58235,58237,0,2,0
16595,2,3,58237,58237,58240,0,3,0
16596,6,3,58243,58243,58246,0,3,3
16597,2,3,58245,58246,58249,1,4,0
16598,1,1,58246,58249,58250,3,4,0
16599,2,1,58248,58250,58251,2,3,0
16600,5,1,58253,58253,58254,0,1,2
16601,4,3,58257,58257,58260,0,3,3
16602,3,1,58260,58260,58261,0,1,0
16603,1,3,58261,58261,58264,0,3,0
16604,6,3,58267,58267,58270,0,3,3
16605,2,1,58269,58270,58271,1,2,0
16606,6,1,58275,58275,58276,0,1,4
16607,1,2,58276,58276,58278,0,2,0
16608,4,2,58280,58280,58282,0,2,2
16609,3,1,58283,58283,58284,0,1,1
16610,2,1,58285,58285,58286,0,1,1
16611,5,3,58290,58290,58293,0,3,4
16612,5,3,58295,58295,58298,0,3,2
16613,1,1,58296,58298,58299,2,3,0
16614,3,3,58299,58299,58302,0,3,0
16615,2,2,58301,58302,58304,1,3,0
16616,3,2,58304,58304,58306,0,2,0
16617,6,3,58310,58310,58313,0,3,4
16618,1,2,58311,58313,58315,2,4,0
16619,2,3,58313,58315,58318,2,5,0
16620,3,3,58316,58318,58321,2,5,0
16621,5,3,58321,58321,58324,0,3,0
16622,4,2,58325,58325,58327,0,2,1
16623,4,3,58329,58329,58332,0,3,2
16624,1,2,58330,58332,58334,2,4,0
16625,5,1,58335,58335,58336,0,1,1
16626,5,2,58340,58340,58342,0,2,4
16627,3,3,58343,58343,58346,0,3,1
16628,3,3,58346,58346,58349,0,3,0
16629,3,3,58349,58349,58352,0,3,0
16630,5,2,58354,58354,58356,0,2,2
16631,2,2,58356,58356,58358,0,2,0
16632,1,3,58357,58358,58361,1,4,0
16633,3,1,58360,58361,58362,1,2,0
16634,6,3,58366,58366,58369,0,3,4
16635,1,3,58367,58369,58372,2,5,0
16636,5,1,58372,58372,58373,0,1,0
16637,6,1,58378,58378,58379,0,1,5
16638,3,3,58381,58381,58384,0,3,2
16639,4,2,58385,58385,58387,0,2,1
16640,6,3,58391,58391,58394,0,3,4
16641,2,3,58393,58394,58397,1,4,0
16642,1,3,58394,58397,58400,3,6,0
16643,4,2,58398,58400,58402,2,4,0
16644,2,2,58400,58402,58404,2,4,0
16645,4,1,58404,58404,58405,0,1,0
16646,6,1,58410,58410,58411,0,1,5
16647,5,1,58415,58415,58416,0,1,4
16648,3,1,58418,58418,58419,0,1,2
16649,1,3,58419,58419,58422,0,3,0
16650,2,2,58421,58422,58424,1,3,0
16651,1,1,58422,58424,58425,2,3,0
16652,2,3,58424,58425,58428,1,4,0
16653,5,1,58429,58429,58430,0,1,1
16654,1,3,58430,58430,58433,0,3,0
16655,1,1,58431,58433,58434,2,3,0
16656,6,1,58437,58437,58438,0,1,3
16657,3,2,58440,58440,58442,0,2,2
16658,6,3,58446,58446,58449,0,3,4
16659,1,3,58447,58449,58452,2,5,0
16660,3,1,58450,58452,58453,2,3,0
16661,5,1,58455,58455,58456,0,1,2
16662,1,3,58456,58456,58459,0,3,0
16663,4,1,58460,58460,58461,0,1,1
16664,3,1,58463,58463,58464,0,1,2
16665,6,3,58469,58469,58472,0,3,5
16666,5,3,58474,58474,58477,0,3,2
16667,3,3,58477,58477,58480,0,3,0
16668,3,2,58480,58480,58482,0,2,0
16669,3,2,58483,58483,58485,0,2,1
16670,4,3,58487,58487,58490,0,3,2
16671,2,3,58489,58490,58493,1,4,0
16672,3,3,58492,58493,58496,1,4,0
16673,1,2,58493,58496,58498,3,5,0
16674,4,2,58497,58498,58500,1,3,0
16675,2,3,58499,58500,58503,1,4,0
16676,1,1,58500,58503,58504,3,4,0
16677,3,3,58503,58504,58507,1,4,0
16678,5,2,58508,58508,58510,0,2,1
16679,5,1,58513,58513,58514,0,1,3
16680,2,3,58515,58515,58518,0,3,1
16681,1,2,58516,58518,58520,2,4,0
16682,2,3,58518,58520,58523,2,5,0
16683,4,2,58522,58523,58525,1,3,0
16684,4,3,58526,58526,58529,0,3,1
16685,3,1,58529,58529,58530,0,1,0
16686,4,1,58533,58533,58534,0,1,3
16687,2,2,58535,58535,58537,0,2,1
16688,3,3,58538,58538,58541,0,3,1
16689,1,3,58539,58541,58544,2,5,0
16690,3,3,58542,58544,58547,2,5,0
16691,4,3,58546,58547,58550,1,4,0
16692,5,3,58551,58551,58554,0,3,1
16693,4,1,58555,58555,58556,0,1,1
16694,3,3,58558,58558,58561,0,3,2
16695,4,1,58562,58562,58563,0,1,1
16696,2,2,58564,58564,58566,0,2,1
16697,5,1,58569,58569,58570,0,1,3
16698,6,3,58575,58575,58578,0,3,5
16699,4,3,58579,58579,58582,0,3,1
16700,1,2,58580,58582,58584,2,4,0
16701,6,3,58586,58586,58589,0,3,2
16702,4,3,58590,58590,58593,0,3,1
16703,1,1,58591,58593,58594,2,3,0
16704,4,1,58595,58595,58596,0,1,1
16705,6,1,58601,58601,58602,0,1,5
16706,1,3,58602,58602,58605,0,3,0
16707,4,3,58606,58606,58609,0,3,1
16708,4,2,58610,58610,58612,0,2,1
16709,3,2,58613,58613,58615,0,2,1
16710,6,2,58619,58619,58621,0,2,4
16711,5,2,58624,58624,58626,0,2,3
16712,3,1,58627,58627,58628,0,1,1
16713,1,1,58628,58628,58629,0,1,0
16714,3,2,58631,58631,58633,0,2,2
16715,4,1,58635,58635,58636,0,1,2
16716,2,3,58637,58637,58640,0,3,1
16717,6,1,58643,58643,58644,0,1,3
16718,1,3,58644,58644,58647,0,3,0
16719,6,2,58650,58650,58652,0,2,3
16720,1,2,58651,58652,58654,1,3,0
16721,1,3,58652,58654,58657,2,5,0
16722,4,3,58656,58657,58660,1,4,0
16723,1,1,58657,58660,58661,3,4,0
16724,4,1,58661,58661,58662,0,1,0
16725,2,1,58663,58663,58664,0,1,1
16726,2,3,58665,58665,58668,0,3,1
16727,6,2,58671,58671,58673,0,2,3
16728,2,2,58673,58673,58675,0,2,0
16729,6,2,58679,58679,58681,0,2,4
16730,4,1,58683,58683,58684,0,1,2
16731,5,1,58688,58688,58689,0,1,4
16732,5,2,58693,58693,58695,0,2,4
16733,6,2,58699,58699,58701,0,2,4
16734,3,3,58702,58702,58705,0,3,1
16735,5,2,58707,58707,58709,0,2,2
16736,5,2,58712,58712,58714,0,2,3
16737,6,2,58718,58718,58720,0,2,4
16738,2,1,58720,58720,58721,0,1,0
16739,2,3,58722,58722,58725,0,3,1
16740,3,1,58725,58725,58726,0,1,0
16741,4,2,58729,58729,58731,0,2,3
16742,1,2,58730,58731,58733,1,3,0
16743,1,2,58731,58733,58735,2,4,0
16744,4,2,58735,58735,58737,0,2,0
16745,5,2,58740,58740,58742,0,2,3
16746,6,2,58746,58746,58748,0,2,4
16747,3,1,58749,58749,58750,0,1,1
16748,1,2,58750,58750,58752,0,2,0
16749,4,2,58754,58754,58756,0,2,2
16750,5,2,58759,58759,58761,0,2,3
16751,3,3,58762,58762,58765,0,3,1
16752,5,3,58767,58767,58770,0,3,2
16753,5,3,58772,58772,58775,0,3,2
16754,5,1,58777,58777,58778,0,1,2
16755,5,2,58782,58782,58784,0,2,4
16756,2,1,58784,58784,58785,0,1,0
16757,4,2,58788,58788,58790,0,2,3
16758,1,3,58789,58790,58793,1,4,0
16759,6,3,58795,58795,58798,0,3,2
16760,6,2,58801,58801,58803,0,2,3
16761,5,3,58806,58806,58809,0,3,3
16762,6,2,58812,58812,58814,0,2,3
16763,3,1,58815,58815,58816,0,1,1
16764,2,3,58817,58817,58820,0,3,1
16765,3,2,58820,58820,58822,0,2,0
16766,3,2,58823,58823,58825,0,2,1
16767,3,1,58826,58826,58827,0,1,1
16768,1,3,58827,58827,58830,0,3,0
16769,2,3,58829,58830,58833,1,4,0
16770,5,1,58834,58834,58835,0,1,1
16771,4,3,58838,58838,58841,0,3,3
16772,2,1,58840,58841,58842,1,2,0
16773,3,2,58843,58843,58845,0,2,1
16774,5,3,58848,58848,58851,0,3,3
16775,2,1,58850,58851,58852,1,2,0
16776,5,1,58855,58855,58856,0,1,3
16777,6,3,58861,58861,58864,0,3,5
16778,5,3,58866,58866,58869,0,3,2
16779,6,2,58872,58872,58874,0,2,3
16780,4,3,58876,58876,58879,0,3,2
16781,1,3,58877,58879,58882,2,5,0
16782,3,1,58880,58882,58883,2,3,0
16783,5,3,58885,58885,58888,0,3,2
16784,5,3,58890,58890,58893,0,3,2
16785,1,2,58891,58893,58895,2,4,0
16786,6,2,58897,58897,58899,0,2,2
16787,5,3,58902,58902,58905,0,3,3
16788,1,1,58903,58905,58906,2,3,0
16789,3,2,58906,58906,58908,0,2,0
16790,1,1,58907,58908,58909,1,2,0
16791,1,2,58908,58909,58911,1,3,0
16792,2,2,58910,58911,58913,1,3,0
16793,3,3,58913,58913,58916,0,3,0
16794,4,2,58917,58917,58919,0,2,1
16795,3,2,58920,58920,58922,0,2,1
16796,4,2,58924,58924,58926,0,2,2
16797,2,2,58926,58926,58928,0,2,0
16798,4,2,58930,58930,58932,0,2,2
16799,1,2,58931,58932,58934,1,3,0
16800,2,2,58933,58934,58936,1,3,0
16801,3,1,58936,58936,58937,0,1,0
16802,2,2,58938,58938,58940,0,2,1
16803,1,3,58939,58940,58943,1,4,0
16804,5,3,58944,58944,58947,0,3,1
16805,6,1,58950,58950,58951,0,1,3
16806,4,1,58954,58954,58955,0,1,3
16807,6,1,58960,58960,58961,0,1,5
16808,6,2,58966,58966,58968,0,2,5
16809,5,2,58971,58971,58973,0,2,3
16810,2,1,58973,58973,58974,0,1,0
16811,6,3,58979,58979,58982,0,3,5
16812,5,1,58984,58984,58985,0,1,2
16813,4,3,58988,58988,58991,0,3,3
16814,2,3,58990,58991,58994,1,4,0
16815,6,2,58996,58996,58998,0,2,2
16816,2,1,58998,58998,58999,0,1,0
16817,1,2,58999,58999,59001,0,2,0
16818,6,3,59005,59005,59008,0,3,4
16819,5,1,59010,59010,59011,0,1,2
16820,5,3,59015,59015,59018,0,3,4
16821,3,3,59018,59018,59021,0,3,0
16822,6,3,59024,59024,59027,0,3,3
16823,5,3,59029,59029,59032,0,3,2
16824,6,2,59035,59035,59037,0,2,3
16825,2,2,59037,59037,59039,0,2,0
16826,6,2,59043,59043,59045,0,2,4
16827,3,2,59046,59046,59048,0,2,1
16828,3,1,59049,59049,59050,0,1,1
16829,3,3,59052,59052,59055,0,3,2
16830,1,3,59053,59055,59058,2,5,0
16831,1,1,59054,59058,59059,4,5,0
16832,1,2,59055,59059,59061,4,6,0
16833,4,1,59059,59061,59062,2,3,0
16834,6,3,59065,59065,59068,0,3,3
16835,4,2,59069,59069,59071,0,2,1
16836,2,3,59071,59071,59074,0,3,0
16837,6,3,59077,59077,59080,0,3,3
16838,5,2,59082,59082,59084,0,2,2
16839,2,1,59084,59084,59085,0,1,0
16840,1,1,59085,59085,59086,0,1,0
16841,1,1,59086,59086,59087,0,1,0
16842,6,3,59092,59092,59095,0,3,5
16843,1,3,59093,59095,59098,2,5,0
16844,5,3,59098,59098,59101,0,3,0
16845,1,2,59099,59101,59103,2,4,0
16846,5,1,59104,59104,59105,0,1,1
16847,2,2,59106,59106,59108,0,2,1
16848,5,3,59111,59111,59114,0,3,3
16849,3,1,59114,59114,59115,0,1,0
16850,1,1,59115,59115,59116,0,1,0
16851,4,2,59119,59119,59121,0,2,3
16852,3,1,59122,59122,59123,0,1,1
16853,6,3,59128,59128,59131,0,3,5
16854,3,3,59131,59131,59134,0,3,0
16855,1,2,59132,59134,59136,2,4,0
16856,5,3,59137,59137,59140,0,3,1
16857,2,2,59139,59140,59142,1,3,0
16858,1,2,59140,59142,59144,2,4,0
16859,4,3,59144,59144,59147,0,3,0
16860,3,3,59147,59147,59150,0,3,0
16861,5,2,59152,59152,59154,0,2,2
16862,6,3,59158,59158,59161,0,3,4
16863,5,1,59163,59163,59164,0,1,2
16864,6,2,59169,59169,59171,0,2,5
16865,5,1,59174,59174,59175,0,1,3
16866,3,1,59177,59177,59178,0,1,2
16867,4,1,59181,59181,59182,0,1,3
16868,1,2,59182,59182,59184,0,2,0
16869,1,3,59183,59184,59187,1,4,0
16870,2,2,59185,59187,59189,2,4,0
16871,1,1,59186,59189,59190,3,4,0
16872,5,3,59191,59191,59194,0,3,1
16873,3,2,59194,59194,59196,0,2,0
16874,2,1,59196,59196,59197,0,1,0
16875,5,3,59201,59201,59204,0,3,4
16876,5,1,59206,59206,59207,0,1,2
16877,3,3,59209,59209,59212,0,3,2
16878,3,1,59212,59212,59213,0,1,0
16879,2,3,59214,59214,59217,0,3,1
16880,2,3,59216,59217,59220,1,4,0
16881,3,2,59219,59220,59222,1,3,0
16882,3,3,59222,59222,59225,0,3,0
16883,5,2,59227,59227,59229,0,2,2
16884,5,1,59232,59232,59233,0,1,3
16885,3,3,59235,59235,59238,0,3,2
16886,5,1,59240,59240,59241,0,1,2
16887,3,3,59243,59243,59246,0,3,2
16888,6,3,59249,59249,59252,0,3,3
16889,3,2,59252,59252,59254,0,2,0
16890,2,2,59254,59254,59256,0,2,0
16891,2,3,59256,59256,59259,0,3,0
16892,3,3,59259,59259,59262,0,3,0
16893,6,3,59265,59265,59268,0,3,3
16894,4,2,59269,59269,59271,0,2,1
16895,3,3,59272,59272,59275,0,3,1
16896,4,2,59276,59276,59278,0,2,1
16897,6,2,59282,59282,59284,0,2,4
16898,3,2,59285,59285,59287,0,2,1
16899,1,2,59286,59287,59289,1,3,0
16900,5,1,59291,59291,59292,0,1,2
16901,2,1,59293,59293,59294,0,1,1
16902,4,3,59297,59297,59300,0,3,3
16903,3,2,59300,59300,59302,0,2,0
16904,5,3,59305,59305,59308,0,3,3
16905,2,2,59307,59308,59310,1,3,0
16906,1,1,59308,59310,59311,2,3,0
16907,6,3,59314,59314,59317,0,3,3
16908,2,3,59316,59317,59320,1,4,0
16909,2,2,59318,59320,59322,2,4,0
16910,3,2,59321,59322,59324,1,3,0
16911,4,1,59325,59325,59326,0,1,1
16912,3,1,59328,59328,59329,0,1,2
16913,5,2,59333,59333,59335,0,2,4
16914,6,2,59339,59339,59341,0,2,4
16915,5,3,59344,59344,59347,0,3,3
16916,1,1,59345,59347,59348,2,3,0
16917,1,3,59346,59348,59351,2,5,0
16918,1,3,59347,59351,59354,4,7,0
16919,3,2,59350,59354,59356,4,6,0
16920,4,2,59354,59356,59358,2,4,0
16921,6,1,59360,59360,59361,0,1,2
16922,5,2,59365,59365,59367,0,2,4
16923,3,2,59368,59368,59370,0,2,1
16924,6,2,59374,59374,59376,0,2,4
16925,4,2,59378,59378,59380,0,2,2
16926,2,3,59380,59380,59383,0,3,0
16927,1,1,59381,59383,59384,2,3,0
16928,4,2,59385,59385,59387,0,2,1
16929,1,2,59386,59387,59389,1,3,0
16930,2,3,59388,59389,59392,1,4,0
16931,6,2,59394,59394,59396,0,2,2
16932,3,3,59397,59397,59400,0,3,1
16933,1,3,59398,59400,59403,2,5,0
16934,5,1,59403,59403,59404,0,1,0
16935,1,1,59404,59404,59405,0,1,0
16936,4,2,59408,59408,59410,0,2,3
16937,5,2,59413,59413,59415,0,2,3
16938,5,1,59418,59418,59419,0,1,3
16939,2,3,59420,59420,59423,0,3,1
16940,1,2,59421,59423,59425,2,4,0
16941,4,1,59425,59425,59426,0,1,0
16942,5,2,59430,59430,59432,0,2,4
16943,4,1,59434,59434,59435,0,1,2
16944,3,2,59437,59437,59439,0,2,2
16945,6,2,59443,59443,59445,0,2,4
16946,4,1,59447,59447,59448,0,1,2
16947,4,3,59451,59451,59454,0,3,3
16948,3,3,59454,59454,59457,0,3,0
16949,3,3,59457,59457,59460,0,3,0
16950,3,2,59460,59460,59462,0,2,0
16951,1,2,59461,59462,59464,1,3,0
16952,1,2,59462,59464,59466,2,4,0
16953,4,1,59466,59466,59467,0,1,0
16954,6,2,59472,59472,59474,0,2,5
16955,5,3,59477,59477,59480,0,3,3
16956,6,1,59483,59483,59484,0,1,3
16957,2,2,59485,59485,59487,0,2,1
16958,5,3,59490,59490,59493,0,3,3
16959,4,2,59494,59494,59496,0,2,1
16960,4,3,59498,59498,59501,0,3,2
16961,5,3,59503,59503,59506,0,3,2
16962,6,1,59509,59509,59510,0,1,3
16963,4,2,59513,59513,59515,0,2,3
16964,2,2,59515,59515,59517,0,2,0
16965,3,2,59518,59518,59520,0,2,1
16966,3,1,59521,59521,59522,0,1,1
16967,1,2,59522,59522,59524,0,2,0
16968,5,3,59527,59527,59530,0,3,3
16969,5,2,59532,59532,59534,0,2,2
16970,2,1,59534,59534,59535,0,1,0
16971,4,3,59538,59538,59541,0,3,3
16972,3,1,59541,59541,59542,0,1,0
16973,5,3,59546,59546,59549,0,3,4
16974,6,2,59552,59552,59554,0,2,3
16975,1,1,59553,59554,59555,1,2,0
16976,2,3,59555,59555,59558,0,3,0
16977,2,3,59557,59558,59561,1,4,0
16978,2,1,59559,59561,59562,2,3,0
16979,5,3,59564,59564,59567,0,3,2
16980,1,3,59565,59567,59570,2,5,0
16981,2,3,59567,59570,59573,3,6,0
16982,1,3,59568,59573,59576,5,8,0
16983,6,3,59574,59576,59579,2,5,0
16984,2,3,59576,59579,59582,3,6,0
16985,1,1,59577,59582,59583,5,6,0
16986,4,1,59581,59583,59584,2,3,0
16987,2,3,59583,59584,59587,1,4,0
16988,2,3,59585,59587,59590,2,5,0
16989,4,1,59589,59590,59591,1,2,0
16990,1,1,59590,59591,59592,1,2,0
16991,6,3,59596,59596,59599,0,3,4
16992,2,2,59598,59599,59601,1,3,0
16993,4,1,59602,59602,59603,0,1,1
16994,5,3,59607,59607,59610,0,3,4
16995,5,3,59612,59612,59615,0,3,2
16996,2,2,59614,59615,59617,1,3,0
16997,1,3,59615,59617,59620,2,5,0
16998,3,2,59618,59620,59622,2,4,0
16999,4,2,59622,59622,59624,0,2,0
17000,6,2,59628,59628,59630,0,2,4
17001,5,1,59633,59633,59634,0,1,3
17002,5,1,59638,59638,59639,0,1,4
17003,2,3,59640,59640,59643,0,3,1
17004,6,1,59646,59646,59647,0,1,3
17005,2,3,59648,59648,59651,0,3,1
17006,2,2,59650,59651,59653,1,3,0
17007,5,2,59655,59655,59657,0,2,2
17008,6,2,59661,59661,59663,0,2,4
17009,6,2,59667,59667,59669,0,2,4
17010,2,1,59669,59669,59670,0,1,0
17011,1,3,59670,59670,59673,0,3,0
17012,6,2,59676,59676,59678,0,2,3
17013,6,2,59682,59682,59684,0,2,4
17014,6,2,59688,59688,59690,0,2,4
17015,1,2,59689,59690,59692,1,3,0
17016,5,2,59694,59694,59696,0,2,2
17017,6,2,59700,59700,59702,0,2,4
17018,5,3,59705,59705,59708,0,3,3
17019,1,3,59706,59708,59711,2,5,0
17020,4,1,59710,59711,59712,1,2,0
17021,2,2,59712,59712,59714,0,2,0
17022,6,1,59718,59718,59719,0,1,4
17023,1,3,59719,59719,59722,0,3,0
17024,4,1,59723,59723,59724,0,1,1
17025,1,1,59724,59724,59725,0,1,0
17026,3,1,59727,59727,59728,0,1,2
17027,4,1,59731,59731,59732,0,1,3
17028,6,2,59737,59737,59739,0,2,5
17029,2,3,59739,59739,59742,0,3,0
17030,5,2,59744,59744,59746,0,2,2
17031,3,3,59747,59747,59750,0,3,1
17032,4,1,59751,59751,59752,0,1,1
17033,1,3,59752,59752,59755,0,3,0
17034,5,3,59757,59757,59760,0,3,2
17035,4,2,59761,59761,59763,0,2,1
17036,5,2,59766,59766,59768,0,2,3
17037,4,1,59770,59770,59771,0,1,2
17038,3,3,59773,59773,59776,0,3,2
17039,3,2,59776,59776,59778,0,2,0
17040,3,1,59779,59779,59780,0,1,1
17041,1,2,59780,59780,59782,0,2,0
17042,6,1,59786,59786,59787,0,1,4
17043,1,3,59787,59787,59790,0,3,0
17044,5,2,59792,59792,59794,0,2,2
17045,2,1,59794,59794,59795,0,1,0
17046,1,1,59795,59795,59796,0,1,0
17047,2,3,59797,59797,59800,0,3,1
17048,5,2,59802,59802,59804,0,2,2
17049,3,2,59805,59805,59807,0,2,1
17050,3,3,59808,59808,59811,0,3,1
17051,6,3,59814,59814,59817,0,3,3
17052,4,2,59818,59818,59820,0,2,1
17053,1,1,59819,59820,59821,1,2,0
17054,3,1,59822,59822,59823,0,1,1
17055,1,1,59823,59823,59824,0,1,0
17056,2,1,59825,59825,59826,0,1,1
17057,6,2,59831,59831,59833,0,2,5
17058,3,2,59834,59834,59836,0,2,1
17059,4,2,59838,59838,59840,0,2,2
17060,4,2,59842,59842,59844,0,2,2
17061,5,2,59847,59847,59849,0,2,3
17062,6,2,59853,59853,59855,0,2,4
17063,1,3,59854,59855,59858,1,4,0
17064,5,2,59859,59859,59861,0,2,1
17065,2,3,59861,59861,59864,0,3,0
17066,2,1,59863,59864,59865,1,2,0
17067,3,1,59866,59866,59867,0,1,1
17068,2,2,59868,59868,59870,0,2,1
17069,3,1,59871,59871,59872,0,1,1
17070,2,2,59873,59873,59875,0,2,1
17071,6,2,59879,59879,59881,0,2,4
17072,5,1,59884,59884,59885,0,1,3
17073,2,1,59886,59886,59887,0,1,1
17074,4,2,59890,59890,59892,0,2,3
17075,4,1,59894,59894,59895,0,1,2
17076,2,3,59896,59896,59899,0,3,1
17077,6,3,59902,59902,59905,0,3,3
17078,6,3,59908,59908,59911,0,3,3
17079,3,2,59911,59911,59913,0,2,0
17080,3,1,59914,59914,59915,0,1,1
17081,1,1,59915,59915,59916,0,1,0
17082,5,1,59920,59920,59921,0,1,4
17083,1,3,59921,59921,59924,0,3,0
17084,6,2,59927,59927,59929,0,2,3
17085,2,1,59929,59929,59930,0,1,0
17086,1,1,59930,59930,59931,0,1,0
17087,3,3,59933,59933,59936,0,3,2
17088,2,1,59935,59936,59937,1,2,0
17089,4,1,59939,59939,59940,0,1,2
17090,3,1,59942,59942,59943,0,1,2
17091,6,3,59948,59948,59951,0,3,5
17092,4,3,59952,59952,59955,0,3,1
17093,3,3,59955,59955,59958,0,3,0
17094,1,1,59956,59958,59959,2,3,0
17095,3,2,59959,59959,59961,0,2,0
17096,6,1,59965,59965,59966,0,1,4
17097,5,1,59970,59970,59971,0,1,4
17098,6,1,59976,59976,59977,0,1,5
17099,6,1,59982,59982,59983,0,1,5
17100,3,1,59985,59985,59986,0,1,2
17101,4,3,59989,59989,59992,0,3,3
17102,6,1,59995,59995,59996,0,1,3
17103,4,1,59999,59999,60000,0,1,3
17104,2,3,60001,60001,60004,0,3,1
17105,3,1,60004,60004,60005,0,1,0
17106,6,3,60010,60010,60013,0,3,5
17107,4,1,60014,60014,60015,0,1,1
17108,4,3,60018,60018,60021,0,3,3
17109,6,1,60024,60024,60025,0,1,3
17110,3,3,60027,60027,60030,0,3,2
17111,5,2,60032,60032,60034,0,2,2
17112,5,2,60037,60037,60039,0,2,3
17113,1,2,60038,60039,60041,1,3,0
17114,2,3,60040,60041,60044,1,4,0
17115,6,3,60046,60046,60049,0,3,2
17116,5,3,60051,60051,60054,0,3,2
17117,1,2,60052,60054,60056,2,4,0
17118,1,2,60053,60056,60058,3,5,0
17119,6,1,60059,60059,60060,0,1,1
17120,6,1,60065,60065,60066,0,1,5
17121,1,1,60066,60066,60067,0,1,0
17122,5,2,60071,60071,60073,0,2,4
17123,3,3,60074,60074,60077,0,3,1
17124,4,2,60078,60078,60080,0,2,1
17125,5,2,60083,60083,60085,0,2,3
17126,4,2,60087,60087,60089,0,2,2
17127,1,3,60088,60089,60092,1,4,0
17128,6,1,60094,60094,60095,0,1,2
17129,4,1,60098,60098,60099,0,1,3
17130,1,1,60099,60099,60100,0,1,0
17131,3,1,60102,60102,60103,0,1,2
17132,3,3,60105,60105,60108,0,3,2
17133,5,2,60110,60110,60112,0,2,2
17134,3,3,60113,60113,60116,0,3,1
17135,3,2,60116,60116,60118,0,2,0
17136,4,3,60120,60120,60123,0,3,2
17137,3,2,60123,60123,60125,0,2,0
17138,2,2,60125,60125,60127,0,2,0
17139,1,2,60126,60127,60129,1,3,0
17140,1,3,60127,60129,60132,2,5,0
17141,4,3,60131,60132,60135,1,4,0
17142,2,2,60133,60135,60137,2,4,0
17143,1,2,60134,60137,60139,3,5,0
17144,3,2,60137,60139,60141,2,4,0
17145,6,2,60143,60143,60145,0,2,2
17146,2,1,60145,60145,60146,0,1,0
17147,4,1,60149,60149,60150,0,1,3
17148,1,3,60150,60150,60153,0,3,0
17149,6,2,60156,60156,60158,0,2,3
17150,6,1,60162,60162,60163,0,1,4
17151,1,3,60163,60163,60166,0,3,0
17152,3,1,60166,60166,60167,0,1,0
17153,4,3,60170,60170,60173,0,3,3
17154,2,1,60172,60173,60174,1,2,0
17155,4,3,60176,60176,60179,0,3,2
17156,6,3,60182,60182,60185,0,3,3
17157,5,2,60187,60187,60189,0,2,2
17158,4,3,60191,60191,60194,0,3,2
17159,3,3,60194,60194,60197,0,3,0
17160,3,1,60197,60197,60198,0,1,0
17161,4,1,60201,60201,60202,0,1,3
17162,6,3,60207,60207,60210,0,3,5
17163,6,1,60213,60213,60214,0,1,3
17164,2,2,60215,60215,60217,0,2,1
17165,6,3,60221,60221,60224,0,3,4
17166,3,3,60224,60224,60227,0,3,0
17167,1,1,60225,60227,60228,2,3,0
17168,2,2,60227,60228,60230,1,3,0
17169,2,1,60229,60230,60231,1,2,0
17170,5,2,60234,60234,60236,0,2,3
17171,2,1,60236,60236,60237,0,1,0
17172,4,2,60240,60240,60242,0,2,3
17173,2,1,60242,60242,60243,0,1,0
17174,1,1,60243,60243,60244,0,1,0
17175,6,3,60249,60249,60252,0,3,5
17176,6,2,60255,60255,60257,0,2,3
17177,1,3,60256,60257,60260,1,4,0
17178,5,3,60261,60261,60264,0,3,1
17179,6,2,60267,60267,60269,0,2,3
17180,2,1,60269,60269,60270,0,1,0
17181,1,3,60270,60270,60273,0,3,0
17182,2,1,60272,60273,60274,1,2,0
17183,1,1,60273,60274,60275,1,2,0
17184,1,3,60274,60275,60278,1,4,0
17185,6,3,60280,60280,60283,0,3,2
17186,6,1,60286,60286,60287,0,1,3
17187,5,3,60291,60291,60294,0,3,4
17188,5,3,60296,60296,60299,0,3,2
17189,1,1,60297,60299,60300,2,3,0
17190,1,1,60298,60300,60301,2,3,0
17191,4,2,60302,60302,60304,0,2,1
17192,5,1,60307,60307,60308,0,1,3
17193,5,3,60312,60312,60315,0,3,4
17194,6,2,60318,60318,60320,0,2,3
17195,4,2,60322,60322,60324,0,2,2
17196,4,1,60326,60326,60327,0,1,2
17197,6,3,60332,60332,60335,0,3,5
17198,4,1,60336,60336,60337,0,1,1
17199,3,3,60339,60339,60342,0,3,2
17200,3,2,60342,60342,60344,0,2,0
17201,4,1,60346,60346,60347,0,1,2
17202,2,2,60348,60348,60350,0,2,1
17203,4,3,60352,60352,60355,0,3,2
17204,1,3,60353,60355,60358,2,5,0
17205,1,3,60354,60358,60361,4,7,0
17206,6,2,60360,60361,60363,1,3,0
17207,3,2,60363,60363,60365,0,2,0
17208,5,3,60368,60368,60371,0,3,3
17209,1,1,60369,60371,60372,2,3,0
17210,5,2,60374,60374,60376,0,2,2
17211,3,3,60377,60377,60380,0,3,1
17212,5,2,60382,60382,60384,0,2,2
17213,4,3,60386,60386,60389,0,3,2
17214,2,1,60388,60389,60390,1,2,0
17215,2,3,60390,60390,60393,0,3,0
17216,2,1,60392,60393,60394,1,2,0
17217,1,3,60393,60394,60397,1,4,0
17218,3,2,60396,60397,60399,1,3,0
17219,2,1,60398,60399,60400,1,2,0
17220,3,1,60401,60401,60402,0,1,1
17221,5,2,60406,60406,60408,0,2,4
17222,6,2,60412,60412,60414,0,2,4
17223,2,3,60414,60414,60417,0,3,0
17224,3,2,60417,60417,60419,0,2,0
17225,4,3,60421,60421,60424,0,3,2
17226,4,2,60425,60425,60427,0,2,1
17227,3,1,60428,60428,60429,0,1,1
17228,2,1,60430,60430,60431,0,1,1
17229,3,2,60433,60433,60435,0,2,2
17230,5,1,60438,60438,60439,0,1,3
17231,3,1,60441,60441,60442,0,1,2
17232,3,2,60444,60444,60446,0,2,2
17233,3,1,60447,60447,60448,0,1,1
17234,3,1,60450,60450,60451,0,1,2
17235,6,1,60456,60456,60457,0,1,5
17236,3,3,60459,60459,60462,0,3,2
17237,1,1,60460,60462,60463,2,3,0
17238,4,2,60464,60464,60466,0,2,1
17239,1,3,60465,60466,60469,1,4,0
17240,1,3,60466,60469,60472,3,6,0
17241,3,1,60469,60472,60473,3,4,0
17242,3,3,60472,60473,60476,1,4,0
17243,5,1,60477,60477,60478,0,1,1
17244,6,3,60483,60483,60486,0,3,5
17245,4,1,60487,60487,60488,0,1,1
17246,3,3,60490,60490,60493,0,3,2
17247,6,3,60496,60496,60499,0,3,3
17248,1,1,60497,60499,60500,2,3,0
17249,5,2,60502,60502,60504,0,2,2
17250,4,1,60506,60506,60507,0,1,2
17251,4,1,60510,60510,60511,0,1,3
17252,4,1,60514,60514,60515,0,1,3
17253,3,2,60517,60517,60519,0,2,2
17254,6,3,60523,60523,60526,0,3,4
17255,2,3,60525,60526,60529,1,4,0
17256,4,3,60529,60529,60532,0,3,0
17257,5,2,60534,60534,60536,0,2,2
17258,1,1,60535,60536,60537,1,2,0
17259,2,2,60537,60537,60539,0,2,0
17260,3,2,60540,60540,60542,0,2,1
17261,6,3,60546,60546,60549,0,3,4
17262,4,1,60550,60550,60551,0,1,1
17263,5,2,60555,60555,60557,0,2,4
17264,3,3,60558,60558,60561,0,3,1
17265,5,2,60563,60563,60565,0,2,2
17266,4,1,60567,60567,60568,0,1,2
17267,3,3,60570,60570,60573,0,3,2
17268,5,2,60575,60575,60577,0,2,2
17269,3,2,60578,60578,60580,0,2,1
17270,2,1,60580,60580,60581,0,1,0
17271,5,3,60585,60585,60588,0,3,4
17272,6,1,60591,60591,60592,0,1,3
17273,3,2,60594,60594,60596,0,2,2
17274,6,3,60600,60600,60603,0,3,4
17275,3,2,60603,60603,60605,0,2,0
17276,6,1,60609,60609,60610,0,1,4
17277,3,1,60612,60612,60613,0,1,2
17278,5,2,60617,60617,60619,0,2,4
17279,2,2,60619,60619,60621,0,2,0
17280,5,1,60624,60624,60625,0,1,3
17281,1,1,60625,60625,60626,0,1,0
17282,2,2,60627,60627,60629,0,2,1
17283,2,2,60629,60629,60631,0,2,0
17284,5,3,60634,60634,60637,0,3,3
17285,6,3,60640,60640,60643,0,3,3
17286,2,1,60642,60643,60644,1,2,0
17287,2,1,60644,60644,60645,0,1,0
17288,3,2,60647,60647,60649,0,2,2
17289,3,3,60650,60650,60653,0,3,1
17290,5,2,60655,60655,60657,0,2,2
17291,4,3,60659,60659,60662,0,3,2
17292,5,1,60664,60664,60665,0,1,2
17293,2,3,60666,60666,60669,0,3,1
17294,5,2,60671,60671,60673,0,2,2
17295,6,1,60677,60677,60678,0,1,4
17296,2,1,60679,60679,60680,0,1,1
17297,3,2,60682,60682,60684,0,2,2
17298,2,2,60684,60684,60686,0,2,0
17299,1,1,60685,60686,60687,1,2,0
17300,2,2,60687,60687,60689,0,2,0
17301,6,1,60693,60693,60694,0,1,4
17302,2,1,60695,60695,60696,0,1,1
17303,3,1,60698,60698,60699,0,1,2
17304,2,1,60700,60700,60701,0,1,1
17305,6,3,60706,60706,60709,0,3,5
17306,2,1,60708,60709,60710,1,2,0
17307,1,1,60709,60710,60711,1,2,0
17308,3,2,60712,60712,60714,0,2,1
17309,4,2,60716,60716,60718,0,2,2
17310,3,2,60719,60719,60721,0,2,1
17311,1,1,60720,60721,60722,1,2,0
17312,1,1,60721,60722,60723,1,2,0
17313,1,3,60722,60723,60726,1,4,0
17314,6,1,60728,60728,60729,0,1,2
17315,6,3,60734,60734,60737,0,3,5
17316,1,1,60735,60737,60738,2,3,0
17317,4,2,60739,60739,60741,0,2,1
17318,6,2,60745,60745,60747,0,2,4
17319,5,1,60750,60750,60751,0,1,3
17320,5,2,60755,60755,60757,0,2,4
17321,2,3,60757,60757,60760,0,3,0
17322,5,2,60762,60762,60764,0,2,2
17323,4,3,60766,60766,60769,0,3,2
17324,2,2,60768,60769,60771,1,3,0
17325,5,3,60773,60773,60776,0,3,2
17326,6,1,60779,60779,60780,0,1,3
17327,1,2,60780,60780,60782,0,2,0
17328,6,2,60786,60786,60788,0,2,4
17329,2,2,60788,60788,60790,0,2,0
17330,2,1,60790,60790,60791,0,1,0
17331,2,2,60792,60792,60794,0,2,1
17332,5,3,60797,60797,60800,0,3,3
17333,4,1,60801,60801,60802,0,1,1
17334,5,3,60806,60806,60809,0,3,4
17335,4,3,60810,60810,60813,0,3,1
17336,3,1,60813,60813,60814,0,1,0
17337,6,3,60819,60819,60822,0,3,5
17338,5,3,60824,60824,60827,0,3,2
17339,1,1,60825,60827,60828,2,3,0
17340,2,1,60827,60828,60829,1,2,0
17341,2,1,60829,60829,60830,0,1,0
17342,2,3,60831,60831,60834,0,3,1
17343,3,3,60834,60834,60837,0,3,0
17344,3,1,60837,60837,60838,0,1,0
17345,6,2,60843,60843,60845,0,2,5
17346,4,3,60847,60847,60850,0,3,2
17347,4,3,60851,60851,60854,0,3,1
17348,1,2,60852,60854,60856,2,4,0
17349,5,3,60857,60857,60860,0,3,1
17350,3,1,60860,60860,60861,0,1,0
17351,6,2,60866,60866,60868,0,2,5
17352,2,3,60868,60868,60871,0,3,0
17353,6,2,60874,60874,60876,0,2,3
17354,5,1,60879,60879,60880,0,1,3
17355,5,1,60884,60884,60885,0,1,4
17356,6,2,60890,60890,60892,0,2,5
17357,6,2,60896,60896,60898,0,2,4
17358,5,2,60901,60901,60903,0,2,3
17359,5,1,60906,60906,60907,0,1,3
17360,6,1,60912,60912,60913,0,1,5
17361,4,2,60916,60916,60918,0,2,3
17362,3,3,60919,60919,60922,0,3,1
17363,3,2,60922,60922,60924,0,2,0
17364,5,1,60927,60927,60928,0,1,3
17365,3,2,60930,60930,60932,0,2,2
17366,1,1,60931,60932,60933,1,2,0
17367,6,2,60937,60937,60939,0,2,4
17368,6,1,60943,60943,60944,0,1,4
17369,4,3,60947,60947,60950,0,3,3
17370,1,1,60948,60950,60951,2,3,0
17371,4,3,60952,60952,60955,0,3,1
17372,4,1,60956,60956,60957,0,1,1
17373,2,1,60958,60958,60959,0,1,1
17374,1,1,60959,60959,60960,0,1,0
17375,2,1,60961,60961,60962,0,1,1
17376,4,3,60965,60965,60968,0,3,3
17377,4,3,60969,60969,60972,0,3,1
17378,6,3,60975,60975,60978,0,3,3
17379,3,1,60978,60978,60979,0,1,0
17380,6,1,60984,60984,60985,0,1,5
17381,6,2,60990,60990,60992,0,2,5
17382,4,2,60994,60994,60996,0,2,2
17383,3,2,60997,60997,60999,0,2,1
17384,4,2,61001,61001,61003,0,2,2
17385,1,3,61002,61003,61006,1,4,0
17386,4,3,61006,61006,61009,0,3,0
17387,5,3,61011,61011,61014,0,3,2
17388,2,1,61013,61014,61015,1,2,0
17389,3,3,61016,61016,61019,0,3,1
17390,5,1,61021,61021,61022,0,1,2
17391,6,1,61027,61027,61028,0,1,5
17392,1,3,61028,61028,61031,0,3,0
17393,4,2,61032,61032,61034,0,2,1
17394,5,1,61037,61037,61038,0,1,3
17395,3,2,61040,61040,61042,0,2,2
17396,3,1,61043,61043,61044,0,1,1
17397,3,2,61046,61046,61048,0,2,2
17398,5,1,61051,61051,61052,0,1,3
17399,6,1,61057,61057,61058,0,1,5
17400,2,2,61059,61059,61061,0,2,1
17401,6,1,61065,61065,61066,0,1,4
17402,3,3,61068,61068,61071,0,3,2
17403,1,3,61069,61071,61074,2,5,0
17404,6,2,61075,61075,61077,0,2,1
17405,3,2,61078,61078,61080,0,2,1
17406,5,3,61083,61083,61086,0,3,3
17407,6,2,61089,61089,61091,0,2,3
17408,1,1,61090,61091,61092,1,2,0
17409,4,3,61094,61094,61097,0,3,2
17410,5,3,61099,61099,61102,0,3,2
17411,2,2,61101,61102,61104,1,3,0
17412,4,2,61105,61105,61107,0,2,1
17413,5,2,61110,61110,61112,0,2,3
17414,3,1,61113,61113,61114,0,1,1
17415,5,1,61118,61118,61119,0,1,4
17416,6,2,61124,61124,61126,0,2,5
17417,2,1,61126,61126,61127,0,1,0
17418,6,1,61132,61132,61133,0,1,5
17419,2,3,61134,61134,61137,0,3,1
17420,1,2,61135,61137,61139,2,4,0
17421,3,2,61138,61139,61141,1,3,0
17422,3,1,61141,61141,61142,0,1,0
17423,2,1,61143,61143,61144,0,1,1
17424,3,3,61146,61146,61149,0,3,2
17425,5,2,61151,61151,61153,0,2,2
17426,3,2,61154,61154,61156,0,2,1
17427,3,1,61157,61157,61158,0,1,1
17428,5,2,61162,61162,61164,0,2,4
17429,6,2,61168,61168,61170,0,2,4
17430,6,2,61174,61174,61176,0,2,4
17431,3,1,61177,61177,61178,0,1,1
17432,1,2,61178,61178,61180,0,2,0
17433,5,2,61183,61183,61185,0,2,3
17434,3,3,61186,61186,61189,0,3,1
17435,4,2,61190,61190,61192,0,2,1
17436,6,3,61196,61196,61199,0,3,4
17437,3,1,61199,61199,61200,0,1,0
17438,4,2,61203,61203,61205,0,2,3
17439,4,1,61207,61207,61208,0,1,2
17440,2,1,61209,61209,61210,0,1,1
17441,5,1,61214,61214,61215,0,1,4
17442,3,2,61217,61217,61219,0,2,2
17443,3,2,61220,61220,61222,0,2,1
17444,2,1,61222,61222,61223,0,1,0
17445,2,1,61224,61224,61225,0,1,1
17446,5,1,61229,61229,61230,0,1,4
17447,3,1,61232,61232,61233,0,1,2
17448,4,2,61236,61236,61238,0,2,3
17449,3,2,61239,61239,61241,0,2,1
17450,3,2,61242,61242,61244,0,2,1
17451,5,2,61247,61247,61249,0,2,3
17452,2,1,61249,61249,61250,0,1,0
17453,4,3,61253,61253,61256,0,3,3
17454,6,3,61259,61259,61262,0,3,3
17455,5,1,61264,61264,61265,0,1,2
17456,6,2,61270,61270,61272,0,2,5
17457,6,2,61276,61276,61278,0,2,4
17458,4,3,61280,61280,61283,0,3,2
17459,2,1,61282,61283,61284,1,2,0
17460,1,1,61283,61284,61285,1,2,0
17461,5,2,61288,61288,61290,0,2,3
17462,1,1,61289,61290,61291,1,2,0
17463,1,1,61290,61291,61292,1,2,0
17464,3,3,61293,61293,61296,0,3,1
17465,6,3,61299,61299,61302,0,3,3
17466,5,2,61304,61304,61306,0,2,2
17467,2,2,61306,61306,61308,0,2,0
17468,3,1,61309,61309,61310,0,1,1
17469,4,1,61313,61313,61314,0,1,3
17470,3,3,61316,61316,61319,0,3,2
17471,1,2,61317,61319,61321,2,4,0
17472,4,3,61321,61321,61324,0,3,0
17473,4,2,61325,61325,61327,0,2,1
17474,1,1,61326,61327,61328,1,2,0
17475,3,3,61329,61329,61332,0,3,1
17476,1,3,61330,61332,61335,2,5,0
17477,6,2,61336,61336,61338,0,2,1
17478,6,3,61342,61342,61345,0,3,4
17479,3,2,61345,61345,61347,0,2,0
17480,6,1,61351,61351,61352,0,1,4
17481,3,3,61354,61354,61357,0,3,2
17482,1,3,61355,61357,61360,2,5,0
17483,2,3,61357,61360,61363,3,6,0
17484,5,3,61362,61363,61366,1,4,0
17485,6,2,61368,61368,61370,0,2,2
17486,2,3,61370,61370,61373,0,3,0
17487,3,2,61373,61373,61375,0,2,0
17488,3,2,61376,61376,61378,0,2,1
17489,4,1,61380,61380,61381,0,1,2
17490,2,1,61382,61382,61383,0,1,1
17491,6,3,61388,61388,61391,0,3,5
17492,2,3,61390,61391,61394,1,4,0
17493,5,2,61395,61395,61397,0,2,1
17494,6,3,61401,61401,61404,0,3,4
17495,2,1,61403,61404,61405,1,2,0
17496,5,1,61408,61408,61409,0,1,3
17497,5,1,61413,61413,61414,0,1,4
17498,4,2,61417,61417,61419,0,2,3
17499,6,2,61423,61423,61425,0,2,4
17500,6,3,61429,61429,61432,0,3,4
17501,5,1,61434,61434,61435,0,1,2
17502,2,3,61436,61436,61439,0,3,1
17503,2,3,61438,61439,61442,1,4,0
17504,2,3,61440,61442,61445,2,5,0
17505,3,2,61443,61445,61447,2,4,0
17506,5,2,61448,61448,61450,0,2,1
17507,4,3,61452,61452,61455,0,3,2
17508,4,3,61456,61456,61459,0,3,1
17509,2,2,61458,61459,61461,1,3,0
17510,4,2,61462,61462,61464,0,2,1
17511,5,1,61467,61467,61468,0,1,3
17512,3,2,61470,61470,61472,0,2,2
17513,4,1,61474,61474,61475,0,1,2
17514,6,2,61480,61480,61482,0,2,5
17515,1,2,61481,61482,61484,1,3,0
17516,6,1,61487,61487,61488,0,1,3
17517,2,2,61489,61489,61491,0,2,1
17518,1,2,61490,61491,61493,1,3,0
17519,4,3,61494,61494,61497,0,3,1
17520,6,2,61500,61500,61502,0,2,3
17521,1,2,61501,61502,61504,1,3,0
17522,3,3,61504,61504,61507,0,3,0
17523,6,1,61510,61510,61511,0,1,3
17524,6,2,61516,61516,61518,0,2,5
17525,2,3,61518,61518,61521,0,3,0
17526,6,3,61524,61524,61527,0,3,3
17527,2,2,61526,61527,61529,1,3,0
17528,4,2,61530,61530,61532,0,2,1
17529,1,3,61531,61532,61535,1,4,0
17530,5,3,61536,61536,61539,0,3,1
17531,1,1,61537,61539,61540,2,3,0
17532,6,1,61543,61543,61544,0,1,3
17533,2,2,61545,61545,61547,0,2,1
17534,6,1,61551,61551,61552,0,1,4
17535,1,1,61552,61552,61553,0,1,0
17536,1,2,61553,61553,61555,0,2,0
17537,4,1,61557,61557,61558,0,1,2
17538,1,3,61558,61558,61561,0,3,0
17539,5,1,61563,61563,61564,0,1,2
17540,2,2,61565,61565,61567,0,2,1
17541,6,3,61571,61571,61574,0,3,4
17542,4,2,61575,61575,61577,0,2,1
17543,1,1,61576,61577,61578,1,2,0
17544,2,1,61578,61578,61579,0,1,0
17545,6,1,61584,61584,61585,0,1,5
17546,6,3,61590,61590,61593,0,3,5
17547,1,1,61591,61593,61594,2,3,0
17548,1,2,61592,61594,61596,2,4,0
17549,6,2,61598,61598,61600,0,2,2
17550,1,3,61599,61600,61603,1,4,0
17551,1,3,61600,61603,61606,3,6,0
17552,4,2,61604,61606,61608,2,4,0
17553,1,2,61605,61608,61610,3,5,0
17554,5,1,61610,61610,61611,0,1,0
17555,6,2,61616,61616,61618,0,2,5
17556,6,3,61622,61622,61625,0,3,4
17557,6,3,61628,61628,61631,0,3,3
17558,4,3,61632,61632,61635,0,3,1
17559,2,3,61634,61635,61638,1,4,0
17560,1,2,61635,61638,61640,3,5,0
17561,3,2,61638,61640,61642,2,4,0
17562,4,3,61642,61642,61645,0,3,0
17563,6,3,61648,61648,61651,0,3,3
17564,6,2,61654,61654,61656,0,2,3
17565,6,3,61660,61660,61663,0,3,4
17566,3,3,61663,61663,61666,0,3,0
17567,4,2,61667,61667,61669,0,2,1
17568,2,2,61669,61669,61671,0,2,0
17569,4,2,61673,61673,61675,0,2,2
17570,2,2,61675,61675,61677,0,2,0
17571,6,3,61681,61681,61684,0,3,4
17572,2,3,61683,61684,61687,1,4,0
17573,3,1,61686,61687,61688,1,2,0
17574,4,3,61690,61690,61693,0,3,2
17575,2,2,61692,61693,61695,1,3,0
17576,2,2,61694,61695,61697,1,3,0
17577,2,2,61696,61697,61699,1,3,0
17578,4,3,61700,61700,61703,0,3,1
17579,1,2,61701,61703,61705,2,4,0
17580,4,3,61705,61705,61708,0,3,0
17581,6,3,61711,61711,61714,0,3,3
17582,4,2,61715,61715,61717,0,2,1
17583,5,2,61720,61720,61722,0,2,3
17584,1,1,61721,61722,61723,1,2,0
17585,3,3,61724,61724,61727,0,3,1
17586,5,2,61729,61729,61731,0,2,2
17587,1,2,61730,61731,61733,1,3,0
17588,3,2,61733,61733,61735,0,2,0
17589,6,3,61739,61739,61742,0,3,4
17590,4,1,61743,61743,61744,0,1,1
17591,2,2,61745,61745,61747,0,2,1
17592,6,2,61751,61751,61753,0,2,4
17593,1,3,61752,61753,61756,1,4,0
17594,5,1,61757,61757,61758,0,1,1
17595,4,2,61761,61761,61763,0,2,3
17596,6,3,61767,61767,61770,0,3,4
17597,2,3,61769,61770,61773,1,4,0
17598,2,1,61771,61773,61774,2,3,0
17599,2,2,61773,61774,61776,1,3,0
17600,4,3,61777,61777,61780,0,3,1
17601,3,1,61780,61780,61781,0,1,0
17602,4,3,61784,61784,61787,0,3,3
17603,5,1,61789,61789,61790,0,1,2
17604,2,1,61791,61791,61792,0,1,1
17605,5,2,61796,61796,61798,0,2,4
17606,2,3,61798,61798,61801,0,3,0
17607,3,3,61801,61801,61804,0,3,0
17608,6,1,61807,61807,61808,0,1,3
17609,6,2,61813,61813,61815,0,2,5
17610,4,3,61817,61817,61820,0,3,2
17611,2,2,61819,61820,61822,1,3,0
17612,4,1,61823,61823,61824,0,1,1
17613,3,3,61826,61826,61829,0,3,2
17614,1,1,61827,61829,61830,2,3,0
17615,5,3,61832,61832,61835,0,3,2
17616,2,2,61834,61835,61837,1,3,0
17617,3,1,61837,61837,61838,0,1,0
17618,1,1,61838,61838,61839,0,1,0
17619,3,1,61841,61841,61842,0,1,2
17620,4,3,61845,61845,61848,0,3,3
17621,1,2,61846,61848,61850,2,4,0
17622,4,3,61850,61850,61853,0,3,0
17623,2,2,61852,61853,61855,1,3,0
17624,4,2,61856,61856,61858,0,2,1
17625,1,3,61857,61858,61861,1,4,0
17626,1,2,61858,61861,61863,3,5,0
17627,2,2,61860,61863,61865,3,5,0
17628,5,1,61865,61865,61866,0,1,0
17629,3,2,61868,61868,61870,0,2,2
17630,3,3,61871,61871,61874,0,3,1
17631,3,2,61874,61874,61876,0,2,0
17632,6,3,61880,61880,61883,0,3,4
17633,1,3,61881,61883,61886,2,5,0
17634,3,3,61884,61886,61889,2,5,0
17635,3,2,61887,61889,61891,2,4,0
17636,1,2,61888,61891,61893,3,5,0
17637,2,2,61890,61893,61895,3,5,0
17638,2,1,61892,61895,61896,3,4,0
17639,4,3,61896,61896,61899,0,3,0
17640,6,3,61902,61902,61905,0,3,3
17641,1,1,61903,61905,61906,2,3,0
17642,5,3,61908,61908,61911,0,3,2
17643,1,3,61909,61911,61914,2,5,0
17644,3,3,61912,61914,61917,2,5,0
17645,1,1,61913,61917,61918,4,5,0
17646,6,3,61919,61919,61922,0,3,1
17647,5,2,61924,61924,61926,0,2,2
17648,3,1,61927,61927,61928,0,1,1
17649,1,3,61928,61928,61931,0,3,0
17650,1,2,61929,61931,61933,2,4,0
17651,6,1,61935,61935,61936,0,1,2
17652,1,2,61936,61936,61938,0,2,0
17653,3,3,61939,61939,61942,0,3,1
17654,6,2,61945,61945,61947,0,2,3
17655,1,1,61946,61947,61948,1,2,0
17656,6,2,61952,61952,61954,0,2,4
17657,1,2,61953,61954,61956,1,3,0
17658,3,1,61956,61956,61957,0,1,0
17659,5,3,61961,61961,61964,0,3,4
17660,2,3,61963,61964,61967,1,4,0
17661,2,2,61965,61967,61969,2,4,0
17662,4,3,61969,61969,61972,0,3,0
17663,5,2,61974,61974,61976,0,2,2
17664,5,2,61979,61979,61981,0,2,3
17665,3,2,61982,61982,61984,0,2,1
17666,3,3,61985,61985,61988,0,3,1
17667,2,1,61987,61988,61989,1,2,0
17668,1,3,61988,61989,61992,1,4,0
17669,5,3,61993,61993,61996,0,3,1
17670,2,3,61995,61996,61999,1,4,0
17671,6,1,62001,62001,62002,0,1,2
17672,4,1,62005,62005,62006,0,1,3
17673,6,1,62011,62011,62012,0,1,5
17674,1,2,62012,62012,62014,0,2,0
17675,5,1,62017,62017,62018,0,1,3
17676,6,2,62023,62023,62025,0,2,5
17677,3,3,62026,62026,62029,0,3,1
17678,2,3,62028,62029,62032,1,4,0
17679,3,2,62031,62032,62034,1,3,0
17680,1,3,62032,62034,62037,2,5,0
17681,1,3,62033,62037,62040,4,7,0
17682,3,3,62036,62040,62043,4,7,0
17683,2,2,62038,62043,62045,5,7,0
17684,2,1,62040,62045,62046,5,6,0
17685,2,1,62042,62046,62047,4,5,0
17686,3,3,62045,62047,62050,2,5,0
17687,2,1,62047,62050,62051,3,4,0
17688,5,3,62052,62052,62055,0,3,1
17689,3,1,62055,62055,62056,0,1,0
17690,6,2,62061,62061,62063,0,2,5
17691,3,2,62064,62064,62066,0,2,1
17692,6,3,62070,62070,62073,0,3,4
17693,2,1,62072,62073,62074,1,2,0
17694,6,1,62078,62078,62079,0,1,4
17695,6,1,62084,62084,62085,0,1,5
17696,4,2,62088,62088,62090,0,2,3
17697,2,2,62090,62090,62092,0,2,0
17698,2,1,62092,62092,62093,0,1,0
17699,5,3,62097,62097,62100,0,3,4
17700,4,1,62101,62101,62102,0,1,1
17701,1,1,62102,62102,62103,0,1,0
17702,3,2,62105,62105,62107,0,2,2
17703,6,2,62111,62111,62113,0,2,4
17704,5,3,62116,62116,62119,0,3,3
17705,4,1,62120,62120,62121,0,1,1
17706,4,1,62124,62124,62125,0,1,3
17707,4,1,62128,62128,62129,0,1,3
17708,6,2,62134,62134,62136,0,2,5
17709,4,3,62138,62138,62141,0,3,2
17710,3,1,62141,62141,62142,0,1,0
17711,1,2,62142,62142,62144,0,2,0
17712,6,3,62148,62148,62151,0,3,4
17713,5,1,62153,62153,62154,0,1,2
17714,3,1,62156,62156,62157,0,1,2
17715,4,2,62160,62160,62162,0,2,3
17716,5,3,62165,62165,62168,0,3,3
17717,1,2,62166,62168,62170,2,4,0
17718,5,2,62171,62171,62173,0,2,1
17719,6,1,62177,62177,62178,0,1,4
17720,6,3,62183,62183,62186,0,3,5
17721,4,2,62187,62187,62189,0,2,1
17722,5,2,62192,62192,62194,0,2,3
17723,1,1,62193,62194,62195,1,2,0
17724,6,3,62199,62199,62202,0,3,4
17725,6,1,62205,62205,62206,0,1,3
17726,6,3,62211,62211,62214,0,3,5
17727,3,2,62214,62214,62216,0,2,0
17728,1,2,62215,62216,62218,1,3,0
17729,2,1,62217,62218,62219,1,2,0
17730,6,1,62223,62223,62224,0,1,4
17731,5,2,62228,62228,62230,0,2,4
17732,4,3,62232,62232,62235,0,3,2
17733,6,3,62238,62238,62241,0,3,3
17734,5,2,62243,62243,62245,0,2,2
17735,6,3,62249,62249,62252,0,3,4
17736,1,3,62250,62252,62255,2,5,0
17737,6,3,62256,62256,62259,0,3,1
17738,5,2,62261,62261,62263,0,2,2
17739,1,2,62262,62263,62265,1,3,0
17740,4,1,62266,62266,62267,0,1,1
17741,5,3,62271,62271,62274,0,3,4
17742,5,2,62276,62276,62278,0,2,2
17743,2,3,62278,62278,62281,0,3,0
17744,6,3,62284,62284,62287,0,3,3
17745,6,1,62290,62290,62291,0,1,3
17746,4,2,62294,62294,62296,0,2,3
17747,6,1,62300,62300,62301,0,1,4
17748,2,2,62302,62302,62304,0,2,1
17749,2,2,62304,62304,62306,0,2,0
17750,3,2,62307,62307,62309,0,2,1
17751,4,1,62311,62311,62312,0,1,2
17752,3,1,62314,62314,62315,0,1,2
17753,3,3,62317,62317,62320,0,3,2
17754,5,3,62322,62322,62325,0,3,2
17755,2,1,62324,62325,62326,1,2,0
17756,5,3,62329,62329,62332,0,3,3
17757,6,2,62335,62335,62337,0,2,3
17758,6,2,62341,62341,62343,0,2,4
17759,6,2,62347,62347,62349,0,2,4
17760,5,1,62352,62352,62353,0,1,3
17761,2,1,62354,62354,62355,0,1,1
17762,6,1,62360,62360,62361,0,1,5
17763,1,1,62361,62361,62362,0,1,0
17764,5,1,62366,62366,62367,0,1,4
17765,3,1,62369,62369,62370,0,1,2
17766,3,1,62372,62372,62373,0,1,2
17767,6,1,62378,62378,62379,0,1,5
17768,6,2,62384,62384,62386,0,2,5
17769,1,1,62385,62386,62387,1,2,0
17770,4,3,62389,62389,62392,0,3,2
17771,3,2,62392,62392,62394,0,2,0
17772,1,3,62393,62394,62397,1,4,0
17773,2,3,62395,62397,62400,2,5,0
17774,4,1,62399,62400,62401,1,2,0
17775,4,2,62403,62403,62405,0,2,2
17776,5,1,62408,62408,62409,0,1,3
17777,2,2,62410,62410,62412,0,2,1
17778,1,2,62411,62412,62414,1,3,0
17779,5,1,62416,62416,62417,0,1,2
17780,3,3,62419,62419,62422,0,3,2
17781,3,1,62422,62422,62423,0,1,0
17782,3,1,62425,62425,62426,0,1,2
17783,4,2,62429,62429,62431,0,2,3
17784,6,3,62435,62435,62438,0,3,4
17785,4,3,62439,62439,62442,0,3,1
17786,3,1,62442,62442,62443,0,1,0
17787,2,1,62444,62444,62445,0,1,1
17788,6,1,62450,62450,62451,0,1,5
17789,6,3,62456,62456,62459,0,3,5
17790,3,1,62459,62459,62460,0,1,0
17791,1,1,62460,62460,62461,0,1,0
17792,3,1,62463,62463,62464,0,1,2
17793,5,1,62468,62468,62469,0,1,4
17794,6,1,62474,62474,62475,0,1,5
17795,5,2,62479,62479,62481,0,2,4
17796,6,3,62485,62485,62488,0,3,4
17797,5,2,62490,62490,62492,0,2,2
17798,5,3,62495,62495,62498,0,3,3
17799,5,2,62500,62500,62502,0,2,2
17800,6,2,62506,62506,62508,0,2,4
17801,2,1,62508,62508,62509,0,1,0
17802,2,3,62510,62510,62513,0,3,1
17803,2,3,62512,62513,62516,1,4,0
17804,2,3,62514,62516,62519,2,5,0
17805,4,1,62518,62519,62520,1,2,0
17806,1,3,62519,62520,62523,1,4,0
17807,2,1,62521,62523,62524,2,3,0
17808,4,2,62525,62525,62527,0,2,1
17809,1,1,62526,62527,62528,1,2,0
17810,1,3,62527,62528,62531,1,4,0
17811,5,2,62532,62532,62534,0,2,1
17812,6,2,62538,62538,62540,0,2,4
17813,5,3,62543,62543,62546,0,3,3
17814,1,3,62544,62546,62549,2,5,0
17815,5,2,62549,62549,62551,0,2,0
17816,3,1,62552,62552,62553,0,1,1
17817,1,2,62553,62553,62555,0,2,0
17818,1,2,62554,62555,62557,1,3,0
17819,5,1,62559,62559,62560,0,1,2
17820,2,1,62561,62561,62562,0,1,1
17821,4,3,62565,62565,62568,0,3,3
17822,2,2,62567,62568,62570,1,3,0
17823,4,1,62571,62571,62572,0,1,1
17824,6,2,62577,62577,62579,0,2,5
17825,1,1,62578,62579,62580,1,2,0
17826,6,2,62584,62584,62586,0,2,4
17827,2,3,62586,62586,62589,0,3,0
17828,3,2,62589,62589,62591,0,2,0
17829,6,3,62595,62595,62598,0,3,4
17830,2,2,62597,62598,62600,1,3,0
17831,5,2,62602,62602,62604,0,2,2
17832,4,2,62606,62606,62608,0,2,2
17833,3,2,62609,62609,62611,0,2,1
17834,5,2,62614,62614,62616,0,2,3
17835,2,3,62616,62616,62619,0,3,0
17836,4,1,62620,62620,62621,0,1,1
17837,3,1,62623,62623,62624,0,1,2
17838,1,3,62624,62624,62627,0,3,0
17839,6,3,62630,62630,62633,0,3,3
17840,5,1,62635,62635,62636,0,1,2
17841,2,3,62637,62637,62640,0,3,1
17842,5,2,62642,62642,62644,0,2,2
17843,6,2,62648,62648,62650,0,2,4
17844,1,2,62649,62650,62652,1,3,0
17845,6,1,62655,62655,62656,0,1,3
17846,5,2,62660,62660,62662,0,2,4
17847,2,1,62662,62662,62663,0,1,0
17848,2,1,62664,62664,62665,0,1,1
17849,3,2,62667,62667,62669,0,2,2
17850,2,1,62669,62669,62670,0,1,0
17851,4,2,62673,62673,62675,0,2,3
17852,2,1,62675,62675,62676,0,1,0
17853,6,3,62681,62681,62684,0,3,5
17854,5,3,62686,62686,62689,0,3,2
17855,6,2,62692,62692,62694,0,2,3
17856,5,1,62697,62697,62698,0,1,3
17857,3,3,62700,62700,62703,0,3,2
17858,5,3,62705,62705,62708,0,3,2
17859,2,2,62707,62708,62710,1,3,0
17860,3,3,62710,62710,62713,0,3,0
17861,4,3,62714,62714,62717,0,3,1
17862,1,2,62715,62717,62719,2,4,0
17863,4,3,62719,62719,62722,0,3,0
17864,2,2,62721,62722,62724,1,3,0
17865,2,1,62723,62724,62725,1,2,0
17866,4,2,62727,62727,62729,0,2,2
17867,5,3,62732,62732,62735,0,3,3
17868,1,3,62733,62735,62738,2,5,0
17869,2,1,62735,62738,62739,3,4,0
17870,3,3,62738,62739,62742,1,4,0
17871,1,3,62739,62742,62745,3,6,0
17872,6,1,62745,62745,62746,0,1,0
17873,6,3,62751,62751,62754,0,3,5
17874,5,2,62756,62756,62758,0,2,2
17875,1,3,62757,62758,62761,1,4,0
17876,1,1,62758,62761,62762,3,4,0
17877,1,3,62759,62762,62765,3,6,0
17878,6,3,62765,62765,62768,0,3,0
17879,5,3,62770,62770,62773,0,3,2
17880,4,3,62774,62774,62777,0,3,1
17881,3,2,62777,62777,62779,0,2,0
17882,4,2,62781,62781,62783,0,2,2
17883,1,3,62782,62783,62786,1,4,0
17884,5,2,62787,62787,62789,0,2,1
17885,5,1,62792,62792,62793,0,1,3
17886,5,2,62797,62797,62799,0,2,4
17887,4,1,62801,62801,62802,0,1,2
17888,4,2,62805,62805,62807,0,2,3
17889,6,1,62811,62811,62812,0,1,4
17890,6,1,62817,62817,62818,0,1,5
17891,1,1,62818,62818,62819,0,1,0
17892,3,3,62821,62821,62824,0,3,2
17893,2,3,62823,62824,62827,1,4,0
17894,2,1,62825,62827,62828,2,3,0
17895,6,1,62831,62831,62832,0,1,3
17896,2,1,62833,62833,62834,0,1,1
17897,5,1,62838,62838,62839,0,1,4
17898,3,2,62841,62841,62843,0,2,2
17899,2,3,62843,62843,62846,0,3,0
17900,4,1,62847,62847,62848,0,1,1
17901,2,2,62849,62849,62851,0,2,1
17902,6,2,62855,62855,62857,0,2,4
17903,3,2,62858,62858,62860,0,2,1
17904,5,3,62863,62863,62866,0,3,3
17905,5,1,62868,62868,62869,0,1,2
17906,3,1,62871,62871,62872,0,1,2
17907,4,1,62875,62875,62876,0,1,3
17908,4,1,62879,62879,62880,0,1,3
17909,5,1,62884,62884,62885,0,1,4
17910,5,2,62889,62889,62891,0,2,4
17911,2,3,62891,62891,62894,0,3,0
17912,1,2,62892,62894,62896,2,4,0
17913,3,1,62895,62896,62897,1,2,0
17914,6,3,62901,62901,62904,0,3,4
17915,2,1,62903,62904,62905,1,2,0
17916,2,1,62905,62905,62906,0,1,0
17917,1,1,62906,62906,62907,0,1,0
17918,1,3,62907,62907,62910,0,3,0
17919,2,1,62909,62910,62911,1,2,0
17920,3,1,62912,62912,62913,0,1,1
17921,5,3,62917,62917,62920,0,3,4
17922,6,1,62923,62923,62924,0,1,3
17923,5,2,62928,62928,62930,0,2,4
17924,5,2,62933,62933,62935,0,2,3
17925,2,1,62935,62935,62936,0,1,0
17926,2,1,62937,62937,62938,0,1,1
17927,2,1,62939,62939,62940,0,1,1
17928,5,1,62944,62944,62945,0,1,4
17929,2,2,62946,62946,62948,0,2,1
17930,2,2,62948,62948,62950,0,2,0
17931,1,1,62949,62950,62951,1,2,0
17932,3,3,62952,62952,62955,0,3,1
17933,4,1,62956,62956,62957,0,1,1
17934,4,3,62960,62960,62963,0,3,3
17935,1,2,62961,62963,62965,2,4,0
17936,2,2,62963,62965,62967,2,4,0
17937,6,1,62969,62969,62970,0,1,2
17938,4,2,62973,62973,62975,0,2,3
17939,4,3,62977,62977,62980,0,3,2
17940,2,3,62979,62980,62983,1,4,0
17941,3,1,62982,62983,62984,1,2,0
17942,5,1,62987,62987,62988,0,1,3
17943,3,1,62990,62990,62991,0,1,2
17944,1,2,62991,62991,62993,0,2,0
17945,1,2,62992,62993,62995,1,3,0
17946,1,3,62993,62995,62998,2,5,0
17947,1,2,62994,62998,63000,4,6,0
17948,1,3,62995,63000,63003,5,8,0
17949,4,2,62999,63003,63005,4,6,0
17950,5,1,63004,63005,63006,1,2,0
17951,2,1,63006,63006,63007,0,1,0
17952,6,2,63012,63012,63014,0,2,5
17953,1,3,63013,63014,63017,1,4,0
17954,2,1,63015,63017,63018,2,3,0
17955,6,1,63021,63021,63022,0,1,3
17956,6,3,63027,63027,63030,0,3,5
17957,2,2,63029,63030,63032,1,3,0
17958,4,3,63033,63033,63036,0,3,1
17959,1,2,63034,63036,63038,2,4,0
17960,2,2,63036,63038,63040,2,4,0
17961,6,2,63042,63042,63044,0,2,2
17962,3,2,63045,63045,63047,0,2,1
17963,3,1,63048,63048,63049,0,1,1
17964,6,2,63054,63054,63056,0,2,5
17965,6,2,63060,63060,63062,0,2,4
17966,5,2,63065,63065,63067,0,2,3
17967,1,2,63066,63067,63069,1,3,0
17968,6,3,63072,63072,63075,0,3,3
17969,5,3,63077,63077,63080,0,3,2
17970,4,2,63081,63081,63083,0,2,1
17971,5,3,63086,63086,63089,0,3,3
17972,5,3,63091,63091,63094,0,3,2
17973,5,2,63096,63096,63098,0,2,2
17974,1,3,63097,63098,63101,1,4,0
17975,4,2,63101,63101,63103,0,2,0
17976,3,2,63104,63104,63106,0,2,1
17977,6,3,63110,63110,63113,0,3,4
17978,5,2,63115,63115,63117,0,2,2
17979,2,3,63117,63117,63120,0,3,0
17980,1,3,63118,63120,63123,2,5,0
17981,4,1,63122,63123,63124,1,2,0
17982,4,1,63126,63126,63127,0,1,2
17983,6,2,63132,63132,63134,0,2,5
17984,3,3,63135,63135,63138,0,3,1
17985,6,3,63141,63141,63144,0,3,3
17986,5,1,63146,63146,63147,0,1,2
17987,5,3,63151,63151,63154,0,3,4
17988,4,1,63155,63155,63156,0,1,1
17989,2,3,63157,63157,63160,0,3,1
17990,1,2,63158,63160,63162,2,4,0
17991,6,3,63164,63164,63167,0,3,2
17992,5,2,63169,63169,63171,0,2,2
17993,4,3,63173,63173,63176,0,3,2
17994,2,2,63175,63176,63178,1,3,0
17995,5,3,63180,63180,63183,0,3,2
17996,5,2,63185,63185,63187,0,2,2
17997,2,1,63187,63187,63188,0,1,0
17998,1,3,63188,63188,63191,0,3,0
17999,2,1,63190,63191,63192,1,2,0
18000,5,3,63195,63195,63198,0,3,3
18001,4,1,63199,63199,63200,0,1,1
18002,2,2,63201,63201,63203,0,2,1
18003,6,3,63207,63207,63210,0,3,4
18004,4,3,63211,63211,63214,0,3,1
18005,1,2,63212,63214,63216,2,4,0
18006,3,1,63215,63216,63217,1,2,0
18007,1,3,63216,63217,63220,1,4,0
18008,2,2,63218,63220,63222,2,4,0
18009,3,1,63221,63222,63223,1,2,0
18010,6,1,63227,63227,63228,0,1,4
18011,1,3,63228,63228,63231,0,3,0
18012,6,1,63234,63234,63235,0,1,3
18013,3,1,63237,63237,63238,0,1,2
18014,6,1,63243,63243,63244,0,1,5
18015,5,1,63248,63248,63249,0,1,4
18016,1,3,63249,63249,63252,0,3,0
18017,5,1,63254,63254,63255,0,1,2
18018,2,2,63256,63256,63258,0,2,1
18019,4,3,63260,63260,63263,0,3,2
18020,2,1,63262,63263,63264,1,2,0
18021,6,2,63268,63268,63270,0,2,4
18022,1,2,63269,63270,63272,1,3,0
18023,6,2,63275,63275,63277,0,2,3
18024,2,3,63277,63277,63280,0,3,0
18025,4,1,63281,63281,63282,0,1,1
18026,5,3,63286,63286,63289,0,3,4
18027,5,2,63291,63291,63293,0,2,2
18028,4,2,63295,63295,63297,0,2,2
18029,4,2,63299,63299,63301,0,2,2
18030,3,1,63302,63302,63303,0,1,1
18031,3,3,63305,63305,63308,0,3,2
18032,5,2,63310,63310,63312,0,2,2
18033,1,3,63311,63312,63315,1,4,0
18034,5,1,63316,63316,63317,0,1,1
18035,3,1,63319,63319,63320,0,1,2
18036,2,2,63321,63321,63323,0,2,1
18037,1,3,63322,63323,63326,1,4,0
18038,6,1,63328,63328,63329,0,1,2
18039,3,3,63331,63331,63334,0,3,2
18040,1,1,63332,63334,63335,2,3,0
18041,1,2,63333,63335,63337,2,4,0
18042,5,1,63338,63338,63339,0,1,1
18043,5,1,63343,63343,63344,0,1,4
18044,6,1,63349,63349,63350,0,1,5
18045,3,1,63352,63352,63353,0,1,2
18046,3,1,63355,63355,63356,0,1,2
18047,3,3,63358,63358,63361,0,3,2
18048,5,1,63363,63363,63364,0,1,2
18049,3,1,63366,63366,63367,0,1,2
18050,1,1,63367,63367,63368,0,1,0
18051,2,3,63369,63369,63372,0,3,1
18052,3,2,63372,63372,63374,0,2,0
18053,3,1,63375,63375,63376,0,1,1
18054,2,3,63377,63377,63380,0,3,1
18055,2,1,63379,63380,63381,1,2,0
18056,4,2,63383,63383,63385,0,2,2
18057,2,1,63385,63385,63386,0,1,0
18058,6,3,63391,63391,63394,0,3,5
18059,1,2,63392,63394,63396,2,4,0
18060,6,1,63398,63398,63399,0,1,2
18061,4,1,63402,63402,63403,0,1,3
18062,4,2,63406,63406,63408,0,2,3
18063,1,1,63407,63408,63409,1,2,0
18064,5,2,63412,63412,63414,0,2,3
18065,2,2,63414,63414,63416,0,2,0
18066,4,1,63418,63418,63419,0,1,2
18067,4,3,63422,63422,63425,0,3,3
18068,3,2,63425,63425,63427,0,2,0
18069,4,3,63429,63429,63432,0,3,2
18070,2,2,63431,63432,63434,1,3,0
18071,1,3,63432,63434,63437,2,5,0
18072,1,2,63433,63437,63439,4,6,0
18073,1,3,63434,63439,63442,5,8,0
18074,2,3,63436,63442,63445,6,9,0
18075,1,1,63437,63445,63446,8,9,0
18076,4,2,63441,63446,63448,5,7,0
18077,3,3,63444,63448,63451,4,7,0
18078,2,3,63446,63451,63454,5,8,0
18079,3,2,63449,63454,63456,5,7,0
18080,4,3,63453,63456,63459,3,6,0
18081,6,2,63459,63459,63461,0,2,0
18082,6,1,63465,63465,63466,0,1,4
18083,2,3,63467,63467,63470,0,3,1
18084,5,3,63472,63472,63475,0,3,2
18085,1,2,63473,63475,63477,2,4,0
18086,1,1,63474,63477,63478,3,4,0
18087,1,3,63475,63478,63481,3,6,0
18088,6,3,63481,63481,63484,0,3,0
18089,1,3,63482,63484,63487,2,5,0
18090,2,2,63484,63487,63489,3,5,0
18091,6,1,63490,63490,63491,0,1,1
18092,2,1,63492,63492,63493,0,1,1
18093,2,2,63494,63494,63496,0,2,1
18094,4,2,63498,63498,63500,0,2,2
18095,4,3,63502,63502,63505,0,3,2
18096,3,2,63505,63505,63507,0,2,0
18097,2,1,63507,63507,63508,0,1,0
18098,2,3,63509,63509,63512,0,3,1
18099,3,3,63512,63512,63515,0,3,0
18100,3,3,63515,63515,63518,0,3,0
18101,1,2,63516,63518,63520,2,4,0
18102,2,3,63518,63520,63523,2,5,0
18103,3,1,63521,63523,63524,2,3,0
18104,2,2,63523,63524,63526,1,3,0
18105,4,3,63527,63527,63530,0,3,1
18106,1,2,63528,63530,63532,2,4,0
18107,6,1,63534,63534,63535,0,1,2
18108,6,2,63540,63540,63542,0,2,5
18109,3,3,63543,63543,63546,0,3,1
18110,1,3,63544,63546,63549,2,5,0
18111,1,3,63545,63549,63552,4,7,0
18112,6,1,63551,63552,63553,1,2,0
18113,2,3,63553,63553,63556,0,3,0
18114,2,3,63555,63556,63559,1,4,0
18115,6,3,63561,63561,63564,0,3,2
18116,3,1,63564,63564,63565,0,1,0
18117,1,2,63565,63565,63567,0,2,0
18118,2,3,63567,63567,63570,0,3,0
18119,5,1,63572,63572,63573,0,1,2
18120,1,1,63573,63573,63574,0,1,0
18121,5,3,63578,63578,63581,0,3,4
18122,2,3,63580,63581,63584,1,4,0
18123,2,1,63582,63584,63585,2,3,0
18124,3,3,63585,63585,63588,0,3,0
18125,5,2,63590,63590,63592,0,2,2
18126,3,2,63593,63593,63595,0,2,1
18127,5,1,63598,63598,63599,0,1,3
18128,1,1,63599,63599,63600,0,1,0
18129,4,2,63603,63603,63605,0,2,3
18130,4,1,63607,63607,63608,0,1,2
18131,6,2,63613,63613,63615,0,2,5
18132,4,3,63617,63617,63620,0,3,2
18133,3,2,63620,63620,63622,0,2,0
18134,5,2,63625,63625,63627,0,2,3
18135,6,1,63631,63631,63632,0,1,4
18136,2,3,63633,63633,63636,0,3,1
18137,1,1,63634,63636,63637,2,3,0
18138,6,2,63640,63640,63642,0,2,3
18139,2,1,63642,63642,63643,0,1,0
18140,4,3,63646,63646,63649,0,3,3
18141,3,2,63649,63649,63651,0,2,0
18142,4,3,63653,63653,63656,0,3,2
18143,4,2,63657,63657,63659,0,2,1
18144,2,2,63659,63659,63661,0,2,0
18145,6,2,63665,63665,63667,0,2,4
18146,6,1,63671,63671,63672,0,1,4
18147,2,2,63673,63673,63675,0,2,1
18148,2,1,63675,63675,63676,0,1,0
18149,5,3,63680,63680,63683,0,3,4
18150,2,3,63682,63683,63686,1,4,0
18151,1,1,63683,63686,63687,3,4,0
18152,3,1,63686,63687,63688,1,2,0
18153,1,3,63687,63688,63691,1,4,0
18154,6,3,63693,63693,63696,0,3,2
18155,2,3,63695,63696,63699,1,4,0
18156,5,2,63700,63700,63702,0,2,1
18157,1,2,63701,63702,63704,1,3,0
18158,2,2,63703,63704,63706,1,3,0
18159,1,3,63704,63706,63709,2,5,0
18160,6,3,63710,63710,63713,0,3,1
18161,3,1,63713,63713,63714,0,1,0
18162,3,3,63716,63716,63719,0,3,2
18163,3,3,63719,63719,63722,0,3,0
18164,2,2,63721,63722,63724,1,3,0
18165,6,1,63727,63727,63728,0,1,3
18166,4,3,63731,63731,63734,0,3,3
18167,6,1,63737,63737,63738,0,1,3
18168,3,3,63740,63740,63743,0,3,2
18169,1,2,63741,63743,63745,2,4,0
18170,1,1,63742,63745,63746,3,4,0
18171,2,3,63744,63746,63749,2,5,0
18172,6,2,63750,63750,63752,0,2,1
18173,6,2,63756,63756,63758,0,2,4
18174,4,1,63760,63760,63761,0,1,2
18175,4,2,63764,63764,63766,0,2,3
18176,6,1,63770,63770,63771,0,1,4
18177,3,3,63773,63773,63776,0,3,2
18178,6,3,63779,63779,63782,0,3,3
18179,3,1,63782,63782,63783,0,1,0
18180,5,3,63787,63787,63790,0,3,4
18181,1,2,63788,63790,63792,2,4,0
18182,2,2,63790,63792,63794,2,4,0
18183,6,2,63796,63796,63798,0,2,2
18184,4,1,63800,63800,63801,0,1,2
18185,6,2,63806,63806,63808,0,2,5
18186,3,1,63809,63809,63810,0,1,1
18187,5,1,63814,63814,63815,0,1,4
18188,4,2,63818,63818,63820,0,2,3
18189,1,1,63819,63820,63821,1,2,0
18190,4,3,63823,63823,63826,0,3,2
18191,1,3,63824,63826,63829,2,5,0
18192,1,2,63825,63829,63831,4,6,0
18193,6,2,63831,63831,63833,0,2,0
18194,4,2,63835,63835,63837,0,2,2
18195,3,3,63838,63838,63841,0,3,1
18196,1,1,63839,63841,63842,2,3,0
18197,3,1,63842,63842,63843,0,1,0
18198,3,2,63845,63845,63847,0,2,2
18199,2,1,63847,63847,63848,0,1,0
18200,3,2,63850,63850,63852,0,2,2
18201,3,1,63853,63853,63854,0,1,1
18202,4,3,63857,63857,63860,0,3,3
18203,2,2,63859,63860,63862,1,3,0
18204,3,2,63862,63862,63864,0,2,0
18205,1,3,63863,63864,63867,1,4,0
18206,2,1,63865,63867,63868,2,3,0
18207,1,2,63866,63868,63870,2,4,0
18208,1,2,63867,63870,63872,3,5,0
18209,3,3,63870,63872,63875,2,5,0
18210,4,3,63874,63875,63878,1,4,0
18211,6,1,63880,63880,63881,0,1,2
18212,2,1,63882,63882,63883,0,1,1
18213,5,2,63887,63887,63889,0,2,4
18214,5,3,63892,63892,63895,0,3,3
18215,4,3,63896,63896,63899,0,3,1
18216,6,2,63902,63902,63904,0,2,3
18217,4,2,63906,63906,63908,0,2,2
18218,3,3,63909,63909,63912,0,3,1
18219,5,1,63914,63914,63915,0,1,2
18220,5,1,63919,63919,63920,0,1,4
18221,2,1,63921,63921,63922,0,1,1
18222,1,1,63922,63922,63923,0,1,0
18223,2,1,63924,63924,63925,0,1,1
18224,2,2,63926,63926,63928,0,2,1
18225,1,1,63927,63928,63929,1,2,0
18226,5,3,63932,63932,63935,0,3,3
18227,4,1,63936,63936,63937,0,1,1
18228,2,1,63938,63938,63939,0,1,1
18229,1,1,63939,63939,63940,0,1,0
18230,4,2,63943,63943,63945,0,2,3
18231,1,1,63944,63945,63946,1,2,0
18232,5,1,63949,63949,63950,0,1,3
18233,1,3,63950,63950,63953,0,3,0
18234,4,3,63954,63954,63957,0,3,1
18235,2,1,63956,63957,63958,1,2,0
18236,3,1,63959,63959,63960,0,1,1
18237,5,1,63964,63964,63965,0,1,4
18238,4,2,63968,63968,63970,0,2,3
18239,6,1,63974,63974,63975,0,1,4
18240,2,2,63976,63976,63978,0,2,1
18241,4,3,63980,63980,63983,0,3,2
18242,2,3,63982,63983,63986,1,4,0
18243,6,1,63988,63988,63989,0,1,2
18244,2,1,63990,63990,63991,0,1,1
18245,3,1,63993,63993,63994,0,1,2
18246,2,2,63995,63995,63997,0,2,1
18247,5,3,64000,64000,64003,0,3,3
18248,2,1,64002,64003,64004,1,2,0
18249,3,1,64005,64005,64006,0,1,1
18250,2,3,64007,64007,64010,0,3,1
18251,1,1,64008,64010,64011,2,3,0
18252,2,3,64010,64011,64014,1,4,0
18253,1,3,64011,64014,64017,3,6,0
18254,3,3,64014,64017,64020,3,6,0
18255,5,2,64019,64020,64022,1,3,0
18256,1,3,64020,64022,64025,2,5,0
18257,6,3,64026,64026,64029,0,3,1
18258,2,1,64028,64029,64030,1,2,0
18259,6,2,64034,64034,64036,0,2,4
18260,1,2,64035,64036,64038,1,3,0
18261,3,1,64038,64038,64039,0,1,0
18262,2,2,64040,64040,64042,0,2,1
18263,1,2,64041,64042,64044,1,3,0
18264,2,1,64043,64044,64045,1,2,0
18265,6,1,64049,64049,64050,0,1,4
18266,6,3,64055,64055,64058,0,3,5
18267,1,3,64056,64058,64061,2,5,0
18268,2,1,64058,64061,64062,3,4,0
18269,3,1,64061,64062,64063,1,2,0
18270,3,2,64064,64064,64066,0,2,1
18271,1,3,64065,64066,64069,1,4,0
18272,2,3,64067,64069,64072,2,5,0
18273,1,3,64068,64072,64075,4,7,0
18274,5,3,64073,64075,64078,2,5,0
18275,4,2,64077,64078,64080,1,3,0
18276,2,2,64079,64080,64082,1,3,0
18277,2,3,64081,64082,64085,1,4,0
18278,6,2,64087,64087,64089,0,2,2
18279,2,2,64089,64089,64091,0,2,0
18280,5,1,64094,64094,64095,0,1,3
18281,3,1,64097,64097,64098,0,1,2
18282,3,1,64100,64100,64101,0,1,2
18283,2,1,64102,64102,64103,0,1,1
18284,2,1,64104,64104,64105,0,1,1
18285,2,2,64106,64106,64108,0,2,1
18286,6,3,64112,64112,64115,0,3,4
18287,5,3,64117,64117,64120,0,3,2
18288,5,1,64122,64122,64123,0,1,2
18289,2,3,64124,64124,64127,0,3,1
18290,6,2,64130,64130,64132,0,2,3
18291,3,1,64133,64133,64134,0,1,1
18292,6,2,64139,64139,64141,0,2,5
18293,3,2,64142,64142,64144,0,2,1
18294,2,1,64144,64144,64145,0,1,0
18295,6,3,64150,64150,64153,0,3,5
18296,6,3,64156,64156,64159,0,3,3
18297,1,1,64157,64159,64160,2,3,0
18298,4,3,64161,64161,64164,0,3,1
18299,3,1,64164,64164,64165,0,1,0
18300,1,2,64165,64165,64167,0,2,0
18301,3,2,64168,64168,64170,0,2,1
18302,3,2,64171,64171,64173,0,2,1
18303,2,1,64173,64173,64174,0,1,0
18304,6,3,64179,64179,64182,0,3,5
18305,2,3,64181,64182,64185,1,4,0
18306,5,2,64186,64186,64188,0,2,1
18307,2,2,64188,64188,64190,0,2,0
18308,6,2,64194,64194,64196,0,2,4
18309,6,1,64200,64200,64201,0,1,4
18310,6,3,64206,64206,64209,0,3,5
18311,6,1,64212,64212,64213,0,1,3
18312,3,3,64215,64215,64218,0,3,2
18313,1,2,64216,64218,64220,2,4,0
18314,6,1,64222,64222,64223,0,1,2
18315,1,2,64223,64223,64225,0,2,0
18316,3,1,64226,64226,64227,0,1,1
18317,1,2,64227,64227,64229,0,2,0
18318,3,2,64230,64230,64232,0,2,1
18319,3,3,64233,64233,64236,0,3,1
18320,4,1,64237,64237,64238,0,1,1
18321,3,1,64240,64240,64241,0,1,2
18322,3,3,64243,64243,64246,0,3,2
18323,2,3,64245,64246,64249,1,4,0
18324,6,2,64251,64251,64253,0,2,2
18325,6,2,64257,64257,64259,0,2,4
18326,3,3,64260,64260,64263,0,3,1
18327,3,2,64263,64263,64265,0,2,0
18328,6,2,64269,64269,64271,0,2,4
18329,5,3,64274,64274,64277,0,3,3
18330,6,2,64280,64280,64282,0,2,3
18331,2,1,64282,64282,64283,0,1,0
18332,3,1,64285,64285,64286,0,1,2
18333,5,1,64290,64290,64291,0,1,4
18334,4,3,64294,64294,64297,0,3,3
18335,4,3,64298,64298,64301,0,3,1
18336,1,1,64299,64301,64302,2,3,0
18337,1,2,64300,64302,64304,2,4,0
18338,4,2,64304,64304,64306,0,2,0
18339,6,3,64310,64310,64313,0,3,4
18340,1,2,64311,64313,64315,2,4,0
18341,1,2,64312,64315,64317,3,5,0
18342,4,3,64316,64317,64320,1,4,0
18343,5,1,64321,64321,64322,0,1,1
18344,2,2,64323,64323,64325,0,2,1
18345,6,3,64329,64329,64332,0,3,4
18346,2,1,64331,64332,64333,1,2,0
18347,2,1,64333,64333,64334,0,1,0
18348,3,3,64336,64336,64339,0,3,2
18349,3,2,64339,64339,64341,0,2,0
18350,2,2,64341,64341,64343,0,2,0
18351,2,2,64343,64343,64345,0,2,0
18352,5,2,64348,64348,64350,0,2,3
18353,5,3,64353,64353,64356,0,3,3
18354,4,3,64357,64357,64360,0,3,1
18355,4,2,64361,64361,64363,0,2,1
18356,2,2,64363,64363,64365,0,2,0
18357,2,1,64365,64365,64366,0,1,0
18358,2,2,64367,64367,64369,0,2,1
18359,1,2,64368,64369,64371,1,3,0
18360,6,2,64374,64374,64376,0,2,3
18361,2,3,64376,64376,64379,0,3,0
18362,2,1,64378,64379,64380,1,2,0
18363,5,3,64383,64383,64386,0,3,3
18364,1,3,64384,64386,64389,2,5,0
18365,3,3,64387,64389,64392,2,5,0
18366,5,2,64392,64392,64394,0,2,0
18367,6,1,64398,64398,64399,0,1,4
18368,3,2,64401,64401,64403,0,2,2
18369,1,3,64402,64403,64406,1,4,0
18370,2,2,64404,64406,64408,2,4,0
18371,6,3,64410,64410,64413,0,3,2
18372,5,3,64415,64415,64418,0,3,2
18373,3,1,64418,64418,64419,0,1,0
18374,2,2,64420,64420,64422,0,2,1
18375,3,1,64423,64423,64424,0,1,1
18376,1,1,64424,64424,64425,0,1,0
18377,2,1,64426,64426,64427,0,1,1
18378,6,1,64432,64432,64433,0,1,5
18379,2,1,64434,64434,64435,0,1,1
18380,6,3,64440,64440,64443,0,3,5
18381,6,3,64446,64446,64449,0,3,3
18382,4,2,64450,64450,64452,0,2,1
18383,3,3,64453,64453,64456,0,3,1
18384,4,2,64457,64457,64459,0,2,1
18385,3,2,64460,64460,64462,0,2,1
18386,6,1,64466,64466,64467,0,1,4
18387,6,3,64472,64472,64475,0,3,5
18388,1,2,64473,64475,64477,2,4,0
18389,6,3,64479,64479,64482,0,3,2
18390,3,3,64482,64482,64485,0,3,0
18391,3,1,64485,64485,64486,0,1,0
18392,1,1,64486,64486,64487,0,1,0
18393,1,2,64487,64487,64489,0,2,0
18394,4,1,64491,64491,64492,0,1,2
18395,2,1,64493,64493,64494,0,1,1
18396,4,1,64497,64497,64498,0,1,3
18397,5,1,64502,64502,64503,0,1,4
18398,3,3,64505,64505,64508,0,3,2
18399,3,2,64508,64508,64510,0,2,0
18400,1,3,64509,64510,64513,1,4,0
18401,4,2,64513,64513,64515,0,2,0
18402,4,2,64517,64517,64519,0,2,2
18403,1,1,64518,64519,64520,1,2,0
18404,5,2,64523,64523,64525,0,2,3
18405,5,2,64528,64528,64530,0,2,3
18406,1,2,64529,64530,64532,1,3,0
18407,6,3,64535,64535,64538,0,3,3
18408,1,1,64536,64538,64539,2,3,0
18409,4,2,64540,64540,64542,0,2,1
18410,3,3,64543,64543,64546,0,3,1
18411,5,2,64548,64548,64550,0,2,2
18412,6,1,64554,64554,64555,0,1,4
18413,6,3,64560,64560,64563,0,3,5
18414,2,1,64562,64563,64564,1,2,0
18415,5,2,64567,64567,64569,0,2,3
18416,6,1,64573,64573,64574,0,1,4
18417,4,2,64577,64577,64579,0,2,3
18418,4,1,64581,64581,64582,0,1,2
18419,1,3,64582,64582,64585,0,3,0
18420,2,1,64584,64585,64586,1,2,0
18421,1,2,64585,64586,64588,1,3,0
18422,5,3,64590,64590,64593,0,3,2
18423,6,2,64596,64596,64598,0,2,3
18424,3,1,64599,64599,64600,0,1,1
18425,6,2,64605,64605,64607,0,2,5
18426,1,2,64606,64607,64609,1,3,0
18427,1,1,64607,64609,64610,2,3,0
18428,5,2,64612,64612,64614,0,2,2
18429,2,3,64614,64614,64617,0,3,0
18430,6,3,64620,64620,64623,0,3,3
18431,3,3,64623,64623,64626,0,3,0
18432,4,2,64627,64627,64629,0,2,1
18433,2,1,64629,64629,64630,0,1,0
18434,1,3,64630,64630,64633,0,3,0
18435,2,2,64632,64633,64635,1,3,0
18436,4,2,64636,64636,64638,0,2,1
18437,3,3,64639,64639,64642,0,3,1
18438,2,2,64641,64642,64644,1,3,0
18439,1,3,64642,64644,64647,2,5,0
18440,6,1,64648,64648,64649,0,1,1
18441,4,3,64652,64652,64655,0,3,3
18442,6,1,64658,64658,64659,0,1,3
18443,2,1,64660,64660,64661,0,1,1
18444,2,2,64662,64662,64664,0,2,1
18445,5,1,64667,64667,64668,0,1,3
18446,3,2,64670,64670,64672,0,2,2
18447,3,2,64673,64673,64675,0,2,1
18448,4,1,64677,64677,64678,0,1,2
18449,3,3,64680,64680,64683,0,3,2
18450,5,3,64685,64685,64688,0,3,2
18451,4,3,64689,64689,64692,0,3,1
18452,3,2,64692,64692,64694,0,2,0
18453,5,2,64697,64697,64699,0,2,3
18454,6,2,64703,64703,64705,0,2,4
18455,6,3,64709,64709,64712,0,3,4
18456,2,1,64711,64712,64713,1,2,0
18457,4,3,64715,64715,64718,0,3,2
18458,6,1,64721,64721,64722,0,1,3
18459,1,3,64722,64722,64725,0,3,0
18460,3,2,64725,64725,64727,0,2,0
18461,3,2,64728,64728,64730,0,2,1
18462,1,1,64729,64730,64731,1,2,0
18463,4,2,64733,64733,64735,0,2,2
18464,5,2,64738,64738,64740,0,2,3
18465,1,2,64739,64740,64742,1,3,0
18466,5,3,64744,64744,64747,0,3,2
18467,2,3,64746,64747,64750,1,4,0
18468,3,2,64749,64750,64752,1,3,0
18469,1,3,64750,64752,64755,2,5,0
18470,5,2,64755,64755,64757,0,2,0
18471,3,1,64758,64758,64759,0,1,1
18472,3,2,64761,64761,64763,0,2,2
18473,1,2,64762,64763,64765,1,3,0
18474,4,1,64766,64766,64767,0,1,1
18475,1,2,64767,64767,64769,0,2,0
18476,6,2,64773,64773,64775,0,2,4
18477,4,1,64777,64777,64778,0,1,2
18478,6,2,64783,64783,64785,0,2,5
18479,3,3,64786,64786,64789,0,3,1
18480,3,1,64789,64789,64790,0,1,0
18481,6,3,64795,64795,64798,0,3,5
18482,1,1,64796,64798,64799,2,3,0
18483,3,2,64799,64799,64801,0,2,0
18484,4,1,64803,64803,64804,0,1,2
18485,4,3,64807,64807,64810,0,3,3
18486,1,3,64808,64810,64813,2,5,0
18487,4,3,64812,64813,64816,1,4,0
18488,5,3,64817,64817,64820,0,3,1
18489,2,1,64819,64820,64821,1,2,0
18490,5,2,64824,64824,64826,0,2,3
18491,1,1,64825,64826,64827,1,2,0
18492,5,1,64830,64830,64831,0,1,3
18493,4,2,64834,64834,64836,0,2,3
18494,2,3,64836,64836,64839,0,3,0
18495,3,2,64839,64839,64841,0,2,0
18496,3,1,64842,64842,64843,0,1,1
18497,6,3,64848,64848,64851,0,3,5
18498,4,3,64852,64852,64855,0,3,1
18499,4,1,64856,64856,64857,0,1,1
18500,4,3,64860,64860,64863,0,3,3
18501,1,1,64861,64863,64864,2,3,0
18502,1,2,64862,64864,64866,2,4,0
18503,6,3,64868,64868,64871,0,3,2
18504,1,3,64869,64871,64874,2,5,0
18505,4,2,64873,64874,64876,1,3,0
18506,6,3,64879,64879,64882,0,3,3
18507,3,1,64882,64882,64883,0,1,0
18508,6,2,64888,64888,64890,0,2,5
18509,2,1,64890,64890,64891,0,1,0
18510,1,2,64891,64891,64893,0,2,0
18511,5,1,64896,64896,64897,0,1,3
18512,3,1,64899,64899,64900,0,1,2
18513,5,2,64904,64904,64906,0,2,4
18514,6,1,64910,64910,64911,0,1,4
18515,5,3,64915,64915,64918,0,3,4
18516,1,1,64916,64918,64919,2,3,0
18517,6,3,64922,64922,64925,0,3,3
18518,3,3,64925,64925,64928,0,3,0
18519,4,3,64929,64929,64932,0,3,1
18520,3,2,64932,64932,64934,0,2,0
18521,2,3,64934,64934,64937,0,3,0
18522,6,2,64940,64940,64942,0,2,3
18523,2,2,64942,64942,64944,0,2,0
18524,2,1,64944,64944,64945,0,1,0
18525,4,2,64948,64948,64950,0,2,3
18526,1,3,64949,64950,64953,1,4,0
18527,4,1,64953,64953,64954,0,1,0
18528,4,3,64957,64957,64960,0,3,3
18529,5,1,64962,64962,64963,0,1,2
18530,2,2,64964,64964,64966,0,2,1
18531,3,3,64967,64967,64970,0,3,1
18532,4,2,64971,64971,64973,0,2,1
18533,2,1,64973,64973,64974,0,1,0
18534,4,3,64977,64977,64980,0,3,3
18535,2,1,64979,64980,64981,1,2,0
18536,5,3,64984,64984,64987,0,3,3
18537,2,1,64986,64987,64988,1,2,0
18538,2,3,64988,64988,64991,0,3,0
18539,1,1,64989,64991,64992,2,3,0
18540,2,3,64991,64992,64995,1,4,0
18541,2,1,64993,64995,64996,2,3,0
18542,6,3,64999,64999,65002,0,3,3
18543,1,3,65000,65002,65005,2,5,0
18544,3,2,65003,65005,65007,2,4,0
18545,5,1,65008,65008,65009,0,1,1
18546,5,2,65013,65013,65015,0,2,4
18547,2,2,65015,65015,65017,0,2,0
18548,1,3,65016,65017,65020,1,4,0
18549,2,3,65018,65020,65023,2,5,0
18550,2,1,65020,65023,65024,3,4,0
18551,2,2,65022,65024,65026,2,4,0
18552,1,3,65023,65026,65029,3,6,0
18553,5,3,65028,65029,65032,1,4,0
18554,5,1,65033,65033,65034,0,1,1
18555,4,1,65037,65037,65038,0,1,3
18556,1,1,65038,65038,65039,0,1,0
18557,5,2,65043,65043,65045,0,2,4
18558,3,3,65046,65046,65049,0,3,1
18559,2,1,65048,65049,65050,1,2,0
18560,5,1,65053,65053,65054,0,1,3
18561,3,3,65056,65056,65059,0,3,2
18562,5,3,65061,65061,65064,0,3,2
18563,3,2,65064,65064,65066,0,2,0
18564,5,2,65069,65069,65071,0,2,3
18565,5,2,65074,65074,65076,0,2,3
18566,4,3,65078,65078,65081,0,3,2
18567,1,1,65079,65081,65082,2,3,0
18568,6,3,65085,65085,65088,0,3,3
18569,5,3,65090,65090,65093,0,3,2
18570,2,3,65092,65093,65096,1,4,0
18571,1,1,65093,65096,65097,3,4,0
18572,2,3,65095,65097,65100,2,5,0
18573,6,3,65101,65101,65104,0,3,1
18574,1,2,65102,65104,65106,2,4,0
18575,1,3,65103,65106,65109,3,6,0
18576,5,2,65108,65109,65111,1,3,0
18577,3,1,65111,65111,65112,0,1,0
18578,4,1,65115,65115,65116,0,1,3
18579,3,3,65118,65118,65121,0,3,2
18580,5,2,65123,65123,65125,0,2,2
18581,4,1,65127,65127,65128,0,1,2
18582,5,2,65132,65132,65134,0,2,4
18583,3,2,65135,65135,65137,0,2,1
18584,1,2,65136,65137,65139,1,3,0
18585,5,2,65141,65141,65143,0,2,2
18586,3,3,65144,65144,65147,0,3,1
18587,4,2,65148,65148,65150,0,2,1
18588,5,2,65153,65153,65155,0,2,3
18589,1,2,65154,65155,65157,1,3,0
18590,4,3,65158,65158,65161,0,3,1
18591,6,1,65164,65164,65165,0,1,3
18592,6,1,65170,65170,65171,0,1,5
18593,6,1,65176,65176,65177,0,1,5
18594,4,3,65180,65180,65183,0,3,3
18595,2,2,65182,65183,65185,1,3,0
18596,3,3,65185,65185,65188,0,3,0
18597,1,3,65186,65188,65191,2,5,0
18598,3,1,65189,65191,65192,2,3,0
18599,3,3,65192,65192,65195,0,3,0
18600,1,2,65193,65195,65197,2,4,0
18601,4,3,65197,65197,65200,0,3,0
18602,5,2,65202,65202,65204,0,2,2
18603,1,1,65203,65204,65205,1,2,0
18604,2,3,65205,65205,65208,0,3,0
18605,1,2,65206,65208,65210,2,4,0
18606,2,2,65208,65210,65212,2,4,0
18607,4,3,65212,65212,65215,0,3,0
18608,3,1,65215,65215,65216,0,1,0
18609,6,3,65221,65221,65224,0,3,5
18610,5,1,65226,65226,65227,0,1,2
18611,6,3,65232,65232,65235,0,3,5
18612,5,1,65237,65237,65238,0,1,2
18613,6,3,65243,65243,65246,0,3,5
18614,6,3,65249,65249,65252,0,3,3
18615,1,3,65250,65252,65255,2,5,0
18616,1,2,65251,65255,65257,4,6,0
18617,2,2,65253,65257,65259,4,6,0
18618,2,3,65255,65259,65262,4,7,0
18619,3,1,65258,65262,65263,4,5,0
18620,3,1,65261,65263,65264,2,3,0
18621,5,3,65266,65266,65269,0,3,2
18622,4,1,65270,65270,65271,0,1,1
18623,2,3,65272,65272,65275,0,3,1
18624,6,1,65278,65278,65279,0,1,3
18625,1,3,65279,65279,65282,0,3,0
18626,1,1,65280,65282,65283,2,3,0
18627,1,2,65281,65283,65285,2,4,0
18628,3,3,65284,65285,65288,1,4,0
18629,1,2,65285,65288,65290,3,5,0
18630,5,2,65290,65290,65292,0,2,0
18631,6,2,65296,65296,65298,0,2,4
18632,2,1,65298,65298,65299,0,1,0
18633,3,2,65301,65301,65303,0,2,2
18634,3,2,65304,65304,65306,0,2,1
18635,5,2,65309,65309,65311,0,2,3
18636,6,3,65315,65315,65318,0,3,4
18637,3,2,65318,65318,65320,0,2,0
18638,4,3,65322,65322,65325,0,3,2
18639,3,1,65325,65325,65326,0,1,0
18640,3,2,65328,65328,65330,0,2,2
18641,4,2,65332,65332,65334,0,2,2
18642,2,2,65334,65334,65336,0,2,0
18643,1,3,65335,65336,65339,1,4,0
18644,1,1,65336,65339,65340,3,4,0
18645,6,1,65342,65342,65343,0,1,2
18646,4,3,65346,65346,65349,0,3,3
18647,6,1,65352,65352,65353,0,1,3
18648,1,2,65353,65353,65355,0,2,0
18649,2,1,65355,65355,65356,0,1,0
18650,6,2,65361,65361,65363,0,2,5
18651,1,1,65362,65363,65364,1,2,0
18652,3,3,65365,65365,65368,0,3,1
18653,6,3,65371,65371,65374,0,3,3
18654,5,2,65376,65376,65378,0,2,2
18655,1,1,65377,65378,65379,1,2,0
18656,5,2,65382,65382,65384,0,2,3
18657,2,2,65384,65384,65386,0,2,0
18658,5,3,65389,65389,65392,0,3,3
18659,6,2,65395,65395,65397,0,2,3
18660,2,3,65397,65397,65400,0,3,0
18661,6,2,65403,65403,65405,0,2,3
18662,6,2,65409,65409,65411,0,2,4
18663,4,3,65413,65413,65416,0,3,2
18664,4,2,65417,65417,65419,0,2,1
18665,2,1,65419,65419,65420,0,1,0
18666,6,2,65425,65425,65427,0,2,5
18667,3,2,65428,65428,65430,0,2,1
18668,2,1,65430,65430,65431,0,1,0
18669,5,3,65435,65435,65438,0,3,4
18670,5,3,65440,65440,65443,0,3,2
18671,5,3,65445,65445,65448,0,3,2
18672,4,3,65449,65449,65452,0,3,1
18673,1,2,65450,65452,65454,2,4,0
18674,3,1,65453,65454,65455,1,2,0
18675,2,2,65455,65455,65457,0,2,0
18676,6,3,65461,65461,65464,0,3,4
18677,4,1,65465,65465,65466,0,1,1
18678,5,3,65470,65470,65473,0,3,4
18679,5,2,65475,65475,65477,0,2,2
18680,6,3,65481,65481,65484,0,3,4
18681,1,3,65482,65484,65487,2,5,0
18682,5,3,65487,65487,65490,0,3,0
18683,2,1,65489,65490,65491,1,2,0
18684,3,2,65492,65492,65494,0,2,1
18685,5,3,65497,65497,65500,0,3,3
18686,4,1,65501,65501,65502,0,1,1
18687,1,3,65502,65502,65505,0,3,0
18688,5,3,65507,65507,65510,0,3,2
18689,1,3,65508,65510,65513,2,5,0
18690,6,2,65514,65514,65516,0,2,1
18691,6,3,65520,65520,65523,0,3,4
18692,3,2,65523,65523,65525,0,2,0
18693,5,2,65528,65528,65530,0,2,3
18694,4,3,65532,65532,65535,0,3,2
18695,4,3,65536,65536,65539,0,3,1
18696,2,2,65538,65539,65541,1,3,0
18697,5,1,65543,65543,65544,0,1,2
18698,5,1,65548,65548,65549,0,1,4
18699,2,1,65550,65550,65551,0,1,1
18700,3,1,65553,65553,65554,0,1,2
18701,6,3,65559,65559,65562,0,3,5
18702,5,1,65564,65564,65565,0,1,2
18703,3,1,65567,65567,65568,0,1,2
18704,3,1,65570,65570,65571,0,1,2
18705,2,2,65572,65572,65574,0,2,1
18706,1,2,65573,65574,65576,1,3,0
18707,4,3,65577,65577,65580,0,3,1
18708,4,1,65581,65581,65582,0,1,1
18709,6,3,65587,65587,65590,0,3,5
18710,5,3,65592,65592,65595,0,3,2
18711,4,2,65596,65596,65598,0,2,1
18712,4,3,65600,65600,65603,0,3,2
18713,6,3,65606,65606,65609,0,3,3
18714,5,2,65611,65611,65613,0,2,2
18715,2,1,65613,65613,65614,0,1,0
18716,6,3,65619,65619,65622,0,3,5
18717,1,2,65620,65622,65624,2,4,0
18718,5,1,65625,65625,65626,0,1,1
18719,3,1,65628,65628,65629,0,1,2
18720,2,2,65630,65630,65632,0,2,1
18721,2,2,65632,65632,65634,0,2,0
18722,3,2,65635,65635,65637,0,2,1
18723,2,3,65637,65637,65640,0,3,0
18724,4,2,65641,65641,65643,0,2,1
18725,3,1,65644,65644,65645,0,1,1
18726,1,3,65645,65645,65648,0,3,0
18727,5,2,65650,65650,65652,0,2,2
18728,4,2,65654,65654,65656,0,2,2
18729,3,3,65657,65657,65660,0,3,1
18730,6,2,65663,65663,65665,0,2,3
18731,4,3,65667,65667,65670,0,3,2
18732,6,3,65673,65673,65676,0,3,3
18733,4,1,65677,65677,65678,0,1,1
18734,3,2,65680,65680,65682,0,2,2
18735,5,1,65685,65685,65686,0,1,3
18736,5,2,65690,65690,65692,0,2,4
18737,1,2,65691,65692,65694,1,3,0
18738,4,1,65695,65695,65696,0,1,1
18739,1,1,65696,65696,65697,0,1,0
18740,1,2,65697,65697,65699,0,2,0
18741,6,3,65703,65703,65706,0,3,4
18742,2,1,65705,65706,65707,1,2,0
18743,2,2,65707,65707,65709,0,2,0
18744,3,1,65710,65710,65711,0,1,1
18745,1,2,65711,65711,65713,0,2,0
18746,6,1,65717,65717,65718,0,1,4
18747,1,3,65718,65718,65721,0,3,0
18748,3,1,65721,65721,65722,0,1,0
18749,6,1,65727,65727,65728,0,1,5
18750,3,1,65730,65730,65731,0,1,2
18751,2,1,65732,65732,65733,0,1,1
18752,1,1,65733,65733,65734,0,1,0
18753,6,1,65739,65739,65740,0,1,5
18754,3,2,65742,65742,65744,0,2,2
18755,1,2,65743,65744,65746,1,3,0
18756,3,1,65746,65746,65747,0,1,0
18757,4,3,65750,65750,65753,0,3,3
18758,2,2,65752,65753,65755,1,3,0
18759,2,1,65754,65755,65756,1,2,0
18760,6,1,65760,65760,65761,0,1,4
18761,6,3,65766,65766,65769,0,3,5
18762,6,3,65772,65772,65775,0,3,3
18763,4,3,65776,65776,65779,0,3,1
18764,2,1,65778,65779,65780,1,2,0
18765,4,2,65782,65782,65784,0,2,2
18766,6,3,65788,65788,65791,0,3,4
18767,2,2,65790,65791,65793,1,3,0
18768,4,3,65794,65794,65797,0,3,1
18769,2,2,65796,65797,65799,1,3,0
18770,6,2,65802,65802,65804,0,2,3
18771,5,3,65807,65807,65810,0,3,3
18772,6,1,65813,65813,65814,0,1,3
18773,5,2,65818,65818,65820,0,2,4
18774,1,2,65819,65820,65822,1,3,0
18775,2,3,65821,65822,65825,1,4,0
18776,6,1,65827,65827,65828,0,1,2
18777,2,1,65829,65829,65830,0,1,1
18778,1,2,65830,65830,65832,0,2,0
18779,1,1,65831,65832,65833,1,2,0
18780,6,1,65837,65837,65838,0,1,4
18781,4,2,65841,65841,65843,0,2,3
18782,4,3,65845,65845,65848,0,3,2
18783,6,3,65851,65851,65854,0,3,3
18784,1,1,65852,65854,65855,2,3,0
18785,4,1,65856,65856,65857,0,1,1
18786,5,2,65861,65861,65863,0,2,4
18787,3,2,65864,65864,65866,0,2,1
18788,4,1,65868,65868,65869,0,1,2
18789,3,1,65871,65871,65872,0,1,2
18790,6,3,65877,65877,65880,0,3,5
18791,3,2,65880,65880,65882,0,2,0
18792,5,3,65885,65885,65888,0,3,3
18793,2,3,65887,65888,65891,1,4,0
18794,5,3,65892,65892,65895,0,3,1
18795,4,3,65896,65896,65899,0,3,1
18796,6,2,65902,65902,65904,0,2,3
18797,3,1,65905,65905,65906,0,1,1
18798,6,2,65911,65911,65913,0,2,5
18799,3,1,65914,65914,65915,0,1,1
18800,6,3,65920,65920,65923,0,3,5
18801,5,3,65925,65925,65928,0,3,2
18802,3,1,65928,65928,65929,0,1,0
18803,2,1,65930,65930,65931,0,1,1
18804,5,3,65935,65935,65938,0,3,4
18805,4,1,65939,65939,65940,0,1,1
18806,4,3,65943,65943,65946,0,3,3
18807,6,1,65949,65949,65950,0,1,3
18808,5,1,65954,65954,65955,0,1,4
18809,4,3,65958,65958,65961,0,3,3
18810,1,2,65959,65961,65963,2,4,0
18811,4,3,65963,65963,65966,0,3,0
18812,6,2,65969,65969,65971,0,2,3
18813,3,2,65972,65972,65974,0,2,1
18814,2,3,65974,65974,65977,0,3,0
18815,2,2,65976,65977,65979,1,3,0
18816,4,3,65980,65980,65983,0,3,1
18817,5,1,65985,65985,65986,0,1,2
18818,3,1,65988,65988,65989,0,1,2
18819,6,3,65994,65994,65997,0,3,5
18820,1,2,65995,65997,65999,2,4,0
18821,6,2,66001,66001,66003,0,2,2
18822,5,3,66006,66006,66009,0,3,3
18823,2,1,66008,66009,66010,1,2,0
18824,1,2,66009,66010,66012,1,3,0
18825,6,1,66015,66015,66016,0,1,3
18826,3,1,66018,66018,66019,0,1,2
18827,2,1,66020,66020,66021,0,1,1
18828,6,3,66026,66026,66029,0,3,5
18829,1,2,66027,66029,66031,2,4,0
18830,5,1,66032,66032,66033,0,1,1
18831,4,3,66036,66036,66039,0,3,3
18832,1,3,66037,66039,66042,2,5,0
18833,4,1,66041,66042,66043,1,2,0
18834,2,3,66043,66043,66046,0,3,0
18835,2,1,66045,66046,66047,1,2,0
18836,3,2,66048,66048,66050,0,2,1
18837,5,2,66053,66053,66055,0,2,3
18838,6,1,66059,66059,66060,0,1,4
18839,5,3,66064,66064,66067,0,3,4
18840,6,2,66070,66070,66072,0,2,3
18841,4,1,66074,66074,66075,0,1,2
18842,1,2,66075,66075,66077,0,2,0
18843,1,3,66076,66077,66080,1,4,0
18844,5,2,66081,66081,66083,0,2,1
18845,3,2,66084,66084,66086,0,2,1
18846,1,2,66085,66086,66088,1,3,0
18847,2,1,66087,66088,66089,1,2,0
18848,6,1,66093,66093,66094,0,1,4
18849,4,2,66097,66097,66099,0,2,3
18850,3,3,66100,66100,66103,0,3,1
18851,6,1,66106,66106,66107,0,1,3
18852,1,2,66107,66107,66109,0,2,0
18853,5,2,66112,66112,66114,0,2,3
18854,1,3,66113,66114,66117,1,4,0
18855,4,3,66117,66117,66120,0,3,0
18856,4,2,66121,66121,66123,0,2,1
18857,5,3,66126,66126,66129,0,3,3
18858,4,3,66130,66130,66133,0,3,1
18859,4,1,66134,66134,66135,0,1,1
18860,1,2,66135,66135,66137,0,2,0
18861,5,3,66140,66140,66143,0,3,3
18862,1,2,66141,66143,66145,2,4,0
18863,6,3,66147,66147,66150,0,3,2
18864,5,3,66152,66152,66155,0,3,2
18865,6,1,66158,66158,66159,0,1,3
18866,6,2,66164,66164,66166,0,2,5
18867,2,2,66166,66166,66168,0,2,0
18868,1,1,66167,66168,66169,1,2,0
18869,3,3,66170,66170,66173,0,3,1
18870,4,1,66174,66174,66175,0,1,1
18871,2,3,66176,66176,66179,0,3,1
18872,4,1,66180,66180,66181,0,1,1
18873,6,3,66186,66186,66189,0,3,5
18874,6,2,66192,66192,66194,0,2,3
18875,5,1,66197,66197,66198,0,1,3
18876,1,3,66198,66198,66201,0,3,0
18877,1,2,66199,66201,66203,2,4,0
18878,6,2,66205,66205,66207,0,2,2
18879,2,3,66207,66207,66210,0,3,0
18880,6,2,66213,66213,66215,0,2,3
18881,5,1,66218,66218,66219,0,1,3
18882,3,3,66221,66221,66224,0,3,2
18883,2,2,66223,66224,66226,1,3,0
18884,1,1,66224,66226,66227,2,3,0
18885,2,1,66226,66227,66228,1,2,0
18886,2,1,66228,66228,66229,0,1,0
18887,3,1,66231,66231,66232,0,1,2
18888,1,3,66232,66232,66235,0,3,0
18889,4,1,66236,66236,66237,0,1,1
18890,5,3,66241,66241,66244,0,3,4
18891,5,2,66246,66246,66248,0,2,2
18892,2,3,66248,66248,66251,0,3,0
18893,2,3,66250,66251,66254,1,4,0
18894,4,3,66254,66254,66257,0,3,0
18895,5,1,66259,66259,66260,0,1,2
18896,4,3,66263,66263,66266,0,3,3
18897,4,1,66267,66267,66268,0,1,1
18898,4,2,66271,66271,66273,0,2,3
18899,5,1,66276,66276,66277,0,1,3
18900,6,1,66282,66282,66283,0,1,5
18901,5,1,66287,66287,66288,0,1,4
18902,4,3,66291,66291,66294,0,3,3
18903,5,1,66296,66296,66297,0,1,2
18904,3,1,66299,66299,66300,0,1,2
18905,5,3,66304,66304,66307,0,3,4
18906,3,1,66307,66307,66308,0,1,0
18907,3,2,66310,66310,66312,0,2,2
18908,6,2,66316,66316,66318,0,2,4
18909,2,3,66318,66318,66321,0,3,0
18910,1,1,66319,66321,66322,2,3,0
18911,2,2,66321,66322,66324,1,3,0
18912,3,2,66324,66324,66326,0,2,0
18913,5,3,66329,66329,66332,0,3,3
18914,4,1,66333,66333,66334,0,1,1
18915,2,3,66335,66335,66338,0,3,1
18916,6,2,66341,66341,66343,0,2,3
18917,4,2,66345,66345,66347,0,2,2
18918,3,1,66348,66348,66349,0,1,1
18919,3,3,66351,66351,66354,0,3,2
18920,1,2,66352,66354,66356,2,4,0
18921,6,3,66358,66358,66361,0,3,2
18922,4,1,66362,66362,66363,0,1,1
18923,2,2,66364,66364,66366,0,2,1
18924,1,1,66365,66366,66367,1,2,0
18925,1,2,66366,66367,66369,1,3,0
18926,5,1,66371,66371,66372,0,1,2
18927,6,2,66377,66377,66379,0,2,5
18928,2,1,66379,66379,66380,0,1,0
18929,5,3,66384,66384,66387,0,3,4
18930,3,1,66387,66387,66388,0,1,0
18931,4,3,66391,66391,66394,0,3,3
18932,5,2,66396,66396,66398,0,2,2
18933,1,3,66397,66398,66401,1,4,0
18934,2,2,66399,66401,66403,2,4,0
18935,4,1,66403,66403,66404,0,1,0
18936,3,2,66406,66406,66408,0,2,2
18937,5,1,66411,66411,66412,0,1,3
18938,1,1,66412,66412,66413,0,1,0
18939,3,3,66415,66415,66418,0,3,2
18940,2,1,66417,66418,66419,1,2,0
18941,5,2,66422,66422,66424,0,2,3
18942,6,1,66428,66428,66429,0,1,4
18943,6,3,66434,66434,66437,0,3,5
18944,5,3,66439,66439,66442,0,3,2
18945,3,2,66442,66442,66444,0,2,0
18946,6,2,66448,66448,66450,0,2,4
18947,5,1,66453,66453,66454,0,1,3
18948,2,2,66455,66455,66457,0,2,1
18949,4,1,66459,66459,66460,0,1,2
18950,1,3,66460,66460,66463,0,3,0
18951,3,1,66463,66463,66464,0,1,0
18952,1,1,66464,66464,66465,0,1,0
18953,4,3,66468,66468,66471,0,3,3
18954,1,2,66469,66471,66473,2,4,0
18955,5,3,66474,66474,66477,0,3,1
18956,2,2,66476,66477,66479,1,3,0
18957,1,3,66477,66479,66482,2,5,0
18958,2,2,66479,66482,66484,3,5,0
18959,2,3,66481,66484,66487,3,6,0
18960,2,2,66483,66487,66489,4,6,0
18961,3,3,66486,66489,66492,3,6,0
18962,5,3,66491,66492,66495,1,4,0
18963,2,3,66493,66495,66498,2,5,0
18964,5,3,66498,66498,66501,0,3,0
18965,2,1,66500,66501,66502,1,2,0
18966,3,2,66503,66503,66505,0,2,1
18967,4,3,66507,66507,66510,0,3,2
18968,2,2,66509,66510,66512,1,3,0
18969,1,3,66510,66512,66515,2,5,0
18970,6,3,66516,66516,66519,0,3,1
18971,3,3,66519,66519,66522,0,3,0
18972,5,2,66524,66524,66526,0,2,2
18973,4,3,66528,66528,66531,0,3,2
18974,2,1,66530,66531,66532,1,2,0
18975,5,2,66535,66535,66537,0,2,3
18976,5,2,66540,66540,66542,0,2,3
18977,4,3,66544,66544,66547,0,3,2
18978,5,1,66549,66549,66550,0,1,2
18979,2,2,66551,66551,66553,0,2,1
18980,1,1,66552,66553,66554,1,2,0
18981,6,1,66558,66558,66559,0,1,4
18982,1,1,66559,66559,66560,0,1,0
18983,5,3,66564,66564,66567,0,3,4
18984,1,2,66565,66567,66569,2,4,0
18985,5,2,66570,66570,66572,0,2,1
18986,3,1,66573,66573,66574,0,1,1
18987,1,1,66574,66574,66575,0,1,0
18988,4,3,66578,66578,66581,0,3,3
18989,3,1,66581,66581,66582,0,1,0
18990,4,3,66585,66585,66588,0,3,3
18991,2,1,66587,66588,66589,1,2,0
18992,4,2,66591,66591,66593,0,2,2
18993,6,1,66597,66597,66598,0,1,4
18994,1,2,66598,66598,66600,0,2,0
18995,5,3,66603,66603,66606,0,3,3
18996,2,2,66605,66606,66608,1,3,0
18997,6,3,66611,66611,66614,0,3,3
18998,5,3,66616,66616,66619,0,3,2
18999,4,3,66620,66620,66623,0,3,1
19000,6,1,66626,66626,66627,0,1,3
19001,1,3,66627,66627,66630,0,3,0
19002,1,3,66628,66630,66633,2,5,0
19003,6,2,66634,66634,66636,0,2,1
19004,6,2,66640,66640,66642,0,2,4
19005,3,2,66643,66643,66645,0,2,1
19006,6,3,66649,66649,66652,0,3,4
19007,4,1,66653,66653,66654,0,1,1
19008,2,3,66655,66655,66658,0,3,1
19009,2,3,66657,66658,66661,1,4,0
19010,6,3,66663,66663,66666,0,3,2
19011,6,1,66669,66669,66670,0,1,3
19012,1,3,66670,66670,66673,0,3,0
19013,3,3,66673,66673,66676,0,3,0
19014,2,1,66675,66676,66677,1,2,0
19015,1,3,66676,66677,66680,1,4,0
19016,5,3,66681,66681,66684,0,3,1
19017,5,3,66686,66686,66689,0,3,2
19018,5,1,66691,66691,66692,0,1,2
19019,4,1,66695,66695,66696,0,1,3
19020,5,1,66700,66700,66701,0,1,4
19021,2,1,66702,66702,66703,0,1,1
19022,4,1,66706,66706,66707,0,1,3
19023,2,1,66708,66708,66709,0,1,1
19024,2,1,66710,66710,66711,0,1,1
19025,4,2,66714,66714,66716,0,2,3
19026,1,1,66715,66716,66717,1,2,0
19027,5,3,66720,66720,66723,0,3,3
19028,2,1,66722,66723,66724,1,2,0
19029,1,1,66723,66724,66725,1,2,0
19030,5,1,66728,66728,66729,0,1,3
19031,6,1,66734,66734,66735,0,1,5
19032,6,3,66740,66740,66743,0,3,5
19033,3,2,66743,66743,66745,0,2,0
19034,3,2,66746,66746,66748,0,2,1
19035,4,3,66750,66750,66753,0,3,2
19036,1,1,66751,66753,66754,2,3,0
19037,3,3,66754,66754,66757,0,3,0
19038,6,1,66760,66760,66761,0,1,3
19039,1,3,66761,66761,66764,0,3,0
19040,5,3,66766,66766,66769,0,3,2
19041,1,3,66767,66769,66772,2,5,0
19042,6,2,66773,66773,66775,0,2,1
19043,1,2,66774,66775,66777,1,3,0
19044,1,1,66775,66777,66778,2,3,0
19045,2,1,66777,66778,66779,1,2,0
19046,5,1,66782,66782,66783,0,1,3
19047,3,1,66785,66785,66786,0,1,2
19048,2,3,66787,66787,66790,0,3,1
19049,3,2,66790,66790,66792,0,2,0
19050,6,1,66796,66796,66797,0,1,4
19051,6,3,66802,66802,66805,0,3,5
19052,6,3,66808,66808,66811,0,3,3
19053,5,3,66813,66813,66816,0,3,2
19054,6,3,66819,66819,66822,0,3,3
19055,5,2,66824,66824,66826,0,2,2
19056,5,3,66829,66829,66832,0,3,3
19057,5,3,66834,66834,66837,0,3,2
19058,1,3,66835,66837,66840,2,5,0
19059,5,2,66840,66840,66842,0,2,0
19060,1,3,66841,66842,66845,1,4,0
19061,2,1,66843,66845,66846,2,3,0
19062,5,2,66848,66848,66850,0,2,2
19063,5,2,66853,66853,66855,0,2,3
19064,2,1,66855,66855,66856,0,1,0
19065,3,1,66858,66858,66859,0,1,2
19066,1,1,66859,66859,66860,0,1,0
19067,1,1,66860,66860,66861,0,1,0
19068,3,1,66863,66863,66864,0,1,2
19069,5,1,66868,66868,66869,0,1,4
19070,5,2,66873,66873,66875,0,2,4
19071,2,1,66875,66875,66876,0,1,0
19072,1,3,66876,66876,66879,0,3,0
19073,2,1,66878,66879,66880,1,2,0
19074,6,3,66884,66884,66887,0,3,4
19075,6,3,66890,66890,66893,0,3,3
19076,2,2,66892,66893,66895,1,3,0
19077,3,2,66895,66895,66897,0,2,0
19078,5,1,66900,66900,66901,0,1,3
19079,2,3,66902,66902,66905,0,3,1
19080,3,3,66905,66905,66908,0,3,0
19081,1,2,66906,66908,66910,2,4,0
19082,2,2,66908,66910,66912,2,4,0
19083,5,1,66913,66913,66914,0,1,1
19084,2,2,66915,66915,66917,0,2,1
19085,6,1,66921,66921,66922,0,1,4
19086,2,2,66923,66923,66925,0,2,1
19087,2,3,66925,66925,66928,0,3,0
19088,2,1,66927,66928,66929,1,2,0
19089,2,1,66929,66929,66930,0,1,0
19090,6,1,66935,66935,66936,0,1,5
19091,1,2,66936,66936,66938,0,2,0
19092,1,3,66937,66938,66941,1,4,0
19093,1,3,66938,66941,66944,3,6,0
19094,3,3,66941,66944,66947,3,6,0
19095,6,2,66947,66947,66949,0,2,0
19096,5,3,66952,66952,66955,0,3,3
19097,2,3,66954,66955,66958,1,4,0
19098,1,3,66955,66958,66961,3,6,0
19099,3,2,66958,66961,66963,3,5,0
19100,6,2,66964,66964,66966,0,2,1
19101,4,3,66968,66968,66971,0,3,2
19102,6,3,66974,66974,66977,0,3,3
19103,5,1,66979,66979,66980,0,1,2
19104,2,2,66981,66981,66983,0,2,1
19105,6,2,66987,66987,66989,0,2,4
19106,5,2,66992,66992,66994,0,2,3
19107,1,1,66993,66994,66995,1,2,0
19108,5,3,66998,66998,67001,0,3,3
19109,4,1,67002,67002,67003,0,1,1
19110,6,2,67008,67008,67010,0,2,5
19111,3,1,67011,67011,67012,0,1,1
19112,2,3,67013,67013,67016,0,3,1
19113,6,1,67019,67019,67020,0,1,3
19114,1,1,67020,67020,67021,0,1,0
19115,1,2,67021,67021,67023,0,2,0
19116,5,1,67026,67026,67027,0,1,3
19117,1,2,67027,67027,67029,0,2,0
19118,3,1,67030,67030,67031,0,1,1
19119,1,2,67031,67031,67033,0,2,0
19120,3,2,67034,67034,67036,0,2,1
19121,5,2,67039,67039,67041,0,2,3
19122,6,3,67045,67045,67048,0,3,4
19123,4,3,67049,67049,67052,0,3,1
19124,6,2,67055,67055,67057,0,2,3
19125,1,2,67056,67057,67059,1,3,0
19126,3,3,67059,67059,67062,0,3,0
19127,6,1,67065,67065,67066,0,1,3
19128,3,1,67068,67068,67069,0,1,2
19129,1,3,67069,67069,67072,0,3,0
19130,4,1,67073,67073,67074,0,1,1
19131,3,2,67076,67076,67078,0,2,2
19132,1,3,67077,67078,67081,1,4,0
19133,3,1,67080,67081,67082,1,2,0
19134,2,3,67082,67082,67085,0,3,0
19135,6,2,67088,67088,67090,0,2,3
19136,1,2,67089,67090,67092,1,3,0
19137,2,3,67091,67092,67095,1,4,0
19138,4,2,67095,67095,67097,0,2,0
19139,4,1,67099,67099,67100,0,1,2
19140,3,2,67102,67102,67104,0,2,2
19141,6,1,67108,67108,67109,0,1,4
19142,1,1,67109,67109,67110,0,1,0
19143,4,3,67113,67113,67116,0,3,3
19144,6,1,67119,67119,67120,0,1,3
19145,4,2,67123,67123,67125,0,2,3
19146,1,2,67124,67125,67127,1,3,0
19147,4,1,67128,67128,67129,0,1,1
19148,1,2,67129,67129,67131,0,2,0
19149,3,3,67132,67132,67135,0,3,1
19150,6,1,67138,67138,67139,0,1,3
19151,5,2,67143,67143,67145,0,2,4
19152,6,2,67149,67149,67151,0,2,4
19153,3,1,67152,67152,67153,0,1,1
19154,6,2,67158,67158,67160,0,2,5
19155,5,2,67163,67163,67165,0,2,3
19156,5,1,67168,67168,67169,0,1,3
19157,2,3,67170,67170,67173,0,3,1
19158,1,2,67171,67173,67175,2,4,0
19159,1,1,67172,67175,67176,3,4,0
19160,6,3,67178,67178,67181,0,3,2
19161,5,1,67183,67183,67184,0,1,2
19162,6,3,67189,67189,67192,0,3,5
19163,6,3,67195,67195,67198,0,3,3
19164,3,1,67198,67198,67199,0,1,0
19165,3,2,67201,67201,67203,0,2,2
19166,4,1,67205,67205,67206,0,1,2
19167,4,3,67209,67209,67212,0,3,3
19168,4,1,67213,67213,67214,0,1,1
19169,6,3,67219,67219,67222,0,3,5
19170,4,1,67223,67223,67224,0,1,1
19171,4,3,67227,67227,67230,0,3,3
19172,4,3,67231,67231,67234,0,3,1
19173,1,3,67232,67234,67237,2,5,0
19174,1,3,67233,67237,67240,4,7,0
19175,1,3,67234,67240,67243,6,9,0
19176,1,2,67235,67243,67245,8,10,0
19177,2,3,67237,67245,67248,8,11,0
19178,2,3,67239,67248,67251,9,12,0
19179,5,1,67244,67251,67252,7,8,0
19180,3,2,67247,67252,67254,5,7,0
19181,1,2,67248,67254,67256,6,8,0
19182,1,3,67249,67256,67259,7,10,0
19183,4,2,67253,67259,67261,6,8,0
19184,6,1,67259,67261,67262,2,3,0
19185,6,1,67265,67265,67266,0,1,3
19186,2,1,67267,67267,67268,0,1,1
19187,3,3,67270,67270,67273,0,3,2
19188,6,3,67276,67276,67279,0,3,3
19189,2,1,67278,67279,67280,1,2,0
19190,3,3,67281,67281,67284,0,3,1
19191,1,3,67282,67284,67287,2,5,0
19192,1,1,67283,67287,67288,4,5,0
19193,5,3,67288,67288,67291,0,3,0
19194,5,2,67293,67293,67295,0,2,2
19195,3,2,67296,67296,67298,0,2,1
19196,1,3,67297,67298,67301,1,4,0
19197,1,2,67298,67301,67303,3,5,0
19198,6,2,67304,67304,67306,0,2,1
19199,3,1,67307,67307,67308,0,1,1
19200,4,3,67311,67311,67314,0,3,3
19201,6,3,67317,67317,67320,0,3,3
19202,2,2,67319,67320,67322,1,3,0
19203,3,3,67322,67322,67325,0,3,0
19204,1,1,67323,67325,67326,2,3,0
19205,5,2,67328,67328,67330,0,2,2
19206,4,1,67332,67332,67333,0,1,2
19207,5,3,67337,67337,67340,0,3,4
19208,3,2,67340,67340,67342,0,2,0
19209,6,2,67346,67346,67348,0,2,4
19210,6,3,67352,67352,67355,0,3,4
19211,4,3,67356,67356,67359,0,3,1
19212,3,3,67359,67359,67362,0,3,0
19213,1,1,67360,67362,67363,2,3,0
19214,4,2,67364,67364,67366,0,2,1
19215,3,3,67367,67367,67370,0,3,1
19216,4,1,67371,67371,67372,0,1,1
19217,6,2,67377,67377,67379,0,2,5
19218,4,1,67381,67381,67382,0,1,2
19219,3,1,67384,67384,67385,0,1,2
19220,1,1,67385,67385,67386,0,1,0
19221,3,2,67388,67388,67390,0,2,2
19222,1,1,67389,67390,67391,1,2,0
19223,2,1,67391,67391,67392,0,1,0
19224,6,2,67397,67397,67399,0,2,5
19225,4,3,67401,67401,67404,0,3,2
19226,4,2,67405,67405,67407,0,2,1
19227,3,1,67408,67408,67409,0,1,1
19228,5,3,67413,67413,67416,0,3,4
19229,1,2,67414,67416,67418,2,4,0
19230,6,3,67420,67420,67423,0,3,2
19231,5,3,67425,67425,67428,0,3,2
19232,2,2,67427,67428,67430,1,3,0
19233,5,1,67432,67432,67433,0,1,2
19234,1,2,67433,67433,67435,0,2,0
19235,3,2,67436,67436,67438,0,2,1
19236,1,1,67437,67438,67439,1,2,0
19237,5,3,67442,67442,67445,0,3,3
19238,6,3,67448,67448,67451,0,3,3
19239,4,3,67452,67452,67455,0,3,1
19240,1,1,67453,67455,67456,2,3,0
19241,4,3,67457,67457,67460,0,3,1
19242,4,3,67461,67461,67464,0,3,1
19243,5,1,67466,67466,67467,0,1,2
19244,6,3,67472,67472,67475,0,3,5
19245,2,2,67474,67475,67477,1,3,0
19246,5,2,67479,67479,67481,0,2,2
19247,4,3,67483,67483,67486,0,3,2
19248,3,2,67486,67486,67488,0,2,0
19249,2,1,67488,67488,67489,0,1,0
19250,5,3,67493,67493,67496,0,3,4
19251,1,2,67494,67496,67498,2,4,0
19252,2,1,67496,67498,67499,2,3,0
19253,1,1,67497,67499,67500,2,3,0
19254,4,3,67501,67501,67504,0,3,1
19255,6,3,67507,67507,67510,0,3,3
19256,2,3,67509,67510,67513,1,4,0
19257,4,1,67513,67513,67514,0,1,0
19258,4,3,67517,67517,67520,0,3,3
19259,6,3,67523,67523,67526,0,3,3
19260,3,1,67526,67526,67527,0,1,0
19261,6,1,67532,67532,67533,0,1,5
19262,3,2,67535,67535,67537,0,2,2
19263,3,2,67538,67538,67540,0,2,1
19264,4,2,67542,67542,67544,0,2,2
19265,3,1,67545,67545,67546,0,1,1
19266,6,1,67551,67551,67552,0,1,5
19267,4,2,67555,67555,67557,0,2,3
19268,5,3,67560,67560,67563,0,3,3
19269,6,2,67566,67566,67568,0,2,3
19270,1,3,67567,67568,67571,1,4,0
19271,4,3,67571,67571,67574,0,3,0
19272,2,3,67573,67574,67577,1,4,0
19273,5,3,67578,67578,67581,0,3,1
19274,5,3,67583,67583,67586,0,3,2
19275,4,3,67587,67587,67590,0,3,1
19276,5,3,67592,67592,67595,0,3,2
19277,1,3,67593,67595,67598,2,5,0
19278,2,2,67595,67598,67600,3,5,0
19279,3,3,67598,67600,67603,2,5,0
19280,4,2,67602,67603,67605,1,3,0
19281,1,2,67603,67605,67607,2,4,0
19282,3,2,67606,67607,67609,1,3,0
19283,6,1,67612,67612,67613,0,1,3
19284,5,1,67617,67617,67618,0,1,4
19285,2,2,67619,67619,67621,0,2,1
19286,6,3,67625,67625,67628,0,3,4
19287,3,2,67628,67628,67630,0,2,0
19288,1,1,67629,67630,67631,1,2,0
19289,2,1,67631,67631,67632,0,1,0
19290,6,3,67637,67637,67640,0,3,5
19291,6,2,67643,67643,67645,0,2,3
19292,5,3,67648,67648,67651,0,3,3
19293,4,2,67652,67652,67654,0,2,1
19294,1,2,67653,67654,67656,1,3,0
19295,3,1,67656,67656,67657,0,1,0
19296,3,2,67659,67659,67661,0,2,2
19297,3,1,67662,67662,67663,0,1,1
19298,2,3,67664,67664,67667,0,3,1
19299,2,2,67666,67667,67669,1,3,0
19300,2,2,67668,67669,67671,1,3,0
19301,6,1,67674,67674,67675,0,1,3
19302,3,1,67677,67677,67678,0,1,2
19303,3,3,67680,67680,67683,0,3,2
19304,5,2,67685,67685,67687,0,2,2
19305,2,1,67687,67687,67688,0,1,0
19306,5,2,67692,67692,67694,0,2,4
19307,2,3,67694,67694,67697,0,3,0
19308,6,1,67700,67700,67701,0,1,3
19309,4,1,67704,67704,67705,0,1,3
19310,2,1,67706,67706,67707,0,1,1
19311,5,2,67711,67711,67713,0,2,4
19312,5,2,67716,67716,67718,0,2,3
19313,6,1,67722,67722,67723,0,1,4
19314,1,3,67723,67723,67726,0,3,0
19315,4,1,67727,67727,67728,0,1,1
19316,6,1,67733,67733,67734,0,1,5
19317,4,3,67737,67737,67740,0,3,3
19318,2,1,67739,67740,67741,1,2,0
19319,5,2,67744,67744,67746,0,2,3
19320,1,3,67745,67746,67749,1,4,0
19321,6,3,67751,67751,67754,0,3,2
19322,6,3,67757,67757,67760,0,3,3
19323,3,2,67760,67760,67762,0,2,0
19324,6,2,67766,67766,67768,0,2,4
19325,6,2,67772,67772,67774,0,2,4
19326,5,2,67777,67777,67779,0,2,3
19327,3,1,67780,67780,67781,0,1,1
19328,1,1,67781,67781,67782,0,1,0
19329,5,2,67786,67786,67788,0,2,4
19330,5,1,67791,67791,67792,0,1,3
19331,1,3,67792,67792,67795,0,3,0
19332,6,2,67798,67798,67800,0,2,3
19333,3,1,67801,67801,67802,0,1,1
19334,2,2,67803,67803,67805,0,2,1
19335,1,3,67804,67805,67808,1,4,0
19336,1,2,67805,67808,67810,3,5,0
19337,2,2,67807,67810,67812,3,5,0
19338,1,2,67808,67812,67814,4,6,0
19339,5,2,67813,67814,67816,1,3,0
19340,2,2,67815,67816,67818,1,3,0
19341,6,1,67821,67821,67822,0,1,3
19342,2,3,67823,67823,67826,0,3,1
19343,2,2,67825,67826,67828,1,3,0
19344,6,2,67831,67831,67833,0,2,3
19345,6,3,67837,67837,67840,0,3,4
19346,6,2,67843,67843,67845,0,2,3
19347,6,3,67849,67849,67852,0,3,4
19348,6,2,67855,67855,67857,0,2,3
19349,1,1,67856,67857,67858,1,2,0
19350,3,2,67859,67859,67861,0,2,1
19351,6,1,67865,67865,67866,0,1,4
19352,3,2,67868,67868,67870,0,2,2
19353,6,3,67874,67874,67877,0,3,4
19354,2,1,67876,67877,67878,1,2,0
19355,4,1,67880,67880,67881,0,1,2
19356,1,3,67881,67881,67884,0,3,0
19357,3,2,67884,67884,67886,0,2,0
19358,6,2,67890,67890,67892,0,2,4
19359,4,2,67894,67894,67896,0,2,2
19360,5,1,67899,67899,67900,0,1,3
19361,2,3,67901,67901,67904,0,3,1
19362,1,2,67902,67904,67906,2,4,0
19363,4,3,67906,67906,67909,0,3,0
19364,3,2,67909,67909,67911,0,2,0
19365,4,1,67913,67913,67914,0,1,2
19366,5,3,67918,67918,67921,0,3,4
19367,6,2,67924,67924,67926,0,2,3
19368,4,2,67928,67928,67930,0,2,2
19369,6,3,67934,67934,67937,0,3,4
19370,6,2,67940,67940,67942,0,2,3
19371,5,1,67945,67945,67946,0,1,3
19372,4,2,67949,67949,67951,0,2,3
19373,6,3,67955,67955,67958,0,3,4
19374,5,2,67960,67960,67962,0,2,2
19375,1,2,67961,67962,67964,1,3,0
19376,3,1,67964,67964,67965,0,1,0
19377,6,1,67970,67970,67971,0,1,5
19378,6,3,67976,67976,67979,0,3,5
19379,6,1,67982,67982,67983,0,1,3
19380,4,3,67986,67986,67989,0,3,3
19381,5,2,67991,67991,67993,0,2,2
19382,6,1,67997,67997,67998,0,1,4
19383,3,3,68000,68000,68003,0,3,2
19384,4,3,68004,68004,68007,0,3,1
19385,6,1,68010,68010,68011,0,1,3
19386,6,2,68016,68016,68018,0,2,5
19387,6,3,68022,68022,68025,0,3,4
19388,4,2,68026,68026,68028,0,2,1
19389,1,2,68027,68028,68030,1,3,0
19390,2,1,68029,68030,68031,1,2,0
19391,2,2,68031,68031,68033,0,2,0
19392,4,1,68035,68035,68036,0,1,2
19393,3,3,68038,68038,68041,0,3,2
19394,3,2,68041,68041,68043,0,2,0
19395,6,1,68047,68047,68048,0,1,4
19396,4,2,68051,68051,68053,0,2,3
19397,3,1,68054,68054,68055,0,1,1
19398,6,1,68060,68060,68061,0,1,5
19399,3,1,68063,68063,68064,0,1,2
19400,2,2,68065,68065,68067,0,2,1
19401,3,3,68068,68068,68071,0,3,1
19402,4,2,68072,68072,68074,0,2,1
19403,2,2,68074,68074,68076,0,2,0
19404,4,1,68078,68078,68079,0,1,2
19405,4,2,68082,68082,68084,0,2,3
19406,2,2,68084,68084,68086,0,2,0
19407,6,3,68090,68090,68093,0,3,4
19408,4,3,68094,68094,68097,0,3,1
19409,3,2,68097,68097,68099,0,2,0
19410,5,3,68102,68102,68105,0,3,3
19411,4,2,68106,68106,68108,0,2,1
19412,1,3,68107,68108,68111,1,4,0
19413,2,1,68109,68111,68112,2,3,0
19414,2,3,68111,68112,68115,1,4,0
19415,1,1,68112,68115,68116,3,4,0
19416,2,2,68114,68116,68118,2,4,0
19417,1,3,68115,68118,68121,3,6,0
19418,4,3,68119,68121,68124,2,5,0
19419,5,2,68124,68124,68126,0,2,0
19420,3,2,68127,68127,68129,0,2,1
19421,3,3,68130,68130,68133,0,3,1
19422,2,1,68132,68133,68134,1,2,0
19423,2,1,68134,68134,68135,0,1,0
19424,1,2,68135,68135,68137,0,2,0
19425,3,2,68138,68138,68140,0,2,1
19426,1,2,68139,68140,68142,1,3,0
19427,4,2,68143,68143,68145,0,2,1
19428,2,3,68145,68145,68148,0,3,0
19429,4,1,68149,68149,68150,0,1,1
19430,5,1,68154,68154,68155,0,1,4
19431,5,3,68159,68159,68162,0,3,4
19432,6,1,68165,68165,68166,0,1,3
19433,5,3,68170,68170,68173,0,3,4
19434,4,1,68174,68174,68175,0,1,1
19435,2,1,68176,68176,68177,0,1,1
19436,2,3,68178,68178,68181,0,3,1
19437,2,1,68180,68181,68182,1,2,0
19438,6,1,68186,68186,68187,0,1,4
19439,6,3,68192,68192,68195,0,3,5
19440,4,3,68196,68196,68199,0,3,1
19441,2,2,68198,68199,68201,1,3,0
19442,5,1,68203,68203,68204,0,1,2
19443,6,1,68209,68209,68210,0,1,5
19444,6,1,68215,68215,68216,0,1,5
19445,4,2,68219,68219,68221,0,2,3
19446,2,1,68221,68221,68222,0,1,0
19447,1,3,68222,68222,68225,0,3,0
19448,2,3,68224,68225,68228,1,4,0
19449,4,2,68228,68228,68230,0,2,0
19450,1,3,68229,68230,68233,1,4,0
19451,6,1,68235,68235,68236,0,1,2
19452,2,1,68237,68237,68238,0,1,1
19453,2,1,68239,68239,68240,0,1,1
19454,2,1,68241,68241,68242,0,1,1
19455,6,3,68247,68247,68250,0,3,5
19456,2,2,68249,68250,68252,1,3,0
19457,1,3,68250,68252,68255,2,5,0
19458,1,3,68251,68255,68258,4,7,0
19459,3,1,68254,68258,68259,4,5,0
19460,1,2,68255,68259,68261,4,6,0
19461,4,1,68259,68261,68262,2,3,0
19462,6,3,68265,68265,68268,0,3,3
19463,6,3,68271,68271,68274,0,3,3
19464,3,3,68274,68274,68277,0,3,0
19465,2,3,68276,68277,68280,1,4,0
19466,1,1,68277,68280,68281,3,4,0
19467,4,2,68281,68281,68283,0,2,0
19468,1,2,68282,68283,68285,1,3,0
19469,4,1,68286,68286,68287,0,1,1
19470,3,1,68289,68289,68290,0,1,2
19471,3,3,68292,68292,68295,0,3,2
19472,6,1,68298,68298,68299,0,1,3
19473,3,3,68301,68301,68304,0,3,2
19474,3,3,68304,68304,68307,0,3,0
19475,1,2,68305,68307,68309,2,4,0
19476,5,3,68310,68310,68313,0,3,1
19477,1,2,68311,68313,68315,2,4,0
19478,2,3,68313,68315,68318,2,5,0
19479,5,1,68318,68318,68319,0,1,0
19480,2,1,68320,68320,68321,0,1,1
19481,3,1,68323,68323,68324,0,1,2
19482,6,3,68329,68329,68332,0,3,5
19483,4,2,68333,68333,68335,0,2,1
19484,2,3,68335,68335,68338,0,3,0
19485,4,3,68339,68339,68342,0,3,1
19486,6,3,68345,68345,68348,0,3,3
19487,2,3,68347,68348,68351,1,4,0
19488,6,3,68353,68353,68356,0,3,2
19489,6,1,68359,68359,68360,0,1,3
19490,1,1,68360,68360,68361,0,1,0
19491,4,2,68364,68364,68366,0,2,3
19492,1,3,68365,68366,68369,1,4,0
19493,4,1,68369,68369,68370,0,1,0
19494,1,2,68370,68370,68372,0,2,0
19495,3,2,68373,68373,68375,0,2,1
19496,2,2,68375,68375,68377,0,2,0
19497,3,3,68378,68378,68381,0,3,1
19498,1,2,68379,68381,68383,2,4,0
19499,3,1,68382,68383,68384,1,2,0
19500,6,1,68388,68388,68389,0,1,4
19501,4,2,68392,68392,68394,0,2,3
19502,3,2,68395,68395,68397,0,2,1
19503,3,1,68398,68398,68399,0,1,1
19504,1,2,68399,68399,68401,0,2,0
19505,6,3,68405,68405,68408,0,3,4
19506,2,1,68407,68408,68409,1,2,0
19507,6,1,68413,68413,68414,0,1,4
19508,1,2,68414,68414,68416,0,2,0
19509,4,1,68418,68418,68419,0,1,2
19510,6,1,68424,68424,68425,0,1,5
19511,4,1,68428,68428,68429,0,1,3
19512,3,2,68431,68431,68433,0,2,2
19513,6,2,68437,68437,68439,0,2,4
19514,4,1,68441,68441,68442,0,1,2
19515,1,3,68442,68442,68445,0,3,0
19516,3,3,68445,68445,68448,0,3,0
19517,5,3,68450,68450,68453,0,3,2
19518,6,1,68456,68456,68457,0,1,3
19519,2,2,68458,68458,68460,0,2,1
19520,2,1,68460,68460,68461,0,1,0
19521,1,2,68461,68461,68463,0,2,0
19522,4,2,68465,68465,68467,0,2,2
19523,5,1,68470,68470,68471,0,1,3
19524,2,2,68472,68472,68474,0,2,1
19525,2,3,68474,68474,68477,0,3,0
19526,1,1,68475,68477,68478,2,3,0
19527,3,2,68478,68478,68480,0,2,0
19528,3,1,68481,68481,68482,0,1,1
19529,5,3,68486,68486,68489,0,3,4
19530,3,3,68489,68489,68492,0,3,0
19531,2,3,68491,68492,68495,1,4,0
19532,5,3,68496,68496,68499,0,3,1
19533,3,3,68499,68499,68502,0,3,0
19534,1,2,68500,68502,68504,2,4,0
19535,1,3,68501,68504,68507,3,6,0
19536,4,2,68505,68507,68509,2,4,0
19537,4,1,68509,68509,68510,0,1,0
19538,3,3,68512,68512,68515,0,3,2
19539,3,3,68515,68515,68518,0,3,0
19540,2,3,68517,68518,68521,1,4,0
19541,2,2,68519,68521,68523,2,4,0
19542,3,2,68522,68523,68525,1,3,0
19543,3,1,68525,68525,68526,0,1,0
19544,2,3,68527,68527,68530,0,3,1
19545,3,3,68530,68530,68533,0,3,0
19546,3,2,68533,68533,68535,0,2,0
19547,2,2,68535,68535,68537,0,2,0
19548,6,3,68541,68541,68544,0,3,4
19549,1,2,68542,68544,68546,2,4,0
19550,5,1,68547,68547,68548,0,1,1
19551,2,1,68549,68549,68550,0,1,1
19552,6,1,68555,68555,68556,0,1,5
19553,5,2,68560,68560,68562,0,2,4
19554,4,2,68564,68564,68566,0,2,2
19555,3,3,68567,68567,68570,0,3,1
19556,5,2,68572,68572,68574,0,2,2
19557,2,3,68574,68574,68577,0,3,0
19558,1,2,68575,68577,68579,2,4,0
19559,1,2,68576,68579,68581,3,5,0
19560,2,3,68578,68581,68584,3,6,0
19561,6,2,68584,68584,68586,0,2,0
19562,2,3,68586,68586,68589,0,3,0
19563,5,1,68591,68591,68592,0,1,2
19564,5,3,68596,68596,68599,0,3,4
19565,6,3,68602,68602,68605,0,3,3
19566,3,1,68605,68605,68606,0,1,0
19567,5,3,68610,68610,68613,0,3,4
19568,2,1,68612,68613,68614,1,2,0
19569,2,2,68614,68614,68616,0,2,0
19570,6,2,68620,68620,68622,0,2,4
19571,1,1,68621,68622,68623,1,2,0
19572,6,1,68627,68627,68628,0,1,4
19573,4,3,68631,68631,68634,0,3,3
19574,3,1,68634,68634,68635,0,1,0
19575,6,1,68640,68640,68641,0,1,5
19576,4,3,68644,68644,68647,0,3,3
19577,2,1,68646,68647,68648,1,2,0
19578,1,3,68647,68648,68651,1,4,0
19579,6,3,68653,68653,68656,0,3,2
19580,4,3,68657,68657,68660,0,3,1
19581,3,2,68660,68660,68662,0,2,0
19582,5,2,68665,68665,68667,0,2,3
19583,5,3,68670,68670,68673,0,3,3
19584,4,2,68674,68674,68676,0,2,1
19585,3,1,68677,68677,68678,0,1,1
19586,5,2,68682,68682,68684,0,2,4
19587,5,3,68687,68687,68690,0,3,3
19588,4,2,68691,68691,68693,0,2,1
19589,3,2,68694,68694,68696,0,2,1
19590,5,1,68699,68699,68700,0,1,3
19591,1,3,68700,68700,68703,0,3,0
19592,2,1,68702,68703,68704,1,2,0
19593,4,1,68706,68706,68707,0,1,2
19594,6,1,68712,68712,68713,0,1,5
19595,3,1,68715,68715,68716,0,1,2
19596,2,1,68717,68717,68718,0,1,1
19597,4,2,68721,68721,68723,0,2,3
19598,6,1,68727,68727,68728,0,1,4
19599,1,1,68728,68728,68729,0,1,0
19600,5,3,68733,68733,68736,0,3,4
19601,1,2,68734,68736,68738,2,4,0
19602,5,2,68739,68739,68741,0,2,1
19603,4,3,68743,68743,68746,0,3,2
19604,5,3,68748,68748,68751,0,3,2
19605,6,1,68754,68754,68755,0,1,3
19606,2,3,68756,68756,68759,0,3,1
19607,3,3,68759,68759,68762,0,3,0
19608,4,1,68763,68763,68764,0,1,1
19609,6,1,68769,68769,68770,0,1,5
19610,2,1,68771,68771,68772,0,1,1
19611,4,3,68775,68775,68778,0,3,3
19612,3,2,68778,68778,68780,0,2,0
19613,3,2,68781,68781,68783,0,2,1
19614,1,3,68782,68783,68786,1,4,0
19615,5,1,68787,68787,68788,0,1,1
19616,4,3,68791,68791,68794,0,3,3
19617,5,2,68796,68796,68798,0,2,2
19618,3,1,68799,68799,68800,0,1,1
19619,5,1,68804,68804,68805,0,1,4
19620,4,3,68808,68808,68811,0,3,3
19621,5,2,68813,68813,68815,0,2,2
19622,5,2,68818,68818,68820,0,2,3
19623,3,1,68821,68821,68822,0,1,1
19624,6,2,68827,68827,68829,0,2,5
19625,5,1,68832,68832,68833,0,1,3
19626,2,2,68834,68834,68836,0,2,1
19627,4,2,68838,68838,68840,0,2,2
19628,1,2,68839,68840,68842,1,3,0
19629,2,2,68841,68842,68844,1,3,0
19630,1,1,68842,68844,68845,2,3,0
19631,4,2,68846,68846,68848,0,2,1
19632,4,3,68850,68850,68853,0,3,2
19633,1,2,68851,68853,68855,2,4,0
19634,2,2,68853,68855,68857,2,4,0
19635,3,3,68856,68857,68860,1,4,0
19636,1,1,68857,68860,68861,3,4,0
19637,5,3,68862,68862,68865,0,3,1
19638,1,3,68863,68865,68868,2,5,0
19639,4,3,68867,68868,68871,1,4,0
19640,6,3,68873,68873,68876,0,3,2
19641,2,2,68875,68876,68878,1,3,0
19642,4,2,68879,68879,68881,0,2,1
19643,6,2,68885,68885,68887,0,2,4
19644,4,3,68889,68889,68892,0,3,2
19645,2,3,68891,68892,68895,1,4,0
19646,3,1,68894,68895,68896,1,2,0
19647,3,2,68897,68897,68899,0,2,1
19648,5,3,68902,68902,68905,0,3,3
19649,4,1,68906,68906,68907,0,1,1
19650,1,3,68907,68907,68910,0,3,0
19651,4,3,68911,68911,68914,0,3,1
19652,6,2,68917,68917,68919,0,2,3
19653,2,2,68919,68919,68921,0,2,0
19654,6,2,68925,68925,68927,0,2,4
19655,2,2,68927,68927,68929,0,2,0
19656,2,2,68929,68929,68931,0,2,0
19657,1,2,68930,68931,68933,1,3,0
19658,1,3,68931,68933,68936,2,5,0
19659,4,3,68935,68936,68939,1,4,0
19660,3,1,68938,68939,68940,1,2,0
19661,2,3,68940,68940,68943,0,3,0
19662,2,2,68942,68943,68945,1,3,0
19663,6,1,68948,68948,68949,0,1,3
19664,6,1,68954,68954,68955,0,1,5
19665,4,3,68958,68958,68961,0,3,3
19666,5,3,68963,68963,68966,0,3,2
19667,2,3,68965,68966,68969,1,4,0
19668,2,3,68967,68969,68972,2,5,0
19669,5,1,68972,68972,68973,0,1,0
19670,2,1,68974,68974,68975,0,1,1
19671,5,2,68979,68979,68981,0,2,4
19672,2,3,68981,68981,68984,0,3,0
19673,5,1,68986,68986,68987,0,1,2
19674,4,2,68990,68990,68992,0,2,3
19675,6,1,68996,68996,68997,0,1,4
19676,2,1,68998,68998,68999,0,1,1
19677,1,2,68999,68999,69001,0,2,0
19678,4,3,69003,69003,69006,0,3,2
19679,1,1,69004,69006,69007,2,3,0
19680,3,1,69007,69007,69008,0,1,0
19681,3,2,69010,69010,69012,0,2,2
19682,6,2,69016,69016,69018,0,2,4
19683,6,3,69022,69022,69025,0,3,4
19684,3,2,69025,69025,69027,0,2,0
19685,3,3,69028,69028,69031,0,3,1
19686,1,1,69029,69031,69032,2,3,0
19687,6,2,69035,69035,69037,0,2,3
19688,6,2,69041,69041,69043,0,2,4
19689,2,3,69043,69043,69046,0,3,0
19690,2,2,69045,69046,69048,1,3,0
19691,1,2,69046,69048,69050,2,4,0
19692,5,1,69051,69051,69052,0,1,1
19693,6,3,69057,69057,69060,0,3,5
19694,4,3,69061,69061,69064,0,3,1
19695,4,2,69065,69065,69067,0,2,1
19696,4,3,69069,69069,69072,0,3,2
19697,5,2,69074,69074,69076,0,2,2
19698,6,1,69080,69080,69081,0,1,4
19699,5,2,69085,69085,69087,0,2,4
19700,6,1,69091,69091,69092,0,1,4
19701,6,3,69097,69097,69100,0,3,5
19702,4,3,69101,69101,69104,0,3,1
19703,1,3,69102,69104,69107,2,5,0
19704,3,3,69105,69107,69110,2,5,0
19705,1,1,69106,69110,69111,4,5,0
19706,5,1,69111,69111,69112,0,1,0
19707,5,2,69116,69116,69118,0,2,4
19708,3,2,69119,69119,69121,0,2,1
19709,3,2,69122,69122,69124,0,2,1
19710,2,1,69124,69124,69125,0,1,0
19711,1,2,69125,69125,69127,0,2,0
19712,2,2,69127,69127,69129,0,2,0
19713,4,3,69131,69131,69134,0,3,2
19714,4,1,69135,69135,69136,0,1,1
19715,1,2,69136,69136,69138,0,2,0
19716,2,3,69138,69138,69141,0,3,0
19717,2,1,69140,69141,69142,1,2,0
19718,2,3,69142,69142,69145,0,3,0
19719,3,2,69145,69145,69147,0,2,0
19720,4,2,69149,69149,69151,0,2,2
19721,2,2,69151,69151,69153,0,2,0
19722,4,2,69155,69155,69157,0,2,2
19723,3,2,69158,69158,69160,0,2,1
19724,3,3,69161,69161,69164,0,3,1
19725,5,3,69166,69166,69169,0,3,2
19726,6,3,69172,69172,69175,0,3,3
19727,6,3,69178,69178,69181,0,3,3
19728,2,3,69180,69181,69184,1,4,0
19729,1,1,69181,69184,69185,3,4,0
19730,2,1,69183,69185,69186,2,3,0
19731,6,1,69189,69189,69190,0,1,3
19732,4,1,69193,69193,69194,0,1,3
19733,4,1,69197,69197,69198,0,1,3
19734,1,2,69198,69198,69200,0,2,0
19735,6,2,69204,69204,69206,0,2,4
19736,4,2,69208,69208,69210,0,2,2
19737,4,1,69212,69212,69213,0,1,2
19738,3,3,69215,69215,69218,0,3,2
19739,2,3,69217,69218,69221,1,4,0
19740,3,3,69220,69221,69224,1,4,0
19741,1,2,69221,69224,69226,3,5,0
19742,1,3,69222,69226,69229,4,7,0
19743,5,3,69227,69229,69232,2,5,0
19744,5,2,69232,69232,69234,0,2,0
19745,1,2,69233,69234,69236,1,3,0
19746,2,2,69235,69236,69238,1,3,0
19747,2,1,69237,69238,69239,1,2,0
19748,6,2,69243,69243,69245,0,2,4
19749,3,1,69246,69246,69247,0,1,1
19750,1,3,69247,69247,69250,0,3,0
19751,3,3,69250,69250,69253,0,3,0
19752,1,3,69251,69253,69256,2,5,0
19753,4,1,69255,69256,69257,1,2,0
19754,6,1,69261,69261,69262,0,1,4
19755,4,1,69265,69265,69266,0,1,3
19756,4,3,69269,69269,69272,0,3,3
19757,6,1,69275,69275,69276,0,1,3
19758,5,1,69280,69280,69281,0,1,4
19759,3,1,69283,69283,69284,0,1,2
19760,1,1,69284,69284,69285,0,1,0
19761,4,3,69288,69288,69291,0,3,3
19762,1,2,69289,69291,69293,2,4,0
19763,6,2,69295,69295,69297,0,2,2
19764,6,1,69301,69301,69302,0,1,4
19765,4,2,69305,69305,69307,0,2,3
19766,4,1,69309,69309,69310,0,1,2
19767,1,3,69310,69310,69313,0,3,0
19768,1,2,69311,69313,69315,2,4,0
19769,3,1,69314,69315,69316,1,2,0
19770,4,3,69318,69318,69321,0,3,2
19771,1,1,69319,69321,69322,2,3,0
19772,1,3,69320,69322,69325,2,5,0
19773,3,1,69323,69325,69326,2,3,0
19774,3,3,69326,69326,69329,0,3,0
19775,2,2,69328,69329,69331,1,3,0
19776,1,1,69329,69331,69332,2,3,0
19777,6,3,69335,69335,69338,0,3,3
19778,3,1,69338,69338,69339,0,1,0
19779,2,2,69340,69340,69342,0,2,1
19780,6,1,69346,69346,69347,0,1,4
19781,4,2,69350,69350,69352,0,2,3
19782,4,1,69354,69354,69355,0,1,2
19783,4,2,69358,69358,69360,0,2,3
19784,5,2,69363,69363,69365,0,2,3
19785,4,1,69367,69367,69368,0,1,2
19786,6,2,69373,69373,69375,0,2,5
19787,2,3,69375,69375,69378,0,3,0
19788,5,3,69380,69380,69383,0,3,2
19789,5,3,69385,69385,69388,0,3,2
19790,6,1,69391,69391,69392,0,1,3
19791,2,2,69393,69393,69395,0,2,1
19792,4,1,69397,69397,69398,0,1,2
19793,5,1,69402,69402,69403,0,1,4
19794,2,2,69404,69404,69406,0,2,1
19795,5,3,69409,69409,69412,0,3,3
19796,6,2,69415,69415,69417,0,2,3
19797,6,2,69421,69421,69423,0,2,4
19798,2,1,69423,69423,69424,0,1,0
19799,1,3,69424,69424,69427,0,3,0
19800,1,3,69425,69427,69430,2,5,0
19801,3,3,69428,69430,69433,2,5,0
19802,6,2,69434,69434,69436,0,2,1
19803,1,3,69435,69436,69439,1,4,0
19804,5,2,69440,69440,69442,0,2,1
19805,3,3,69443,69443,69446,0,3,1
19806,2,2,69445,69446,69448,1,3,0
19807,4,2,69449,69449,69451,0,2,1
19808,2,1,69451,69451,69452,0,1,0
19809,5,2,69456,69456,69458,0,2,4
19810,2,3,69458,69458,69461,0,3,0
19811,2,2,69460,69461,69463,1,3,0
19812,4,3,69464,69464,69467,0,3,1
19813,6,2,69470,69470,69472,0,2,3
19814,3,1,69473,69473,69474,0,1,1
19815,2,1,69475,69475,69476,0,1,1
19816,4,1,69479,69479,69480,0,1,3
19817,3,1,69482,69482,69483,0,1,2
19818,4,3,69486,69486,69489,0,3,3
19819,6,1,69492,69492,69493,0,1,3
19820,1,1,69493,69493,69494,0,1,0
19821,6,2,69499,69499,69501,0,2,5
19822,5,2,69504,69504,69506,0,2,3
19823,2,1,69506,69506,69507,0,1,0
19824,2,1,69508,69508,69509,0,1,1
19825,4,1,69512,69512,69513,0,1,3
19826,5,2,69517,69517,69519,0,2,4
19827,2,1,69519,69519,69520,0,1,0
19828,2,2,69521,69521,69523,0,2,1
19829,2,2,69523,69523,69525,0,2,0
19830,4,3,69527,69527,69530,0,3,2
19831,2,2,69529,69530,69532,1,3,0
19832,1,2,69530,69532,69534,2,4,0
19833,3,3,69533,69534,69537,1,4,0
19834,3,1,69536,69537,69538,1,2,0
19835,3,2,69539,69539,69541,0,2,1
19836,4,3,69543,69543,69546,0,3,2
19837,6,1,69549,69549,69550,0,1,3
19838,3,3,69552,69552,69555,0,3,2
19839,2,3,69554,69555,69558,1,4,0
19840,4,3,69558,69558,69561,0,3,0
19841,1,1,69559,69561,69562,2,3,0
19842,5,2,69564,69564,69566,0,2,2
19843,6,3,69570,69570,69573,0,3,4
19844,5,2,69575,69575,69577,0,2,2
19845,4,3,69579,69579,69582,0,3,2
19846,5,1,69584,69584,69585,0,1,2
19847,5,3,69589,69589,69592,0,3,4
19848,5,2,69594,69594,69596,0,2,2
19849,5,2,69599,69599,69601,0,2,3
19850,3,3,69602,69602,69605,0,3,1
19851,3,3,69605,69605,69608,0,3,0
19852,2,1,69607,69608,69609,1,2,0
19853,2,1,69609,69609,69610,0,1,0
19854,6,2,69615,69615,69617,0,2,5
19855,5,2,69620,69620,69622,0,2,3
19856,4,2,69624,69624,69626,0,2,2
19857,4,2,69628,69628,69630,0,2,2
19858,2,3,69630,69630,69633,0,3,0
19859,4,3,69634,69634,69637,0,3,1
19860,3,3,69637,69637,69640,0,3,0
19861,3,2,69640,69640,69642,0,2,0
19862,3,1,69643,69643,69644,0,1,1
19863,1,2,69644,69644,69646,0,2,0
19864,2,1,69646,69646,69647,0,1,0
19865,4,3,69650,69650,69653,0,3,3
19866,4,1,69654,69654,69655,0,1,1
19867,2,3,69656,69656,69659,0,3,1
19868,2,3,69658,69659,69662,1,4,0
19869,6,2,69664,69664,69666,0,2,2
19870,4,3,69668,69668,69671,0,3,2
19871,1,3,69669,69671,69674,2,5,0
19872,1,2,69670,69674,69676,4,6,0
19873,3,3,69673,69676,69679,3,6,0
19874,3,2,69676,69679,69681,3,5,0
19875,6,2,69682,69682,69684,0,2,1
19876,2,3,69684,69684,69687,0,3,0
19877,1,1,69685,69687,69688,2,3,0
19878,3,2,69688,69688,69690,0,2,0
19879,2,3,69690,69690,69693,0,3,0
19880,4,3,69694,69694,69697,0,3,1
19881,2,2,69696,69697,69699,1,3,0
19882,1,2,69697,69699,69701,2,4,0
19883,6,1,69703,69703,69704,0,1,2
19884,5,3,69708,69708,69711,0,3,4
19885,1,3,69709,69711,69714,2,5,0
19886,6,1,69715,69715,69716,0,1,1
19887,6,2,69721,69721,69723,0,2,5
19888,4,3,69725,69725,69728,0,3,2
19889,3,2,69728,69728,69730,0,2,0
19890,1,1,69729,69730,69731,1,2,0
19891,4,1,69733,69733,69734,0,1,2
19892,5,1,69738,69738,69739,0,1,4
19893,1,2,69739,69739,69741,0,2,0
19894,6,1,69745,69745,69746,0,1,4
19895,3,3,69748,69748,69751,0,3,2
19896,3,1,69751,69751,69752,0,1,0
19897,4,2,69755,69755,69757,0,2,3
19898,2,2,69757,69757,69759,0,2,0
19899,2,2,69759,69759,69761,0,2,0
19900,3,1,69762,69762,69763,0,1,1
19901,6,2,69768,69768,69770,0,2,5
19902,2,2,69770,69770,69772,0,2,0
19903,5,1,69775,69775,69776,0,1,3
19904,4,1,69779,69779,69780,0,1,3
19905,5,3,69784,69784,69787,0,3,4
19906,2,3,69786,69787,69790,1,4,0
19907,6,2,69792,69792,69794,0,2,2
19908,6,2,69798,69798,69800,0,2,4
19909,5,3,69803,69803,69806,0,3,3
19910,3,3,69806,69806,69809,0,3,0
19911,4,1,69810,69810,69811,0,1,1
19912,6,3,69816,69816,69819,0,3,5
19913,2,3,69818,69819,69822,1,4,0
19914,4,1,69822,69822,69823,0,1,0
19915,2,1,69824,69824,69825,0,1,1
19916,2,1,69826,69826,69827,0,1,1
19917,4,2,69830,69830,69832,0,2,3
19918,2,2,69832,69832,69834,0,2,0
19919,2,3,69834,69834,69837,0,3,0
19920,3,1,69837,69837,69838,0,1,0
19921,6,1,69843,69843,69844,0,1,5
19922,4,3,69847,69847,69850,0,3,3
19923,2,3,69849,69850,69853,1,4,0
19924,2,1,69851,69853,69854,2,3,0
19925,6,1,69857,69857,69858,0,1,3
19926,3,2,69860,69860,69862,0,2,2
19927,5,2,69865,69865,69867,0,2,3
19928,6,2,69871,69871,69873,0,2,4
19929,2,2,69873,69873,69875,0,2,0
19930,1,1,69874,69875,69876,1,2,0
19931,1,2,69875,69876,69878,1,3,0
19932,4,2,69879,69879,69881,0,2,1
19933,3,1,69882,69882,69883,0,1,1
19934,2,2,69884,69884,69886,0,2,1
19935,3,2,69887,69887,69889,0,2,1
19936,4,3,69891,69891,69894,0,3,2
19937,3,1,69894,69894,69895,0,1,0
19938,1,1,69895,69895,69896,0,1,0
19939,1,3,69896,69896,69899,0,3,0
19940,1,1,69897,69899,69900,2,3,0
19941,6,2,69903,69903,69905,0,2,3
19942,6,3,69909,69909,69912,0,3,4
19943,4,2,69913,69913,69915,0,2,1
19944,4,1,69917,69917,69918,0,1,2
19945,1,1,69918,69918,69919,0,1,0
19946,3,1,69921,69921,69922,0,1,2
19947,3,2,69924,69924,69926,0,2,2
19948,3,3,69927,69927,69930,0,3,1
19949,1,1,69928,69930,69931,2,3,0
19950,3,3,69931,69931,69934,0,3,0
19951,3,3,69934,69934,69937,0,3,0
19952,1,3,69935,69937,69940,2,5,0
19953,2,1,69937,69940,69941,3,4,0
19954,3,2,69940,69941,69943,1,3,0
19955,1,3,69941,69943,69946,2,5,0
19956,1,2,69942,69946,69948,4,6,0
19957,4,2,69946,69948,69950,2,4,0
19958,6,2,69952,69952,69954,0,2,2
19959,6,3,69958,69958,69961,0,3,4
19960,2,2,69960,69961,69963,1,3,0
19961,2,1,69962,69963,69964,1,2,0
19962,3,1,69965,69965,69966,0,1,1
19963,2,2,69967,69967,69969,0,2,1
19964,5,2,69972,69972,69974,0,2,3
19965,6,2,69978,69978,69980,0,2,4
19966,4,1,69982,69982,69983,0,1,2
19967,5,2,69987,69987,69989,0,2,4
19968,2,2,69989,69989,69991,0,2,0
19969,2,2,69991,69991,69993,0,2,0
19970,4,3,69995,69995,69998,0,3,2
19971,1,3,69996,69998,70001,2,5,0
19972,3,3,69999,70001,70004,2,5,0
19973,3,3,70002,70004,70007,2,5,0
19974,2,3,70004,70007,70010,3,6,0
19975,2,3,70006,70010,70013,4,7,0
19976,3,1,70009,70013,70014,4,5,0
19977,3,1,70012,70014,70015,2,3,0
19978,4,3,70016,70016,70019,0,3,1
19979,3,2,70019,70019,70021,0,2,0
19980,3,1,70022,70022,70023,0,1,1
19981,1,1,70023,70023,70024,0,1,0
19982,2,3,70025,70025,70028,0,3,1
19983,6,1,70031,70031,70032,0,1,3
19984,3,2,70034,70034,70036,0,2,2
19985,6,2,70040,70040,70042,0,2,4
19986,4,1,70044,70044,70045,0,1,2
19987,2,1,70046,70046,70047,0,1,1
19988,1,1,70047,70047,70048,0,1,0
19989,5,2,70052,70052,70054,0,2,4
19990,1,2,70053,70054,70056,1,3,0
19991,2,2,70055,70056,70058,1,3,0
19992,1,1,70056,70058,70059,2,3,0
19993,3,1,70059,70059,70060,0,1,0
19994,6,2,70065,70065,70067,0,2,5
19995,4,2,70069,70069,70071,0,2,2
19996,1,2,70070,70071,70073,1,3,0
19997,2,1,70072,70073,70074,1,2,0
19998,5,1,70077,70077,70078,0,1,3
19999,6,3,70083,70083,70086,0,3,5
20000,2,3,70085,70086,70089,1,4,0
20001,1,3,70086,70089,70092,3,6,0
20002,6,3,70092,70092,70095,0,3,0
20003,5,1,70097,70097,70098,0,1,2
20004,2,2,70099,70099,70101,0,2,1
20005,1,3,70100,70101,70104,1,4,0
20006,3,3,70103,70104,70107,1,4,0
20007,5,2,70108,70108,70110,0,2,1
20008,2,3,70110,70110,70113,0,3,0
20009,2,3,70112,70113,70116,1,4,0
20010,2,1,70114,70116,70117,2,3,0
20011,5,1,70119,70119,70120,0,1,2
20012,1,1,70120,70120,70121,0,1,0
20013,1,1,70121,70121,70122,0,1,0
20014,6,3,70127,70127,70130,0,3,5
20015,5,1,70132,70132,70133,0,1,2
20016,1,2,70133,70133,70135,0,2,0
20017,2,3,70135,70135,70138,0,3,0
20018,3,3,70138,70138,70141,0,3,0
20019,4,1,70142,70142,70143,0,1,1
20020,2,2,70144,70144,70146,0,2,1
20021,5,1,70149,70149,70150,0,1,3
20022,1,3,70150,70150,70153,0,3,0
20023,1,2,70151,70153,70155,2,4,0
20024,3,1,70154,70155,70156,1,2,0
20025,3,2,70157,70157,70159,0,2,1
20026,5,2,70162,70162,70164,0,2,3
20027,6,1,70168,70168,70169,0,1,4
20028,5,1,70173,70173,70174,0,1,4
20029,5,1,70178,70178,70179,0,1,4
20030,2,3,70180,70180,70183,0,3,1
20031,2,3,70182,70183,70186,1,4,0
20032,3,1,70185,70186,70187,1,2,0
20033,1,1,70186,70187,70188,1,2,0
20034,4,2,70190,70190,70192,0,2,2
20035,6,2,70196,70196,70198,0,2,4
20036,3,1,70199,70199,70200,0,1,1
20037,1,2,70200,70200,70202,0,2,0
20038,4,2,70204,70204,70206,0,2,2
20039,1,3,70205,70206,70209,1,4,0
20040,6,2,70211,70211,70213,0,2,2
20041,4,2,70215,70215,70217,0,2,2
20042,5,2,70220,70220,70222,0,2,3
20043,2,1,70222,70222,70223,0,1,0
20044,6,3,70228,70228,70231,0,3,5
20045,5,3,70233,70233,70236,0,3,2
20046,2,2,70235,70236,70238,1,3,0
20047,2,1,70237,70238,70239,1,2,0
20048,5,3,70242,70242,70245,0,3,3
20049,2,2,70244,70245,70247,1,3,0
20050,6,2,70250,70250,70252,0,2,3
20051,5,3,70255,70255,70258,0,3,3
20052,3,2,70258,70258,70260,0,2,0
20053,6,2,70264,70264,70266,0,2,4
20054,6,2,70270,70270,70272,0,2,4
20055,4,1,70274,70274,70275,0,1,2
20056,4,2,70278,70278,70280,0,2,3
20057,3,3,70281,70281,70284,0,3,1
20058,1,3,70282,70284,70287,2,5,0
20059,5,2,70287,70287,70289,0,2,0
20060,6,2,70293,70293,70295,0,2,4
20061,5,3,70298,70298,70301,0,3,3
20062,4,2,70302,70302,70304,0,2,1
20063,3,1,70305,70305,70306,0,1,1
20064,4,2,70309,70309,70311,0,2,3
20065,1,2,70310,70311,70313,1,3,0
20066,5,3,70315,70315,70318,0,3,2
20067,3,3,70318,70318,70321,0,3,0
20068,6,1,70324,70324,70325,0,1,3
20069,5,3,70329,70329,70332,0,3,4
20070,1,1,70330,70332,70333,2,3,0
20071,3,3,70333,70333,70336,0,3,0
20072,4,2,70337,70337,70339,0,2,1
20073,6,1,70343,70343,70344,0,1,4
20074,6,2,70349,70349,70351,0,2,5
20075,4,2,70353,70353,70355,0,2,2
20076,4,2,70357,70357,70359,0,2,2
20077,5,2,70362,70362,70364,0,2,3
20078,6,3,70368,70368,70371,0,3,4
20079,2,2,70370,70371,70373,1,3,0
20080,1,1,70371,70373,70374,2,3,0
20081,4,3,70375,70375,70378,0,3,1
20082,5,1,70380,70380,70381,0,1,2
20083,3,1,70383,70383,70384,0,1,2
20084,2,1,70385,70385,70386,0,1,1
20085,4,2,70389,70389,70391,0,2,3
20086,4,3,70393,70393,70396,0,3,2
20087,3,2,70396,70396,70398,0,2,0
20088,4,3,70400,70400,70403,0,3,2
20089,3,1,70403,70403,70404,0,1,0
20090,2,3,70405,70405,70408,0,3,1
20091,2,3,70407,70408,70411,1,4,0
20092,6,3,70413,70413,70416,0,3,2
20093,1,2,70414,70416,70418,2,4,0
20094,4,1,70418,70418,70419,0,1,0
20095,6,2,70424,70424,70426,0,2,5
20096,4,2,70428,70428,70430,0,2,2
20097,2,3,70430,70430,70433,0,3,0
20098,1,3,70431,70433,70436,2,5,0
20099,5,3,70436,70436,70439,0,3,0
20100,3,1,70439,70439,70440,0,1,0
20101,3,1,70442,70442,70443,0,1,2
20102,3,3,70445,70445,70448,0,3,2
20103,4,1,70449,70449,70450,0,1,1
20104,1,2,70450,70450,70452,0,2,0
20105,1,3,70451,70452,70455,1,4,0
20106,1,3,70452,70455,70458,3,6,0
20107,5,1,70457,70458,70459,1,2,0
20108,1,3,70458,70459,70462,1,4,0
20109,1,2,70459,70462,70464,3,5,0
20110,3,3,70462,70464,70467,2,5,0
20111,1,3,70463,70467,70470,4,7,0
20112,6,1,70469,70470,70471,1,2,0
20113,2,1,70471,70471,70472,0,1,0
20114,1,3,70472,70472,70475,0,3,0
20115,6,1,70478,70478,70479,0,1,3
20116,5,2,70483,70483,70485,0,2,4
20117,2,1,70485,70485,70486,0,1,0
20118,2,2,70487,70487,70489,0,2,1
20119,1,3,70488,70489,70492,1,4,0
20120,4,1,70492,70492,70493,0,1,0
20121,6,2,70498,70498,70500,0,2,5
20122,4,1,70502,70502,70503,0,1,2
20123,1,3,70503,70503,70506,0,3,0
20124,5,1,70508,70508,70509,0,1,2
20125,4,3,70512,70512,70515,0,3,3
20126,5,2,70517,70517,70519,0,2,2
20127,3,2,70520,70520,70522,0,2,1
20128,2,3,70522,70522,70525,0,3,0
20129,3,3,70525,70525,70528,0,3,0
20130,2,3,70527,70528,70531,1,4,0
20131,2,2,70529,70531,70533,2,4,0
20132,2,1,70531,70533,70534,2,3,0
20133,5,2,70536,70536,70538,0,2,2
20134,2,2,70538,70538,70540,0,2,0
20135,2,3,70540,70540,70543,0,3,0
20136,4,3,70544,70544,70547,0,3,1
20137,3,1,70547,70547,70548,0,1,0
20138,1,3,70548,70548,70551,0,3,0
20139,4,3,70552,70552,70555,0,3,1
20140,3,1,70555,70555,70556,0,1,0
20141,6,1,70561,70561,70562,0,1,5
20142,1,3,70562,70562,70565,0,3,0
20143,1,2,70563,70565,70567,2,4,0
20144,5,3,70568,70568,70571,0,3,1
20145,3,1,70571,70571,70572,0,1,0
20146,5,1,70576,70576,70577,0,1,4
20147,4,1,70580,70580,70581,0,1,3
20148,4,1,70584,70584,70585,0,1,3
20149,6,3,70590,70590,70593,0,3,5
20150,5,3,70595,70595,70598,0,3,2
20151,1,3,70596,70598,70601,2,5,0
20152,2,2,70598,70601,70603,3,5,0
20153,3,3,70601,70603,70606,2,5,0
20154,2,1,70603,70606,70607,3,4,0
20155,4,2,70607,70607,70609,0,2,0
20156,2,1,70609,70609,70610,0,1,0
20157,2,1,70611,70611,70612,0,1,1
20158,2,1,70613,70613,70614,0,1,1
20159,2,3,70615,70615,70618,0,3,1
20160,5,3,70620,70620,70623,0,3,2
20161,3,1,70623,70623,70624,0,1,0
20162,3,1,70626,70626,70627,0,1,2
20163,2,3,70628,70628,70631,0,3,1
20164,5,1,70633,70633,70634,0,1,2
20165,1,3,70634,70634,70637,0,3,0
20166,6,1,70640,70640,70641,0,1,3
20167,4,1,70644,70644,70645,0,1,3
20168,2,3,70646,70646,70649,0,3,1
20169,1,2,70647,70649,70651,2,4,0
20170,2,3,70649,70651,70654,2,5,0
20171,5,1,70654,70654,70655,0,1,0
20172,1,3,70655,70655,70658,0,3,0
20173,6,3,70661,70661,70664,0,3,3
20174,2,3,70663,70664,70667,1,4,0
20175,4,1,70667,70667,70668,0,1,0
20176,2,3,70669,70669,70672,0,3,1
20177,1,3,70670,70672,70675,2,5,0
20178,6,1,70676,70676,70677,0,1,1
20179,3,2,70679,70679,70681,0,2,2
20180,2,1,70681,70681,70682,0,1,0
20181,4,3,70685,70685,70688,0,3,3
20182,2,2,70687,70688,70690,1,3,0
20183,1,1,70688,70690,70691,2,3,0
20184,1,3,70689,70691,70694,2,5,0
20185,5,3,70694,70694,70697,0,3,0
20186,5,3,70699,70699,70702,0,3,2
20187,2,2,70701,70702,70704,1,3,0
20188,6,2,70707,70707,70709,0,2,3
20189,6,3,70713,70713,70716,0,3,4
20190,6,3,70719,70719,70722,0,3,3
20191,1,3,70720,70722,70725,2,5,0
20192,3,2,70723,70725,70727,2,4,0
20193,3,1,70726,70727,70728,1,2,0
20194,2,2,70728,70728,70730,0,2,0
20195,5,3,70733,70733,70736,0,3,3
20196,5,3,70738,70738,70741,0,3,2
20197,4,2,70742,70742,70744,0,2,1
20198,5,2,70747,70747,70749,0,2,3
20199,6,1,70753,70753,70754,0,1,4
20200,4,2,70757,70757,70759,0,2,3
20201,6,1,70763,70763,70764,0,1,4
20202,4,3,70767,70767,70770,0,3,3
20203,3,1,70770,70770,70771,0,1,0
20204,3,3,70773,70773,70776,0,3,2
20205,3,3,70776,70776,70779,0,3,0
20206,5,2,70781,70781,70783,0,2,2
20207,2,3,70783,70783,70786,0,3,0
20208,3,3,70786,70786,70789,0,3,0
20209,5,2,70791,70791,70793,0,2,2
20210,2,1,70793,70793,70794,0,1,0
20211,6,3,70799,70799,70802,0,3,5
20212,5,1,70804,70804,70805,0,1,2
20213,2,1,70806,70806,70807,0,1,1
20214,3,1,70809,70809,70810,0,1,2
20215,1,2,70810,70810,70812,0,2,0
20216,2,3,70812,70812,70815,0,3,0
20217,3,3,70815,70815,70818,0,3,0
20218,5,3,70820,70820,70823,0,3,2
20219,5,2,70825,70825,70827,0,2,2
20220,1,3,70826,70827,70830,1,4,0
20221,5,1,70831,70831,70832,0,1,1
20222,4,3,70835,70835,70838,0,3,3
20223,4,2,70839,70839,70841,0,2,1
20224,2,1,70841,70841,70842,0,1,0
20225,4,3,70845,70845,70848,0,3,3
20226,3,2,70848,70848,70850,0,2,0
20227,6,1,70854,70854,70855,0,1,4
20228,3,3,70857,70857,70860,0,3,2
20229,2,2,70859,70860,70862,1,3,0
20230,2,3,70861,70862,70865,1,4,0
20231,1,1,70862,70865,70866,3,4,0
20232,1,3,70863,70866,70869,3,6,0
20233,6,1,70869,70869,70870,0,1,0
20234,1,1,70870,70870,70871,0,1,0
20235,1,3,70871,70871,70874,0,3,0
20236,1,1,70872,70874,70875,2,3,0
20237,5,2,70877,70877,70879,0,2,2
20238,6,3,70883,70883,70886,0,3,4
20239,4,1,70887,70887,70888,0,1,1
20240,6,3,70893,70893,70896,0,3,5
20241,3,2,70896,70896,70898,0,2,0
20242,1,3,70897,70898,70901,1,4,0
20243,2,2,70899,70901,70903,2,4,0
20244,1,1,70900,70903,70904,3,4,0
20245,4,1,70904,70904,70905,0,1,0
20246,1,2,70905,70905,70907,0,2,0
20247,3,1,70908,70908,70909,0,1,1
20248,4,1,70912,70912,70913,0,1,3
20249,3,1,70915,70915,70916,0,1,2
20250,2,2,70917,70917,70919,0,2,1
20251,3,1,70920,70920,70921,0,1,1
20252,6,1,70926,70926,70927,0,1,5
20253,2,3,70928,70928,70931,0,3,1
20254,4,1,70932,70932,70933,0,1,1
20255,4,3,70936,70936,70939,0,3,3
20256,2,2,70938,70939,70941,1,3,0
20257,5,2,70943,70943,70945,0,2,2
20258,4,2,70947,70947,70949,0,2,2
20259,4,2,70951,70951,70953,0,2,2
20260,2,1,70953,70953,70954,0,1,0
20261,5,3,70958,70958,70961,0,3,4
20262,1,1,70959,70961,70962,2,3,0
20263,4,2,70963,70963,70965,0,2,1
20264,4,3,70967,70967,70970,0,3,2
20265,2,1,70969,70970,70971,1,2,0
20266,4,3,70973,70973,70976,0,3,2
20267,5,2,70978,70978,70980,0,2,2
20268,5,3,70983,70983,70986,0,3,3
20269,5,2,70988,70988,70990,0,2,2
20270,4,1,70992,70992,70993,0,1,2
20271,1,1,70993,70993,70994,0,1,0
20272,4,1,70997,70997,70998,0,1,3
20273,2,1,70999,70999,71000,0,1,1
20274,4,2,71003,71003,71005,0,2,3
20275,6,1,71009,71009,71010,0,1,4
20276,6,3,71015,71015,71018,0,3,5
20277,5,1,71020,71020,71021,0,1,2
20278,4,1,71024,71024,71025,0,1,3
20279,4,1,71028,71028,71029,0,1,3
20280,2,1,71030,71030,71031,0,1,1
20281,2,1,71032,71032,71033,0,1,1
20282,3,2,71035,71035,71037,0,2,2
20283,5,2,71040,71040,71042,0,2,3
20284,3,1,71043,71043,71044,0,1,1
20285,3,1,71046,71046,71047,0,1,2
20286,6,3,71052,71052,71055,0,3,5
20287,3,2,71055,71055,71057,0,2,0
20288,1,2,71056,71057,71059,1,3,0
20289,2,2,71058,71059,71061,1,3,0
20290,3,3,71061,71061,71064,0,3,0
20291,1,1,71062,71064,71065,2,3,0
20292,4,2,71066,71066,71068,0,2,1
20293,6,3,71072,71072,71075,0,3,4
20294,4,3,71076,71076,71079,0,3,1
20295,6,3,71082,71082,71085,0,3,3
20296,2,2,71084,71085,71087,1,3,0
20297,1,2,71085,71087,71089,2,4,0
20298,1,1,71086,71089,71090,3,4,0
20299,1,2,71087,71090,71092,3,5,0
20300,1,3,71088,71092,71095,4,7,0
20301,1,2,71089,71095,71097,6,8,0
20302,5,2,71094,71097,71099,3,5,0
20303,2,2,71096,71099,71101,3,5,0
20304,4,3,71100,71101,71104,1,4,0
20305,2,2,71102,71104,71106,2,4,0
20306,1,1,71103,71106,71107,3,4,0
20307,3,3,71106,71107,71110,1,4,0
20308,4,2,71110,71110,71112,0,2,0
20309,2,2,71112,71112,71114,0,2,0
20310,5,3,71117,71117,71120,0,3,3
20311,5,3,71122,71122,71125,0,3,2
20312,5,3,71127,71127,71130,0,3,2
20313,3,1,71130,71130,71131,0,1,0
20314,4,1,71134,71134,71135,0,1,3
20315,4,1,71138,71138,71139,0,1,3
20316,5,1,71143,71143,71144,0,1,4
20317,2,1,71145,71145,71146,0,1,1
20318,3,1,71148,71148,71149,0,1,2
20319,2,1,71150,71150,71151,0,1,1
20320,3,1,71153,71153,71154,0,1,2
20321,4,3,71157,71157,71160,0,3,3
20322,2,2,71159,71160,71162,1,3,0
20323,5,1,71164,71164,71165,0,1,2
20324,4,3,71168,71168,71171,0,3,3
20325,5,1,71173,71173,71174,0,1,2
20326,6,1,71179,71179,71180,0,1,5
20327,5,1,71184,71184,71185,0,1,4
20328,4,1,71188,71188,71189,0,1,3
20329,5,3,71193,71193,71196,0,3,4
20330,4,2,71197,71197,71199,0,2,1
20331,4,1,71201,71201,71202,0,1,2
20332,6,2,71207,71207,71209,0,2,5
20333,6,3,71213,71213,71216,0,3,4
20334,1,3,71214,71216,71219,2,5,0
20335,4,3,71218,71219,71222,1,4,0
20336,4,2,71222,71222,71224,0,2,0
20337,4,1,71226,71226,71227,0,1,2
20338,1,1,71227,71227,71228,0,1,0
20339,5,2,71232,71232,71234,0,2,4
20340,4,3,71236,71236,71239,0,3,2
20341,4,2,71240,71240,71242,0,2,1
20342,3,1,71243,71243,71244,0,1,1
20343,3,2,71246,71246,71248,0,2,2
20344,2,2,71248,71248,71250,0,2,0
20345,4,3,71252,71252,71255,0,3,2
20346,6,1,71258,71258,71259,0,1,3
20347,1,1,71259,71259,71260,0,1,0
20348,4,2,71263,71263,71265,0,2,3
20349,6,1,71269,71269,71270,0,1,4
20350,2,1,71271,71271,71272,0,1,1
20351,5,3,71276,71276,71279,0,3,4
20352,3,2,71279,71279,71281,0,2,0
20353,2,2,71281,71281,71283,0,2,0
20354,5,2,71286,71286,71288,0,2,3
20355,6,1,71292,71292,71293,0,1,4
20356,4,1,71296,71296,71297,0,1,3
20357,5,2,71301,71301,71303,0,2,4
20358,2,1,71303,71303,71304,0,1,0
20359,4,2,71307,71307,71309,0,2,3
20360,5,3,71312,71312,71315,0,3,3
20361,5,1,71317,71317,71318,0,1,2
20362,3,2,71320,71320,71322,0,2,2
20363,2,1,71322,71322,71323,0,1,0
20364,2,2,71324,71324,71326,0,2,1
20365,5,3,71329,71329,71332,0,3,3
20366,3,2,71332,71332,71334,0,2,0
20367,1,1,71333,71334,71335,1,2,0
20368,3,2,71336,71336,71338,0,2,1
20369,4,2,71340,71340,71342,0,2,2
20370,5,2,71345,71345,71347,0,2,3
20371,1,3,71346,71347,71350,1,4,0
20372,4,2,71350,71350,71352,0,2,0
20373,3,2,71353,71353,71355,0,2,1
20374,5,2,71358,71358,71360,0,2,3
20375,3,2,71361,71361,71363,0,2,1
20376,3,1,71364,71364,71365,0,1,1
20377,2,1,71366,71366,71367,0,1,1
20378,1,1,71367,71367,71368,0,1,0
20379,6,2,71373,71373,71375,0,2,5
20380,3,1,71376,71376,71377,0,1,1
20381,1,2,71377,71377,71379,0,2,0
20382,4,2,71381,71381,71383,0,2,2
20383,6,1,71387,71387,71388,0,1,4
20384,4,3,71391,71391,71394,0,3,3
20385,1,2,71392,71394,71396,2,4,0
20386,2,1,71394,71396,71397,2,3,0
20387,4,1,71398,71398,71399,0,1,1
20388,2,2,71400,71400,71402,0,2,1
20389,4,3,71404,71404,71407,0,3,2
20390,1,2,71405,71407,71409,2,4,0
20391,2,2,71407,71409,71411,2,4,0
20392,5,2,71412,71412,71414,0,2,1
20393,2,3,71414,71414,71417,0,3,0
20394,6,1,71420,71420,71421,0,1,3
20395,2,2,71422,71422,71424,0,2,1
20396,1,2,71423,71424,71426,1,3,0
20397,5,2,71428,71428,71430,0,2,2
20398,4,2,71432,71432,71434,0,2,2
20399,4,3,71436,71436,71439,0,3,2
20400,6,1,71442,71442,71443,0,1,3
20401,1,2,71443,71443,71445,0,2,0
20402,1,3,71444,71445,71448,1,4,0
20403,6,3,71450,71450,71453,0,3,2
20404,2,2,71452,71453,71455,1,3,0
20405,3,3,71455,71455,71458,0,3,0
20406,2,1,71457,71458,71459,1,2,0
20407,6,2,71463,71463,71465,0,2,4
20408,5,3,71468,71468,71471,0,3,3
20409,1,3,71469,71471,71474,2,5,0
20410,2,3,71471,71474,71477,3,6,0
20411,6,1,71477,71477,71478,0,1,0
20412,1,3,71478,71478,71481,0,3,0
20413,6,1,71484,71484,71485,0,1,3
20414,1,3,71485,71485,71488,0,3,0
20415,4,2,71489,71489,71491,0,2,1
20416,6,1,71495,71495,71496,0,1,4
20417,5,3,71500,71500,71503,0,3,4
20418,3,3,71503,71503,71506,0,3,0
20419,2,1,71505,71506,71507,1,2,0
20420,1,3,71506,71507,71510,1,4,0
20421,2,3,71508,71510,71513,2,5,0
20422,2,3,71510,71513,71516,3,6,0
20423,4,2,71514,71516,71518,2,4,0
20424,3,3,71517,71518,71521,1,4,0
20425,5,3,71522,71522,71525,0,3,1
20426,2,1,71524,71525,71526,1,2,0
20427,2,1,71526,71526,71527,0,1,0
20428,2,2,71528,71528,71530,0,2,1
20429,3,2,71531,71531,71533,0,2,1
20430,6,2,71537,71537,71539,0,2,4
20431,1,1,71538,71539,71540,1,2,0
20432,2,1,71540,71540,71541,0,1,0
20433,2,2,71542,71542,71544,0,2,1
20434,6,2,71548,71548,71550,0,2,4
20435,5,2,71553,71553,71555,0,2,3
20436,4,2,71557,71557,71559,0,2,2
20437,4,1,71561,71561,71562,0,1,2
20438,4,2,71565,71565,71567,0,2,3
20439,4,2,71569,71569,71571,0,2,2
20440,4,2,71573,71573,71575,0,2,2
20441,3,1,71576,71576,71577,0,1,1
20442,2,1,71578,71578,71579,0,1,1
20443,2,1,71580,71580,71581,0,1,1
20444,2,1,71582,71582,71583,0,1,1
20445,5,1,71587,71587,71588,0,1,4
20446,2,1,71589,71589,71590,0,1,1
20447,2,1,71591,71591,71592,0,1,1
20448,4,3,71595,71595,71598,0,3,3
20449,2,2,71597,71598,71600,1,3,0
20450,6,3,71603,71603,71606,0,3,3
20451,3,1,71606,71606,71607,0,1,0
20452,4,2,71610,71610,71612,0,2,3
20453,2,1,71612,71612,71613,0,1,0
20454,3,2,71615,71615,71617,0,2,2
20455,5,1,71620,71620,71621,0,1,3
20456,3,1,71623,71623,71624,0,1,2
20457,1,2,71624,71624,71626,0,2,0
20458,6,1,71630,71630,71631,0,1,4
20459,5,3,71635,71635,71638,0,3,4
20460,1,1,71636,71638,71639,2,3,0
20461,4,3,71640,71640,71643,0,3,1
20462,1,3,71641,71643,71646,2,5,0
20463,6,2,71647,71647,71649,0,2,1
20464,1,2,71648,71649,71651,1,3,0
20465,1,2,71649,71651,71653,2,4,0
20466,4,2,71653,71653,71655,0,2,0
20467,1,2,71654,71655,71657,1,3,0
20468,4,1,71658,71658,71659,0,1,1
20469,5,3,71663,71663,71666,0,3,4
20470,5,3,71668,71668,71671,0,3,2
20471,5,3,71673,71673,71676,0,3,2
20472,1,1,71674,71676,71677,2,3,0
20473,6,3,71680,71680,71683,0,3,3
20474,2,1,71682,71683,71684,1,2,0
20475,3,1,71685,71685,71686,0,1,1
20476,1,3,71686,71686,71689,0,3,0
20477,2,2,71688,71689,71691,1,3,0
20478,6,3,71694,71694,71697,0,3,3
20479,1,3,71695,71697,71700,2,5,0
20480,5,3,71700,71700,71703,0,3,0
20481,5,1,71705,71705,71706,0,1,2
20482,4,1,71709,71709,71710,0,1,3
20483,6,2,71715,71715,71717,0,2,5
20484,5,1,71720,71720,71721,0,1,3
20485,5,1,71725,71725,71726,0,1,4
20486,4,1,71729,71729,71730,0,1,3
20487,2,2,71731,71731,71733,0,2,1
20488,5,2,71736,71736,71738,0,2,3
20489,6,2,71742,71742,71744,0,2,4
20490,5,3,71747,71747,71750,0,3,3
20491,2,1,71749,71750,71751,1,2,0
20492,3,2,71752,71752,71754,0,2,1
20493,3,2,71755,71755,71757,0,2,1
20494,4,2,71759,71759,71761,0,2,2
20495,2,1,71761,71761,71762,0,1,0
20496,3,1,71764,71764,71765,0,1,2
20497,5,2,71769,71769,71771,0,2,4
20498,3,2,71772,71772,71774,0,2,1
20499,1,2,71773,71774,71776,1,3,0
20500,5,3,71778,71778,71781,0,3,2
20501,3,3,71781,71781,71784,0,3,0
20502,1,1,71782,71784,71785,2,3,0
20503,1,3,71783,71785,71788,2,5,0
20504,6,1,71789,71789,71790,0,1,1
20505,6,3,71795,71795,71798,0,3,5
20506,5,2,71800,71800,71802,0,2,2
20507,1,3,71801,71802,71805,1,4,0
20508,1,3,71802,71805,71808,3,6,0
20509,3,1,71805,71808,71809,3,4,0
20510,5,1,71810,71810,71811,0,1,1
20511,5,3,71815,71815,71818,0,3,4
20512,5,3,71820,71820,71823,0,3,2
20513,1,2,71821,71823,71825,2,4,0
20514,6,1,71827,71827,71828,0,1,2
20515,4,1,71831,71831,71832,0,1,3
20516,4,2,71835,71835,71837,0,2,3
20517,2,1,71837,71837,71838,0,1,0
20518,4,1,71841,71841,71842,0,1,3
20519,5,3,71846,71846,71849,0,3,4
20520,6,2,71852,71852,71854,0,2,3
20521,4,1,71856,71856,71857,0,1,2
20522,6,1,71862,71862,71863,0,1,5
20523,1,3,71863,71863,71866,0,3,0
20524,1,1,71864,71866,71867,2,3,0
20525,1,3,71865,71867,71870,2,5,0
20526,3,3,71868,71870,71873,2,5,0
20527,3,3,71871,71873,71876,2,5,0
20528,3,2,71874,71876,71878,2,4,0
20529,5,3,71879,71879,71882,0,3,1
20530,5,2,71884,71884,71886,0,2,2
20531,2,2,71886,71886,71888,0,2,0
20532,1,2,71887,71888,71890,1,3,0
20533,5,2,71892,71892,71894,0,2,2
20534,1,2,71893,71894,71896,1,3,0
20535,6,2,71899,71899,71901,0,2,3
20536,2,2,71901,71901,71903,0,2,0
20537,4,2,71905,71905,71907,0,2,2
20538,6,3,71911,71911,71914,0,3,4
20539,5,2,71916,71916,71918,0,2,2
20540,4,2,71920,71920,71922,0,2,2
20541,6,3,71926,71926,71929,0,3,4
20542,5,1,71931,71931,71932,0,1,2
20543,4,2,71935,71935,71937,0,2,3
20544,4,1,71939,71939,71940,0,1,2
20545,6,2,71945,71945,71947,0,2,5
20546,4,1,71949,71949,71950,0,1,2
20547,2,1,71951,71951,71952,0,1,1
20548,6,2,71957,71957,71959,0,2,5
20549,2,1,71959,71959,71960,0,1,0
20550,6,3,71965,71965,71968,0,3,5
20551,5,3,71970,71970,71973,0,3,2
20552,2,1,71972,71973,71974,1,2,0
20553,4,3,71976,71976,71979,0,3,2
20554,4,2,71980,71980,71982,0,2,1
20555,2,3,71982,71982,71985,0,3,0
20556,4,2,71986,71986,71988,0,2,1
20557,1,2,71987,71988,71990,1,3,0
20558,3,3,71990,71990,71993,0,3,0
20559,5,3,71995,71995,71998,0,3,2
20560,3,1,71998,71998,71999,0,1,0
20561,4,3,72002,72002,72005,0,3,3
20562,5,3,72007,72007,72010,0,3,2
20563,2,2,72009,72010,72012,1,3,0
20564,3,2,72012,72012,72014,0,2,0
20565,4,2,72016,72016,72018,0,2,2
20566,5,3,72021,72021,72024,0,3,3
20567,6,2,72027,72027,72029,0,2,3
20568,5,2,72032,72032,72034,0,2,3
20569,1,3,72033,72034,72037,1,4,0
20570,2,3,72035,72037,72040,2,5,0
20571,1,3,72036,72040,72043,4,7,0
20572,1,1,72037,72043,72044,6,7,0
20573,1,2,72038,72044,72046,6,8,0
20574,1,1,72039,72046,72047,7,8,0
20575,5,3,72044,72047,72050,3,6,0
20576,6,1,72050,72050,72051,0,1,0
20577,4,3,72054,72054,72057,0,3,3
20578,4,3,72058,72058,72061,0,3,1
20579,2,3,72060,72061,72064,1,4,0
20580,2,3,72062,72064,72067,2,5,0
20581,6,3,72068,72068,72071,0,3,1
20582,1,1,72069,72071,72072,2,3,0
20583,3,1,72072,72072,72073,0,1,0
20584,3,2,72075,72075,72077,0,2,2
20585,3,3,72078,72078,72081,0,3,1
20586,1,1,72079,72081,72082,2,3,0
20587,4,3,72083,72083,72086,0,3,1
20588,3,3,72086,72086,72089,0,3,0
20589,3,3,72089,72089,72092,0,3,0
20590,2,3,72091,72092,72095,1,4,0
20591,5,1,72096,72096,72097,0,1,1
20592,2,1,72098,72098,72099,0,1,1
20593,1,2,72099,72099,72101,0,2,0
20594,5,2,72104,72104,72106,0,2,3
20595,3,2,72107,72107,72109,0,2,1
20596,5,1,72112,72112,72113,0,1,3
20597,3,3,72115,72115,72118,0,3,2
20598,5,2,72120,72120,72122,0,2,2
20599,4,1,72124,72124,72125,0,1,2
20600,2,1,72126,72126,72127,0,1,1
20601,2,2,72128,72128,72130,0,2,1
20602,6,2,72134,72134,72136,0,2,4
20603,1,3,72135,72136,72139,1,4,0
20604,5,1,72140,72140,72141,0,1,1
20605,6,2,72146,72146,72148,0,2,5
20606,4,2,72150,72150,72152,0,2,2
20607,5,3,72155,72155,72158,0,3,3
20608,2,1,72157,72158,72159,1,2,0
20609,3,3,72160,72160,72163,0,3,1
20610,4,1,72164,72164,72165,0,1,1
20611,2,1,72166,72166,72167,0,1,1
20612,4,3,72170,72170,72173,0,3,3
20613,5,2,72175,72175,72177,0,2,2
20614,2,2,72177,72177,72179,0,2,0
20615,2,1,72179,72179,72180,0,1,0
20616,4,3,72183,72183,72186,0,3,3
20617,6,1,72189,72189,72190,0,1,3
20618,5,1,72194,72194,72195,0,1,4
20619,5,1,72199,72199,72200,0,1,4
20620,5,3,72204,72204,72207,0,3,4
20621,1,2,72205,72207,72209,2,4,0
20622,6,2,72211,72211,72213,0,2,2
20623,1,2,72212,72213,72215,1,3,0
20624,3,2,72215,72215,72217,0,2,0
20625,2,2,72217,72217,72219,0,2,0
20626,4,2,72221,72221,72223,0,2,2
20627,4,1,72225,72225,72226,0,1,2
20628,5,2,72230,72230,72232,0,2,4
20629,1,2,72231,72232,72234,1,3,0
20630,5,2,72236,72236,72238,0,2,2
20631,3,2,72239,72239,72241,0,2,1
20632,5,3,72244,72244,72247,0,3,3
20633,6,1,72250,72250,72251,0,1,3
20634,2,1,72252,72252,72253,0,1,1
20635,6,1,72258,72258,72259,0,1,5
20636,5,3,72263,72263,72266,0,3,4
20637,1,1,72264,72266,72267,2,3,0
20638,1,1,72265,72267,72268,2,3,0
20639,2,1,72267,72268,72269,1,2,0
20640,2,1,72269,72269,72270,0,1,0
20641,2,2,72271,72271,72273,0,2,1
20642,4,1,72275,72275,72276,0,1,2
20643,3,3,72278,72278,72281,0,3,2
20644,5,2,72283,72283,72285,0,2,2
20645,1,1,72284,72285,72286,1,2,0
20646,2,3,72286,72286,72289,0,3,0
20647,1,2,72287,72289,72291,2,4,0
20648,4,3,72291,72291,72294,0,3,0
20649,5,1,72296,72296,72297,0,1,2
20650,3,1,72299,72299,72300,0,1,2
20651,5,1,72304,72304,72305,0,1,4
20652,6,3,72310,72310,72313,0,3,5
20653,4,1,72314,72314,72315,0,1,1
20654,2,3,72316,72316,72319,0,3,1
20655,1,1,72317,72319,72320,2,3,0
20656,3,1,72320,72320,72321,0,1,0
20657,1,1,72321,72321,72322,0,1,0
20658,2,1,72323,72323,72324,0,1,1
20659,3,2,72326,72326,72328,0,2,2
20660,6,2,72332,72332,72334,0,2,4
20661,4,2,72336,72336,72338,0,2,2
20662,6,2,72342,72342,72344,0,2,4
20663,1,2,72343,72344,72346,1,3,0
20664,1,3,72344,72346,72349,2,5,0
20665,2,2,72346,72349,72351,3,5,0
20666,4,3,72350,72351,72354,1,4,0
20667,4,2,72354,72354,72356,0,2,0
20668,4,3,72358,72358,72361,0,3,2
20669,3,3,72361,72361,72364,0,3,0
20670,3,3,72364,72364,72367,0,3,0
20671,1,2,72365,72367,72369,2,4,0
20672,3,1,72368,72369,72370,1,2,0
20673,3,3,72371,72371,72374,0,3,1
20674,6,1,72377,72377,72378,0,1,3
20675,4,1,72381,72381,72382,0,1,3
20676,5,2,72386,72386,72388,0,2,4
20677,1,3,72387,72388,72391,1,4,0
20678,5,2,72392,72392,72394,0,2,1
20679,3,1,72395,72395,72396,0,1,1
20680,6,3,72401,72401,72404,0,3,5
20681,2,3,72403,72404,72407,1,4,0
20682,2,3,72405,72407,72410,2,5,0
20683,2,3,72407,72410,72413,3,6,0
20684,5,2,72412,72413,72415,1,3,0
20685,6,2,72418,72418,72420,0,2,3
20686,5,1,72423,72423,72424,0,1,3
20687,4,1,72427,72427,72428,0,1,3
20688,3,1,72430,72430,72431,0,1,2
20689,5,3,72435,72435,72438,0,3,4
20690,1,1,72436,72438,72439,2,3,0
20691,6,3,72442,72442,72445,0,3,3
20692,4,2,72446,72446,72448,0,2,1
20693,6,1,72452,72452,72453,0,1,4
20694,1,2,72453,72453,72455,0,2,0
20695,1,2,72454,72455,72457,1,3,0
20696,5,1,72459,72459,72460,0,1,2
20697,2,1,72461,72461,72462,0,1,1
20698,6,1,72467,72467,72468,0,1,5
20699,4,2,72471,72471,72473,0,2,3
20700,2,3,72473,72473,72476,0,3,0
20701,4,2,72477,72477,72479,0,2,1
20702,4,3,72481,72481,72484,0,3,2
20703,1,3,72482,72484,72487,2,5,0
20704,6,1,72488,72488,72489,0,1,1
20705,3,3,72491,72491,72494,0,3,2
20706,3,1,72494,72494,72495,0,1,0
20707,1,1,72495,72495,72496,0,1,0
20708,2,2,72497,72497,72499,0,2,1
20709,3,1,72500,72500,72501,0,1,1
20710,3,3,72503,72503,72506,0,3,2
20711,1,1,72504,72506,72507,2,3,0
20712,4,3,72508,72508,72511,0,3,1
20713,5,2,72513,72513,72515,0,2,2
20714,6,1,72519,72519,72520,0,1,4
20715,1,1,72520,72520,72521,0,1,0
20716,2,3,72522,72522,72525,0,3,1
20717,4,2,72526,72526,72528,0,2,1
20718,3,2,72529,72529,72531,0,2,1
20719,5,3,72534,72534,72537,0,3,3
20720,1,2,72535,72537,72539,2,4,0
20721,3,1,72538,72539,72540,1,2,0
20722,2,2,72540,72540,72542,0,2,0
20723,1,2,72541,72542,72544,1,3,0
20724,3,1,72544,72544,72545,0,1,0
20725,3,2,72547,72547,72549,0,2,2
20726,1,3,72548,72549,72552,1,4,0
20727,1,2,72549,72552,72554,3,5,0
20728,1,3,72550,72554,72557,4,7,0
20729,4,2,72554,72557,72559,3,5,0
20730,5,2,72559,72559,72561,0,2,0
20731,3,2,72562,72562,72564,0,2,1
20732,3,2,72565,72565,72567,0,2,1
20733,1,1,72566,72567,72568,1,2,0
20734,6,2,72572,72572,72574,0,2,4
20735,5,3,72577,72577,72580,0,3,3
20736,3,1,72580,72580,72581,0,1,0
20737,1,2,72581,72581,72583,0,2,0
20738,4,2,72585,72585,72587,0,2,2
20739,1,3,72586,72587,72590,1,4,0
20740,4,1,72590,72590,72591,0,1,0
20741,3,2,72593,72593,72595,0,2,2
20742,1,2,72594,72595,72597,1,3,0
20743,3,2,72597,72597,72599,0,2,0
20744,3,2,72600,72600,72602,0,2,1
20745,6,3,72606,72606,72609,0,3,4
20746,4,1,72610,72610,72611,0,1,1
20747,2,1,72612,72612,72613,0,1,1
20748,1,1,72613,72613,72614,0,1,0
20749,4,2,72617,72617,72619,0,2,3
20750,1,3,72618,72619,72622,1,4,0
20751,1,1,72619,72622,72623,3,4,0
20752,2,3,72621,72623,72626,2,5,0
20753,4,3,72625,72626,72629,1,4,0
20754,2,3,72627,72629,72632,2,5,0
20755,5,2,72632,72632,72634,0,2,0
20756,5,2,72637,72637,72639,0,2,3
20757,5,1,72642,72642,72643,0,1,3
20758,6,1,72648,72648,72649,0,1,5
20759,5,2,72653,72653,72655,0,2,4
20760,4,2,72657,72657,72659,0,2,2
20761,2,2,72659,72659,72661,0,2,0
20762,5,1,72664,72664,72665,0,1,3
20763,4,3,72668,72668,72671,0,3,3
20764,4,2,72672,72672,72674,0,2,1
20765,2,1,72674,72674,72675,0,1,0
20766,5,2,72679,72679,72681,0,2,4
20767,1,3,72680,72681,72684,1,4,0
20768,2,1,72682,72684,72685,2,3,0
20769,3,2,72685,72685,72687,0,2,0
20770,1,2,72686,72687,72689,1,3,0
20771,5,1,72691,72691,72692,0,1,2
20772,2,2,72693,72693,72695,0,2,1
20773,2,3,72695,72695,72698,0,3,0
20774,6,1,72701,72701,72702,0,1,3
20775,3,1,72704,72704,72705,0,1,2
20776,5,2,72709,72709,72711,0,2,4
20777,1,3,72710,72711,72714,1,4,0
20778,6,1,72716,72716,72717,0,1,2
20779,2,2,72718,72718,72720,0,2,1
20780,3,3,72721,72721,72724,0,3,1
20781,4,1,72725,72725,72726,0,1,1
20782,6,1,72731,72731,72732,0,1,5
20783,2,3,72733,72733,72736,0,3,1
20784,1,2,72734,72736,72738,2,4,0
20785,3,3,72737,72738,72741,1,4,0
20786,1,1,72738,72741,72742,3,4,0
20787,3,2,72741,72742,72744,1,3,0
20788,6,2,72747,72747,72749,0,2,3
20789,5,3,72752,72752,72755,0,3,3
20790,4,2,72756,72756,72758,0,2,1
20791,1,3,72757,72758,72761,1,4,0
20792,6,3,72763,72763,72766,0,3,2
20793,3,3,72766,72766,72769,0,3,0
20794,3,1,72769,72769,72770,0,1,0
20795,4,2,72773,72773,72775,0,2,3
20796,3,3,72776,72776,72779,0,3,1
20797,4,3,72780,72780,72783,0,3,1
20798,1,3,72781,72783,72786,2,5,0
20799,6,1,72787,72787,72788,0,1,1
20800,2,2,72789,72789,72791,0,2,1
20801,6,1,72795,72795,72796,0,1,4
20802,4,2,72799,72799,72801,0,2,3
20803,2,3,72801,72801,72804,0,3,0
20804,6,2,72807,72807,72809,0,2,3
20805,2,2,72809,72809,72811,0,2,0
20806,4,2,72813,72813,72815,0,2,2
20807,6,3,72819,72819,72822,0,3,4
20808,4,3,72823,72823,72826,0,3,1
20809,4,2,72827,72827,72829,0,2,1
20810,4,3,72831,72831,72834,0,3,2
20811,1,3,72832,72834,72837,2,5,0
20812,1,3,72833,72837,72840,4,7,0
20813,1,2,72834,72840,72842,6,8,0
20814,5,3,72839,72842,72845,3,6,0
20815,6,1,72845,72845,72846,0,1,0
20816,6,2,72851,72851,72853,0,2,5
20817,3,1,72854,72854,72855,0,1,1
20818,5,1,72859,72859,72860,0,1,4
20819,2,2,72861,72861,72863,0,2,1
20820,6,1,72867,72867,72868,0,1,4
20821,1,1,72868,72868,72869,0,1,0
20822,5,3,72873,72873,72876,0,3,4
20823,4,3,72877,72877,72880,0,3,1
20824,6,3,72883,72883,72886,0,3,3
20825,2,1,72885,72886,72887,1,2,0
20826,1,2,72886,72887,72889,1,3,0
20827,5,1,72891,72891,72892,0,1,2
20828,4,1,72895,72895,72896,0,1,3
20829,4,1,72899,72899,72900,0,1,3
20830,4,3,72903,72903,72906,0,3,3
20831,1,3,72904,72906,72909,2,5,0
20832,3,2,72907,72909,72911,2,4,0
20833,3,1,72910,72911,72912,1,2,0
20834,2,3,72912,72912,72915,0,3,0
20835,5,3,72917,72917,72920,0,3,2
20836,3,3,72920,72920,72923,0,3,0
20837,3,3,72923,72923,72926,0,3,0
20838,3,2,72926,72926,72928,0,2,0
20839,1,2,72927,72928,72930,1,3,0
20840,2,3,72929,72930,72933,1,4,0
20841,3,3,72932,72933,72936,1,4,0
20842,3,1,72935,72936,72937,1,2,0
20843,6,3,72941,72941,72944,0,3,4
20844,6,2,72947,72947,72949,0,2,3
20845,6,2,72953,72953,72955,0,2,4
20846,1,3,72954,72955,72958,1,4,0
20847,2,1,72956,72958,72959,2,3,0
20848,4,1,72960,72960,72961,0,1,1
20849,5,2,72965,72965,72967,0,2,4
20850,4,3,72969,72969,72972,0,3,2
20851,2,2,72971,72972,72974,1,3,0
20852,3,2,72974,72974,72976,0,2,0
20853,2,2,72976,72976,72978,0,2,0
20854,6,1,72982,72982,72983,0,1,4
20855,4,2,72986,72986,72988,0,2,3
20856,2,3,72988,72988,72991,0,3,0
20857,2,1,72990,72991,72992,1,2,0
20858,3,1,72993,72993,72994,0,1,1
20859,1,3,72994,72994,72997,0,3,0
20860,5,1,72999,72999,73000,0,1,2
20861,5,1,73004,73004,73005,0,1,4
20862,3,1,73007,73007,73008,0,1,2
20863,5,1,73012,73012,73013,0,1,4
20864,2,1,73014,73014,73015,0,1,1
20865,1,1,73015,73015,73016,0,1,0
20866,5,2,73020,73020,73022,0,2,4
20867,1,3,73021,73022,73025,1,4,0
20868,5,1,73026,73026,73027,0,1,1
20869,3,3,73029,73029,73032,0,3,2
20870,1,1,73030,73032,73033,2,3,0
20871,3,2,73033,73033,73035,0,2,0
20872,4,3,73037,73037,73040,0,3,2
20873,3,3,73040,73040,73043,0,3,0
20874,2,1,73042,73043,73044,1,2,0
20875,4,1,73046,73046,73047,0,1,2
20876,5,2,73051,73051,73053,0,2,4
20877,1,1,73052,73053,73054,1,2,0
20878,3,3,73055,73055,73058,0,3,1
20879,1,3,73056,73058,73061,2,5,0
20880,1,3,73057,73061,73064,4,7,0
20881,6,3,73063,73064,73067,1,4,0
20882,2,3,73065,73067,73070,2,5,0
20883,2,3,73067,73070,73073,3,6,0
20884,4,1,73071,73073,73074,2,3,0
20885,2,2,73073,73074,73076,1,3,0
20886,4,3,73077,73077,73080,0,3,1
20887,3,2,73080,73080,73082,0,2,0
20888,4,2,73084,73084,73086,0,2,2
20889,5,2,73089,73089,73091,0,2,3
20890,1,2,73090,73091,73093,1,3,0
20891,5,1,73095,73095,73096,0,1,2
20892,6,1,73101,73101,73102,0,1,5
20893,6,1,73107,73107,73108,0,1,5
20894,6,3,73113,73113,73116,0,3,5
20895,2,1,73115,73116,73117,1,2,0
20896,5,1,73120,73120,73121,0,1,3
20897,5,3,73125,73125,73128,0,3,4
20898,3,3,73128,73128,73131,0,3,0
20899,6,3,73134,73134,73137,0,3,3
20900,3,3,73137,73137,73140,0,3,0
20901,4,1,73141,73141,73142,0,1,1
20902,1,2,73142,73142,73144,0,2,0
20903,1,1,73143,73144,73145,1,2,0
20904,1,2,73144,73145,73147,1,3,0
20905,6,1,73150,73150,73151,0,1,3
20906,2,2,73152,73152,73154,0,2,1
20907,6,1,73158,73158,73159,0,1,4
20908,3,3,73161,73161,73164,0,3,2
20909,4,2,73165,73165,73167,0,2,1
20910,1,3,73166,73167,73170,1,4,0
20911,3,1,73169,73170,73171,1,2,0
20912,5,2,73174,73174,73176,0,2,3
20913,4,3,73178,73178,73181,0,3,2
20914,5,2,73183,73183,73185,0,2,2
20915,1,1,73184,73185,73186,1,2,0
20916,4,3,73188,73188,73191,0,3,2
20917,6,1,73194,73194,73195,0,1,3
20918,1,1,73195,73195,73196,0,1,0
20919,5,2,73200,73200,73202,0,2,4
20920,3,1,73203,73203,73204,0,1,1
20921,3,1,73206,73206,73207,0,1,2
20922,2,3,73208,73208,73211,0,3,1
20923,3,3,73211,73211,73214,0,3,0
20924,1,1,73212,73214,73215,2,3,0
20925,2,2,73214,73215,73217,1,3,0
20926,1,3,73215,73217,73220,2,5,0
20927,3,2,73218,73220,73222,2,4,0
20928,4,1,73222,73222,73223,0,1,0
20929,3,3,73225,73225,73228,0,3,2
20930,5,2,73230,73230,73232,0,2,2
20931,4,3,73234,73234,73237,0,3,2
20932,3,1,73237,73237,73238,0,1,0
20933,2,3,73239,73239,73242,0,3,1
20934,6,1,73245,73245,73246,0,1,3
20935,1,1,73246,73246,73247,0,1,0
20936,5,2,73251,73251,73253,0,2,4
20937,4,2,73255,73255,73257,0,2,2
20938,2,1,73257,73257,73258,0,1,0
20939,6,3,73263,73263,73266,0,3,5
20940,5,1,73268,73268,73269,0,1,2
20941,1,2,73269,73269,73271,0,2,0
20942,4,2,73273,73273,73275,0,2,2
20943,4,1,73277,73277,73278,0,1,2
20944,3,2,73280,73280,73282,0,2,2
20945,5,1,73285,73285,73286,0,1,3
20946,3,2,73288,73288,73290,0,2,2
20947,6,1,73294,73294,73295,0,1,4
20948,6,3,73300,73300,73303,0,3,5
20949,1,1,73301,73303,73304,2,3,0
20950,3,2,73304,73304,73306,0,2,0
20951,3,1,73307,73307,73308,0,1,1
20952,4,3,73311,73311,73314,0,3,3
20953,3,3,73314,73314,73317,0,3,0
20954,1,2,73315,73317,73319,2,4,0
20955,4,3,73319,73319,73322,0,3,0
20956,3,1,73322,73322,73323,0,1,0
20957,6,3,73328,73328,73331,0,3,5
20958,5,2,73333,73333,73335,0,2,2
20959,5,2,73338,73338,73340,0,2,3
20960,1,1,73339,73340,73341,1,2,0
20961,5,3,73344,73344,73347,0,3,3
20962,2,3,73346,73347,73350,1,4,0
20963,4,3,73350,73350,73353,0,3,0
20964,6,2,73356,73356,73358,0,2,3
20965,5,1,73361,73361,73362,0,1,3
20966,6,2,73367,73367,73369,0,2,5
20967,4,3,73371,73371,73374,0,3,2
20968,1,1,73372,73374,73375,2,3,0
20969,2,3,73374,73375,73378,1,4,0
20970,5,1,73379,73379,73380,0,1,1
20971,5,1,73384,73384,73385,0,1,4
20972,6,3,73390,73390,73393,0,3,5
20973,3,3,73393,73393,73396,0,3,0
20974,2,1,73395,73396,73397,1,2,0
20975,2,2,73397,73397,73399,0,2,0
20976,1,1,73398,73399,73400,1,2,0
20977,5,1,73403,73403,73404,0,1,3
20978,2,2,73405,73405,73407,0,2,1
20979,4,1,73409,73409,73410,0,1,2
20980,1,1,73410,73410,73411,0,1,0
20981,6,1,73416,73416,73417,0,1,5
20982,6,3,73422,73422,73425,0,3,5
20983,2,3,73424,73425,73428,1,4,0
20984,2,2,73426,73428,73430,2,4,0
20985,2,3,73428,73430,73433,2,5,0
20986,5,1,73433,73433,73434,0,1,0
20987,6,1,73439,73439,73440,0,1,5
20988,4,1,73443,73443,73444,0,1,3
20989,5,1,73448,73448,73449,0,1,4
20990,3,1,73451,73451,73452,0,1,2
20991,1,1,73452,73452,73453,0,1,0
20992,1,3,73453,73453,73456,0,3,0
20993,4,1,73457,73457,73458,0,1,1
20994,6,2,73463,73463,73465,0,2,5
20995,3,3,73466,73466,73469,0,3,1
20996,1,2,73467,73469,73471,2,4,0
20997,2,3,73469,73471,73474,2,5,0
20998,5,2,73474,73474,73476,0,2,0
20999,3,3,73477,73477,73480,0,3,1
21000,3,2,73480,73480,73482,0,2,0
21001,5,3,73485,73485,73488,0,3,3
21002,4,1,73489,73489,73490,0,1,1
21003,2,3,73491,73491,73494,0,3,1
21004,2,3,73493,73494,73497,1,4,0
21005,4,1,73497,73497,73498,0,1,0
21006,2,3,73499,73499,73502,0,3,1
21007,2,2,73501,73502,73504,1,3,0
21008,4,2,73505,73505,73507,0,2,1
21009,6,2,73511,73511,73513,0,2,4
21010,6,2,73517,73517,73519,0,2,4
21011,6,1,73523,73523,73524,0,1,4
21012,4,1,73527,73527,73528,0,1,3
21013,4,3,73531,73531,73534,0,3,3
21014,5,2,73536,73536,73538,0,2,2
21015,1,3,73537,73538,73541,1,4,0
21016,1,1,73538,73541,73542,3,4,0
21017,5,1,73543,73543,73544,0,1,1
21018,4,1,73547,73547,73548,0,1,3
21019,2,2,73549,73549,73551,0,2,1
21020,1,2,73550,73551,73553,1,3,0
21021,1,3,73551,73553,73556,2,5,0
21022,4,2,73555,73556,73558,1,3,0
21023,5,1,73560,73560,73561,0,1,2
21024,3,2,73563,73563,73565,0,2,2
21025,5,2,73568,73568,73570,0,2,3
21026,3,2,73571,73571,73573,0,2,1
21027,3,1,73574,73574,73575,0,1,1
21028,4,1,73578,73578,73579,0,1,3
21029,5,2,73583,73583,73585,0,2,4
21030,1,3,73584,73585,73588,1,4,0
21031,6,2,73590,73590,73592,0,2,2
21032,6,3,73596,73596,73599,0,3,4
21033,2,2,73598,73599,73601,1,3,0
21034,1,3,73599,73601,73604,2,5,0
21035,3,1,73602,73604,73605,2,3,0
21036,3,1,73605,73605,73606,0,1,0
21037,1,2,73606,73606,73608,0,2,0
21038,6,1,73612,73612,73613,0,1,4
21039,4,2,73616,73616,73618,0,2,3
21040,5,2,73621,73621,73623,0,2,3
21041,2,3,73623,73623,73626,0,3,0
21042,4,3,73627,73627,73630,0,3,1
21043,4,3,73631,73631,73634,0,3,1
21044,6,3,73637,73637,73640,0,3,3
21045,5,3,73642,73642,73645,0,3,2
21046,5,1,73647,73647,73648,0,1,2
21047,3,2,73650,73650,73652,0,2,2
21048,4,1,73654,73654,73655,0,1,2
21049,4,2,73658,73658,73660,0,2,3
21050,3,1,73661,73661,73662,0,1,1
21051,3,2,73664,73664,73666,0,2,2
21052,4,2,73668,73668,73670,0,2,2
21053,6,1,73674,73674,73675,0,1,4
21054,1,2,73675,73675,73677,0,2,0
21055,5,2,73680,73680,73682,0,2,3
21056,4,3,73684,73684,73687,0,3,2
21057,1,1,73685,73687,73688,2,3,0
21058,5,3,73690,73690,73693,0,3,2
21059,3,2,73693,73693,73695,0,2,0
21060,3,3,73696,73696,73699,0,3,1
21061,1,1,73697,73699,73700,2,3,0
21062,2,2,73699,73700,73702,1,3,0
21063,4,2,73703,73703,73705,0,2,1
21064,6,2,73709,73709,73711,0,2,4
21065,2,3,73711,73711,73714,0,3,0
21066,2,1,73713,73714,73715,1,2,0
21067,6,3,73719,73719,73722,0,3,4
21068,5,2,73724,73724,73726,0,2,2
21069,3,3,73727,73727,73730,0,3,1
21070,2,3,73729,73730,73733,1,4,0
21071,5,3,73734,73734,73737,0,3,1
21072,1,2,73735,73737,73739,2,4,0
21073,1,3,73736,73739,73742,3,6,0
21074,2,3,73738,73742,73745,4,7,0
21075,1,3,73739,73745,73748,6,9,0
21076,2,3,73741,73748,73751,7,10,0
21077,4,2,73745,73751,73753,6,8,0
21078,2,3,73747,73753,73756,6,9,0
21079,6,3,73753,73756,73759,3,6,0
21080,4,3,73757,73759,73762,2,5,0
21081,2,2,73759,73762,73764,3,5,0
21082,3,1,73762,73764,73765,2,3,0
21083,1,3,73763,73765,73768,2,5,0
21084,3,3,73766,73768,73771,2,5,0
21085,6,2,73772,73772,73774,0,2,1
21086,3,1,73775,73775,73776,0,1,1
21087,5,2,73780,73780,73782,0,2,4
21088,2,1,73782,73782,73783,0,1,0
21089,1,1,73783,73783,73784,0,1,0
21090,6,2,73789,73789,73791,0,2,5
21091,1,1,73790,73791,73792,1,2,0
21092,3,1,73793,73793,73794,0,1,1
21093,1,1,73794,73794,73795,0,1,0
21094,2,3,73796,73796,73799,0,3,1
21095,6,2,73802,73802,73804,0,2,3
21096,1,2,73803,73804,73806,1,3,0
21097,6,1,73809,73809,73810,0,1,3
21098,4,2,73813,73813,73815,0,2,3
21099,4,1,73817,73817,73818,0,1,2
21100,1,2,73818,73818,73820,0,2,0
21101,4,1,73822,73822,73823,0,1,2
21102,3,2,73825,73825,73827,0,2,2
21103,2,2,73827,73827,73829,0,2,0
21104,3,2,73830,73830,73832,0,2,1
21105,4,3,73834,73834,73837,0,3,2
21106,1,2,73835,73837,73839,2,4,0
21107,5,2,73840,73840,73842,0,2,1
21108,1,1,73841,73842,73843,1,2,0
21109,5,3,73846,73846,73849,0,3,3
21110,4,2,73850,73850,73852,0,2,1
21111,1,3,73851,73852,73855,1,4,0
21112,3,1,73854,73855,73856,1,2,0
21113,6,2,73860,73860,73862,0,2,4
21114,1,3,73861,73862,73865,1,4,0
21115,6,1,73867,73867,73868,0,1,2
21116,4,3,73871,73871,73874,0,3,3
21117,5,3,73876,73876,73879,0,3,2
21118,6,1,73882,73882,73883,0,1,3
21119,4,3,73886,73886,73889,0,3,3
21120,4,3,73890,73890,73893,0,3,1
21121,1,1,73891,73893,73894,2,3,0
21122,4,2,73895,73895,73897,0,2,1
21123,2,1,73897,73897,73898,0,1,0
21124,6,3,73903,73903,73906,0,3,5
21125,1,3,73904,73906,73909,2,5,0
21126,5,1,73909,73909,73910,0,1,0
21127,1,2,73910,73910,73912,0,2,0
21128,2,1,73912,73912,73913,0,1,0
21129,6,3,73918,73918,73921,0,3,5
21130,2,2,73920,73921,73923,1,3,0
21131,5,1,73925,73925,73926,0,1,2
21132,3,2,73928,73928,73930,0,2,2
21133,5,3,73933,73933,73936,0,3,3
21134,5,2,73938,73938,73940,0,2,2
21135,1,2,73939,73940,73942,1,3,0
21136,5,1,73944,73944,73945,0,1,2
21137,3,2,73947,73947,73949,0,2,2
21138,4,1,73951,73951,73952,0,1,2
21139,1,3,73952,73952,73955,0,3,0
21140,5,3,73957,73957,73960,0,3,2
21141,3,3,73960,73960,73963,0,3,0
21142,4,2,73964,73964,73966,0,2,1
21143,5,1,73969,73969,73970,0,1,3
21144,3,3,73972,73972,73975,0,3,2
21145,4,3,73976,73976,73979,0,3,1
21146,6,1,73982,73982,73983,0,1,3
21147,6,2,73988,73988,73990,0,2,5
21148,3,3,73991,73991,73994,0,3,1
21149,5,1,73996,73996,73997,0,1,2
21150,3,2,73999,73999,74001,0,2,2
21151,3,3,74002,74002,74005,0,3,1
21152,5,2,74007,74007,74009,0,2,2
21153,4,1,74011,74011,74012,0,1,2
21154,4,2,74015,74015,74017,0,2,3
21155,1,1,74016,74017,74018,1,2,0
21156,4,2,74020,74020,74022,0,2,2
21157,1,3,74021,74022,74025,1,4,0
21158,2,1,74023,74025,74026,2,3,0
21159,5,1,74028,74028,74029,0,1,2
21160,2,3,74030,74030,74033,0,3,1
21161,2,2,74032,74033,74035,1,3,0
21162,3,1,74035,74035,74036,0,1,0
21163,1,3,74036,74036,74039,0,3,0
21164,1,1,74037,74039,74040,2,3,0
21165,1,1,74038,74040,74041,2,3,0
21166,2,3,74040,74041,74044,1,4,0
21167,2,3,74042,74044,74047,2,5,0
21168,1,1,74043,74047,74048,4,5,0
21169,1,1,74044,74048,74049,4,5,0
21170,2,1,74046,74049,74050,3,4,0
21171,2,2,74048,74050,74052,2,4,0
21172,4,1,74052,74052,74053,0,1,0
21173,5,3,74057,74057,74060,0,3,4
21174,5,1,74062,74062,74063,0,1,2
21175,3,2,74065,74065,74067,0,2,2
21176,3,2,74068,74068,74070,0,2,1
21177,4,3,74072,74072,74075,0,3,2
21178,3,3,74075,74075,74078,0,3,0
21179,6,3,74081,74081,74084,0,3,3
21180,5,1,74086,74086,74087,0,1,2
21181,3,3,74089,74089,74092,0,3,2
21182,2,2,74091,74092,74094,1,3,0
21183,5,2,74096,74096,74098,0,2,2
21184,2,2,74098,74098,74100,0,2,0
21185,4,3,74102,74102,74105,0,3,2
21186,6,1,74108,74108,74109,0,1,3
21187,5,2,74113,74113,74115,0,2,4
21188,5,1,74118,74118,74119,0,1,3
21189,1,2,74119,74119,74121,0,2,0
21190,3,3,74122,74122,74125,0,3,1
21191,6,3,74128,74128,74131,0,3,3
21192,1,3,74129,74131,74134,2,5,0
21193,4,3,74133,74134,74137,1,4,0
21194,2,2,74135,74137,74139,2,4,0
21195,5,2,74140,74140,74142,0,2,1
21196,6,1,74146,74146,74147,0,1,4
21197,3,2,74149,74149,74151,0,2,2
21198,3,1,74152,74152,74153,0,1,1
21199,5,1,74157,74157,74158,0,1,4
21200,1,1,74158,74158,74159,0,1,0
21201,4,1,74162,74162,74163,0,1,3
21202,1,1,74163,74163,74164,0,1,0
21203,3,1,74166,74166,74167,0,1,2
21204,6,2,74172,74172,74174,0,2,5
21205,5,2,74177,74177,74179,0,2,3
21206,6,1,74183,74183,74184,0,1,4
21207,4,2,74187,74187,74189,0,2,3
21208,5,2,74192,74192,74194,0,2,3
21209,2,1,74194,74194,74195,0,1,0
21210,3,1,74197,74197,74198,0,1,2
21211,1,1,74198,74198,74199,0,1,0
21212,5,1,74203,74203,74204,0,1,4
21213,2,2,74205,74205,74207,0,2,1
21214,1,1,74206,74207,74208,1,2,0
21215,4,1,74210,74210,74211,0,1,2
21216,3,2,74213,74213,74215,0,2,2
21217,6,2,74219,74219,74221,0,2,4
21218,1,1,74220,74221,74222,1,2,0
21219,5,2,74225,74225,74227,0,2,3
21220,4,3,74229,74229,74232,0,3,2
21221,1,2,74230,74232,74234,2,4,0
21222,2,2,74232,74234,74236,2,4,0
21223,2,2,74234,74236,74238,2,4,0
21224,4,1,74238,74238,74239,0,1,0
21225,3,2,74241,74241,74243,0,2,2
21226,1,2,74242,74243,74245,1,3,0
21227,6,1,74248,74248,74249,0,1,3
21228,2,2,74250,74250,74252,0,2,1
21229,5,2,74255,74255,74257,0,2,3
21230,4,1,74259,74259,74260,0,1,2
21231,4,3,74263,74263,74266,0,3,3
21232,2,3,74265,74266,74269,1,4,0
21233,5,1,74270,74270,74271,0,1,1
21234,6,3,74276,74276,74279,0,3,5
21235,5,3,74281,74281,74284,0,3,2
21236,1,3,74282,74284,74287,2,5,0
21237,3,3,74285,74287,74290,2,5,0
21238,3,3,74288,74290,74293,2,5,0
21239,4,3,74292,74293,74296,1,4,0
21240,1,2,74293,74296,74298,3,5,0
21241,3,3,74296,74298,74301,2,5,0
21242,4,1,74300,74301,74302,1,2,0
21243,2,3,74302,74302,74305,0,3,0
21244,3,3,74305,74305,74308,0,3,0
21245,4,1,74309,74309,74310,0,1,1
21246,3,1,74312,74312,74313,0,1,2
21247,2,2,74314,74314,74316,0,2,1
21248,4,2,74318,74318,74320,0,2,2
21249,5,1,74323,74323,74324,0,1,3
21250,2,1,74325,74325,74326,0,1,1
21251,1,1,74326,74326,74327,0,1,0
21252,2,1,74328,74328,74329,0,1,1
21253,2,3,74330,74330,74333,0,3,1
21254,5,3,74335,74335,74338,0,3,2
21255,4,3,74339,74339,74342,0,3,1
21256,2,1,74341,74342,74343,1,2,0
21257,6,1,74347,74347,74348,0,1,4
21258,4,1,74351,74351,74352,0,1,3
21259,5,1,74356,74356,74357,0,1,4
21260,5,2,74361,74361,74363,0,2,4
21261,6,2,74367,74367,74369,0,2,4
21262,5,2,74372,74372,74374,0,2,3
21263,5,3,74377,74377,74380,0,3,3
21264,5,1,74382,74382,74383,0,1,2
21265,4,1,74386,74386,74387,0,1,3
21266,2,1,74388,74388,74389,0,1,1
21267,1,3,74389,74389,74392,0,3,0
21268,4,3,74393,74393,74396,0,3,1
21269,1,3,74394,74396,74399,2,5,0
21270,1,1,74395,74399,74400,4,5,0
21271,2,1,74397,74400,74401,3,4,0
21272,2,1,74399,74401,74402,2,3,0
21273,4,2,74403,74403,74405,0,2,1
21274,4,3,74407,74407,74410,0,3,2
21275,1,1,74408,74410,74411,2,3,0
21276,5,2,74413,74413,74415,0,2,2
21277,3,3,74416,74416,74419,0,3,1
21278,2,1,74418,74419,74420,1,2,0
21279,1,1,74419,74420,74421,1,2,0
21280,3,1,74422,74422,74423,0,1,1
21281,5,3,74427,74427,74430,0,3,4
21282,6,1,74433,74433,74434,0,1,3
21283,4,1,74437,74437,74438,0,1,3
21284,6,3,74443,74443,74446,0,3,5
21285,3,3,74446,74446,74449,0,3,0
21286,6,1,74452,74452,74453,0,1,3
21287,3,1,74455,74455,74456,0,1,2
21288,5,1,74460,74460,74461,0,1,4
21289,1,3,74461,74461,74464,0,3,0
21290,3,1,74464,74464,74465,0,1,0
21291,4,2,74468,74468,74470,0,2,3
21292,6,2,74474,74474,74476,0,2,4
21293,2,2,74476,74476,74478,0,2,0
21294,6,2,74482,74482,74484,0,2,4
21295,4,1,74486,74486,74487,0,1,2
21296,3,1,74489,74489,74490,0,1,2
21297,4,3,74493,74493,74496,0,3,3
21298,3,2,74496,74496,74498,0,2,0
21299,6,3,74502,74502,74505,0,3,4
21300,5,3,74507,74507,74510,0,3,2
21301,4,3,74511,74511,74514,0,3,1
21302,4,1,74515,74515,74516,0,1,1
21303,1,1,74516,74516,74517,0,1,0
21304,3,3,74519,74519,74522,0,3,2
21305,6,1,74525,74525,74526,0,1,3
21306,4,1,74529,74529,74530,0,1,3
21307,3,3,74532,74532,74535,0,3,2
21308,5,3,74537,74537,74540,0,3,2
21309,4,3,74541,74541,74544,0,3,1
21310,1,1,74542,74544,74545,2,3,0
21311,2,1,74544,74545,74546,1,2,0
21312,4,1,74548,74548,74549,0,1,2
21313,5,1,74553,74553,74554,0,1,4
21314,3,1,74556,74556,74557,0,1,2
21315,3,2,74559,74559,74561,0,2,2
21316,2,2,74561,74561,74563,0,2,0
21317,1,2,74562,74563,74565,1,3,0
21318,2,3,74564,74565,74568,1,4,0
21319,2,3,74566,74568,74571,2,5,0
21320,1,3,74567,74571,74574,4,7,0
21321,1,1,74568,74574,74575,6,7,0
21322,4,2,74572,74575,74577,3,5,0
21323,3,2,74575,74577,74579,2,4,0
21324,5,3,74580,74580,74583,0,3,1
21325,4,3,74584,74584,74587,0,3,1
21326,6,2,74590,74590,74592,0,2,3
21327,6,3,74596,74596,74599,0,3,4
21328,1,3,74597,74599,74602,2,5,0
21329,5,1,74602,74602,74603,0,1,0
21330,3,2,74605,74605,74607,0,2,2
21331,1,1,74606,74607,74608,1,2,0
21332,4,2,74610,74610,74612,0,2,2
21333,5,1,74615,74615,74616,0,1,3
21334,1,3,74616,74616,74619,0,3,0
21335,4,3,74620,74620,74623,0,3,1
21336,3,1,74623,74623,74624,0,1,0
21337,2,3,74625,74625,74628,0,3,1
21338,1,3,74626,74628,74631,2,5,0
21339,6,3,74632,74632,74635,0,3,1
21340,5,3,74637,74637,74640,0,3,2
21341,5,3,74642,74642,74645,0,3,2
21342,2,3,74644,74645,74648,1,4,0
21343,5,1,74649,74649,74650,0,1,1
21344,1,3,74650,74650,74653,0,3,0
21345,2,3,74652,74653,74656,1,4,0
21346,6,1,74658,74658,74659,0,1,2
21347,6,3,74664,74664,74667,0,3,5
21348,3,1,74667,74667,74668,0,1,0
21349,6,3,74673,74673,74676,0,3,5
21350,6,1,74679,74679,74680,0,1,3
21351,3,3,74682,74682,74685,0,3,2
21352,5,2,74687,74687,74689,0,2,2
21353,5,3,74692,74692,74695,0,3,3
21354,6,2,74698,74698,74700,0,2,3
21355,1,1,74699,74700,74701,1,2,0
21356,2,1,74701,74701,74702,0,1,0
21357,6,2,74707,74707,74709,0,2,5
21358,4,3,74711,74711,74714,0,3,2
21359,1,2,74712,74714,74716,2,4,0
21360,2,3,74714,74716,74719,2,5,0
21361,6,2,74720,74720,74722,0,2,1
21362,6,2,74726,74726,74728,0,2,4
21363,1,1,74727,74728,74729,1,2,0
21364,5,2,74732,74732,74734,0,2,3
21365,2,1,74734,74734,74735,0,1,0
21366,4,2,74738,74738,74740,0,2,3
21367,4,2,74742,74742,74744,0,2,2
21368,4,3,74746,74746,74749,0,3,2
21369,5,1,74751,74751,74752,0,1,2
21370,3,3,74754,74754,74757,0,3,2
21371,5,2,74759,74759,74761,0,2,2
21372,2,3,74761,74761,74764,0,3,0
21373,4,2,74765,74765,74767,0,2,1
21374,1,2,74766,74767,74769,1,3,0
21375,2,2,74768,74769,74771,1,3,0
21376,5,1,74773,74773,74774,0,1,2
21377,5,3,74778,74778,74781,0,3,4
21378,6,1,74784,74784,74785,0,1,3
21379,1,1,74785,74785,74786,0,1,0
21380,4,2,74789,74789,74791,0,2,3
21381,1,1,74790,74791,74792,1,2,0
21382,3,1,74793,74793,74794,0,1,1
21383,2,2,74795,74795,74797,0,2,1
21384,3,1,74798,74798,74799,0,1,1
21385,2,2,74800,74800,74802,0,2,1
21386,2,2,74802,74802,74804,0,2,0
21387,2,3,74804,74804,74807,0,3,0
21388,5,2,74809,74809,74811,0,2,2
21389,6,2,74815,74815,74817,0,2,4
21390,3,1,74818,74818,74819,0,1,1
21391,4,2,74822,74822,74824,0,2,3
21392,3,1,74825,74825,74826,0,1,1
21393,6,2,74831,74831,74833,0,2,5
21394,3,1,74834,74834,74835,0,1,1
21395,2,3,74836,74836,74839,0,3,1
21396,1,1,74837,74839,74840,2,3,0
21397,3,2,74840,74840,74842,0,2,0
21398,1,3,74841,74842,74845,1,4,0
21399,1,3,74842,74845,74848,3,6,0
21400,3,1,74845,74848,74849,3,4,0
21401,2,2,74847,74849,74851,2,4,0
21402,4,1,74851,74851,74852,0,1,0
21403,1,3,74852,74852,74855,0,3,0
21404,2,3,74854,74855,74858,1,4,0
21405,4,1,74858,74858,74859,0,1,0
21406,3,3,74861,74861,74864,0,3,2
21407,2,3,74863,74864,74867,1,4,0
21408,4,3,74867,74867,74870,0,3,0
21409,3,1,74870,74870,74871,0,1,0
21410,1,2,74871,74871,74873,0,2,0
21411,6,3,74877,74877,74880,0,3,4
21412,1,3,74878,74880,74883,2,5,0
21413,3,1,74881,74883,74884,2,3,0
21414,5,1,74886,74886,74887,0,1,2
21415,4,3,74890,74890,74893,0,3,3
21416,6,3,74896,74896,74899,0,3,3
21417,2,3,74898,74899,74902,1,4,0
21418,4,1,74902,74902,74903,0,1,0
21419,4,2,74906,74906,74908,0,2,3
21420,1,1,74907,74908,74909,1,2,0
21421,1,1,74908,74909,74910,1,2,0
21422,1,1,74909,74910,74911,1,2,0
21423,4,1,74913,74913,74914,0,1,2
21424,4,2,74917,74917,74919,0,2,3
21425,6,3,74923,74923,74926,0,3,4
21426,3,3,74926,74926,74929,0,3,0
21427,3,1,74929,74929,74930,0,1,0
21428,1,1,74930,74930,74931,0,1,0
21429,2,1,74932,74932,74933,0,1,1
21430,2,2,74934,74934,74936,0,2,1
21431,4,3,74938,74938,74941,0,3,2
21432,1,1,74939,74941,74942,2,3,0
21433,3,2,74942,74942,74944,0,2,0
21434,1,2,74943,74944,74946,1,3,0
21435,4,2,74947,74947,74949,0,2,1
21436,5,2,74952,74952,74954,0,2,3
21437,4,3,74956,74956,74959,0,3,2
21438,1,1,74957,74959,74960,2,3,0
21439,6,2,74963,74963,74965,0,2,3
21440,5,1,74968,74968,74969,0,1,3
21441,2,3,74970,74970,74973,0,3,1
21442,4,2,74974,74974,74976,0,2,1
21443,6,2,74980,74980,74982,0,2,4
21444,4,2,74984,74984,74986,0,2,2
21445,4,2,74988,74988,74990,0,2,2
21446,3,1,74991,74991,74992,0,1,1
21447,3,1,74994,74994,74995,0,1,2
21448,1,1,74995,74995,74996,0,1,0
21449,2,1,74997,74997,74998,0,1,1
21450,1,3,74998,74998,75001,0,3,0
21451,3,1,75001,75001,75002,0,1,0
21452,3,3,75004,75004,75007,0,3,2
21453,2,2,75006,75007,75009,1,3,0
21454,1,3,75007,75009,75012,2,5,0
21455,4,1,75011,75012,75013,1,2,0
21456,6,1,75017,75017,75018,0,1,4
21457,1,1,75018,75018,75019,0,1,0
21458,6,1,75024,75024,75025,0,1,5
21459,6,3,75030,75030,75033,0,3,5
21460,2,1,75032,75033,75034,1,2,0
21461,4,1,75036,75036,75037,0,1,2
21462,4,3,75040,75040,75043,0,3,3
21463,5,2,75045,75045,75047,0,2,2
21464,3,2,75048,75048,75050,0,2,1
21465,3,2,75051,75051,75053,0,2,1
21466,1,3,75052,75053,75056,1,4,0
21467,5,1,75057,75057,75058,0,1,1
21468,5,1,75062,75062,75063,0,1,4
21469,1,2,75063,75063,75065,0,2,0
21470,5,3,75068,75068,75071,0,3,3
21471,6,1,75074,75074,75075,0,1,3
21472,1,1,75075,75075,75076,0,1,0
21473,1,3,75076,75076,75079,0,3,0
21474,6,3,75082,75082,75085,0,3,3
21475,5,2,75087,75087,75089,0,2,2
21476,6,2,75093,75093,75095,0,2,4
21477,4,1,75097,75097,75098,0,1,2
21478,3,2,75100,75100,75102,0,2,2
21479,4,3,75104,75104,75107,0,3,2
21480,4,3,75108,75108,75111,0,3,1
21481,1,3,75109,75111,75114,2,5,0
21482,4,1,75113,75114,75115,1,2,0
21483,5,3,75118,75118,75121,0,3,3
21484,4,3,75122,75122,75125,0,3,1
21485,6,2,75128,75128,75130,0,2,3
21486,3,2,75131,75131,75133,0,2,1
21487,3,2,75134,75134,75136,0,2,1
21488,2,1,75136,75136,75137,0,1,0
21489,1,3,75137,75137,75140,0,3,0
21490,6,3,75143,75143,75146,0,3,3
21491,3,1,75146,75146,75147,0,1,0
21492,1,1,75147,75147,75148,0,1,0
21493,4,2,75151,75151,75153,0,2,3
21494,2,3,75153,75153,75156,0,3,0
21495,5,3,75158,75158,75161,0,3,2
21496,6,3,75164,75164,75167,0,3,3
21497,1,1,75165,75167,75168,2,3,0
21498,6,1,75171,75171,75172,0,1,3
21499,6,3,75177,75177,75180,0,3,5
21500,3,2,75180,75180,75182,0,2,0
21501,3,3,75183,75183,75186,0,3,1
21502,5,1,75188,75188,75189,0,1,2
21503,3,1,75191,75191,75192,0,1,2
21504,6,2,75197,75197,75199,0,2,5
21505,1,1,75198,75199,75200,1,2,0
21506,1,2,75199,75200,75202,1,3,0
21507,3,3,75202,75202,75205,0,3,0
21508,2,3,75204,75205,75208,1,4,0
21509,6,3,75210,75210,75213,0,3,2
21510,6,2,75216,75216,75218,0,2,3
21511,2,1,75218,75218,75219,0,1,0
21512,1,1,75219,75219,75220,0,1,0
21513,3,3,75222,75222,75225,0,3,2
21514,4,2,75226,75226,75228,0,2,1
21515,4,1,75230,75230,75231,0,1,2
21516,4,1,75234,75234,75235,0,1,3
21517,1,3,75235,75235,75238,0,3,0
21518,6,2,75241,75241,75243,0,2,3
21519,3,2,75244,75244,75246,0,2,1
21520,6,1,75250,75250,75251,0,1,4
21521,2,2,75252,75252,75254,0,2,1
21522,4,2,75256,75256,75258,0,2,2
21523,1,2,75257,75258,75260,1,3,0
21524,6,3,75263,75263,75266,0,3,3
21525,6,3,75269,75269,75272,0,3,3
21526,1,2,75270,75272,75274,2,4,0
21527,4,3,75274,75274,75277,0,3,0
21528,2,2,75276,75277,75279,1,3,0
21529,6,1,75282,75282,75283,0,1,3
21530,5,3,75287,75287,75290,0,3,4
21531,1,2,75288,75290,75292,2,4,0
21532,5,3,75293,75293,75296,0,3,1
21533,2,2,75295,75296,75298,1,3,0
21534,3,2,75298,75298,75300,0,2,0
21535,2,2,75300,75300,75302,0,2,0
21536,4,2,75304,75304,75306,0,2,2
21537,6,3,75310,75310,75313,0,3,4
21538,5,1,75315,75315,75316,0,1,2
21539,3,2,75318,75318,75320,0,2,2
21540,2,3,75320,75320,75323,0,3,0
21541,6,1,75326,75326,75327,0,1,3
21542,3,1,75329,75329,75330,0,1,2
21543,6,1,75335,75335,75336,0,1,5
21544,1,1,75336,75336,75337,0,1,0
21545,2,3,75338,75338,75341,0,3,1
21546,6,1,75344,75344,75345,0,1,3
21547,5,1,75349,75349,75350,0,1,4
21548,6,1,75355,75355,75356,0,1,5
21549,2,1,75357,75357,75358,0,1,1
21550,4,1,75361,75361,75362,0,1,3
21551,6,3,75367,75367,75370,0,3,5
21552,1,1,75368,75370,75371,2,3,0
21553,3,3,75371,75371,75374,0,3,0
21554,5,1,75376,75376,75377,0,1,2
21555,2,2,75378,75378,75380,0,2,1
21556,2,1,75380,75380,75381,0,1,0
21557,3,2,75383,75383,75385,0,2,2
21558,1,3,75384,75385,75388,1,4,0
21559,6,3,75390,75390,75393,0,3,2
21560,2,2,75392,75393,75395,1,3,0
21561,6,1,75398,75398,75399,0,1,3
21562,4,2,75402,75402,75404,0,2,3
21563,1,2,75403,75404,75406,1,3,0
21564,6,3,75409,75409,75412,0,3,3
21565,2,2,75411,75412,75414,1,3,0
21566,3,1,75414,75414,75415,0,1,0
21567,4,3,75418,75418,75421,0,3,3
21568,2,1,75420,75421,75422,1,2,0
21569,1,3,75421,75422,75425,1,4,0
21570,6,2,75427,75427,75429,0,2,2
21571,5,2,75432,75432,75434,0,2,3
21572,6,1,75438,75438,75439,0,1,4
21573,3,1,75441,75441,75442,0,1,2
21574,4,1,75445,75445,75446,0,1,3
21575,1,3,75446,75446,75449,0,3,0
21576,1,1,75447,75449,75450,2,3,0
21577,2,2,75449,75450,75452,1,3,0
21578,3,2,75452,75452,75454,0,2,0
21579,1,1,75453,75454,75455,1,2,0
21580,1,2,75454,75455,75457,1,3,0
21581,4,2,75458,75458,75460,0,2,1
21582,5,1,75463,75463,75464,0,1,3
21583,6,3,75469,75469,75472,0,3,5
21584,6,3,75475,75475,75478,0,3,3
21585,2,1,75477,75478,75479,1,2,0
21586,3,1,75480,75480,75481,0,1,1
21587,1,1,75481,75481,75482,0,1,0
21588,6,3,75487,75487,75490,0,3,5
21589,2,2,75489,75490,75492,1,3,0
21590,3,2,75492,75492,75494,0,2,0
21591,6,3,75498,75498,75501,0,3,4
21592,6,1,75504,75504,75505,0,1,3
21593,4,2,75508,75508,75510,0,2,3
21594,6,2,75514,75514,75516,0,2,4
21595,2,1,75516,75516,75517,0,1,0
21596,2,1,75518,75518,75519,0,1,1
21597,6,1,75524,75524,75525,0,1,5
21598,2,3,75526,75526,75529,0,3,1
21599,2,3,75528,75529,75532,1,4,0
21600,2,1,75530,75532,75533,2,3,0
21601,6,1,75536,75536,75537,0,1,3
21602,3,3,75539,75539,75542,0,3,2
21603,6,2,75545,75545,75547,0,2,3
21604,4,1,75549,75549,75550,0,1,2
21605,5,3,75554,75554,75557,0,3,4
21606,6,3,75560,75560,75563,0,3,3
21607,6,3,75566,75566,75569,0,3,3
21608,4,2,75570,75570,75572,0,2,1
21609,6,3,75576,75576,75579,0,3,4
21610,1,1,75577,75579,75580,2,3,0
21611,5,3,75582,75582,75585,0,3,2
21612,2,1,75584,75585,75586,1,2,0
21613,6,3,75590,75590,75593,0,3,4
21614,3,3,75593,75593,75596,0,3,0
21615,1,1,75594,75596,75597,2,3,0
21616,2,3,75596,75597,75600,1,4,0
21617,4,3,75600,75600,75603,0,3,0
21618,2,2,75602,75603,75605,1,3,0
21619,5,2,75607,75607,75609,0,2,2
21620,3,2,75610,75610,75612,0,2,1
21621,1,3,75611,75612,75615,1,4,0
21622,3,3,75614,75615,75618,1,4,0
21623,2,2,75616,75618,75620,2,4,0
21624,5,3,75621,75621,75624,0,3,1
21625,6,1,75627,75627,75628,0,1,3
21626,5,1,75632,75632,75633,0,1,4
21627,3,2,75635,75635,75637,0,2,2
21628,5,2,75640,75640,75642,0,2,3
21629,4,3,75644,75644,75647,0,3,2
21630,6,2,75650,75650,75652,0,2,3
21631,2,3,75652,75652,75655,0,3,0
21632,2,2,75654,75655,75657,1,3,0
21633,4,3,75658,75658,75661,0,3,1
21634,4,2,75662,75662,75664,0,2,1
21635,1,3,75663,75664,75667,1,4,0
21636,3,1,75666,75667,75668,1,2,0
21637,3,1,75669,75669,75670,0,1,1
21638,1,2,75670,75670,75672,0,2,0
21639,5,2,75675,75675,75677,0,2,3
21640,4,3,75679,75679,75682,0,3,2
21641,2,1,75681,75682,75683,1,2,0
21642,2,3,75683,75683,75686,0,3,0
21643,2,3,75685,75686,75689,1,4,0
21644,5,3,75690,75690,75693,0,3,1
21645,6,3,75696,75696,75699,0,3,3
21646,2,3,75698,75699,75702,1,4,0
21647,3,3,75701,75702,75705,1,4,0
21648,5,1,75706,75706,75707,0,1,1
21649,2,1,75708,75708,75709,0,1,1
21650,3,3,75711,75711,75714,0,3,2
21651,1,2,75712,75714,75716,2,4,0
21652,5,2,75717,75717,75719,0,2,1
21653,6,2,75723,75723,75725,0,2,4
21654,1,1,75724,75725,75726,1,2,0
21655,3,2,75727,75727,75729,0,2,1
21656,5,2,75732,75732,75734,0,2,3
21657,1,2,75733,75734,75736,1,3,0
21658,5,1,75738,75738,75739,0,1,2
21659,5,1,75743,75743,75744,0,1,4
21660,2,3,75745,75745,75748,0,3,1
21661,1,2,75746,75748,75750,2,4,0
21662,2,2,75748,75750,75752,2,4,0
21663,5,1,75753,75753,75754,0,1,1
21664,3,3,75756,75756,75759,0,3,2
21665,3,1,75759,75759,75760,0,1,0
21666,5,1,75764,75764,75765,0,1,4
21667,2,1,75766,75766,75767,0,1,1
21668,1,3,75767,75767,75770,0,3,0
21669,3,2,75770,75770,75772,0,2,0
21670,1,2,75771,75772,75774,1,3,0
21671,3,3,75774,75774,75777,0,3,0
21672,4,3,75778,75778,75781,0,3,1
21673,4,3,75782,75782,75785,0,3,1
21674,6,1,75788,75788,75789,0,1,3
21675,6,1,75794,75794,75795,0,1,5
21676,4,3,75798,75798,75801,0,3,3
21677,1,3,75799,75801,75804,2,5,0
21678,6,3,75805,75805,75808,0,3,1
21679,4,3,75809,75809,75812,0,3,1
21680,3,1,75812,75812,75813,0,1,0
21681,1,2,75813,75813,75815,0,2,0
21682,4,2,75817,75817,75819,0,2,2
21683,5,3,75822,75822,75825,0,3,3
21684,4,1,75826,75826,75827,0,1,1
21685,1,2,75827,75827,75829,0,2,0
21686,3,1,75830,75830,75831,0,1,1
21687,1,2,75831,75831,75833,0,2,0
21688,6,3,75837,75837,75840,0,3,4
21689,2,3,75839,75840,75843,1,4,0
21690,4,3,75843,75843,75846,0,3,0
21691,4,1,75847,75847,75848,0,1,1
21692,2,2,75849,75849,75851,0,2,1
21693,2,1,75851,75851,75852,0,1,0
21694,1,1,75852,75852,75853,0,1,0
21695,3,3,75855,75855,75858,0,3,2
21696,6,3,75861,75861,75864,0,3,3
21697,2,1,75863,75864,75865,1,2,0
21698,1,2,75864,75865,75867,1,3,0
21699,4,3,75868,75868,75871,0,3,1
21700,3,1,75871,75871,75872,0,1,0
21701,6,1,75877,75877,75878,0,1,5
21702,2,2,75879,75879,75881,0,2,1
21703,3,2,75882,75882,75884,0,2,1
21704,6,2,75888,75888,75890,0,2,4
21705,5,2,75893,75893,75895,0,2,3
21706,4,2,75897,75897,75899,0,2,2
21707,6,3,75903,75903,75906,0,3,4
21708,3,3,75906,75906,75909,0,3,0
21709,2,1,75908,75909,75910,1,2,0
21710,2,2,75910,75910,75912,0,2,0
21711,2,3,75912,75912,75915,0,3,0
21712,2,3,75914,75915,75918,1,4,0
21713,3,3,75917,75918,75921,1,4,0
21714,5,1,75922,75922,75923,0,1,1
21715,3,1,75925,75925,75926,0,1,2
21716,5,1,75930,75930,75931,0,1,4
21717,5,3,75935,75935,75938,0,3,4
21718,4,3,75939,75939,75942,0,3,1
21719,6,3,75945,75945,75948,0,3,3
21720,5,1,75950,75950,75951,0,1,2
21721,2,3,75952,75952,75955,0,3,1
21722,2,3,75954,75955,75958,1,4,0
21723,6,1,75960,75960,75961,0,1,2
21724,1,3,75961,75961,75964,0,3,0
21725,6,1,75967,75967,75968,0,1,3
21726,4,3,75971,75971,75974,0,3,3
21727,4,3,75975,75975,75978,0,3,1
21728,2,2,75977,75978,75980,1,3,0
21729,1,3,75978,75980,75983,2,5,0
21730,4,2,75982,75983,75985,1,3,0
21731,4,3,75986,75986,75989,0,3,1
21732,6,2,75992,75992,75994,0,2,3
21733,2,2,75994,75994,75996,0,2,0
21734,4,1,75998,75998,75999,0,1,2
21735,4,2,76002,76002,76004,0,2,3
21736,5,2,76007,76007,76009,0,2,3
21737,6,2,76013,76013,76015,0,2,4
21738,5,3,76018,76018,76021,0,3,3
21739,4,2,76022,76022,76024,0,2,1
21740,1,3,76023,76024,76027,1,4,0
21741,2,2,76025,76027,76029,2,4,0
21742,4,3,76029,76029,76032,0,3,0
21743,2,3,76031,76032,76035,1,4,0
21744,3,2,76034,76035,76037,1,3,0
21745,4,3,76038,76038,76041,0,3,1
21746,4,1,76042,76042,76043,0,1,1
21747,6,1,76048,76048,76049,0,1,5
21748,6,3,76054,76054,76057,0,3,5
21749,2,2,76056,76057,76059,1,3,0
21750,5,2,76061,76061,76063,0,2,2
21751,6,3,76067,76067,76070,0,3,4
21752,5,2,76072,76072,76074,0,2,2
21753,4,1,76076,76076,76077,0,1,2
21754,2,3,76078,76078,76081,0,3,1
21755,2,3,76080,76081,76084,1,4,0
21756,6,2,76086,76086,76088,0,2,2
21757,1,2,76087,76088,76090,1,3,0
21758,2,2,76089,76090,76092,1,3,0
21759,3,3,76092,76092,76095,0,3,0
21760,5,2,76097,76097,76099,0,2,2
21761,2,1,76099,76099,76100,0,1,0
21762,2,2,76101,76101,76103,0,2,1
21763,1,1,76102,76103,76104,1,2,0
21764,1,3,76103,76104,76107,1,4,0
21765,1,2,76104,76107,76109,3,5,0
21766,3,3,76107,76109,76112,2,5,0
21767,6,1,76113,76113,76114,0,1,1
21768,2,1,76115,76115,76116,0,1,1
21769,4,2,76119,76119,76121,0,2,3
21770,1,2,76120,76121,76123,1,3,0
21771,3,2,76123,76123,76125,0,2,0
21772,6,1,76129,76129,76130,0,1,4
21773,3,2,76132,76132,76134,0,2,2
21774,1,1,76133,76134,76135,1,2,0
21775,4,2,76137,76137,76139,0,2,2
21776,4,1,76141,76141,76142,0,1,2
21777,3,1,76144,76144,76145,0,1,2
21778,4,2,76148,76148,76150,0,2,3
21779,6,3,76154,76154,76157,0,3,4
21780,6,1,76160,76160,76161,0,1,3
21781,3,1,76163,76163,76164,0,1,2
21782,1,2,76164,76164,76166,0,2,0
21783,3,3,76167,76167,76170,0,3,1
21784,6,2,76173,76173,76175,0,2,3
21785,6,2,76179,76179,76181,0,2,4
21786,4,3,76183,76183,76186,0,3,2
21787,2,2,76185,76186,76188,1,3,0
21788,2,2,76187,76188,76190,1,3,0
21789,6,2,76193,76193,76195,0,2,3
21790,5,2,76198,76198,76200,0,2,3
21791,4,3,76202,76202,76205,0,3,2
21792,1,3,76203,76205,76208,2,5,0
21793,5,3,76208,76208,76211,0,3,0
21794,2,3,76210,76211,76214,1,4,0
21795,2,2,76212,76214,76216,2,4,0
21796,3,3,76215,76216,76219,1,4,0
21797,3,3,76218,76219,76222,1,4,0
21798,5,3,76223,76223,76226,0,3,1
21799,1,2,76224,76226,76228,2,4,0
21800,5,3,76229,76229,76232,0,3,1
21801,3,2,76232,76232,76234,0,2,0
21802,5,3,76237,76237,76240,0,3,3
21803,4,2,76241,76241,76243,0,2,1
21804,1,1,76242,76243,76244,1,2,0
21805,3,2,76245,76245,76247,0,2,1
21806,3,2,76248,76248,76250,0,2,1
21807,4,1,76252,76252,76253,0,1,2
21808,4,3,76256,76256,76259,0,3,3
21809,3,1,76259,76259,76260,0,1,0
21810,6,3,76265,76265,76268,0,3,5
21811,4,2,76269,76269,76271,0,2,1
21812,3,3,76272,76272,76275,0,3,1
21813,5,3,76277,76277,76280,0,3,2
21814,1,2,76278,76280,76282,2,4,0
21815,3,2,76281,76282,76284,1,3,0
21816,3,1,76284,76284,76285,0,1,0
21817,1,3,76285,76285,76288,0,3,0
21818,5,1,76290,76290,76291,0,1,2
21819,3,2,76293,76293,76295,0,2,2
21820,2,3,76295,76295,76298,0,3,0
21821,3,2,76298,76298,76300,0,2,0
21822,5,1,76303,76303,76304,0,1,3
21823,3,1,76306,76306,76307,0,1,2
21824,2,2,76308,76308,76310,0,2,1
21825,1,2,76309,76310,76312,1,3,0
21826,6,3,76315,76315,76318,0,3,3
21827,5,3,76320,76320,76323,0,3,2
21828,1,2,76321,76323,76325,2,4,0
21829,6,2,76327,76327,76329,0,2,2
21830,5,3,76332,76332,76335,0,3,3
21831,1,1,76333,76335,76336,2,3,0
21832,1,3,76334,76336,76339,2,5,0
21833,3,2,76337,76339,76341,2,4,0
21834,4,1,76341,76341,76342,0,1,0
21835,1,1,76342,76342,76343,0,1,0
21836,5,3,76347,76347,76350,0,3,4
21837,5,3,76352,76352,76355,0,3,2
21838,6,3,76358,76358,76361,0,3,3
21839,4,3,76362,76362,76365,0,3,1
21840,5,3,76367,76367,76370,0,3,2
21841,2,2,76369,76370,76372,1,3,0
21842,6,1,76375,76375,76376,0,1,3
21843,3,1,76378,76378,76379,0,1,2
21844,3,1,76381,76381,76382,0,1,2
21845,6,3,76387,76387,76390,0,3,5
21846,4,2,76391,76391,76393,0,2,1
21847,3,3,76394,76394,76397,0,3,1
21848,6,2,76400,76400,76402,0,2,3
21849,2,2,76402,76402,76404,0,2,0
21850,1,1,76403,76404,76405,1,2,0
21851,6,2,76409,76409,76411,0,2,4
21852,2,1,76411,76411,76412,0,1,0
21853,5,1,76416,76416,76417,0,1,4
21854,5,1,76421,76421,76422,0,1,4
21855,6,3,76427,76427,76430,0,3,5
21856,3,2,76430,76430,76432,0,2,0
21857,5,1,76435,76435,76436,0,1,3
21858,6,2,76441,76441,76443,0,2,5
21859,2,1,76443,76443,76444,0,1,0
21860,5,1,76448,76448,76449,0,1,4
21861,2,3,76450,76450,76453,0,3,1
21862,1,1,76451,76453,76454,2,3,0
21863,1,1,76452,76454,76455,2,3,0
21864,3,2,76455,76455,76457,0,2,0
21865,6,3,76461,76461,76464,0,3,4
21866,2,1,76463,76464,76465,1,2,0
21867,1,3,76464,76465,76468,1,4,0
21868,2,2,76466,76468,76470,2,4,0
21869,6,2,76472,76472,76474,0,2,2
21870,1,2,76473,76474,76476,1,3,0
21871,4,1,76477,76477,76478,0,1,1
21872,2,2,76479,76479,76481,0,2,1
21873,4,2,76483,76483,76485,0,2,2
21874,2,1,76485,76485,76486,0,1,0
21875,2,1,76487,76487,76488,0,1,1
21876,3,2,76490,76490,76492,0,2,2
21877,1,3,76491,76492,76495,1,4,0
21878,2,2,76493,76495,76497,2,4,0
21879,5,3,76498,76498,76501,0,3,1
21880,3,3,76501,76501,76504,0,3,0
21881,1,1,76502,76504,76505,2,3,0
21882,6,1,76508,76508,76509,0,1,3
21883,1,2,76509,76509,76511,0,2,0
21884,1,3,76510,76511,76514,1,4,0
21885,6,3,76516,76516,76519,0,3,2
21886,6,3,76522,76522,76525,0,3,3
21887,5,2,76527,76527,76529,0,2,2
21888,2,1,76529,76529,76530,0,1,0
21889,1,3,76530,76530,76533,0,3,0
21890,2,3,76532,76533,76536,1,4,0
21891,6,3,76538,76538,76541,0,3,2
21892,6,3,76544,76544,76547,0,3,3
21893,6,1,76550,76550,76551,0,1,3
21894,1,1,76551,76551,76552,0,1,0
21895,2,3,76553,76553,76556,0,3,1
21896,6,2,76559,76559,76561,0,2,3
21897,3,2,76562,76562,76564,0,2,1
21898,4,3,76566,76566,76569,0,3,2
21899,3,3,76569,76569,76572,0,3,0
21900,5,3,76574,76574,76577,0,3,2
21901,6,3,76580,76580,76583,0,3,3
21902,6,1,76586,76586,76587,0,1,3
21903,5,2,76591,76591,76593,0,2,4
21904,3,3,76594,76594,76597,0,3,1
21905,6,3,76600,76600,76603,0,3,3
21906,1,2,76601,76603,76605,2,4,0
21907,6,3,76607,76607,76610,0,3,2
21908,3,3,76610,76610,76613,0,3,0
21909,6,2,76616,76616,76618,0,2,3
21910,2,2,76618,76618,76620,0,2,0
21911,2,2,76620,76620,76622,0,2,0
21912,1,3,76621,76622,76625,1,4,0
21913,6,2,76627,76627,76629,0,2,2
21914,5,2,76632,76632,76634,0,2,3
21915,5,1,76637,76637,76638,0,1,3
21916,5,3,76642,76642,76645,0,3,4
21917,2,1,76644,76645,76646,1,2,0
21918,1,3,76645,76646,76649,1,4,0
21919,3,1,76648,76649,76650,1,2,0
21920,2,3,76650,76650,76653,0,3,0
21921,2,1,76652,76653,76654,1,2,0
21922,2,1,76654,76654,76655,0,1,0
21923,5,3,76659,76659,76662,0,3,4
21924,4,1,76663,76663,76664,0,1,1
21925,1,3,76664,76664,76667,0,3,0
21926,1,3,76665,76667,76670,2,5,0
21927,5,1,76670,76670,76671,0,1,0
21928,1,2,76671,76671,76673,0,2,0
21929,4,1,76675,76675,76676,0,1,2
21930,6,1,76681,76681,76682,0,1,5
21931,1,2,76682,76682,76684,0,2,0
21932,2,3,76684,76684,76687,0,3,0
21933,5,1,76689,76689,76690,0,1,2
21934,4,3,76693,76693,76696,0,3,3
21935,6,1,76699,76699,76700,0,1,3
21936,1,2,76700,76700,76702,0,2,0
21937,4,3,76704,76704,76707,0,3,2
21938,1,2,76705,76707,76709,2,4,0
21939,5,3,76710,76710,76713,0,3,1
21940,2,2,76712,76713,76715,1,3,0
21941,1,1,76713,76715,76716,2,3,0
21942,4,1,76717,76717,76718,0,1,1
21943,1,1,76718,76718,76719,0,1,0
21944,6,2,76724,76724,76726,0,2,5
21945,5,2,76729,76729,76731,0,2,3
21946,3,1,76732,76732,76733,0,1,1
21947,1,3,76733,76733,76736,0,3,0
21948,3,2,76736,76736,76738,0,2,0
21949,5,2,76741,76741,76743,0,2,3
21950,1,3,76742,76743,76746,1,4,0
21951,5,1,76747,76747,76748,0,1,1
21952,1,1,76748,76748,76749,0,1,0
21953,6,1,76754,76754,76755,0,1,5
21954,6,1,76760,76760,76761,0,1,5
21955,6,3,76766,76766,76769,0,3,5
21956,4,3,76770,76770,76773,0,3,1
21957,1,2,76771,76773,76775,2,4,0
21958,1,1,76772,76775,76776,3,4,0
21959,4,2,76776,76776,76778,0,2,0
21960,3,1,76779,76779,76780,0,1,1
21961,6,2,76785,76785,76787,0,2,5
21962,1,1,76786,76787,76788,1,2,0
21963,6,1,76792,76792,76793,0,1,4
21964,3,3,76795,76795,76798,0,3,2
21965,6,2,76801,76801,76803,0,2,3
21966,5,2,76806,76806,76808,0,2,3
21967,4,3,76810,76810,76813,0,3,2
21968,5,2,76815,76815,76817,0,2,2
21969,5,3,76820,76820,76823,0,3,3
21970,1,1,76821,76823,76824,2,3,0
21971,5,2,76826,76826,76828,0,2,2
21972,3,3,76829,76829,76832,0,3,1
21973,2,2,76831,76832,76834,1,3,0
21974,1,3,76832,76834,76837,2,5,0
21975,6,1,76838,76838,76839,0,1,1
21976,4,2,76842,76842,76844,0,2,3
21977,6,3,76848,76848,76851,0,3,4
21978,5,3,76853,76853,76856,0,3,2
21979,2,2,76855,76856,76858,1,3,0
21980,5,2,76860,76860,76862,0,2,2
21981,2,3,76862,76862,76865,0,3,0
21982,3,3,76865,76865,76868,0,3,0
21983,3,1,76868,76868,76869,0,1,0
21984,5,1,76873,76873,76874,0,1,4
21985,5,3,76878,76878,76881,0,3,4
21986,6,3,76884,76884,76887,0,3,3
21987,6,2,76890,76890,76892,0,2,3
21988,1,3,76891,76892,76895,1,4,0
21989,2,1,76893,76895,76896,2,3,0
21990,2,1,76895,76896,76897,1,2,0
21991,1,1,76896,76897,76898,1,2,0
21992,1,2,76897,76898,76900,1,3,0
21993,6,2,76903,76903,76905,0,2,3
21994,5,2,76908,76908,76910,0,2,3
21995,3,1,76911,76911,76912,0,1,1
21996,4,3,76915,76915,76918,0,3,3
21997,4,2,76919,76919,76921,0,2,1
21998,1,1,76920,76921,76922,1,2,0
21999,4,2,76924,76924,76926,0,2,2
22000,4,1,76928,76928,76929,0,1,2
22001,5,3,76933,76933,76936,0,3,4
22002,3,1,76936,76936,76937,0,1,0
22003,6,1,76942,76942,76943,0,1,5
22004,4,2,76946,76946,76948,0,2,3
22005,2,1,76948,76948,76949,0,1,0
22006,3,2,76951,76951,76953,0,2,2
22007,6,3,76957,76957,76960,0,3,4
22008,3,3,76960,76960,76963,0,3,0
22009,4,1,76964,76964,76965,0,1,1
22010,1,2,76965,76965,76967,0,2,0
22011,5,2,76970,76970,76972,0,2,3
22012,4,2,76974,76974,76976,0,2,2
22013,3,2,76977,76977,76979,0,2,1
22014,1,1,76978,76979,76980,1,2,0
22015,2,1,76980,76980,76981,0,1,0
22016,2,1,76982,76982,76983,0,1,1
22017,2,3,76984,76984,76987,0,3,1
22018,1,3,76985,76987,76990,2,5,0
22019,6,1,76991,76991,76992,0,1,1
22020,2,3,76993,76993,76996,0,3,1
22021,1,3,76994,76996,76999,2,5,0
22022,6,1,77000,77000,77001,0,1,1
22023,3,3,77003,77003,77006,0,3,2
22024,1,2,77004,77006,77008,2,4,0
22025,1,2,77005,77008,77010,3,5,0
22026,3,1,77008,77010,77011,2,3,0
22027,3,1,77011,77011,77012,0,1,0
22028,6,1,77017,77017,77018,0,1,5
22029,6,3,77023,77023,77026,0,3,5
22030,6,3,77029,77029,77032,0,3,3
22031,2,3,77031,77032,77035,1,4,0
22032,1,3,77032,77035,77038,3,6,0
22033,1,2,77033,77038,77040,5,7,0
22034,5,2,77038,77040,77042,2,4,0
22035,4,1,77042,77042,77043,0,1,0
22036,1,2,77043,77043,77045,0,2,0
22037,1,1,77044,77045,77046,1,2,0
22038,3,2,77047,77047,77049,0,2,1
22039,1,1,77048,77049,77050,1,2,0
22040,3,2,77051,77051,77053,0,2,1
22041,4,1,77055,77055,77056,0,1,2
22042,6,1,77061,77061,77062,0,1,5
22043,1,2,77062,77062,77064,0,2,0
22044,2,3,77064,77064,77067,0,3,0
22045,5,2,77069,77069,77071,0,2,2
22046,2,3,77071,77071,77074,0,3,0
22047,5,1,77076,77076,77077,0,1,2
22048,4,3,77080,77080,77083,0,3,3
22049,2,3,77082,77083,77086,1,4,0
22050,4,3,77086,77086,77089,0,3,0
22051,5,3,77091,77091,77094,0,3,2
22052,6,2,77097,77097,77099,0,2,3
22053,6,1,77103,77103,77104,0,1,4
22054,3,1,77106,77106,77107,0,1,2
22055,4,1,77110,77110,77111,0,1,3
22056,3,1,77113,77113,77114,0,1,2
22057,3,2,77116,77116,77118,0,2,2
22058,3,2,77119,77119,77121,0,2,1
22059,4,2,77123,77123,77125,0,2,2
22060,2,3,77125,77125,77128,0,3,0
22061,3,2,77128,77128,77130,0,2,0
22062,6,2,77134,77134,77136,0,2,4
22063,5,1,77139,77139,77140,0,1,3
22064,4,3,77143,77143,77146,0,3,3
22065,2,3,77145,77146,77149,1,4,0
22066,5,2,77150,77150,77152,0,2,1
22067,1,1,77151,77152,77153,1,2,0
22068,4,2,77155,77155,77157,0,2,2
22069,5,2,77160,77160,77162,0,2,3
22070,5,1,77165,77165,77166,0,1,3
22071,5,2,77170,77170,77172,0,2,4
22072,1,3,77171,77172,77175,1,4,0
22073,1,1,77172,77175,77176,3,4,0
22074,6,2,77178,77178,77180,0,2,2
22075,1,3,77179,77180,77183,1,4,0
22076,4,1,77183,77183,77184,0,1,0
22077,4,3,77187,77187,77190,0,3,3
22078,2,1,77189,77190,77191,1,2,0
22079,5,2,77194,77194,77196,0,2,3
22080,3,1,77197,77197,77198,0,1,1
22081,1,3,77198,77198,77201,0,3,0
22082,2,2,77200,77201,77203,1,3,0
22083,6,1,77206,77206,77207,0,1,3
22084,4,1,77210,77210,77211,0,1,3
22085,2,2,77212,77212,77214,0,2,1
22086,2,3,77214,77214,77217,0,3,0
22087,2,1,77216,77217,77218,1,2,0
22088,2,3,77218,77218,77221,0,3,0
22089,3,1,77221,77221,77222,0,1,0
22090,2,3,77223,77223,77226,0,3,1
22091,1,1,77224,77226,77227,2,3,0
22092,5,3,77229,77229,77232,0,3,2
22093,4,3,77233,77233,77236,0,3,1
22094,2,3,77235,77236,77239,1,4,0
22095,5,2,77240,77240,77242,0,2,1
22096,2,3,77242,77242,77245,0,3,0
22097,5,1,77247,77247,77248,0,1,2
22098,5,3,77252,77252,77255,0,3,4
22099,4,2,77256,77256,77258,0,2,1
22100,5,2,77261,77261,77263,0,2,3
22101,1,3,77262,77263,77266,1,4,0
22102,3,3,77265,77266,77269,1,4,0
22103,3,3,77268,77269,77272,1,4,0
22104,2,1,77270,77272,77273,2,3,0
22105,4,1,77274,77274,77275,0,1,1
22106,5,2,77279,77279,77281,0,2,4
22107,6,3,77285,77285,77288,0,3,4
22108,2,3,77287,77288,77291,1,4,0
22109,6,3,77293,77293,77296,0,3,2
22110,3,3,77296,77296,77299,0,3,0
22111,6,3,77302,77302,77305,0,3,3
22112,6,1,77308,77308,77309,0,1,3
22113,1,2,77309,77309,77311,0,2,0
22114,4,2,77313,77313,77315,0,2,2
22115,3,1,77316,77316,77317,0,1,1
22116,3,3,77319,77319,77322,0,3,2
22117,4,2,77323,77323,77325,0,2,1
22118,4,2,77327,77327,77329,0,2,2
22119,1,2,77328,77329,77331,1,3,0
22120,4,1,77332,77332,77333,0,1,1
22121,5,3,77337,77337,77340,0,3,4
22122,5,2,77342,77342,77344,0,2,2
22123,5,1,77347,77347,77348,0,1,3
22124,3,2,77350,77350,77352,0,2,2
22125,2,1,77352,77352,77353,0,1,0
22126,5,2,77357,77357,77359,0,2,4
22127,1,2,77358,77359,77361,1,3,0
22128,3,3,77361,77361,77364,0,3,0
22129,5,2,77366,77366,77368,0,2,2
22130,2,3,77368,77368,77371,0,3,0
22131,5,2,77373,77373,77375,0,2,2
22132,5,2,77378,77378,77380,0,2,3
22133,2,1,77380,77380,77381,0,1,0
22134,4,1,77384,77384,77385,0,1,3
22135,1,2,77385,77385,77387,0,2,0
22136,5,1,77390,77390,77391,0,1,3
22137,4,3,77394,77394,77397,0,3,3
22138,4,2,77398,77398,77400,0,2,1
22139,1,1,77399,77400,77401,1,2,0
22140,6,2,77405,77405,77407,0,2,4
22141,4,1,77409,77409,77410,0,1,2
22142,5,1,77414,77414,77415,0,1,4
22143,3,3,77417,77417,77420,0,3,2
22144,1,2,77418,77420,77422,2,4,0
22145,4,3,77422,77422,77425,0,3,0
22146,4,2,77426,77426,77428,0,2,1
22147,5,1,77431,77431,77432,0,1,3
22148,3,1,77434,77434,77435,0,1,2
22149,3,2,77437,77437,77439,0,2,2
22150,5,2,77442,77442,77444,0,2,3
22151,1,3,77443,77444,77447,1,4,0
22152,5,1,77448,77448,77449,0,1,1
22153,1,1,77449,77449,77450,0,1,0
22154,2,2,77451,77451,77453,0,2,1
22155,6,1,77457,77457,77458,0,1,4
22156,1,1,77458,77458,77459,0,1,0
22157,3,3,77461,77461,77464,0,3,2
22158,3,3,77464,77464,77467,0,3,0
22159,4,1,77468,77468,77469,0,1,1
22160,5,1,77473,77473,77474,0,1,4
22161,5,1,77478,77478,77479,0,1,4
22162,5,3,77483,77483,77486,0,3,4
22163,4,1,77487,77487,77488,0,1,1
22164,2,2,77489,77489,77491,0,2,1
22165,1,1,77490,77491,77492,1,2,0
22166,4,2,77494,77494,77496,0,2,2
22167,6,3,77500,77500,77503,0,3,4
22168,5,3,77505,77505,77508,0,3,2
22169,4,1,77509,77509,77510,0,1,1
22170,3,3,77512,77512,77515,0,3,2
22171,6,3,77518,77518,77521,0,3,3
22172,1,1,77519,77521,77522,2,3,0
22173,1,2,77520,77522,77524,2,4,0
22174,5,1,77525,77525,77526,0,1,1
22175,6,2,77531,77531,77533,0,2,5
22176,2,3,77533,77533,77536,0,3,0
22177,6,3,77539,77539,77542,0,3,3
22178,3,3,77542,77542,77545,0,3,0
22179,6,1,77548,77548,77549,0,1,3
22180,4,1,77552,77552,77553,0,1,3
22181,6,3,77558,77558,77561,0,3,5
22182,5,2,77563,77563,77565,0,2,2
22183,2,3,77565,77565,77568,0,3,0
22184,3,2,77568,77568,77570,0,2,0
22185,1,2,77569,77570,77572,1,3,0
22186,3,2,77572,77572,77574,0,2,0
22187,5,3,77577,77577,77580,0,3,3
22188,3,3,77580,77580,77583,0,3,0
22189,6,1,77586,77586,77587,0,1,3
22190,2,1,77588,77588,77589,0,1,1
22191,5,1,77593,77593,77594,0,1,4
22192,4,3,77597,77597,77600,0,3,3
22193,1,1,77598,77600,77601,2,3,0
22194,1,2,77599,77601,77603,2,4,0
22195,6,3,77605,77605,77608,0,3,2
22196,2,1,77607,77608,77609,1,2,0
22197,4,2,77611,77611,77613,0,2,2
22198,1,1,77612,77613,77614,1,2,0
22199,1,2,77613,77614,77616,1,3,0
22200,1,3,77614,77616,77619,2,5,0
22201,4,1,77618,77619,77620,1,2,0
22202,6,1,77624,77624,77625,0,1,4
22203,2,1,77626,77626,77627,0,1,1
22204,1,1,77627,77627,77628,0,1,0
22205,3,2,77630,77630,77632,0,2,2
22206,1,1,77631,77632,77633,1,2,0
22207,3,1,77634,77634,77635,0,1,1
22208,1,2,77635,77635,77637,0,2,0
22209,3,3,77638,77638,77641,0,3,1
22210,3,2,77641,77641,77643,0,2,0
22211,1,1,77642,77643,77644,1,2,0
22212,3,1,77645,77645,77646,0,1,1
22213,5,2,77650,77650,77652,0,2,4
22214,2,1,77652,77652,77653,0,1,0
22215,6,2,77658,77658,77660,0,2,5
22216,4,2,77662,77662,77664,0,2,2
22217,4,1,77666,77666,77667,0,1,2
22218,6,2,77672,77672,77674,0,2,5
22219,1,2,77673,77674,77676,1,3,0
22220,4,1,77677,77677,77678,0,1,1
22221,6,3,77683,77683,77686,0,3,5
22222,3,2,77686,77686,77688,0,2,0
22223,6,2,77692,77692,77694,0,2,4
22224,4,1,77696,77696,77697,0,1,2
22225,6,3,77702,77702,77705,0,3,5
22226,2,3,77704,77705,77708,1,4,0
22227,6,1,77710,77710,77711,0,1,2
22228,2,1,77712,77712,77713,0,1,1
22229,6,1,77718,77718,77719,0,1,5
22230,5,1,77723,77723,77724,0,1,4
22231,6,2,77729,77729,77731,0,2,5
22232,3,2,77732,77732,77734,0,2,1
22233,2,2,77734,77734,77736,0,2,0
22234,3,3,77737,77737,77740,0,3,1
22235,6,2,77743,77743,77745,0,2,3
22236,6,1,77749,77749,77750,0,1,4
22237,6,2,77755,77755,77757,0,2,5
22238,3,1,77758,77758,77759,0,1,1
22239,1,2,77759,77759,77761,0,2,0
22240,5,2,77764,77764,77766,0,2,3
22241,3,2,77767,77767,77769,0,2,1
22242,4,1,77771,77771,77772,0,1,2
22243,2,1,77773,77773,77774,0,1,1
22244,6,1,77779,77779,77780,0,1,5
22245,1,2,77780,77780,77782,0,2,0
22246,1,3,77781,77782,77785,1,4,0
22247,1,3,77782,77785,77788,3,6,0
22248,5,3,77787,77788,77791,1,4,0
22249,6,2,77793,77793,77795,0,2,2
22250,5,3,77798,77798,77801,0,3,3
22251,3,3,77801,77801,77804,0,3,0
22252,6,1,77807,77807,77808,0,1,3
22253,6,1,77813,77813,77814,0,1,5
22254,4,2,77817,77817,77819,0,2,3
22255,1,2,77818,77819,77821,1,3,0
22256,4,2,77822,77822,77824,0,2,1
22257,6,1,77828,77828,77829,0,1,4
22258,4,3,77832,77832,77835,0,3,3
22259,2,3,77834,77835,77838,1,4,0
22260,6,3,77840,77840,77843,0,3,2
22261,1,3,77841,77843,77846,2,5,0
22262,3,2,77844,77846,77848,2,4,0
22263,6,2,77850,77850,77852,0,2,2
22264,4,3,77854,77854,77857,0,3,2
22265,2,1,77856,77857,77858,1,2,0
22266,5,3,77861,77861,77864,0,3,3
22267,4,3,77865,77865,77868,0,3,1
22268,4,1,77869,77869,77870,0,1,1
22269,1,3,77870,77870,77873,0,3,0
22270,4,2,77874,77874,77876,0,2,1
22271,6,3,77880,77880,77883,0,3,4
22272,5,3,77885,77885,77888,0,3,2
22273,5,2,77890,77890,77892,0,2,2
22274,5,1,77895,77895,77896,0,1,3
22275,4,3,77899,77899,77902,0,3,3
22276,1,2,77900,77902,77904,2,4,0
22277,1,3,77901,77904,77907,3,6,0
22278,1,3,77902,77907,77910,5,8,0
22279,4,2,77906,77910,77912,4,6,0
22280,4,1,77910,77912,77913,2,3,0
22281,3,1,77913,77913,77914,0,1,0
22282,1,3,77914,77914,77917,0,3,0
22283,2,1,77916,77917,77918,1,2,0
22284,3,1,77919,77919,77920,0,1,1
22285,2,2,77921,77921,77923,0,2,1
22286,2,2,77923,77923,77925,0,2,0
22287,3,1,77926,77926,77927,0,1,1
22288,5,2,77931,77931,77933,0,2,4
22289,6,2,77937,77937,77939,0,2,4
22290,3,2,77940,77940,77942,0,2,1
22291,3,3,77943,77943,77946,0,3,1
22292,5,3,77948,77948,77951,0,3,2
22293,5,1,77953,77953,77954,0,1,2
22294,5,3,77958,77958,77961,0,3,4
22295,6,3,77964,77964,77967,0,3,3
22296,4,3,77968,77968,77971,0,3,1
22297,4,3,77972,77972,77975,0,3,1
22298,3,2,77975,77975,77977,0,2,0
22299,3,3,77978,77978,77981,0,3,1
22300,3,1,77981,77981,77982,0,1,0
22301,3,1,77984,77984,77985,0,1,2
22302,5,1,77989,77989,77990,0,1,4
22303,4,3,77993,77993,77996,0,3,3
22304,2,1,77995,77996,77997,1,2,0
22305,5,3,78000,78000,78003,0,3,3
22306,5,2,78005,78005,78007,0,2,2
22307,3,3,78008,78008,78011,0,3,1
22308,5,2,78013,78013,78015,0,2,2
22309,3,1,78016,78016,78017,0,1,1
22310,1,1,78017,78017,78018,0,1,0
22311,6,2,78023,78023,78025,0,2,5
22312,5,2,78028,78028,78030,0,2,3
22313,6,1,78034,78034,78035,0,1,4
22314,6,3,78040,78040,78043,0,3,5
22315,6,3,78046,78046,78049,0,3,3
22316,5,3,78051,78051,78054,0,3,2
22317,1,3,78052,78054,78057,2,5,0
22318,4,3,78056,78057,78060,1,4,0
22319,6,2,78062,78062,78064,0,2,2
22320,3,2,78065,78065,78067,0,2,1
22321,2,1,78067,78067,78068,0,1,0
22322,4,3,78071,78071,78074,0,3,3
22323,4,3,78075,78075,78078,0,3,1
22324,5,1,78080,78080,78081,0,1,2
22325,5,1,78085,78085,78086,0,1,4
22326,6,1,78091,78091,78092,0,1,5
22327,3,3,78094,78094,78097,0,3,2
22328,6,1,78100,78100,78101,0,1,3
22329,6,3,78106,78106,78109,0,3,5
22330,4,2,78110,78110,78112,0,2,1
22331,2,2,78112,78112,78114,0,2,0
22332,5,1,78117,78117,78118,0,1,3
22333,2,2,78119,78119,78121,0,2,1
22334,6,3,78125,78125,78128,0,3,4
22335,6,2,78131,78131,78133,0,2,3
22336,2,1,78133,78133,78134,0,1,0
22337,1,3,78134,78134,78137,0,3,0
22338,4,3,78138,78138,78141,0,3,1
22339,1,1,78139,78141,78142,2,3,0
22340,3,3,78142,78142,78145,0,3,0
22341,5,2,78147,78147,78149,0,2,2
22342,2,3,78149,78149,78152,0,3,0
22343,6,3,78155,78155,78158,0,3,3
22344,2,3,78157,78158,78161,1,4,0
22345,3,3,78160,78161,78164,1,4,0
22346,1,3,78161,78164,78167,3,6,0
22347,1,3,78162,78167,78170,5,8,0
22348,1,2,78163,78170,78172,7,9,0
22349,2,3,78165,78172,78175,7,10,0
22350,1,3,78166,78175,78178,9,12,0
22351,2,3,78168,78178,78181,10,13,0
22352,3,1,78171,78181,78182,10,11,0
22353,3,3,78174,78182,78185,8,11,0
22354,1,3,78175,78185,78188,10,13,0
22355,2,2,78177,78188,78190,11,13,0
22356,4,3,78181,78190,78193,9,12,0
22357,3,1,78184,78193,78194,9,10,0
22358,6,2,78190,78194,78196,4,6,0
22359,6,2,78196,78196,78198,0,2,0
22360,6,3,78202,78202,78205,0,3,4
22361,4,1,78206,78206,78207,0,1,1
22362,2,3,78208,78208,78211,0,3,1
22363,4,1,78212,78212,78213,0,1,1
22364,2,2,78214,78214,78216,0,2,1
22365,6,1,78220,78220,78221,0,1,4
22366,3,3,78223,78223,78226,0,3,2
22367,6,3,78229,78229,78232,0,3,3
22368,4,1,78233,78233,78234,0,1,1
22369,3,1,78236,78236,78237,0,1,2
22370,2,3,78238,78238,78241,0,3,1
22371,6,2,78244,78244,78246,0,2,3
22372,6,2,78250,78250,78252,0,2,4
22373,4,1,78254,78254,78255,0,1,2
22374,1,3,78255,78255,78258,0,3,0
22375,1,1,78256,78258,78259,2,3,0
22376,4,2,78260,78260,78262,0,2,1
22377,4,1,78264,78264,78265,0,1,2
22378,6,3,78270,78270,78273,0,3,5
22379,1,3,78271,78273,78276,2,5,0
22380,2,1,78273,78276,78277,3,4,0
22381,4,1,78277,78277,78278,0,1,0
22382,1,3,78278,78278,78281,0,3,0
22383,2,1,78280,78281,78282,1,2,0
22384,2,2,78282,78282,78284,0,2,0
22385,6,1,78288,78288,78289,0,1,4
22386,1,2,78289,78289,78291,0,2,0
22387,6,1,78295,78295,78296,0,1,4
22388,3,3,78298,78298,78301,0,3,2
22389,6,2,78304,78304,78306,0,2,3
22390,5,2,78309,78309,78311,0,2,3
22391,6,1,78315,78315,78316,0,1,4
22392,6,3,78321,78321,78324,0,3,5
22393,4,1,78325,78325,78326,0,1,1
22394,5,1,78330,78330,78331,0,1,4
22395,6,1,78336,78336,78337,0,1,5
22396,1,1,78337,78337,78338,0,1,0
22397,6,3,78343,78343,78346,0,3,5
22398,3,1,78346,78346,78347,0,1,0
22399,5,3,78351,78351,78354,0,3,4
22400,1,3,78352,78354,78357,2,5,0
22401,3,2,78355,78357,78359,2,4,0
22402,2,3,78357,78359,78362,2,5,0
22403,3,1,78360,78362,78363,2,3,0
22404,5,1,78365,78365,78366,0,1,2
22405,2,2,78367,78367,78369,0,2,1
22406,1,1,78368,78369,78370,1,2,0
22407,2,2,78370,78370,78372,0,2,0
22408,5,2,78375,78375,78377,0,2,3
22409,6,1,78381,78381,78382,0,1,4
22410,6,1,78387,78387,78388,0,1,5
22411,6,3,78393,78393,78396,0,3,5
22412,3,3,78396,78396,78399,0,3,0
22413,3,3,78399,78399,78402,0,3,0
22414,1,1,78400,78402,78403,2,3,0
22415,3,2,78403,78403,78405,0,2,0
22416,5,3,78408,78408,78411,0,3,3
22417,3,1,78411,78411,78412,0,1,0
22418,1,3,78412,78412,78415,0,3,0
22419,4,3,78416,78416,78419,0,3,1
22420,3,2,78419,78419,78421,0,2,0
22421,5,1,78424,78424,78425,0,1,3
22422,3,2,78427,78427,78429,0,2,2
22423,6,3,78433,78433,78436,0,3,4
22424,5,2,78438,78438,78440,0,2,2
22425,4,3,78442,78442,78445,0,3,2
22426,4,3,78446,78446,78449,0,3,1
22427,1,1,78447,78449,78450,2,3,0
22428,4,1,78451,78451,78452,0,1,1
22429,2,2,78453,78453,78455,0,2,1
22430,1,3,78454,78455,78458,1,4,0
22431,4,3,78458,78458,78461,0,3,0
22432,2,2,78460,78461,78463,1,3,0
22433,2,3,78462,78463,78466,1,4,0
22434,2,3,78464,78466,78469,2,5,0
22435,2,1,78466,78469,78470,3,4,0
22436,5,1,78471,78471,78472,0,1,1
22437,2,2,78473,78473,78475,0,2,1
22438,3,2,78476,78476,78478,0,2,1
22439,1,2,78477,78478,78480,1,3,0
22440,5,2,78482,78482,78484,0,2,2
22441,2,1,78484,78484,78485,0,1,0
22442,2,2,78486,78486,78488,0,2,1
22443,4,2,78490,78490,78492,0,2,2
22444,3,2,78493,78493,78495,0,2,1
22445,1,2,78494,78495,78497,1,3,0
22446,1,2,78495,78497,78499,2,4,0
22447,1,3,78496,78499,78502,3,6,0
22448,2,1,78498,78502,78503,4,5,0
22449,1,1,78499,78503,78504,4,5,0
22450,3,2,78502,78504,78506,2,4,0
22451,2,3,78504,78506,78509,2,5,0
22452,4,3,78508,78509,78512,1,4,0
22453,4,1,78512,78512,78513,0,1,0
22454,3,3,78515,78515,78518,0,3,2
22455,2,3,78517,78518,78521,1,4,0
22456,3,1,78520,78521,78522,1,2,0
22457,3,3,78523,78523,78526,0,3,1
22458,6,2,78529,78529,78531,0,2,3
22459,4,1,78533,78533,78534,0,1,2
22460,6,2,78539,78539,78541,0,2,5
22461,3,1,78542,78542,78543,0,1,1
22462,5,1,78547,78547,78548,0,1,4
22463,4,1,78551,78551,78552,0,1,3
22464,3,3,78554,78554,78557,0,3,2
22465,4,1,78558,78558,78559,0,1,1
22466,1,1,78559,78559,78560,0,1,0
22467,2,2,78561,78561,78563,0,2,1
22468,2,3,78563,78563,78566,0,3,0
22469,2,1,78565,78566,78567,1,2,0
22470,2,3,78567,78567,78570,0,3,0
22471,6,1,78573,78573,78574,0,1,3
22472,2,2,78575,78575,78577,0,2,1
22473,2,2,78577,78577,78579,0,2,0
22474,4,2,78581,78581,78583,0,2,2
22475,5,3,78586,78586,78589,0,3,3
22476,5,2,78591,78591,78593,0,2,2
22477,4,2,78595,78595,78597,0,2,2
22478,5,1,78600,78600,78601,0,1,3
22479,1,3,78601,78601,78604,0,3,0
22480,4,1,78605,78605,78606,0,1,1
22481,1,1,78606,78606,78607,0,1,0
22482,1,3,78607,78607,78610,0,3,0
22483,5,3,78612,78612,78615,0,3,2
22484,5,3,78617,78617,78620,0,3,2
22485,3,3,78620,78620,78623,0,3,0
22486,1,1,78621,78623,78624,2,3,0
22487,5,3,78626,78626,78629,0,3,2
22488,1,1,78627,78629,78630,2,3,0
22489,3,3,78630,78630,78633,0,3,0
22490,4,1,78634,78634,78635,0,1,1
22491,6,1,78640,78640,78641,0,1,5
22492,6,2,78646,78646,78648,0,2,5
22493,3,1,78649,78649,78650,0,1,1
22494,1,2,78650,78650,78652,0,2,0
22495,4,3,78654,78654,78657,0,3,2
22496,2,3,78656,78657,78660,1,4,0
22497,3,2,78659,78660,78662,1,3,0
22498,3,3,78662,78662,78665,0,3,0
22499,2,1,78664,78665,78666,1,2,0
22500,1,2,78665,78666,78668,1,3,0
22501,5,2,78670,78670,78672,0,2,2
22502,2,2,78672,78672,78674,0,2,0
22503,2,1,78674,78674,78675,0,1,0
22504,5,1,78679,78679,78680,0,1,4
22505,2,3,78681,78681,78684,0,3,1
22506,2,2,78683,78684,78686,1,3,0
22507,3,2,78686,78686,78688,0,2,0
22508,3,1,78689,78689,78690,0,1,1
22509,6,3,78695,78695,78698,0,3,5
22510,2,2,78697,78698,78700,1,3,0
22511,6,2,78703,78703,78705,0,2,3
22512,3,2,78706,78706,78708,0,2,1
22513,2,3,78708,78708,78711,0,3,0
22514,4,2,78712,78712,78714,0,2,1
22515,5,1,78717,78717,78718,0,1,3
22516,4,2,78721,78721,78723,0,2,3
22517,5,2,78726,78726,78728,0,2,3
22518,3,3,78729,78729,78732,0,3,1
22519,5,2,78734,78734,78736,0,2,2
22520,3,1,78737,78737,78738,0,1,1
22521,4,2,78741,78741,78743,0,2,3
22522,5,1,78746,78746,78747,0,1,3
22523,1,2,78747,78747,78749,0,2,0
22524,5,2,78752,78752,78754,0,2,3
22525,2,2,78754,78754,78756,0,2,0
22526,1,1,78755,78756,78757,1,2,0
22527,2,3,78757,78757,78760,0,3,0
22528,1,2,78758,78760,78762,2,4,0
22529,1,3,78759,78762,78765,3,6,0
22530,3,2,78762,78765,78767,3,5,0
22531,3,3,78765,78767,78770,2,5,0
22532,4,3,78769,78770,78773,1,4,0
22533,1,2,78770,78773,78775,3,5,0
22534,5,2,78775,78775,78777,0,2,0
22535,4,1,78779,78779,78780,0,1,2
22536,6,2,78785,78785,78787,0,2,5
22537,3,2,78788,78788,78790,0,2,1
22538,5,2,78793,78793,78795,0,2,3
22539,3,1,78796,78796,78797,0,1,1
22540,1,2,78797,78797,78799,0,2,0
22541,6,1,78803,78803,78804,0,1,4
22542,5,2,78808,78808,78810,0,2,4
22543,5,1,78813,78813,78814,0,1,3
22544,4,3,78817,78817,78820,0,3,3
22545,2,3,78819,78820,78823,1,4,0
22546,3,1,78822,78823,78824,1,2,0
22547,6,2,78828,78828,78830,0,2,4
22548,2,1,78830,78830,78831,0,1,0
22549,3,1,78833,78833,78834,0,1,2
22550,5,1,78838,78838,78839,0,1,4
22551,5,3,78843,78843,78846,0,3,4
22552,3,2,78846,78846,78848,0,2,0
22553,4,2,78850,78850,78852,0,2,2
22554,2,1,78852,78852,78853,0,1,0
22555,2,1,78854,78854,78855,0,1,1
22556,2,2,78856,78856,78858,0,2,1
22557,3,2,78859,78859,78861,0,2,1
22558,5,1,78864,78864,78865,0,1,3
22559,2,1,78866,78866,78867,0,1,1
22560,4,3,78870,78870,78873,0,3,3
22561,5,2,78875,78875,78877,0,2,2
22562,1,3,78876,78877,78880,1,4,0
22563,2,2,78878,78880,78882,2,4,0
22564,3,3,78881,78882,78885,1,4,0
22565,4,2,78885,78885,78887,0,2,0
22566,3,2,78888,78888,78890,0,2,1
22567,4,3,78892,78892,78895,0,3,2
22568,5,1,78897,78897,78898,0,1,2
22569,2,3,78899,78899,78902,0,3,1
22570,6,2,78905,78905,78907,0,2,3
22571,6,2,78911,78911,78913,0,2,4
22572,5,1,78916,78916,78917,0,1,3
22573,4,3,78920,78920,78923,0,3,3
22574,2,3,78922,78923,78926,1,4,0
22575,4,1,78926,78926,78927,0,1,0
22576,5,1,78931,78931,78932,0,1,4
22577,3,1,78934,78934,78935,0,1,2
22578,4,3,78938,78938,78941,0,3,3
22579,2,2,78940,78941,78943,1,3,0
22580,1,3,78941,78943,78946,2,5,0
22581,6,2,78947,78947,78949,0,2,1
22582,2,1,78949,78949,78950,0,1,0
22583,5,2,78954,78954,78956,0,2,4
22584,5,1,78959,78959,78960,0,1,3
22585,1,2,78960,78960,78962,0,2,0
22586,3,1,78963,78963,78964,0,1,1
22587,2,2,78965,78965,78967,0,2,1
22588,1,3,78966,78967,78970,1,4,0
22589,5,1,78971,78971,78972,0,1,1
22590,3,3,78974,78974,78977,0,3,2
22591,4,1,78978,78978,78979,0,1,1
22592,6,2,78984,78984,78986,0,2,5
22593,3,2,78987,78987,78989,0,2,1
22594,5,1,78992,78992,78993,0,1,3
22595,1,1,78993,78993,78994,0,1,0
22596,3,2,78996,78996,78998,0,2,2
22597,5,2,79001,79001,79003,0,2,3
22598,2,3,79003,79003,79006,0,3,0
22599,6,3,79009,79009,79012,0,3,3
22600,3,2,79012,79012,79014,0,2,0
22601,2,2,79014,79014,79016,0,2,0
22602,3,3,79017,79017,79020,0,3,1
22603,1,3,79018,79020,79023,2,5,0
22604,4,2,79022,79023,79025,1,3,0
22605,5,3,79027,79027,79030,0,3,2
22606,3,2,79030,79030,79032,0,2,0
22607,6,1,79036,79036,79037,0,1,4
22608,3,1,79039,79039,79040,0,1,2
22609,2,2,79041,79041,79043,0,2,1
22610,5,3,79046,79046,79049,0,3,3
22611,3,1,79049,79049,79050,0,1,0
22612,1,1,79050,79050,79051,0,1,0
22613,5,1,79055,79055,79056,0,1,4
22614,6,1,79061,79061,79062,0,1,5
22615,6,2,79067,79067,79069,0,2,5
22616,3,1,79070,79070,79071,0,1,1
22617,4,3,79074,79074,79077,0,3,3
22618,6,2,79080,79080,79082,0,2,3
22619,1,1,79081,79082,79083,1,2,0
22620,1,3,79082,79083,79086,1,4,0
22621,5,3,79087,79087,79090,0,3,1
22622,5,2,79092,79092,79094,0,2,2
22623,6,3,79098,79098,79101,0,3,4
22624,6,2,79104,79104,79106,0,2,3
22625,5,2,79109,79109,79111,0,2,3
22626,4,2,79113,79113,79115,0,2,2
22627,4,2,79117,79117,79119,0,2,2
22628,4,2,79121,79121,79123,0,2,2
22629,3,2,79124,79124,79126,0,2,1
22630,4,2,79128,79128,79130,0,2,2
22631,5,2,79133,79133,79135,0,2,3
22632,2,3,79135,79135,79138,0,3,0
22633,5,2,79140,79140,79142,0,2,2
22634,1,3,79141,79142,79145,1,4,0
22635,1,3,79142,79145,79148,3,6,0
22636,2,2,79144,79148,79150,4,6,0
22637,1,1,79145,79150,79151,5,6,0
22638,4,2,79149,79151,79153,2,4,0
22639,2,1,79151,79153,79154,2,3,0
22640,4,1,79155,79155,79156,0,1,1
22641,5,2,79160,79160,79162,0,2,4
22642,5,3,79165,79165,79168,0,3,3
22643,6,2,79171,79171,79173,0,2,3
22644,2,1,79173,79173,79174,0,1,0
22645,5,3,79178,79178,79181,0,3,4
22646,1,1,79179,79181,79182,2,3,0
22647,4,2,79183,79183,79185,0,2,1
22648,3,1,79186,79186,79187,0,1,1
22649,5,3,79191,79191,79194,0,3,4
22650,6,3,79197,79197,79200,0,3,3
22651,4,1,79201,79201,79202,0,1,1
22652,6,2,79207,79207,79209,0,2,5
22653,6,1,79213,79213,79214,0,1,4
22654,5,2,79218,79218,79220,0,2,4
22655,1,1,79219,79220,79221,1,2,0
22656,5,1,79224,79224,79225,0,1,3
22657,5,2,79229,79229,79231,0,2,4
22658,3,2,79232,79232,79234,0,2,1
22659,3,1,79235,79235,79236,0,1,1
22660,6,1,79241,79241,79242,0,1,5
22661,3,3,79244,79244,79247,0,3,2
22662,1,2,79245,79247,79249,2,4,0
22663,2,3,79247,79249,79252,2,5,0
22664,5,3,79252,79252,79255,0,3,0
22665,4,2,79256,79256,79258,0,2,1
22666,2,2,79258,79258,79260,0,2,0
22667,3,1,79261,79261,79262,0,1,1
22668,3,3,79264,79264,79267,0,3,2
22669,1,3,79265,79267,79270,2,5,0
22670,5,3,79270,79270,79273,0,3,0
22671,2,2,79272,79273,79275,1,3,0
22672,5,3,79277,79277,79280,0,3,2
22673,5,2,79282,79282,79284,0,2,2
22674,1,1,79283,79284,79285,1,2,0
22675,5,1,79288,79288,79289,0,1,3
22676,5,3,79293,79293,79296,0,3,4
22677,5,2,79298,79298,79300,0,2,2
22678,2,2,79300,79300,79302,0,2,0
22679,3,2,79303,79303,79305,0,2,1
22680,5,3,79308,79308,79311,0,3,3
22681,2,1,79310,79311,79312,1,2,0
22682,2,2,79312,79312,79314,0,2,0
22683,3,3,79315,79315,79318,0,3,1
22684,1,1,79316,79318,79319,2,3,0
22685,1,3,79317,79319,79322,2,5,0
22686,6,2,79323,79323,79325,0,2,1
22687,4,2,79327,79327,79329,0,2,2
22688,6,1,79333,79333,79334,0,1,4
22689,6,1,79339,79339,79340,0,1,5
22690,6,2,79345,79345,79347,0,2,5
22691,6,2,79351,79351,79353,0,2,4
22692,2,1,79353,79353,79354,0,1,0
22693,4,3,79357,79357,79360,0,3,3
22694,5,2,79362,79362,79364,0,2,2
22695,1,3,79363,79364,79367,1,4,0
22696,2,3,79365,79367,79370,2,5,0
22697,2,2,79367,79370,79372,3,5,0
22698,4,2,79371,79372,79374,1,3,0
22699,1,3,79372,79374,79377,2,5,0
22700,2,3,79374,79377,79380,3,6,0
22701,5,3,79379,79380,79383,1,4,0
22702,4,2,79383,79383,79385,0,2,0
22703,5,1,79388,79388,79389,0,1,3
22704,2,2,79390,79390,79392,0,2,1
22705,4,1,79394,79394,79395,0,1,2
22706,5,1,79399,79399,79400,0,1,4
22707,6,1,79405,79405,79406,0,1,5
22708,6,1,79411,79411,79412,0,1,5
22709,4,2,79415,79415,79417,0,2,3
22710,5,3,79420,79420,79423,0,3,3
22711,1,1,79421,79423,79424,2,3,0
22712,5,1,79426,79426,79427,0,1,2
22713,3,3,79429,79429,79432,0,3,2
22714,5,3,79434,79434,79437,0,3,2
22715,5,1,79439,79439,79440,0,1,2
22716,6,2,79445,79445,79447,0,2,5
22717,5,2,79450,79450,79452,0,2,3
22718,6,3,79456,79456,79459,0,3,4
22719,5,2,79461,79461,79463,0,2,2
22720,6,2,79467,79467,79469,0,2,4
22721,6,1,79473,79473,79474,0,1,4
22722,3,3,79476,79476,79479,0,3,2
22723,6,1,79482,79482,79483,0,1,3
22724,3,3,79485,79485,79488,0,3,2
22725,4,2,79489,79489,79491,0,2,1
22726,3,1,79492,79492,79493,0,1,1
22727,6,3,79498,79498,79501,0,3,5
22728,2,1,79500,79501,79502,1,2,0
22729,4,2,79504,79504,79506,0,2,2
22730,6,1,79510,79510,79511,0,1,4
22731,3,1,79513,79513,79514,0,1,2
22732,2,2,79515,79515,79517,0,2,1
22733,4,1,79519,79519,79520,0,1,2
22734,5,2,79524,79524,79526,0,2,4
22735,3,3,79527,79527,79530,0,3,1
22736,6,3,79533,79533,79536,0,3,3
22737,1,3,79534,79536,79539,2,5,0
22738,3,3,79537,79539,79542,2,5,0
22739,4,3,79541,79542,79545,1,4,0
22740,6,3,79547,79547,79550,0,3,2
22741,2,2,79549,79550,79552,1,3,0
22742,1,3,79550,79552,79555,2,5,0
22743,4,3,79554,79555,79558,1,4,0
22744,4,2,79558,79558,79560,0,2,0
22745,4,1,79562,79562,79563,0,1,2
22746,2,1,79564,79564,79565,0,1,1
22747,3,3,79567,79567,79570,0,3,2
22748,6,3,79573,79573,79576,0,3,3
22749,2,1,79575,79576,79577,1,2,0
22750,2,3,79577,79577,79580,0,3,0
22751,5,3,79582,79582,79585,0,3,2
22752,6,3,79588,79588,79591,0,3,3
22753,3,3,79591,79591,79594,0,3,0
22754,6,3,79597,79597,79600,0,3,3
22755,6,2,79603,79603,79605,0,2,3
22756,2,2,79605,79605,79607,0,2,0
22757,4,3,79609,79609,79612,0,3,2
22758,3,2,79612,79612,79614,0,2,0
22759,1,1,79613,79614,79615,1,2,0
22760,1,2,79614,79615,79617,1,3,0
22761,1,3,79615,79617,79620,2,5,0
22762,6,1,79621,79621,79622,0,1,1
22763,1,1,79622,79622,79623,0,1,0
22764,3,1,79625,79625,79626,0,1,2
22765,3,3,79628,79628,79631,0,3,2
22766,6,2,79634,79634,79636,0,2,3
22767,2,1,79636,79636,79637,0,1,0
22768,3,3,79639,79639,79642,0,3,2
22769,2,3,79641,79642,79645,1,4,0
22770,2,2,79643,79645,79647,2,4,0
22771,6,2,79649,79649,79651,0,2,2
22772,5,3,79654,79654,79657,0,3,3
22773,2,2,79656,79657,79659,1,3,0
22774,4,1,79660,79660,79661,0,1,1
22775,4,2,79664,79664,79666,0,2,3
22776,5,3,79669,79669,79672,0,3,3
22777,2,1,79671,79672,79673,1,2,0
22778,5,2,79676,79676,79678,0,2,3
22779,4,2,79680,79680,79682,0,2,2
22780,2,3,79682,79682,79685,0,3,0
22781,1,3,79683,79685,79688,2,5,0
22782,2,3,79685,79688,79691,3,6,0
22783,5,2,79690,79691,79693,1,3,0
22784,6,1,79696,79696,79697,0,1,3
22785,2,2,79698,79698,79700,0,2,1
22786,3,3,79701,79701,79704,0,3,1
22787,1,3,79702,79704,79707,2,5,0
22788,5,3,79707,79707,79710,0,3,0
22789,6,1,79713,79713,79714,0,1,3
22790,5,3,79718,79718,79721,0,3,4
22791,3,3,79721,79721,79724,0,3,0
22792,4,3,79725,79725,79728,0,3,1
22793,2,2,79727,79728,79730,1,3,0
22794,5,1,79732,79732,79733,0,1,2
22795,3,3,79735,79735,79738,0,3,2
22796,1,2,79736,79738,79740,2,4,0
22797,2,2,79738,79740,79742,2,4,0
22798,4,1,79742,79742,79743,0,1,0
22799,4,1,79746,79746,79747,0,1,3
22800,2,2,79748,79748,79750,0,2,1
22801,2,1,79750,79750,79751,0,1,0
22802,1,2,79751,79751,79753,0,2,0
22803,1,2,79752,79753,79755,1,3,0
22804,4,2,79756,79756,79758,0,2,1
22805,4,3,79760,79760,79763,0,3,2
22806,5,2,79765,79765,79767,0,2,2
22807,4,1,79769,79769,79770,0,1,2
22808,4,2,79773,79773,79775,0,2,3
22809,4,2,79777,79777,79779,0,2,2
22810,5,2,79782,79782,79784,0,2,3
22811,3,2,79785,79785,79787,0,2,1
22812,1,1,79786,79787,79788,1,2,0
22813,3,3,79789,79789,79792,0,3,1
22814,5,2,79794,79794,79796,0,2,2
22815,2,2,79796,79796,79798,0,2,0
22816,4,3,79800,79800,79803,0,3,2
22817,5,2,79805,79805,79807,0,2,2
22818,2,2,79807,79807,79809,0,2,0
22819,5,1,79812,79812,79813,0,1,3
22820,5,1,79817,79817,79818,0,1,4
22821,5,3,79822,79822,79825,0,3,4
22822,2,1,79824,79825,79826,1,2,0
22823,3,1,79827,79827,79828,0,1,1
22824,6,2,79833,79833,79835,0,2,5
22825,5,2,79838,79838,79840,0,2,3
22826,2,2,79840,79840,79842,0,2,0
22827,1,1,79841,79842,79843,1,2,0
22828,6,1,79847,79847,79848,0,1,4
22829,3,2,79850,79850,79852,0,2,2
22830,6,2,79856,79856,79858,0,2,4
22831,3,3,79859,79859,79862,0,3,1
22832,1,1,79860,79862,79863,2,3,0
22833,6,1,79866,79866,79867,0,1,3
22834,1,1,79867,79867,79868,0,1,0
22835,4,3,79871,79871,79874,0,3,3
22836,4,2,79875,79875,79877,0,2,1
22837,2,2,79877,79877,79879,0,2,0
22838,5,3,79882,79882,79885,0,3,3
22839,6,3,79888,79888,79891,0,3,3
22840,5,3,79893,79893,79896,0,3,2
22841,5,3,79898,79898,79901,0,3,2
22842,2,1,79900,79901,79902,1,2,0
22843,5,3,79905,79905,79908,0,3,3
22844,4,3,79909,79909,79912,0,3,1
22845,4,1,79913,79913,79914,0,1,1
22846,6,3,79919,79919,79922,0,3,5
22847,2,1,79921,79922,79923,1,2,0
22848,6,2,79927,79927,79929,0,2,4
22849,2,3,79929,79929,79932,0,3,0
22850,6,3,79935,79935,79938,0,3,3
22851,5,2,79940,79940,79942,0,2,2
22852,2,2,79942,79942,79944,0,2,0
22853,1,1,79943,79944,79945,1,2,0
22854,6,1,79949,79949,79950,0,1,4
22855,5,3,79954,79954,79957,0,3,4
22856,2,1,79956,79957,79958,1,2,0
22857,2,3,79958,79958,79961,0,3,0
22858,2,2,79960,79961,79963,1,3,0
22859,1,3,79961,79963,79966,2,5,0
22860,2,3,79963,79966,79969,3,6,0
22861,1,1,79964,79969,79970,5,6,0
22862,3,3,79967,79970,79973,3,6,0
22863,5,1,79972,79973,79974,1,2,0
22864,6,1,79978,79978,79979,0,1,4
22865,3,1,79981,79981,79982,0,1,2
22866,5,2,79986,79986,79988,0,2,4
22867,2,2,79988,79988,79990,0,2,0
22868,3,2,79991,79991,79993,0,2,1
22869,5,1,79996,79996,79997,0,1,3
22870,3,3,79999,79999,80002,0,3,2
22871,2,3,80001,80002,80005,1,4,0
22872,3,2,80004,80005,80007,1,3,0
22873,3,2,80007,80007,80009,0,2,0
22874,4,1,80011,80011,80012,0,1,2
22875,5,3,80016,80016,80019,0,3,4
22876,4,2,80020,80020,80022,0,2,1
22877,6,1,80026,80026,80027,0,1,4
22878,4,1,80030,80030,80031,0,1,3
22879,5,3,80035,80035,80038,0,3,4
22880,5,3,80040,80040,80043,0,3,2
22881,3,1,80043,80043,80044,0,1,0
22882,5,3,80048,80048,80051,0,3,4
22883,1,2,80049,80051,80053,2,4,0
22884,4,2,80053,80053,80055,0,2,0
22885,6,1,80059,80059,80060,0,1,4
22886,4,2,80063,80063,80065,0,2,3
22887,5,3,80068,80068,80071,0,3,3
22888,2,3,80070,80071,80074,1,4,0
22889,6,2,80076,80076,80078,0,2,2
22890,2,3,80078,80078,80081,0,3,0
22891,6,2,80084,80084,80086,0,2,3
22892,5,3,80089,80089,80092,0,3,3
22893,5,1,80094,80094,80095,0,1,2
22894,3,2,80097,80097,80099,0,2,2
22895,5,3,80102,80102,80105,0,3,3
22896,1,1,80103,80105,80106,2,3,0
22897,1,1,80104,80106,80107,2,3,0
22898,2,3,80106,80107,80110,1,4,0
22899,5,1,80111,80111,80112,0,1,1
22900,2,1,80113,80113,80114,0,1,1
22901,1,3,80114,80114,80117,0,3,0
22902,3,3,80117,80117,80120,0,3,0
22903,1,3,80118,80120,80123,2,5,0
22904,3,3,80121,80123,80126,2,5,0
22905,3,2,80124,80126,80128,2,4,0
22906,1,3,80125,80128,80131,3,6,0
22907,4,2,80129,80131,80133,2,4,0
22908,4,1,80133,80133,80134,0,1,0
22909,4,1,80137,80137,80138,0,1,3
22910,2,3,80139,80139,80142,0,3,1
22911,5,2,80144,80144,80146,0,2,2
22912,3,2,80147,80147,80149,0,2,1
22913,6,2,80153,80153,80155,0,2,4
22914,1,3,80154,80155,80158,1,4,0
22915,3,1,80157,80158,80159,1,2,0
22916,2,3,80159,80159,80162,0,3,0
22917,2,2,80161,80162,80164,1,3,0
22918,3,1,80164,80164,80165,0,1,0
22919,5,1,80169,80169,80170,0,1,4
22920,6,2,80175,80175,80177,0,2,5
22921,5,1,80180,80180,80181,0,1,3
22922,6,1,80186,80186,80187,0,1,5
22923,3,2,80189,80189,80191,0,2,2
22924,1,3,80190,80191,80194,1,4,0
22925,6,3,80196,80196,80199,0,3,2
22926,6,2,80202,80202,80204,0,2,3
22927,5,1,80207,80207,80208,0,1,3
22928,5,2,80212,80212,80214,0,2,4
22929,2,1,80214,80214,80215,0,1,0
22930,4,1,80218,80218,80219,0,1,3
22931,3,2,80221,80221,80223,0,2,2
22932,4,3,80225,80225,80228,0,3,2
22933,1,2,80226,80228,80230,2,4,0
22934,2,2,80228,80230,80232,2,4,0
22935,4,1,80232,80232,80233,0,1,0
22936,1,1,80233,80233,80234,0,1,0
22937,2,3,80235,80235,80238,0,3,1
22938,2,1,80237,80238,80239,1,2,0
22939,3,2,80240,80240,80242,0,2,1
22940,1,1,80241,80242,80243,1,2,0
22941,1,3,80242,80243,80246,1,4,0
22942,4,2,80246,80246,80248,0,2,0
22943,2,2,80248,80248,80250,0,2,0
22944,3,1,80251,80251,80252,0,1,1
22945,2,2,80253,80253,80255,0,2,1
22946,5,3,80258,80258,80261,0,3,3
22947,3,3,80261,80261,80264,0,3,0
22948,4,1,80265,80265,80266,0,1,1
22949,3,2,80268,80268,80270,0,2,2
22950,4,1,80272,80272,80273,0,1,2
22951,5,1,80277,80277,80278,0,1,4
22952,4,1,80281,80281,80282,0,1,3
22953,6,1,80287,80287,80288,0,1,5
22954,1,2,80288,80288,80290,0,2,0
22955,4,1,80292,80292,80293,0,1,2
22956,4,3,80296,80296,80299,0,3,3
22957,3,1,80299,80299,80300,0,1,0
22958,5,3,80304,80304,80307,0,3,4
22959,1,3,80305,80307,80310,2,5,0
22960,4,2,80309,80310,80312,1,3,0
22961,1,3,80310,80312,80315,2,5,0
22962,4,3,80314,80315,80318,1,4,0
22963,3,1,80317,80318,80319,1,2,0
22964,6,2,80323,80323,80325,0,2,4
22965,2,1,80325,80325,80326,0,1,0
22966,4,3,80329,80329,80332,0,3,3
22967,6,3,80335,80335,80338,0,3,3
22968,3,2,80338,80338,80340,0,2,0
22969,1,2,80339,80340,80342,1,3,0
22970,6,2,80345,80345,80347,0,2,3
22971,3,2,80348,80348,80350,0,2,1
22972,3,3,80351,80351,80354,0,3,1
22973,3,2,80354,80354,80356,0,2,0
22974,6,3,80360,80360,80363,0,3,4
22975,5,1,80365,80365,80366,0,1,2
22976,2,3,80367,80367,80370,0,3,1
22977,1,2,80368,80370,80372,2,4,0
22978,6,1,80374,80374,80375,0,1,2
22979,2,1,80376,80376,80377,0,1,1
22980,1,3,80377,80377,80380,0,3,0
22981,5,2,80382,80382,80384,0,2,2
22982,4,2,80386,80386,80388,0,2,2
22983,3,3,80389,80389,80392,0,3,1
22984,2,2,80391,80392,80394,1,3,0
22985,4,2,80395,80395,80397,0,2,1
22986,3,1,80398,80398,80399,0,1,1
22987,4,2,80402,80402,80404,0,2,3
22988,1,2,80403,80404,80406,1,3,0
22989,3,2,80406,80406,80408,0,2,0
22990,5,1,80411,80411,80412,0,1,3
22991,5,2,80416,80416,80418,0,2,4
22992,1,3,80417,80418,80421,1,4,0
22993,6,3,80423,80423,80426,0,3,2
22994,1,1,80424,80426,80427,2,3,0
22995,4,1,80428,80428,80429,0,1,1
22996,2,2,80430,80430,80432,0,2,1
22997,1,3,80431,80432,80435,1,4,0
22998,6,2,80437,80437,80439,0,2,2
22999,1,3,80438,80439,80442,1,4,0
23000,3,1,80441,80442,80443,1,2,0
23001,3,2,80444,80444,80446,0,2,1
23002,3,1,80447,80447,80448,0,1,1
23003,4,2,80451,80451,80453,0,2,3
23004,4,3,80455,80455,80458,0,3,2
23005,3,1,80458,80458,80459,0,1,0
23006,3,3,80461,80461,80464,0,3,2
23007,2,1,80463,80464,80465,1,2,0
23008,1,1,80464,80465,80466,1,2,0
23009,5,3,80469,80469,80472,0,3,3
23010,3,2,80472,80472,80474,0,2,0
23011,1,1,80473,80474,80475,1,2,0
23012,5,2,80478,80478,80480,0,2,3
23013,4,1,80482,80482,80483,0,1,2
23014,1,3,80483,80483,80486,0,3,0
23015,1,2,80484,80486,80488,2,4,0
23016,3,3,80487,80488,80491,1,4,0
23017,2,1,80489,80491,80492,2,3,0
23018,2,1,80491,80492,80493,1,2,0
23019,6,1,80497,80497,80498,0,1,4
23020,3,3,80500,80500,80503,0,3,2
23021,3,1,80503,80503,80504,0,1,0
23022,5,3,80508,80508,80511,0,3,4
23023,6,1,80514,80514,80515,0,1,3
23024,6,3,80520,80520,80523,0,3,5
23025,4,3,80524,80524,80527,0,3,1
23026,6,2,80530,80530,80532,0,2,3
23027,4,3,80534,80534,80537,0,3,2
23028,6,2,80540,80540,80542,0,2,3
23029,6,1,80546,80546,80547,0,1,4
23030,2,1,80548,80548,80549,0,1,1
23031,1,1,80549,80549,80550,0,1,0
23032,5,1,80554,80554,80555,0,1,4
23033,1,2,80555,80555,80557,0,2,0
23034,4,1,80559,80559,80560,0,1,2
23035,6,1,80565,80565,80566,0,1,5
23036,5,3,80570,80570,80573,0,3,4
23037,3,3,80573,80573,80576,0,3,0
23038,5,2,80578,80578,80580,0,2,2
23039,2,1,80580,80580,80581,0,1,0
23040,6,1,80586,80586,80587,0,1,5
23041,3,1,80589,80589,80590,0,1,2
23042,5,1,80594,80594,80595,0,1,4
23043,4,1,80598,80598,80599,0,1,3
23044,4,1,80602,80602,80603,0,1,3
23045,2,3,80604,80604,80607,0,3,1
23046,5,2,80609,80609,80611,0,2,2
23047,3,1,80612,80612,80613,0,1,1
23048,6,2,80618,80618,80620,0,2,5
23049,6,1,80624,80624,80625,0,1,4
23050,5,1,80629,80629,80630,0,1,4
23051,5,1,80634,80634,80635,0,1,4
23052,5,3,80639,80639,80642,0,3,4
23053,2,1,80641,80642,80643,1,2,0
23054,5,2,80646,80646,80648,0,2,3
23055,3,2,80649,80649,80651,0,2,1
23056,5,3,80654,80654,80657,0,3,3
23057,4,3,80658,80658,80661,0,3,1
23058,6,1,80664,80664,80665,0,1,3
23059,4,3,80668,80668,80671,0,3,3
23060,6,1,80674,80674,80675,0,1,3
23061,3,3,80677,80677,80680,0,3,2
23062,5,1,80682,80682,80683,0,1,2
23063,4,3,80686,80686,80689,0,3,3
23064,1,3,80687,80689,80692,2,5,0
23065,2,3,80689,80692,80695,3,6,0
23066,5,2,80694,80695,80697,1,3,0
23067,5,3,80699,80699,80702,0,3,2
23068,2,2,80701,80702,80704,1,3,0
23069,4,3,80705,80705,80708,0,3,1
23070,6,3,80711,80711,80714,0,3,3
23071,4,2,80715,80715,80717,0,2,1
23072,3,1,80718,80718,80719,0,1,1
23073,3,1,80721,80721,80722,0,1,2
23074,5,1,80726,80726,80727,0,1,4
23075,3,2,80729,80729,80731,0,2,2
23076,6,3,80735,80735,80738,0,3,4
23077,1,2,80736,80738,80740,2,4,0
23078,1,3,80737,80740,80743,3,6,0
23079,2,3,80739,80743,80746,4,7,0
23080,3,3,80742,80746,80749,4,7,0
23081,5,3,80747,80749,80752,2,5,0
23082,6,2,80753,80753,80755,0,2,1
23083,1,2,80754,80755,80757,1,3,0
23084,4,1,80758,80758,80759,0,1,1
23085,3,3,80761,80761,80764,0,3,2
23086,5,2,80766,80766,80768,0,2,2
23087,6,1,80772,80772,80773,0,1,4
23088,4,2,80776,80776,80778,0,2,3
23089,3,1,80779,80779,80780,0,1,1
23090,5,3,80784,80784,80787,0,3,4
23091,1,2,80785,80787,80789,2,4,0
23092,5,3,80790,80790,80793,0,3,1
23093,1,3,80791,80793,80796,2,5,0
23094,2,1,80793,80796,80797,3,4,0
23095,1,2,80794,80797,80799,3,5,0
23096,2,1,80796,80799,80800,3,4,0
23097,1,1,80797,80800,80801,3,4,0
23098,6,2,80803,80803,80805,0,2,2
23099,4,3,80807,80807,80810,0,3,2
23100,5,3,80812,80812,80815,0,3,2
23101,5,2,80817,80817,80819,0,2,2
23102,1,1,80818,80819,80820,1,2,0
23103,3,3,80821,80821,80824,0,3,1
23104,1,1,80822,80824,80825,2,3,0
23105,6,2,80828,80828,80830,0,2,3
23106,5,1,80833,80833,80834,0,1,3
23107,3,3,80836,80836,80839,0,3,2
23108,5,2,80841,80841,80843,0,2,2
23109,1,3,80842,80843,80846,1,4,0
23110,4,3,80846,80846,80849,0,3,0
23111,4,3,80850,80850,80853,0,3,1
23112,6,3,80856,80856,80859,0,3,3
23113,3,1,80859,80859,80860,0,1,0
23114,1,1,80860,80860,80861,0,1,0
23115,1,3,80861,80861,80864,0,3,0
23116,2,1,80863,80864,80865,1,2,0
23117,1,1,80864,80865,80866,1,2,0
23118,3,1,80867,80867,80868,0,1,1
23119,1,2,80868,80868,80870,0,2,0
23120,6,2,80874,80874,80876,0,2,4
23121,5,1,80879,80879,80880,0,1,3
23122,4,2,80883,80883,80885,0,2,3
23123,2,2,80885,80885,80887,0,2,0
23124,6,1,80891,80891,80892,0,1,4
23125,6,3,80897,80897,80900,0,3,5
23126,4,2,80901,80901,80903,0,2,1
23127,4,2,80905,80905,80907,0,2,2
23128,3,2,80908,80908,80910,0,2,1
23129,4,2,80912,80912,80914,0,2,2
23130,2,3,80914,80914,80917,0,3,0
23131,6,3,80920,80920,80923,0,3,3
23132,5,1,80925,80925,80926,0,1,2
23133,3,3,80928,80928,80931,0,3,2
23134,4,3,80932,80932,80935,0,3,1
23135,3,1,80935,80935,80936,0,1,0
23136,5,3,80940,80940,80943,0,3,4
23137,6,3,80946,80946,80949,0,3,3
23138,3,1,80949,80949,80950,0,1,0
23139,1,3,80950,80950,80953,0,3,0
23140,6,2,80956,80956,80958,0,2,3
23141,3,2,80959,80959,80961,0,2,1
23142,6,2,80965,80965,80967,0,2,4
23143,6,2,80971,80971,80973,0,2,4
23144,4,1,80975,80975,80976,0,1,2
23145,3,1,80978,80978,80979,0,1,2
23146,2,3,80980,80980,80983,0,3,1
23147,5,3,80985,80985,80988,0,3,2
23148,1,1,80986,80988,80989,2,3,0
23149,4,3,80990,80990,80993,0,3,1
23150,2,1,80992,80993,80994,1,2,0
23151,5,1,80997,80997,80998,0,1,3
23152,5,2,81002,81002,81004,0,2,4
23153,3,1,81005,81005,81006,0,1,1
23154,3,1,81008,81008,81009,0,1,2
23155,4,1,81012,81012,81013,0,1,3
23156,4,1,81016,81016,81017,0,1,3
23157,6,2,81022,81022,81024,0,2,5
23158,3,3,81025,81025,81028,0,3,1
23159,2,1,81027,81028,81029,1,2,0
23160,4,1,81031,81031,81032,0,1,2
23161,5,1,81036,81036,81037,0,1,4
23162,2,1,81038,81038,81039,0,1,1
23163,4,3,81042,81042,81045,0,3,3
23164,5,3,81047,81047,81050,0,3,2
23165,4,3,81051,81051,81054,0,3,1
23166,5,3,81056,81056,81059,0,3,2
23167,6,1,81062,81062,81063,0,1,3
23168,4,3,81066,81066,81069,0,3,3
23169,1,3,81067,81069,81072,2,5,0
23170,5,2,81072,81072,81074,0,2,0
23171,4,3,81076,81076,81079,0,3,2
23172,6,1,81082,81082,81083,0,1,3
23173,2,1,81084,81084,81085,0,1,1
23174,2,3,81086,81086,81089,0,3,1
23175,3,1,81089,81089,81090,0,1,0
23176,1,2,81090,81090,81092,0,2,0
23177,4,2,81094,81094,81096,0,2,2
23178,5,1,81099,81099,81100,0,1,3
23179,6,2,81105,81105,81107,0,2,5
23180,4,3,81109,81109,81112,0,3,2
23181,6,3,81115,81115,81118,0,3,3
23182,2,1,81117,81118,81119,1,2,0
23183,3,3,81120,81120,81123,0,3,1
23184,2,1,81122,81123,81124,1,2,0
23185,2,3,81124,81124,81127,0,3,0
23186,2,1,81126,81127,81128,1,2,0
23187,4,3,81130,81130,81133,0,3,2
23188,6,2,81136,81136,81138,0,2,3
23189,6,3,81142,81142,81145,0,3,4
23190,1,3,81143,81145,81148,2,5,0
23191,3,1,81146,81148,81149,2,3,0
23192,6,1,81152,81152,81153,0,1,3
23193,5,1,81157,81157,81158,0,1,4
23194,4,2,81161,81161,81163,0,2,3
23195,1,1,81162,81163,81164,1,2,0
23196,2,2,81164,81164,81166,0,2,0
23197,3,2,81167,81167,81169,0,2,1
23198,2,1,81169,81169,81170,0,1,0
23199,2,2,81171,81171,81173,0,2,1
23200,2,2,81173,81173,81175,0,2,0
23201,1,2,81174,81175,81177,1,3,0
23202,2,2,81176,81177,81179,1,3,0
23203,2,3,81178,81179,81182,1,4,0
23204,4,2,81182,81182,81184,0,2,0
23205,3,3,81185,81185,81188,0,3,1
23206,6,2,81191,81191,81193,0,2,3
23207,1,2,81192,81193,81195,1,3,0
23208,1,2,81193,81195,81197,2,4,0
23209,5,1,81198,81198,81199,0,1,1
23210,4,3,81202,81202,81205,0,3,3
23211,1,3,81203,81205,81208,2,5,0
23212,4,3,81207,81208,81211,1,4,0
23213,4,2,81211,81211,81213,0,2,0
23214,1,1,81212,81213,81214,1,2,0
23215,5,3,81217,81217,81220,0,3,3
23216,4,3,81221,81221,81224,0,3,1
23217,1,3,81222,81224,81227,2,5,0
23218,5,2,81227,81227,81229,0,2,0
23219,2,3,81229,81229,81232,0,3,0
23220,6,1,81235,81235,81236,0,1,3
23221,1,1,81236,81236,81237,0,1,0
23222,5,2,81241,81241,81243,0,2,4
23223,3,3,81244,81244,81247,0,3,1
23224,2,3,81246,81247,81250,1,4,0
23225,6,2,81252,81252,81254,0,2,2
23226,5,2,81257,81257,81259,0,2,3
23227,3,2,81260,81260,81262,0,2,1
23228,2,2,81262,81262,81264,0,2,0
23229,3,2,81265,81265,81267,0,2,1
23230,2,1,81267,81267,81268,0,1,0
23231,4,1,81271,81271,81272,0,1,3
23232,6,2,81277,81277,81279,0,2,5
23233,1,1,81278,81279,81280,1,2,0
23234,6,2,81284,81284,81286,0,2,4
23235,6,3,81290,81290,81293,0,3,4
23236,1,3,81291,81293,81296,2,5,0
23237,2,2,81293,81296,81298,3,5,0
23238,5,3,81298,81298,81301,0,3,0
23239,1,3,81299,81301,81304,2,5,0
23240,6,1,81305,81305,81306,0,1,1
23241,3,2,81308,81308,81310,0,2,2
23242,5,1,81313,81313,81314,0,1,3
23243,3,1,81316,81316,81317,0,1,2
23244,4,2,81320,81320,81322,0,2,3
23245,2,3,81322,81322,81325,0,3,0
23246,5,3,81327,81327,81330,0,3,2
23247,1,1,81328,81330,81331,2,3,0
23248,3,3,81331,81331,81334,0,3,0
23249,4,3,81335,81335,81338,0,3,1
23250,3,1,81338,81338,81339,0,1,0
23251,6,2,81344,81344,81346,0,2,5
23252,6,2,81350,81350,81352,0,2,4
23253,5,2,81355,81355,81357,0,2,3
23254,4,2,81359,81359,81361,0,2,2
23255,2,1,81361,81361,81362,0,1,0
23256,5,1,81366,81366,81367,0,1,4
23257,1,1,81367,81367,81368,0,1,0
23258,2,2,81369,81369,81371,0,2,1
23259,3,3,81372,81372,81375,0,3,1
23260,6,3,81378,81378,81381,0,3,3
23261,3,1,81381,81381,81382,0,1,0
23262,5,2,81386,81386,81388,0,2,4
23263,2,2,81388,81388,81390,0,2,0
23264,2,1,81390,81390,81391,0,1,0
23265,2,3,81392,81392,81395,0,3,1
23266,1,2,81393,81395,81397,2,4,0
23267,2,2,81395,81397,81399,2,4,0
23268,5,2,81400,81400,81402,0,2,1
23269,6,2,81406,81406,81408,0,2,4
23270,1,1,81407,81408,81409,1,2,0
23271,2,3,81409,81409,81412,0,3,0
23272,5,3,81414,81414,81417,0,3,2
23273,1,3,81415,81417,81420,2,5,0
23274,3,1,81418,81420,81421,2,3,0
23275,4,1,81422,81422,81423,0,1,1
23276,6,1,81428,81428,81429,0,1,5
23277,1,3,81429,81429,81432,0,3,0
23278,6,3,81435,81435,81438,0,3,3
23279,2,1,81437,81438,81439,1,2,0
23280,4,2,81441,81441,81443,0,2,2
23281,4,1,81445,81445,81446,0,1,2
23282,2,2,81447,81447,81449,0,2,1
23283,4,3,81451,81451,81454,0,3,2
23284,4,1,81455,81455,81456,0,1,1
23285,1,1,81456,81456,81457,0,1,0
23286,6,2,81462,81462,81464,0,2,5
23287,5,2,81467,81467,81469,0,2,3
23288,6,2,81473,81473,81475,0,2,4
23289,2,3,81475,81475,81478,0,3,0
23290,3,2,81478,81478,81480,0,2,0
23291,4,2,81482,81482,81484,0,2,2
23292,3,1,81485,81485,81486,0,1,1
23293,4,1,81489,81489,81490,0,1,3
23294,6,3,81495,81495,81498,0,3,5
23295,4,1,81499,81499,81500,0,1,1
23296,3,2,81502,81502,81504,0,2,2
23297,5,3,81507,81507,81510,0,3,3
23298,3,2,81510,81510,81512,0,2,0
23299,6,3,81516,81516,81519,0,3,4
23300,4,1,81520,81520,81521,0,1,1
23301,1,3,81521,81521,81524,0,3,0
23302,6,3,81527,81527,81530,0,3,3
23303,2,3,81529,81530,81533,1,4,0
23304,6,1,81535,81535,81536,0,1,2
23305,5,1,81540,81540,81541,0,1,4
23306,3,1,81543,81543,81544,0,1,2
23307,2,3,81545,81545,81548,0,3,1
23308,4,1,81549,81549,81550,0,1,1
23309,3,1,81552,81552,81553,0,1,2
23310,1,1,81553,81553,81554,0,1,0
23311,3,1,81556,81556,81557,0,1,2
23312,3,3,81559,81559,81562,0,3,2
23313,4,1,81563,81563,81564,0,1,1
23314,5,3,81568,81568,81571,0,3,4
23315,2,3,81570,81571,81574,1,4,0
23316,1,2,81571,81574,81576,3,5,0
23317,4,3,81575,81576,81579,1,4,0
23318,5,3,81580,81580,81583,0,3,1
23319,4,3,81584,81584,81587,0,3,1
23320,2,1,81586,81587,81588,1,2,0
23321,5,2,81591,81591,81593,0,2,3
23322,1,2,81592,81593,81595,1,3,0
23323,5,2,81597,81597,81599,0,2,2
23324,5,2,81602,81602,81604,0,2,3
23325,2,3,81604,81604,81607,0,3,0
23326,5,3,81609,81609,81612,0,3,2
23327,4,2,81613,81613,81615,0,2,1
23328,1,3,81614,81615,81618,1,4,0
23329,2,1,81616,81618,81619,2,3,0
23330,3,3,81619,81619,81622,0,3,0
23331,5,1,81624,81624,81625,0,1,2
23332,4,3,81628,81628,81631,0,3,3
23333,6,2,81634,81634,81636,0,2,3
23334,6,3,81640,81640,81643,0,3,4
23335,6,1,81646,81646,81647,0,1,3
23336,2,1,81648,81648,81649,0,1,1
23337,4,3,81652,81652,81655,0,3,3
23338,4,3,81656,81656,81659,0,3,1
23339,6,1,81662,81662,81663,0,1,3
23340,3,2,81665,81665,81667,0,2,2
23341,2,1,81667,81667,81668,0,1,0
23342,2,2,81669,81669,81671,0,2,1
23343,3,3,81672,81672,81675,0,3,1
23344,2,2,81674,81675,81677,1,3,0
23345,2,3,81676,81677,81680,1,4,0
23346,6,3,81682,81682,81685,0,3,2
23347,3,1,81685,81685,81686,0,1,0
23348,3,3,81688,81688,81691,0,3,2
23349,3,2,81691,81691,81693,0,2,0
23350,2,3,81693,81693,81696,0,3,0
23351,2,2,81695,81696,81698,1,3,0
23352,6,2,81701,81701,81703,0,2,3
23353,6,3,81707,81707,81710,0,3,4
23354,2,2,81709,81710,81712,1,3,0
23355,4,1,81713,81713,81714,0,1,1
23356,4,2,81717,81717,81719,0,2,3
23357,2,1,81719,81719,81720,0,1,0
23358,6,3,81725,81725,81728,0,3,5
23359,2,1,81727,81728,81729,1,2,0
23360,5,3,81732,81732,81735,0,3,3
23361,1,2,81733,81735,81737,2,4,0
23362,4,1,81737,81737,81738,0,1,0
23363,1,3,81738,81738,81741,0,3,0
23364,4,1,81742,81742,81743,0,1,1
23365,1,2,81743,81743,81745,0,2,0
23366,4,1,81747,81747,81748,0,1,2
23367,5,1,81752,81752,81753,0,1,4
23368,3,1,81755,81755,81756,0,1,2
23369,1,1,81756,81756,81757,0,1,0
23370,4,2,81760,81760,81762,0,2,3
23371,3,3,81763,81763,81766,0,3,1
23372,2,2,81765,81766,81768,1,3,0
23373,6,3,81771,81771,81774,0,3,3
23374,5,1,81776,81776,81777,0,1,2
23375,1,1,81777,81777,81778,0,1,0
23376,3,1,81780,81780,81781,0,1,2
23377,5,2,81785,81785,81787,0,2,4
23378,3,1,81788,81788,81789,0,1,1
23379,3,3,81791,81791,81794,0,3,2
23380,6,1,81797,81797,81798,0,1,3
23381,5,3,81802,81802,81805,0,3,4
23382,4,2,81806,81806,81808,0,2,1
23383,6,2,81812,81812,81814,0,2,4
23384,4,1,81816,81816,81817,0,1,2
23385,1,1,81817,81817,81818,0,1,0
23386,6,2,81823,81823,81825,0,2,5
23387,1,2,81824,81825,81827,1,3,0
23388,4,2,81828,81828,81830,0,2,1
23389,1,2,81829,81830,81832,1,3,0
23390,1,2,81830,81832,81834,2,4,0
23391,2,3,81832,81834,81837,2,5,0
23392,1,3,81833,81837,81840,4,7,0
23393,4,3,81837,81840,81843,3,6,0
23394,4,1,81841,81843,81844,2,3,0
23395,3,1,81844,81844,81845,0,1,0
23396,6,1,81850,81850,81851,0,1,5
23397,6,3,81856,81856,81859,0,3,5
23398,6,2,81862,81862,81864,0,2,3
23399,4,3,81866,81866,81869,0,3,2
23400,4,3,81870,81870,81873,0,3,1
23401,3,1,81873,81873,81874,0,1,0
23402,5,3,81878,81878,81881,0,3,4
23403,6,3,81884,81884,81887,0,3,3
23404,2,2,81886,81887,81889,1,3,0
23405,1,1,81887,81889,81890,2,3,0
23406,2,1,81889,81890,81891,1,2,0
23407,4,3,81893,81893,81896,0,3,2
23408,3,1,81896,81896,81897,0,1,0
23409,1,1,81897,81897,81898,0,1,0
23410,4,1,81901,81901,81902,0,1,3
23411,2,3,81903,81903,81906,0,3,1
23412,1,2,81904,81906,81908,2,4,0
23413,3,3,81907,81908,81911,1,4,0
23414,6,1,81913,81913,81914,0,1,2
23415,5,1,81918,81918,81919,0,1,4
23416,3,2,81921,81921,81923,0,2,2
23417,3,2,81924,81924,81926,0,2,1
23418,2,2,81926,81926,81928,0,2,0
23419,2,2,81928,81928,81930,0,2,0
23420,4,3,81932,81932,81935,0,3,2
23421,2,1,81934,81935,81936,1,2,0
23422,3,2,81937,81937,81939,0,2,1
23423,1,1,81938,81939,81940,1,2,0
23424,3,1,81941,81941,81942,0,1,1
23425,3,1,81944,81944,81945,0,1,2
23426,3,2,81947,81947,81949,0,2,2
23427,6,3,81953,81953,81956,0,3,4
23428,3,1,81956,81956,81957,0,1,0
23429,5,3,81961,81961,81964,0,3,4
23430,3,1,81964,81964,81965,0,1,0
23431,3,3,81967,81967,81970,0,3,2
23432,4,1,81971,81971,81972,0,1,1
23433,1,3,81972,81972,81975,0,3,0
23434,1,3,81973,81975,81978,2,5,0
23435,1,1,81974,81978,81979,4,5,0
23436,4,2,81978,81979,81981,1,3,0
23437,3,1,81981,81981,81982,0,1,0
23438,1,2,81982,81982,81984,0,2,0
23439,6,1,81988,81988,81989,0,1,4
23440,5,1,81993,81993,81994,0,1,4
23441,1,3,81994,81994,81997,0,3,0
23442,4,1,81998,81998,81999,0,1,1
23443,1,3,81999,81999,82002,0,3,0
23444,1,1,82000,82002,82003,2,3,0
23445,6,1,82006,82006,82007,0,1,3
23446,1,3,82007,82007,82010,0,3,0
23447,1,3,82008,82010,82013,2,5,0
23448,5,2,82013,82013,82015,0,2,0
23449,2,3,82015,82015,82018,0,3,0
23450,6,1,82021,82021,82022,0,1,3
23451,6,3,82027,82027,82030,0,3,5
23452,2,3,82029,82030,82033,1,4,0
23453,6,3,82035,82035,82038,0,3,2
23454,4,2,82039,82039,82041,0,2,1
23455,2,3,82041,82041,82044,0,3,0
23456,4,1,82045,82045,82046,0,1,1
23457,1,1,82046,82046,82047,0,1,0
23458,1,1,82047,82047,82048,0,1,0
23459,3,3,82050,82050,82053,0,3,2
23460,4,1,82054,82054,82055,0,1,1
23461,3,1,82057,82057,82058,0,1,2
23462,5,3,82062,82062,82065,0,3,4
23463,4,1,82066,82066,82067,0,1,1
23464,5,1,82071,82071,82072,0,1,4
23465,6,2,82077,82077,82079,0,2,5
23466,4,2,82081,82081,82083,0,2,2
23467,1,2,82082,82083,82085,1,3,0
23468,6,2,82088,82088,82090,0,2,3
23469,2,1,82090,82090,82091,0,1,0
23470,2,3,82092,82092,82095,0,3,1
23471,4,1,82096,82096,82097,0,1,1
23472,6,3,82102,82102,82105,0,3,5
23473,1,1,82103,82105,82106,2,3,0
23474,5,3,82108,82108,82111,0,3,2
23475,3,2,82111,82111,82113,0,2,0
23476,5,3,82116,82116,82119,0,3,3
23477,3,2,82119,82119,82121,0,2,0
23478,2,3,82121,82121,82124,0,3,0
23479,4,1,82125,82125,82126,0,1,1
23480,1,1,82126,82126,82127,0,1,0
23481,1,3,82127,82127,82130,0,3,0
23482,3,1,82130,82130,82131,0,1,0
23483,6,2,82136,82136,82138,0,2,5
23484,2,3,82138,82138,82141,0,3,0
23485,1,2,82139,82141,82143,2,4,0
23486,4,1,82143,82143,82144,0,1,0
23487,4,3,82147,82147,82150,0,3,3
23488,1,3,82148,82150,82153,2,5,0
23489,1,1,82149,82153,82154,4,5,0
23490,6,3,82155,82155,82158,0,3,1
23491,6,3,82161,82161,82164,0,3,3
23492,5,2,82166,82166,82168,0,2,2
23493,2,1,82168,82168,82169,0,1,0
23494,2,1,82170,82170,82171,0,1,1
23495,6,3,82176,82176,82179,0,3,5
23496,6,3,82182,82182,82185,0,3,3
23497,4,3,82186,82186,82189,0,3,1
23498,6,1,82192,82192,82193,0,1,3
23499,4,3,82196,82196,82199,0,3,3
23500,2,2,82198,82199,82201,1,3,0
23501,1,1,82199,82201,82202,2,3,0
23502,2,3,82201,82202,82205,1,4,0
23503,5,3,82206,82206,82209,0,3,1
23504,3,2,82209,82209,82211,0,2,0
23505,1,2,82210,82211,82213,1,3,0
23506,1,1,82211,82213,82214,2,3,0
23507,5,2,82216,82216,82218,0,2,2
23508,4,1,82220,82220,82221,0,1,2
23509,6,1,82226,82226,82227,0,1,5
23510,2,3,82228,82228,82231,0,3,1
23511,1,3,82229,82231,82234,2,5,0
23512,5,2,82234,82234,82236,0,2,0
23513,4,1,82238,82238,82239,0,1,2
23514,6,3,82244,82244,82247,0,3,5
23515,4,3,82248,82248,82251,0,3,1
23516,3,2,82251,82251,82253,0,2,0
23517,2,1,82253,82253,82254,0,1,0
23518,1,2,82254,82254,82256,0,2,0
23519,6,2,82260,82260,82262,0,2,4
23520,5,3,82265,82265,82268,0,3,3
23521,3,1,82268,82268,82269,0,1,0
23522,3,2,82271,82271,82273,0,2,2
23523,1,1,82272,82273,82274,1,2,0
23524,5,1,82277,82277,82278,0,1,3
23525,4,3,82281,82281,82284,0,3,3
23526,4,1,82285,82285,82286,0,1,1
23527,1,2,82286,82286,82288,0,2,0
23528,6,2,82292,82292,82294,0,2,4
23529,1,3,82293,82294,82297,1,4,0
23530,1,3,82294,82297,82300,3,6,0
23531,2,3,82296,82300,82303,4,7,0
23532,4,1,82300,82303,82304,3,4,0
23533,4,2,82304,82304,82306,0,2,0
23534,1,2,82305,82306,82308,1,3,0
23535,4,2,82309,82309,82311,0,2,1
23536,2,2,82311,82311,82313,0,2,0
23537,4,2,82315,82315,82317,0,2,2
23538,4,1,82319,82319,82320,0,1,2
23539,3,1,82322,82322,82323,0,1,2
23540,2,3,82324,82324,82327,0,3,1
23541,3,1,82327,82327,82328,0,1,0
23542,6,1,82333,82333,82334,0,1,5
23543,2,3,82335,82335,82338,0,3,1
23544,2,2,82337,82338,82340,1,3,0
23545,5,2,82342,82342,82344,0,2,2
23546,4,2,82346,82346,82348,0,2,2
23547,1,2,82347,82348,82350,1,3,0
23548,4,3,82351,82351,82354,0,3,1
23549,6,2,82357,82357,82359,0,2,3
23550,6,3,82363,82363,82366,0,3,4
23551,4,2,82367,82367,82369,0,2,1
23552,3,1,82370,82370,82371,0,1,1
23553,6,1,82376,82376,82377,0,1,5
23554,6,3,82382,82382,82385,0,3,5
23555,6,3,82388,82388,82391,0,3,3
23556,5,1,82393,82393,82394,0,1,2
23557,6,3,82399,82399,82402,0,3,5
23558,6,3,82405,82405,82408,0,3,3
23559,6,1,82411,82411,82412,0,1,3
23560,2,2,82413,82413,82415,0,2,1
23561,2,2,82415,82415,82417,0,2,0
23562,3,2,82418,82418,82420,0,2,1
23563,3,1,82421,82421,82422,0,1,1
23564,2,1,82423,82423,82424,0,1,1
23565,2,2,82425,82425,82427,0,2,1
23566,4,3,82429,82429,82432,0,3,2
23567,4,2,82433,82433,82435,0,2,1
23568,6,1,82439,82439,82440,0,1,4
23569,5,3,82444,82444,82447,0,3,4
23570,3,2,82447,82447,82449,0,2,0
23571,3,3,82450,82450,82453,0,3,1
23572,6,3,82456,82456,82459,0,3,3
23573,4,3,82460,82460,82463,0,3,1
23574,1,1,82461,82463,82464,2,3,0
23575,3,1,82464,82464,82465,0,1,0
23576,3,2,82467,82467,82469,0,2,2
23577,3,3,82470,82470,82473,0,3,1
23578,6,3,82476,82476,82479,0,3,3
23579,5,1,82481,82481,82482,0,1,2
23580,2,3,82483,82483,82486,0,3,1
23581,3,2,82486,82486,82488,0,2,0
23582,4,3,82490,82490,82493,0,3,2
23583,1,3,82491,82493,82496,2,5,0
23584,6,3,82497,82497,82500,0,3,1
23585,6,2,82503,82503,82505,0,2,3
23586,5,1,82508,82508,82509,0,1,3
23587,1,1,82509,82509,82510,0,1,0
23588,4,2,82513,82513,82515,0,2,3
23589,1,2,82514,82515,82517,1,3,0
23590,1,1,82515,82517,82518,2,3,0
23591,4,3,82519,82519,82522,0,3,1
23592,4,1,82523,82523,82524,0,1,1
23593,5,1,82528,82528,82529,0,1,4
23594,2,2,82530,82530,82532,0,2,1
23595,4,2,82534,82534,82536,0,2,2
23596,1,2,82535,82536,82538,1,3,0
23597,6,2,82541,82541,82543,0,2,3
23598,3,2,82544,82544,82546,0,2,1
23599,5,2,82549,82549,82551,0,2,3
23600,5,2,82554,82554,82556,0,2,3
23601,3,3,82557,82557,82560,0,3,1
23602,1,1,82558,82560,82561,2,3,0
23603,5,3,82563,82563,82566,0,3,2
23604,2,3,82565,82566,82569,1,4,0
23605,4,2,82569,82569,82571,0,2,0
23606,3,1,82572,82572,82573,0,1,1
23607,6,3,82578,82578,82581,0,3,5
23608,4,1,82582,82582,82583,0,1,1
23609,2,2,82584,82584,82586,0,2,1
23610,1,1,82585,82586,82587,1,2,0
23611,2,3,82587,82587,82590,0,3,0
23612,5,1,82592,82592,82593,0,1,2
23613,4,3,82596,82596,82599,0,3,3
23614,4,2,82600,82600,82602,0,2,1
23615,5,1,82605,82605,82606,0,1,3
23616,4,3,82609,82609,82612,0,3,3
23617,1,1,82610,82612,82613,2,3,0
23618,4,1,82614,82614,82615,0,1,1
23619,4,3,82618,82618,82621,0,3,3
23620,2,1,82620,82621,82622,1,2,0
23621,1,3,82621,82622,82625,1,4,0
23622,1,1,82622,82625,82626,3,4,0
23623,5,3,82627,82627,82630,0,3,1
23624,4,3,82631,82631,82634,0,3,1
23625,3,1,82634,82634,82635,0,1,0
23626,3,2,82637,82637,82639,0,2,2
23627,4,3,82641,82641,82644,0,3,2
23628,6,3,82647,82647,82650,0,3,3
23629,2,2,82649,82650,82652,1,3,0
23630,4,3,82653,82653,82656,0,3,1
23631,4,1,82657,82657,82658,0,1,1
23632,5,2,82662,82662,82664,0,2,4
23633,5,2,82667,82667,82669,0,2,3
23634,2,1,82669,82669,82670,0,1,0
23635,4,2,82673,82673,82675,0,2,3
23636,2,2,82675,82675,82677,0,2,0
23637,3,2,82678,82678,82680,0,2,1
23638,3,2,82681,82681,82683,0,2,1
23639,4,1,82685,82685,82686,0,1,2
23640,5,3,82690,82690,82693,0,3,4
23641,5,2,82695,82695,82697,0,2,2
23642,6,1,82701,82701,82702,0,1,4
23643,4,1,82705,82705,82706,0,1,3
23644,5,1,82710,82710,82711,0,1,4
23645,5,3,82715,82715,82718,0,3,4
23646,5,3,82720,82720,82723,0,3,2
23647,4,1,82724,82724,82725,0,1,1
23648,3,1,82727,82727,82728,0,1,2
23649,6,1,82733,82733,82734,0,1,5
23650,3,2,82736,82736,82738,0,2,2
23651,4,3,82740,82740,82743,0,3,2
23652,6,2,82746,82746,82748,0,2,3
23653,5,1,82751,82751,82752,0,1,3
23654,6,1,82757,82757,82758,0,1,5
23655,6,2,82763,82763,82765,0,2,5
23656,5,3,82768,82768,82771,0,3,3
23657,6,3,82774,82774,82777,0,3,3
23658,5,2,82779,82779,82781,0,2,2
23659,4,2,82783,82783,82785,0,2,2
23660,4,2,82787,82787,82789,0,2,2
23661,4,1,82791,82791,82792,0,1,2
23662,5,1,82796,82796,82797,0,1,4
23663,3,1,82799,82799,82800,0,1,2
23664,4,3,82803,82803,82806,0,3,3
23665,4,1,82807,82807,82808,0,1,1
23666,4,1,82811,82811,82812,0,1,3
23667,4,3,82815,82815,82818,0,3,3
23668,1,1,82816,82818,82819,2,3,0
23669,6,1,82822,82822,82823,0,1,3
23670,6,3,82828,82828,82831,0,3,5
23671,6,3,82834,82834,82837,0,3,3
23672,5,3,82839,82839,82842,0,3,2
23673,4,1,82843,82843,82844,0,1,1
23674,1,1,82844,82844,82845,0,1,0
23675,1,1,82845,82845,82846,0,1,0
23676,4,2,82849,82849,82851,0,2,3
23677,6,3,82855,82855,82858,0,3,4
23678,4,2,82859,82859,82861,0,2,1
23679,5,3,82864,82864,82867,0,3,3
23680,1,1,82865,82867,82868,2,3,0
23681,6,3,82871,82871,82874,0,3,3
23682,6,3,82877,82877,82880,0,3,3
23683,3,1,82880,82880,82881,0,1,0
23684,4,1,82884,82884,82885,0,1,3
23685,2,3,82886,82886,82889,0,3,1
23686,1,2,82887,82889,82891,2,4,0
23687,1,1,82888,82891,82892,3,4,0
23688,4,3,82892,82892,82895,0,3,0
23689,5,3,82897,82897,82900,0,3,2
23690,1,2,82898,82900,82902,2,4,0
23691,5,3,82903,82903,82906,0,3,1
23692,6,1,82909,82909,82910,0,1,3
23693,6,2,82915,82915,82917,0,2,5
23694,5,3,82920,82920,82923,0,3,3
23695,1,2,82921,82923,82925,2,4,0
23696,1,3,82922,82925,82928,3,6,0
23697,1,3,82923,82928,82931,5,8,0
23698,3,2,82926,82931,82933,5,7,0
23699,1,1,82927,82933,82934,6,7,0
23700,2,1,82929,82934,82935,5,6,0
23701,5,1,82934,82935,82936,1,2,0
23702,4,3,82938,82938,82941,0,3,2
23703,5,1,82943,82943,82944,0,1,2
23704,5,2,82948,82948,82950,0,2,4
23705,4,2,82952,82952,82954,0,2,2
23706,4,2,82956,82956,82958,0,2,2
23707,5,1,82961,82961,82962,0,1,3
23708,5,2,82966,82966,82968,0,2,4
23709,5,2,82971,82971,82973,0,2,3
23710,5,3,82976,82976,82979,0,3,3
23711,4,3,82980,82980,82983,0,3,1
23712,4,1,82984,82984,82985,0,1,1
23713,5,2,82989,82989,82991,0,2,4
23714,4,1,82993,82993,82994,0,1,2
23715,5,3,82998,82998,83001,0,3,4
23716,6,1,83004,83004,83005,0,1,3
23717,1,2,83005,83005,83007,0,2,0
23718,2,3,83007,83007,83010,0,3,0
23719,3,3,83010,83010,83013,0,3,0
23720,1,1,83011,83013,83014,2,3,0
23721,1,1,83012,83014,83015,2,3,0
23722,6,2,83018,83018,83020,0,2,3
23723,5,1,83023,83023,83024,0,1,3
23724,6,3,83029,83029,83032,0,3,5
23725,1,1,83030,83032,83033,2,3,0
23726,4,1,83034,83034,83035,0,1,1
23727,6,3,83040,83040,83043,0,3,5
23728,1,2,83041,83043,83045,2,4,0
23729,3,1,83044,83045,83046,1,2,0
23730,1,1,83045,83046,83047,1,2,0
23731,6,2,83051,83051,83053,0,2,4
23732,3,2,83054,83054,83056,0,2,1
23733,6,2,83060,83060,83062,0,2,4
23734,5,3,83065,83065,83068,0,3,3
23735,4,1,83069,83069,83070,0,1,1
23736,4,3,83073,83073,83076,0,3,3
23737,6,1,83079,83079,83080,0,1,3
23738,3,2,83082,83082,83084,0,2,2
23739,5,2,83087,83087,83089,0,2,3
23740,4,3,83091,83091,83094,0,3,2
23741,4,1,83095,83095,83096,0,1,1
23742,5,2,83100,83100,83102,0,2,4
23743,3,1,83103,83103,83104,0,1,1
23744,5,3,83108,83108,83111,0,3,4
23745,5,3,83113,83113,83116,0,3,2
23746,3,2,83116,83116,83118,0,2,0
23747,1,3,83117,83118,83121,1,4,0
23748,1,2,83118,83121,83123,3,5,0
23749,4,3,83122,83123,83126,1,4,0
23750,6,1,83128,83128,83129,0,1,2
23751,3,3,83131,83131,83134,0,3,2
23752,2,3,83133,83134,83137,1,4,0
23753,1,2,83134,83137,83139,3,5,0
23754,3,1,83137,83139,83140,2,3,0
23755,1,2,83138,83140,83142,2,4,0
23756,3,3,83141,83142,83145,1,4,0
23757,2,2,83143,83145,83147,2,4,0
23758,3,3,83146,83147,83150,1,4,0
23759,5,2,83151,83151,83153,0,2,1
23760,2,2,83153,83153,83155,0,2,0
23761,2,3,83155,83155,83158,0,3,0
23762,4,1,83159,83159,83160,0,1,1
23763,1,2,83160,83160,83162,0,2,0
23764,2,3,83162,83162,83165,0,3,0
23765,1,1,83163,83165,83166,2,3,0
23766,6,3,83169,83169,83172,0,3,3
23767,1,2,83170,83172,83174,2,4,0
23768,1,3,83171,83174,83177,3,6,0
23769,4,1,83175,83177,83178,2,3,0
23770,5,2,83180,83180,83182,0,2,2
23771,2,3,83182,83182,83185,0,3,0
23772,1,3,83183,83185,83188,2,5,0
23773,1,1,83184,83188,83189,4,5,0
23774,1,3,83185,83189,83192,4,7,0
23775,6,3,83191,83192,83195,1,4,0
23776,2,3,83193,83195,83198,2,5,0
23777,2,1,83195,83198,83199,3,4,0
23778,1,2,83196,83199,83201,3,5,0
23779,1,2,83197,83201,83203,4,6,0
23780,1,1,83198,83203,83204,5,6,0
23781,1,3,83199,83204,83207,5,8,0
23782,4,1,83203,83207,83208,4,5,0
23783,1,1,83204,83208,83209,4,5,0
23784,1,3,83205,83209,83212,4,7,0
23785,3,2,83208,83212,83214,4,6,0
23786,4,2,83212,83214,83216,2,4,0
23787,5,3,83217,83217,83220,0,3,1
23788,2,1,83219,83220,83221,1,2,0
23789,4,2,83223,83223,83225,0,2,2
23790,1,1,83224,83225,83226,1,2,0
23791,4,3,83228,83228,83231,0,3,2
23792,1,3,83229,83231,83234,2,5,0
23793,5,2,83234,83234,83236,0,2,0
23794,2,3,83236,83236,83239,0,3,0
23795,6,1,83242,83242,83243,0,1,3
23796,6,1,83248,83248,83249,0,1,5
23797,4,3,83252,83252,83255,0,3,3
23798,1,1,83253,83255,83256,2,3,0
23799,3,2,83256,83256,83258,0,2,0
23800,3,2,83259,83259,83261,0,2,1
23801,1,1,83260,83261,83262,1,2,0
23802,3,3,83263,83263,83266,0,3,1
23803,3,1,83266,83266,83267,0,1,0
23804,5,1,83271,83271,83272,0,1,4
23805,6,2,83277,83277,83279,0,2,5
23806,3,1,83280,83280,83281,0,1,1
23807,4,3,83284,83284,83287,0,3,3
23808,6,1,83290,83290,83291,0,1,3
23809,6,1,83296,83296,83297,0,1,5
23810,2,3,83298,83298,83301,0,3,1
23811,2,3,83300,83301,83304,1,4,0
23812,3,2,83303,83304,83306,1,3,0
23813,2,2,83305,83306,83308,1,3,0
23814,2,1,83307,83308,83309,1,2,0
23815,6,2,83313,83313,83315,0,2,4
23816,4,2,83317,83317,83319,0,2,2
23817,2,3,83319,83319,83322,0,3,0
23818,5,3,83324,83324,83327,0,3,2
23819,3,3,83327,83327,83330,0,3,0
23820,6,2,83333,83333,83335,0,2,3
23821,3,3,83336,83336,83339,0,3,1
23822,1,1,83337,83339,83340,2,3,0
23823,4,3,83341,83341,83344,0,3,1
23824,3,1,83344,83344,83345,0,1,0
23825,5,2,83349,83349,83351,0,2,4
23826,4,2,83353,83353,83355,0,2,2
23827,4,1,83357,83357,83358,0,1,2
23828,2,1,83359,83359,83360,0,1,1
23829,1,3,83360,83360,83363,0,3,0
23830,1,2,83361,83363,83365,2,4,0
23831,2,3,83363,83365,83368,2,5,0
23832,5,1,83368,83368,83369,0,1,0
23833,5,3,83373,83373,83376,0,3,4
23834,4,3,83377,83377,83380,0,3,1
23835,6,3,83383,83383,83386,0,3,3
23836,4,3,83387,83387,83390,0,3,1
23837,3,2,83390,83390,83392,0,2,0
23838,6,3,83396,83396,83399,0,3,4
23839,5,2,83401,83401,83403,0,2,2
23840,3,2,83404,83404,83406,0,2,1
23841,3,1,83407,83407,83408,0,1,1
23842,3,3,83410,83410,83413,0,3,2
23843,5,2,83415,83415,83417,0,2,2
23844,3,2,83418,83418,83420,0,2,1
23845,5,3,83423,83423,83426,0,3,3
23846,5,3,83428,83428,83431,0,3,2
23847,1,3,83429,83431,83434,2,5,0
23848,2,3,83431,83434,83437,3,6,0
23849,6,2,83437,83437,83439,0,2,0
23850,5,2,83442,83442,83444,0,2,3
23851,3,2,83445,83445,83447,0,2,1
23852,3,2,83448,83448,83450,0,2,1
23853,1,2,83449,83450,83452,1,3,0
23854,5,1,83454,83454,83455,0,1,2
23855,4,1,83458,83458,83459,0,1,3
23856,3,3,83461,83461,83464,0,3,2
23857,2,3,83463,83464,83467,1,4,0
23858,2,2,83465,83467,83469,2,4,0
23859,1,1,83466,83469,83470,3,4,0
23860,6,3,83472,83472,83475,0,3,2
23861,6,2,83478,83478,83480,0,2,3
23862,5,2,83483,83483,83485,0,2,3
23863,1,1,83484,83485,83486,1,2,0
23864,6,2,83490,83490,83492,0,2,4
23865,4,2,83494,83494,83496,0,2,2
23866,3,3,83497,83497,83500,0,3,1
23867,2,3,83499,83500,83503,1,4,0
23868,3,1,83502,83503,83504,1,2,0
23869,3,3,83505,83505,83508,0,3,1
23870,3,3,83508,83508,83511,0,3,0
23871,1,2,83509,83511,83513,2,4,0
23872,1,2,83510,83513,83515,3,5,0
23873,1,2,83511,83515,83517,4,6,0
23874,2,3,83513,83517,83520,4,7,0
23875,2,2,83515,83520,83522,5,7,0
23876,6,1,83521,83522,83523,1,2,0
23877,6,2,83527,83527,83529,0,2,4
23878,5,2,83532,83532,83534,0,2,3
23879,3,2,83535,83535,83537,0,2,1
23880,1,2,83536,83537,83539,1,3,0
23881,5,1,83541,83541,83542,0,1,2
23882,4,1,83545,83545,83546,0,1,3
23883,3,3,83548,83548,83551,0,3,2
23884,2,1,83550,83551,83552,1,2,0
23885,3,1,83553,83553,83554,0,1,1
23886,2,1,83555,83555,83556,0,1,1
23887,2,3,83557,83557,83560,0,3,1
23888,4,1,83561,83561,83562,0,1,1
23889,6,3,83567,83567,83570,0,3,5
23890,2,2,83569,83570,83572,1,3,0
23891,3,2,83572,83572,83574,0,2,0
23892,2,3,83574,83574,83577,0,3,0
23893,5,1,83579,83579,83580,0,1,2
23894,5,2,83584,83584,83586,0,2,4
23895,1,1,83585,83586,83587,1,2,0
23896,6,3,83591,83591,83594,0,3,4
23897,4,2,83595,83595,83597,0,2,1
23898,3,2,83598,83598,83600,0,2,1
23899,4,1,83602,83602,83603,0,1,2
23900,2,3,83604,83604,83607,0,3,1
23901,2,1,83606,83607,83608,1,2,0
23902,4,2,83610,83610,83612,0,2,2
23903,4,1,83614,83614,83615,0,1,2
23904,2,3,83616,83616,83619,0,3,1
23905,3,2,83619,83619,83621,0,2,0
23906,1,2,83620,83621,83623,1,3,0
23907,3,2,83623,83623,83625,0,2,0
23908,5,1,83628,83628,83629,0,1,3
23909,1,1,83629,83629,83630,0,1,0
23910,3,1,83632,83632,83633,0,1,2
23911,2,2,83634,83634,83636,0,2,1
23912,4,1,83638,83638,83639,0,1,2
23913,1,3,83639,83639,83642,0,3,0
23914,4,3,83643,83643,83646,0,3,1
23915,4,3,83647,83647,83650,0,3,1
23916,6,2,83653,83653,83655,0,2,3
23917,5,2,83658,83658,83660,0,2,3
23918,4,3,83662,83662,83665,0,3,2
23919,3,2,83665,83665,83667,0,2,0
23920,3,2,83668,83668,83670,0,2,1
23921,2,2,83670,83670,83672,0,2,0
23922,4,2,83674,83674,83676,0,2,2
23923,5,2,83679,83679,83681,0,2,3
23924,6,3,83685,83685,83688,0,3,4
23925,5,1,83690,83690,83691,0,1,2
23926,5,2,83695,83695,83697,0,2,4
23927,4,1,83699,83699,83700,0,1,2
23928,2,1,83701,83701,83702,0,1,1
23929,2,1,83703,83703,83704,0,1,1
23930,1,1,83704,83704,83705,0,1,0
23931,2,2,83706,83706,83708,0,2,1
23932,2,3,83708,83708,83711,0,3,0
23933,1,2,83709,83711,83713,2,4,0
23934,1,3,83710,83713,83716,3,6,0
23935,5,2,83715,83716,83718,1,3,0
23936,1,1,83716,83718,83719,2,3,0
23937,1,3,83717,83719,83722,2,5,0
23938,5,1,83722,83722,83723,0,1,0
23939,3,2,83725,83725,83727,0,2,2
23940,6,2,83731,83731,83733,0,2,4
23941,4,3,83735,83735,83738,0,3,2
23942,5,3,83740,83740,83743,0,3,2
23943,2,3,83742,83743,83746,1,4,0
23944,4,3,83746,83746,83749,0,3,0
23945,5,2,83751,83751,83753,0,2,2
23946,3,3,83754,83754,83757,0,3,1
23947,4,2,83758,83758,83760,0,2,1
23948,3,2,83761,83761,83763,0,2,1
23949,6,3,83767,83767,83770,0,3,4
23950,4,2,83771,83771,83773,0,2,1
23951,4,1,83775,83775,83776,0,1,2
23952,6,2,83781,83781,83783,0,2,5
23953,4,3,83785,83785,83788,0,3,2
23954,4,2,83789,83789,83791,0,2,1
23955,3,1,83792,83792,83793,0,1,1
23956,1,3,83793,83793,83796,0,3,0
23957,2,2,83795,83796,83798,1,3,0
23958,5,2,83800,83800,83802,0,2,2
23959,5,1,83805,83805,83806,0,1,3
23960,5,3,83810,83810,83813,0,3,4
23961,4,1,83814,83814,83815,0,1,1
23962,3,1,83817,83817,83818,0,1,2
23963,2,1,83819,83819,83820,0,1,1
23964,4,1,83823,83823,83824,0,1,3
23965,5,3,83828,83828,83831,0,3,4
23966,2,2,83830,83831,83833,1,3,0
23967,3,2,83833,83833,83835,0,2,0
23968,5,1,83838,83838,83839,0,1,3
23969,4,2,83842,83842,83844,0,2,3
23970,2,2,83844,83844,83846,0,2,0
23971,5,1,83849,83849,83850,0,1,3
23972,1,3,83850,83850,83853,0,3,0
23973,2,1,83852,83853,83854,1,2,0
23974,6,1,83858,83858,83859,0,1,4
23975,4,3,83862,83862,83865,0,3,3
23976,6,2,83868,83868,83870,0,2,3
23977,6,1,83874,83874,83875,0,1,4
23978,2,3,83876,83876,83879,0,3,1
23979,5,3,83881,83881,83884,0,3,2
23980,3,2,83884,83884,83886,0,2,0
23981,3,1,83887,83887,83888,0,1,1
23982,5,3,83892,83892,83895,0,3,4
23983,1,3,83893,83895,83898,2,5,0
23984,5,2,83898,83898,83900,0,2,0
23985,1,3,83899,83900,83903,1,4,0
23986,6,2,83905,83905,83907,0,2,2
23987,4,3,83909,83909,83912,0,3,2
23988,5,2,83914,83914,83916,0,2,2
23989,5,1,83919,83919,83920,0,1,3
23990,3,2,83922,83922,83924,0,2,2
23991,5,2,83927,83927,83929,0,2,3
23992,3,1,83930,83930,83931,0,1,1
23993,1,3,83931,83931,83934,0,3,0
23994,6,1,83937,83937,83938,0,1,3
23995,2,1,83939,83939,83940,0,1,1
23996,5,2,83944,83944,83946,0,2,4
23997,1,2,83945,83946,83948,1,3,0
23998,4,3,83949,83949,83952,0,3,1
23999,4,1,83953,83953,83954,0,1,1
24000,1,1,83954,83954,83955,0,1,0
24001,3,2,83957,83957,83959,0,2,2
24002,1,2,83958,83959,83961,1,3,0
24003,6,3,83964,83964,83967,0,3,3
24004,3,1,83967,83967,83968,0,1,0
24005,6,1,83973,83973,83974,0,1,5
24006,5,3,83978,83978,83981,0,3,4
24007,2,1,83980,83981,83982,1,2,0
24008,2,1,83982,83982,83983,0,1,0
24009,3,3,83985,83985,83988,0,3,2
24010,3,2,83988,83988,83990,0,2,0
24011,1,1,83989,83990,83991,1,2,0
24012,3,3,83992,83992,83995,0,3,1
24013,5,2,83997,83997,83999,0,2,2
24014,1,2,83998,83999,84001,1,3,0
24015,3,3,84001,84001,84004,0,3,0
24016,5,3,84006,84006,84009,0,3,2
24017,1,2,84007,84009,84011,2,4,0
24018,2,1,84009,84011,84012,2,3,0
24019,2,2,84011,84012,84014,1,3,0
24020,2,3,84013,84014,84017,1,4,0
24021,1,1,84014,84017,84018,3,4,0
24022,5,2,84019,84019,84021,0,2,1
24023,4,3,84023,84023,84026,0,3,2
24024,4,2,84027,84027,84029,0,2,1
24025,6,1,84033,84033,84034,0,1,4
24026,5,2,84038,84038,84040,0,2,4
24027,1,1,84039,84040,84041,1,2,0
24028,6,1,84045,84045,84046,0,1,4
24029,4,2,84049,84049,84051,0,2,3
24030,3,2,84052,84052,84054,0,2,1
24031,1,1,84053,84054,84055,1,2,0
24032,6,1,84059,84059,84060,0,1,4
24033,5,1,84064,84064,84065,0,1,4
24034,3,3,84067,84067,84070,0,3,2
24035,1,1,84068,84070,84071,2,3,0
24036,2,3,84070,84071,84074,1,4,0
24037,3,1,84073,84074,84075,1,2,0
24038,3,2,84076,84076,84078,0,2,1
24039,4,3,84080,84080,84083,0,3,2
24040,2,2,84082,84083,84085,1,3,0
24041,6,3,84088,84088,84091,0,3,3
24042,2,1,84090,84091,84092,1,2,0
24043,6,1,84096,84096,84097,0,1,4
24044,2,3,84098,84098,84101,0,3,1
24045,1,2,84099,84101,84103,2,4,0
24046,1,1,84100,84103,84104,3,4,0
24047,5,3,84105,84105,84108,0,3,1
24048,4,3,84109,84109,84112,0,3,1
24049,6,2,84115,84115,84117,0,2,3
24050,6,3,84121,84121,84124,0,3,4
24051,3,3,84124,84124,84127,0,3,0
24052,1,1,84125,84127,84128,2,3,0
24053,3,2,84128,84128,84130,0,2,0
24054,5,3,84133,84133,84136,0,3,3
24055,2,1,84135,84136,84137,1,2,0
24056,5,3,84140,84140,84143,0,3,3
24057,3,3,84143,84143,84146,0,3,0
24058,5,2,84148,84148,84150,0,2,2
24059,3,2,84151,84151,84153,0,2,1
24060,4,3,84155,84155,84158,0,3,2
24061,4,1,84159,84159,84160,0,1,1
24062,1,1,84160,84160,84161,0,1,0
24063,2,2,84162,84162,84164,0,2,1
24064,4,3,84166,84166,84169,0,3,2
24065,6,1,84172,84172,84173,0,1,3
24066,4,1,84176,84176,84177,0,1,3
24067,3,3,84179,84179,84182,0,3,2
24068,6,3,84185,84185,84188,0,3,3
24069,3,3,84188,84188,84191,0,3,0
24070,4,3,84192,84192,84195,0,3,1
24071,3,1,84195,84195,84196,0,1,0
24072,5,1,84200,84200,84201,0,1,4
24073,5,3,84205,84205,84208,0,3,4
24074,5,2,84210,84210,84212,0,2,2
24075,6,2,84216,84216,84218,0,2,4
24076,4,1,84220,84220,84221,0,1,2
24077,4,2,84224,84224,84226,0,2,3
24078,1,3,84225,84226,84229,1,4,0
24079,2,3,84227,84229,84232,2,5,0
24080,1,1,84228,84232,84233,4,5,0
24081,1,2,84229,84233,84235,4,6,0
24082,3,2,84232,84235,84237,3,5,0
24083,5,2,84237,84237,84239,0,2,0
24084,2,3,84239,84239,84242,0,3,0
24085,5,2,84244,84244,84246,0,2,2
24086,2,1,84246,84246,84247,0,1,0
24087,6,1,84252,84252,84253,0,1,5
24088,5,2,84257,84257,84259,0,2,4
24089,6,1,84263,84263,84264,0,1,4
24090,2,2,84265,84265,84267,0,2,1
24091,1,3,84266,84267,84270,1,4,0
24092,5,3,84271,84271,84274,0,3,1
24093,3,2,84274,84274,84276,0,2,0
24094,5,1,84279,84279,84280,0,1,3
24095,5,3,84284,84284,84287,0,3,4
24096,1,3,84285,84287,84290,2,5,0
24097,5,1,84290,84290,84291,0,1,0
24098,6,2,84296,84296,84298,0,2,5
24099,2,1,84298,84298,84299,0,1,0
24100,3,3,84301,84301,84304,0,3,2
24101,2,1,84303,84304,84305,1,2,0
24102,1,1,84304,84305,84306,1,2,0
24103,5,1,84309,84309,84310,0,1,3
24104,3,1,84312,84312,84313,0,1,2
24105,3,3,84315,84315,84318,0,3,2
24106,2,2,84317,84318,84320,1,3,0
24107,5,3,84322,84322,84325,0,3,2
24108,2,1,84324,84325,84326,1,2,0
24109,5,1,84329,84329,84330,0,1,3
24110,6,3,84335,84335,84338,0,3,5
24111,4,1,84339,84339,84340,0,1,1
24112,3,1,84342,84342,84343,0,1,2
24113,6,3,84348,84348,84351,0,3,5
24114,5,1,84353,84353,84354,0,1,2
24115,5,2,84358,84358,84360,0,2,4
24116,2,3,84360,84360,84363,0,3,0
24117,5,2,84365,84365,84367,0,2,2
24118,1,2,84366,84367,84369,1,3,0
24119,5,2,84371,84371,84373,0,2,2
24120,5,2,84376,84376,84378,0,2,3
24121,2,3,84378,84378,84381,0,3,0
24122,2,1,84380,84381,84382,1,2,0
24123,2,1,84382,84382,84383,0,1,0
24124,5,2,84387,84387,84389,0,2,4
24125,6,3,84393,84393,84396,0,3,4
24126,4,3,84397,84397,84400,0,3,1
24127,6,2,84403,84403,84405,0,2,3
24128,5,1,84408,84408,84409,0,1,3
24129,4,2,84412,84412,84414,0,2,3
24130,3,1,84415,84415,84416,0,1,1
24131,2,3,84417,84417,84420,0,3,1
24132,2,3,84419,84420,84423,1,4,0
24133,1,1,84420,84423,84424,3,4,0
24134,5,2,84425,84425,84427,0,2,1
24135,3,2,84428,84428,84430,0,2,1
24136,5,1,84433,84433,84434,0,1,3
24137,6,2,84439,84439,84441,0,2,5
24138,6,2,84445,84445,84447,0,2,4
24139,5,1,84450,84450,84451,0,1,3
24140,5,1,84455,84455,84456,0,1,4
24141,4,3,84459,84459,84462,0,3,3
24142,6,2,84465,84465,84467,0,2,3
24143,6,3,84471,84471,84474,0,3,4
24144,4,2,84475,84475,84477,0,2,1
24145,2,1,84477,84477,84478,0,1,0
24146,2,3,84479,84479,84482,0,3,1
24147,4,3,84483,84483,84486,0,3,1
24148,2,2,84485,84486,84488,1,3,0
24149,3,2,84488,84488,84490,0,2,0
24150,5,3,84493,84493,84496,0,3,3
24151,2,3,84495,84496,84499,1,4,0
24152,4,2,84499,84499,84501,0,2,0
24153,6,2,84505,84505,84507,0,2,4
24154,5,1,84510,84510,84511,0,1,3
24155,6,3,84516,84516,84519,0,3,5
24156,2,2,84518,84519,84521,1,3,0
24157,1,3,84519,84521,84524,2,5,0
24158,4,2,84523,84524,84526,1,3,0
24159,1,1,84524,84526,84527,2,3,0
24160,3,3,84527,84527,84530,0,3,0
24161,3,1,84530,84530,84531,0,1,0
24162,2,3,84532,84532,84535,0,3,1
24163,5,2,84537,84537,84539,0,2,2
24164,5,1,84542,84542,84543,0,1,3
24165,2,2,84544,84544,84546,0,2,1
24166,5,1,84549,84549,84550,0,1,3
24167,2,1,84551,84551,84552,0,1,1
24168,6,1,84557,84557,84558,0,1,5
24169,6,2,84563,84563,84565,0,2,5
24170,5,2,84568,84568,84570,0,2,3
24171,3,1,84571,84571,84572,0,1,1
24172,6,2,84577,84577,84579,0,2,5
24173,2,3,84579,84579,84582,0,3,0
24174,2,1,84581,84582,84583,1,2,0
24175,3,3,84584,84584,84587,0,3,1
24176,3,2,84587,84587,84589,0,2,0
24177,5,2,84592,84592,84594,0,2,3
24178,5,2,84597,84597,84599,0,2,3
24179,6,1,84603,84603,84604,0,1,4
24180,3,1,84606,84606,84607,0,1,2
24181,6,2,84612,84612,84614,0,2,5
24182,3,2,84615,84615,84617,0,2,1
24183,3,3,84618,84618,84621,0,3,1
24184,2,1,84620,84621,84622,1,2,0
24185,6,2,84626,84626,84628,0,2,4
24186,6,1,84632,84632,84633,0,1,4
24187,5,2,84637,84637,84639,0,2,4
24188,5,1,84642,84642,84643,0,1,3
24189,2,2,84644,84644,84646,0,2,1
24190,1,3,84645,84646,84649,1,4,0
24191,5,1,84650,84650,84651,0,1,1
24192,3,3,84653,84653,84656,0,3,2
24193,4,1,84657,84657,84658,0,1,1
24194,1,2,84658,84658,84660,0,2,0
24195,4,1,84662,84662,84663,0,1,2
24196,3,3,84665,84665,84668,0,3,2
24197,6,2,84671,84671,84673,0,2,3
24198,4,2,84675,84675,84677,0,2,2
24199,6,3,84681,84681,84684,0,3,4
24200,6,2,84687,84687,84689,0,2,3
24201,4,1,84691,84691,84692,0,1,2
24202,4,1,84695,84695,84696,0,1,3
24203,6,1,84701,84701,84702,0,1,5
24204,4,3,84705,84705,84708,0,3,3
24205,1,3,84706,84708,84711,2,5,0
24206,3,1,84709,84711,84712,2,3,0
24207,3,3,84712,84712,84715,0,3,0
24208,1,2,84713,84715,84717,2,4,0
24209,4,1,84717,84717,84718,0,1,0
24210,2,3,84719,84719,84722,0,3,1
24211,4,3,84723,84723,84726,0,3,1
24212,2,2,84725,84726,84728,1,3,0
24213,4,1,84729,84729,84730,0,1,1
24214,6,1,84735,84735,84736,0,1,5
24215,3,3,84738,84738,84741,0,3,2
24216,6,2,84744,84744,84746,0,2,3
24217,3,3,84747,84747,84750,0,3,1
24218,2,3,84749,84750,84753,1,4,0
24219,1,3,84750,84753,84756,3,6,0
24220,6,1,84756,84756,84757,0,1,0
24221,1,3,84757,84757,84760,0,3,0
24222,3,2,84760,84760,84762,0,2,0
24223,5,3,84765,84765,84768,0,3,3
24224,6,1,84771,84771,84772,0,1,3
24225,2,2,84773,84773,84775,0,2,1
24226,2,1,84775,84775,84776,0,1,0
24227,2,2,84777,84777,84779,0,2,1
24228,6,2,84783,84783,84785,0,2,4
24229,5,3,84788,84788,84791,0,3,3
24230,3,3,84791,84791,84794,0,3,0
24231,2,1,84793,84794,84795,1,2,0
24232,2,1,84795,84795,84796,0,1,0
24233,5,1,84800,84800,84801,0,1,4
24234,5,1,84805,84805,84806,0,1,4
24235,2,1,84807,84807,84808,0,1,1
24236,1,1,84808,84808,84809,0,1,0
24237,2,2,84810,84810,84812,0,2,1
24238,2,1,84812,84812,84813,0,1,0
24239,3,3,84815,84815,84818,0,3,2
24240,5,3,84820,84820,84823,0,3,2
24241,6,2,84826,84826,84828,0,2,3
24242,5,3,84831,84831,84834,0,3,3
24243,1,1,84832,84834,84835,2,3,0
24244,5,2,84837,84837,84839,0,2,2
24245,4,3,84841,84841,84844,0,3,2
24246,3,1,84844,84844,84845,0,1,0
24247,4,2,84848,84848,84850,0,2,3
24248,4,3,84852,84852,84855,0,3,2
24249,2,2,84854,84855,84857,1,3,0
24250,4,1,84858,84858,84859,0,1,1
24251,4,3,84862,84862,84865,0,3,3
24252,1,3,84863,84865,84868,2,5,0
24253,3,1,84866,84868,84869,2,3,0
24254,5,2,84871,84871,84873,0,2,2
24255,6,3,84877,84877,84880,0,3,4
24256,1,3,84878,84880,84883,2,5,0
24257,4,3,84882,84883,84886,1,4,0
24258,2,3,84884,84886,84889,2,5,0
24259,1,1,84885,84889,84890,4,5,0
24260,6,2,84891,84891,84893,0,2,1
24261,6,2,84897,84897,84899,0,2,4
24262,1,2,84898,84899,84901,1,3,0
24263,6,1,84904,84904,84905,0,1,3
24264,3,3,84907,84907,84910,0,3,2
24265,5,2,84912,84912,84914,0,2,2
24266,4,2,84916,84916,84918,0,2,2
24267,5,2,84921,84921,84923,0,2,3
24268,3,3,84924,84924,84927,0,3,1
24269,3,3,84927,84927,84930,0,3,0
24270,2,3,84929,84930,84933,1,4,0
24271,5,3,84934,84934,84937,0,3,1
24272,5,2,84939,84939,84941,0,2,2
24273,4,2,84943,84943,84945,0,2,2
24274,1,1,84944,84945,84946,1,2,0
24275,6,1,84950,84950,84951,0,1,4
24276,2,2,84952,84952,84954,0,2,1
24277,2,2,84954,84954,84956,0,2,0
24278,1,2,84955,84956,84958,1,3,0
24279,5,2,84960,84960,84962,0,2,2
24280,4,1,84964,84964,84965,0,1,2
24281,5,3,84969,84969,84972,0,3,4
24282,4,2,84973,84973,84975,0,2,1
24283,6,2,84979,84979,84981,0,2,4
24284,3,2,84982,84982,84984,0,2,1
24285,2,2,84984,84984,84986,0,2,0
24286,6,2,84990,84990,84992,0,2,4
24287,2,2,84992,84992,84994,0,2,0
24288,2,1,84994,84994,84995,0,1,0
24289,5,3,84999,84999,85002,0,3,4
24290,3,3,85002,85002,85005,0,3,0
24291,3,3,85005,85005,85008,0,3,0
24292,4,1,85009,85009,85010,0,1,1
24293,6,2,85015,85015,85017,0,2,5
24294,1,1,85016,85017,85018,1,2,0
24295,5,2,85021,85021,85023,0,2,3
24296,5,1,85026,85026,85027,0,1,3
24297,6,1,85032,85032,85033,0,1,5
24298,6,3,85038,85038,85041,0,3,5
24299,4,2,85042,85042,85044,0,2,1
24300,5,3,85047,85047,85050,0,3,3
24301,3,2,85050,85050,85052,0,2,0
24302,4,2,85054,85054,85056,0,2,2
24303,6,3,85060,85060,85063,0,3,4
24304,6,1,85066,85066,85067,0,1,3
24305,4,2,85070,85070,85072,0,2,3
24306,4,1,85074,85074,85075,0,1,2
24307,3,3,85077,85077,85080,0,3,2
24308,6,3,85083,85083,85086,0,3,3
24309,2,1,85085,85086,85087,1,2,0
24310,6,2,85091,85091,85093,0,2,4
24311,1,2,85092,85093,85095,1,3,0
24312,1,2,85093,85095,85097,2,4,0
24313,2,3,85095,85097,85100,2,5,0
24314,2,2,85097,85100,85102,3,5,0
24315,5,3,85102,85102,85105,0,3,0
24316,5,1,85107,85107,85108,0,1,2
24317,5,3,85112,85112,85115,0,3,4
24318,1,1,85113,85115,85116,2,3,0
24319,5,2,85118,85118,85120,0,2,2
24320,4,2,85122,85122,85124,0,2,2
24321,2,1,85124,85124,85125,0,1,0
24322,5,3,85129,85129,85132,0,3,4
24323,2,3,85131,85132,85135,1,4,0
24324,6,2,85137,85137,85139,0,2,2
24325,4,1,85141,85141,85142,0,1,2
24326,5,1,85146,85146,85147,0,1,4
24327,1,1,85147,85147,85148,0,1,0
24328,3,3,85150,85150,85153,0,3,2
24329,1,2,85151,85153,85155,2,4,0
24330,2,2,85153,85155,85157,2,4,0
24331,4,1,85157,85157,85158,0,1,0
24332,2,3,85159,85159,85162,0,3,1
24333,4,1,85163,85163,85164,0,1,1
24334,5,3,85168,85168,85171,0,3,4
24335,4,3,85172,85172,85175,0,3,1
24336,2,2,85174,85175,85177,1,3,0
24337,6,1,85180,85180,85181,0,1,3
24338,3,3,85183,85183,85186,0,3,2
24339,1,2,85184,85186,85188,2,4,0
24340,6,3,85190,85190,85193,0,3,2
24341,6,2,85196,85196,85198,0,2,3
24342,6,3,85202,85202,85205,0,3,4
24343,4,2,85206,85206,85208,0,2,1
24344,3,2,85209,85209,85211,0,2,1
24345,3,1,85212,85212,85213,0,1,1
24346,5,1,85217,85217,85218,0,1,4
24347,6,2,85223,85223,85225,0,2,5
24348,2,2,85225,85225,85227,0,2,0
24349,1,2,85226,85227,85229,1,3,0
24350,4,1,85230,85230,85231,0,1,1
24351,1,3,85231,85231,85234,0,3,0
24352,5,2,85236,85236,85238,0,2,2
24353,6,1,85242,85242,85243,0,1,4
24354,3,2,85245,85245,85247,0,2,2
24355,4,3,85249,85249,85252,0,3,2
24356,6,2,85255,85255,85257,0,2,3
24357,5,1,85260,85260,85261,0,1,3
24358,4,3,85264,85264,85267,0,3,3
24359,3,1,85267,85267,85268,0,1,0
24360,5,2,85272,85272,85274,0,2,4
24361,3,3,85275,85275,85278,0,3,1
24362,1,1,85276,85278,85279,2,3,0
24363,3,2,85279,85279,85281,0,2,0
24364,2,2,85281,85281,85283,0,2,0
24365,2,1,85283,85283,85284,0,1,0
24366,5,3,85288,85288,85291,0,3,4
24367,3,2,85291,85291,85293,0,2,0
24368,5,2,85296,85296,85298,0,2,3
24369,2,3,85298,85298,85301,0,3,0
24370,4,3,85302,85302,85305,0,3,1
24371,3,1,85305,85305,85306,0,1,0
24372,1,1,85306,85306,85307,0,1,0
24373,3,2,85309,85309,85311,0,2,2
24374,6,3,85315,85315,85318,0,3,4
24375,5,2,85320,85320,85322,0,2,2
24376,4,1,85324,85324,85325,0,1,2
24377,5,1,85329,85329,85330,0,1,4
24378,1,1,85330,85330,85331,0,1,0
24379,4,2,85334,85334,85336,0,2,3
24380,5,3,85339,85339,85342,0,3,3
24381,6,3,85345,85345,85348,0,3,3
24382,5,3,85350,85350,85353,0,3,2
24383,2,2,85352,85353,85355,1,3,0
24384,3,1,85355,85355,85356,0,1,0
24385,3,1,85358,85358,85359,0,1,2
24386,1,1,85359,85359,85360,0,1,0
24387,4,2,85363,85363,85365,0,2,3
24388,5,2,85368,85368,85370,0,2,3
24389,3,3,85371,85371,85374,0,3,1
24390,1,2,85372,85374,85376,2,4,0
24391,4,1,85376,85376,85377,0,1,0
24392,6,2,85382,85382,85384,0,2,5
24393,2,1,85384,85384,85385,0,1,0
24394,5,1,85389,85389,85390,0,1,4
24395,6,1,85395,85395,85396,0,1,5
24396,1,1,85396,85396,85397,0,1,0
24397,2,2,85398,85398,85400,0,2,1
24398,5,3,85403,85403,85406,0,3,3
24399,6,2,85409,85409,85411,0,2,3
24400,6,1,85415,85415,85416,0,1,4
24401,1,1,85416,85416,85417,0,1,0
24402,5,3,85421,85421,85424,0,3,4
24403,3,2,85424,85424,85426,0,2,0
24404,5,3,85429,85429,85432,0,3,3
24405,4,2,85433,85433,85435,0,2,1
24406,6,2,85439,85439,85441,0,2,4
24407,4,2,85443,85443,85445,0,2,2
24408,1,3,85444,85445,85448,1,4,0
24409,3,3,85447,85448,85451,1,4,0
24410,1,1,85448,85451,85452,3,4,0
24411,2,1,85450,85452,85453,2,3,0
24412,6,1,85456,85456,85457,0,1,3
24413,6,2,85462,85462,85464,0,2,5
24414,3,2,85465,85465,85467,0,2,1
24415,6,2,85471,85471,85473,0,2,4
24416,6,3,85477,85477,85480,0,3,4
24417,5,2,85482,85482,85484,0,2,2
24418,5,3,85487,85487,85490,0,3,3
24419,5,2,85492,85492,85494,0,2,2
24420,4,1,85496,85496,85497,0,1,2
24421,4,3,85500,85500,85503,0,3,3
24422,1,2,85501,85503,85505,2,4,0
24423,4,3,85505,85505,85508,0,3,0
24424,2,2,85507,85508,85510,1,3,0
24425,6,3,85513,85513,85516,0,3,3
24426,3,2,85516,85516,85518,0,2,0
24427,6,3,85522,85522,85525,0,3,4
24428,2,2,85524,85525,85527,1,3,0
24429,4,2,85528,85528,85530,0,2,1
24430,5,3,85533,85533,85536,0,3,3
24431,1,1,85534,85536,85537,2,3,0
24432,2,2,85536,85537,85539,1,3,0
24433,3,1,85539,85539,85540,0,1,0
24434,2,2,85541,85541,85543,0,2,1
24435,3,1,85544,85544,85545,0,1,1
24436,5,3,85549,85549,85552,0,3,4
24437,4,1,85553,85553,85554,0,1,1
24438,3,2,85556,85556,85558,0,2,2
24439,4,2,85560,85560,85562,0,2,2
24440,5,2,85565,85565,85567,0,2,3
24441,5,1,85570,85570,85571,0,1,3
24442,6,1,85576,85576,85577,0,1,5
24443,4,1,85580,85580,85581,0,1,3
24444,3,2,85583,85583,85585,0,2,2
24445,3,1,85586,85586,85587,0,1,1
24446,6,1,85592,85592,85593,0,1,5
24447,4,2,85596,85596,85598,0,2,3
24448,2,1,85598,85598,85599,0,1,0
24449,6,2,85604,85604,85606,0,2,5
24450,5,2,85609,85609,85611,0,2,3
24451,4,3,85613,85613,85616,0,3,2
24452,3,1,85616,85616,85617,0,1,0
24453,3,1,85619,85619,85620,0,1,2
24454,1,1,85620,85620,85621,0,1,0
24455,3,2,85623,85623,85625,0,2,2
24456,4,2,85627,85627,85629,0,2,2
24457,1,3,85628,85629,85632,1,4,0
24458,5,1,85633,85633,85634,0,1,1
24459,4,1,85637,85637,85638,0,1,3
24460,4,3,85641,85641,85644,0,3,3
24461,2,3,85643,85644,85647,1,4,0
24462,4,3,85647,85647,85650,0,3,0
24463,4,3,85651,85651,85654,0,3,1
24464,6,3,85657,85657,85660,0,3,3
24465,5,1,85662,85662,85663,0,1,2
24466,6,3,85668,85668,85671,0,3,5
24467,3,3,85671,85671,85674,0,3,0
24468,6,3,85677,85677,85680,0,3,3
24469,5,3,85682,85682,85685,0,3,2
24470,1,3,85683,85685,85688,2,5,0
24471,4,3,85687,85688,85691,1,4,0
24472,3,3,85690,85691,85694,1,4,0
24473,1,1,85691,85694,85695,3,4,0
24474,6,2,85697,85697,85699,0,2,2
24475,2,3,85699,85699,85702,0,3,0
24476,3,1,85702,85702,85703,0,1,0
24477,1,1,85703,85703,85704,0,1,0
24478,2,2,85705,85705,85707,0,2,1
24479,6,3,85711,85711,85714,0,3,4
24480,4,1,85715,85715,85716,0,1,1
24481,4,3,85719,85719,85722,0,3,3
24482,5,2,85724,85724,85726,0,2,2
24483,5,2,85729,85729,85731,0,2,3
24484,2,2,85731,85731,85733,0,2,0
24485,2,1,85733,85733,85734,0,1,0
24486,1,1,85734,85734,85735,0,1,0
24487,2,3,85736,85736,85739,0,3,1
24488,2,2,85738,85739,85741,1,3,0
24489,3,1,85741,85741,85742,0,1,0
24490,1,2,85742,85742,85744,0,2,0
24491,6,3,85748,85748,85751,0,3,4
24492,2,1,85750,85751,85752,1,2,0
24493,4,3,85754,85754,85757,0,3,2
24494,6,1,85760,85760,85761,0,1,3
24495,1,3,85761,85761,85764,0,3,0
24496,2,2,85763,85764,85766,1,3,0
24497,5,3,85768,85768,85771,0,3,2
24498,2,1,85770,85771,85772,1,2,0
24499,2,3,85772,85772,85775,0,3,0
24500,2,3,85774,85775,85778,1,4,0
24501,2,2,85776,85778,85780,2,4,0
24502,3,3,85779,85780,85783,1,4,0
24503,4,3,85783,85783,85786,0,3,0
24504,1,1,85784,85786,85787,2,3,0
24505,3,2,85787,85787,85789,0,2,0
24506,4,3,85791,85791,85794,0,3,2
24507,1,3,85792,85794,85797,2,5,0
24508,2,2,85794,85797,85799,3,5,0
24509,1,3,85795,85799,85802,4,7,0
24510,4,3,85799,85802,85805,3,6,0
24511,6,3,85805,85805,85808,0,3,0
24512,1,3,85806,85808,85811,2,5,0
24513,4,3,85810,85811,85814,1,4,0
24514,5,3,85815,85815,85818,0,3,1
24515,3,3,85818,85818,85821,0,3,0
24516,6,3,85824,85824,85827,0,3,3
24517,2,2,85826,85827,85829,1,3,0
24518,1,2,85827,85829,85831,2,4,0
24519,3,3,85830,85831,85834,1,4,0
24520,6,3,85836,85836,85839,0,3,2
24521,2,3,85838,85839,85842,1,4,0
24522,6,2,85844,85844,85846,0,2,2
24523,3,3,85847,85847,85850,0,3,1
24524,2,3,85849,85850,85853,1,4,0
24525,5,2,85854,85854,85856,0,2,1
24526,4,3,85858,85858,85861,0,3,2
24527,4,2,85862,85862,85864,0,2,1
24528,3,1,85865,85865,85866,0,1,1
24529,2,2,85867,85867,85869,0,2,1
24530,2,3,85869,85869,85872,0,3,0
24531,4,2,85873,85873,85875,0,2,1
24532,4,1,85877,85877,85878,0,1,2
24533,1,2,85878,85878,85880,0,2,0
24534,5,3,85883,85883,85886,0,3,3
24535,4,1,85887,85887,85888,0,1,1
24536,4,1,85891,85891,85892,0,1,3
24537,3,2,85894,85894,85896,0,2,2
24538,6,3,85900,85900,85903,0,3,4
24539,6,1,85906,85906,85907,0,1,3
24540,4,3,85910,85910,85913,0,3,3
24541,1,1,85911,85913,85914,2,3,0
24542,4,1,85915,85915,85916,0,1,1
24543,2,2,85917,85917,85919,0,2,1
24544,2,2,85919,85919,85921,0,2,0
24545,2,3,85921,85921,85924,0,3,0
24546,1,1,85922,85924,85925,2,3,0
24547,4,3,85926,85926,85929,0,3,1
24548,5,1,85931,85931,85932,0,1,2
24549,3,1,85934,85934,85935,0,1,2
24550,5,2,85939,85939,85941,0,2,4
24551,3,2,85942,85942,85944,0,2,1
24552,4,2,85946,85946,85948,0,2,2
24553,2,2,85948,85948,85950,0,2,0
24554,6,1,85954,85954,85955,0,1,4
24555,4,1,85958,85958,85959,0,1,3
24556,3,3,85961,85961,85964,0,3,2
24557,3,1,85964,85964,85965,0,1,0
24558,5,2,85969,85969,85971,0,2,4
24559,3,2,85972,85972,85974,0,2,1
24560,2,3,85974,85974,85977,0,3,0
24561,4,3,85978,85978,85981,0,3,1
24562,5,3,85983,85983,85986,0,3,2
24563,1,3,85984,85986,85989,2,5,0
24564,6,2,85990,85990,85992,0,2,1
24565,4,2,85994,85994,85996,0,2,2
24566,2,3,85996,85996,85999,0,3,0
24567,5,1,86001,86001,86002,0,1,2
24568,3,2,86004,86004,86006,0,2,2
24569,4,2,86008,86008,86010,0,2,2
24570,4,2,86012,86012,86014,0,2,2
24571,3,3,86015,86015,86018,0,3,1
24572,6,1,86021,86021,86022,0,1,3
24573,5,3,86026,86026,86029,0,3,4
24574,1,1,86027,86029,86030,2,3,0
24575,6,3,86033,86033,86036,0,3,3
24576,1,2,86034,86036,86038,2,4,0
24577,1,2,86035,86038,86040,3,5,0
24578,4,3,86039,86040,86043,1,4,0
24579,6,3,86045,86045,86048,0,3,2
24580,2,2,86047,86048,86050,1,3,0
24581,2,2,86049,86050,86052,1,3,0
24582,1,3,86050,86052,86055,2,5,0
24583,4,2,86054,86055,86057,1,3,0
24584,5,2,86059,86059,86061,0,2,2
24585,5,1,86064,86064,86065,0,1,3
24586,2,1,86066,86066,86067,0,1,1
24587,5,2,86071,86071,86073,0,2,4
24588,3,3,86074,86074,86077,0,3,1
24589,3,3,86077,86077,86080,0,3,0
24590,1,1,86078,86080,86081,2,3,0
24591,1,1,86079,86081,86082,2,3,0
24592,2,2,86081,86082,86084,1,3,0
24593,4,1,86085,86085,86086,0,1,1
24594,5,3,86090,86090,86093,0,3,4
24595,5,3,86095,86095,86098,0,3,2
24596,4,3,86099,86099,86102,0,3,1
24597,1,2,86100,86102,86104,2,4,0
24598,4,2,86104,86104,86106,0,2,0
24599,2,1,86106,86106,86107,0,1,0
24600,1,1,86107,86107,86108,0,1,0
24601,4,1,86111,86111,86112,0,1,3
24602,4,2,86115,86115,86117,0,2,3
24603,1,2,86116,86117,86119,1,3,0
24604,1,3,86117,86119,86122,2,5,0
24605,2,3,86119,86122,86125,3,6,0
24606,3,3,86122,86125,86128,3,6,0
24607,5,1,86127,86128,86129,1,2,0
24608,2,1,86129,86129,86130,0,1,0
24609,2,1,86131,86131,86132,0,1,1
24610,3,3,86134,86134,86137,0,3,2
24611,4,1,86138,86138,86139,0,1,1
24612,6,1,86144,86144,86145,0,1,5
24613,6,1,86150,86150,86151,0,1,5
24614,1,3,86151,86151,86154,0,3,0
24615,6,3,86157,86157,86160,0,3,3
24616,6,2,86163,86163,86165,0,2,3
24617,1,2,86164,86165,86167,1,3,0
24618,1,1,86165,86167,86168,2,3,0
24619,5,3,86170,86170,86173,0,3,2
24620,6,1,86176,86176,86177,0,1,3
24621,5,3,86181,86181,86184,0,3,4
24622,3,3,86184,86184,86187,0,3,0
24623,3,1,86187,86187,86188,0,1,0
24624,6,3,86193,86193,86196,0,3,5
24625,2,2,86195,86196,86198,1,3,0
24626,5,3,86200,86200,86203,0,3,2
24627,3,3,86203,86203,86206,0,3,0
24628,4,2,86207,86207,86209,0,2,1
24629,2,2,86209,86209,86211,0,2,0
24630,4,1,86213,86213,86214,0,1,2
24631,5,1,86218,86218,86219,0,1,4
24632,3,2,86221,86221,86223,0,2,2
24633,6,3,86227,86227,86230,0,3,4
24634,1,1,86228,86230,86231,2,3,0
24635,4,1,86232,86232,86233,0,1,1
24636,6,1,86238,86238,86239,0,1,5
24637,3,1,86241,86241,86242,0,1,2
24638,1,1,86242,86242,86243,0,1,0
24639,1,1,86243,86243,86244,0,1,0
24640,4,1,86247,86247,86248,0,1,3
24641,4,2,86251,86251,86253,0,2,3
24642,2,2,86253,86253,86255,0,2,0
24643,3,2,86256,86256,86258,0,2,1
24644,1,3,86257,86258,86261,1,4,0
24645,1,1,86258,86261,86262,3,4,0
24646,4,2,86262,86262,86264,0,2,0
24647,2,1,86264,86264,86265,0,1,0
24648,4,1,86268,86268,86269,0,1,3
24649,4,1,86272,86272,86273,0,1,3
24650,4,2,86276,86276,86278,0,2,3
24651,3,2,86279,86279,86281,0,2,1
24652,3,2,86282,86282,86284,0,2,1
24653,1,2,86283,86284,86286,1,3,0
24654,4,1,86287,86287,86288,0,1,1
24655,1,1,86288,86288,86289,0,1,0
24656,5,2,86293,86293,86295,0,2,4
24657,6,2,86299,86299,86301,0,2,4
24658,3,2,86302,86302,86304,0,2,1
24659,4,3,86306,86306,86309,0,3,2
24660,2,1,86308,86309,86310,1,2,0
24661,3,1,86311,86311,86312,0,1,1
24662,4,1,86315,86315,86316,0,1,3
24663,5,3,86320,86320,86323,0,3,4
24664,2,2,86322,86323,86325,1,3,0
24665,3,3,86325,86325,86328,0,3,0
24666,2,2,86327,86328,86330,1,3,0
24667,4,1,86331,86331,86332,0,1,1
24668,5,2,86336,86336,86338,0,2,4
24669,3,1,86339,86339,86340,0,1,1
24670,5,2,86344,86344,86346,0,2,4
24671,6,3,86350,86350,86353,0,3,4
24672,1,1,86351,86353,86354,2,3,0
24673,3,3,86354,86354,86357,0,3,0
24674,3,2,86357,86357,86359,0,2,0
24675,6,2,86363,86363,86365,0,2,4
24676,2,1,86365,86365,86366,0,1,0
24677,4,1,86369,86369,86370,0,1,3
24678,4,1,86373,86373,86374,0,1,3
24679,6,3,86379,86379,86382,0,3,5
24680,3,3,86382,86382,86385,0,3,0
24681,6,3,86388,86388,86391,0,3,3
24682,3,3,86391,86391,86394,0,3,0
24683,4,3,86395,86395,86398,0,3,1
24684,5,3,86400,86400,86403,0,3,2
24685,1,3,86401,86403,86406,2,5,0
24686,2,3,86403,86406,86409,3,6,0
24687,4,3,86407,86409,86412,2,5,0
24688,4,2,86411,86412,86414,1,3,0
24689,5,3,86416,86416,86419,0,3,2
24690,5,1,86421,86421,86422,0,1,2
24691,4,1,86425,86425,86426,0,1,3
24692,3,3,86428,86428,86431,0,3,2
24693,2,1,86430,86431,86432,1,2,0
24694,5,3,86435,86435,86438,0,3,3
24695,3,2,86438,86438,86440,0,2,0
24696,4,2,86442,86442,86444,0,2,2
24697,3,2,86445,86445,86447,0,2,1
24698,1,1,86446,86447,86448,1,2,0
24699,2,2,86448,86448,86450,0,2,0
24700,4,2,86452,86452,86454,0,2,2
24701,2,1,86454,86454,86455,0,1,0
24702,4,2,86458,86458,86460,0,2,3
24703,4,2,86462,86462,86464,0,2,2
24704,5,2,86467,86467,86469,0,2,3
24705,1,3,86468,86469,86472,1,4,0
24706,4,1,86472,86472,86473,0,1,0
24707,4,2,86476,86476,86478,0,2,3
24708,1,1,86477,86478,86479,1,2,0
24709,2,2,86479,86479,86481,0,2,0
24710,3,2,86482,86482,86484,0,2,1
24711,6,2,86488,86488,86490,0,2,4
24712,1,1,86489,86490,86491,1,2,0
24713,3,2,86492,86492,86494,0,2,1
24714,6,3,86498,86498,86501,0,3,4
24715,4,2,86502,86502,86504,0,2,1
24716,5,2,86507,86507,86509,0,2,3
24717,1,2,86508,86509,86511,1,3,0
24718,6,2,86514,86514,86516,0,2,3
24719,3,2,86517,86517,86519,0,2,1
24720,5,3,86522,86522,86525,0,3,3
24721,4,2,86526,86526,86528,0,2,1
24722,3,3,86529,86529,86532,0,3,1
24723,4,3,86533,86533,86536,0,3,1
24724,6,3,86539,86539,86542,0,3,3
24725,6,1,86545,86545,86546,0,1,3
24726,2,2,86547,86547,86549,0,2,1
24727,1,3,86548,86549,86552,1,4,0
24728,4,3,86552,86552,86555,0,3,0
24729,2,1,86554,86555,86556,1,2,0
24730,2,3,86556,86556,86559,0,3,0
24731,3,1,86559,86559,86560,0,1,0
24732,5,2,86564,86564,86566,0,2,4
24733,6,2,86570,86570,86572,0,2,4
24734,5,2,86575,86575,86577,0,2,3
24735,1,1,86576,86577,86578,1,2,0
24736,3,2,86579,86579,86581,0,2,1
24737,2,1,86581,86581,86582,0,1,0
24738,2,1,86583,86583,86584,0,1,1
24739,5,1,86588,86588,86589,0,1,4
24740,3,1,86591,86591,86592,0,1,2
24741,2,3,86593,86593,86596,0,3,1
24742,3,3,86596,86596,86599,0,3,0
24743,4,2,86600,86600,86602,0,2,1
24744,1,2,86601,86602,86604,1,3,0
24745,2,2,86603,86604,86606,1,3,0
24746,6,1,86609,86609,86610,0,1,3
24747,5,2,86614,86614,86616,0,2,4
24748,4,1,86618,86618,86619,0,1,2
24749,5,1,86623,86623,86624,0,1,4
24750,6,2,86629,86629,86631,0,2,5
24751,2,1,86631,86631,86632,0,1,0
24752,3,3,86634,86634,86637,0,3,2
24753,3,3,86637,86637,86640,0,3,0
24754,1,2,86638,86640,86642,2,4,0
24755,4,2,86642,86642,86644,0,2,0
24756,4,1,86646,86646,86647,0,1,2
24757,2,2,86648,86648,86650,0,2,1
24758,5,2,86653,86653,86655,0,2,3
24759,1,1,86654,86655,86656,1,2,0
24760,6,3,86660,86660,86663,0,3,4
24761,5,2,86665,86665,86667,0,2,2
24762,1,2,86666,86667,86669,1,3,0
24763,5,2,86671,86671,86673,0,2,2
24764,6,1,86677,86677,86678,0,1,4
24765,5,2,86682,86682,86684,0,2,4
24766,5,3,86687,86687,86690,0,3,3
24767,2,1,86689,86690,86691,1,2,0
24768,6,2,86695,86695,86697,0,2,4
24769,1,3,86696,86697,86700,1,4,0
24770,1,2,86697,86700,86702,3,5,0
24771,2,2,86699,86702,86704,3,5,0
24772,4,3,86703,86704,86707,1,4,0
24773,2,2,86705,86707,86709,2,4,0
24774,3,3,86708,86709,86712,1,4,0
24775,5,1,86713,86713,86714,0,1,1
24776,6,2,86719,86719,86721,0,2,5
24777,2,3,86721,86721,86724,0,3,0
24778,2,3,86723,86724,86727,1,4,0
24779,6,1,86729,86729,86730,0,1,2
24780,5,2,86734,86734,86736,0,2,4
24781,6,2,86740,86740,86742,0,2,4
24782,4,1,86744,86744,86745,0,1,2
24783,3,1,86747,86747,86748,0,1,2
24784,6,2,86753,86753,86755,0,2,5
24785,6,3,86759,86759,86762,0,3,4
24786,5,1,86764,86764,86765,0,1,2
24787,5,3,86769,86769,86772,0,3,4
24788,6,3,86775,86775,86778,0,3,3
24789,6,2,86781,86781,86783,0,2,3
24790,5,1,86786,86786,86787,0,1,3
24791,6,1,86792,86792,86793,0,1,5
24792,2,3,86794,86794,86797,0,3,1
24793,4,2,86798,86798,86800,0,2,1
24794,3,1,86801,86801,86802,0,1,1
24795,4,1,86805,86805,86806,0,1,3
24796,1,1,86806,86806,86807,0,1,0
24797,3,3,86809,86809,86812,0,3,2
24798,3,2,86812,86812,86814,0,2,0
24799,3,1,86815,86815,86816,0,1,1
24800,6,3,86821,86821,86824,0,3,5
24801,5,2,86826,86826,86828,0,2,2
24802,6,3,86832,86832,86835,0,3,4
24803,6,1,86838,86838,86839,0,1,3
24804,2,1,86840,86840,86841,0,1,1
24805,1,3,86841,86841,86844,0,3,0
24806,3,3,86844,86844,86847,0,3,0
24807,4,2,86848,86848,86850,0,2,1
24808,5,3,86853,86853,86856,0,3,3
24809,5,1,86858,86858,86859,0,1,2
24810,6,2,86864,86864,86866,0,2,5
24811,1,2,86865,86866,86868,1,3,0
24812,3,3,86868,86868,86871,0,3,0
24813,1,1,86869,86871,86872,2,3,0
24814,1,2,86870,86872,86874,2,4,0
24815,6,2,86876,86876,86878,0,2,2
24816,1,2,86877,86878,86880,1,3,0
24817,3,2,86880,86880,86882,0,2,0
24818,2,1,86882,86882,86883,0,1,0
24819,1,2,86883,86883,86885,0,2,0
24820,4,2,86887,86887,86889,0,2,2
24821,1,3,86888,86889,86892,1,4,0
24822,1,1,86889,86892,86893,3,4,0
24823,6,3,86895,86895,86898,0,3,2
24824,3,2,86898,86898,86900,0,2,0
24825,2,1,86900,86900,86901,0,1,0
24826,4,3,86904,86904,86907,0,3,3
24827,6,2,86910,86910,86912,0,2,3
24828,3,2,86913,86913,86915,0,2,1
24829,5,3,86918,86918,86921,0,3,3
24830,5,3,86923,86923,86926,0,3,2
24831,3,3,86926,86926,86929,0,3,0
24832,6,3,86932,86932,86935,0,3,3
24833,6,1,86938,86938,86939,0,1,3
24834,5,3,86943,86943,86946,0,3,4
24835,4,1,86947,86947,86948,0,1,1
24836,5,1,86952,86952,86953,0,1,4
24837,1,3,86953,86953,86956,0,3,0
24838,6,2,86959,86959,86961,0,2,3
24839,4,2,86963,86963,86965,0,2,2
24840,2,3,86965,86965,86968,0,3,0
24841,5,3,86970,86970,86973,0,3,2
24842,6,1,86976,86976,86977,0,1,3
24843,2,3,86978,86978,86981,0,3,1
24844,4,3,86982,86982,86985,0,3,1
24845,1,1,86983,86985,86986,2,3,0
24846,4,1,86987,86987,86988,0,1,1
24847,2,3,86989,86989,86992,0,3,1
24848,4,1,86993,86993,86994,0,1,1
24849,3,1,86996,86996,86997,0,1,2
24850,4,3,87000,87000,87003,0,3,3
24851,6,3,87006,87006,87009,0,3,3
24852,5,2,87011,87011,87013,0,2,2
24853,5,1,87016,87016,87017,0,1,3
24854,2,1,87018,87018,87019,0,1,1
24855,4,1,87022,87022,87023,0,1,3
24856,3,3,87025,87025,87028,0,3,2
24857,3,3,87028,87028,87031,0,3,0
24858,3,1,87031,87031,87032,0,1,0
24859,5,2,87036,87036,87038,0,2,4
24860,4,3,87040,87040,87043,0,3,2
24861,5,2,87045,87045,87047,0,2,2
24862,5,1,87050,87050,87051,0,1,3
24863,5,2,87055,87055,87057,0,2,4
24864,3,1,87058,87058,87059,0,1,1
24865,2,1,87060,87060,87061,0,1,1
24866,1,2,87061,87061,87063,0,2,0
24867,2,2,87063,87063,87065,0,2,0
24868,1,1,87064,87065,87066,1,2,0
24869,1,3,87065,87066,87069,1,4,0
24870,1,1,87066,87069,87070,3,4,0
24871,4,2,87070,87070,87072,0,2,0
24872,1,3,87071,87072,87075,1,4,0
24873,3,3,87074,87075,87078,1,4,0
24874,6,2,87080,87080,87082,0,2,2
24875,3,3,87083,87083,87086,0,3,1
24876,6,3,87089,87089,87092,0,3,3
24877,5,1,87094,87094,87095,0,1,2
24878,1,1,87095,87095,87096,0,1,0
24879,3,2,87098,87098,87100,0,2,2
24880,5,2,87103,87103,87105,0,2,3
24881,6,2,87109,87109,87111,0,2,4
24882,4,3,87113,87113,87116,0,3,2
24883,5,1,87118,87118,87119,0,1,2
24884,1,3,87119,87119,87122,0,3,0
24885,4,1,87123,87123,87124,0,1,1
24886,6,3,87129,87129,87132,0,3,5
24887,5,2,87134,87134,87136,0,2,2
24888,4,3,87138,87138,87141,0,3,2
24889,2,1,87140,87141,87142,1,2,0
24890,4,2,87144,87144,87146,0,2,2
24891,1,2,87145,87146,87148,1,3,0
24892,6,2,87151,87151,87153,0,2,3
24893,3,3,87154,87154,87157,0,3,1
24894,4,2,87158,87158,87160,0,2,1
24895,6,1,87164,87164,87165,0,1,4
24896,6,3,87170,87170,87173,0,3,5
24897,3,3,87173,87173,87176,0,3,0
24898,5,2,87178,87178,87180,0,2,2
24899,4,1,87182,87182,87183,0,1,2
24900,3,3,87185,87185,87188,0,3,2
24901,2,2,87187,87188,87190,1,3,0
24902,2,2,87189,87190,87192,1,3,0
24903,3,3,87192,87192,87195,0,3,0
24904,5,3,87197,87197,87200,0,3,2
24905,3,2,87200,87200,87202,0,2,0
24906,5,2,87205,87205,87207,0,2,3
24907,1,2,87206,87207,87209,1,3,0
24908,4,2,87210,87210,87212,0,2,1
24909,3,2,87213,87213,87215,0,2,1
24910,1,3,87214,87215,87218,1,4,0
24911,3,3,87217,87218,87221,1,4,0
24912,4,3,87221,87221,87224,0,3,0
24913,1,1,87222,87224,87225,2,3,0
24914,2,1,87224,87225,87226,1,2,0
24915,2,3,87226,87226,87229,0,3,0
24916,6,1,87232,87232,87233,0,1,3
24917,1,1,87233,87233,87234,0,1,0
24918,3,1,87236,87236,87237,0,1,2
24919,5,3,87241,87241,87244,0,3,4
24920,5,1,87246,87246,87247,0,1,2
24921,5,2,87251,87251,87253,0,2,4
24922,3,1,87254,87254,87255,0,1,1
24923,3,1,87257,87257,87258,0,1,2
24924,5,3,87262,87262,87265,0,3,4
24925,4,3,87266,87266,87269,0,3,1
24926,2,1,87268,87269,87270,1,2,0
24927,3,1,87271,87271,87272,0,1,1
24928,2,3,87273,87273,87276,0,3,1
24929,3,1,87276,87276,87277,0,1,0
24930,2,2,87278,87278,87280,0,2,1
24931,1,3,87279,87280,87283,1,4,0
24932,5,2,87284,87284,87286,0,2,1
24933,6,2,87290,87290,87292,0,2,4
24934,4,3,87294,87294,87297,0,3,2
24935,5,3,87299,87299,87302,0,3,2
24936,1,3,87300,87302,87305,2,5,0
24937,3,3,87303,87305,87308,2,5,0
24938,1,1,87304,87308,87309,4,5,0
24939,4,3,87308,87309,87312,1,4,0
24940,1,2,87309,87312,87314,3,5,0
24941,6,1,87315,87315,87316,0,1,1
24942,2,2,87317,87317,87319,0,2,1
24943,5,3,87322,87322,87325,0,3,3
24944,3,1,87325,87325,87326,0,1,0
24945,5,2,87330,87330,87332,0,2,4
24946,2,3,87332,87332,87335,0,3,0
24947,4,3,87336,87336,87339,0,3,1
24948,6,2,87342,87342,87344,0,2,3
24949,4,3,87346,87346,87349,0,3,2
24950,4,1,87350,87350,87351,0,1,1
24951,5,1,87355,87355,87356,0,1,4
24952,1,3,87356,87356,87359,0,3,0
24953,1,1,87357,87359,87360,2,3,0
24954,5,2,87362,87362,87364,0,2,2
24955,5,1,87367,87367,87368,0,1,3
24956,5,3,87372,87372,87375,0,3,4
24957,2,3,87374,87375,87378,1,4,0
24958,4,1,87378,87378,87379,0,1,0
24959,6,2,87384,87384,87386,0,2,5
24960,1,2,87385,87386,87388,1,3,0
24961,3,1,87388,87388,87389,0,1,0
24962,6,3,87394,87394,87397,0,3,5
24963,3,2,87397,87397,87399,0,2,0
24964,1,1,87398,87399,87400,1,2,0
24965,1,1,87399,87400,87401,1,2,0
24966,1,1,87400,87401,87402,1,2,0
24967,2,3,87402,87402,87405,0,3,0
24968,4,2,87406,87406,87408,0,2,1
24969,5,1,87411,87411,87412,0,1,3
24970,4,1,87415,87415,87416,0,1,3
24971,1,3,87416,87416,87419,0,3,0
24972,6,2,87422,87422,87424,0,2,3
24973,4,2,87426,87426,87428,0,2,2
24974,5,2,87431,87431,87433,0,2,3
24975,1,3,87432,87433,87436,1,4,0
24976,6,2,87438,87438,87440,0,2,2
24977,2,1,87440,87440,87441,0,1,0
24978,1,3,87441,87441,87444,0,3,0
24979,3,2,87444,87444,87446,0,2,0
24980,5,2,87449,87449,87451,0,2,3
24981,6,2,87455,87455,87457,0,2,4
24982,6,2,87461,87461,87463,0,2,4
24983,6,3,87467,87467,87470,0,3,4
24984,3,2,87470,87470,87472,0,2,0
24985,2,2,87472,87472,87474,0,2,0
24986,3,3,87475,87475,87478,0,3,1
24987,3,1,87478,87478,87479,0,1,0
24988,2,3,87480,87480,87483,0,3,1
24989,4,1,87484,87484,87485,0,1,1
24990,1,1,87485,87485,87486,0,1,0
24991,2,3,87487,87487,87490,0,3,1
24992,2,1,87489,87490,87491,1,2,0
24993,5,2,87494,87494,87496,0,2,3
24994,6,2,87500,87500,87502,0,2,4
24995,2,3,87502,87502,87505,0,3,0
24996,5,3,87507,87507,87510,0,3,2
24997,1,1,87508,87510,87511,2,3,0
24998,3,3,87511,87511,87514,0,3,0
24999,2,2,87513,87514,87516,1,3,0
25000,5,3,87518,87518,87521,0,3,2
25001,1,3,87519,87521,87524,2,5,0
25002,6,2,87525,87525,87527,0,2,1
25003,5,3,87530,87530,87533,0,3,3
25004,3,1,87533,87533,87534,0,1,0
25005,1,2,87534,87534,87536,0,2,0
25006,4,1,87538,87538,87539,0,1,2
25007,5,3,87543,87543,87546,0,3,4
25008,3,3,87546,87546,87549,0,3,0
25009,3,1,87549,87549,87550,0,1,0
25010,4,3,87553,87553,87556,0,3,3
25011,6,1,87559,87559,87560,0,1,3
25012,6,2,87565,87565,87567,0,2,5
25013,5,1,87570,87570,87571,0,1,3
25014,4,2,87574,87574,87576,0,2,3
25015,6,2,87580,87580,87582,0,2,4
25016,4,3,87584,87584,87587,0,3,2
25017,5,2,87589,87589,87591,0,2,2
25018,4,1,87593,87593,87594,0,1,2
25019,3,3,87596,87596,87599,0,3,2
25020,2,2,87598,87599,87601,1,3,0
25021,5,3,87603,87603,87606,0,3,2
25022,3,1,87606,87606,87607,0,1,0
25023,1,2,87607,87607,87609,0,2,0
25024,4,3,87611,87611,87614,0,3,2
25025,6,1,87617,87617,87618,0,1,3
25026,5,3,87622,87622,87625,0,3,4
25027,2,3,87624,87625,87628,1,4,0
25028,3,2,87627,87628,87630,1,3,0
25029,3,2,87630,87630,87632,0,2,0
25030,5,1,87635,87635,87636,0,1,3
25031,3,3,87638,87638,87641,0,3,2
25032,3,1,87641,87641,87642,0,1,0
25033,5,2,87646,87646,87648,0,2,4
25034,1,2,87647,87648,87650,1,3,0
25035,6,1,87653,87653,87654,0,1,3
25036,3,1,87656,87656,87657,0,1,2
25037,5,3,87661,87661,87664,0,3,4
25038,5,2,87666,87666,87668,0,2,2
25039,4,3,87670,87670,87673,0,3,2
25040,1,1,87671,87673,87674,2,3,0
25041,3,1,87674,87674,87675,0,1,0
25042,3,3,87677,87677,87680,0,3,2
25043,6,1,87683,87683,87684,0,1,3
25044,3,3,87686,87686,87689,0,3,2
25045,4,1,87690,87690,87691,0,1,1
25046,2,1,87692,87692,87693,0,1,1
25047,4,3,87696,87696,87699,0,3,3
25048,3,3,87699,87699,87702,0,3,0
25049,1,2,87700,87702,87704,2,4,0
25050,3,2,87703,87704,87706,1,3,0
25051,3,2,87706,87706,87708,0,2,0
25052,5,3,87711,87711,87714,0,3,3
25053,4,2,87715,87715,87717,0,2,1
25054,2,1,87717,87717,87718,0,1,0
25055,6,3,87723,87723,87726,0,3,5
25056,4,3,87727,87727,87730,0,3,1
25057,1,2,87728,87730,87732,2,4,0
25058,3,3,87731,87732,87735,1,4,0
25059,2,1,87733,87735,87736,2,3,0
25060,6,3,87739,87739,87742,0,3,3
25061,3,3,87742,87742,87745,0,3,0
25062,5,3,87747,87747,87750,0,3,2
25063,3,3,87750,87750,87753,0,3,0
25064,5,3,87755,87755,87758,0,3,2
25065,5,1,87760,87760,87761,0,1,2
25066,3,1,87763,87763,87764,0,1,2
25067,6,1,87769,87769,87770,0,1,5
25068,5,2,87774,87774,87776,0,2,4
25069,1,2,87775,87776,87778,1,3,0
25070,4,3,87779,87779,87782,0,3,1
25071,2,1,87781,87782,87783,1,2,0
25072,4,1,87785,87785,87786,0,1,2
25073,1,2,87786,87786,87788,0,2,0
25074,5,2,87791,87791,87793,0,2,3
25075,5,1,87796,87796,87797,0,1,3
25076,1,2,87797,87797,87799,0,2,0
25077,6,1,87803,87803,87804,0,1,4
25078,3,3,87806,87806,87809,0,3,2
25079,3,1,87809,87809,87810,0,1,0
25080,6,2,87815,87815,87817,0,2,5
25081,2,2,87817,87817,87819,0,2,0
25082,1,2,87818,87819,87821,1,3,0
25083,6,3,87824,87824,87827,0,3,3
25084,5,3,87829,87829,87832,0,3,2
25085,1,2,87830,87832,87834,2,4,0
25086,3,1,87833,87834,87835,1,2,0
25087,2,1,87835,87835,87836,0,1,0
25088,5,1,87840,87840,87841,0,1,4
25089,2,3,87842,87842,87845,0,3,1
25090,4,2,87846,87846,87848,0,2,1
25091,3,1,87849,87849,87850,0,1,1
25092,1,2,87850,87850,87852,0,2,0
25093,6,2,87856,87856,87858,0,2,4
25094,5,1,87861,87861,87862,0,1,3
25095,3,2,87864,87864,87866,0,2,2
25096,5,1,87869,87869,87870,0,1,3
25097,5,1,87874,87874,87875,0,1,4
25098,4,1,87878,87878,87879,0,1,3
25099,6,1,87884,87884,87885,0,1,5
25100,4,2,87888,87888,87890,0,2,3
25101,5,3,87893,87893,87896,0,3,3
25102,3,2,87896,87896,87898,0,2,0
25103,4,1,87900,87900,87901,0,1,2
25104,3,1,87903,87903,87904,0,1,2
25105,4,2,87907,87907,87909,0,2,3
25106,3,1,87910,87910,87911,0,1,1
25107,1,1,87911,87911,87912,0,1,0
25108,3,3,87914,87914,87917,0,3,2
25109,6,3,87920,87920,87923,0,3,3
25110,4,2,87924,87924,87926,0,2,1
25111,1,3,87925,87926,87929,1,4,0
25112,6,3,87931,87931,87934,0,3,2
25113,5,1,87936,87936,87937,0,1,2
25114,1,1,87937,87937,87938,0,1,0
25115,3,2,87940,87940,87942,0,2,2
25116,4,2,87944,87944,87946,0,2,2
25117,3,3,87947,87947,87950,0,3,1
25118,4,1,87951,87951,87952,0,1,1
25119,6,1,87957,87957,87958,0,1,5
25120,3,3,87960,87960,87963,0,3,2
25121,3,1,87963,87963,87964,0,1,0
25122,2,2,87965,87965,87967,0,2,1
25123,3,1,87968,87968,87969,0,1,1
25124,2,3,87970,87970,87973,0,3,1
25125,6,3,87976,87976,87979,0,3,3
25126,1,3,87977,87979,87982,2,5,0
25127,1,2,87978,87982,87984,4,6,0
25128,2,2,87980,87984,87986,4,6,0
25129,2,2,87982,87986,87988,4,6,0
25130,4,2,87986,87988,87990,2,4,0
25131,4,1,87990,87990,87991,0,1,0
25132,2,2,87992,87992,87994,0,2,1
25133,6,3,87998,87998,88001,0,3,4
25134,5,1,88003,88003,88004,0,1,2
25135,6,3,88009,88009,88012,0,3,5
25136,4,3,88013,88013,88016,0,3,1
25137,5,1,88018,88018,88019,0,1,2
25138,5,3,88023,88023,88026,0,3,4
25139,4,2,88027,88027,88029,0,2,1
25140,1,3,88028,88029,88032,1,4,0
25141,2,1,88030,88032,88033,2,3,0
25142,3,1,88033,88033,88034,0,1,0
25143,4,2,88037,88037,88039,0,2,3
25144,6,3,88043,88043,88046,0,3,4
25145,5,3,88048,88048,88051,0,3,2
25146,2,2,88050,88051,88053,1,3,0
25147,6,2,88056,88056,88058,0,2,3
25148,2,2,88058,88058,88060,0,2,0
25149,4,2,88062,88062,88064,0,2,2
25150,2,2,88064,88064,88066,0,2,0
25151,3,1,88067,88067,88068,0,1,1
25152,6,2,88073,88073,88075,0,2,5
25153,2,2,88075,88075,88077,0,2,0
25154,5,1,88080,88080,88081,0,1,3
25155,2,3,88082,88082,88085,0,3,1
25156,6,2,88088,88088,88090,0,2,3
25157,4,2,88092,88092,88094,0,2,2
25158,5,2,88097,88097,88099,0,2,3
25159,5,2,88102,88102,88104,0,2,3
25160,2,1,88104,88104,88105,0,1,0
25161,2,1,88106,88106,88107,0,1,1
25162,5,3,88111,88111,88114,0,3,4
25163,6,2,88117,88117,88119,0,2,3
25164,5,3,88122,88122,88125,0,3,3
25165,3,3,88125,88125,88128,0,3,0
25166,3,1,88128,88128,88129,0,1,0
25167,1,1,88129,88129,88130,0,1,0
25168,4,3,88133,88133,88136,0,3,3
25169,1,2,88134,88136,88138,2,4,0
25170,6,1,88140,88140,88141,0,1,2
25171,1,2,88141,88141,88143,0,2,0
25172,2,3,88143,88143,88146,0,3,0
25173,2,1,88145,88146,88147,1,2,0
25174,1,3,88146,88147,88150,1,4,0
25175,3,2,88149,88150,88152,1,3,0
25176,1,3,88150,88152,88155,2,5,0
25177,1,3,88151,88155,88158,4,7,0
25178,1,1,88152,88158,88159,6,7,0
25179,6,3,88158,88159,88162,1,4,0
25180,2,2,88160,88162,88164,2,4,0
25181,5,1,88165,88165,88166,0,1,1
25182,4,1,88169,88169,88170,0,1,3
25183,2,1,88171,88171,88172,0,1,1
25184,3,2,88174,88174,88176,0,2,2
25185,5,1,88179,88179,88180,0,1,3
25186,2,3,88181,88181,88184,0,3,1
25187,4,3,88185,88185,88188,0,3,1
25188,3,1,88188,88188,88189,0,1,0
25189,3,3,88191,88191,88194,0,3,2
25190,1,2,88192,88194,88196,2,4,0
25191,2,3,88194,88196,88199,2,5,0
25192,2,2,88196,88199,88201,3,5,0
25193,4,2,88200,88201,88203,1,3,0
25194,5,1,88205,88205,88206,0,1,2
25195,6,1,88211,88211,88212,0,1,5
25196,1,3,88212,88212,88215,0,3,0
25197,6,1,88218,88218,88219,0,1,3
25198,2,2,88220,88220,88222,0,2,1
25199,1,3,88221,88222,88225,1,4,0
25200,1,1,88222,88225,88226,3,4,0
25201,1,1,88223,88226,88227,3,4,0
25202,1,1,88224,88227,88228,3,4,0
25203,6,1,88230,88230,88231,0,1,2
25204,2,2,88232,88232,88234,0,2,1
25205,5,3,88237,88237,88240,0,3,3
25206,5,3,88242,88242,88245,0,3,2
25207,3,2,88245,88245,88247,0,2,0
25208,1,3,88246,88247,88250,1,4,0
25209,1,2,88247,88250,88252,3,5,0
25210,1,1,88248,88252,88253,4,5,0
25211,2,1,88250,88253,88254,3,4,0
25212,4,3,88254,88254,88257,0,3,0
25213,4,1,88258,88258,88259,0,1,1
25214,2,1,88260,88260,88261,0,1,1
25215,5,1,88265,88265,88266,0,1,4
25216,4,3,88269,88269,88272,0,3,3
25217,2,1,88271,88272,88273,1,2,0
25218,5,3,88276,88276,88279,0,3,3
25219,1,2,88277,88279,88281,2,4,0
25220,3,1,88280,88281,88282,1,2,0
25221,1,2,88281,88282,88284,1,3,0
25222,2,1,88283,88284,88285,1,2,0
25223,6,1,88289,88289,88290,0,1,4
25224,3,1,88292,88292,88293,0,1,2
25225,4,2,88296,88296,88298,0,2,3
25226,6,3,88302,88302,88305,0,3,4
25227,3,3,88305,88305,88308,0,3,0
25228,5,2,88310,88310,88312,0,2,2
25229,2,2,88312,88312,88314,0,2,0
25230,3,3,88315,88315,88318,0,3,1
25231,1,1,88316,88318,88319,2,3,0
25232,5,2,88321,88321,88323,0,2,2
25233,5,1,88326,88326,88327,0,1,3
25234,5,3,88331,88331,88334,0,3,4
25235,3,1,88334,88334,88335,0,1,0
25236,6,3,88340,88340,88343,0,3,5
25237,4,1,88344,88344,88345,0,1,1
25238,4,1,88348,88348,88349,0,1,3
25239,3,2,88351,88351,88353,0,2,2
25240,6,3,88357,88357,88360,0,3,4
25241,5,1,88362,88362,88363,0,1,2
25242,3,1,88365,88365,88366,0,1,2
25243,6,1,88371,88371,88372,0,1,5
25244,6,3,88377,88377,88380,0,3,5
25245,6,1,88383,88383,88384,0,1,3
25246,5,3,88388,88388,88391,0,3,4
25247,1,2,88389,88391,88393,2,4,0
25248,5,3,88394,88394,88397,0,3,1
25249,5,2,88399,88399,88401,0,2,2
25250,2,3,88401,88401,88404,0,3,0
25251,2,1,88403,88404,88405,1,2,0
25252,5,2,88408,88408,88410,0,2,3
25253,1,3,88409,88410,88413,1,4,0
25254,2,2,88411,88413,88415,2,4,0
25255,3,3,88414,88415,88418,1,4,0
25256,1,1,88415,88418,88419,3,4,0
25257,5,2,88420,88420,88422,0,2,1
25258,3,1,88423,88423,88424,0,1,1
25259,2,1,88425,88425,88426,0,1,1
25260,2,2,88427,88427,88429,0,2,1
25261,6,3,88433,88433,88436,0,3,4
25262,2,1,88435,88436,88437,1,2,0
25263,3,2,88438,88438,88440,0,2,1
25264,4,2,88442,88442,88444,0,2,2
25265,3,2,88445,88445,88447,0,2,1
25266,3,3,88448,88448,88451,0,3,1
25267,5,1,88453,88453,88454,0,1,2
25268,6,1,88459,88459,88460,0,1,5
25269,3,1,88462,88462,88463,0,1,2
25270,1,2,88463,88463,88465,0,2,0
25271,3,1,88466,88466,88467,0,1,1
25272,3,1,88469,88469,88470,0,1,2
25273,6,2,88475,88475,88477,0,2,5
25274,3,1,88478,88478,88479,0,1,1
25275,3,3,88481,88481,88484,0,3,2
25276,6,3,88487,88487,88490,0,3,3
25277,1,2,88488,88490,88492,2,4,0
25278,1,2,88489,88492,88494,3,5,0
25279,1,1,88490,88494,88495,4,5,0
25280,4,3,88494,88495,88498,1,4,0
25281,2,2,88496,88498,88500,2,4,0
25282,2,2,88498,88500,88502,2,4,0
25283,4,3,88502,88502,88505,0,3,0
25284,2,3,88504,88505,88508,1,4,0
25285,1,1,88505,88508,88509,3,4,0
25286,3,3,88508,88509,88512,1,4,0
25287,1,2,88509,88512,88514,3,5,0
25288,5,3,88514,88514,88517,0,3,0
25289,6,3,88520,88520,88523,0,3,3
25290,4,2,88524,88524,88526,0,2,1
25291,5,1,88529,88529,88530,0,1,3
25292,4,3,88533,88533,88536,0,3,3
25293,6,3,88539,88539,88542,0,3,3
25294,2,2,88541,88542,88544,1,3,0
25295,5,3,88546,88546,88549,0,3,2
25296,6,2,88552,88552,88554,0,2,3
25297,2,3,88554,88554,88557,0,3,0
25298,4,2,88558,88558,88560,0,2,1
25299,3,1,88561,88561,88562,0,1,1
25300,2,2,88563,88563,88565,0,2,1
25301,2,1,88565,88565,88566,0,1,0
25302,4,3,88569,88569,88572,0,3,3
25303,2,1,88571,88572,88573,1,2,0
25304,5,3,88576,88576,88579,0,3,3
25305,6,2,88582,88582,88584,0,2,3
25306,1,1,88583,88584,88585,1,2,0
25307,5,2,88588,88588,88590,0,2,3
25308,5,1,88593,88593,88594,0,1,3
25309,5,1,88598,88598,88599,0,1,4
25310,1,3,88599,88599,88602,0,3,0
25311,1,3,88600,88602,88605,2,5,0
25312,6,3,88606,88606,88609,0,3,1
25313,1,2,88607,88609,88611,2,4,0
25314,1,1,88608,88611,88612,3,4,0
25315,3,3,88611,88612,88615,1,4,0
25316,3,3,88614,88615,88618,1,4,0
25317,1,1,88615,88618,88619,3,4,0
25318,3,3,88618,88619,88622,1,4,0
25319,3,3,88621,88622,88625,1,4,0
25320,1,1,88622,88625,88626,3,4,0
25321,3,1,88625,88626,88627,1,2,0
25322,5,1,88630,88630,88631,0,1,3
25323,6,3,88636,88636,88639,0,3,5
25324,2,2,88638,88639,88641,1,3,0
25325,5,2,88643,88643,88645,0,2,2
25326,2,1,88645,88645,88646,0,1,0
25327,6,2,88651,88651,88653,0,2,5
25328,6,2,88657,88657,88659,0,2,4
25329,2,2,88659,88659,88661,0,2,0
25330,3,1,88662,88662,88663,0,1,1
25331,1,3,88663,88663,88666,0,3,0
25332,5,1,88668,88668,88669,0,1,2
25333,2,2,88670,88670,88672,0,2,1
25334,2,1,88672,88672,88673,0,1,0
25335,1,1,88673,88673,88674,0,1,0
25336,6,3,88679,88679,88682,0,3,5
25337,1,3,88680,88682,88685,2,5,0
25338,6,3,88686,88686,88689,0,3,1
25339,3,2,88689,88689,88691,0,2,0
25340,4,2,88693,88693,88695,0,2,2
25341,1,1,88694,88695,88696,1,2,0
25342,1,2,88695,88696,88698,1,3,0
25343,3,1,88698,88698,88699,0,1,0
25344,1,1,88699,88699,88700,0,1,0
25345,4,2,88703,88703,88705,0,2,3
25346,2,3,88705,88705,88708,0,3,0
25347,6,2,88711,88711,88713,0,2,3
25348,4,2,88715,88715,88717,0,2,2
25349,5,1,88720,88720,88721,0,1,3
25350,6,2,88726,88726,88728,0,2,5
25351,3,2,88729,88729,88731,0,2,1
25352,5,2,88734,88734,88736,0,2,3
25353,1,3,88735,88736,88739,1,4,0
25354,1,1,88736,88739,88740,3,4,0
25355,4,1,88740,88740,88741,0,1,0
25356,5,2,88745,88745,88747,0,2,4
25357,6,3,88751,88751,88754,0,3,4
25358,3,2,88754,88754,88756,0,2,0
25359,1,3,88755,88756,88759,1,4,0
25360,4,3,88759,88759,88762,0,3,0
25361,2,1,88761,88762,88763,1,2,0
25362,6,1,88767,88767,88768,0,1,4
25363,5,3,88772,88772,88775,0,3,4
25364,6,1,88778,88778,88779,0,1,3
25365,5,1,88783,88783,88784,0,1,4
25366,6,3,88789,88789,88792,0,3,5
25367,3,3,88792,88792,88795,0,3,0
25368,3,3,88795,88795,88798,0,3,0
25369,1,2,88796,88798,88800,2,4,0
25370,2,1,88798,88800,88801,2,3,0
25371,6,3,88804,88804,88807,0,3,3
25372,5,2,88809,88809,88811,0,2,2
25373,1,1,88810,88811,88812,1,2,0
25374,3,3,88813,88813,88816,0,3,1
25375,5,3,88818,88818,88821,0,3,2
25376,2,3,88820,88821,88824,1,4,0
25377,1,1,88821,88824,88825,3,4,0
25378,2,1,88823,88825,88826,2,3,0
25379,4,3,88827,88827,88830,0,3,1
25380,5,1,88832,88832,88833,0,1,2
25381,4,1,88836,88836,88837,0,1,3
25382,1,3,88837,88837,88840,0,3,0
25383,3,1,88840,88840,88841,0,1,0
25384,6,2,88846,88846,88848,0,2,5
25385,2,2,88848,88848,88850,0,2,0
25386,2,1,88850,88850,88851,0,1,0
25387,2,3,88852,88852,88855,0,3,1
25388,3,1,88855,88855,88856,0,1,0
25389,2,3,88857,88857,88860,0,3,1
25390,3,3,88860,88860,88863,0,3,0
25391,2,3,88862,88863,88866,1,4,0
25392,5,2,88867,88867,88869,0,2,1
25393,2,2,88869,88869,88871,0,2,0
25394,4,3,88873,88873,88876,0,3,2
25395,4,1,88877,88877,88878,0,1,1
25396,3,3,88880,88880,88883,0,3,2
25397,3,3,88883,88883,88886,0,3,0
25398,4,2,88887,88887,88889,0,2,1
25399,5,3,88892,88892,88895,0,3,3
25400,4,2,88896,88896,88898,0,2,1
25401,6,2,88902,88902,88904,0,2,4
25402,5,3,88907,88907,88910,0,3,3
25403,2,1,88909,88910,88911,1,2,0
25404,4,2,88913,88913,88915,0,2,2
25405,6,3,88919,88919,88922,0,3,4
25406,4,3,88923,88923,88926,0,3,1
25407,2,3,88925,88926,88929,1,4,0
25408,4,2,88929,88929,88931,0,2,0
25409,2,2,88931,88931,88933,0,2,0
25410,5,2,88936,88936,88938,0,2,3
25411,2,1,88938,88938,88939,0,1,0
25412,1,3,88939,88939,88942,0,3,0
25413,5,2,88944,88944,88946,0,2,2
25414,5,3,88949,88949,88952,0,3,3
25415,4,1,88953,88953,88954,0,1,1
25416,4,2,88957,88957,88959,0,2,3
25417,5,3,88962,88962,88965,0,3,3
25418,6,1,88968,88968,88969,0,1,3
25419,4,1,88972,88972,88973,0,1,3
25420,2,3,88974,88974,88977,0,3,1
25421,2,2,88976,88977,88979,1,3,0
25422,2,3,88978,88979,88982,1,4,0
25423,3,3,88981,88982,88985,1,4,0
25424,1,3,88982,88985,88988,3,6,0
25425,1,1,88983,88988,88989,5,6,0
25426,1,1,88984,88989,88990,5,6,0
25427,2,1,88986,88990,88991,4,5,0
25428,3,3,88989,88991,88994,2,5,0
25429,6,2,88995,88995,88997,0,2,1
25430,4,2,88999,88999,89001,0,2,2
25431,6,1,89005,89005,89006,0,1,4
25432,4,2,89009,89009,89011,0,2,3
25433,3,2,89012,89012,89014,0,2,1
25434,5,3,89017,89017,89020,0,3,3
25435,2,3,89019,89020,89023,1,4,0
25436,4,3,89023,89023,89026,0,3,0
25437,6,3,89029,89029,89032,0,3,3
25438,1,3,89030,89032,89035,2,5,0
25439,1,2,89031,89035,89037,4,6,0
25440,1,2,89032,89037,89039,5,7,0
25441,5,1,89037,89039,89040,2,3,0
25442,1,2,89038,89040,89042,2,4,0
25443,3,3,89041,89042,89045,1,4,0
25444,3,1,89044,89045,89046,1,2,0
25445,2,2,89046,89046,89048,0,2,0
25446,3,3,89049,89049,89052,0,3,1
25447,5,2,89054,89054,89056,0,2,2
25448,5,3,89059,89059,89062,0,3,3
25449,1,1,89060,89062,89063,2,3,0
25450,3,1,89063,89063,89064,0,1,0
25451,6,2,89069,89069,89071,0,2,5
25452,6,2,89075,89075,89077,0,2,4
25453,2,3,89077,89077,89080,0,3,0
25454,4,3,89081,89081,89084,0,3,1
25455,3,3,89084,89084,89087,0,3,0
25456,5,3,89089,89089,89092,0,3,2
25457,1,2,89090,89092,89094,2,4,0
25458,6,1,89096,89096,89097,0,1,2
25459,4,1,89100,89100,89101,0,1,3
25460,5,2,89105,89105,89107,0,2,4
25461,1,3,89106,89107,89110,1,4,0
25462,2,1,89108,89110,89111,2,3,0
25463,1,3,89109,89111,89114,2,5,0
25464,6,1,89115,89115,89116,0,1,1
25465,6,1,89121,89121,89122,0,1,5
25466,3,1,89124,89124,89125,0,1,2
25467,5,1,89129,89129,89130,0,1,4
25468,1,1,89130,89130,89131,0,1,0
25469,1,1,89131,89131,89132,0,1,0
25470,4,3,89135,89135,89138,0,3,3
25471,5,3,89140,89140,89143,0,3,2
25472,2,3,89142,89143,89146,1,4,0
25473,3,1,89145,89146,89147,1,2,0
25474,6,2,89151,89151,89153,0,2,4
25475,2,2,89153,89153,89155,0,2,0
25476,6,1,89159,89159,89160,0,1,4
25477,1,3,89160,89160,89163,0,3,0
25478,3,2,89163,89163,89165,0,2,0
25479,2,2,89165,89165,89167,0,2,0
25480,5,1,89170,89170,89171,0,1,3
25481,6,3,89176,89176,89179,0,3,5
25482,3,2,89179,89179,89181,0,2,0
25483,5,3,89184,89184,89187,0,3,3
25484,6,3,89190,89190,89193,0,3,3
25485,1,3,89191,89193,89196,2,5,0
25486,1,3,89192,89196,89199,4,7,0
25487,3,1,89195,89199,89200,4,5,0
25488,4,2,89199,89200,89202,1,3,0
25489,1,1,89200,89202,89203,2,3,0
25490,6,2,89206,89206,89208,0,2,3
25491,2,2,89208,89208,89210,0,2,0
25492,5,2,89213,89213,89215,0,2,3
25493,6,2,89219,89219,89221,0,2,4
25494,2,3,89221,89221,89224,0,3,0
25495,3,2,89224,89224,89226,0,2,0
25496,1,3,89225,89226,89229,1,4,0
25497,1,1,89226,89229,89230,3,4,0
25498,4,3,89230,89230,89233,0,3,0
25499,6,2,89236,89236,89238,0,2,3
25500,4,3,89240,89240,89243,0,3,2
25501,1,2,89241,89243,89245,2,4,0
25502,2,1,89243,89245,89246,2,3,0
25503,3,2,89246,89246,89248,0,2,0
25504,3,2,89249,89249,89251,0,2,1
25505,4,1,89253,89253,89254,0,1,2
25506,2,3,89255,89255,89258,0,3,1
25507,2,3,89257,89258,89261,1,4,0
25508,6,1,89263,89263,89264,0,1,2
25509,5,3,89268,89268,89271,0,3,4
25510,2,3,89270,89271,89274,1,4,0
25511,1,2,89271,89274,89276,3,5,0
25512,5,1,89276,89276,89277,0,1,0
25513,3,2,89279,89279,89281,0,2,2
25514,5,1,89284,89284,89285,0,1,3
25515,1,3,89285,89285,89288,0,3,0
25516,4,3,89289,89289,89292,0,3,1
25517,6,3,89295,89295,89298,0,3,3
25518,2,3,89297,89298,89301,1,4,0
25519,4,1,89301,89301,89302,0,1,0
25520,3,1,89304,89304,89305,0,1,2
25521,6,1,89310,89310,89311,0,1,5
25522,6,3,89316,89316,89319,0,3,5
25523,6,2,89322,89322,89324,0,2,3
25524,2,3,89324,89324,89327,0,3,0
25525,2,1,89326,89327,89328,1,2,0
25526,3,2,89329,89329,89331,0,2,1
25527,5,3,89334,89334,89337,0,3,3
25528,4,1,89338,89338,89339,0,1,1
25529,4,1,89342,89342,89343,0,1,3
25530,4,3,89346,89346,89349,0,3,3
25531,3,3,89349,89349,89352,0,3,0
25532,4,2,89353,89353,89355,0,2,1
25533,6,2,89359,89359,89361,0,2,4
25534,5,3,89364,89364,89367,0,3,3
25535,3,3,89367,89367,89370,0,3,0
25536,4,2,89371,89371,89373,0,2,1
25537,4,1,89375,89375,89376,0,1,2
25538,6,3,89381,89381,89384,0,3,5
25539,4,3,89385,89385,89388,0,3,1
25540,3,2,89388,89388,89390,0,2,0
25541,2,1,89390,89390,89391,0,1,0
25542,4,1,89394,89394,89395,0,1,3
25543,4,3,89398,89398,89401,0,3,3
25544,3,3,89401,89401,89404,0,3,0
25545,4,3,89405,89405,89408,0,3,1
25546,2,3,89407,89408,89411,1,4,0
25547,6,3,89413,89413,89416,0,3,2
25548,6,2,89419,89419,89421,0,2,3
25549,1,3,89420,89421,89424,1,4,0
25550,2,3,89422,89424,89427,2,5,0
25551,6,2,89428,89428,89430,0,2,1
25552,3,2,89431,89431,89433,0,2,1
25553,6,2,89437,89437,89439,0,2,4
25554,5,3,89442,89442,89445,0,3,3
25555,5,3,89447,89447,89450,0,3,2
25556,5,3,89452,89452,89455,0,3,2
25557,4,1,89456,89456,89457,0,1,1
25558,3,3,89459,89459,89462,0,3,2
25559,1,2,89460,89462,89464,2,4,0
25560,3,1,89463,89464,89465,1,2,0
25561,4,1,89467,89467,89468,0,1,2
25562,5,3,89472,89472,89475,0,3,4
25563,4,1,89476,89476,89477,0,1,1
25564,6,1,89482,89482,89483,0,1,5
25565,6,1,89488,89488,89489,0,1,5
25566,4,1,89492,89492,89493,0,1,3
25567,3,2,89495,89495,89497,0,2,2
25568,5,2,89500,89500,89502,0,2,3
25569,3,1,89503,89503,89504,0,1,1
25570,1,2,89504,89504,89506,0,2,0
25571,5,3,89509,89509,89512,0,3,3
25572,3,3,89512,89512,89515,0,3,0
25573,4,2,89516,89516,89518,0,2,1
25574,1,2,89517,89518,89520,1,3,0
25575,1,1,89518,89520,89521,2,3,0
25576,1,2,89519,89521,89523,2,4,0
25577,3,1,89522,89523,89524,1,2,0
25578,2,3,89524,89524,89527,0,3,0
25579,5,1,89529,89529,89530,0,1,2
25580,3,3,89532,89532,89535,0,3,2
25581,4,3,89536,89536,89539,0,3,1
25582,6,1,89542,89542,89543,0,1,3
25583,2,1,89544,89544,89545,0,1,1
25584,4,1,89548,89548,89549,0,1,3
25585,1,3,89549,89549,89552,0,3,0
25586,5,1,89554,89554,89555,0,1,2
25587,5,1,89559,89559,89560,0,1,4
25588,6,2,89565,89565,89567,0,2,5
25589,2,2,89567,89567,89569,0,2,0
25590,4,2,89571,89571,89573,0,2,2
25591,3,2,89574,89574,89576,0,2,1
25592,4,1,89578,89578,89579,0,1,2
25593,5,2,89583,89583,89585,0,2,4
25594,1,1,89584,89585,89586,1,2,0
25595,5,1,89589,89589,89590,0,1,3
25596,5,3,89594,89594,89597,0,3,4
25597,3,1,89597,89597,89598,0,1,0
25598,6,3,89603,89603,89606,0,3,5
25599,1,3,89604,89606,89609,2,5,0
25600,5,3,89609,89609,89612,0,3,0
25601,3,2,89612,89612,89614,0,2,0
25602,4,1,89616,89616,89617,0,1,2
25603,5,2,89621,89621,89623,0,2,4
25604,3,1,89624,89624,89625,0,1,1
25605,1,3,89625,89625,89628,0,3,0
25606,4,3,89629,89629,89632,0,3,1
25607,1,1,89630,89632,89633,2,3,0
25608,4,2,89634,89634,89636,0,2,1
25609,3,1,89637,89637,89638,0,1,1
25610,5,2,89642,89642,89644,0,2,4
25611,5,1,89647,89647,89648,0,1,3
25612,6,3,89653,89653,89656,0,3,5
25613,2,1,89655,89656,89657,1,2,0
25614,6,2,89661,89661,89663,0,2,4
25615,2,3,89663,89663,89666,0,3,0
25616,3,2,89666,89666,89668,0,2,0
25617,3,3,89669,89669,89672,0,3,1
25618,3,2,89672,89672,89674,0,2,0
25619,3,1,89675,89675,89676,0,1,1
25620,4,1,89679,89679,89680,0,1,3
25621,4,3,89683,89683,89686,0,3,3
25622,6,2,89689,89689,89691,0,2,3
25623,1,1,89690,89691,89692,1,2,0
25624,2,2,89692,89692,89694,0,2,0
25625,4,3,89696,89696,89699,0,3,2
25626,1,3,89697,89699,89702,2,5,0
25627,1,2,89698,89702,89704,4,6,0
25628,1,3,89699,89704,89707,5,8,0
25629,5,3,89704,89707,89710,3,6,0
25630,5,1,89709,89710,89711,1,2,0
25631,2,2,89711,89711,89713,0,2,0
25632,5,2,89716,89716,89718,0,2,3
25633,4,1,89720,89720,89721,0,1,2
25634,3,2,89723,89723,89725,0,2,2
25635,1,3,89724,89725,89728,1,4,0
25636,3,2,89727,89728,89730,1,3,0
25637,5,1,89732,89732,89733,0,1,2
25638,4,1,89736,89736,89737,0,1,3
25639,1,1,89737,89737,89738,0,1,0
25640,5,3,89742,89742,89745,0,3,4
25641,6,2,89748,89748,89750,0,2,3
25642,5,1,89753,89753,89754,0,1,3
25643,6,3,89759,89759,89762,0,3,5
25644,1,1,89760,89762,89763,2,3,0
25645,4,3,89764,89764,89767,0,3,1
25646,1,1,89765,89767,89768,2,3,0
25647,6,1,89771,89771,89772,0,1,3
25648,5,1,89776,89776,89777,0,1,4
25649,5,1,89781,89781,89782,0,1,4
25650,6,3,89787,89787,89790,0,3,5
25651,1,1,89788,89790,89791,2,3,0
25652,1,2,89789,89791,89793,2,4,0
25653,6,3,89795,89795,89798,0,3,2
25654,4,3,89799,89799,89802,0,3,1
25655,4,2,89803,89803,89805,0,2,1
25656,6,1,89809,89809,89810,0,1,4
25657,3,3,89812,89812,89815,0,3,2
25658,1,2,89813,89815,89817,2,4,0
25659,6,3,89819,89819,89822,0,3,2
25660,2,2,89821,89822,89824,1,3,0
25661,5,1,89826,89826,89827,0,1,2
25662,2,1,89828,89828,89829,0,1,1
25663,6,1,89834,89834,89835,0,1,5
25664,5,3,89839,89839,89842,0,3,4
25665,6,1,89845,89845,89846,0,1,3
25666,5,3,89850,89850,89853,0,3,4
25667,3,1,89853,89853,89854,0,1,0
25668,1,1,89854,89854,89855,0,1,0
25669,6,2,89860,89860,89862,0,2,5
25670,5,1,89865,89865,89866,0,1,3
25671,4,2,89869,89869,89871,0,2,3
25672,6,2,89875,89875,89877,0,2,4
25673,1,2,89876,89877,89879,1,3,0
25674,1,2,89877,89879,89881,2,4,0
25675,3,3,89880,89881,89884,1,4,0
25676,3,3,89883,89884,89887,1,4,0
25677,3,1,89886,89887,89888,1,2,0
25678,6,1,89892,89892,89893,0,1,4
25679,5,3,89897,89897,89900,0,3,4
25680,4,3,89901,89901,89904,0,3,1
25681,2,1,89903,89904,89905,1,2,0
25682,4,3,89907,89907,89910,0,3,2
25683,6,1,89913,89913,89914,0,1,3
25684,5,1,89918,89918,89919,0,1,4
25685,2,1,89920,89920,89921,0,1,1
25686,2,1,89922,89922,89923,0,1,1
25687,1,3,89923,89923,89926,0,3,0
25688,4,1,89927,89927,89928,0,1,1
25689,1,1,89928,89928,89929,0,1,0
25690,2,1,89930,89930,89931,0,1,1
25691,4,2,89934,89934,89936,0,2,3
25692,1,3,89935,89936,89939,1,4,0
25693,3,3,89938,89939,89942,1,4,0
25694,5,3,89943,89943,89946,0,3,1
25695,5,2,89948,89948,89950,0,2,2
25696,5,1,89953,89953,89954,0,1,3
25697,6,1,89959,89959,89960,0,1,5
25698,4,1,89963,89963,89964,0,1,3
25699,4,2,89967,89967,89969,0,2,3
25700,3,3,89970,89970,89973,0,3,1
25701,6,3,89976,89976,89979,0,3,3
25702,5,2,89981,89981,89983,0,2,2
25703,5,1,89986,89986,89987,0,1,3
25704,3,3,89989,89989,89992,0,3,2
25705,1,1,89990,89992,89993,2,3,0
25706,3,2,89993,89993,89995,0,2,0
25707,1,1,89994,89995,89996,1,2,0
25708,2,2,89996,89996,89998,0,2,0
25709,3,1,89999,89999,90000,0,1,1
25710,3,1,90002,90002,90003,0,1,2
25711,2,2,90004,90004,90006,0,2,1
25712,5,3,90009,90009,90012,0,3,3
25713,5,1,90014,90014,90015,0,1,2
25714,4,3,90018,90018,90021,0,3,3
25715,4,3,90022,90022,90025,0,3,1
25716,2,2,90024,90025,90027,1,3,0
25717,4,2,90028,90028,90030,0,2,1
25718,5,1,90033,90033,90034,0,1,3
25719,5,3,90038,90038,90041,0,3,4
25720,6,2,90044,90044,90046,0,2,3
25721,6,2,90050,90050,90052,0,2,4
25722,2,1,90052,90052,90053,0,1,0
25723,6,3,90058,90058,90061,0,3,5
25724,1,3,90059,90061,90064,2,5,0
25725,3,1,90062,90064,90065,2,3,0
25726,6,3,90068,90068,90071,0,3,3
25727,1,2,90069,90071,90073,2,4,0
25728,6,3,90075,90075,90078,0,3,2
25729,1,2,90076,90078,90080,2,4,0
25730,5,3,90081,90081,90084,0,3,1
25731,6,1,90087,90087,90088,0,1,3
25732,1,1,90088,90088,90089,0,1,0
25733,6,2,90094,90094,90096,0,2,5
25734,6,3,90100,90100,90103,0,3,4
25735,6,1,90106,90106,90107,0,1,3
25736,3,1,90109,90109,90110,0,1,2
25737,5,3,90114,90114,90117,0,3,4
25738,3,3,90117,90117,90120,0,3,0
25739,2,2,90119,90120,90122,1,3,0
25740,6,2,90125,90125,90127,0,2,3
25741,1,2,90126,90127,90129,1,3,0
25742,2,2,90128,90129,90131,1,3,0
25743,5,3,90133,90133,90136,0,3,2
25744,4,1,90137,90137,90138,0,1,1
25745,2,1,90139,90139,90140,0,1,1
25746,4,1,90143,90143,90144,0,1,3
25747,6,1,90149,90149,90150,0,1,5
25748,1,2,90150,90150,90152,0,2,0
25749,4,3,90154,90154,90157,0,3,2
25750,4,1,90158,90158,90159,0,1,1
25751,5,3,90163,90163,90166,0,3,4
25752,5,2,90168,90168,90170,0,2,2
25753,1,1,90169,90170,90171,1,2,0
25754,4,1,90173,90173,90174,0,1,2
25755,5,2,90178,90178,90180,0,2,4
25756,5,3,90183,90183,90186,0,3,3
25757,5,3,90188,90188,90191,0,3,2
25758,1,1,90189,90191,90192,2,3,0
25759,1,2,90190,90192,90194,2,4,0
25760,5,2,90195,90195,90197,0,2,1
25761,5,1,90200,90200,90201,0,1,3
25762,1,2,90201,90201,90203,0,2,0
25763,2,3,90203,90203,90206,0,3,0
25764,2,2,90205,90206,90208,1,3,0
25765,3,2,90208,90208,90210,0,2,0
25766,4,3,90212,90212,90215,0,3,2
25767,3,2,90215,90215,90217,0,2,0
25768,6,1,90221,90221,90222,0,1,4
25769,1,3,90222,90222,90225,0,3,0
25770,4,2,90226,90226,90228,0,2,1
25771,3,1,90229,90229,90230,0,1,1
25772,2,3,90231,90231,90234,0,3,1
25773,6,1,90237,90237,90238,0,1,3
25774,6,3,90243,90243,90246,0,3,5
25775,4,3,90247,90247,90250,0,3,1
25776,6,3,90253,90253,90256,0,3,3
25777,4,2,90257,90257,90259,0,2,1
25778,6,3,90263,90263,90266,0,3,4
25779,2,3,90265,90266,90269,1,4,0
25780,5,3,90270,90270,90273,0,3,1
25781,2,3,90272,90273,90276,1,4,0
25782,6,2,90278,90278,90280,0,2,2
25783,2,3,90280,90280,90283,0,3,0
25784,1,3,90281,90283,90286,2,5,0
25785,3,1,90284,90286,90287,2,3,0
25786,3,2,90287,90287,90289,0,2,0
25787,2,1,90289,90289,90290,0,1,0
25788,1,1,90290,90290,90291,0,1,0
25789,5,1,90295,90295,90296,0,1,4
25790,5,1,90300,90300,90301,0,1,4
25791,6,2,90306,90306,90308,0,2,5
25792,4,2,90310,90310,90312,0,2,2
25793,5,3,90315,90315,90318,0,3,3
25794,3,2,90318,90318,90320,0,2,0
25795,1,3,90319,90320,90323,1,4,0
25796,1,2,90320,90323,90325,3,5,0
25797,6,3,90326,90326,90329,0,3,1
25798,3,1,90329,90329,90330,0,1,0
25799,2,1,90331,90331,90332,0,1,1
25800,4,1,90335,90335,90336,0,1,3
25801,5,3,90340,90340,90343,0,3,4
25802,2,1,90342,90343,90344,1,2,0
25803,2,1,90344,90344,90345,0,1,0
25804,4,2,90348,90348,90350,0,2,3
25805,4,2,90352,90352,90354,0,2,2
25806,2,2,90354,90354,90356,0,2,0
25807,6,2,90360,90360,90362,0,2,4
25808,4,3,90364,90364,90367,0,3,2
25809,5,3,90369,90369,90372,0,3,2
25810,4,2,90373,90373,90375,0,2,1
25811,1,3,90374,90375,90378,1,4,0
25812,4,3,90378,90378,90381,0,3,0
25813,1,3,90379,90381,90384,2,5,0
25814,5,3,90384,90384,90387,0,3,0
25815,5,1,90389,90389,90390,0,1,2
25816,2,1,90391,90391,90392,0,1,1
25817,4,1,90395,90395,90396,0,1,3
25818,1,2,90396,90396,90398,0,2,0
25819,5,2,90401,90401,90403,0,2,3
25820,5,2,90406,90406,90408,0,2,3
25821,6,1,90412,90412,90413,0,1,4
25822,1,2,90413,90413,90415,0,2,0
25823,6,3,90419,90419,90422,0,3,4
25824,6,1,90425,90425,90426,0,1,3
25825,5,3,90430,90430,90433,0,3,4
25826,5,1,90435,90435,90436,0,1,2
25827,4,2,90439,90439,90441,0,2,3
25828,3,1,90442,90442,90443,0,1,1
25829,3,1,90445,90445,90446,0,1,2
25830,3,2,90448,90448,90450,0,2,2
25831,5,2,90453,90453,90455,0,2,3
25832,2,2,90455,90455,90457,0,2,0
25833,6,1,90461,90461,90462,0,1,4
25834,6,2,90467,90467,90469,0,2,5
25835,2,3,90469,90469,90472,0,3,0
25836,5,2,90474,90474,90476,0,2,2
25837,4,2,90478,90478,90480,0,2,2
25838,3,3,90481,90481,90484,0,3,1
25839,6,1,90487,90487,90488,0,1,3
25840,6,1,90493,90493,90494,0,1,5
25841,6,3,90499,90499,90502,0,3,5
25842,1,1,90500,90502,90503,2,3,0
25843,1,2,90501,90503,90505,2,4,0
25844,2,3,90503,90505,90508,2,5,0
25845,1,3,90504,90508,90511,4,7,0
25846,2,2,90506,90511,90513,5,7,0
25847,1,2,90507,90513,90515,6,8,0
25848,4,2,90511,90515,90517,4,6,0
25849,1,3,90512,90517,90520,5,8,0
25850,3,2,90515,90520,90522,5,7,0
25851,1,3,90516,90522,90525,6,9,0
25852,5,1,90521,90525,90526,4,5,0
25853,1,1,90522,90526,90527,4,5,0
25854,1,2,90523,90527,90529,4,6,0
25855,5,1,90528,90529,90530,1,2,0
25856,3,1,90531,90531,90532,0,1,1
25857,3,2,90534,90534,90536,0,2,2
25858,3,1,90537,90537,90538,0,1,1
25859,6,2,90543,90543,90545,0,2,5
25860,6,1,90549,90549,90550,0,1,4
25861,5,2,90554,90554,90556,0,2,4
25862,6,3,90560,90560,90563,0,3,4
25863,6,1,90566,90566,90567,0,1,3
25864,5,3,90571,90571,90574,0,3,4
25865,5,3,90576,90576,90579,0,3,2
25866,4,2,90580,90580,90582,0,2,1
25867,1,1,90581,90582,90583,1,2,0
25868,1,3,90582,90583,90586,1,4,0
25869,1,2,90583,90586,90588,3,5,0
25870,3,2,90586,90588,90590,2,4,0
25871,4,1,90590,90590,90591,0,1,0
25872,6,2,90596,90596,90598,0,2,5
25873,4,3,90600,90600,90603,0,3,2
25874,3,3,90603,90603,90606,0,3,0
25875,1,3,90604,90606,90609,2,5,0
25876,4,3,90608,90609,90612,1,4,0
25877,5,1,90613,90613,90614,0,1,1
25878,5,1,90618,90618,90619,0,1,4
25879,6,2,90624,90624,90626,0,2,5
25880,1,2,90625,90626,90628,1,3,0
25881,1,1,90626,90628,90629,2,3,0
25882,6,2,90632,90632,90634,0,2,3
25883,4,1,90636,90636,90637,0,1,2
25884,5,1,90641,90641,90642,0,1,4
25885,1,1,90642,90642,90643,0,1,0
25886,2,3,90644,90644,90647,0,3,1
25887,2,2,90646,90647,90649,1,3,0
25888,2,3,90648,90649,90652,1,4,0
25889,2,2,90650,90652,90654,2,4,0
25890,2,3,90652,90654,90657,2,5,0
25891,1,1,90653,90657,90658,4,5,0
25892,3,1,90656,90658,90659,2,3,0
25893,6,1,90662,90662,90663,0,1,3
25894,2,1,90664,90664,90665,0,1,1
25895,1,1,90665,90665,90666,0,1,0
25896,2,2,90667,90667,90669,0,2,1
25897,4,1,90671,90671,90672,0,1,2
25898,1,3,90672,90672,90675,0,3,0
25899,1,1,90673,90675,90676,2,3,0
25900,1,1,90674,90676,90677,2,3,0
25901,6,1,90680,90680,90681,0,1,3
25902,2,3,90682,90682,90685,0,3,1
25903,1,1,90683,90685,90686,2,3,0
25904,3,2,90686,90686,90688,0,2,0
25905,5,1,90691,90691,90692,0,1,3
25906,3,1,90694,90694,90695,0,1,2
25907,4,3,90698,90698,90701,0,3,3
25908,3,1,90701,90701,90702,0,1,0
25909,1,1,90702,90702,90703,0,1,0
25910,6,2,90708,90708,90710,0,2,5
25911,4,1,90712,90712,90713,0,1,2
25912,6,1,90718,90718,90719,0,1,5
25913,4,2,90722,90722,90724,0,2,3
25914,1,2,90723,90724,90726,1,3,0
25915,5,1,90728,90728,90729,0,1,2
25916,3,1,90731,90731,90732,0,1,2
25917,4,2,90735,90735,90737,0,2,3
25918,6,3,90741,90741,90744,0,3,4
25919,1,3,90742,90744,90747,2,5,0
25920,5,3,90747,90747,90750,0,3,0
25921,3,1,90750,90750,90751,0,1,0
25922,4,3,90754,90754,90757,0,3,3
25923,6,3,90760,90760,90763,0,3,3
25924,1,3,90761,90763,90766,2,5,0
25925,4,1,90765,90766,90767,1,2,0
25926,4,2,90769,90769,90771,0,2,2
25927,1,1,90770,90771,90772,1,2,0
25928,3,3,90773,90773,90776,0,3,1
25929,1,2,90774,90776,90778,2,4,0
25930,5,1,90779,90779,90780,0,1,1
25931,3,2,90782,90782,90784,0,2,2
25932,3,1,90785,90785,90786,0,1,1
25933,2,1,90787,90787,90788,0,1,1
25934,3,1,90790,90790,90791,0,1,2
25935,2,1,90792,90792,90793,0,1,1
25936,1,2,90793,90793,90795,0,2,0
25937,2,3,90795,90795,90798,0,3,0
25938,5,3,90800,90800,90803,0,3,2
25939,3,2,90803,90803,90805,0,2,0
25940,3,2,90806,90806,90808,0,2,1
25941,1,2,90807,90808,90810,1,3,0
25942,5,3,90812,90812,90815,0,3,2
25943,1,1,90813,90815,90816,2,3,0
25944,5,1,90818,90818,90819,0,1,2
25945,6,1,90824,90824,90825,0,1,5
25946,4,1,90828,90828,90829,0,1,3
25947,3,3,90831,90831,90834,0,3,2
25948,3,3,90834,90834,90837,0,3,0
25949,3,1,90837,90837,90838,0,1,0
25950,2,2,90839,90839,90841,0,2,1
25951,6,2,90845,90845,90847,0,2,4
25952,1,3,90846,90847,90850,1,4,0
25953,5,2,90851,90851,90853,0,2,1
25954,6,2,90857,90857,90859,0,2,4
25955,6,1,90863,90863,90864,0,1,4
25956,4,2,90867,90867,90869,0,2,3
25957,5,3,90872,90872,90875,0,3,3
25958,3,2,90875,90875,90877,0,2,0
25959,3,2,90878,90878,90880,0,2,1
25960,4,2,90882,90882,90884,0,2,2
25961,3,2,90885,90885,90887,0,2,1
25962,6,3,90891,90891,90894,0,3,4
25963,1,2,90892,90894,90896,2,4,0
25964,6,3,90898,90898,90901,0,3,2
25965,5,1,90903,90903,90904,0,1,2
25966,1,2,90904,90904,90906,0,2,0
25967,1,2,90905,90906,90908,1,3,0
25968,1,3,90906,90908,90911,2,5,0
25969,1,2,90907,90911,90913,4,6,0
25970,6,2,90913,90913,90915,0,2,0
25971,1,3,90914,90915,90918,1,4,0
25972,5,3,90919,90919,90922,0,3,1
25973,4,3,90923,90923,90926,0,3,1
25974,6,2,90929,90929,90931,0,2,3
25975,6,3,90935,90935,90938,0,3,4
25976,3,2,90938,90938,90940,0,2,0
25977,4,1,90942,90942,90943,0,1,2
25978,1,3,90943,90943,90946,0,3,0
25979,4,2,90947,90947,90949,0,2,1
25980,1,1,90948,90949,90950,1,2,0
25981,3,2,90951,90951,90953,0,2,1
25982,4,2,90955,90955,90957,0,2,2
25983,5,2,90960,90960,90962,0,2,3
25984,6,2,90966,90966,90968,0,2,4
25985,1,3,90967,90968,90971,1,4,0
25986,4,2,90971,90971,90973,0,2,0
25987,2,1,90973,90973,90974,0,1,0
25988,3,3,90976,90976,90979,0,3,2
25989,5,2,90981,90981,90983,0,2,2
25990,4,2,90985,90985,90987,0,2,2
25991,2,3,90987,90987,90990,0,3,0
25992,5,1,90992,90992,90993,0,1,2
25993,3,2,90995,90995,90997,0,2,2
25994,4,3,90999,90999,91002,0,3,2
25995,5,1,91004,91004,91005,0,1,2
25996,5,3,91009,91009,91012,0,3,4
25997,6,1,91015,91015,91016,0,1,3
25998,1,3,91016,91016,91019,0,3,0
25999,5,3,91021,91021,91024,0,3,2
26000,3,1,91024,91024,91025,0,1,0
26001,6,2,91030,91030,91032,0,2,5
26002,2,2,91032,91032,91034,0,2,0
26003,3,2,91035,91035,91037,0,2,1
26004,3,2,91038,91038,91040,0,2,1
26005,5,3,91043,91043,91046,0,3,3
26006,5,3,91048,91048,91051,0,3,2
26007,3,2,91051,91051,91053,0,2,0
26008,3,2,91054,91054,91056,0,2,1
26009,6,3,91060,91060,91063,0,3,4
26010,2,1,91062,91063,91064,1,2,0
26011,2,1,91064,91064,91065,0,1,0
26012,1,2,91065,91065,91067,0,2,0
26013,2,2,91067,91067,91069,0,2,0
26014,1,1,91068,91069,91070,1,2,0
26015,4,3,91072,91072,91075,0,3,2
26016,4,1,91076,91076,91077,0,1,1
26017,3,3,91079,91079,91082,0,3,2
26018,3,2,91082,91082,91084,0,2,0
26019,4,1,91086,91086,91087,0,1,2
26020,6,1,91092,91092,91093,0,1,5
26021,6,2,91098,91098,91100,0,2,5
26022,5,2,91103,91103,91105,0,2,3
26023,2,1,91105,91105,91106,0,1,0
26024,3,2,91108,91108,91110,0,2,2
26025,1,1,91109,91110,91111,1,2,0
26026,5,1,91114,91114,91115,0,1,3
26027,2,3,91116,91116,91119,0,3,1
26028,1,3,91117,91119,91122,2,5,0
26029,3,3,91120,91122,91125,2,5,0
26030,3,3,91123,91125,91128,2,5,0
26031,4,1,91127,91128,91129,1,2,0
26032,4,1,91131,91131,91132,0,1,2
26033,1,3,91132,91132,91135,0,3,0
26034,1,3,91133,91135,91138,2,5,0
26035,3,2,91136,91138,91140,2,4,0
26036,1,3,91137,91140,91143,3,6,0
26037,1,3,91138,91143,91146,5,8,0
26038,2,3,91140,91146,91149,6,9,0
26039,4,1,91144,91149,91150,5,6,0
26040,2,3,91146,91150,91153,4,7,0
26041,5,3,91151,91153,91156,2,5,0
26042,6,1,91157,91157,91158,0,1,1
26043,1,3,91158,91158,91161,0,3,0
26044,5,3,91163,91163,91166,0,3,2
26045,6,1,91169,91169,91170,0,1,3
26046,2,2,91171,91171,91173,0,2,1
26047,4,2,91175,91175,91177,0,2,2
26048,4,1,91179,91179,91180,0,1,2
26049,5,1,91184,91184,91185,0,1,4
26050,6,1,91190,91190,91191,0,1,5
26051,4,3,91194,91194,91197,0,3,3
26052,6,2,91200,91200,91202,0,2,3
26053,1,1,91201,91202,91203,1,2,0
26054,4,3,91205,91205,91208,0,3,2
26055,5,3,91210,91210,91213,0,3,2
26056,1,2,91211,91213,91215,2,4,0
26057,5,1,91216,91216,91217,0,1,1
26058,2,3,91218,91218,91221,0,3,1
26059,6,1,91224,91224,91225,0,1,3
26060,6,1,91230,91230,91231,0,1,5
26061,2,1,91232,91232,91233,0,1,1
26062,1,3,91233,91233,91236,0,3,0
26063,1,3,91234,91236,91239,2,5,0
26064,3,1,91237,91239,91240,2,3,0
26065,4,1,91241,91241,91242,0,1,1
26066,3,2,91244,91244,91246,0,2,2
26067,1,1,91245,91246,91247,1,2,0
26068,3,1,91248,91248,91249,0,1,1
26069,2,2,91250,91250,91252,0,2,1
26070,5,2,91255,91255,91257,0,2,3
26071,4,2,91259,91259,91261,0,2,2
26072,3,1,91262,91262,91263,0,1,1
26073,3,3,91265,91265,91268,0,3,2
26074,2,3,91267,91268,91271,1,4,0
26075,5,1,91272,91272,91273,0,1,1
26076,2,2,91274,91274,91276,0,2,1
26077,5,3,91279,91279,91282,0,3,3
26078,3,2,91282,91282,91284,0,2,0
26079,5,2,91287,91287,91289,0,2,3
26080,2,3,91289,91289,91292,0,3,0
26081,2,3,91291,91292,91295,1,4,0
26082,4,3,91295,91295,91298,0,3,0
26083,2,2,91297,91298,91300,1,3,0
26084,5,3,91302,91302,91305,0,3,2
26085,6,3,91308,91308,91311,0,3,3
26086,2,3,91310,91311,91314,1,4,0
26087,5,3,91315,91315,91318,0,3,1
26088,3,2,91318,91318,91320,0,2,0
26089,5,3,91323,91323,91326,0,3,3
26090,6,3,91329,91329,91332,0,3,3
26091,6,2,91335,91335,91337,0,2,3
26092,6,1,91341,91341,91342,0,1,4
26093,5,3,91346,91346,91349,0,3,4
26094,1,3,91347,91349,91352,2,5,0
26095,2,2,91349,91352,91354,3,5,0
26096,5,2,91354,91354,91356,0,2,0
26097,4,1,91358,91358,91359,0,1,2
26098,3,2,91361,91361,91363,0,2,2
26099,3,1,91364,91364,91365,0,1,1
26100,1,1,91365,91365,91366,0,1,0
26101,2,3,91367,91367,91370,0,3,1
26102,4,3,91371,91371,91374,0,3,1
26103,6,1,91377,91377,91378,0,1,3
26104,4,1,91381,91381,91382,0,1,3
26105,2,2,91383,91383,91385,0,2,1
26106,2,2,91385,91385,91387,0,2,0
26107,3,3,91388,91388,91391,0,3,1
26108,1,3,91389,91391,91394,2,5,0
26109,3,3,91392,91394,91397,2,5,0
26110,4,3,91396,91397,91400,1,4,0
26111,5,2,91401,91401,91403,0,2,1
26112,4,2,91405,91405,91407,0,2,2
26113,4,1,91409,91409,91410,0,1,2
26114,5,2,91414,91414,91416,0,2,4
26115,3,2,91417,91417,91419,0,2,1
26116,2,1,91419,91419,91420,0,1,0
26117,6,3,91425,91425,91428,0,3,5
26118,1,1,91426,91428,91429,2,3,0
26119,5,3,91431,91431,91434,0,3,2
26120,2,3,91433,91434,91437,1,4,0
26121,2,2,91435,91437,91439,2,4,0
26122,1,3,91436,91439,91442,3,6,0
26123,1,2,91437,91442,91444,5,7,0
26124,2,2,91439,91444,91446,5,7,0
26125,4,1,91443,91446,91447,3,4,0
26126,5,1,91448,91448,91449,0,1,1
26127,1,3,91449,91449,91452,0,3,0
26128,3,3,91452,91452,91455,0,3,0
26129,2,3,91454,91455,91458,1,4,0
26130,2,2,91456,91458,91460,2,4,0
26131,3,1,91459,91460,91461,1,2,0
26132,1,1,91460,91461,91462,1,2,0
26133,1,2,91461,91462,91464,1,3,0
26134,2,1,91463,91464,91465,1,2,0
26135,6,2,91469,91469,91471,0,2,4
26136,4,3,91473,91473,91476,0,3,2
26137,3,2,91476,91476,91478,0,2,0
26138,6,1,91482,91482,91483,0,1,4
26139,4,2,91486,91486,91488,0,2,3
26140,1,3,91487,91488,91491,1,4,0
26141,6,1,91493,91493,91494,0,1,2
26142,6,1,91499,91499,91500,0,1,5
26143,4,2,91503,91503,91505,0,2,3
26144,3,3,91506,91506,91509,0,3,1
26145,5,1,91511,91511,91512,0,1,2
26146,3,3,91514,91514,91517,0,3,2
26147,5,3,91519,91519,91522,0,3,2
26148,5,1,91524,91524,91525,0,1,2
26149,3,3,91527,91527,91530,0,3,2
26150,3,2,91530,91530,91532,0,2,0
26151,4,1,91534,91534,91535,0,1,2
26152,6,1,91540,91540,91541,0,1,5
26153,4,3,91544,91544,91547,0,3,3
26154,5,1,91549,91549,91550,0,1,2
26155,3,1,91552,91552,91553,0,1,2
26156,1,1,91553,91553,91554,0,1,0
26157,3,1,91556,91556,91557,0,1,2
26158,1,3,91557,91557,91560,0,3,0
26159,5,2,91562,91562,91564,0,2,2
26160,5,1,91567,91567,91568,0,1,3
26161,6,2,91573,91573,91575,0,2,5
26162,2,3,91575,91575,91578,0,3,0
26163,6,1,91581,91581,91582,0,1,3
26164,1,2,91582,91582,91584,0,2,0
26165,4,1,91586,91586,91587,0,1,2
26166,6,3,91592,91592,91595,0,3,5
26167,5,1,91597,91597,91598,0,1,2
26168,5,1,91602,91602,91603,0,1,4
26169,6,3,91608,91608,91611,0,3,5
26170,2,2,91610,91611,91613,1,3,0
26171,1,1,91611,91613,91614,2,3,0
26172,4,3,91615,91615,91618,0,3,1
26173,2,1,91617,91618,91619,1,2,0
26174,3,2,91620,91620,91622,0,2,1
26175,1,2,91621,91622,91624,1,3,0
26176,6,2,91627,91627,91629,0,2,3
26177,1,2,91628,91629,91631,1,3,0
26178,3,3,91631,91631,91634,0,3,0
26179,4,3,91635,91635,91638,0,3,1
26180,6,2,91641,91641,91643,0,2,3
26181,1,1,91642,91643,91644,1,2,0
26182,3,2,91645,91645,91647,0,2,1
26183,2,1,91647,91647,91648,0,1,0
26184,1,2,91648,91648,91650,0,2,0
26185,4,1,91652,91652,91653,0,1,2
26186,2,3,91654,91654,91657,0,3,1
26187,1,1,91655,91657,91658,2,3,0
26188,1,3,91656,91658,91661,2,5,0
26189,2,1,91658,91661,91662,3,4,0
26190,5,1,91663,91663,91664,0,1,1
26191,6,2,91669,91669,91671,0,2,5
26192,5,2,91674,91674,91676,0,2,3
26193,4,3,91678,91678,91681,0,3,2
26194,6,2,91684,91684,91686,0,2,3
26195,2,1,91686,91686,91687,0,1,0
26196,4,1,91690,91690,91691,0,1,3
26197,4,2,91694,91694,91696,0,2,3
26198,4,1,91698,91698,91699,0,1,2
26199,1,3,91699,91699,91702,0,3,0
26200,1,1,91700,91702,91703,2,3,0
26201,3,2,91703,91703,91705,0,2,0
26202,4,3,91707,91707,91710,0,3,2
26203,1,2,91708,91710,91712,2,4,0
26204,3,1,91711,91712,91713,1,2,0
26205,1,1,91712,91713,91714,1,2,0
26206,3,1,91715,91715,91716,0,1,1
26207,6,2,91721,91721,91723,0,2,5
26208,5,1,91726,91726,91727,0,1,3
26209,4,3,91730,91730,91733,0,3,3
26210,1,2,91731,91733,91735,2,4,0
26211,4,2,91735,91735,91737,0,2,0
26212,3,2,91738,91738,91740,0,2,1
26213,2,2,91740,91740,91742,0,2,0
26214,2,2,91742,91742,91744,0,2,0
26215,5,3,91747,91747,91750,0,3,3
26216,3,2,91750,91750,91752,0,2,0
26217,1,1,91751,91752,91753,1,2,0
26218,6,2,91757,91757,91759,0,2,4
26219,2,2,91759,91759,91761,0,2,0
26220,4,1,91763,91763,91764,0,1,2
26221,2,3,91765,91765,91768,0,3,1
26222,2,2,91767,91768,91770,1,3,0
26223,1,2,91768,91770,91772,2,4,0
26224,3,3,91771,91772,91775,1,4,0
26225,2,2,91773,91775,91777,2,4,0
26226,2,1,91775,91777,91778,2,3,0
26227,6,3,91781,91781,91784,0,3,3
26228,3,3,91784,91784,91787,0,3,0
26229,5,2,91789,91789,91791,0,2,2
26230,2,3,91791,91791,91794,0,3,0
26231,2,3,91793,91794,91797,1,4,0
26232,5,3,91798,91798,91801,0,3,1
26233,6,2,91804,91804,91806,0,2,3
26234,2,1,91806,91806,91807,0,1,0
26235,2,1,91808,91808,91809,0,1,1
26236,4,2,91812,91812,91814,0,2,3
26237,3,1,91815,91815,91816,0,1,1
26238,6,3,91821,91821,91824,0,3,5
26239,2,2,91823,91824,91826,1,3,0
26240,1,1,91824,91826,91827,2,3,0
26241,6,3,91830,91830,91833,0,3,3
26242,2,3,91832,91833,91836,1,4,0
26243,6,1,91838,91838,91839,0,1,2
26244,5,2,91843,91843,91845,0,2,4
26245,4,1,91847,91847,91848,0,1,2
26246,3,3,91850,91850,91853,0,3,2
26247,1,2,91851,91853,91855,2,4,0
26248,4,3,91855,91855,91858,0,3,0
26249,3,1,91858,91858,91859,0,1,0
26250,1,3,91859,91859,91862,0,3,0
26251,5,2,91864,91864,91866,0,2,2
26252,1,1,91865,91866,91867,1,2,0
26253,4,2,91869,91869,91871,0,2,2
26254,3,2,91872,91872,91874,0,2,1
26255,2,2,91874,91874,91876,0,2,0
26256,2,1,91876,91876,91877,0,1,0
26257,3,1,91879,91879,91880,0,1,2
26258,1,1,91880,91880,91881,0,1,0
26259,3,1,91883,91883,91884,0,1,2
26260,1,1,91884,91884,91885,0,1,0
26261,6,3,91890,91890,91893,0,3,5
26262,2,3,91892,91893,91896,1,4,0
26263,5,2,91897,91897,91899,0,2,1
26264,5,2,91902,91902,91904,0,2,3
26265,6,2,91908,91908,91910,0,2,4
26266,6,2,91914,91914,91916,0,2,4
26267,5,2,91919,91919,91921,0,2,3
26268,1,2,91920,91921,91923,1,3,0
26269,4,3,91924,91924,91927,0,3,1
26270,2,3,91926,91927,91930,1,4,0
26271,3,1,91929,91930,91931,1,2,0
26272,3,3,91932,91932,91935,0,3,1
26273,4,2,91936,91936,91938,0,2,1
26274,2,2,91938,91938,91940,0,2,0
26275,3,1,91941,91941,91942,0,1,1
26276,2,3,91943,91943,91946,0,3,1
26277,2,3,91945,91946,91949,1,4,0
26278,1,1,91946,91949,91950,3,4,0
26279,4,2,91950,91950,91952,0,2,0
26280,1,2,91951,91952,91954,1,3,0
26281,5,1,91956,91956,91957,0,1,2
26282,3,3,91959,91959,91962,0,3,2
26283,2,3,91961,91962,91965,1,4,0
26284,1,3,91962,91965,91968,3,6,0
26285,4,3,91966,91968,91971,2,5,0
26286,6,2,91972,91972,91974,0,2,1
26287,1,2,91973,91974,91976,1,3,0
26288,1,2,91974,91976,91978,2,4,0
26289,6,3,91980,91980,91983,0,3,2
26290,2,1,91982,91983,91984,1,2,0
26291,3,1,91985,91985,91986,0,1,1
26292,3,2,91988,91988,91990,0,2,2
26293,3,1,91991,91991,91992,0,1,1
26294,6,2,91997,91997,91999,0,2,5
26295,2,2,91999,91999,92001,0,2,0
26296,5,2,92004,92004,92006,0,2,3
26297,4,3,92008,92008,92011,0,3,2
26298,3,2,92011,92011,92013,0,2,0
26299,6,3,92017,92017,92020,0,3,4
26300,5,3,92022,92022,92025,0,3,2
26301,2,2,92024,92025,92027,1,3,0
26302,3,3,92027,92027,92030,0,3,0
26303,5,1,92032,92032,92033,0,1,2
26304,2,1,92034,92034,92035,0,1,1
26305,3,1,92037,92037,92038,0,1,2
26306,1,3,92038,92038,92041,0,3,0
26307,3,3,92041,92041,92044,0,3,0
26308,3,3,92044,92044,92047,0,3,0
26309,2,3,92046,92047,92050,1,4,0
26310,2,2,92048,92050,92052,2,4,0
26311,1,1,92049,92052,92053,3,4,0
26312,3,3,92052,92053,92056,1,4,0
26313,5,2,92057,92057,92059,0,2,1
26314,2,3,92059,92059,92062,0,3,0
26315,3,1,92062,92062,92063,0,1,0
26316,1,3,92063,92063,92066,0,3,0
26317,6,1,92069,92069,92070,0,1,3
26318,1,2,92070,92070,92072,0,2,0
26319,3,3,92073,92073,92076,0,3,1
26320,3,1,92076,92076,92077,0,1,0
26321,1,1,92077,92077,92078,0,1,0
26322,5,3,92082,92082,92085,0,3,4
26323,4,2,92086,92086,92088,0,2,1
26324,5,2,92091,92091,92093,0,2,3
26325,3,2,92094,92094,92096,0,2,1
26326,5,3,92099,92099,92102,0,3,3
26327,3,1,92102,92102,92103,0,1,0
26328,4,2,92106,92106,92108,0,2,3
26329,3,1,92109,92109,92110,0,1,1
26330,6,2,92115,92115,92117,0,2,5
26331,4,2,92119,92119,92121,0,2,2
26332,6,2,92125,92125,92127,0,2,4
26333,1,2,92126,92127,92129,1,3,0
26334,4,3,92130,92130,92133,0,3,1
26335,2,2,92132,92133,92135,1,3,0
26336,1,1,92133,92135,92136,2,3,0
26337,4,3,92137,92137,92140,0,3,1
26338,6,1,92143,92143,92144,0,1,3
26339,4,2,92147,92147,92149,0,2,3
26340,6,3,92153,92153,92156,0,3,4
26341,6,2,92159,92159,92161,0,2,3
26342,6,1,92165,92165,92166,0,1,4
26343,1,3,92166,92166,92169,0,3,0
26344,5,2,92171,92171,92173,0,2,2
26345,2,2,92173,92173,92175,0,2,0
26346,6,2,92179,92179,92181,0,2,4
26347,6,3,92185,92185,92188,0,3,4
26348,2,3,92187,92188,92191,1,4,0
26349,6,3,92193,92193,92196,0,3,2
26350,3,1,92196,92196,92197,0,1,0
26351,5,2,92201,92201,92203,0,2,4
26352,1,2,92202,92203,92205,1,3,0
26353,3,3,92205,92205,92208,0,3,0
26354,6,3,92211,92211,92214,0,3,3
26355,4,3,92215,92215,92218,0,3,1
26356,5,2,92220,92220,92222,0,2,2
26357,3,3,92223,92223,92226,0,3,1
26358,1,3,92224,92226,92229,2,5,0
26359,5,1,92229,92229,92230,0,1,0
26360,4,3,92233,92233,92236,0,3,3
26361,2,3,92235,92236,92239,1,4,0
26362,5,1,92240,92240,92241,0,1,1
26363,5,2,92245,92245,92247,0,2,4
26364,1,2,92246,92247,92249,1,3,0
26365,2,1,92248,92249,92250,1,2,0
26366,1,3,92249,92250,92253,1,4,0
26367,1,1,92250,92253,92254,3,4,0
26368,3,3,92253,92254,92257,1,4,0
26369,1,3,92254,92257,92260,3,6,0
26370,5,2,92259,92260,92262,1,3,0
26371,1,3,92260,92262,92265,2,5,0
26372,4,1,92264,92265,92266,1,2,0
26373,2,1,92266,92266,92267,0,1,0
26374,2,1,92268,92268,92269,0,1,1
26375,5,1,92273,92273,92274,0,1,4
26376,5,3,92278,92278,92281,0,3,4
26377,2,2,92280,92281,92283,1,3,0
26378,1,3,92281,92283,92286,2,5,0
26379,5,3,92286,92286,92289,0,3,0
26380,2,1,92288,92289,92290,1,2,0
26381,4,1,92292,92292,92293,0,1,2
26382,3,1,92295,92295,92296,0,1,2
26383,2,3,92297,92297,92300,0,3,1
26384,5,3,92302,92302,92305,0,3,2
26385,1,2,92303,92305,92307,2,4,0
26386,1,2,92304,92307,92309,3,5,0
26387,6,1,92310,92310,92311,0,1,1
26388,5,3,92315,92315,92318,0,3,4
26389,6,1,92321,92321,92322,0,1,3
26390,5,3,92326,92326,92329,0,3,4
26391,1,1,92327,92329,92330,2,3,0
26392,1,2,92328,92330,92332,2,4,0
26393,3,2,92331,92332,92334,1,3,0
26394,5,3,92336,92336,92339,0,3,2
26395,5,3,92341,92341,92344,0,3,2
26396,5,2,92346,92346,92348,0,2,2
26397,1,3,92347,92348,92351,1,4,0
26398,1,3,92348,92351,92354,3,6,0
26399,4,3,92352,92354,92357,2,5,0
26400,5,2,92357,92357,92359,0,2,0
26401,1,1,92358,92359,92360,1,2,0
26402,6,1,92364,92364,92365,0,1,4
26403,4,2,92368,92368,92370,0,2,3
26404,2,2,92370,92370,92372,0,2,0
26405,6,1,92376,92376,92377,0,1,4
26406,5,2,92381,92381,92383,0,2,4
26407,4,1,92385,92385,92386,0,1,2
26408,5,3,92390,92390,92393,0,3,4
26409,3,1,92393,92393,92394,0,1,0
26410,3,1,92396,92396,92397,0,1,2
26411,5,3,92401,92401,92404,0,3,4
26412,4,1,92405,92405,92406,0,1,1
26413,2,3,92407,92407,92410,0,3,1
26414,4,2,92411,92411,92413,0,2,1
26415,4,3,92415,92415,92418,0,3,2
26416,4,1,92419,92419,92420,0,1,1
26417,2,3,92421,92421,92424,0,3,1
26418,4,3,92425,92425,92428,0,3,1
26419,4,2,92429,92429,92431,0,2,1
26420,1,2,92430,92431,92433,1,3,0
26421,6,3,92436,92436,92439,0,3,3
26422,4,1,92440,92440,92441,0,1,1
26423,1,3,92441,92441,92444,0,3,0
26424,5,3,92446,92446,92449,0,3,2
26425,1,2,92447,92449,92451,2,4,0
26426,1,1,92448,92451,92452,3,4,0
26427,1,3,92449,92452,92455,3,6,0
26428,5,2,92454,92455,92457,1,3,0
26429,6,2,92460,92460,92462,0,2,3
26430,5,2,92465,92465,92467,0,2,3
26431,3,1,92468,92468,92469,0,1,1
26432,4,2,92472,92472,92474,0,2,3
26433,1,2,92473,92474,92476,1,3,0
26434,3,2,92476,92476,92478,0,2,0
26435,2,2,92478,92478,92480,0,2,0
26436,1,1,92479,92480,92481,1,2,0
26437,1,3,92480,92481,92484,1,4,0
26438,1,3,92481,92484,92487,3,6,0
26439,5,2,92486,92487,92489,1,3,0
26440,2,2,92488,92489,92491,1,3,0
26441,3,3,92491,92491,92494,0,3,0
26442,4,3,92495,92495,92498,0,3,1
26443,3,2,92498,92498,92500,0,2,0
26444,3,2,92501,92501,92503,0,2,1
26445,1,1,92502,92503,92504,1,2,0
26446,4,3,92506,92506,92509,0,3,2
26447,2,3,92508,92509,92512,1,4,0
26448,6,2,92514,92514,92516,0,2,2
26449,4,3,92518,92518,92521,0,3,2
26450,1,2,92519,92521,92523,2,4,0
26451,2,3,92521,92523,92526,2,5,0
26452,5,2,92526,92526,92528,0,2,0
26453,1,3,92527,92528,92531,1,4,0
26454,3,3,92530,92531,92534,1,4,0
26455,3,2,92533,92534,92536,1,3,0
26456,1,2,92534,92536,92538,2,4,0
26457,2,2,92536,92538,92540,2,4,0
26458,1,3,92537,92540,92543,3,6,0
26459,6,1,92543,92543,92544,0,1,0
26460,2,1,92545,92545,92546,0,1,1
26461,3,2,92548,92548,92550,0,2,2
26462,3,3,92551,92551,92554,0,3,1
26463,5,1,92556,92556,92557,0,1,2
26464,5,2,92561,92561,92563,0,2,4
26465,5,2,92566,92566,92568,0,2,3
26466,5,1,92571,92571,92572,0,1,3
26467,6,2,92577,92577,92579,0,2,5
26468,3,3,92580,92580,92583,0,3,1
26469,6,2,92586,92586,92588,0,2,3
26470,4,1,92590,92590,92591,0,1,2
26471,6,1,92596,92596,92597,0,1,5
26472,6,3,92602,92602,92605,0,3,5
26473,3,3,92605,92605,92608,0,3,0
26474,3,1,92608,92608,92609,0,1,0
26475,4,2,92612,92612,92614,0,2,3
26476,4,1,92616,92616,92617,0,1,2
26477,2,3,92618,92618,92621,0,3,1
26478,3,1,92621,92621,92622,0,1,0
26479,5,2,92626,92626,92628,0,2,4
26480,6,3,92632,92632,92635,0,3,4
26481,5,1,92637,92637,92638,0,1,2
26482,3,2,92640,92640,92642,0,2,2
26483,4,3,92644,92644,92647,0,3,2
26484,3,1,92647,92647,92648,0,1,0
26485,2,3,92649,92649,92652,0,3,1
26486,6,2,92655,92655,92657,0,2,3
26487,1,2,92656,92657,92659,1,3,0
26488,1,3,92657,92659,92662,2,5,0
26489,1,2,92658,92662,92664,4,6,0
26490,3,3,92661,92664,92667,3,6,0
26491,1,3,92662,92667,92670,5,8,0
26492,6,1,92668,92670,92671,2,3,0
26493,5,3,92673,92673,92676,0,3,2
26494,5,3,92678,92678,92681,0,3,2
26495,4,2,92682,92682,92684,0,2,1
26496,2,3,92684,92684,92687,0,3,0
26497,5,1,92689,92689,92690,0,1,2
26498,4,1,92693,92693,92694,0,1,3
26499,5,3,92698,92698,92701,0,3,4
26500,4,2,92702,92702,92704,0,2,1
26501,1,3,92703,92704,92707,1,4,0
26502,3,2,92706,92707,92709,1,3,0
26503,4,1,92710,92710,92711,0,1,1
26504,3,3,92713,92713,92716,0,3,2
26505,2,2,92715,92716,92718,1,3,0
26506,6,3,92721,92721,92724,0,3,3
26507,3,2,92724,92724,92726,0,2,0
26508,4,3,92728,92728,92731,0,3,2
26509,3,2,92731,92731,92733,0,2,0
26510,5,3,92736,92736,92739,0,3,3
26511,6,1,92742,92742,92743,0,1,3
26512,4,1,92746,92746,92747,0,1,3
26513,4,1,92750,92750,92751,0,1,3
26514,6,1,92756,92756,92757,0,1,5
26515,1,2,92757,92757,92759,0,2,0
26516,5,2,92762,92762,92764,0,2,3
26517,6,1,92768,92768,92769,0,1,4
26518,5,1,92773,92773,92774,0,1,4
26519,3,3,92776,92776,92779,0,3,2
26520,5,3,92781,92781,92784,0,3,2
26521,4,2,92785,92785,92787,0,2,1
26522,1,1,92786,92787,92788,1,2,0
26523,5,2,92791,92791,92793,0,2,3
26524,6,2,92797,92797,92799,0,2,4
26525,4,2,92801,92801,92803,0,2,2
26526,6,1,92807,92807,92808,0,1,4
26527,5,1,92812,92812,92813,0,1,4
26528,3,2,92815,92815,92817,0,2,2
26529,2,3,92817,92817,92820,0,3,0
26530,3,2,92820,92820,92822,0,2,0
26531,5,1,92825,92825,92826,0,1,3
26532,2,3,92827,92827,92830,0,3,1
26533,6,2,92833,92833,92835,0,2,3
26534,6,2,92839,92839,92841,0,2,4
26535,2,1,92841,92841,92842,0,1,0
26536,4,1,92845,92845,92846,0,1,3
26537,6,2,92851,92851,92853,0,2,5
26538,6,1,92857,92857,92858,0,1,4
26539,2,3,92859,92859,92862,0,3,1
26540,6,3,92865,92865,92868,0,3,3
26541,3,3,92868,92868,92871,0,3,0
26542,1,2,92869,92871,92873,2,4,0
26543,1,2,92870,92873,92875,3,5,0
26544,2,3,92872,92875,92878,3,6,0
26545,2,3,92874,92878,92881,4,7,0
26546,6,2,92880,92881,92883,1,3,0
26547,6,3,92886,92886,92889,0,3,3
26548,2,3,92888,92889,92892,1,4,0
26549,4,1,92892,92892,92893,0,1,0
26550,3,1,92895,92895,92896,0,1,2
26551,5,3,92900,92900,92903,0,3,4
26552,6,3,92906,92906,92909,0,3,3
26553,1,1,92907,92909,92910,2,3,0
26554,6,1,92913,92913,92914,0,1,3
26555,4,3,92917,92917,92920,0,3,3
26556,3,2,92920,92920,92922,0,2,0
26557,6,1,92926,92926,92927,0,1,4
26558,5,3,92931,92931,92934,0,3,4
26559,4,1,92935,92935,92936,0,1,1
26560,3,2,92938,92938,92940,0,2,2
26561,5,2,92943,92943,92945,0,2,3
26562,1,2,92944,92945,92947,1,3,0
26563,1,3,92945,92947,92950,2,5,0
26564,6,1,92951,92951,92952,0,1,1
26565,5,1,92956,92956,92957,0,1,4
26566,6,1,92962,92962,92963,0,1,5
26567,6,2,92968,92968,92970,0,2,5
26568,5,3,92973,92973,92976,0,3,3
26569,5,1,92978,92978,92979,0,1,2
26570,5,1,92983,92983,92984,0,1,4
26571,2,2,92985,92985,92987,0,2,1
26572,4,1,92989,92989,92990,0,1,2
26573,5,3,92994,92994,92997,0,3,4
26574,6,1,93000,93000,93001,0,1,3
26575,6,3,93006,93006,93009,0,3,5
26576,5,3,93011,93011,93014,0,3,2
26577,6,1,93017,93017,93018,0,1,3
26578,3,1,93020,93020,93021,0,1,2
26579,3,3,93023,93023,93026,0,3,2
26580,1,2,93024,93026,93028,2,4,0
26581,5,3,93029,93029,93032,0,3,1
26582,4,3,93033,93033,93036,0,3,1
26583,6,3,93039,93039,93042,0,3,3
26584,6,3,93045,93045,93048,0,3,3
26585,5,2,93050,93050,93052,0,2,2
26586,6,2,93056,93056,93058,0,2,4
26587,3,2,93059,93059,93061,0,2,1
26588,4,2,93063,93063,93065,0,2,2
26589,6,3,93069,93069,93072,0,3,4
26590,1,1,93070,93072,93073,2,3,0
26591,3,1,93073,93073,93074,0,1,0
26592,2,3,93075,93075,93078,0,3,1
26593,4,2,93079,93079,93081,0,2,1
26594,1,3,93080,93081,93084,1,4,0
26595,1,3,93081,93084,93087,3,6,0
26596,3,1,93084,93087,93088,3,4,0
26597,6,1,93090,93090,93091,0,1,2
26598,5,1,93095,93095,93096,0,1,4
26599,1,2,93096,93096,93098,0,2,0
26600,2,3,93098,93098,93101,0,3,0
26601,5,3,93103,93103,93106,0,3,2
26602,4,2,93107,93107,93109,0,2,1
26603,6,3,93113,93113,93116,0,3,4
26604,5,1,93118,93118,93119,0,1,2
26605,6,2,93124,93124,93126,0,2,5
26606,3,1,93127,93127,93128,0,1,1
26607,4,2,93131,93131,93133,0,2,3
26608,1,2,93132,93133,93135,1,3,0
26609,3,2,93135,93135,93137,0,2,0
26610,3,2,93138,93138,93140,0,2,1
26611,3,3,93141,93141,93144,0,3,1
26612,1,1,93142,93144,93145,2,3,0
26613,4,2,93146,93146,93148,0,2,1
26614,2,3,93148,93148,93151,0,3,0
26615,5,2,93153,93153,93155,0,2,2
26616,5,1,93158,93158,93159,0,1,3
26617,5,1,93163,93163,93164,0,1,4
26618,3,3,93166,93166,93169,0,3,2
26619,1,3,93167,93169,93172,2,5,0
26620,3,3,93170,93172,93175,2,5,0
26621,4,2,93174,93175,93177,1,3,0
26622,4,3,93178,93178,93181,0,3,1
26623,3,3,93181,93181,93184,0,3,0
26624,3,3,93184,93184,93187,0,3,0
26625,2,3,93186,93187,93190,1,4,0
26626,3,1,93189,93190,93191,1,2,0
26627,1,2,93190,93191,93193,1,3,0
26628,4,3,93194,93194,93197,0,3,1
26629,6,3,93200,93200,93203,0,3,3
26630,6,3,93206,93206,93209,0,3,3
26631,6,2,93212,93212,93214,0,2,3
26632,6,3,93218,93218,93221,0,3,4
26633,2,2,93220,93221,93223,1,3,0
26634,4,1,93224,93224,93225,0,1,1
26635,5,3,93229,93229,93232,0,3,4
26636,2,3,93231,93232,93235,1,4,0
26637,2,3,93233,93235,93238,2,5,0
26638,1,3,93234,93238,93241,4,7,0
26639,2,1,93236,93241,93242,5,6,0
26640,4,3,93240,93242,93245,2,5,0
26641,3,2,93243,93245,93247,2,4,0
26642,5,3,93248,93248,93251,0,3,1
26643,1,2,93249,93251,93253,2,4,0
26644,5,3,93254,93254,93257,0,3,1
26645,3,2,93257,93257,93259,0,2,0
26646,3,1,93260,93260,93261,0,1,1
26647,1,2,93261,93261,93263,0,2,0
26648,6,2,93267,93267,93269,0,2,4
26649,4,1,93271,93271,93272,0,1,2
26650,3,1,93274,93274,93275,0,1,2
26651,5,3,93279,93279,93282,0,3,4
26652,1,2,93280,93282,93284,2,4,0
26653,4,2,93284,93284,93286,0,2,0
26654,6,1,93290,93290,93291,0,1,4
26655,2,3,93292,93292,93295,0,3,1
26656,4,3,93296,93296,93299,0,3,1
26657,5,2,93301,93301,93303,0,2,2
26658,1,1,93302,93303,93304,1,2,0
26659,4,2,93306,93306,93308,0,2,2
26660,5,1,93311,93311,93312,0,1,3
26661,3,1,93314,93314,93315,0,1,2
26662,5,2,93319,93319,93321,0,2,4
26663,6,1,93325,93325,93326,0,1,4
26664,3,3,93328,93328,93331,0,3,2
26665,4,3,93332,93332,93335,0,3,1
26666,3,2,93335,93335,93337,0,2,0
26667,5,2,93340,93340,93342,0,2,3
26668,4,2,93344,93344,93346,0,2,2
26669,6,3,93350,93350,93353,0,3,4
26670,4,1,93354,93354,93355,0,1,1
26671,5,3,93359,93359,93362,0,3,4
26672,6,3,93365,93365,93368,0,3,3
26673,5,1,93370,93370,93371,0,1,2
26674,5,2,93375,93375,93377,0,2,4
26675,1,1,93376,93377,93378,1,2,0
26676,4,1,93380,93380,93381,0,1,2
26677,1,2,93381,93381,93383,0,2,0
26678,2,1,93383,93383,93384,0,1,0
26679,1,3,93384,93384,93387,0,3,0
26680,1,1,93385,93387,93388,2,3,0
26681,3,3,93388,93388,93391,0,3,0
26682,3,3,93391,93391,93394,0,3,0
26683,1,1,93392,93394,93395,2,3,0
26684,5,1,93397,93397,93398,0,1,2
26685,3,3,93400,93400,93403,0,3,2
26686,3,1,93403,93403,93404,0,1,0
26687,3,2,93406,93406,93408,0,2,2
26688,1,2,93407,93408,93410,1,3,0
26689,2,3,93409,93410,93413,1,4,0
26690,4,3,93413,93413,93416,0,3,0
26691,6,3,93419,93419,93422,0,3,3
26692,5,2,93424,93424,93426,0,2,2
26693,3,3,93427,93427,93430,0,3,1
26694,3,1,93430,93430,93431,0,1,0
26695,5,1,93435,93435,93436,0,1,4
26696,4,3,93439,93439,93442,0,3,3
26697,2,2,93441,93442,93444,1,3,0
26698,4,1,93445,93445,93446,0,1,1
26699,3,2,93448,93448,93450,0,2,2
26700,1,1,93449,93450,93451,1,2,0
26701,6,2,93455,93455,93457,0,2,4
26702,6,3,93461,93461,93464,0,3,4
26703,5,1,93466,93466,93467,0,1,2
26704,1,3,93467,93467,93470,0,3,0
26705,5,1,93472,93472,93473,0,1,2
26706,2,1,93474,93474,93475,0,1,1
26707,4,1,93478,93478,93479,0,1,3
26708,6,2,93484,93484,93486,0,2,5
26709,5,1,93489,93489,93490,0,1,3
26710,3,3,93492,93492,93495,0,3,2
26711,2,2,93494,93495,93497,1,3,0
26712,3,3,93497,93497,93500,0,3,0
26713,2,1,93499,93500,93501,1,2,0
26714,4,1,93503,93503,93504,0,1,2
26715,1,1,93504,93504,93505,0,1,0
26716,6,1,93510,93510,93511,0,1,5
26717,4,3,93514,93514,93517,0,3,3
26718,6,3,93520,93520,93523,0,3,3
26719,1,3,93521,93523,93526,2,5,0
26720,5,3,93526,93526,93529,0,3,0
26721,6,1,93532,93532,93533,0,1,3
26722,3,3,93535,93535,93538,0,3,2
26723,5,2,93540,93540,93542,0,2,2
26724,1,1,93541,93542,93543,1,2,0
26725,2,2,93543,93543,93545,0,2,0
26726,3,1,93546,93546,93547,0,1,1
26727,1,1,93547,93547,93548,0,1,0
26728,2,2,93549,93549,93551,0,2,1
26729,2,2,93551,93551,93553,0,2,0
26730,4,3,93555,93555,93558,0,3,2
26731,6,1,93561,93561,93562,0,1,3
26732,5,2,93566,93566,93568,0,2,4
26733,4,3,93570,93570,93573,0,3,2
26734,1,2,93571,93573,93575,2,4,0
26735,2,2,93573,93575,93577,2,4,0
26736,4,3,93577,93577,93580,0,3,0
26737,3,1,93580,93580,93581,0,1,0
26738,2,1,93582,93582,93583,0,1,1
26739,1,2,93583,93583,93585,0,2,0
26740,3,2,93586,93586,93588,0,2,1
26741,1,2,93587,93588,93590,1,3,0
26742,6,2,93593,93593,93595,0,2,3
26743,1,3,93594,93595,93598,1,4,0
26744,3,3,93597,93598,93601,1,4,0
26745,6,1,93603,93603,93604,0,1,2
26746,2,2,93605,93605,93607,0,2,1
26747,1,1,93606,93607,93608,1,2,0
26748,6,3,93612,93612,93615,0,3,4
26749,6,2,93618,93618,93620,0,2,3
26750,1,2,93619,93620,93622,1,3,0
26751,2,1,93621,93622,93623,1,2,0
26752,2,1,93623,93623,93624,0,1,0
26753,2,2,93625,93625,93627,0,2,1
26754,3,3,93628,93628,93631,0,3,1
26755,6,2,93634,93634,93636,0,2,3
26756,6,3,93640,93640,93643,0,3,4
26757,1,2,93641,93643,93645,2,4,0
26758,3,1,93644,93645,93646,1,2,0
26759,2,2,93646,93646,93648,0,2,0
26760,3,3,93649,93649,93652,0,3,1
26761,5,2,93654,93654,93656,0,2,2
26762,2,3,93656,93656,93659,0,3,0
26763,4,3,93660,93660,93663,0,3,1
26764,3,2,93663,93663,93665,0,2,0
26765,6,3,93669,93669,93672,0,3,4
26766,4,2,93673,93673,93675,0,2,1
26767,5,2,93678,93678,93680,0,2,3
26768,1,3,93679,93680,93683,1,4,0
26769,2,1,93681,93683,93684,2,3,0
26770,5,2,93686,93686,93688,0,2,2
26771,6,2,93692,93692,93694,0,2,4
26772,6,3,93698,93698,93701,0,3,4
26773,2,2,93700,93701,93703,1,3,0
26774,4,2,93704,93704,93706,0,2,1
26775,3,3,93707,93707,93710,0,3,1
26776,3,3,93710,93710,93713,0,3,0
26777,4,3,93714,93714,93717,0,3,1
26778,1,1,93715,93717,93718,2,3,0
26779,2,1,93717,93718,93719,1,2,0
26780,5,1,93722,93722,93723,0,1,3
26781,2,2,93724,93724,93726,0,2,1
26782,1,1,93725,93726,93727,1,2,0
26783,3,1,93728,93728,93729,0,1,1
26784,6,1,93734,93734,93735,0,1,5
26785,1,1,93735,93735,93736,0,1,0
26786,2,2,93737,93737,93739,0,2,1
26787,2,3,93739,93739,93742,0,3,0
26788,3,1,93742,93742,93743,0,1,0
26789,6,3,93748,93748,93751,0,3,5
26790,5,1,93753,93753,93754,0,1,2
26791,1,3,93754,93754,93757,0,3,0
26792,2,3,93756,93757,93760,1,4,0
26793,4,1,93760,93760,93761,0,1,0
26794,5,1,93765,93765,93766,0,1,4
26795,2,3,93767,93767,93770,0,3,1
26796,4,3,93771,93771,93774,0,3,1
26797,4,3,93775,93775,93778,0,3,1
26798,6,2,93781,93781,93783,0,2,3
26799,4,1,93785,93785,93786,0,1,2
26800,5,1,93790,93790,93791,0,1,4
26801,3,3,93793,93793,93796,0,3,2
26802,2,1,93795,93796,93797,1,2,0
26803,5,2,93800,93800,93802,0,2,3
26804,2,2,93802,93802,93804,0,2,0
26805,1,3,93803,93804,93807,1,4,0
26806,6,2,93809,93809,93811,0,2,2
26807,2,3,93811,93811,93814,0,3,0
26808,4,1,93815,93815,93816,0,1,1
26809,2,1,93817,93817,93818,0,1,1
26810,6,1,93823,93823,93824,0,1,5
26811,3,1,93826,93826,93827,0,1,2
26812,6,3,93832,93832,93835,0,3,5
26813,2,2,93834,93835,93837,1,3,0
26814,1,1,93835,93837,93838,2,3,0
26815,6,3,93841,93841,93844,0,3,3
26816,1,1,93842,93844,93845,2,3,0
26817,2,3,93844,93845,93848,1,4,0
26818,3,1,93847,93848,93849,1,2,0
26819,5,1,93852,93852,93853,0,1,3
26820,4,3,93856,93856,93859,0,3,3
26821,5,3,93861,93861,93864,0,3,2
26822,2,3,93863,93864,93867,1,4,0
26823,4,2,93867,93867,93869,0,2,0
26824,4,2,93871,93871,93873,0,2,2
26825,3,1,93874,93874,93875,0,1,1
26826,2,2,93876,93876,93878,0,2,1
26827,5,2,93881,93881,93883,0,2,3
26828,3,2,93884,93884,93886,0,2,1
26829,5,1,93889,93889,93890,0,1,3
26830,4,2,93893,93893,93895,0,2,3
26831,2,1,93895,93895,93896,0,1,0
26832,3,1,93898,93898,93899,0,1,2
26833,4,1,93902,93902,93903,0,1,3
26834,6,1,93908,93908,93909,0,1,5
26835,3,1,93911,93911,93912,0,1,2
26836,3,3,93914,93914,93917,0,3,2
26837,5,1,93919,93919,93920,0,1,2
26838,5,1,93924,93924,93925,0,1,4
26839,4,3,93928,93928,93931,0,3,3
26840,3,2,93931,93931,93933,0,2,0
26841,4,3,93935,93935,93938,0,3,2
26842,4,2,93939,93939,93941,0,2,1
26843,5,2,93944,93944,93946,0,2,3
26844,3,1,93947,93947,93948,0,1,1
26845,5,2,93952,93952,93954,0,2,4
26846,6,2,93958,93958,93960,0,2,4
26847,1,1,93959,93960,93961,1,2,0
26848,3,1,93962,93962,93963,0,1,1
26849,4,3,93966,93966,93969,0,3,3
26850,5,1,93971,93971,93972,0,1,2
26851,4,3,93975,93975,93978,0,3,3
26852,6,2,93981,93981,93983,0,2,3
26853,2,2,93983,93983,93985,0,2,0
26854,6,2,93989,93989,93991,0,2,4
26855,4,1,93993,93993,93994,0,1,2
26856,3,1,93996,93996,93997,0,1,2
26857,1,1,93997,93997,93998,0,1,0
26858,6,3,94003,94003,94006,0,3,5
26859,4,1,94007,94007,94008,0,1,1
26860,6,1,94013,94013,94014,0,1,5
26861,3,1,94016,94016,94017,0,1,2
26862,5,1,94021,94021,94022,0,1,4
26863,5,3,94026,94026,94029,0,3,4
26864,2,2,94028,94029,94031,1,3,0
26865,4,1,94032,94032,94033,0,1,1
26866,5,2,94037,94037,94039,0,2,4
26867,2,3,94039,94039,94042,0,3,0
26868,4,1,94043,94043,94044,0,1,1
26869,2,2,94045,94045,94047,0,2,1
26870,6,2,94051,94051,94053,0,2,4
26871,5,2,94056,94056,94058,0,2,3
26872,5,3,94061,94061,94064,0,3,3
26873,1,2,94062,94064,94066,2,4,0
26874,1,1,94063,94066,94067,3,4,0
26875,2,2,94065,94067,94069,2,4,0
26876,5,2,94070,94070,94072,0,2,1
26877,4,2,94074,94074,94076,0,2,2
26878,1,2,94075,94076,94078,1,3,0
26879,5,2,94080,94080,94082,0,2,2
26880,6,3,94086,94086,94089,0,3,4
26881,3,2,94089,94089,94091,0,2,0
26882,3,3,94092,94092,94095,0,3,1
26883,4,2,94096,94096,94098,0,2,1
26884,1,1,94097,94098,94099,1,2,0
26885,2,3,94099,94099,94102,0,3,0
26886,3,1,94102,94102,94103,0,1,0
26887,4,3,94106,94106,94109,0,3,3
26888,5,3,94111,94111,94114,0,3,2
26889,4,2,94115,94115,94117,0,2,1
26890,6,2,94121,94121,94123,0,2,4
26891,6,2,94127,94127,94129,0,2,4
26892,4,3,94131,94131,94134,0,3,2
26893,4,3,94135,94135,94138,0,3,1
26894,4,2,94139,94139,94141,0,2,1
26895,1,2,94140,94141,94143,1,3,0
26896,2,2,94142,94143,94145,1,3,0
26897,3,2,94145,94145,94147,0,2,0
26898,4,2,94149,94149,94151,0,2,2
26899,2,2,94151,94151,94153,0,2,0
26900,1,2,94152,94153,94155,1,3,0
26901,5,3,94157,94157,94160,0,3,2
26902,3,3,94160,94160,94163,0,3,0
26903,4,2,94164,94164,94166,0,2,1
26904,6,3,94170,94170,94173,0,3,4
26905,4,2,94174,94174,94176,0,2,1
26906,3,1,94177,94177,94178,0,1,1
26907,5,3,94182,94182,94185,0,3,4
26908,2,1,94184,94185,94186,1,2,0
26909,3,3,94187,94187,94190,0,3,1
26910,1,3,94188,94190,94193,2,5,0
26911,2,1,94190,94193,94194,3,4,0
26912,1,3,94191,94194,94197,3,6,0
26913,4,1,94195,94197,94198,2,3,0
26914,3,2,94198,94198,94200,0,2,0
26915,6,2,94204,94204,94206,0,2,4
26916,2,1,94206,94206,94207,0,1,0
26917,5,2,94211,94211,94213,0,2,4
26918,2,2,94213,94213,94215,0,2,0
26919,3,2,94216,94216,94218,0,2,1
26920,4,2,94220,94220,94222,0,2,2
26921,1,3,94221,94222,94225,1,4,0
26922,4,2,94225,94225,94227,0,2,0
26923,6,2,94231,94231,94233,0,2,4
26924,5,3,94236,94236,94239,0,3,3
26925,5,3,94241,94241,94244,0,3,2
26926,5,2,94246,94246,94248,0,2,2
26927,6,1,94252,94252,94253,0,1,4
26928,4,3,94256,94256,94259,0,3,3
26929,1,2,94257,94259,94261,2,4,0
26930,5,2,94262,94262,94264,0,2,1
26931,3,3,94265,94265,94268,0,3,1
26932,4,2,94269,94269,94271,0,2,1
26933,3,2,94272,94272,94274,0,2,1
26934,6,2,94278,94278,94280,0,2,4
26935,6,3,94284,94284,94287,0,3,4
26936,6,2,94290,94290,94292,0,2,3
26937,3,1,94293,94293,94294,0,1,1
26938,6,3,94299,94299,94302,0,3,5
26939,4,3,94303,94303,94306,0,3,1
26940,6,3,94309,94309,94312,0,3,3
26941,3,1,94312,94312,94313,0,1,0
26942,1,2,94313,94313,94315,0,2,0
26943,5,2,94318,94318,94320,0,2,3
26944,4,3,94322,94322,94325,0,3,2
26945,6,1,94328,94328,94329,0,1,3
26946,4,3,94332,94332,94335,0,3,3
26947,1,1,94333,94335,94336,2,3,0
26948,4,3,94337,94337,94340,0,3,1
26949,4,3,94341,94341,94344,0,3,1
26950,2,1,94343,94344,94345,1,2,0
26951,5,3,94348,94348,94351,0,3,3
26952,2,3,94350,94351,94354,1,4,0
26953,6,1,94356,94356,94357,0,1,2
26954,3,2,94359,94359,94361,0,2,2
26955,1,1,94360,94361,94362,1,2,0
26956,5,1,94365,94365,94366,0,1,3
26957,1,2,94366,94366,94368,0,2,0
26958,3,3,94369,94369,94372,0,3,1
26959,5,2,94374,94374,94376,0,2,2
26960,1,2,94375,94376,94378,1,3,0
26961,2,2,94377,94378,94380,1,3,0
26962,5,2,94382,94382,94384,0,2,2
26963,5,1,94387,94387,94388,0,1,3
26964,4,1,94391,94391,94392,0,1,3
26965,3,3,94394,94394,94397,0,3,2
26966,2,3,94396,94397,94400,1,4,0
26967,1,3,94397,94400,94403,3,6,0
26968,5,2,94402,94403,94405,1,3,0
26969,3,3,94405,94405,94408,0,3,0
26970,2,1,94407,94408,94409,1,2,0
26971,6,3,94413,94413,94416,0,3,4
26972,3,3,94416,94416,94419,0,3,0
26973,3,3,94419,94419,94422,0,3,0
26974,5,1,94424,94424,94425,0,1,2
26975,5,1,94429,94429,94430,0,1,4
26976,1,3,94430,94430,94433,0,3,0
26977,2,3,94432,94433,94436,1,4,0
26978,6,1,94438,94438,94439,0,1,2
26979,3,3,94441,94441,94444,0,3,2
26980,6,3,94447,94447,94450,0,3,3
26981,3,2,94450,94450,94452,0,2,0
26982,4,3,94454,94454,94457,0,3,2
26983,2,2,94456,94457,94459,1,3,0
26984,3,2,94459,94459,94461,0,2,0
26985,6,3,94465,94465,94468,0,3,4
26986,5,1,94470,94470,94471,0,1,2
26987,5,1,94475,94475,94476,0,1,4
26988,3,1,94478,94478,94479,0,1,2
26989,3,3,94481,94481,94484,0,3,2
26990,4,3,94485,94485,94488,0,3,1
26991,1,1,94486,94488,94489,2,3,0
26992,4,2,94490,94490,94492,0,2,1
26993,3,1,94493,94493,94494,0,1,1
26994,5,3,94498,94498,94501,0,3,4
26995,4,3,94502,94502,94505,0,3,1
26996,3,1,94505,94505,94506,0,1,0
26997,6,2,94511,94511,94513,0,2,5
26998,1,3,94512,94513,94516,1,4,0
26999,5,2,94517,94517,94519,0,2,1
27000,1,1,94518,94519,94520,1,2,0
27001,4,3,94522,94522,94525,0,3,2
27002,1,2,94523,94525,94527,2,4,0
27003,4,1,94527,94527,94528,0,1,0
27004,4,1,94531,94531,94532,0,1,3
27005,3,1,94534,94534,94535,0,1,2
27006,4,3,94538,94538,94541,0,3,3
27007,2,1,94540,94541,94542,1,2,0
27008,1,3,94541,94542,94545,1,4,0
27009,6,2,94547,94547,94549,0,2,2
27010,4,3,94551,94551,94554,0,3,2
27011,4,3,94555,94555,94558,0,3,1
27012,2,2,94557,94558,94560,1,3,0
27013,2,1,94559,94560,94561,1,2,0
27014,4,3,94563,94563,94566,0,3,2
27015,4,3,94567,94567,94570,0,3,1
27016,5,3,94572,94572,94575,0,3,2
27017,3,1,94575,94575,94576,0,1,0
27018,4,3,94579,94579,94582,0,3,3
27019,5,2,94584,94584,94586,0,2,2
27020,3,3,94587,94587,94590,0,3,1
27021,2,2,94589,94590,94592,1,3,0
27022,1,3,94590,94592,94595,2,5,0
27023,4,2,94594,94595,94597,1,3,0
27024,1,1,94595,94597,94598,2,3,0
27025,5,2,94600,94600,94602,0,2,2
27026,5,1,94605,94605,94606,0,1,3
27027,3,2,94608,94608,94610,0,2,2
27028,4,3,94612,94612,94615,0,3,2
27029,3,1,94615,94615,94616,0,1,0
27030,2,2,94617,94617,94619,0,2,1
27031,2,2,94619,94619,94621,0,2,0
27032,3,3,94622,94622,94625,0,3,1
27033,5,1,94627,94627,94628,0,1,2
27034,3,1,94630,94630,94631,0,1,2
27035,4,1,94634,94634,94635,0,1,3
27036,2,1,94636,94636,94637,0,1,1
27037,5,3,94641,94641,94644,0,3,4
27038,2,1,94643,94644,94645,1,2,0
27039,6,2,94649,94649,94651,0,2,4
27040,2,1,94651,94651,94652,0,1,0
27041,2,2,94653,94653,94655,0,2,1
27042,6,3,94659,94659,94662,0,3,4
27043,5,2,94664,94664,94666,0,2,2
27044,5,3,94669,94669,94672,0,3,3
27045,3,3,94672,94672,94675,0,3,0
27046,1,3,94673,94675,94678,2,5,0
27047,6,3,94679,94679,94682,0,3,1
27048,5,1,94684,94684,94685,0,1,2
27049,1,2,94685,94685,94687,0,2,0
27050,1,1,94686,94687,94688,1,2,0
27051,6,3,94692,94692,94695,0,3,4
27052,4,2,94696,94696,94698,0,2,1
27053,3,1,94699,94699,94700,0,1,1
27054,6,2,94705,94705,94707,0,2,5
27055,2,3,94707,94707,94710,0,3,0
27056,2,1,94709,94710,94711,1,2,0
27057,2,2,94711,94711,94713,0,2,0
27058,5,2,94716,94716,94718,0,2,3
27059,4,2,94720,94720,94722,0,2,2
27060,4,1,94724,94724,94725,0,1,2
27061,2,2,94726,94726,94728,0,2,1
27062,4,2,94730,94730,94732,0,2,2
27063,4,3,94734,94734,94737,0,3,2
27064,4,2,94738,94738,94740,0,2,1
27065,3,1,94741,94741,94742,0,1,1
27066,5,1,94746,94746,94747,0,1,4
27067,2,1,94748,94748,94749,0,1,1
27068,2,2,94750,94750,94752,0,2,1
27069,6,3,94756,94756,94759,0,3,4
27070,4,3,94760,94760,94763,0,3,1
27071,1,1,94761,94763,94764,2,3,0
27072,6,2,94767,94767,94769,0,2,3
27073,6,1,94773,94773,94774,0,1,4
27074,4,3,94777,94777,94780,0,3,3
27075,4,1,94781,94781,94782,0,1,1
27076,3,3,94784,94784,94787,0,3,2
27077,6,1,94790,94790,94791,0,1,3
27078,6,1,94796,94796,94797,0,1,5
27079,3,1,94799,94799,94800,0,1,2
27080,2,1,94801,94801,94802,0,1,1
27081,6,1,94807,94807,94808,0,1,5
27082,5,1,94812,94812,94813,0,1,4
27083,3,3,94815,94815,94818,0,3,2
27084,4,2,94819,94819,94821,0,2,1
27085,4,3,94823,94823,94826,0,3,2
27086,3,2,94826,94826,94828,0,2,0
27087,6,3,94832,94832,94835,0,3,4
27088,1,1,94833,94835,94836,2,3,0
27089,2,2,94835,94836,94838,1,3,0
27090,1,3,94836,94838,94841,2,5,0
27091,2,2,94838,94841,94843,3,5,0
27092,2,3,94840,94843,94846,3,6,0
27093,3,1,94843,94846,94847,3,4,0
27094,4,1,94847,94847,94848,0,1,0
27095,4,3,94851,94851,94854,0,3,3
27096,3,1,94854,94854,94855,0,1,0
27097,4,3,94858,94858,94861,0,3,3
27098,6,3,94864,94864,94867,0,3,3
27099,3,1,94867,94867,94868,0,1,0
27100,4,1,94871,94871,94872,0,1,3
27101,1,3,94872,94872,94875,0,3,0
27102,5,3,94877,94877,94880,0,3,2
27103,1,3,94878,94880,94883,2,5,0
27104,4,3,94882,94883,94886,1,4,0
27105,4,2,94886,94886,94888,0,2,0
27106,1,1,94887,94888,94889,1,2,0
27107,3,3,94890,94890,94893,0,3,1
27108,3,1,94893,94893,94894,0,1,0
27109,2,3,94895,94895,94898,0,3,1
27110,2,1,94897,94898,94899,1,2,0
27111,4,2,94901,94901,94903,0,2,2
27112,3,3,94904,94904,94907,0,3,1
27113,1,3,94905,94907,94910,2,5,0
27114,3,3,94908,94910,94913,2,5,0
27115,4,3,94912,94913,94916,1,4,0
27116,2,1,94914,94916,94917,2,3,0
27117,3,2,94917,94917,94919,0,2,0
27118,3,2,94920,94920,94922,0,2,1
27119,6,1,94926,94926,94927,0,1,4
27120,1,3,94927,94927,94930,0,3,0
27121,4,3,94931,94931,94934,0,3,1
27122,5,2,94936,94936,94938,0,2,2
27123,6,3,94942,94942,94945,0,3,4
27124,5,2,94947,94947,94949,0,2,2
27125,2,3,94949,94949,94952,0,3,0
27126,2,1,94951,94952,94953,1,2,0
27127,4,1,94955,94955,94956,0,1,2
27128,4,1,94959,94959,94960,0,1,3
27129,1,3,94960,94960,94963,0,3,0
27130,3,1,94963,94963,94964,0,1,0
27131,5,1,94968,94968,94969,0,1,4
27132,6,1,94974,94974,94975,0,1,5
27133,1,1,94975,94975,94976,0,1,0
27134,2,2,94977,94977,94979,0,2,1
27135,4,1,94981,94981,94982,0,1,2
27136,6,2,94987,94987,94989,0,2,5
27137,5,1,94992,94992,94993,0,1,3
27138,2,1,94994,94994,94995,0,1,1
27139,4,1,94998,94998,94999,0,1,3
27140,1,1,94999,94999,95000,0,1,0
27141,4,1,95003,95003,95004,0,1,3
27142,6,3,95009,95009,95012,0,3,5
27143,4,2,95013,95013,95015,0,2,1
27144,2,2,95015,95015,95017,0,2,0
27145,3,1,95018,95018,95019,0,1,1
27146,3,2,95021,95021,95023,0,2,2
27147,4,1,95025,95025,95026,0,1,2
27148,2,2,95027,95027,95029,0,2,1
27149,4,3,95031,95031,95034,0,3,2
27150,4,3,95035,95035,95038,0,3,1
27151,6,1,95041,95041,95042,0,1,3
27152,1,1,95042,95042,95043,0,1,0
27153,5,2,95047,95047,95049,0,2,4
27154,5,1,95052,95052,95053,0,1,3
27155,1,3,95053,95053,95056,0,3,0
27156,1,1,95054,95056,95057,2,3,0
27157,2,2,95056,95057,95059,1,3,0
27158,1,2,95057,95059,95061,2,4,0
27159,5,1,95062,95062,95063,0,1,1
27160,3,2,95065,95065,95067,0,2,2
27161,5,1,95070,95070,95071,0,1,3
27162,4,3,95074,95074,95077,0,3,3
27163,5,3,95079,95079,95082,0,3,2
27164,2,2,95081,95082,95084,1,3,0
27165,1,1,95082,95084,95085,2,3,0
27166,6,3,95088,95088,95091,0,3,3
27167,2,2,95090,95091,95093,1,3,0
27168,6,3,95096,95096,95099,0,3,3
27169,6,2,95102,95102,95104,0,2,3
27170,6,1,95108,95108,95109,0,1,4
27171,5,3,95113,95113,95116,0,3,4
27172,3,2,95116,95116,95118,0,2,0
27173,6,1,95122,95122,95123,0,1,4
27174,4,2,95126,95126,95128,0,2,3
27175,1,2,95127,95128,95130,1,3,0
27176,2,2,95129,95130,95132,1,3,0
27177,1,3,95130,95132,95135,2,5,0
27178,1,1,95131,95135,95136,4,5,0
27179,2,2,95133,95136,95138,3,5,0
27180,5,2,95138,95138,95140,0,2,0
27181,5,2,95143,95143,95145,0,2,3
27182,5,3,95148,95148,95151,0,3,3
27183,5,2,95153,95153,95155,0,2,2
27184,6,2,95159,95159,95161,0,2,4
27185,1,2,95160,95161,95163,1,3,0
27186,1,1,95161,95163,95164,2,3,0
27187,1,3,95162,95164,95167,2,5,0
27188,1,2,95163,95167,95169,4,6,0
27189,5,2,95168,95169,95171,1,3,0
27190,2,3,95170,95171,95174,1,4,0
27191,3,2,95173,95174,95176,1,3,0
27192,4,2,95177,95177,95179,0,2,1
27193,6,3,95183,95183,95186,0,3,4
27194,1,3,95184,95186,95189,2,5,0
27195,1,3,95185,95189,95192,4,7,0
27196,3,2,95188,95192,95194,4,6,0
27197,3,1,95191,95194,95195,3,4,0
27198,2,2,95193,95195,95197,2,4,0
27199,4,2,95197,95197,95199,0,2,0
27200,3,2,95200,95200,95202,0,2,1
27201,2,2,95202,95202,95204,0,2,0
27202,5,2,95207,95207,95209,0,2,3
27203,6,2,95213,95213,95215,0,2,4
27204,4,3,95217,95217,95220,0,3,2
27205,1,2,95218,95220,95222,2,4,0
27206,1,1,95219,95222,95223,3,4,0
27207,2,2,95221,95223,95225,2,4,0
27208,3,3,95224,95225,95228,1,4,0
27209,5,1,95229,95229,95230,0,1,1
27210,2,1,95231,95231,95232,0,1,1
27211,1,3,95232,95232,95235,0,3,0
27212,6,2,95238,95238,95240,0,2,3
27213,2,2,95240,95240,95242,0,2,0
27214,3,2,95243,95243,95245,0,2,1
27215,4,1,95247,95247,95248,0,1,2
27216,4,2,95251,95251,95253,0,2,3
27217,5,3,95256,95256,95259,0,3,3
27218,4,2,95260,95260,95262,0,2,1
27219,2,2,95262,95262,95264,0,2,0
27220,4,2,95266,95266,95268,0,2,2
27221,4,2,95270,95270,95272,0,2,2
27222,4,1,95274,95274,95275,0,1,2
27223,1,2,95275,95275,95277,0,2,0
27224,4,3,95279,95279,95282,0,3,2
27225,4,2,95283,95283,95285,0,2,1
27226,1,1,95284,95285,95286,1,2,0
27227,2,2,95286,95286,95288,0,2,0
27228,6,3,95292,95292,95295,0,3,4
27229,3,2,95295,95295,95297,0,2,0
27230,4,2,95299,95299,95301,0,2,2
27231,3,3,95302,95302,95305,0,3,1
27232,6,3,95308,95308,95311,0,3,3
27233,4,1,95312,95312,95313,0,1,1
27234,4,1,95316,95316,95317,0,1,3
27235,4,2,95320,95320,95322,0,2,3
27236,6,2,95326,95326,95328,0,2,4
27237,4,2,95330,95330,95332,0,2,2
27238,1,1,95331,95332,95333,1,2,0
27239,2,3,95333,95333,95336,0,3,0
27240,4,1,95337,95337,95338,0,1,1
27241,6,3,95343,95343,95346,0,3,5
27242,5,2,95348,95348,95350,0,2,2
27243,6,3,95354,95354,95357,0,3,4
27244,1,1,95355,95357,95358,2,3,0
27245,3,2,95358,95358,95360,0,2,0
27246,3,3,95361,95361,95364,0,3,1
27247,5,2,95366,95366,95368,0,2,2
27248,5,2,95371,95371,95373,0,2,3
27249,1,1,95372,95373,95374,1,2,0
27250,5,1,95377,95377,95378,0,1,3
27251,4,2,95381,95381,95383,0,2,3
27252,6,2,95387,95387,95389,0,2,4
27253,6,1,95393,95393,95394,0,1,4
27254,2,2,95395,95395,95397,0,2,1
27255,5,1,95400,95400,95401,0,1,3
27256,2,3,95402,95402,95405,0,3,1
27257,2,2,95404,95405,95407,1,3,0
27258,6,1,95410,95410,95411,0,1,3
27259,3,3,95413,95413,95416,0,3,2
27260,4,1,95417,95417,95418,0,1,1
27261,6,3,95423,95423,95426,0,3,5
27262,1,2,95424,95426,95428,2,4,0
27263,5,2,95429,95429,95431,0,2,1
27264,2,1,95431,95431,95432,0,1,0
27265,3,2,95434,95434,95436,0,2,2
27266,2,2,95436,95436,95438,0,2,0
27267,1,3,95437,95438,95441,1,4,0
27268,5,1,95442,95442,95443,0,1,1
27269,1,3,95443,95443,95446,0,3,0
27270,5,3,95448,95448,95451,0,3,2
27271,6,3,95454,95454,95457,0,3,3
27272,4,2,95458,95458,95460,0,2,1
27273,2,1,95460,95460,95461,0,1,0
27274,5,1,95465,95465,95466,0,1,4
27275,2,3,95467,95467,95470,0,3,1
27276,4,2,95471,95471,95473,0,2,1
27277,2,3,95473,95473,95476,0,3,0
27278,5,2,95478,95478,95480,0,2,2
27279,4,3,95482,95482,95485,0,3,2
27280,3,3,95485,95485,95488,0,3,0
27281,5,2,95490,95490,95492,0,2,2
27282,4,2,95494,95494,95496,0,2,2
27283,4,1,95498,95498,95499,0,1,2
27284,6,2,95504,95504,95506,0,2,5
27285,4,3,95508,95508,95511,0,3,2
27286,5,1,95513,95513,95514,0,1,2
27287,1,3,95514,95514,95517,0,3,0
27288,2,1,95516,95517,95518,1,2,0
27289,2,3,95518,95518,95521,0,3,0
27290,1,1,95519,95521,95522,2,3,0
27291,6,1,95525,95525,95526,0,1,3
27292,2,1,95527,95527,95528,0,1,1
27293,1,3,95528,95528,95531,0,3,0
27294,6,3,95534,95534,95537,0,3,3
27295,2,3,95536,95537,95540,1,4,0
27296,1,2,95537,95540,95542,3,5,0
27297,3,1,95540,95542,95543,2,3,0
27298,1,3,95541,95543,95546,2,5,0
27299,6,1,95547,95547,95548,0,1,1
27300,3,2,95550,95550,95552,0,2,2
27301,3,3,95553,95553,95556,0,3,1
27302,5,1,95558,95558,95559,0,1,2
27303,6,1,95564,95564,95565,0,1,5
27304,6,2,95570,95570,95572,0,2,5
27305,1,3,95571,95572,95575,1,4,0
27306,2,2,95573,95575,95577,2,4,0
27307,1,1,95574,95577,95578,3,4,0
27308,2,3,95576,95578,95581,2,5,0
27309,1,1,95577,95581,95582,4,5,0
27310,2,1,95579,95582,95583,3,4,0
27311,5,1,95584,95584,95585,0,1,1
27312,2,1,95586,95586,95587,0,1,1
27313,6,2,95592,95592,95594,0,2,5
27314,3,1,95595,95595,95596,0,1,1
27315,6,1,95601,95601,95602,0,1,5
27316,5,1,95606,95606,95607,0,1,4
27317,2,3,95608,95608,95611,0,3,1
27318,5,3,95613,95613,95616,0,3,2
27319,2,3,95615,95616,95619,1,4,0
27320,3,3,95618,95619,95622,1,4,0
27321,2,2,95620,95622,95624,2,4,0
27322,5,3,95625,95625,95628,0,3,1
27323,6,3,95631,95631,95634,0,3,3
27324,1,1,95632,95634,95635,2,3,0
27325,6,3,95638,95638,95641,0,3,3
27326,1,1,95639,95641,95642,2,3,0
27327,4,3,95643,95643,95646,0,3,1
27328,2,2,95645,95646,95648,1,3,0
27329,6,2,95651,95651,95653,0,2,3
27330,6,3,95657,95657,95660,0,3,4
27331,4,1,95661,95661,95662,0,1,1
27332,2,3,95663,95663,95666,0,3,1
27333,5,3,95668,95668,95671,0,3,2
27334,4,3,95672,95672,95675,0,3,1
27335,6,1,95678,95678,95679,0,1,3
27336,4,3,95682,95682,95685,0,3,3
27337,2,1,95684,95685,95686,1,2,0
27338,4,1,95688,95688,95689,0,1,2
27339,1,2,95689,95689,95691,0,2,0
27340,6,1,95695,95695,95696,0,1,4
27341,6,3,95701,95701,95704,0,3,5
27342,3,1,95704,95704,95705,0,1,0
27343,5,3,95709,95709,95712,0,3,4
27344,4,3,95713,95713,95716,0,3,1
27345,5,1,95718,95718,95719,0,1,2
27346,3,2,95721,95721,95723,0,2,2
27347,1,1,95722,95723,95724,1,2,0
27348,4,3,95726,95726,95729,0,3,2
27349,1,1,95727,95729,95730,2,3,0
27350,5,1,95732,95732,95733,0,1,2
27351,3,1,95735,95735,95736,0,1,2
27352,4,1,95739,95739,95740,0,1,3
27353,5,1,95744,95744,95745,0,1,4
27354,1,2,95745,95745,95747,0,2,0
27355,5,2,95750,95750,95752,0,2,3
27356,3,1,95753,95753,95754,0,1,1
27357,6,1,95759,95759,95760,0,1,5
27358,2,3,95761,95761,95764,0,3,1
27359,3,3,95764,95764,95767,0,3,0
27360,6,3,95770,95770,95773,0,3,3
27361,5,2,95775,95775,95777,0,2,2
27362,2,3,95777,95777,95780,0,3,0
27363,1,3,95778,95780,95783,2,5,0
27364,6,1,95784,95784,95785,0,1,1
27365,4,1,95788,95788,95789,0,1,3
27366,3,3,95791,95791,95794,0,3,2
27367,4,2,95795,95795,95797,0,2,1
27368,5,2,95800,95800,95802,0,2,3
27369,1,3,95801,95802,95805,1,4,0
27370,2,2,95803,95805,95807,2,4,0
27371,2,1,95805,95807,95808,2,3,0
27372,5,1,95810,95810,95811,0,1,2
27373,1,1,95811,95811,95812,0,1,0
27374,4,3,95815,95815,95818,0,3,3
27375,1,1,95816,95818,95819,2,3,0
27376,3,2,95819,95819,95821,0,2,0
27377,1,2,95820,95821,95823,1,3,0
27378,1,2,95821,95823,95825,2,4,0
27379,5,3,95826,95826,95829,0,3,1
27380,5,3,95831,95831,95834,0,3,2
27381,5,2,95836,95836,95838,0,2,2
27382,3,3,95839,95839,95842,0,3,1
27383,3,3,95842,95842,95845,0,3,0
27384,1,3,95843,95845,95848,2,5,0
27385,2,3,95845,95848,95851,3,6,0
27386,1,1,95846,95851,95852,5,6,0
27387,4,2,95850,95852,95854,2,4,0
27388,4,1,95854,95854,95855,0,1,0
27389,4,3,95858,95858,95861,0,3,3
27390,1,1,95859,95861,95862,2,3,0
27391,6,3,95865,95865,95868,0,3,3
27392,6,1,95871,95871,95872,0,1,3
27393,4,1,95875,95875,95876,0,1,3
27394,5,1,95880,95880,95881,0,1,4
27395,3,1,95883,95883,95884,0,1,2
27396,4,3,95887,95887,95890,0,3,3
27397,3,3,95890,95890,95893,0,3,0
27398,4,3,95894,95894,95897,0,3,1
27399,2,2,95896,95897,95899,1,3,0
27400,4,1,95900,95900,95901,0,1,1
27401,6,1,95906,95906,95907,0,1,5
27402,5,3,95911,95911,95914,0,3,4
27403,5,2,95916,95916,95918,0,2,2
27404,4,3,95920,95920,95923,0,3,2
27405,6,1,95926,95926,95927,0,1,3
27406,3,3,95929,95929,95932,0,3,2
27407,4,2,95933,95933,95935,0,2,1
27408,5,2,95938,95938,95940,0,2,3
27409,6,2,95944,95944,95946,0,2,4
27410,5,3,95949,95949,95952,0,3,3
27411,1,2,95950,95952,95954,2,4,0
27412,4,2,95954,95954,95956,0,2,0
27413,5,3,95959,95959,95962,0,3,3
27414,5,1,95964,95964,95965,0,1,2
27415,4,2,95968,95968,95970,0,2,3
27416,1,3,95969,95970,95973,1,4,0
27417,1,2,95970,95973,95975,3,5,0
27418,1,2,95971,95975,95977,4,6,0
27419,2,2,95973,95977,95979,4,6,0
27420,3,2,95976,95979,95981,3,5,0
27421,3,2,95979,95981,95983,2,4,0
27422,1,2,95980,95983,95985,3,5,0
27423,3,1,95983,95985,95986,2,3,0
27424,6,3,95989,95989,95992,0,3,3
27425,1,1,95990,95992,95993,2,3,0
27426,6,2,95996,95996,95998,0,2,3
27427,6,3,96002,96002,96005,0,3,4
27428,3,1,96005,96005,96006,0,1,0
27429,1,3,96006,96006,96009,0,3,0
27430,2,1,96008,96009,96010,1,2,0
27431,2,1,96010,96010,96011,0,1,0
27432,2,3,96012,96012,96015,0,3,1
27433,3,1,96015,96015,96016,0,1,0
27434,3,2,96018,96018,96020,0,2,2
27435,1,1,96019,96020,96021,1,2,0
27436,3,3,96022,96022,96025,0,3,1
27437,6,3,96028,96028,96031,0,3,3
27438,4,3,96032,96032,96035,0,3,1
27439,2,1,96034,96035,96036,1,2,0
27440,4,3,96038,96038,96041,0,3,2
27441,3,2,96041,96041,96043,0,2,0
27442,5,3,96046,96046,96049,0,3,3
27443,3,3,96049,96049,96052,0,3,0
27444,2,2,96051,96052,96054,1,3,0
27445,4,1,96055,96055,96056,0,1,1
27446,5,1,96060,96060,96061,0,1,4
27447,4,3,96064,96064,96067,0,3,3
27448,3,1,96067,96067,96068,0,1,0
27449,1,1,96068,96068,96069,0,1,0
27450,6,1,96074,96074,96075,0,1,5
27451,2,3,96076,96076,96079,0,3,1
27452,4,3,96080,96080,96083,0,3,1
27453,5,1,96085,96085,96086,0,1,2
27454,3,3,96088,96088,96091,0,3,2
27455,2,3,96090,96091,96094,1,4,0
27456,1,1,96091,96094,96095,3,4,0
27457,1,3,96092,96095,96098,3,6,0
27458,5,2,96097,96098,96100,1,3,0
27459,3,2,96100,96100,96102,0,2,0
27460,2,2,96102,96102,96104,0,2,0
27461,1,3,96103,96104,96107,1,4,0
27462,1,1,96104,96107,96108,3,4,0
27463,4,3,96108,96108,96111,0,3,0
27464,1,2,96109,96111,96113,2,4,0
27465,6,1,96115,96115,96116,0,1,2
27466,3,3,96118,96118,96121,0,3,2
27467,6,2,96124,96124,96126,0,2,3
27468,3,1,96127,96127,96128,0,1,1
27469,2,2,96129,96129,96131,0,2,1
27470,4,2,96133,96133,96135,0,2,2
27471,6,2,96139,96139,96141,0,2,4
27472,3,1,96142,96142,96143,0,1,1
27473,5,3,96147,96147,96150,0,3,4
27474,6,1,96153,96153,96154,0,1,3
27475,1,2,96154,96154,96156,0,2,0
27476,3,1,96157,96157,96158,0,1,1
27477,3,3,96160,96160,96163,0,3,2
27478,6,3,96166,96166,96169,0,3,3
27479,5,3,96171,96171,96174,0,3,2
27480,6,3,96177,96177,96180,0,3,3
27481,2,1,96179,96180,96181,1,2,0
27482,1,2,96180,96181,96183,1,3,0
27483,1,1,96181,96183,96184,2,3,0
27484,4,3,96185,96185,96188,0,3,1
27485,3,3,96188,96188,96191,0,3,0
27486,6,2,96194,96194,96196,0,2,3
27487,4,1,96198,96198,96199,0,1,2
27488,1,2,96199,96199,96201,0,2,0
27489,3,1,96202,96202,96203,0,1,1
27490,3,3,96205,96205,96208,0,3,2
27491,5,1,96210,96210,96211,0,1,2
27492,6,1,96216,96216,96217,0,1,5
27493,3,3,96219,96219,96222,0,3,2
27494,2,1,96221,96222,96223,1,2,0
27495,2,3,96223,96223,96226,0,3,0
27496,5,2,96228,96228,96230,0,2,2
27497,6,2,96234,96234,96236,0,2,4
27498,5,1,96239,96239,96240,0,1,3
27499,5,3,96244,96244,96247,0,3,4
27500,6,1,96250,96250,96251,0,1,3
27501,1,3,96251,96251,96254,0,3,0
27502,5,3,96256,96256,96259,0,3,2
27503,2,1,96258,96259,96260,1,2,0
27504,1,2,96259,96260,96262,1,3,0
27505,4,1,96263,96263,96264,0,1,1
27506,2,1,96265,96265,96266,0,1,1
27507,6,1,96271,96271,96272,0,1,5
27508,6,1,96277,96277,96278,0,1,5
27509,4,2,96281,96281,96283,0,2,3
27510,4,1,96285,96285,96286,0,1,2
27511,5,1,96290,96290,96291,0,1,4
27512,6,3,96296,96296,96299,0,3,5
27513,2,3,96298,96299,96302,1,4,0
27514,2,3,96300,96302,96305,2,5,0
27515,4,3,96304,96305,96308,1,4,0
27516,4,3,96308,96308,96311,0,3,0
27517,2,1,96310,96311,96312,1,2,0
27518,1,2,96311,96312,96314,1,3,0
27519,3,2,96314,96314,96316,0,2,0
27520,2,1,96316,96316,96317,0,1,0
27521,4,1,96320,96320,96321,0,1,3
27522,5,3,96325,96325,96328,0,3,4
27523,2,1,96327,96328,96329,1,2,0
27524,4,3,96331,96331,96334,0,3,2
27525,2,2,96333,96334,96336,1,3,0
27526,1,3,96334,96336,96339,2,5,0
27527,2,2,96336,96339,96341,3,5,0
27528,2,3,96338,96341,96344,3,6,0
27529,2,2,96340,96344,96346,4,6,0
27530,3,2,96343,96346,96348,3,5,0
27531,5,3,96348,96348,96351,0,3,0
27532,6,2,96354,96354,96356,0,2,3
27533,1,3,96355,96356,96359,1,4,0
27534,4,1,96359,96359,96360,0,1,0
27535,4,3,96363,96363,96366,0,3,3
27536,1,3,96364,96366,96369,2,5,0
27537,4,2,96368,96369,96371,1,3,0
27538,3,3,96371,96371,96374,0,3,0
27539,6,3,96377,96377,96380,0,3,3
27540,5,3,96382,96382,96385,0,3,2
27541,2,1,96384,96385,96386,1,2,0
27542,1,3,96385,96386,96389,1,4,0
27543,1,1,96386,96389,96390,3,4,0
27544,6,3,96392,96392,96395,0,3,2
27545,3,2,96395,96395,96397,0,2,0
27546,3,2,96398,96398,96400,0,2,1
27547,4,1,96402,96402,96403,0,1,2
27548,6,1,96408,96408,96409,0,1,5
27549,2,3,96410,96410,96413,0,3,1
27550,3,2,96413,96413,96415,0,2,0
27551,3,2,96416,96416,96418,0,2,1
27552,6,2,96422,96422,96424,0,2,4
27553,3,1,96425,96425,96426,0,1,1
27554,6,2,96431,96431,96433,0,2,5
27555,3,2,96434,96434,96436,0,2,1
27556,4,3,96438,96438,96441,0,3,2
27557,4,2,96442,96442,96444,0,2,1
27558,4,3,96446,96446,96449,0,3,2
27559,1,1,96447,96449,96450,2,3,0
27560,4,3,96451,96451,96454,0,3,1
27561,4,1,96455,96455,96456,0,1,1
27562,1,2,96456,96456,96458,0,2,0
27563,3,2,96459,96459,96461,0,2,1
27564,1,2,96460,96461,96463,1,3,0
27565,3,2,96463,96463,96465,0,2,0
27566,6,2,96469,96469,96471,0,2,4
27567,1,1,96470,96471,96472,1,2,0
27568,2,2,96472,96472,96474,0,2,0
27569,3,3,96475,96475,96478,0,3,1
27570,1,3,96476,96478,96481,2,5,0
27571,2,1,96478,96481,96482,3,4,0
27572,2,2,96480,96482,96484,2,4,0
27573,2,3,96482,96484,96487,2,5,0
27574,1,2,96483,96487,96489,4,6,0
27575,6,2,96489,96489,96491,0,2,0
27576,3,2,96492,96492,96494,0,2,1
27577,5,1,96497,96497,96498,0,1,3
27578,1,3,96498,96498,96501,0,3,0
27579,3,1,96501,96501,96502,0,1,0
27580,1,3,96502,96502,96505,0,3,0
27581,4,1,96506,96506,96507,0,1,1
27582,5,2,96511,96511,96513,0,2,4
27583,3,3,96514,96514,96517,0,3,1
27584,5,3,96519,96519,96522,0,3,2
27585,5,1,96524,96524,96525,0,1,2
27586,5,3,96529,96529,96532,0,3,4
27587,1,3,96530,96532,96535,2,5,0
27588,3,3,96533,96535,96538,2,5,0
27589,1,1,96534,96538,96539,4,5,0
27590,3,1,96537,96539,96540,2,3,0
27591,5,1,96542,96542,96543,0,1,2
27592,4,1,96546,96546,96547,0,1,3
27593,5,1,96551,96551,96552,0,1,4
27594,2,3,96553,96553,96556,0,3,1
27595,5,1,96558,96558,96559,0,1,2
27596,5,2,96563,96563,96565,0,2,4
27597,2,2,96565,96565,96567,0,2,0
27598,6,2,96571,96571,96573,0,2,4
27599,4,1,96575,96575,96576,0,1,2
27600,3,1,96578,96578,96579,0,1,2
27601,5,3,96583,96583,96586,0,3,4
27602,2,3,96585,96586,96589,1,4,0
27603,2,3,96587,96589,96592,2,5,0
27604,3,2,96590,96592,96594,2,4,0
27605,3,3,96593,96594,96597,1,4,0
27606,4,3,96597,96597,96600,0,3,0
27607,3,1,96600,96600,96601,0,1,0
27608,5,2,96605,96605,96607,0,2,4
27609,5,3,96610,96610,96613,0,3,3
27610,1,1,96611,96613,96614,2,3,0
27611,4,3,96615,96615,96618,0,3,1
27612,2,1,96617,96618,96619,1,2,0
27613,3,3,96620,96620,96623,0,3,1
27614,2,1,96622,96623,96624,1,2,0
27615,3,1,96625,96625,96626,0,1,1
27616,5,2,96630,96630,96632,0,2,4
27617,4,3,96634,96634,96637,0,3,2
27618,6,3,96640,96640,96643,0,3,3
27619,5,3,96645,96645,96648,0,3,2
27620,6,2,96651,96651,96653,0,2,3
27621,3,1,96654,96654,96655,0,1,1
27622,6,1,96660,96660,96661,0,1,5
27623,6,1,96666,96666,96667,0,1,5
27624,4,2,96670,96670,96672,0,2,3
27625,5,1,96675,96675,96676,0,1,3
27626,1,2,96676,96676,96678,0,2,0
27627,4,3,96680,96680,96683,0,3,2
27628,4,1,96684,96684,96685,0,1,1
27629,5,3,96689,96689,96692,0,3,4
27630,3,1,96692,96692,96693,0,1,0
27631,5,3,96697,96697,96700,0,3,4
27632,2,3,96699,96700,96703,1,4,0
27633,4,1,96703,96703,96704,0,1,0
27634,3,1,96706,96706,96707,0,1,2
27635,2,2,96708,96708,96710,0,2,1
27636,5,3,96713,96713,96716,0,3,3
27637,5,3,96718,96718,96721,0,3,2
27638,5,1,96723,96723,96724,0,1,2
27639,2,1,96725,96725,96726,0,1,1
27640,6,2,96731,96731,96733,0,2,5
27641,6,1,96737,96737,96738,0,1,4
27642,2,2,96739,96739,96741,0,2,1
27643,3,2,96742,96742,96744,0,2,1
27644,2,1,96744,96744,96745,0,1,0
27645,2,2,96746,96746,96748,0,2,1
27646,2,3,96748,96748,96751,0,3,0
27647,3,2,96751,96751,96753,0,2,0
27648,2,3,96753,96753,96756,0,3,0
27649,5,1,96758,96758,96759,0,1,2
27650,3,1,96761,96761,96762,0,1,2
27651,6,1,96767,96767,96768,0,1,5
27652,3,2,96770,96770,96772,0,2,2
27653,5,3,96775,96775,96778,0,3,3
27654,6,2,96781,96781,96783,0,2,3
27655,4,2,96785,96785,96787,0,2,2
27656,4,2,96789,96789,96791,0,2,2
27657,3,3,96792,96792,96795,0,3,1
27658,5,1,96797,96797,96798,0,1,2
27659,2,2,96799,96799,96801,0,2,1
27660,4,1,96803,96803,96804,0,1,2
27661,1,2,96804,96804,96806,0,2,0
27662,1,2,96805,96806,96808,1,3,0
27663,5,2,96810,96810,96812,0,2,2
27664,2,1,96812,96812,96813,0,1,0
27665,5,1,96817,96817,96818,0,1,4
27666,3,2,96820,96820,96822,0,2,2
27667,2,2,96822,96822,96824,0,2,0
27668,5,2,96827,96827,96829,0,2,3
27669,6,2,96833,96833,96835,0,2,4
27670,2,1,96835,96835,96836,0,1,0
27671,3,2,96838,96838,96840,0,2,2
27672,6,1,96844,96844,96845,0,1,4
27673,2,3,96846,96846,96849,0,3,1
27674,1,1,96847,96849,96850,2,3,0
27675,5,2,96852,96852,96854,0,2,2
27676,5,3,96857,96857,96860,0,3,3
27677,2,3,96859,96860,96863,1,4,0
27678,3,2,96862,96863,96865,1,3,0
27679,6,2,96868,96868,96870,0,2,3
27680,5,3,96873,96873,96876,0,3,3
27681,5,2,96878,96878,96880,0,2,2
27682,2,3,96880,96880,96883,0,3,0
27683,5,1,96885,96885,96886,0,1,2
27684,6,2,96891,96891,96893,0,2,5
27685,5,3,96896,96896,96899,0,3,3
27686,3,1,96899,96899,96900,0,1,0
27687,1,1,96900,96900,96901,0,1,0
27688,2,3,96902,96902,96905,0,3,1
27689,6,1,96908,96908,96909,0,1,3
27690,4,1,96912,96912,96913,0,1,3
27691,5,2,96917,96917,96919,0,2,4
27692,6,2,96923,96923,96925,0,2,4
27693,3,1,96926,96926,96927,0,1,1
27694,6,3,96932,96932,96935,0,3,5
27695,6,1,96938,96938,96939,0,1,3
27696,5,3,96943,96943,96946,0,3,4
27697,2,1,96945,96946,96947,1,2,0
27698,4,1,96949,96949,96950,0,1,2
27699,5,2,96954,96954,96956,0,2,4
27700,2,3,96956,96956,96959,0,3,0
27701,2,1,96958,96959,96960,1,2,0
27702,6,1,96964,96964,96965,0,1,4
27703,2,1,96966,96966,96967,0,1,1
27704,6,1,96972,96972,96973,0,1,5
27705,1,1,96973,96973,96974,0,1,0
27706,1,1,96974,96974,96975,0,1,0
27707,3,3,96977,96977,96980,0,3,2
27708,3,2,96980,96980,96982,0,2,0
27709,4,1,96984,96984,96985,0,1,2
27710,5,3,96989,96989,96992,0,3,4
27711,6,2,96995,96995,96997,0,2,3
27712,5,1,97000,97000,97001,0,1,3
27713,3,3,97003,97003,97006,0,3,2
27714,3,1,97006,97006,97007,0,1,0
27715,5,2,97011,97011,97013,0,2,4
27716,3,2,97014,97014,97016,0,2,1
27717,3,3,97017,97017,97020,0,3,1
27718,4,2,97021,97021,97023,0,2,1
27719,4,2,97025,97025,97027,0,2,2
27720,4,2,97029,97029,97031,0,2,2
27721,1,3,97030,97031,97034,1,4,0
27722,5,3,97035,97035,97038,0,3,1
27723,4,1,97039,97039,97040,0,1,1
27724,6,2,97045,97045,97047,0,2,5
27725,6,1,97051,97051,97052,0,1,4
27726,6,1,97057,97057,97058,0,1,5
27727,1,1,97058,97058,97059,0,1,0
27728,6,3,97064,97064,97067,0,3,5
27729,2,1,97066,97067,97068,1,2,0
27730,2,2,97068,97068,97070,0,2,0
27731,3,1,97071,97071,97072,0,1,1
27732,1,2,97072,97072,97074,0,2,0
27733,3,2,97075,97075,97077,0,2,1
27734,1,1,97076,97077,97078,1,2,0
27735,1,1,97077,97078,97079,1,2,0
27736,6,2,97083,97083,97085,0,2,4
27737,1,2,97084,97085,97087,1,3,0
27738,2,1,97086,97087,97088,1,2,0
27739,6,1,97092,97092,97093,0,1,4
27740,6,2,97098,97098,97100,0,2,5
27741,2,3,97100,97100,97103,0,3,0
27742,3,3,97103,97103,97106,0,3,0
27743,5,2,97108,97108,97110,0,2,2
27744,1,2,97109,97110,97112,1,3,0
27745,4,3,97113,97113,97116,0,3,1
27746,2,1,97115,97116,97117,1,2,0
27747,6,1,97121,97121,97122,0,1,4
27748,6,3,97127,97127,97130,0,3,5
27749,3,1,97130,97130,97131,0,1,0
27750,5,3,97135,97135,97138,0,3,4
27751,6,1,97141,97141,97142,0,1,3
27752,3,3,97144,97144,97147,0,3,2
27753,1,3,97145,97147,97150,2,5,0
27754,3,2,97148,97150,97152,2,4,0
27755,3,3,97151,97152,97155,1,4,0
27756,4,2,97155,97155,97157,0,2,0
27757,5,1,97160,97160,97161,0,1,3
27758,4,3,97164,97164,97167,0,3,3
27759,4,3,97168,97168,97171,0,3,1
27760,2,1,97170,97171,97172,1,2,0
27761,4,1,97174,97174,97175,0,1,2
27762,6,1,97180,97180,97181,0,1,5
27763,3,3,97183,97183,97186,0,3,2
27764,4,1,97187,97187,97188,0,1,1
27765,1,3,97188,97188,97191,0,3,0
27766,6,1,97194,97194,97195,0,1,3
27767,5,1,97199,97199,97200,0,1,4
27768,1,3,97200,97200,97203,0,3,0
27769,2,3,97202,97203,97206,1,4,0
27770,1,2,97203,97206,97208,3,5,0
27771,5,1,97208,97208,97209,0,1,0
27772,1,2,97209,97209,97211,0,2,0
27773,4,2,97213,97213,97215,0,2,2
27774,6,2,97219,97219,97221,0,2,4
27775,2,1,97221,97221,97222,0,1,0
27776,3,3,97224,97224,97227,0,3,2
27777,1,2,97225,97227,97229,2,4,0
27778,2,1,97227,97229,97230,2,3,0
27779,6,2,97233,97233,97235,0,2,3
27780,5,2,97238,97238,97240,0,2,3
27781,6,3,97244,97244,97247,0,3,4
27782,6,2,97250,97250,97252,0,2,3
27783,6,2,97256,97256,97258,0,2,4
27784,6,1,97262,97262,97263,0,1,4
27785,1,1,97263,97263,97264,0,1,0
27786,3,2,97266,97266,97268,0,2,2
27787,1,3,97267,97268,97271,1,4,0
27788,4,2,97271,97271,97273,0,2,0
27789,2,2,97273,97273,97275,0,2,0
27790,2,3,97275,97275,97278,0,3,0
27791,3,3,97278,97278,97281,0,3,0
27792,5,3,97283,97283,97286,0,3,2
27793,4,2,97287,97287,97289,0,2,1
27794,2,2,97289,97289,97291,0,2,0
27795,4,2,97293,97293,97295,0,2,2
27796,6,3,97299,97299,97302,0,3,4
27797,2,3,97301,97302,97305,1,4,0
27798,4,1,97305,97305,97306,0,1,0
27799,4,1,97309,97309,97310,0,1,3
27800,3,1,97312,97312,97313,0,1,2
27801,2,1,97314,97314,97315,0,1,1
27802,5,1,97319,97319,97320,0,1,4
27803,4,3,97323,97323,97326,0,3,3
27804,5,3,97328,97328,97331,0,3,2
27805,4,1,97332,97332,97333,0,1,1
27806,4,3,97336,97336,97339,0,3,3
27807,4,3,97340,97340,97343,0,3,1
27808,4,3,97344,97344,97347,0,3,1
27809,3,1,97347,97347,97348,0,1,0
27810,4,3,97351,97351,97354,0,3,3
27811,3,3,97354,97354,97357,0,3,0
27812,2,3,97356,97357,97360,1,4,0
27813,5,2,97361,97361,97363,0,2,1
27814,1,3,97362,97363,97366,1,4,0
27815,5,2,97367,97367,97369,0,2,1
27816,6,3,97373,97373,97376,0,3,4
27817,4,2,97377,97377,97379,0,2,1
27818,6,3,97383,97383,97386,0,3,4
27819,5,2,97388,97388,97390,0,2,2
27820,1,2,97389,97390,97392,1,3,0
27821,5,1,97394,97394,97395,0,1,2
27822,1,3,97395,97395,97398,0,3,0
27823,4,1,97399,97399,97400,0,1,1
27824,4,1,97403,97403,97404,0,1,3
27825,5,2,97408,97408,97410,0,2,4
27826,6,1,97414,97414,97415,0,1,4
27827,6,3,97420,97420,97423,0,3,5
27828,3,2,97423,97423,97425,0,2,0
27829,4,1,97427,97427,97428,0,1,2
27830,2,2,97429,97429,97431,0,2,1
27831,5,1,97434,97434,97435,0,1,3
27832,4,1,97438,97438,97439,0,1,3
27833,5,2,97443,97443,97445,0,2,4
27834,4,3,97447,97447,97450,0,3,2
27835,6,3,97453,97453,97456,0,3,3
27836,3,2,97456,97456,97458,0,2,0
27837,6,2,97462,97462,97464,0,2,4
27838,5,2,97467,97467,97469,0,2,3
27839,4,2,97471,97471,97473,0,2,2
27840,6,2,97477,97477,97479,0,2,4
27841,1,1,97478,97479,97480,1,2,0
27842,3,2,97481,97481,97483,0,2,1
27843,5,2,97486,97486,97488,0,2,3
27844,1,3,97487,97488,97491,1,4,0
27845,6,1,97493,97493,97494,0,1,2
27846,6,2,97499,97499,97501,0,2,5
27847,5,2,97504,97504,97506,0,2,3
27848,1,1,97505,97506,97507,1,2,0
27849,2,1,97507,97507,97508,0,1,0
27850,2,3,97509,97509,97512,0,3,1
27851,3,2,97512,97512,97514,0,2,0
27852,5,2,97517,97517,97519,0,2,3
27853,5,3,97522,97522,97525,0,3,3
27854,1,3,97523,97525,97528,2,5,0
27855,1,2,97524,97528,97530,4,6,0
27856,3,1,97527,97530,97531,3,4,0
27857,5,3,97532,97532,97535,0,3,1
27858,5,1,97537,97537,97538,0,1,2
27859,3,1,97540,97540,97541,0,1,2
27860,6,2,97546,97546,97548,0,2,5
27861,6,2,97552,97552,97554,0,2,4
27862,1,1,97553,97554,97555,1,2,0
27863,5,1,97558,97558,97559,0,1,3
27864,1,1,97559,97559,97560,0,1,0
27865,4,1,97563,97563,97564,0,1,3
27866,1,1,97564,97564,97565,0,1,0
27867,5,2,97569,97569,97571,0,2,4
27868,5,1,97574,97574,97575,0,1,3
27869,3,3,97577,97577,97580,0,3,2
27870,6,3,97583,97583,97586,0,3,3
27871,2,2,97585,97586,97588,1,3,0
27872,5,3,97590,97590,97593,0,3,2
27873,3,3,97593,97593,97596,0,3,0
27874,5,1,97598,97598,97599,0,1,2
27875,3,1,97601,97601,97602,0,1,2
27876,1,3,97602,97602,97605,0,3,0
27877,6,1,97608,97608,97609,0,1,3
27878,4,2,97612,97612,97614,0,2,3
27879,5,3,97617,97617,97620,0,3,3
27880,3,1,97620,97620,97621,0,1,0
27881,2,2,97622,97622,97624,0,2,1
27882,5,1,97627,97627,97628,0,1,3
27883,1,3,97628,97628,97631,0,3,0
27884,4,1,97632,97632,97633,0,1,1
27885,5,3,97637,97637,97640,0,3,4
27886,1,2,97638,97640,97642,2,4,0
27887,4,1,97642,97642,97643,0,1,0
27888,2,1,97644,97644,97645,0,1,1
27889,5,3,97649,97649,97652,0,3,4
27890,5,1,97654,97654,97655,0,1,2
27891,3,3,97657,97657,97660,0,3,2
27892,5,3,97662,97662,97665,0,3,2
27893,4,3,97666,97666,97669,0,3,1
27894,3,3,97669,97669,97672,0,3,0
27895,6,3,97675,97675,97678,0,3,3
27896,3,2,97678,97678,97680,0,2,0
27897,5,1,97683,97683,97684,0,1,3
27898,6,2,97689,97689,97691,0,2,5
27899,5,2,97694,97694,97696,0,2,3
27900,1,3,97695,97696,97699,1,4,0
27901,2,3,97697,97699,97702,2,5,0
27902,6,2,97703,97703,97705,0,2,1
27903,4,1,97707,97707,97708,0,1,2
27904,1,1,97708,97708,97709,0,1,0
27905,4,2,97712,97712,97714,0,2,3
27906,5,3,97717,97717,97720,0,3,3
27907,6,3,97723,97723,97726,0,3,3
27908,2,3,97725,97726,97729,1,4,0
27909,6,2,97731,97731,97733,0,2,2
27910,2,2,97733,97733,97735,0,2,0
27911,1,2,97734,97735,97737,1,3,0
27912,5,3,97739,97739,97742,0,3,2
27913,4,3,97743,97743,97746,0,3,1
27914,2,1,97745,97746,97747,1,2,0
27915,1,2,97746,97747,97749,1,3,0
27916,3,1,97749,97749,97750,0,1,0
27917,3,1,97752,97752,97753,0,1,2
27918,6,2,97758,97758,97760,0,2,5
27919,1,1,97759,97760,97761,1,2,0
27920,4,2,97763,97763,97765,0,2,2
27921,5,1,97768,97768,97769,0,1,3
27922,6,2,97774,97774,97776,0,2,5
27923,1,3,97775,97776,97779,1,4,0
27924,1,1,97776,97779,97780,3,4,0
27925,5,2,97781,97781,97783,0,2,1
27926,2,1,97783,97783,97784,0,1,0
27927,4,2,97787,97787,97789,0,2,3
27928,5,2,97792,97792,97794,0,2,3
27929,3,1,97795,97795,97796,0,1,1
27930,1,3,97796,97796,97799,0,3,0
27931,6,1,97802,97802,97803,0,1,3
27932,2,3,97804,97804,97807,0,3,1
27933,6,1,97810,97810,97811,0,1,3
27934,6,1,97816,97816,97817,0,1,5
27935,2,2,97818,97818,97820,0,2,1
27936,4,1,97822,97822,97823,0,1,2
27937,6,1,97828,97828,97829,0,1,5
27938,5,2,97833,97833,97835,0,2,4
27939,6,3,97839,97839,97842,0,3,4
27940,2,3,97841,97842,97845,1,4,0
27941,1,3,97842,97845,97848,3,6,0
27942,2,1,97844,97848,97849,4,5,0
27943,4,2,97848,97849,97851,1,3,0
27944,5,2,97853,97853,97855,0,2,2
27945,3,1,97856,97856,97857,0,1,1
27946,1,3,97857,97857,97860,0,3,0
27947,4,1,97861,97861,97862,0,1,1
27948,2,3,97863,97863,97866,0,3,1
27949,1,1,97864,97866,97867,2,3,0
27950,3,2,97867,97867,97869,0,2,0
27951,2,2,97869,97869,97871,0,2,0
27952,3,3,97872,97872,97875,0,3,1
27953,4,3,97876,97876,97879,0,3,1
27954,5,3,97881,97881,97884,0,3,2
27955,4,2,97885,97885,97887,0,2,1
27956,6,1,97891,97891,97892,0,1,4
27957,3,1,97894,97894,97895,0,1,2
27958,4,2,97898,97898,97900,0,2,3
27959,2,1,97900,97900,97901,0,1,0
27960,4,1,97904,97904,97905,0,1,3
27961,2,3,97906,97906,97909,0,3,1
27962,6,2,97912,97912,97914,0,2,3
27963,3,3,97915,97915,97918,0,3,1
27964,2,2,97917,97918,97920,1,3,0
27965,2,1,97919,97920,97921,1,2,0
27966,2,3,97921,97921,97924,0,3,0
27967,6,1,97927,97927,97928,0,1,3
27968,1,2,97928,97928,97930,0,2,0
27969,2,2,97930,97930,97932,0,2,0
27970,3,1,97933,97933,97934,0,1,1
27971,3,3,97936,97936,97939,0,3,2
27972,5,2,97941,97941,97943,0,2,2
27973,6,1,97947,97947,97948,0,1,4
27974,1,1,97948,97948,97949,0,1,0
27975,2,2,97950,97950,97952,0,2,1
27976,5,1,97955,97955,97956,0,1,3
27977,4,2,97959,97959,97961,0,2,3
27978,6,3,97965,97965,97968,0,3,4
27979,4,2,97969,97969,97971,0,2,1
27980,2,3,97971,97971,97974,0,3,0
27981,3,3,97974,97974,97977,0,3,0
27982,3,3,97977,97977,97980,0,3,0
27983,3,2,97980,97980,97982,0,2,0
27984,5,1,97985,97985,97986,0,1,3
27985,6,1,97991,97991,97992,0,1,5
27986,1,1,97992,97992,97993,0,1,0
27987,3,1,97995,97995,97996,0,1,2
27988,5,3,98000,98000,98003,0,3,4
27989,6,1,98006,98006,98007,0,1,3
27990,2,1,98008,98008,98009,0,1,1
27991,2,1,98010,98010,98011,0,1,1
27992,3,3,98013,98013,98016,0,3,2
27993,1,2,98014,98016,98018,2,4,0
27994,1,2,98015,98018,98020,3,5,0
27995,2,3,98017,98020,98023,3,6,0
27996,1,3,98018,98023,98026,5,8,0
27997,6,2,98024,98026,98028,2,4,0
27998,2,2,98026,98028,98030,2,4,0
27999,1,2,98027,98030,98032,3,5,0
28000,6,1,98033,98033,98034,0,1,1
28001,3,3,98036,98036,98039,0,3,2
28002,5,3,98041,98041,98044,0,3,2
28003,6,3,98047,98047,98050,0,3,3
28004,1,1,98048,98050,98051,2,3,0
28005,3,2,98051,98051,98053,0,2,0
28006,1,2,98052,98053,98055,1,3,0
28007,3,3,98055,98055,98058,0,3,0
28008,1,2,98056,98058,98060,2,4,0
28009,5,2,98061,98061,98063,0,2,1
28010,3,3,98064,98064,98067,0,3,1
28011,5,1,98069,98069,98070,0,1,2
28012,5,1,98074,98074,98075,0,1,4
28013,3,3,98077,98077,98080,0,3,2
28014,6,1,98083,98083,98084,0,1,3
28015,3,1,98086,98086,98087,0,1,2
28016,3,2,98089,98089,98091,0,2,2
28017,6,2,98095,98095,98097,0,2,4
28018,2,1,98097,98097,98098,0,1,0
28019,4,2,98101,98101,98103,0,2,3
28020,1,2,98102,98103,98105,1,3,0
28021,1,3,98103,98105,98108,2,5,0
28022,4,3,98107,98108,98111,1,4,0
28023,4,1,98111,98111,98112,0,1,0
28024,4,2,98115,98115,98117,0,2,3
28025,6,1,98121,98121,98122,0,1,4
28026,3,2,98124,98124,98126,0,2,2
28027,1,3,98125,98126,98129,1,4,0
28028,1,1,98126,98129,98130,3,4,0
28029,3,3,98129,98130,98133,1,4,0
28030,3,1,98132,98133,98134,1,2,0
28031,4,2,98136,98136,98138,0,2,2
28032,4,1,98140,98140,98141,0,1,2
28033,4,3,98144,98144,98147,0,3,3
28034,4,3,98148,98148,98151,0,3,1
28035,1,1,98149,98151,98152,2,3,0
28036,6,3,98155,98155,98158,0,3,3
28037,2,2,98157,98158,98160,1,3,0
28038,6,1,98163,98163,98164,0,1,3
28039,1,1,98164,98164,98165,0,1,0
28040,1,1,98165,98165,98166,0,1,0
28041,5,1,98170,98170,98171,0,1,4
28042,6,1,98176,98176,98177,0,1,5
28043,1,1,98177,98177,98178,0,1,0
28044,4,2,98181,98181,98183,0,2,3
28045,6,3,98187,98187,98190,0,3,4
28046,1,1,98188,98190,98191,2,3,0
28047,3,1,98191,98191,98192,0,1,0
28048,5,3,98196,98196,98199,0,3,4
28049,1,3,98197,98199,98202,2,5,0
28050,6,3,98203,98203,98206,0,3,1
28051,5,1,98208,98208,98209,0,1,2
28052,2,3,98210,98210,98213,0,3,1
28053,4,1,98214,98214,98215,0,1,1
28054,6,2,98220,98220,98222,0,2,5
28055,1,1,98221,98222,98223,1,2,0
28056,2,3,98223,98223,98226,0,3,0
28057,5,1,98228,98228,98229,0,1,2
28058,5,3,98233,98233,98236,0,3,4
28059,3,1,98236,98236,98237,0,1,0
28060,2,2,98238,98238,98240,0,2,1
28061,4,3,98242,98242,98245,0,3,2
28062,2,3,98244,98245,98248,1,4,0
28063,6,2,98250,98250,98252,0,2,2
28064,3,1,98253,98253,98254,0,1,1
28065,6,2,98259,98259,98261,0,2,5
28066,6,3,98265,98265,98268,0,3,4
28067,3,3,98268,98268,98271,0,3,0
28068,6,3,98274,98274,98277,0,3,3
28069,6,1,98280,98280,98281,0,1,3
28070,1,2,98281,98281,98283,0,2,0
28071,1,3,98282,98283,98286,1,4,0
28072,4,3,98286,98286,98289,0,3,0
28073,2,1,98288,98289,98290,1,2,0
28074,2,1,98290,98290,98291,0,1,0
28075,1,2,98291,98291,98293,0,2,0
28076,4,2,98295,98295,98297,0,2,2
28077,3,2,98298,98298,98300,0,2,1
28078,5,3,98303,98303,98306,0,3,3
28079,2,3,98305,98306,98309,1,4,0
28080,4,1,98309,98309,98310,0,1,0
28081,5,2,98314,98314,98316,0,2,4
28082,1,2,98315,98316,98318,1,3,0
28083,5,1,98320,98320,98321,0,1,2
28084,6,3,98326,98326,98329,0,3,5
28085,5,2,98331,98331,98333,0,2,2
28086,4,3,98335,98335,98338,0,3,2
28087,1,2,98336,98338,98340,2,4,0
28088,6,2,98342,98342,98344,0,2,2
28089,4,3,98346,98346,98349,0,3,2
28090,2,3,98348,98349,98352,1,4,0
28091,5,1,98353,98353,98354,0,1,1
28092,3,2,98356,98356,98358,0,2,2
28093,3,3,98359,98359,98362,0,3,1
28094,5,3,98364,98364,98367,0,3,2
28095,5,2,98369,98369,98371,0,2,2
28096,5,3,98374,98374,98377,0,3,3
28097,5,2,98379,98379,98381,0,2,2
28098,3,1,98382,98382,98383,0,1,1
28099,5,2,98387,98387,98389,0,2,4
28100,1,1,98388,98389,98390,1,2,0
28101,6,2,98394,98394,98396,0,2,4
28102,4,1,98398,98398,98399,0,1,2
28103,2,2,98400,98400,98402,0,2,1
28104,3,2,98403,98403,98405,0,2,1
28105,2,2,98405,98405,98407,0,2,0
28106,4,3,98409,98409,98412,0,3,2
28107,3,1,98412,98412,98413,0,1,0
28108,4,2,98416,98416,98418,0,2,3
28109,1,3,98417,98418,98421,1,4,0
28110,4,2,98421,98421,98423,0,2,0
28111,2,3,98423,98423,98426,0,3,0
28112,4,3,98427,98427,98430,0,3,1
28113,4,3,98431,98431,98434,0,3,1
28114,4,3,98435,98435,98438,0,3,1
28115,6,1,98441,98441,98442,0,1,3
28116,1,1,98442,98442,98443,0,1,0
28117,2,2,98444,98444,98446,0,2,1
28118,6,1,98450,98450,98451,0,1,4
28119,2,2,98452,98452,98454,0,2,1
28120,4,1,98456,98456,98457,0,1,2
28121,5,1,98461,98461,98462,0,1,4
28122,3,3,98464,98464,98467,0,3,2
28123,4,1,98468,98468,98469,0,1,1
28124,5,2,98473,98473,98475,0,2,4
28125,2,3,98475,98475,98478,0,3,0
28126,6,3,98481,98481,98484,0,3,3
28127,3,3,98484,98484,98487,0,3,0
28128,5,3,98489,98489,98492,0,3,2
28129,3,3,98492,98492,98495,0,3,0
28130,3,2,98495,98495,98497,0,2,0
28131,1,1,98496,98497,98498,1,2,0
28132,5,2,98501,98501,98503,0,2,3
28133,2,3,98503,98503,98506,0,3,0
28134,1,2,98504,98506,98508,2,4,0
28135,1,1,98505,98508,98509,3,4,0
28136,6,3,98511,98511,98514,0,3,2
28137,1,1,98512,98514,98515,2,3,0
28138,3,3,98515,98515,98518,0,3,0
28139,1,1,98516,98518,98519,2,3,0
28140,5,2,98521,98521,98523,0,2,2
28141,3,3,98524,98524,98527,0,3,1
28142,6,3,98530,98530,98533,0,3,3
28143,6,1,98536,98536,98537,0,1,3
28144,5,1,98541,98541,98542,0,1,4
28145,1,2,98542,98542,98544,0,2,0
28146,3,1,98545,98545,98546,0,1,1
28147,6,2,98551,98551,98553,0,2,5
28148,6,2,98557,98557,98559,0,2,4
28149,1,2,98558,98559,98561,1,3,0
28150,3,3,98561,98561,98564,0,3,0
28151,5,3,98566,98566,98569,0,3,2
28152,4,1,98570,98570,98571,0,1,1
28153,5,3,98575,98575,98578,0,3,4
28154,6,2,98581,98581,98583,0,2,3
28155,5,3,98586,98586,98589,0,3,3
28156,3,3,98589,98589,98592,0,3,0
28157,6,3,98595,98595,98598,0,3,3
28158,5,3,98600,98600,98603,0,3,2
28159,4,2,98604,98604,98606,0,2,1
28160,5,1,98609,98609,98610,0,1,3
28161,4,1,98613,98613,98614,0,1,3
28162,1,3,98614,98614,98617,0,3,0
28163,3,2,98617,98617,98619,0,2,0
28164,4,3,98621,98621,98624,0,3,2
28165,2,2,98623,98624,98626,1,3,0
28166,6,2,98629,98629,98631,0,2,3
28167,1,1,98630,98631,98632,1,2,0
28168,5,1,98635,98635,98636,0,1,3
28169,2,1,98637,98637,98638,0,1,1
28170,2,1,98639,98639,98640,0,1,1
28171,5,1,98644,98644,98645,0,1,4
28172,6,1,98650,98650,98651,0,1,5
28173,3,3,98653,98653,98656,0,3,2
28174,5,1,98658,98658,98659,0,1,2
28175,4,1,98662,98662,98663,0,1,3
28176,1,3,98663,98663,98666,0,3,0
28177,1,2,98664,98666,98668,2,4,0
28178,3,1,98667,98668,98669,1,2,0
28179,5,3,98672,98672,98675,0,3,3
28180,4,3,98676,98676,98679,0,3,1
28181,2,3,98678,98679,98682,1,4,0
28182,2,2,98680,98682,98684,2,4,0
28183,4,2,98684,98684,98686,0,2,0
28184,3,2,98687,98687,98689,0,2,1
28185,3,3,98690,98690,98693,0,3,1
28186,1,2,98691,98693,98695,2,4,0
28187,2,3,98693,98695,98698,2,5,0
28188,4,1,98697,98698,98699,1,2,0
28189,4,1,98701,98701,98702,0,1,2
28190,5,3,98706,98706,98709,0,3,4
28191,5,3,98711,98711,98714,0,3,2
28192,5,2,98716,98716,98718,0,2,2
28193,6,1,98722,98722,98723,0,1,4
28194,5,1,98727,98727,98728,0,1,4
28195,5,3,98732,98732,98735,0,3,4
28196,5,2,98737,98737,98739,0,2,2
28197,5,2,98742,98742,98744,0,2,3
28198,2,1,98744,98744,98745,0,1,0
28199,6,2,98750,98750,98752,0,2,5
28200,6,3,98756,98756,98759,0,3,4
28201,5,3,98761,98761,98764,0,3,2
28202,1,2,98762,98764,98766,2,4,0
28203,3,2,98765,98766,98768,1,3,0
28204,6,2,98771,98771,98773,0,2,3
28205,5,2,98776,98776,98778,0,2,3
28206,4,3,98780,98780,98783,0,3,2
28207,4,2,98784,98784,98786,0,2,1
28208,5,1,98789,98789,98790,0,1,3
28209,3,3,98792,98792,98795,0,3,2
28210,2,1,98794,98795,98796,1,2,0
28211,2,1,98796,98796,98797,0,1,0
28212,1,1,98797,98797,98798,0,1,0
28213,3,2,98800,98800,98802,0,2,2
28214,3,3,98803,98803,98806,0,3,1
28215,3,1,98806,98806,98807,0,1,0
28216,2,2,98808,98808,98810,0,2,1
28217,5,2,98813,98813,98815,0,2,3
28218,2,1,98815,98815,98816,0,1,0
28219,5,1,98820,98820,98821,0,1,4
28220,1,3,98821,98821,98824,0,3,0
28221,1,2,98822,98824,98826,2,4,0
28222,4,3,98826,98826,98829,0,3,0
28223,3,1,98829,98829,98830,0,1,0
28224,4,1,98833,98833,98834,0,1,3
28225,3,3,98836,98836,98839,0,3,2
28226,4,3,98840,98840,98843,0,3,1
28227,1,2,98841,98843,98845,2,4,0
28228,6,2,98847,98847,98849,0,2,2
28229,1,2,98848,98849,98851,1,3,0
28230,2,2,98850,98851,98853,1,3,0
28231,2,3,98852,98853,98856,1,4,0
28232,4,1,98856,98856,98857,0,1,0
28233,1,3,98857,98857,98860,0,3,0
28234,2,1,98859,98860,98861,1,2,0
28235,1,3,98860,98861,98864,1,4,0
28236,1,3,98861,98864,98867,3,6,0
28237,1,1,98862,98867,98868,5,6,0
28238,3,2,98865,98868,98870,3,5,0
28239,6,2,98871,98871,98873,0,2,1
28240,5,3,98876,98876,98879,0,3,3
28241,3,2,98879,98879,98881,0,2,0
28242,5,1,98884,98884,98885,0,1,3
28243,4,2,98888,98888,98890,0,2,3
28244,3,2,98891,98891,98893,0,2,1
28245,5,1,98896,98896,98897,0,1,3
28246,1,1,98897,98897,98898,0,1,0
28247,6,2,98903,98903,98905,0,2,5
28248,4,1,98907,98907,98908,0,1,2
28249,2,3,98909,98909,98912,0,3,1
28250,4,2,98913,98913,98915,0,2,1
28251,3,2,98916,98916,98918,0,2,1
28252,4,3,98920,98920,98923,0,3,2
28253,6,3,98926,98926,98929,0,3,3
28254,1,3,98927,98929,98932,2,5,0
28255,4,3,98931,98932,98935,1,4,0
28256,2,2,98933,98935,98937,2,4,0
28257,6,3,98939,98939,98942,0,3,2
28258,5,3,98944,98944,98947,0,3,2
28259,3,1,98947,98947,98948,0,1,0
28260,2,3,98949,98949,98952,0,3,1
28261,2,3,98951,98952,98955,1,4,0
28262,5,3,98956,98956,98959,0,3,1
28263,4,3,98960,98960,98963,0,3,1
28264,5,1,98965,98965,98966,0,1,2
28265,2,2,98967,98967,98969,0,2,1
28266,1,3,98968,98969,98972,1,4,0
28267,2,3,98970,98972,98975,2,5,0
28268,2,2,98972,98975,98977,3,5,0
28269,1,1,98973,98977,98978,4,5,0
28270,6,2,98979,98979,98981,0,2,1
28271,2,2,98981,98981,98983,0,2,0
28272,4,3,98985,98985,98988,0,3,2
28273,1,2,98986,98988,98990,2,4,0
28274,4,2,98990,98990,98992,0,2,0
28275,5,3,98995,98995,98998,0,3,3
28276,1,1,98996,98998,98999,2,3,0
28277,1,1,98997,98999,99000,2,3,0
28278,4,1,99001,99001,99002,0,1,1
28279,6,3,99007,99007,99010,0,3,5
28280,5,3,99012,99012,99015,0,3,2
28281,5,2,99017,99017,99019,0,2,2
28282,3,3,99020,99020,99023,0,3,1
28283,6,3,99026,99026,99029,0,3,3
28284,4,2,99030,99030,99032,0,2,1
28285,3,3,99033,99033,99036,0,3,1
28286,3,1,99036,99036,99037,0,1,0
28287,5,1,99041,99041,99042,0,1,4
28288,5,1,99046,99046,99047,0,1,4
28289,2,1,99048,99048,99049,0,1,1
28290,3,3,99051,99051,99054,0,3,2
28291,1,2,99052,99054,99056,2,4,0
28292,2,2,99054,99056,99058,2,4,0
28293,2,1,99056,99058,99059,2,3,0
28294,2,3,99058,99059,99062,1,4,0
28295,4,2,99062,99062,99064,0,2,0
28296,5,3,99067,99067,99070,0,3,3
28297,1,2,99068,99070,99072,2,4,0
28298,6,3,99074,99074,99077,0,3,2
28299,5,1,99079,99079,99080,0,1,2
28300,6,1,99085,99085,99086,0,1,5
28301,3,1,99088,99088,99089,0,1,2
28302,3,1,99091,99091,99092,0,1,2
28303,4,3,99095,99095,99098,0,3,3
28304,3,3,99098,99098,99101,0,3,0
28305,5,1,99103,99103,99104,0,1,2
28306,6,2,99109,99109,99111,0,2,5
28307,5,2,99114,99114,99116,0,2,3
28308,2,3,99116,99116,99119,0,3,0
28309,5,1,99121,99121,99122,0,1,2
28310,3,1,99124,99124,99125,0,1,2
28311,6,3,99130,99130,99133,0,3,5
28312,4,3,99134,99134,99137,0,3,1
28313,3,2,99137,99137,99139,0,2,0
28314,2,2,99139,99139,99141,0,2,0
28315,3,1,99142,99142,99143,0,1,1
28316,2,2,99144,99144,99146,0,2,1
28317,1,2,99145,99146,99148,1,3,0
28318,5,1,99150,99150,99151,0,1,2
28319,5,2,99155,99155,99157,0,2,4
28320,3,2,99158,99158,99160,0,2,1
28321,2,2,99160,99160,99162,0,2,0
28322,5,3,99165,99165,99168,0,3,3
28323,2,1,99167,99168,99169,1,2,0
28324,3,2,99170,99170,99172,0,2,1
28325,2,1,99172,99172,99173,0,1,0
28326,6,1,99178,99178,99179,0,1,5
28327,2,1,99180,99180,99181,0,1,1
28328,5,1,99185,99185,99186,0,1,4
28329,2,3,99187,99187,99190,0,3,1
28330,3,3,99190,99190,99193,0,3,0
28331,2,3,99192,99193,99196,1,4,0
28332,5,3,99197,99197,99200,0,3,1
28333,2,1,99199,99200,99201,1,2,0
28334,3,3,99202,99202,99205,0,3,1
28335,2,1,99204,99205,99206,1,2,0
28336,3,3,99207,99207,99210,0,3,1
28337,1,1,99208,99210,99211,2,3,0
28338,3,3,99211,99211,99214,0,3,0
28339,5,2,99216,99216,99218,0,2,2
28340,5,3,99221,99221,99224,0,3,3
28341,3,3,99224,99224,99227,0,3,0
28342,6,2,99230,99230,99232,0,2,3
28343,5,2,99235,99235,99237,0,2,3
28344,3,1,99238,99238,99239,0,1,1
28345,2,1,99240,99240,99241,0,1,1
28346,5,1,99245,99245,99246,0,1,4
28347,4,2,99249,99249,99251,0,2,3
28348,2,3,99251,99251,99254,0,3,0
28349,4,1,99255,99255,99256,0,1,1
28350,5,2,99260,99260,99262,0,2,4
28351,2,1,99262,99262,99263,0,1,0
28352,4,3,99266,99266,99269,0,3,3
28353,2,1,99268,99269,99270,1,2,0
28354,3,1,99271,99271,99272,0,1,1
28355,2,2,99273,99273,99275,0,2,1
28356,2,2,99275,99275,99277,0,2,0
28357,4,1,99279,99279,99280,0,1,2
28358,5,3,99284,99284,99287,0,3,4
28359,2,1,99286,99287,99288,1,2,0
28360,4,2,99290,99290,99292,0,2,2
28361,3,1,99293,99293,99294,0,1,1
28362,4,3,99297,99297,99300,0,3,3
28363,3,3,99300,99300,99303,0,3,0
28364,2,3,99302,99303,99306,1,4,0
28365,1,3,99303,99306,99309,3,6,0
28366,1,2,99304,99309,99311,5,7,0
28367,2,1,99306,99311,99312,5,6,0
28368,1,1,99307,99312,99313,5,6,0
28369,4,3,99311,99313,99316,2,5,0
28370,5,2,99316,99316,99318,0,2,0
28371,6,1,99322,99322,99323,0,1,4
28372,1,3,99323,99323,99326,0,3,0
28373,5,3,99328,99328,99331,0,3,2
28374,1,1,99329,99331,99332,2,3,0
28375,5,3,99334,99334,99337,0,3,2
28376,4,1,99338,99338,99339,0,1,1
28377,1,2,99339,99339,99341,0,2,0
28378,3,1,99342,99342,99343,0,1,1
28379,5,2,99347,99347,99349,0,2,4
28380,3,1,99350,99350,99351,0,1,1
28381,6,3,99356,99356,99359,0,3,5
28382,5,1,99361,99361,99362,0,1,2
28383,5,2,99366,99366,99368,0,2,4
28384,3,2,99369,99369,99371,0,2,1
28385,2,1,99371,99371,99372,0,1,0
28386,1,1,99372,99372,99373,0,1,0
28387,6,2,99378,99378,99380,0,2,5
28388,1,1,99379,99380,99381,1,2,0
28389,4,1,99383,99383,99384,0,1,2
28390,6,2,99389,99389,99391,0,2,5
28391,2,3,99391,99391,99394,0,3,0
28392,2,2,99393,99394,99396,1,3,0
28393,3,2,99396,99396,99398,0,2,0
28394,1,3,99397,99398,99401,1,4,0
28395,5,2,99402,99402,99404,0,2,1
28396,1,2,99403,99404,99406,1,3,0
28397,3,2,99406,99406,99408,0,2,0
28398,3,1,99409,99409,99410,0,1,1
28399,5,1,99414,99414,99415,0,1,4
28400,4,1,99418,99418,99419,0,1,3
28401,5,3,99423,99423,99426,0,3,4
28402,5,1,99428,99428,99429,0,1,2
28403,5,2,99433,99433,99435,0,2,4
28404,4,2,99437,99437,99439,0,2,2
28405,4,1,99441,99441,99442,0,1,2
28406,4,2,99445,99445,99447,0,2,3
28407,2,3,99447,99447,99450,0,3,0
28408,4,1,99451,99451,99452,0,1,1
28409,5,1,99456,99456,99457,0,1,4
28410,3,3,99459,99459,99462,0,3,2
28411,5,3,99464,99464,99467,0,3,2
28412,6,1,99470,99470,99471,0,1,3
28413,5,3,99475,99475,99478,0,3,4
28414,4,2,99479,99479,99481,0,2,1
28415,2,3,99481,99481,99484,0,3,0
28416,5,3,99486,99486,99489,0,3,2
28417,5,3,99491,99491,99494,0,3,2
28418,5,3,99496,99496,99499,0,3,2
28419,4,2,99500,99500,99502,0,2,1
28420,2,1,99502,99502,99503,0,1,0
28421,1,2,99503,99503,99505,0,2,0
28422,6,3,99509,99509,99512,0,3,4
28423,3,1,99512,99512,99513,0,1,0
28424,3,1,99515,99515,99516,0,1,2
28425,6,3,99521,99521,99524,0,3,5
28426,6,1,99527,99527,99528,0,1,3
28427,4,3,99531,99531,99534,0,3,3
28428,5,3,99536,99536,99539,0,3,2
28429,1,3,99537,99539,99542,2,5,0
28430,5,3,99542,99542,99545,0,3,0
28431,5,1,99547,99547,99548,0,1,2
28432,6,2,99553,99553,99555,0,2,5
28433,5,1,99558,99558,99559,0,1,3
28434,5,3,99563,99563,99566,0,3,4
28435,6,1,99569,99569,99570,0,1,3
28436,6,3,99575,99575,99578,0,3,5
28437,5,3,99580,99580,99583,0,3,2
28438,6,2,99586,99586,99588,0,2,3
28439,2,2,99588,99588,99590,0,2,0
28440,5,2,99593,99593,99595,0,2,3
28441,4,2,99597,99597,99599,0,2,2
28442,4,1,99601,99601,99602,0,1,2
28443,6,2,99607,99607,99609,0,2,5
28444,6,2,99613,99613,99615,0,2,4
28445,4,1,99617,99617,99618,0,1,2
28446,4,1,99621,99621,99622,0,1,3
28447,3,2,99624,99624,99626,0,2,2
28448,1,2,99625,99626,99628,1,3,0
28449,3,3,99628,99628,99631,0,3,0
28450,1,2,99629,99631,99633,2,4,0
28451,4,2,99633,99633,99635,0,2,0
28452,2,2,99635,99635,99637,0,2,0
28453,4,2,99639,99639,99641,0,2,2
28454,5,1,99644,99644,99645,0,1,3
28455,4,3,99648,99648,99651,0,3,3
28456,6,2,99654,99654,99656,0,2,3
28457,2,3,99656,99656,99659,0,3,0
28458,4,1,99660,99660,99661,0,1,1
28459,3,2,99663,99663,99665,0,2,2
28460,6,3,99669,99669,99672,0,3,4
28461,3,3,99672,99672,99675,0,3,0
28462,5,1,99677,99677,99678,0,1,2
28463,4,1,99681,99681,99682,0,1,3
28464,6,1,99687,99687,99688,0,1,5
28465,3,1,99690,99690,99691,0,1,2
28466,4,2,99694,99694,99696,0,2,3
28467,6,3,99700,99700,99703,0,3,4
28468,1,3,99701,99703,99706,2,5,0
28469,4,2,99705,99706,99708,1,3,0
28470,5,3,99710,99710,99713,0,3,2
28471,2,1,99712,99713,99714,1,2,0
28472,3,3,99715,99715,99718,0,3,1
28473,3,3,99718,99718,99721,0,3,0
28474,1,2,99719,99721,99723,2,4,0
28475,2,3,99721,99723,99726,2,5,0
28476,3,3,99724,99726,99729,2,5,0
28477,6,1,99730,99730,99731,0,1,1
28478,3,1,99733,99733,99734,0,1,2
28479,3,2,99736,99736,99738,0,2,2
28480,6,1,99742,99742,99743,0,1,4
28481,6,1,99748,99748,99749,0,1,5
28482,6,1,99754,99754,99755,0,1,5
28483,5,1,99759,99759,99760,0,1,4
28484,4,1,99763,99763,99764,0,1,3
28485,2,1,99765,99765,99766,0,1,1
28486,5,3,99770,99770,99773,0,3,4
28487,3,1,99773,99773,99774,0,1,0
28488,5,2,99778,99778,99780,0,2,4
28489,2,2,99780,99780,99782,0,2,0
28490,4,3,99784,99784,99787,0,3,2
28491,4,2,99788,99788,99790,0,2,1
28492,5,2,99793,99793,99795,0,2,3
28493,5,2,99798,99798,99800,0,2,3
28494,1,1,99799,99800,99801,1,2,0
28495,5,3,99804,99804,99807,0,3,3
28496,3,1,99807,99807,99808,0,1,0
28497,3,3,99810,99810,99813,0,3,2
28498,1,1,99811,99813,99814,2,3,0
28499,2,3,99813,99814,99817,1,4,0
28500,2,3,99815,99817,99820,2,5,0
28501,3,3,99818,99820,99823,2,5,0
28502,5,2,99823,99823,99825,0,2,0
28503,1,3,99824,99825,99828,1,4,0
28504,1,3,99825,99828,99831,3,6,0
28505,3,1,99828,99831,99832,3,4,0
28506,2,2,99830,99832,99834,2,4,0
28507,2,3,99832,99834,99837,2,5,0
28508,2,1,99834,99837,99838,3,4,0
28509,3,3,99837,99838,99841,1,4,0
28510,1,2,99838,99841,99843,3,5,0
28511,1,2,99839,99843,99845,4,6,0
28512,1,1,99840,99845,99846,5,6,0
28513,5,3,99845,99846,99849,1,4,0
28514,2,1,99847,99849,99850,2,3,0
28515,6,2,99853,99853,99855,0,2,3
28516,6,2,99859,99859,99861,0,2,4
28517,6,1,99865,99865,99866,0,1,4
28518,1,1,99866,99866,99867,0,1,0
28519,5,3,99871,99871,99874,0,3,4
28520,3,3,99874,99874,99877,0,3,0
28521,5,2,99879,99879,99881,0,2,2
28522,3,3,99882,99882,99885,0,3,1
28523,6,3,99888,99888,99891,0,3,3
28524,5,2,99893,99893,99895,0,2,2
28525,2,2,99895,99895,99897,0,2,0
28526,6,2,99901,99901,99903,0,2,4
28527,6,2,99907,99907,99909,0,2,4
28528,6,2,99913,99913,99915,0,2,4
28529,3,2,99916,99916,99918,0,2,1
28530,2,1,99918,99918,99919,0,1,0
28531,5,1,99923,99923,99924,0,1,4
28532,5,3,99928,99928,99931,0,3,4
28533,5,1,99933,99933,99934,0,1,2
28534,4,2,99937,99937,99939,0,2,3
28535,1,2,99938,99939,99941,1,3,0
28536,4,3,99942,99942,99945,0,3,1
28537,6,2,99948,99948,99950,0,2,3
28538,5,2,99953,99953,99955,0,2,3
28539,2,1,99955,99955,99956,0,1,0
28540,1,3,99956,99956,99959,0,3,0
28541,4,2,99960,99960,99962,0,2,1
28542,2,1,99962,99962,99963,0,1,0
28543,5,2,99967,99967,99969,0,2,4
28544,1,2,99968,99969,99971,1,3,0
28545,3,2,99971,99971,99973,0,2,0
28546,5,1,99976,99976,99977,0,1,3
28547,4,1,99980,99980,99981,0,1,3
28548,5,1,99985,99985,99986,0,1,4
28549,1,1,99986,99986,99987,0,1,0
28550,5,2,99991,99991,99993,0,2,4
28551,2,3,99993,99993,99996,0,3,0
28552,4,1,99997,99997,99998,0,1,1
28553,2,3,99999,99999,100002,0,3,1
28554,1,1,100000,100002,100003,2,3,0
28555,4,3,100004,100004,100007,0,3,1
28556,1,2,100005,100007,100009,2,4,0
28557,2,3,100007,100009,100012,2,5,0
28558,3,1,100010,100012,100013,2,3,0
28559,3,2,100013,100013,100015,0,2,0
28560,5,3,100018,100018,100021,0,3,3
28561,5,3,100023,100023,100026,0,3,2
28562,6,1,100029,100029,100030,0,1,3
28563,1,1,100030,100030,100031,0,1,0
28564,2,3,100032,100032,100035,0,3,1
28565,1,2,100033,100035,100037,2,4,0
28566,1,1,100034,100037,100038,3,4,0
28567,3,3,100037,100038,100041,1,4,0
28568,3,3,100040,100041,100044,1,4,0
28569,2,3,100042,100044,100047,2,5,0
28570,5,1,100047,100047,100048,0,1,0
28571,2,1,100049,100049,100050,0,1,1
28572,4,3,100053,100053,100056,0,3,3
28573,1,2,100054,100056,100058,2,4,0
28574,3,3,100057,100058,100061,1,4,0
28575,6,1,100063,100063,100064,0,1,2
28576,1,3,100064,100064,100067,0,3,0
28577,5,2,100069,100069,100071,0,2,2
28578,2,3,100071,100071,100074,0,3,0
28579,5,3,100076,100076,100079,0,3,2
28580,2,1,100078,100079,100080,1,2,0
28581,4,2,100082,100082,100084,0,2,2
28582,4,1,100086,100086,100087,0,1,2
28583,3,1,100089,100089,100090,0,1,2
28584,6,2,100095,100095,100097,0,2,5
28585,2,1,100097,100097,100098,0,1,0
28586,4,2,100101,100101,100103,0,2,3
28587,1,3,100102,100103,100106,1,4,0
28588,4,1,100106,100106,100107,0,1,0
28589,6,3,100112,100112,100115,0,3,5
28590,6,2,100118,100118,100120,0,2,3
28591,3,2,100121,100121,100123,0,2,1
28592,5,2,100126,100126,100128,0,2,3
28593,2,2,100128,100128,100130,0,2,0
28594,1,3,100129,100130,100133,1,4,0
28595,2,3,100131,100133,100136,2,5,0
28596,1,2,100132,100136,100138,4,6,0
28597,3,3,100135,100138,100141,3,6,0
28598,4,3,100139,100141,100144,2,5,0
28599,1,1,100140,100144,100145,4,5,0
28600,5,1,100145,100145,100146,0,1,0
28601,5,3,100150,100150,100153,0,3,4
28602,2,3,100152,100153,100156,1,4,0
28603,3,2,100155,100156,100158,1,3,0
28604,5,2,100160,100160,100162,0,2,2
28605,6,3,100166,100166,100169,0,3,4
28606,3,2,100169,100169,100171,0,2,0
28607,2,2,100171,100171,100173,0,2,0
28608,6,1,100177,100177,100178,0,1,4
28609,4,3,100181,100181,100184,0,3,3
28610,6,1,100187,100187,100188,0,1,3
28611,2,3,100189,100189,100192,0,3,1
28612,6,3,100195,100195,100198,0,3,3
28613,4,3,100199,100199,100202,0,3,1
28614,3,3,100202,100202,100205,0,3,0
28615,5,3,100207,100207,100210,0,3,2
28616,1,1,100208,100210,100211,2,3,0
28617,1,1,100209,100211,100212,2,3,0
28618,3,1,100212,100212,100213,0,1,0
28619,2,2,100214,100214,100216,0,2,1
28620,5,1,100219,100219,100220,0,1,3
28621,1,3,100220,100220,100223,0,3,0
28622,2,3,100222,100223,100226,1,4,0
28623,6,2,100228,100228,100230,0,2,2
28624,1,2,100229,100230,100232,1,3,0
28625,6,3,100235,100235,100238,0,3,3
28626,1,1,100236,100238,100239,2,3,0
28627,1,2,100237,100239,100241,2,4,0
28628,4,2,100241,100241,100243,0,2,0
28629,1,3,100242,100243,100246,1,4,0
28630,3,2,100245,100246,100248,1,3,0
28631,2,2,100247,100248,100250,1,3,0
28632,5,2,100252,100252,100254,0,2,2
28633,2,1,100254,100254,100255,0,1,0
28634,5,2,100259,100259,100261,0,2,4
28635,1,1,100260,100261,100262,1,2,0
28636,5,2,100265,100265,100267,0,2,3
28637,4,2,100269,100269,100271,0,2,2
28638,4,1,100273,100273,100274,0,1,2
28639,2,2,100275,100275,100277,0,2,1
28640,2,1,100277,100277,100278,0,1,0
28641,3,1,100280,100280,100281,0,1,2
28642,6,3,100286,100286,100289,0,3,5
28643,5,3,100291,100291,100294,0,3,2
28644,3,3,100294,100294,100297,0,3,0
28645,6,1,100300,100300,100301,0,1,3
28646,6,1,100306,100306,100307,0,1,5
28647,1,1,100307,100307,100308,0,1,0
28648,5,2,100312,100312,100314,0,2,4
28649,5,1,100317,100317,100318,0,1,3
28650,2,2,100319,100319,100321,0,2,1
28651,1,1,100320,100321,100322,1,2,0
28652,6,3,100326,100326,100329,0,3,4
28653,1,2,100327,100329,100331,2,4,0
28654,2,3,100329,100331,100334,2,5,0
28655,5,3,100334,100334,100337,0,3,0
28656,5,2,100339,100339,100341,0,2,2
28657,5,1,100344,100344,100345,0,1,3
28658,3,2,100347,100347,100349,0,2,2
28659,6,3,100353,100353,100356,0,3,4
28660,4,2,100357,100357,100359,0,2,1
28661,5,3,100362,100362,100365,0,3,3
28662,3,1,100365,100365,100366,0,1,0
28663,5,3,100370,100370,100373,0,3,4
28664,6,1,100376,100376,100377,0,1,3
28665,3,3,100379,100379,100382,0,3,2
28666,1,2,100380,100382,100384,2,4,0
28667,5,2,100385,100385,100387,0,2,1
28668,1,1,100386,100387,100388,1,2,0
28669,5,3,100391,100391,100394,0,3,3
28670,3,2,100394,100394,100396,0,2,0
28671,2,2,100396,100396,100398,0,2,0
28672,6,3,100402,100402,100405,0,3,4
28673,1,3,100403,100405,100408,2,5,0
28674,5,3,100408,100408,100411,0,3,0
28675,5,2,100413,100413,100415,0,2,2
28676,6,2,100419,100419,100421,0,2,4
28677,3,3,100422,100422,100425,0,3,1
28678,6,1,100428,100428,100429,0,1,3
28679,3,1,100431,100431,100432,0,1,2
28680,3,2,100434,100434,100436,0,2,2
28681,6,3,100440,100440,100443,0,3,4
28682,6,3,100446,100446,100449,0,3,3
28683,5,3,100451,100451,100454,0,3,2
28684,5,1,100456,100456,100457,0,1,2
28685,1,3,100457,100457,100460,0,3,0
28686,5,1,100462,100462,100463,0,1,2
28687,6,1,100468,100468,100469,0,1,5
28688,2,2,100470,100470,100472,0,2,1
28689,2,1,100472,100472,100473,0,1,0
28690,6,3,100478,100478,100481,0,3,5
28691,2,3,100480,100481,100484,1,4,0
28692,2,2,100482,100484,100486,2,4,0
28693,5,3,100487,100487,100490,0,3,1
28694,6,1,100493,100493,100494,0,1,3
28695,4,1,100497,100497,100498,0,1,3
28696,2,1,100499,100499,100500,0,1,1
28697,2,3,100501,100501,100504,0,3,1
28698,6,2,100507,100507,100509,0,2,3
28699,6,2,100513,100513,100515,0,2,4
28700,5,1,100518,100518,100519,0,1,3
28701,4,2,100522,100522,100524,0,2,3
28702,4,3,100526,100526,100529,0,3,2
28703,1,3,100527,100529,100532,2,5,0
28704,1,1,100528,100532,100533,4,5,0
28705,1,1,100529,100533,100534,4,5,0
28706,3,3,100532,100534,100537,2,5,0
28707,1,2,100533,100537,100539,4,6,0
28708,1,3,100534,100539,100542,5,8,0
28709,2,1,100536,100542,100543,6,7,0
28710,3,3,100539,100543,100546,4,7,0
28711,6,3,100545,100546,100549,1,4,0
28712,2,3,100547,100549,100552,2,5,0
28713,1,3,100548,100552,100555,4,7,0
28714,5,2,100553,100555,100557,2,4,0
28715,6,2,100559,100559,100561,0,2,2
28716,2,1,100561,100561,100562,0,1,0
28717,3,2,100564,100564,100566,0,2,2
28718,4,1,100568,100568,100569,0,1,2
28719,3,3,100571,100571,100574,0,3,2
28720,1,2,100572,100574,100576,2,4,0
28721,2,3,100574,100576,100579,2,5,0
28722,2,2,100576,100579,100581,3,5,0
28723,3,1,100579,100581,100582,2,3,0
28724,3,2,100582,100582,100584,0,2,0
28725,3,2,100585,100585,100587,0,2,1
28726,5,2,100590,100590,100592,0,2,3
28727,5,2,100595,100595,100597,0,2,3
28728,3,3,100598,100598,100601,0,3,1
28729,4,3,100602,100602,100605,0,3,1
28730,6,2,100608,100608,100610,0,2,3
28731,3,1,100611,100611,100612,0,1,1
28732,6,1,100617,100617,100618,0,1,5
28733,4,3,100621,100621,100624,0,3,3
28734,5,3,100626,100626,100629,0,3,2
28735,2,1,100628,100629,100630,1,2,0
28736,4,1,100632,100632,100633,0,1,2
28737,5,1,100637,100637,100638,0,1,4
28738,1,3,100638,100638,100641,0,3,0
28739,3,1,100641,100641,100642,0,1,0
28740,5,3,100646,100646,100649,0,3,4
28741,3,3,100649,100649,100652,0,3,0
28742,1,2,100650,100652,100654,2,4,0
28743,5,3,100655,100655,100658,0,3,1
28744,2,1,100657,100658,100659,1,2,0
28745,1,3,100658,100659,100662,1,4,0
28746,5,2,100663,100663,100665,0,2,1
28747,5,3,100668,100668,100671,0,3,3
28748,3,2,100671,100671,100673,0,2,0
28749,1,1,100672,100673,100674,1,2,0
28750,4,1,100676,100676,100677,0,1,2
28751,1,1,100677,100677,100678,0,1,0
28752,1,2,100678,100678,100680,0,2,0
28753,1,2,100679,100680,100682,1,3,0
28754,5,2,100684,100684,100686,0,2,2
28755,4,1,100688,100688,100689,0,1,2
28756,6,2,100694,100694,100696,0,2,5
28757,3,3,100697,100697,100700,0,3,1
28758,4,1,100701,100701,100702,0,1,1
28759,5,3,100706,100706,100709,0,3,4
28760,4,2,100710,100710,100712,0,2,1
28761,3,3,100713,100713,100716,0,3,1
28762,1,2,100714,100716,100718,2,4,0
28763,4,3,100718,100718,100721,0,3,0
28764,1,3,100719,100721,100724,2,5,0
28765,4,3,100723,100724,100727,1,4,0
28766,1,1,100724,100727,100728,3,4,0
28767,3,3,100727,100728,100731,1,4,0
28768,4,1,100731,100731,100732,0,1,0
28769,3,2,100734,100734,100736,0,2,2
28770,2,1,100736,100736,100737,0,1,0
28771,6,3,100742,100742,100745,0,3,5
28772,2,1,100744,100745,100746,1,2,0
28773,2,2,100746,100746,100748,0,2,0
28774,2,1,100748,100748,100749,0,1,0
28775,3,1,100751,100751,100752,0,1,2
28776,3,3,100754,100754,100757,0,3,2
28777,4,3,100758,100758,100761,0,3,1
28778,3,2,100761,100761,100763,0,2,0
28779,1,2,100762,100763,100765,1,3,0
28780,3,2,100765,100765,100767,0,2,0
28781,1,1,100766,100767,100768,1,2,0
28782,2,1,100768,100768,100769,0,1,0
28783,6,2,100774,100774,100776,0,2,5
28784,6,3,100780,100780,100783,0,3,4
28785,5,1,100785,100785,100786,0,1,2
28786,1,2,100786,100786,100788,0,2,0
28787,2,2,100788,100788,100790,0,2,0
28788,5,3,100793,100793,100796,0,3,3
28789,5,3,100798,100798,100801,0,3,2
28790,2,2,100800,100801,100803,1,3,0
28791,5,1,100805,100805,100806,0,1,2
28792,2,1,100807,100807,100808,0,1,1
28793,4,1,100811,100811,100812,0,1,3
28794,1,3,100812,100812,100815,0,3,0
28795,5,2,100817,100817,100819,0,2,2
28796,4,1,100821,100821,100822,0,1,2
28797,5,3,100826,100826,100829,0,3,4
28798,4,1,100830,100830,100831,0,1,1
28799,1,2,100831,100831,100833,0,2,0
28800,6,3,100837,100837,100840,0,3,4
28801,5,2,100842,100842,100844,0,2,2
28802,2,1,100844,100844,100845,0,1,0
28803,4,3,100848,100848,100851,0,3,3
28804,1,1,100849,100851,100852,2,3,0
28805,6,3,100855,100855,100858,0,3,3
28806,4,1,100859,100859,100860,0,1,1
28807,2,1,100861,100861,100862,0,1,1
28808,2,3,100863,100863,100866,0,3,1
28809,3,3,100866,100866,100869,0,3,0
28810,6,1,100872,100872,100873,0,1,3
28811,6,3,100878,100878,100881,0,3,5
28812,2,1,100880,100881,100882,1,2,0
28813,2,2,100882,100882,100884,0,2,0
28814,3,3,100885,100885,100888,0,3,1
28815,5,2,100890,100890,100892,0,2,2
28816,2,1,100892,100892,100893,0,1,0
28817,2,2,100894,100894,100896,0,2,1
28818,1,3,100895,100896,100899,1,4,0
28819,5,1,100900,100900,100901,0,1,1
28820,4,3,100904,100904,100907,0,3,3
28821,1,3,100905,100907,100910,2,5,0
28822,4,1,100909,100910,100911,1,2,0
28823,1,3,100910,100911,100914,1,4,0
28824,3,3,100913,100914,100917,1,4,0
28825,5,3,100918,100918,100921,0,3,1
28826,4,1,100922,100922,100923,0,1,1
28827,1,1,100923,100923,100924,0,1,0
28828,6,3,100929,100929,100932,0,3,5
28829,1,3,100930,100932,100935,2,5,0
28830,2,3,100932,100935,100938,3,6,0
28831,6,3,100938,100938,100941,0,3,0
28832,1,2,100939,100941,100943,2,4,0
28833,2,3,100941,100943,100946,2,5,0
28834,4,2,100945,100946,100948,1,3,0
28835,6,2,100951,100951,100953,0,2,3
28836,6,2,100957,100957,100959,0,2,4
28837,5,1,100962,100962,100963,0,1,3
28838,2,3,100964,100964,100967,0,3,1
28839,5,3,100969,100969,100972,0,3,2
28840,6,3,100975,100975,100978,0,3,3
28841,2,3,100977,100978,100981,1,4,0
28842,2,2,100979,100981,100983,2,4,0
28843,5,1,100984,100984,100985,0,1,1
28844,4,1,100988,100988,100989,0,1,3
28845,3,3,100991,100991,100994,0,3,2
28846,4,3,100995,100995,100998,0,3,1
28847,4,2,100999,100999,101001,0,2,1
28848,2,3,101001,101001,101004,0,3,0
28849,5,1,101006,101006,101007,0,1,2
28850,4,3,101010,101010,101013,0,3,3
28851,5,3,101015,101015,101018,0,3,2
28852,5,1,101020,101020,101021,0,1,2
28853,2,2,101022,101022,101024,0,2,1
28854,3,1,101025,101025,101026,0,1,1
28855,1,1,101026,101026,101027,0,1,0
28856,4,3,101030,101030,101033,0,3,3
28857,6,3,101036,101036,101039,0,3,3
28858,6,1,101042,101042,101043,0,1,3
28859,5,3,101047,101047,101050,0,3,4
28860,5,1,101052,101052,101053,0,1,2
28861,5,2,101057,101057,101059,0,2,4
28862,6,1,101063,101063,101064,0,1,4
28863,5,3,101068,101068,101071,0,3,4
28864,3,2,101071,101071,101073,0,2,0
28865,3,1,101074,101074,101075,0,1,1
28866,4,1,101078,101078,101079,0,1,3
28867,2,3,101080,101080,101083,0,3,1
28868,4,2,101084,101084,101086,0,2,1
28869,6,2,101090,101090,101092,0,2,4
28870,5,1,101095,101095,101096,0,1,3
28871,5,2,101100,101100,101102,0,2,4
28872,6,2,101106,101106,101108,0,2,4
28873,6,1,101112,101112,101113,0,1,4
28874,3,2,101115,101115,101117,0,2,2
28875,5,1,101120,101120,101121,0,1,3
28876,2,3,101122,101122,101125,0,3,1
28877,3,3,101125,101125,101128,0,3,0
28878,5,1,101130,101130,101131,0,1,2
28879,5,3,101135,101135,101138,0,3,4
28880,6,1,101141,101141,101142,0,1,3
28881,2,2,101143,101143,101145,0,2,1
28882,2,3,101145,101145,101148,0,3,0
28883,1,3,101146,101148,101151,2,5,0
28884,3,1,101149,101151,101152,2,3,0
28885,6,1,101155,101155,101156,0,1,3
28886,5,3,101160,101160,101163,0,3,4
28887,3,1,101163,101163,101164,0,1,0
28888,2,1,101165,101165,101166,0,1,1
28889,2,2,101167,101167,101169,0,2,1
28890,1,2,101168,101169,101171,1,3,0
28891,6,3,101174,101174,101177,0,3,3
28892,1,1,101175,101177,101178,2,3,0
28893,1,3,101176,101178,101181,2,5,0
28894,2,1,101178,101181,101182,3,4,0
28895,2,1,101180,101182,101183,2,3,0
28896,6,2,101186,101186,101188,0,2,3
28897,5,2,101191,101191,101193,0,2,3
28898,5,1,101196,101196,101197,0,1,3
28899,2,1,101198,101198,101199,0,1,1
28900,6,3,101204,101204,101207,0,3,5
28901,6,3,101210,101210,101213,0,3,3
28902,1,1,101211,101213,101214,2,3,0
28903,3,2,101214,101214,101216,0,2,0
28904,1,3,101215,101216,101219,1,4,0
28905,3,2,101218,101219,101221,1,3,0
28906,5,3,101223,101223,101226,0,3,2
28907,4,3,101227,101227,101230,0,3,1
28908,1,3,101228,101230,101233,2,5,0
28909,3,2,101231,101233,101235,2,4,0
28910,3,3,101234,101235,101238,1,4,0
28911,5,1,101239,101239,101240,0,1,1
28912,6,3,101245,101245,101248,0,3,5
28913,6,2,101251,101251,101253,0,2,3
28914,2,2,101253,101253,101255,0,2,0
28915,5,1,101258,101258,101259,0,1,3
28916,4,1,101262,101262,101263,0,1,3
28917,3,2,101265,101265,101267,0,2,2
28918,1,2,101266,101267,101269,1,3,0
28919,5,3,101271,101271,101274,0,3,2
28920,2,2,101273,101274,101276,1,3,0
28921,2,1,101275,101276,101277,1,2,0
28922,5,1,101280,101280,101281,0,1,3
28923,5,2,101285,101285,101287,0,2,4
28924,6,3,101291,101291,101294,0,3,4
28925,3,3,101294,101294,101297,0,3,0
28926,5,2,101299,101299,101301,0,2,2
28927,4,1,101303,101303,101304,0,1,2
28928,6,2,101309,101309,101311,0,2,5
28929,2,1,101311,101311,101312,0,1,0
28930,4,1,101315,101315,101316,0,1,3
28931,5,3,101320,101320,101323,0,3,4
28932,3,3,101323,101323,101326,0,3,0
28933,2,3,101325,101326,101329,1,4,0
28934,5,1,101330,101330,101331,0,1,1
28935,4,1,101334,101334,101335,0,1,3
28936,1,3,101335,101335,101338,0,3,0
28937,5,3,101340,101340,101343,0,3,2
28938,1,2,101341,101343,101345,2,4,0
28939,3,3,101344,101345,101348,1,4,0
28940,5,2,101349,101349,101351,0,2,1
28941,3,2,101352,101352,101354,0,2,1
28942,1,3,101353,101354,101357,1,4,0
28943,1,3,101354,101357,101360,3,6,0
28944,3,2,101357,101360,101362,3,5,0
28945,1,2,101358,101362,101364,4,6,0
28946,1,2,101359,101364,101366,5,7,0
28947,2,1,101361,101366,101367,5,6,0
28948,2,3,101363,101367,101370,4,7,0
28949,5,3,101368,101370,101373,2,5,0
28950,2,1,101370,101373,101374,3,4,0
28951,2,1,101372,101374,101375,2,3,0
28952,6,2,101378,101378,101380,0,2,3
28953,2,2,101380,101380,101382,0,2,0
28954,5,1,101385,101385,101386,0,1,3
28955,6,1,101391,101391,101392,0,1,5
28956,6,1,101397,101397,101398,0,1,5
28957,4,3,101401,101401,101404,0,3,3
28958,4,3,101405,101405,101408,0,3,1
28959,1,3,101406,101408,101411,2,5,0
28960,4,1,101410,101411,101412,1,2,0
28961,5,1,101415,101415,101416,0,1,3
28962,4,3,101419,101419,101422,0,3,3
28963,5,3,101424,101424,101427,0,3,2
28964,6,2,101430,101430,101432,0,2,3
28965,6,2,101436,101436,101438,0,2,4
28966,4,3,101440,101440,101443,0,3,2
28967,4,1,101444,101444,101445,0,1,1
28968,1,1,101445,101445,101446,0,1,0
28969,6,2,101451,101451,101453,0,2,5
28970,2,1,101453,101453,101454,0,1,0
28971,1,1,101454,101454,101455,0,1,0
28972,3,2,101457,101457,101459,0,2,2
28973,5,1,101462,101462,101463,0,1,3
28974,4,2,101466,101466,101468,0,2,3
28975,4,2,101470,101470,101472,0,2,2
28976,2,2,101472,101472,101474,0,2,0
28977,1,3,101473,101474,101477,1,4,0
28978,1,3,101474,101477,101480,3,6,0
28979,2,1,101476,101480,101481,4,5,0
28980,6,3,101482,101482,101485,0,3,1
28981,4,2,101486,101486,101488,0,2,1
28982,2,2,101488,101488,101490,0,2,0
28983,1,3,101489,101490,101493,1,4,0
28984,1,3,101490,101493,101496,3,6,0
28985,3,3,101493,101496,101499,3,6,0
28986,1,2,101494,101499,101501,5,7,0
28987,1,1,101495,101501,101502,6,7,0
28988,2,1,101497,101502,101503,5,6,0
28989,1,1,101498,101503,101504,5,6,0
28990,1,3,101499,101504,101507,5,8,0
28991,5,1,101504,101507,101508,3,4,0
28992,4,1,101508,101508,101509,0,1,0
28993,5,1,101513,101513,101514,0,1,4
28994,4,2,101517,101517,101519,0,2,3
28995,4,3,101521,101521,101524,0,3,2
28996,6,2,101527,101527,101529,0,2,3
28997,5,3,101532,101532,101535,0,3,3
28998,2,2,101534,101535,101537,1,3,0
28999,5,3,101539,101539,101542,0,3,2
29000,2,3,101541,101542,101545,1,4,0
29001,3,1,101544,101545,101546,1,2,0
29002,4,3,101548,101548,101551,0,3,2
29003,6,1,101554,101554,101555,0,1,3
29004,3,2,101557,101557,101559,0,2,2
29005,2,2,101559,101559,101561,0,2,0
29006,5,2,101564,101564,101566,0,2,3
29007,4,2,101568,101568,101570,0,2,2
29008,4,2,101572,101572,101574,0,2,2
29009,3,1,101575,101575,101576,0,1,1
29010,6,3,101581,101581,101584,0,3,5
29011,2,2,101583,101584,101586,1,3,0
29012,4,1,101587,101587,101588,0,1,1
29013,1,3,101588,101588,101591,0,3,0
29014,6,3,101594,101594,101597,0,3,3
29015,1,2,101595,101597,101599,2,4,0
29016,1,2,101596,101599,101601,3,5,0
29017,4,3,101600,101601,101604,1,4,0
29018,5,2,101605,101605,101607,0,2,1
29019,2,3,101607,101607,101610,0,3,0
29020,4,1,101611,101611,101612,0,1,1
29021,6,2,101617,101617,101619,0,2,5
29022,3,3,101620,101620,101623,0,3,1
29023,1,1,101621,101623,101624,2,3,0
29024,2,3,101623,101624,101627,1,4,0
29025,6,1,101629,101629,101630,0,1,2
29026,1,3,101630,101630,101633,0,3,0
29027,2,1,101632,101633,101634,1,2,0
29028,3,2,101635,101635,101637,0,2,1
29029,5,1,101640,101640,101641,0,1,3
29030,1,3,101641,101641,101644,0,3,0
29031,5,1,101646,101646,101647,0,1,2
29032,6,2,101652,101652,101654,0,2,5
29033,5,1,101657,101657,101658,0,1,3
29034,4,3,101661,101661,101664,0,3,3
29035,2,3,101663,101664,101667,1,4,0
29036,5,3,101668,101668,101671,0,3,1
29037,3,1,101671,101671,101672,0,1,0
29038,5,1,101676,101676,101677,0,1,4
29039,2,2,101678,101678,101680,0,2,1
29040,5,3,101683,101683,101686,0,3,3
29041,5,3,101688,101688,101691,0,3,2
29042,5,2,101693,101693,101695,0,2,2
29043,3,2,101696,101696,101698,0,2,1
29044,5,3,101701,101701,101704,0,3,3
29045,5,1,101706,101706,101707,0,1,2
29046,5,3,101711,101711,101714,0,3,4
29047,1,3,101712,101714,101717,2,5,0
29048,1,3,101713,101717,101720,4,7,0
29049,1,1,101714,101720,101721,6,7,0
29050,5,1,101719,101721,101722,2,3,0
29051,3,1,101722,101722,101723,0,1,0
29052,4,2,101726,101726,101728,0,2,3
29053,2,1,101728,101728,101729,0,1,0
29054,3,3,101731,101731,101734,0,3,2
29055,3,2,101734,101734,101736,0,2,0
29056,4,2,101738,101738,101740,0,2,2
29057,4,3,101742,101742,101745,0,3,2
29058,1,3,101743,101745,101748,2,5,0
29059,4,1,101747,101748,101749,1,2,0
29060,1,1,101748,101749,101750,1,2,0
29061,2,3,101750,101750,101753,0,3,0
29062,3,3,101753,101753,101756,0,3,0
29063,1,1,101754,101756,101757,2,3,0
29064,4,1,101758,101758,101759,0,1,1
29065,5,2,101763,101763,101765,0,2,4
29066,2,3,101765,101765,101768,0,3,0
29067,2,1,101767,101768,101769,1,2,0
29068,6,2,101773,101773,101775,0,2,4
29069,5,1,101778,101778,101779,0,1,3
29070,5,3,101783,101783,101786,0,3,4
29071,5,2,101788,101788,101790,0,2,2
29072,1,3,101789,101790,101793,1,4,0
29073,6,3,101795,101795,101798,0,3,2
29074,6,2,101801,101801,101803,0,2,3
29075,5,3,101806,101806,101809,0,3,3
29076,1,2,101807,101809,101811,2,4,0
29077,1,1,101808,101811,101812,3,4,0
29078,6,1,101814,101814,101815,0,1,2
29079,2,3,101816,101816,101819,0,3,1
29080,6,3,101822,101822,101825,0,3,3
29081,4,2,101826,101826,101828,0,2,1
29082,2,3,101828,101828,101831,0,3,0
29083,1,3,101829,101831,101834,2,5,0
29084,6,1,101835,101835,101836,0,1,1
29085,2,3,101837,101837,101840,0,3,1
29086,3,3,101840,101840,101843,0,3,0
29087,4,3,101844,101844,101847,0,3,1
29088,4,1,101848,101848,101849,0,1,1
29089,2,3,101850,101850,101853,0,3,1
29090,5,3,101855,101855,101858,0,3,2
29091,2,2,101857,101858,101860,1,3,0
29092,3,1,101860,101860,101861,0,1,0
29093,2,1,101862,101862,101863,0,1,1
29094,2,3,101864,101864,101867,0,3,1
29095,4,3,101868,101868,101871,0,3,1
29096,5,3,101873,101873,101876,0,3,2
29097,4,1,101877,101877,101878,0,1,1
29098,3,1,101880,101880,101881,0,1,2
29099,4,1,101884,101884,101885,0,1,3
29100,2,2,101886,101886,101888,0,2,1
29101,2,1,101888,101888,101889,0,1,0
29102,3,3,101891,101891,101894,0,3,2
29103,3,3,101894,101894,101897,0,3,0
29104,6,2,101900,101900,101902,0,2,3
29105,6,2,101906,101906,101908,0,2,4
29106,6,3,101912,101912,101915,0,3,4
29107,2,3,101914,101915,101918,1,4,0
29108,2,2,101916,101918,101920,2,4,0
29109,3,2,101919,101920,101922,1,3,0
29110,6,3,101925,101925,101928,0,3,3
29111,4,2,101929,101929,101931,0,2,1
29112,6,2,101935,101935,101937,0,2,4
29113,2,2,101937,101937,101939,0,2,0
29114,2,2,101939,101939,101941,0,2,0
29115,2,3,101941,101941,101944,0,3,0
29116,3,2,101944,101944,101946,0,2,0
29117,5,2,101949,101949,101951,0,2,3
29118,4,3,101953,101953,101956,0,3,2
29119,4,3,101957,101957,101960,0,3,1
29120,4,2,101961,101961,101963,0,2,1
29121,4,1,101965,101965,101966,0,1,2
29122,6,1,101971,101971,101972,0,1,5
29123,1,1,101972,101972,101973,0,1,0
29124,4,3,101976,101976,101979,0,3,3
29125,1,1,101977,101979,101980,2,3,0
29126,6,2,101983,101983,101985,0,2,3
29127,2,2,101985,101985,101987,0,2,0
29128,6,3,101991,101991,101994,0,3,4
29129,2,2,101993,101994,101996,1,3,0
29130,1,1,101994,101996,101997,2,3,0
29131,5,3,101999,101999,102002,0,3,2
29132,2,2,102001,102002,102004,1,3,0
29133,3,2,102004,102004,102006,0,2,0
29134,4,2,102008,102008,102010,0,2,2
29135,4,2,102012,102012,102014,0,2,2
29136,3,3,102015,102015,102018,0,3,1
29137,4,3,102019,102019,102022,0,3,1
29138,1,1,102020,102022,102023,2,3,0
29139,5,3,102025,102025,102028,0,3,2
29140,1,1,102026,102028,102029,2,3,0
29141,2,2,102028,102029,102031,1,3,0
29142,2,1,102030,102031,102032,1,2,0
29143,6,1,102036,102036,102037,0,1,4
29144,3,2,102039,102039,102041,0,2,2
29145,6,1,102045,102045,102046,0,1,4
29146,3,3,102048,102048,102051,0,3,2
29147,3,1,102051,102051,102052,0,1,0
29148,4,2,102055,102055,102057,0,2,3
29149,4,2,102059,102059,102061,0,2,2
29150,1,3,102060,102061,102064,1,4,0
29151,4,3,102064,102064,102067,0,3,0
29152,6,2,102070,102070,102072,0,2,3
29153,5,3,102075,102075,102078,0,3,3
29154,2,2,102077,102078,102080,1,3,0
29155,2,2,102079,102080,102082,1,3,0
29156,1,3,102080,102082,102085,2,5,0
29157,1,2,102081,102085,102087,4,6,0
29158,1,2,102082,102087,102089,5,7,0
29159,5,2,102087,102089,102091,2,4,0
29160,3,2,102090,102091,102093,1,3,0
29161,5,2,102095,102095,102097,0,2,2
29162,1,1,102096,102097,102098,1,2,0
29163,3,1,102099,102099,102100,0,1,1
29164,4,2,102103,102103,102105,0,2,3
29165,3,1,102106,102106,102107,0,1,1
29166,2,3,102108,102108,102111,0,3,1
29167,3,3,102111,102111,102114,0,3,0
29168,3,3,102114,102114,102117,0,3,0
29169,1,3,102115,102117,102120,2,5,0
29170,5,1,102120,102120,102121,0,1,0
29171,3,2,102123,102123,102125,0,2,2
29172,6,1,102129,102129,102130,0,1,4
29173,2,3,102131,102131,102134,0,3,1
29174,5,1,102136,102136,102137,0,1,2
29175,2,3,102138,102138,102141,0,3,1
29176,2,2,102140,102141,102143,1,3,0
29177,2,2,102142,102143,102145,1,3,0
29178,6,2,102148,102148,102150,0,2,3
29179,1,1,102149,102150,102151,1,2,0
29180,1,3,102150,102151,102154,1,4,0
29181,4,1,102154,102154,102155,0,1,0
29182,4,3,102158,102158,102161,0,3,3
29183,2,3,102160,102161,102164,1,4,0
29184,5,1,102165,102165,102166,0,1,1
29185,2,2,102167,102167,102169,0,2,1
29186,1,3,102168,102169,102172,1,4,0
29187,6,1,102174,102174,102175,0,1,2
29188,2,3,102176,102176,102179,0,3,1
29189,3,3,102179,102179,102182,0,3,0
29190,1,3,102180,102182,102185,2,5,0
29191,1,1,102181,102185,102186,4,5,0
29192,6,2,102187,102187,102189,0,2,1
29193,4,2,102191,102191,102193,0,2,2
29194,4,2,102195,102195,102197,0,2,2
29195,6,1,102201,102201,102202,0,1,4
29196,6,1,102207,102207,102208,0,1,5
29197,5,3,102212,102212,102215,0,3,4
29198,3,1,102215,102215,102216,0,1,0
29199,6,3,102221,102221,102224,0,3,5
29200,4,3,102225,102225,102228,0,3,1
29201,3,1,102228,102228,102229,0,1,0
29202,1,1,102229,102229,102230,0,1,0
29203,4,3,102233,102233,102236,0,3,3
29204,5,1,102238,102238,102239,0,1,2
29205,5,1,102243,102243,102244,0,1,4
29206,5,3,102248,102248,102251,0,3,4
29207,4,2,102252,102252,102254,0,2,1
29208,4,1,102256,102256,102257,0,1,2
29209,1,1,102257,102257,102258,0,1,0
29210,2,2,102259,102259,102261,0,2,1
29211,5,2,102264,102264,102266,0,2,3
29212,4,3,102268,102268,102271,0,3,2
29213,3,1,102271,102271,102272,0,1,0
29214,3,1,102274,102274,102275,0,1,2
29215,5,1,102279,102279,102280,0,1,4
29216,5,3,102284,102284,102287,0,3,4
29217,6,1,102290,102290,102291,0,1,3
29218,3,1,102293,102293,102294,0,1,2
29219,6,2,102299,102299,102301,0,2,5
29220,1,3,102300,102301,102304,1,4,0
29221,2,2,102302,102304,102306,2,4,0
29222,5,3,102307,102307,102310,0,3,1
29223,3,1,102310,102310,102311,0,1,0
29224,4,3,102314,102314,102317,0,3,3
29225,1,2,102315,102317,102319,2,4,0
29226,3,3,102318,102319,102322,1,4,0
29227,5,1,102323,102323,102324,0,1,1
29228,6,3,102329,102329,102332,0,3,5
29229,4,2,102333,102333,102335,0,2,1
29230,1,2,102334,102335,102337,1,3,0
29231,6,1,102340,102340,102341,0,1,3
29232,6,2,102346,102346,102348,0,2,5
29233,3,2,102349,102349,102351,0,2,1
29234,6,3,102355,102355,102358,0,3,4
29235,4,2,102359,102359,102361,0,2,1
29236,4,3,102363,102363,102366,0,3,2
29237,5,2,102368,102368,102370,0,2,2
29238,4,2,102372,102372,102374,0,2,2
29239,3,1,102375,102375,102376,0,1,1
29240,2,1,102377,102377,102378,0,1,1
29241,5,3,102382,102382,102385,0,3,4
29242,2,1,102384,102385,102386,1,2,0
29243,3,1,102387,102387,102388,0,1,1
29244,2,2,102389,102389,102391,0,2,1
29245,3,3,102392,102392,102395,0,3,1
29246,5,1,102397,102397,102398,0,1,2
29247,6,1,102403,102403,102404,0,1,5
29248,4,3,102407,102407,102410,0,3,3
29249,4,1,102411,102411,102412,0,1,1
29250,6,2,102417,102417,102419,0,2,5
29251,4,2,102421,102421,102423,0,2,2
29252,6,3,102427,102427,102430,0,3,4
29253,2,3,102429,102430,102433,1,4,0
29254,2,2,102431,102433,102435,2,4,0
29255,2,3,102433,102435,102438,2,5,0
29256,2,2,102435,102438,102440,3,5,0
29257,6,2,102441,102441,102443,0,2,1
29258,3,2,102444,102444,102446,0,2,1
29259,4,1,102448,102448,102449,0,1,2
29260,3,3,102451,102451,102454,0,3,2
29261,1,3,102452,102454,102457,2,5,0
29262,5,2,102457,102457,102459,0,2,0
29263,2,3,102459,102459,102462,0,3,0
29264,3,2,102462,102462,102464,0,2,0
29265,3,2,102465,102465,102467,0,2,1
29266,6,1,102471,102471,102472,0,1,4
29267,6,1,102477,102477,102478,0,1,5
29268,4,1,102481,102481,102482,0,1,3
29269,4,1,102485,102485,102486,0,1,3
29270,5,3,102490,102490,102493,0,3,4
29271,1,2,102491,102493,102495,2,4,0
29272,3,2,102494,102495,102497,1,3,0
29273,4,3,102498,102498,102501,0,3,1
29274,5,2,102503,102503,102505,0,2,2
29275,5,1,102508,102508,102509,0,1,3
29276,4,3,102512,102512,102515,0,3,3
29277,1,2,102513,102515,102517,2,4,0
29278,5,2,102518,102518,102520,0,2,1
29279,2,3,102520,102520,102523,0,3,0
29280,5,1,102525,102525,102526,0,1,2
29281,6,3,102531,102531,102534,0,3,5
29282,1,2,102532,102534,102536,2,4,0
29283,2,3,102534,102536,102539,2,5,0
29284,1,1,102535,102539,102540,4,5,0
29285,6,1,102541,102541,102542,0,1,1
29286,2,1,102543,102543,102544,0,1,1
29287,4,3,102547,102547,102550,0,3,3
29288,4,1,102551,102551,102552,0,1,1
29289,5,3,102556,102556,102559,0,3,4
29290,4,2,102560,102560,102562,0,2,1
29291,5,1,102565,102565,102566,0,1,3
29292,3,1,102568,102568,102569,0,1,2
29293,2,1,102570,102570,102571,0,1,1
29294,6,3,102576,102576,102579,0,3,5
29295,2,1,102578,102579,102580,1,2,0
29296,1,3,102579,102580,102583,1,4,0
29297,2,2,102581,102583,102585,2,4,0
29298,5,2,102586,102586,102588,0,2,1
29299,6,3,102592,102592,102595,0,3,4
29300,5,2,102597,102597,102599,0,2,2
29301,2,2,102599,102599,102601,0,2,0
29302,2,3,102601,102601,102604,0,3,0
29303,6,3,102607,102607,102610,0,3,3
29304,6,1,102613,102613,102614,0,1,3
29305,4,3,102617,102617,102620,0,3,3
29306,3,3,102620,102620,102623,0,3,0
29307,3,1,102623,102623,102624,0,1,0
29308,5,2,102628,102628,102630,0,2,4
29309,4,1,102632,102632,102633,0,1,2
29310,3,1,102635,102635,102636,0,1,2
29311,1,3,102636,102636,102639,0,3,0
29312,1,2,102637,102639,102641,2,4,0
29313,3,3,102640,102641,102644,1,4,0
29314,5,2,102645,102645,102647,0,2,1
29315,6,1,102651,102651,102652,0,1,4
29316,4,2,102655,102655,102657,0,2,3
29317,5,3,102660,102660,102663,0,3,3
29318,2,1,102662,102663,102664,1,2,0
29319,5,3,102667,102667,102670,0,3,3
29320,3,2,102670,102670,102672,0,2,0
29321,4,2,102674,102674,102676,0,2,2
29322,3,3,102677,102677,102680,0,3,1
29323,3,2,102680,102680,102682,0,2,0
29324,6,2,102686,102686,102688,0,2,4
29325,5,2,102691,102691,102693,0,2,3
29326,4,1,102695,102695,102696,0,1,2
29327,3,3,102698,102698,102701,0,3,2
29328,6,1,102704,102704,102705,0,1,3
29329,4,2,102708,102708,102710,0,2,3
29330,1,1,102709,102710,102711,1,2,0
29331,3,1,102712,102712,102713,0,1,1
29332,6,1,102718,102718,102719,0,1,5
29333,2,3,102720,102720,102723,0,3,1
29334,3,1,102723,102723,102724,0,1,0
29335,6,1,102729,102729,102730,0,1,5
29336,6,3,102735,102735,102738,0,3,5
29337,1,1,102736,102738,102739,2,3,0
29338,3,1,102739,102739,102740,0,1,0
29339,6,1,102745,102745,102746,0,1,5
29340,6,2,102751,102751,102753,0,2,5
29341,6,3,102757,102757,102760,0,3,4
29342,1,1,102758,102760,102761,2,3,0
29343,2,1,102760,102761,102762,1,2,0
29344,2,1,102762,102762,102763,0,1,0
29345,5,1,102767,102767,102768,0,1,4
29346,6,1,102773,102773,102774,0,1,5
29347,1,3,102774,102774,102777,0,3,0
29348,6,3,102780,102780,102783,0,3,3
29349,1,3,102781,102783,102786,2,5,0
29350,2,3,102783,102786,102789,3,6,0
29351,5,3,102788,102789,102792,1,4,0
29352,6,1,102794,102794,102795,0,1,2
29353,2,1,102796,102796,102797,0,1,1
29354,2,1,102798,102798,102799,0,1,1
29355,1,2,102799,102799,102801,0,2,0
29356,3,2,102802,102802,102804,0,2,1
29357,5,3,102807,102807,102810,0,3,3
29358,6,2,102813,102813,102815,0,2,3
29359,3,2,102816,102816,102818,0,2,1
29360,6,3,102822,102822,102825,0,3,4
29361,1,2,102823,102825,102827,2,4,0
29362,4,1,102827,102827,102828,0,1,0
29363,4,2,102831,102831,102833,0,2,3
29364,1,2,102832,102833,102835,1,3,0
29365,6,2,102838,102838,102840,0,2,3
29366,4,1,102842,102842,102843,0,1,2
29367,1,3,102843,102843,102846,0,3,0
29368,5,1,102848,102848,102849,0,1,2
29369,1,1,102849,102849,102850,0,1,0
29370,5,1,102854,102854,102855,0,1,4
29371,6,1,102860,102860,102861,0,1,5
29372,4,3,102864,102864,102867,0,3,3
29373,2,1,102866,102867,102868,1,2,0
29374,6,1,102872,102872,102873,0,1,4
29375,1,3,102873,102873,102876,0,3,0
29376,1,1,102874,102876,102877,2,3,0
29377,6,3,102880,102880,102883,0,3,3
29378,5,3,102885,102885,102888,0,3,2
29379,6,3,102891,102891,102894,0,3,3
29380,5,1,102896,102896,102897,0,1,2
29381,3,3,102899,102899,102902,0,3,2
29382,4,3,102903,102903,102906,0,3,1
29383,4,2,102907,102907,102909,0,2,1
29384,2,1,102909,102909,102910,0,1,0
29385,2,2,102911,102911,102913,0,2,1
29386,5,1,102916,102916,102917,0,1,3
29387,1,2,102917,102917,102919,0,2,0
29388,2,2,102919,102919,102921,0,2,0
29389,2,3,102921,102921,102924,0,3,0
29390,1,3,102922,102924,102927,2,5,0
29391,4,3,102926,102927,102930,1,4,0
29392,4,3,102930,102930,102933,0,3,0
29393,5,2,102935,102935,102937,0,2,2
29394,5,2,102940,102940,102942,0,2,3
29395,2,3,102942,102942,102945,0,3,0
29396,5,1,102947,102947,102948,0,1,2
29397,4,2,102951,102951,102953,0,2,3
29398,1,2,102952,102953,102955,1,3,0
29399,1,3,102953,102955,102958,2,5,0
29400,4,2,102957,102958,102960,1,3,0
29401,5,3,102962,102962,102965,0,3,2
29402,1,3,102963,102965,102968,2,5,0
29403,3,2,102966,102968,102970,2,4,0
29404,4,3,102970,102970,102973,0,3,0
29405,5,1,102975,102975,102976,0,1,2
29406,3,3,102978,102978,102981,0,3,2
29407,1,2,102979,102981,102983,2,4,0
29408,1,2,102980,102983,102985,3,5,0
29409,5,1,102985,102985,102986,0,1,0
29410,5,3,102990,102990,102993,0,3,4
29411,2,2,102992,102993,102995,1,3,0
29412,3,1,102995,102995,102996,0,1,0
29413,3,3,102998,102998,103001,0,3,2
29414,6,1,103004,103004,103005,0,1,3
29415,3,3,103007,103007,103010,0,3,2
29416,1,1,103008,103010,103011,2,3,0
29417,3,2,103011,103011,103013,0,2,0
29418,4,2,103015,103015,103017,0,2,2
29419,6,3,103021,103021,103024,0,3,4
29420,5,1,103026,103026,103027,0,1,2
29421,2,1,103028,103028,103029,0,1,1
29422,2,3,103030,103030,103033,0,3,1
29423,1,2,103031,103033,103035,2,4,0
29424,3,1,103034,103035,103036,1,2,0
29425,5,3,103039,103039,103042,0,3,3
29426,6,2,103045,103045,103047,0,2,3
29427,1,1,103046,103047,103048,1,2,0
29428,6,3,103052,103052,103055,0,3,4
29429,1,2,103053,103055,103057,2,4,0
29430,4,1,103057,103057,103058,0,1,0
29431,3,3,103060,103060,103063,0,3,2
29432,5,2,103065,103065,103067,0,2,2
29433,3,3,103068,103068,103071,0,3,1
29434,4,2,103072,103072,103074,0,2,1
29435,5,2,103077,103077,103079,0,2,3
29436,2,1,103079,103079,103080,0,1,0
29437,5,3,103084,103084,103087,0,3,4
29438,5,3,103089,103089,103092,0,3,2
29439,5,3,103094,103094,103097,0,3,2
29440,6,3,103100,103100,103103,0,3,3
29441,6,3,103106,103106,103109,0,3,3
29442,3,2,103109,103109,103111,0,2,0
29443,4,3,103113,103113,103116,0,3,2
29444,3,1,103116,103116,103117,0,1,0
29445,3,1,103119,103119,103120,0,1,2
29446,5,2,103124,103124,103126,0,2,4
29447,1,3,103125,103126,103129,1,4,0
29448,3,3,103128,103129,103132,1,4,0
29449,4,3,103132,103132,103135,0,3,0
29450,6,3,103138,103138,103141,0,3,3
29451,3,1,103141,103141,103142,0,1,0
29452,3,3,103144,103144,103147,0,3,2
29453,6,1,103150,103150,103151,0,1,3
29454,4,2,103154,103154,103156,0,2,3
29455,1,1,103155,103156,103157,1,2,0
29456,1,3,103156,103157,103160,1,4,0
29457,2,3,103158,103160,103163,2,5,0
29458,5,2,103163,103163,103165,0,2,0
29459,1,2,103164,103165,103167,1,3,0
29460,1,3,103165,103167,103170,2,5,0
29461,5,1,103170,103170,103171,0,1,0
29462,5,1,103175,103175,103176,0,1,4
29463,1,1,103176,103176,103177,0,1,0
29464,5,2,103181,103181,103183,0,2,4
29465,1,2,103182,103183,103185,1,3,0
29466,2,2,103184,103185,103187,1,3,0
29467,6,3,103190,103190,103193,0,3,3
29468,5,1,103195,103195,103196,0,1,2
29469,5,1,103200,103200,103201,0,1,4
29470,1,2,103201,103201,103203,0,2,0
29471,1,2,103202,103203,103205,1,3,0
29472,5,1,103207,103207,103208,0,1,2
29473,5,2,103212,103212,103214,0,2,4
29474,2,2,103214,103214,103216,0,2,0
29475,3,3,103217,103217,103220,0,3,1
29476,2,1,103219,103220,103221,1,2,0
29477,6,2,103225,103225,103227,0,2,4
29478,2,3,103227,103227,103230,0,3,0
29479,3,1,103230,103230,103231,0,1,0
29480,5,3,103235,103235,103238,0,3,4
29481,1,2,103236,103238,103240,2,4,0
29482,6,1,103242,103242,103243,0,1,2
29483,4,3,103246,103246,103249,0,3,3
29484,4,2,103250,103250,103252,0,2,1
29485,1,3,103251,103252,103255,1,4,0
29486,6,1,103257,103257,103258,0,1,2
29487,6,3,103263,103263,103266,0,3,5
29488,5,1,103268,103268,103269,0,1,2
29489,6,2,103274,103274,103276,0,2,5
29490,6,2,103280,103280,103282,0,2,4
29491,2,3,103282,103282,103285,0,3,0
29492,4,1,103286,103286,103287,0,1,1
29493,2,2,103288,103288,103290,0,2,1
29494,6,2,103294,103294,103296,0,2,4
29495,3,1,103297,103297,103298,0,1,1
29496,5,3,103302,103302,103305,0,3,4
29497,6,1,103308,103308,103309,0,1,3
29498,5,3,103313,103313,103316,0,3,4
29499,3,2,103316,103316,103318,0,2,0
29500,2,2,103318,103318,103320,0,2,0
29501,4,3,103322,103322,103325,0,3,2
29502,4,1,103326,103326,103327,0,1,1
29503,4,3,103330,103330,103333,0,3,3
29504,4,2,103334,103334,103336,0,2,1
29505,5,3,103339,103339,103342,0,3,3
29506,4,3,103343,103343,103346,0,3,1
29507,4,1,103347,103347,103348,0,1,1
29508,6,3,103353,103353,103356,0,3,5
29509,4,2,103357,103357,103359,0,2,1
29510,2,3,103359,103359,103362,0,3,0
29511,4,1,103363,103363,103364,0,1,1
29512,2,3,103365,103365,103368,0,3,1
29513,5,2,103370,103370,103372,0,2,2
29514,6,1,103376,103376,103377,0,1,4
29515,1,2,103377,103377,103379,0,2,0
29516,3,2,103380,103380,103382,0,2,1
29517,2,2,103382,103382,103384,0,2,0
29518,4,2,103386,103386,103388,0,2,2
29519,6,1,103392,103392,103393,0,1,4
29520,2,3,103394,103394,103397,0,3,1
29521,5,3,103399,103399,103402,0,3,2
29522,5,3,103404,103404,103407,0,3,2
29523,4,2,103408,103408,103410,0,2,1
29524,1,3,103409,103410,103413,1,4,0
29525,5,3,103414,103414,103417,0,3,1
29526,1,2,103415,103417,103419,2,4,0
29527,6,2,103421,103421,103423,0,2,2
29528,6,3,103427,103427,103430,0,3,4
29529,1,3,103428,103430,103433,2,5,0
29530,1,1,103429,103433,103434,4,5,0
29531,6,2,103435,103435,103437,0,2,1
29532,5,3,103440,103440,103443,0,3,3
29533,1,2,103441,103443,103445,2,4,0
29534,3,1,103444,103445,103446,1,2,0
29535,2,2,103446,103446,103448,0,2,0
29536,1,2,103447,103448,103450,1,3,0
29537,6,1,103453,103453,103454,0,1,3
29538,5,3,103458,103458,103461,0,3,4
29539,3,1,103461,103461,103462,0,1,0
29540,1,1,103462,103462,103463,0,1,0
29541,3,1,103465,103465,103466,0,1,2
29542,4,2,103469,103469,103471,0,2,3
29543,6,2,103475,103475,103477,0,2,4
29544,6,1,103481,103481,103482,0,1,4
29545,2,2,103483,103483,103485,0,2,1
29546,4,2,103487,103487,103489,0,2,2
29547,2,2,103489,103489,103491,0,2,0
29548,2,3,103491,103491,103494,0,3,0
29549,5,3,103496,103496,103499,0,3,2
29550,5,2,103501,103501,103503,0,2,2
29551,2,2,103503,103503,103505,0,2,0
29552,2,2,103505,103505,103507,0,2,0
29553,4,3,103509,103509,103512,0,3,2
29554,6,1,103515,103515,103516,0,1,3
29555,6,1,103521,103521,103522,0,1,5
29556,4,1,103525,103525,103526,0,1,3
29557,6,1,103531,103531,103532,0,1,5
29558,3,2,103534,103534,103536,0,2,2
29559,2,2,103536,103536,103538,0,2,0
29560,2,1,103538,103538,103539,0,1,0
29561,3,1,103541,103541,103542,0,1,2
29562,3,1,103544,103544,103545,0,1,2
29563,3,3,103547,103547,103550,0,3,2
29564,2,3,103549,103550,103553,1,4,0
29565,6,2,103555,103555,103557,0,2,2
29566,4,1,103559,103559,103560,0,1,2
29567,4,2,103563,103563,103565,0,2,3
29568,4,2,103567,103567,103569,0,2,2
29569,4,3,103571,103571,103574,0,3,2
29570,1,1,103572,103574,103575,2,3,0
29571,1,3,103573,103575,103578,2,5,0
29572,4,3,103577,103578,103581,1,4,0
29573,4,3,103581,103581,103584,0,3,0
29574,2,3,103583,103584,103587,1,4,0
29575,2,2,103585,103587,103589,2,4,0
29576,4,1,103589,103589,103590,0,1,0
29577,5,1,103594,103594,103595,0,1,4
29578,1,2,103595,103595,103597,0,2,0
29579,4,1,103599,103599,103600,0,1,2
29580,1,2,103600,103600,103602,0,2,0
29581,1,1,103601,103602,103603,1,2,0
29582,4,2,103605,103605,103607,0,2,2
29583,2,3,103607,103607,103610,0,3,0
29584,6,2,103613,103613,103615,0,2,3
29585,2,1,103615,103615,103616,0,1,0
29586,6,1,103621,103621,103622,0,1,5
29587,6,3,103627,103627,103630,0,3,5
29588,4,3,103631,103631,103634,0,3,1
29589,4,3,103635,103635,103638,0,3,1
29590,3,3,103638,103638,103641,0,3,0
29591,4,2,103642,103642,103644,0,2,1
29592,3,1,103645,103645,103646,0,1,1
29593,2,1,103647,103647,103648,0,1,1
29594,6,3,103653,103653,103656,0,3,5
29595,5,2,103658,103658,103660,0,2,2
29596,2,1,103660,103660,103661,0,1,0
29597,2,1,103662,103662,103663,0,1,1
29598,2,2,103664,103664,103666,0,2,1
29599,2,2,103666,103666,103668,0,2,0
29600,4,2,103670,103670,103672,0,2,2
29601,5,1,103675,103675,103676,0,1,3
29602,5,1,103680,103680,103681,0,1,4
29603,4,3,103684,103684,103687,0,3,3
29604,1,3,103685,103687,103690,2,5,0
29605,3,3,103688,103690,103693,2,5,0
29606,1,2,103689,103693,103695,4,6,0
29607,5,2,103694,103695,103697,1,3,0
29608,4,3,103698,103698,103701,0,3,1
29609,4,3,103702,103702,103705,0,3,1
29610,3,3,103705,103705,103708,0,3,0
29611,4,1,103709,103709,103710,0,1,1
29612,6,2,103715,103715,103717,0,2,5
29613,5,3,103720,103720,103723,0,3,3
29614,1,3,103721,103723,103726,2,5,0
29615,4,2,103725,103726,103728,1,3,0
29616,5,1,103730,103730,103731,0,1,2
29617,2,3,103732,103732,103735,0,3,1
29618,1,3,103733,103735,103738,2,5,0
29619,2,1,103735,103738,103739,3,4,0
29620,3,3,103738,103739,103742,1,4,0
29621,4,2,103742,103742,103744,0,2,0
29622,3,3,103745,103745,103748,0,3,1
29623,5,3,103750,103750,103753,0,3,2
29624,6,3,103756,103756,103759,0,3,3
29625,2,2,103758,103759,103761,1,3,0
29626,6,3,103764,103764,103767,0,3,3
29627,4,1,103768,103768,103769,0,1,1
29628,5,2,103773,103773,103775,0,2,4
29629,3,3,103776,103776,103779,0,3,1
29630,6,3,103782,103782,103785,0,3,3
29631,2,1,103784,103785,103786,1,2,0
29632,2,3,103786,103786,103789,0,3,0
29633,3,3,103789,103789,103792,0,3,0
29634,5,3,103794,103794,103797,0,3,2
29635,5,3,103799,103799,103802,0,3,2
29636,3,3,103802,103802,103805,0,3,0
29637,1,2,103803,103805,103807,2,4,0
29638,5,1,103808,103808,103809,0,1,1
29639,5,1,103813,103813,103814,0,1,4
29640,6,1,103819,103819,103820,0,1,5
29641,1,2,103820,103820,103822,0,2,0
29642,6,3,103826,103826,103829,0,3,4
29643,3,1,103829,103829,103830,0,1,0
29644,5,2,103834,103834,103836,0,2,4
29645,3,2,103837,103837,103839,0,2,1
29646,5,3,103842,103842,103845,0,3,3
29647,5,3,103847,103847,103850,0,3,2
29648,4,1,103851,103851,103852,0,1,1
29649,5,3,103856,103856,103859,0,3,4
29650,2,2,103858,103859,103861,1,3,0
29651,3,3,103861,103861,103864,0,3,0
29652,2,2,103863,103864,103866,1,3,0
29653,5,3,103868,103868,103871,0,3,2
29654,2,3,103870,103871,103874,1,4,0
29655,6,2,103876,103876,103878,0,2,2
29656,3,1,103879,103879,103880,0,1,1
29657,6,1,103885,103885,103886,0,1,5
29658,4,1,103889,103889,103890,0,1,3
29659,6,1,103895,103895,103896,0,1,5
29660,4,2,103899,103899,103901,0,2,3
29661,5,2,103904,103904,103906,0,2,3
29662,1,2,103905,103906,103908,1,3,0
29663,5,3,103910,103910,103913,0,3,2
29664,6,1,103916,103916,103917,0,1,3
29665,1,3,103917,103917,103920,0,3,0
29666,2,1,103919,103920,103921,1,2,0
29667,6,1,103925,103925,103926,0,1,4
29668,4,2,103929,103929,103931,0,2,3
29669,4,1,103933,103933,103934,0,1,2
29670,5,1,103938,103938,103939,0,1,4
29671,1,1,103939,103939,103940,0,1,0
29672,5,3,103944,103944,103947,0,3,4
29673,3,1,103947,103947,103948,0,1,0
29674,5,3,103952,103952,103955,0,3,4
29675,6,2,103958,103958,103960,0,2,3
29676,4,2,103962,103962,103964,0,2,2
29677,3,1,103965,103965,103966,0,1,1
29678,5,3,103970,103970,103973,0,3,4
29679,5,1,103975,103975,103976,0,1,2
29680,3,2,103978,103978,103980,0,2,2
29681,4,3,103982,103982,103985,0,3,2
29682,6,2,103988,103988,103990,0,2,3
29683,2,1,103990,103990,103991,0,1,0
29684,4,3,103994,103994,103997,0,3,3
29685,1,1,103995,103997,103998,2,3,0
29686,1,1,103996,103998,103999,2,3,0
29687,3,1,103999,103999,104000,0,1,0
29688,3,2,104002,104002,104004,0,2,2
29689,5,3,104007,104007,104010,0,3,3
29690,1,2,104008,104010,104012,2,4,0
29691,4,2,104012,104012,104014,0,2,0
29692,2,3,104014,104014,104017,0,3,0
29693,2,3,104016,104017,104020,1,4,0
29694,1,2,104017,104020,104022,3,5,0
29695,3,2,104020,104022,104024,2,4,0
29696,4,3,104024,104024,104027,0,3,0
29697,5,3,104029,104029,104032,0,3,2
29698,6,1,104035,104035,104036,0,1,3
29699,1,2,104036,104036,104038,0,2,0
29700,6,2,104042,104042,104044,0,2,4
29701,3,1,104045,104045,104046,0,1,1
29702,2,1,104047,104047,104048,0,1,1
29703,1,3,104048,104048,104051,0,3,0
29704,3,2,104051,104051,104053,0,2,0
29705,5,2,104056,104056,104058,0,2,3
29706,5,3,104061,104061,104064,0,3,3
29707,4,3,104065,104065,104068,0,3,1
29708,4,2,104069,104069,104071,0,2,1
29709,1,2,104070,104071,104073,1,3,0
29710,4,1,104074,104074,104075,0,1,1
29711,2,3,104076,104076,104079,0,3,1
29712,6,3,104082,104082,104085,0,3,3
29713,6,3,104088,104088,104091,0,3,3
29714,3,2,104091,104091,104093,0,2,0
29715,5,1,104096,104096,104097,0,1,3
29716,5,3,104101,104101,104104,0,3,4
29717,4,3,104105,104105,104108,0,3,1
29718,5,2,104110,104110,104112,0,2,2
29719,2,1,104112,104112,104113,0,1,0
29720,5,3,104117,104117,104120,0,3,4
29721,3,3,104120,104120,104123,0,3,0
29722,5,3,104125,104125,104128,0,3,2
29723,2,1,104127,104128,104129,1,2,0
29724,4,3,104131,104131,104134,0,3,2
29725,6,2,104137,104137,104139,0,2,3
29726,3,3,104140,104140,104143,0,3,1
29727,5,2,104145,104145,104147,0,2,2
29728,3,1,104148,104148,104149,0,1,1
29729,4,1,104152,104152,104153,0,1,3
29730,6,3,104158,104158,104161,0,3,5
29731,5,2,104163,104163,104165,0,2,2
29732,6,3,104169,104169,104172,0,3,4
29733,3,1,104172,104172,104173,0,1,0
29734,3,3,104175,104175,104178,0,3,2
29735,1,1,104176,104178,104179,2,3,0
29736,2,1,104178,104179,104180,1,2,0
29737,5,2,104183,104183,104185,0,2,3
29738,5,3,104188,104188,104191,0,3,3
29739,4,2,104192,104192,104194,0,2,1
29740,5,3,104197,104197,104200,0,3,3
29741,1,3,104198,104200,104203,2,5,0
29742,6,3,104204,104204,104207,0,3,1
29743,3,1,104207,104207,104208,0,1,0
29744,5,3,104212,104212,104215,0,3,4
29745,4,3,104216,104216,104219,0,3,1
29746,5,1,104221,104221,104222,0,1,2
29747,6,2,104227,104227,104229,0,2,5
29748,4,1,104231,104231,104232,0,1,2
29749,5,3,104236,104236,104239,0,3,4
29750,1,1,104237,104239,104240,2,3,0
29751,3,2,104240,104240,104242,0,2,0
29752,6,3,104246,104246,104249,0,3,4
29753,2,2,104248,104249,104251,1,3,0
29754,2,2,104250,104251,104253,1,3,0
29755,6,2,104256,104256,104258,0,2,3
29756,2,1,104258,104258,104259,0,1,0
29757,6,2,104264,104264,104266,0,2,5
29758,3,2,104267,104267,104269,0,2,1
29759,6,3,104273,104273,104276,0,3,4
29760,1,1,104274,104276,104277,2,3,0
29761,2,3,104276,104277,104280,1,4,0
29762,5,2,104281,104281,104283,0,2,1
29763,4,3,104285,104285,104288,0,3,2
29764,5,2,104290,104290,104292,0,2,2
29765,4,1,104294,104294,104295,0,1,2
29766,1,1,104295,104295,104296,0,1,0
29767,4,1,104299,104299,104300,0,1,3
29768,4,2,104303,104303,104305,0,2,3
29769,4,2,104307,104307,104309,0,2,2
29770,5,3,104312,104312,104315,0,3,3
29771,2,1,104314,104315,104316,1,2,0
29772,2,2,104316,104316,104318,0,2,0
29773,5,2,104321,104321,104323,0,2,3
29774,2,3,104323,104323,104326,0,3,0
29775,2,2,104325,104326,104328,1,3,0
29776,4,1,104329,104329,104330,0,1,1
29777,3,3,104332,104332,104335,0,3,2
29778,1,3,104333,104335,104338,2,5,0
29779,4,1,104337,104338,104339,1,2,0
29780,6,2,104343,104343,104345,0,2,4
29781,3,1,104346,104346,104347,0,1,1
29782,3,2,104349,104349,104351,0,2,2
29783,4,1,104353,104353,104354,0,1,2
29784,3,1,104356,104356,104357,0,1,2
29785,5,1,104361,104361,104362,0,1,4
29786,6,3,104367,104367,104370,0,3,5
29787,1,1,104368,104370,104371,2,3,0
29788,2,3,104370,104371,104374,1,4,0
29789,6,2,104376,104376,104378,0,2,2
29790,3,2,104379,104379,104381,0,2,1
29791,1,1,104380,104381,104382,1,2,0
29792,6,1,104386,104386,104387,0,1,4
29793,2,2,104388,104388,104390,0,2,1
29794,3,3,104391,104391,104394,0,3,1
29795,4,2,104395,104395,104397,0,2,1
29796,3,3,104398,104398,104401,0,3,1
29797,1,2,104399,104401,104403,2,4,0
29798,2,2,104401,104403,104405,2,4,0
29799,3,3,104404,104405,104408,1,4,0
29800,2,1,104406,104408,104409,2,3,0
29801,1,2,104407,104409,104411,2,4,0
29802,2,1,104409,104411,104412,2,3,0
29803,1,2,104410,104412,104414,2,4,0
29804,2,1,104412,104414,104415,2,3,0
29805,2,2,104414,104415,104417,1,3,0
29806,2,1,104416,104417,104418,1,2,0
29807,6,2,104422,104422,104424,0,2,4
29808,5,3,104427,104427,104430,0,3,3
29809,2,2,104429,104430,104432,1,3,0
29810,5,2,104434,104434,104436,0,2,2
29811,4,2,104438,104438,104440,0,2,2
29812,6,1,104444,104444,104445,0,1,4
29813,1,1,104445,104445,104446,0,1,0
29814,3,1,104448,104448,104449,0,1,2
29815,1,3,104449,104449,104452,0,3,0
29816,2,2,104451,104452,104454,1,3,0
29817,2,1,104453,104454,104455,1,2,0
29818,2,2,104455,104455,104457,0,2,0
29819,5,3,104460,104460,104463,0,3,3
29820,5,2,104465,104465,104467,0,2,2
29821,6,2,104471,104471,104473,0,2,4
29822,4,3,104475,104475,104478,0,3,2
29823,2,1,104477,104478,104479,1,2,0
29824,2,1,104479,104479,104480,0,1,0
29825,6,1,104485,104485,104486,0,1,5
29826,2,2,104487,104487,104489,0,2,1
29827,2,2,104489,104489,104491,0,2,0
29828,6,3,104495,104495,104498,0,3,4
29829,1,2,104496,104498,104500,2,4,0
29830,4,1,104500,104500,104501,0,1,0
29831,1,3,104501,104501,104504,0,3,0
29832,1,1,104502,104504,104505,2,3,0
29833,2,1,104504,104505,104506,1,2,0
29834,2,3,104506,104506,104509,0,3,0
29835,6,1,104512,104512,104513,0,1,3
29836,5,3,104517,104517,104520,0,3,4
29837,6,1,104523,104523,104524,0,1,3
29838,3,2,104526,104526,104528,0,2,2
29839,4,2,104530,104530,104532,0,2,2
29840,6,2,104536,104536,104538,0,2,4
29841,5,1,104541,104541,104542,0,1,3
29842,5,1,104546,104546,104547,0,1,4
29843,2,1,104548,104548,104549,0,1,1
29844,5,1,104553,104553,104554,0,1,4
29845,6,1,104559,104559,104560,0,1,5
29846,6,1,104565,104565,104566,0,1,5
29847,1,3,104566,104566,104569,0,3,0
29848,1,2,104567,104569,104571,2,4,0
29849,5,1,104572,104572,104573,0,1,1
29850,1,3,104573,104573,104576,0,3,0
29851,2,2,104575,104576,104578,1,3,0
29852,3,3,104578,104578,104581,0,3,0
29853,1,3,104579,104581,104584,2,5,0
29854,5,3,104584,104584,104587,0,3,0
29855,2,2,104586,104587,104589,1,3,0
29856,4,3,104590,104590,104593,0,3,1
29857,2,1,104592,104593,104594,1,2,0
29858,4,1,104596,104596,104597,0,1,2
29859,3,3,104599,104599,104602,0,3,2
29860,6,1,104605,104605,104606,0,1,3
29861,1,1,104606,104606,104607,0,1,0
29862,6,2,104612,104612,104614,0,2,5
29863,1,1,104613,104614,104615,1,2,0
29864,1,2,104614,104615,104617,1,3,0
29865,5,2,104619,104619,104621,0,2,2
29866,1,2,104620,104621,104623,1,3,0
29867,2,3,104622,104623,104626,1,4,0
29868,1,2,104623,104626,104628,3,5,0
29869,3,1,104626,104628,104629,2,3,0
29870,1,1,104627,104629,104630,2,3,0
29871,4,2,104631,104631,104633,0,2,1
29872,3,3,104634,104634,104637,0,3,1
29873,5,1,104639,104639,104640,0,1,2
29874,5,2,104644,104644,104646,0,2,4
29875,3,1,104647,104647,104648,0,1,1
29876,4,3,104651,104651,104654,0,3,3
29877,4,2,104655,104655,104657,0,2,1
29878,4,3,104659,104659,104662,0,3,2
29879,2,3,104661,104662,104665,1,4,0
29880,5,1,104666,104666,104667,0,1,1
29881,6,2,104672,104672,104674,0,2,5
29882,1,1,104673,104674,104675,1,2,0
29883,2,3,104675,104675,104678,0,3,0
29884,5,1,104680,104680,104681,0,1,2
29885,3,3,104683,104683,104686,0,3,2
29886,5,3,104688,104688,104691,0,3,2
29887,4,1,104692,104692,104693,0,1,1
29888,5,1,104697,104697,104698,0,1,4
29889,5,1,104702,104702,104703,0,1,4
29890,6,3,104708,104708,104711,0,3,5
29891,6,1,104714,104714,104715,0,1,3
29892,2,2,104716,104716,104718,0,2,1
29893,2,1,104718,104718,104719,0,1,0
29894,4,1,104722,104722,104723,0,1,3
29895,5,1,104727,104727,104728,0,1,4
29896,3,3,104730,104730,104733,0,3,2
29897,6,1,104736,104736,104737,0,1,3
29898,2,3,104738,104738,104741,0,3,1
29899,3,2,104741,104741,104743,0,2,0
29900,4,1,104745,104745,104746,0,1,2
29901,2,3,104747,104747,104750,0,3,1
29902,1,3,104748,104750,104753,2,5,0
29903,3,2,104751,104753,104755,2,4,0
29904,5,2,104756,104756,104758,0,2,1
29905,3,3,104759,104759,104762,0,3,1
29906,6,3,104765,104765,104768,0,3,3
29907,5,3,104770,104770,104773,0,3,2
29908,2,1,104772,104773,104774,1,2,0
29909,2,2,104774,104774,104776,0,2,0
29910,6,1,104780,104780,104781,0,1,4
29911,2,3,104782,104782,104785,0,3,1
29912,1,3,104783,104785,104788,2,5,0
29913,2,3,104785,104788,104791,3,6,0
29914,2,2,104787,104791,104793,4,6,0
29915,3,1,104790,104793,104794,3,4,0
29916,2,3,104792,104794,104797,2,5,0
29917,5,1,104797,104797,104798,0,1,0
29918,3,3,104800,104800,104803,0,3,2
29919,1,3,104801,104803,104806,2,5,0
29920,1,2,104802,104806,104808,4,6,0
29921,3,1,104805,104808,104809,3,4,0
29922,4,3,104809,104809,104812,0,3,0
29923,5,1,104814,104814,104815,0,1,2
29924,2,3,104816,104816,104819,0,3,1
29925,4,3,104820,104820,104823,0,3,1
29926,3,2,104823,104823,104825,0,2,0
29927,5,3,104828,104828,104831,0,3,3
29928,1,2,104829,104831,104833,2,4,0
29929,3,1,104832,104833,104834,1,2,0
29930,3,3,104835,104835,104838,0,3,1
29931,4,3,104839,104839,104842,0,3,1
29932,1,2,104840,104842,104844,2,4,0
29933,3,3,104843,104844,104847,1,4,0
29934,6,2,104849,104849,104851,0,2,2
29935,1,1,104850,104851,104852,1,2,0
29936,4,2,104854,104854,104856,0,2,2
29937,3,2,104857,104857,104859,0,2,1
29938,5,1,104862,104862,104863,0,1,3
29939,4,2,104866,104866,104868,0,2,3
29940,6,1,104872,104872,104873,0,1,4
29941,5,2,104877,104877,104879,0,2,4
29942,5,1,104882,104882,104883,0,1,3
29943,5,3,104887,104887,104890,0,3,4
29944,3,1,104890,104890,104891,0,1,0
29945,1,2,104891,104891,104893,0,2,0
29946,1,3,104892,104893,104896,1,4,0
29947,6,1,104898,104898,104899,0,1,2
29948,5,2,104903,104903,104905,0,2,4
29949,3,1,104906,104906,104907,0,1,1
29950,2,3,104908,104908,104911,0,3,1
29951,1,1,104909,104911,104912,2,3,0
29952,4,1,104913,104913,104914,0,1,1
29953,4,1,104917,104917,104918,0,1,3
29954,2,1,104919,104919,104920,0,1,1
29955,4,3,104923,104923,104926,0,3,3
29956,5,2,104928,104928,104930,0,2,2
29957,5,1,104933,104933,104934,0,1,3
29958,3,2,104936,104936,104938,0,2,2
29959,5,1,104941,104941,104942,0,1,3
29960,1,2,104942,104942,104944,0,2,0
29961,6,3,104948,104948,104951,0,3,4
29962,1,3,104949,104951,104954,2,5,0
29963,1,2,104950,104954,104956,4,6,0
29964,4,3,104954,104956,104959,2,5,0
29965,6,1,104960,104960,104961,0,1,1
29966,3,1,104963,104963,104964,0,1,2
29967,2,2,104965,104965,104967,0,2,1
29968,3,2,104968,104968,104970,0,2,1
29969,3,2,104971,104971,104973,0,2,1
29970,4,1,104975,104975,104976,0,1,2
29971,4,1,104979,104979,104980,0,1,3
29972,2,3,104981,104981,104984,0,3,1
29973,5,3,104986,104986,104989,0,3,2
29974,2,1,104988,104989,104990,1,2,0
29975,3,1,104991,104991,104992,0,1,1
29976,2,3,104993,104993,104996,0,3,1
29977,2,1,104995,104996,104997,1,2,0
29978,4,3,104999,104999,105002,0,3,2
29979,4,2,105003,105003,105005,0,2,1
29980,2,1,105005,105005,105006,0,1,0
29981,1,3,105006,105006,105009,0,3,0
29982,5,1,105011,105011,105012,0,1,2
29983,2,3,105013,105013,105016,0,3,1
29984,2,1,105015,105016,105017,1,2,0
29985,1,1,105016,105017,105018,1,2,0
29986,4,3,105020,105020,105023,0,3,2
29987,5,2,105025,105025,105027,0,2,2
29988,1,2,105026,105027,105029,1,3,0
29989,4,3,105030,105030,105033,0,3,1
29990,5,2,105035,105035,105037,0,2,2
29991,1,3,105036,105037,105040,1,4,0
29992,1,3,105037,105040,105043,3,6,0
29993,1,1,105038,105043,105044,5,6,0
29994,4,1,105042,105044,105045,2,3,0
29995,4,2,105046,105046,105048,0,2,1
29996,4,2,105050,105050,105052,0,2,2
29997,1,1,105051,105052,105053,1,2,0
29998,1,1,105052,105053,105054,1,2,0
29999,4,2,105056,105056,105058,0,2,2
30000,3,1,105059,105059,105060,0,1,1
30001,1,3,105060,105060,105063,0,3,0
30002,6,3,105066,105066,105069,0,3,3
30003,3,3,105069,105069,105072,0,3,0
30004,1,2,105070,105072,105074,2,4,0
30005,4,3,105074,105074,105077,0,3,0
30006,1,2,105075,105077,105079,2,4,0
30007,3,3,105078,105079,105082,1,4,0
30008,4,2,105082,105082,105084,0,2,0
30009,1,1,105083,105084,105085,1,2,0
30010,2,1,105085,105085,105086,0,1,0
30011,5,3,105090,105090,105093,0,3,4
30012,6,1,105096,105096,105097,0,1,3
30013,2,1,105098,105098,105099,0,1,1
30014,3,2,105101,105101,105103,0,2,2
30015,1,3,105102,105103,105106,1,4,0
30016,6,2,105108,105108,105110,0,2,2
30017,5,3,105113,105113,105116,0,3,3
30018,5,1,105118,105118,105119,0,1,2
30019,1,1,105119,105119,105120,0,1,0
30020,5,2,105124,105124,105126,0,2,4
30021,3,3,105127,105127,105130,0,3,1
30022,6,3,105133,105133,105136,0,3,3
30023,2,2,105135,105136,105138,1,3,0
30024,2,3,105137,105138,105141,1,4,0
30025,4,2,105141,105141,105143,0,2,0
30026,2,3,105143,105143,105146,0,3,0
30027,6,1,105149,105149,105150,0,1,3
30028,4,2,105153,105153,105155,0,2,3
30029,4,1,105157,105157,105158,0,1,2
30030,1,2,105158,105158,105160,0,2,0
30031,5,1,105163,105163,105164,0,1,3
30032,6,1,105169,105169,105170,0,1,5
30033,5,1,105174,105174,105175,0,1,4
30034,4,1,105178,105178,105179,0,1,3
30035,4,1,105182,105182,105183,0,1,3
30036,5,3,105187,105187,105190,0,3,4
30037,3,1,105190,105190,105191,0,1,0
30038,1,1,105191,105191,105192,0,1,0
30039,6,2,105197,105197,105199,0,2,5
30040,6,3,105203,105203,105206,0,3,4
30041,3,3,105206,105206,105209,0,3,0
30042,5,3,105211,105211,105214,0,3,2
30043,4,1,105215,105215,105216,0,1,1
30044,4,1,105219,105219,105220,0,1,3
30045,4,1,105223,105223,105224,0,1,3
30046,5,2,105228,105228,105230,0,2,4
30047,6,2,105234,105234,105236,0,2,4
30048,1,3,105235,105236,105239,1,4,0
30049,5,2,105240,105240,105242,0,2,1
30050,6,3,105246,105246,105249,0,3,4
30051,1,1,105247,105249,105250,2,3,0
30052,3,3,105250,105250,105253,0,3,0
30053,5,1,105255,105255,105256,0,1,2
30054,5,3,105260,105260,105263,0,3,4
30055,1,3,105261,105263,105266,2,5,0
30056,1,2,105262,105266,105268,4,6,0
30057,6,1,105268,105268,105269,0,1,0
30058,4,3,105272,105272,105275,0,3,3
30059,6,2,105278,105278,105280,0,2,3
30060,1,1,105279,105280,105281,1,2,0
30061,2,1,105281,105281,105282,0,1,0
30062,2,2,105283,105283,105285,0,2,1
30063,5,2,105288,105288,105290,0,2,3
30064,4,1,105292,105292,105293,0,1,2
30065,6,1,105298,105298,105299,0,1,5
30066,1,3,105299,105299,105302,0,3,0
30067,2,1,105301,105302,105303,1,2,0
30068,2,2,105303,105303,105305,0,2,0
30069,1,2,105304,105305,105307,1,3,0
30070,6,1,105310,105310,105311,0,1,3
30071,6,2,105316,105316,105318,0,2,5
30072,2,3,105318,105318,105321,0,3,0
30073,6,1,105324,105324,105325,0,1,3
30074,5,1,105329,105329,105330,0,1,4
30075,4,1,105333,105333,105334,0,1,3
30076,5,1,105338,105338,105339,0,1,4
30077,4,2,105342,105342,105344,0,2,3
30078,5,2,105347,105347,105349,0,2,3
30079,6,2,105353,105353,105355,0,2,4
30080,1,3,105354,105355,105358,1,4,0
30081,1,2,105355,105358,105360,3,5,0
30082,6,1,105361,105361,105362,0,1,1
30083,6,1,105367,105367,105368,0,1,5
30084,4,2,105371,105371,105373,0,2,3
30085,1,3,105372,105373,105376,1,4,0
30086,5,1,105377,105377,105378,0,1,1
30087,4,2,105381,105381,105383,0,2,3
30088,1,2,105382,105383,105385,1,3,0
30089,2,1,105384,105385,105386,1,2,0
30090,5,1,105389,105389,105390,0,1,3
30091,4,2,105393,105393,105395,0,2,3
30092,1,2,105394,105395,105397,1,3,0
30093,5,2,105399,105399,105401,0,2,2
30094,4,3,105403,105403,105406,0,3,2
30095,2,3,105405,105406,105409,1,4,0
30096,3,2,105408,105409,105411,1,3,0
30097,5,3,105413,105413,105416,0,3,2
30098,2,2,105415,105416,105418,1,3,0
30099,4,1,105419,105419,105420,0,1,1
30100,5,3,105424,105424,105427,0,3,4
30101,2,1,105426,105427,105428,1,2,0
30102,3,1,105429,105429,105430,0,1,1
30103,4,1,105433,105433,105434,0,1,3
30104,4,3,105437,105437,105440,0,3,3
30105,4,1,105441,105441,105442,0,1,1
30106,5,1,105446,105446,105447,0,1,4
30107,2,1,105448,105448,105449,0,1,1
30108,3,2,105451,105451,105453,0,2,2
30109,6,1,105457,105457,105458,0,1,4
30110,2,1,105459,105459,105460,0,1,1
30111,3,1,105462,105462,105463,0,1,2
30112,3,3,105465,105465,105468,0,3,2
30113,1,1,105466,105468,105469,2,3,0
30114,6,1,105472,105472,105473,0,1,3
30115,4,2,105476,105476,105478,0,2,3
30116,5,1,105481,105481,105482,0,1,3
30117,2,1,105483,105483,105484,0,1,1
30118,6,3,105489,105489,105492,0,3,5
30119,1,3,105490,105492,105495,2,5,0
30120,4,1,105494,105495,105496,1,2,0
30121,5,2,105499,105499,105501,0,2,3
30122,3,3,105502,105502,105505,0,3,1
30123,1,3,105503,105505,105508,2,5,0
30124,6,2,105509,105509,105511,0,2,1
30125,1,2,105510,105511,105513,1,3,0
30126,4,1,105514,105514,105515,0,1,1
30127,5,3,105519,105519,105522,0,3,4
30128,4,3,105523,105523,105526,0,3,1
30129,5,1,105528,105528,105529,0,1,2
30130,1,1,105529,105529,105530,0,1,0
30131,6,1,105535,105535,105536,0,1,5
30132,3,2,105538,105538,105540,0,2,2
30133,5,1,105543,105543,105544,0,1,3
30134,4,3,105547,105547,105550,0,3,3
30135,3,2,105550,105550,105552,0,2,0
30136,4,3,105554,105554,105557,0,3,2
30137,5,2,105559,105559,105561,0,2,2
30138,6,3,105565,105565,105568,0,3,4
30139,5,2,105570,105570,105572,0,2,2
30140,6,1,105576,105576,105577,0,1,4
30141,5,3,105581,105581,105584,0,3,4
30142,2,1,105583,105584,105585,1,2,0
30143,5,2,105588,105588,105590,0,2,3
30144,4,1,105592,105592,105593,0,1,2
30145,4,3,105596,105596,105599,0,3,3
30146,4,3,105600,105600,105603,0,3,1
30147,4,1,105604,105604,105605,0,1,1
30148,5,3,105609,105609,105612,0,3,4
30149,3,1,105612,105612,105613,0,1,0
30150,4,1,105616,105616,105617,0,1,3
30151,1,1,105617,105617,105618,0,1,0
30152,2,3,105619,105619,105622,0,3,1
30153,4,3,105623,105623,105626,0,3,1
30154,4,3,105627,105627,105630,0,3,1
30155,3,3,105630,105630,105633,0,3,0
30156,2,3,105632,105633,105636,1,4,0
30157,2,1,105634,105636,105637,2,3,0
30158,4,2,105638,105638,105640,0,2,1
30159,5,3,105643,105643,105646,0,3,3
30160,6,3,105649,105649,105652,0,3,3
30161,1,1,105650,105652,105653,2,3,0
30162,2,1,105652,105653,105654,1,2,0
30163,1,3,105653,105654,105657,1,4,0
30164,5,2,105658,105658,105660,0,2,1
30165,3,1,105661,105661,105662,0,1,1
30166,6,2,105667,105667,105669,0,2,5
30167,2,2,105669,105669,105671,0,2,0
30168,2,1,105671,105671,105672,0,1,0
30169,3,1,105674,105674,105675,0,1,2
30170,5,1,105679,105679,105680,0,1,4
30171,5,2,105684,105684,105686,0,2,4
30172,1,3,105685,105686,105689,1,4,0
30173,5,1,105690,105690,105691,0,1,1
30174,1,2,105691,105691,105693,0,2,0
30175,6,3,105697,105697,105700,0,3,4
30176,2,2,105699,105700,105702,1,3,0
30177,1,2,105700,105702,105704,2,4,0
30178,4,3,105704,105704,105707,0,3,0
30179,3,1,105707,105707,105708,0,1,0
30180,6,3,105713,105713,105716,0,3,5
30181,5,3,105718,105718,105721,0,3,2
30182,4,3,105722,105722,105725,0,3,1
30183,5,3,105727,105727,105730,0,3,2
30184,5,2,105732,105732,105734,0,2,2
30185,5,2,105737,105737,105739,0,2,3
30186,4,2,105741,105741,105743,0,2,2
30187,4,2,105745,105745,105747,0,2,2
30188,4,2,105749,105749,105751,0,2,2
30189,2,2,105751,105751,105753,0,2,0
30190,1,1,105752,105753,105754,1,2,0
30191,5,3,105757,105757,105760,0,3,3
30192,1,2,105758,105760,105762,2,4,0
30193,1,2,105759,105762,105764,3,5,0
30194,6,1,105765,105765,105766,0,1,1
30195,3,2,105768,105768,105770,0,2,2
30196,2,1,105770,105770,105771,0,1,0
30197,1,1,105771,105771,105772,0,1,0
30198,4,3,105775,105775,105778,0,3,3
30199,3,1,105778,105778,105779,0,1,0
30200,6,2,105784,105784,105786,0,2,5
30201,3,1,105787,105787,105788,0,1,1
30202,4,1,105791,105791,105792,0,1,3
30203,5,1,105796,105796,105797,0,1,4
30204,5,2,105801,105801,105803,0,2,4
30205,4,3,105805,105805,105808,0,3,2
30206,1,3,105806,105808,105811,2,5,0
30207,1,2,105807,105811,105813,4,6,0
30208,2,3,105809,105813,105816,4,7,0
30209,1,1,105810,105816,105817,6,7,0
30210,4,2,105814,105817,105819,3,5,0
30211,6,3,105820,105820,105823,0,3,1
30212,4,2,105824,105824,105826,0,2,1
30213,5,3,105829,105829,105832,0,3,3
30214,1,3,105830,105832,105835,2,5,0
30215,6,1,105836,105836,105837,0,1,1
30216,4,3,105840,105840,105843,0,3,3
30217,6,3,105846,105846,105849,0,3,3
30218,6,3,105852,105852,105855,0,3,3
30219,2,2,105854,105855,105857,1,3,0
30220,5,1,105859,105859,105860,0,1,2
30221,3,1,105862,105862,105863,0,1,2
30222,3,2,105865,105865,105867,0,2,2
30223,6,3,105871,105871,105874,0,3,4
30224,1,2,105872,105874,105876,2,4,0
30225,3,3,105875,105876,105879,1,4,0
30226,3,3,105878,105879,105882,1,4,0
30227,1,1,105879,105882,105883,3,4,0
30228,6,1,105885,105885,105886,0,1,2
30229,1,1,105886,105886,105887,0,1,0
30230,3,2,105889,105889,105891,0,2,2
30231,2,3,105891,105891,105894,0,3,0
30232,3,3,105894,105894,105897,0,3,0
30233,1,3,105895,105897,105900,2,5,0
30234,1,1,105896,105900,105901,4,5,0
30235,5,1,105901,105901,105902,0,1,0
30236,5,3,105906,105906,105909,0,3,4
30237,2,1,105908,105909,105910,1,2,0
30238,5,2,105913,105913,105915,0,2,3
30239,4,2,105917,105917,105919,0,2,2
30240,5,2,105922,105922,105924,0,2,3
30241,2,1,105924,105924,105925,0,1,0
30242,3,3,105927,105927,105930,0,3,2
30243,1,3,105928,105930,105933,2,5,0
30244,6,3,105934,105934,105937,0,3,1
30245,1,3,105935,105937,105940,2,5,0
30246,3,2,105938,105940,105942,2,4,0
30247,6,1,105944,105944,105945,0,1,2
30248,1,1,105945,105945,105946,0,1,0
30249,1,1,105946,105946,105947,0,1,0
30250,4,3,105950,105950,105953,0,3,3
30251,4,3,105954,105954,105957,0,3,1
30252,3,1,105957,105957,105958,0,1,0
30253,6,2,105963,105963,105965,0,2,5
30254,6,2,105969,105969,105971,0,2,4
30255,1,1,105970,105971,105972,1,2,0
30256,1,2,105971,105972,105974,1,3,0
30257,4,1,105975,105975,105976,0,1,1
30258,3,3,105978,105978,105981,0,3,2
30259,1,3,105979,105981,105984,2,5,0
30260,1,1,105980,105984,105985,4,5,0
30261,3,1,105983,105985,105986,2,3,0
30262,3,3,105986,105986,105989,0,3,0
30263,6,2,105992,105992,105994,0,2,3
30264,6,3,105998,105998,106001,0,3,4
30265,5,2,106003,106003,106005,0,2,2
30266,3,2,106006,106006,106008,0,2,1
30267,1,1,106007,106008,106009,1,2,0
30268,3,2,106010,106010,106012,0,2,1
30269,1,3,106011,106012,106015,1,4,0
30270,1,2,106012,106015,106017,3,5,0
30271,6,2,106018,106018,106020,0,2,1
30272,3,1,106021,106021,106022,0,1,1
30273,4,2,106025,106025,106027,0,2,3
30274,3,1,106028,106028,106029,0,1,1
30275,5,3,106033,106033,106036,0,3,4
30276,6,2,106039,106039,106041,0,2,3
30277,2,2,106041,106041,106043,0,2,0
30278,3,3,106044,106044,106047,0,3,1
30279,6,3,106050,106050,106053,0,3,3
30280,2,1,106052,106053,106054,1,2,0
30281,6,2,106058,106058,106060,0,2,4
30282,1,1,106059,106060,106061,1,2,0
30283,5,2,106064,106064,106066,0,2,3
30284,4,2,106068,106068,106070,0,2,2
30285,1,1,106069,106070,106071,1,2,0
30286,3,3,106072,106072,106075,0,3,1
30287,3,3,106075,106075,106078,0,3,0
30288,2,2,106077,106078,106080,1,3,0
30289,5,1,106082,106082,106083,0,1,2
30290,2,2,106084,106084,106086,0,2,1
30291,2,2,106086,106086,106088,0,2,0
30292,1,3,106087,106088,106091,1,4,0
30293,5,2,106092,106092,106094,0,2,1
30294,6,1,106098,106098,106099,0,1,4
30295,3,2,106101,106101,106103,0,2,2
30296,4,1,106105,106105,106106,0,1,2
30297,3,3,106108,106108,106111,0,3,2
30298,2,1,106110,106111,106112,1,2,0
30299,1,2,106111,106112,106114,1,3,0
30300,6,3,106117,106117,106120,0,3,3
30301,2,3,106119,106120,106123,1,4,0
30302,5,2,106124,106124,106126,0,2,1
30303,3,3,106127,106127,106130,0,3,1
30304,1,3,106128,106130,106133,2,5,0
30305,2,3,106130,106133,106136,3,6,0
30306,1,3,106131,106136,106139,5,8,0
30307,3,3,106134,106139,106142,5,8,0
30308,2,3,106136,106142,106145,6,9,0
30309,3,1,106139,106145,106146,6,7,0
30310,4,3,106143,106146,106149,3,6,0
30311,6,2,106149,106149,106151,0,2,0
30312,1,3,106150,106151,106154,1,4,0
30313,6,3,106156,106156,106159,0,3,2
30314,6,2,106162,106162,106164,0,2,3
30315,1,2,106163,106164,106166,1,3,0
30316,6,2,106169,106169,106171,0,2,3
30317,1,1,106170,106171,106172,1,2,0
30318,6,1,106176,106176,106177,0,1,4
30319,3,1,106179,106179,106180,0,1,2
30320,4,1,106183,106183,106184,0,1,3
30321,2,2,106185,106185,106187,0,2,1
30322,4,1,106189,106189,106190,0,1,2
30323,5,3,106194,106194,106197,0,3,4
30324,4,1,106198,106198,106199,0,1,1
30325,3,2,106201,106201,106203,0,2,2
30326,6,3,106207,106207,106210,0,3,4
30327,5,1,106212,106212,106213,0,1,2
30328,1,3,106213,106213,106216,0,3,0
30329,2,1,106215,106216,106217,1,2,0
30330,5,2,106220,106220,106222,0,2,3
30331,1,3,106221,106222,106225,1,4,0
30332,3,1,106224,106225,106226,1,2,0
30333,4,2,106228,106228,106230,0,2,2
30334,3,2,106231,106231,106233,0,2,1
30335,3,3,106234,106234,106237,0,3,1
30336,5,3,106239,106239,106242,0,3,2
30337,2,1,106241,106242,106243,1,2,0
30338,1,3,106242,106243,106246,1,4,0
30339,4,3,106246,106246,106249,0,3,0
30340,1,1,106247,106249,106250,2,3,0
30341,1,3,106248,106250,106253,2,5,0
30342,1,3,106249,106253,106256,4,7,0
30343,5,2,106254,106256,106258,2,4,0
30344,4,2,106258,106258,106260,0,2,0
30345,1,2,106259,106260,106262,1,3,0
30346,6,2,106265,106265,106267,0,2,3
30347,6,1,106271,106271,106272,0,1,4
30348,6,3,106277,106277,106280,0,3,5
30349,1,1,106278,106280,106281,2,3,0
30350,1,1,106279,106281,106282,2,3,0
30351,6,2,106285,106285,106287,0,2,3
30352,4,1,106289,106289,106290,0,1,2
30353,4,3,106293,106293,106296,0,3,3
30354,2,1,106295,106296,106297,1,2,0
30355,2,2,106297,106297,106299,0,2,0
30356,1,2,106298,106299,106301,1,3,0
30357,1,2,106299,106301,106303,2,4,0
30358,1,1,106300,106303,106304,3,4,0
30359,5,3,106305,106305,106308,0,3,1
30360,1,1,106306,106308,106309,2,3,0
30361,3,3,106309,106309,106312,0,3,0
30362,4,2,106313,106313,106315,0,2,1
30363,6,3,106319,106319,106322,0,3,4
30364,3,1,106322,106322,106323,0,1,0
30365,5,1,106327,106327,106328,0,1,4
30366,6,3,106333,106333,106336,0,3,5
30367,5,3,106338,106338,106341,0,3,2
30368,5,2,106343,106343,106345,0,2,2
30369,6,1,106349,106349,106350,0,1,4
30370,4,3,106353,106353,106356,0,3,3
30371,4,2,106357,106357,106359,0,2,1
30372,1,1,106358,106359,106360,1,2,0
30373,5,1,106363,106363,106364,0,1,3
30374,4,1,106367,106367,106368,0,1,3
30375,6,2,106373,106373,106375,0,2,5
30376,1,3,106374,106375,106378,1,4,0
30377,2,1,106376,106378,106379,2,3,0
30378,6,3,106382,106382,106385,0,3,3
30379,4,3,106386,106386,106389,0,3,1
30380,4,2,106390,106390,106392,0,2,1
30381,2,2,106392,106392,106394,0,2,0
30382,4,3,106396,106396,106399,0,3,2
30383,5,2,106401,106401,106403,0,2,2
30384,2,2,106403,106403,106405,0,2,0
30385,6,2,106409,106409,106411,0,2,4
30386,1,2,106410,106411,106413,1,3,0
30387,5,2,106415,106415,106417,0,2,2
30388,2,1,106417,106417,106418,0,1,0
30389,1,2,106418,106418,106420,0,2,0
30390,6,2,106424,106424,106426,0,2,4
30391,6,3,106430,106430,106433,0,3,4
30392,2,3,106432,106433,106436,1,4,0
30393,4,3,106436,106436,106439,0,3,0
30394,5,3,106441,106441,106444,0,3,2
30395,3,1,106444,106444,106445,0,1,0
30396,5,2,106449,106449,106451,0,2,4
30397,1,1,106450,106451,106452,1,2,0
30398,2,3,106452,106452,106455,0,3,0
30399,3,2,106455,106455,106457,0,2,0
30400,2,3,106457,106457,106460,0,3,0
30401,2,1,106459,106460,106461,1,2,0
30402,5,1,106464,106464,106465,0,1,3
30403,4,1,106468,106468,106469,0,1,3
30404,4,3,106472,106472,106475,0,3,3
30405,4,2,106476,106476,106478,0,2,1
30406,1,1,106477,106478,106479,1,2,0
30407,3,3,106480,106480,106483,0,3,1
30408,3,2,106483,106483,106485,0,2,0
30409,4,2,106487,106487,106489,0,2,2
30410,4,3,106491,106491,106494,0,3,2
30411,4,1,106495,106495,106496,0,1,1
30412,2,3,106497,106497,106500,0,3,1
30413,1,2,106498,106500,106502,2,4,0
30414,4,3,106502,106502,106505,0,3,0
30415,2,3,106504,106505,106508,1,4,0
30416,3,1,106507,106508,106509,1,2,0
30417,6,3,106513,106513,106516,0,3,4
30418,6,2,106519,106519,106521,0,2,3
30419,3,1,106522,106522,106523,0,1,1
30420,5,3,106527,106527,106530,0,3,4
30421,4,1,106531,106531,106532,0,1,1
30422,4,1,106535,106535,106536,0,1,3
30423,2,3,106537,106537,106540,0,3,1
30424,6,3,106543,106543,106546,0,3,3
30425,2,3,106545,106546,106549,1,4,0
30426,4,3,106549,106549,106552,0,3,0
30427,5,1,106554,106554,106555,0,1,2
30428,1,1,106555,106555,106556,0,1,0
30429,1,3,106556,106556,106559,0,3,0
30430,3,3,106559,106559,106562,0,3,0
30431,1,1,106560,106562,106563,2,3,0
30432,2,1,106562,106563,106564,1,2,0
30433,3,1,106565,106565,106566,0,1,1
30434,1,3,106566,106566,106569,0,3,0
30435,6,2,106572,106572,106574,0,2,3
30436,3,2,106575,106575,106577,0,2,1
30437,2,3,106577,106577,106580,0,3,0
30438,1,2,106578,106580,106582,2,4,0
30439,1,3,106579,106582,106585,3,6,0
30440,6,2,106585,106585,106587,0,2,0
30441,4,1,106589,106589,106590,0,1,2
30442,2,2,106591,106591,106593,0,2,1
30443,3,2,106594,106594,106596,0,2,1
30444,4,1,106598,106598,106599,0,1,2
30445,2,2,106600,106600,106602,0,2,1
30446,3,1,106603,106603,106604,0,1,1
30447,5,2,106608,106608,106610,0,2,4
30448,6,3,106614,106614,106617,0,3,4
30449,6,2,106620,106620,106622,0,2,3
30450,4,3,106624,106624,106627,0,3,2
30451,6,3,106630,106630,106633,0,3,3
30452,4,3,106634,106634,106637,0,3,1
30453,1,1,106635,106637,106638,2,3,0
30454,4,3,106639,106639,106642,0,3,1
30455,1,2,106640,106642,106644,2,4,0
30456,5,1,106645,106645,106646,0,1,1
30457,4,3,106649,106649,106652,0,3,3
30458,3,1,106652,106652,106653,0,1,0
30459,2,2,106654,106654,106656,0,2,1
30460,2,2,106656,106656,106658,0,2,0
30461,5,3,106661,106661,106664,0,3,3
30462,2,1,106663,106664,106665,1,2,0
30463,3,1,106666,106666,106667,0,1,1
30464,1,2,106667,106667,106669,0,2,0
30465,4,2,106671,106671,106673,0,2,2
30466,1,2,106672,106673,106675,1,3,0
30467,6,3,106678,106678,106681,0,3,3
30468,6,1,106684,106684,106685,0,1,3
30469,5,1,106689,106689,106690,0,1,4
30470,4,3,106693,106693,106696,0,3,3
30471,2,2,106695,106696,106698,1,3,0
30472,6,3,106701,106701,106704,0,3,3
30473,2,2,106703,106704,106706,1,3,0
30474,4,3,106707,106707,106710,0,3,1
30475,3,1,106710,106710,106711,0,1,0
30476,2,1,106712,106712,106713,0,1,1
30477,3,1,106715,106715,106716,0,1,2
30478,1,3,106716,106716,106719,0,3,0
30479,1,1,106717,106719,106720,2,3,0
30480,4,3,106721,106721,106724,0,3,1
30481,1,1,106722,106724,106725,2,3,0
30482,6,3,106728,106728,106731,0,3,3
30483,4,3,106732,106732,106735,0,3,1
30484,6,3,106738,106738,106741,0,3,3
30485,4,3,106742,106742,106745,0,3,1
30486,4,3,106746,106746,106749,0,3,1
30487,6,2,106752,106752,106754,0,2,3
30488,4,2,106756,106756,106758,0,2,2
30489,1,1,106757,106758,106759,1,2,0
30490,3,2,106760,106760,106762,0,2,1
30491,3,1,106763,106763,106764,0,1,1
30492,5,3,106768,106768,106771,0,3,4
30493,6,2,106774,106774,106776,0,2,3
30494,4,1,106778,106778,106779,0,1,2
30495,4,1,106782,106782,106783,0,1,3
30496,5,3,106787,106787,106790,0,3,4
30497,5,2,106792,106792,106794,0,2,2
30498,5,3,106797,106797,106800,0,3,3
30499,1,2,106798,106800,106802,2,4,0
30500,6,3,106804,106804,106807,0,3,2
30501,6,1,106810,106810,106811,0,1,3
30502,3,3,106813,106813,106816,0,3,2
30503,3,2,106816,106816,106818,0,2,0
30504,6,3,106822,106822,106825,0,3,4
30505,1,2,106823,106825,106827,2,4,0
30506,5,3,106828,106828,106831,0,3,1
30507,3,2,106831,106831,106833,0,2,0
30508,5,2,106836,106836,106838,0,2,3
30509,6,3,106842,106842,106845,0,3,4
30510,2,2,106844,106845,106847,1,3,0
30511,4,2,106848,106848,106850,0,2,1
30512,2,3,106850,106850,106853,0,3,0
30513,1,2,106851,106853,106855,2,4,0
30514,3,2,106854,106855,106857,1,3,0
30515,5,1,106859,106859,106860,0,1,2
30516,4,3,106863,106863,106866,0,3,3
30517,2,2,106865,106866,106868,1,3,0
30518,4,1,106869,106869,106870,0,1,1
30519,3,3,106872,106872,106875,0,3,2
30520,4,2,106876,106876,106878,0,2,1
30521,1,3,106877,106878,106881,1,4,0
30522,1,3,106878,106881,106884,3,6,0
30523,4,3,106882,106884,106887,2,5,0
30524,4,3,106886,106887,106890,1,4,0
30525,5,3,106891,106891,106894,0,3,1
30526,2,3,106893,106894,106897,1,4,0
30527,6,3,106899,106899,106902,0,3,2
30528,6,1,106905,106905,106906,0,1,3
30529,1,3,106906,106906,106909,0,3,0
30530,1,3,106907,106909,106912,2,5,0
30531,4,1,106911,106912,106913,1,2,0
30532,1,1,106912,106913,106914,1,2,0
30533,1,2,106913,106914,106916,1,3,0
30534,4,3,106917,106917,106920,0,3,1
30535,1,1,106918,106920,106921,2,3,0
30536,4,1,106922,106922,106923,0,1,1
30537,1,1,106923,106923,106924,0,1,0
30538,6,2,106929,106929,106931,0,2,5
30539,5,2,106934,106934,106936,0,2,3
30540,1,3,106935,106936,106939,1,4,0
30541,6,2,106941,106941,106943,0,2,2
30542,4,2,106945,106945,106947,0,2,2
30543,4,1,106949,106949,106950,0,1,2
30544,2,1,106951,106951,106952,0,1,1
30545,6,2,106957,106957,106959,0,2,5
30546,6,2,106963,106963,106965,0,2,4
30547,4,2,106967,106967,106969,0,2,2
30548,2,2,106969,106969,106971,0,2,0
30549,5,1,106974,106974,106975,0,1,3
30550,1,2,106975,106975,106977,0,2,0
30551,2,2,106977,106977,106979,0,2,0
30552,6,3,106983,106983,106986,0,3,4
30553,5,2,106988,106988,106990,0,2,2
30554,2,2,106990,106990,106992,0,2,0
30555,4,2,106994,106994,106996,0,2,2
30556,6,3,107000,107000,107003,0,3,4
30557,5,1,107005,107005,107006,0,1,2
30558,6,3,107011,107011,107014,0,3,5
30559,1,1,107012,107014,107015,2,3,0
30560,2,1,107014,107015,107016,1,2,0
30561,2,1,107016,107016,107017,0,1,0
30562,6,3,107022,107022,107025,0,3,5
30563,5,3,107027,107027,107030,0,3,2
30564,4,1,107031,107031,107032,0,1,1
30565,5,1,107036,107036,107037,0,1,4
30566,5,1,107041,107041,107042,0,1,4
30567,1,3,107042,107042,107045,0,3,0
30568,2,2,107044,107045,107047,1,3,0
30569,3,2,107047,107047,107049,0,2,0
30570,1,1,107048,107049,107050,1,2,0
30571,5,1,107053,107053,107054,0,1,3
30572,3,2,107056,107056,107058,0,2,2
30573,3,2,107059,107059,107061,0,2,1
30574,1,1,107060,107061,107062,1,2,0
30575,3,2,107063,107063,107065,0,2,1
30576,1,1,107064,107065,107066,1,2,0
30577,3,1,107067,107067,107068,0,1,1
30578,5,3,107072,107072,107075,0,3,4
30579,5,2,107077,107077,107079,0,2,2
30580,5,3,107082,107082,107085,0,3,3
30581,5,3,107087,107087,107090,0,3,2
30582,5,1,107092,107092,107093,0,1,2
30583,6,3,107098,107098,107101,0,3,5
30584,5,1,107103,107103,107104,0,1,2
30585,2,2,107105,107105,107107,0,2,1
30586,5,2,107110,107110,107112,0,2,3
30587,4,2,107114,107114,107116,0,2,2
30588,2,3,107116,107116,107119,0,3,0
30589,5,1,107121,107121,107122,0,1,2
30590,3,2,107124,107124,107126,0,2,2
30591,3,1,107127,107127,107128,0,1,1
30592,3,1,107130,107130,107131,0,1,2
30593,2,2,107132,107132,107134,0,2,1
30594,5,1,107137,107137,107138,0,1,3
30595,4,1,107141,107141,107142,0,1,3
30596,1,2,107142,107142,107144,0,2,0
30597,1,2,107143,107144,107146,1,3,0
30598,5,2,107148,107148,107150,0,2,2
30599,5,3,107153,107153,107156,0,3,3
30600,5,1,107158,107158,107159,0,1,2
30601,2,3,107160,107160,107163,0,3,1
30602,4,1,107164,107164,107165,0,1,1
30603,2,3,107166,107166,107169,0,3,1
30604,3,2,107169,107169,107171,0,2,0
30605,6,3,107175,107175,107178,0,3,4
30606,3,3,107178,107178,107181,0,3,0
30607,4,3,107182,107182,107185,0,3,1
30608,4,1,107186,107186,107187,0,1,1
30609,1,1,107187,107187,107188,0,1,0
30610,1,3,107188,107188,107191,0,3,0
30611,3,3,107191,107191,107194,0,3,0
30612,1,2,107192,107194,107196,2,4,0
30613,3,2,107195,107196,107198,1,3,0
30614,6,1,107201,107201,107202,0,1,3
30615,4,1,107205,107205,107206,0,1,3
30616,3,3,107208,107208,107211,0,3,2
30617,5,1,107213,107213,107214,0,1,2
30618,6,3,107219,107219,107222,0,3,5
30619,6,3,107225,107225,107228,0,3,3
30620,3,3,107228,107228,107231,0,3,0
30621,5,3,107233,107233,107236,0,3,2
30622,3,2,107236,107236,107238,0,2,0
30623,3,1,107239,107239,107240,0,1,1
30624,1,2,107240,107240,107242,0,2,0
30625,2,1,107242,107242,107243,0,1,0
30626,3,2,107245,107245,107247,0,2,2
30627,6,2,107251,107251,107253,0,2,4
30628,4,3,107255,107255,107258,0,3,2
30629,6,1,107261,107261,107262,0,1,3
30630,3,3,107264,107264,107267,0,3,2
30631,5,2,107269,107269,107271,0,2,2
30632,4,3,107273,107273,107276,0,3,2
30633,1,1,107274,107276,107277,2,3,0
30634,5,1,107279,107279,107280,0,1,2
30635,6,2,107285,107285,107287,0,2,5
30636,2,2,107287,107287,107289,0,2,0
30637,6,3,107293,107293,107296,0,3,4
30638,2,1,107295,107296,107297,1,2,0
30639,4,1,107299,107299,107300,0,1,2
30640,2,1,107301,107301,107302,0,1,1
30641,6,1,107307,107307,107308,0,1,5
30642,6,3,107313,107313,107316,0,3,5
30643,3,1,107316,107316,107317,0,1,0
30644,6,3,107322,107322,107325,0,3,5
30645,3,2,107325,107325,107327,0,2,0
30646,3,1,107328,107328,107329,0,1,1
30647,3,1,107331,107331,107332,0,1,2
30648,2,1,107333,107333,107334,0,1,1
30649,2,2,107335,107335,107337,0,2,1
30650,5,2,107340,107340,107342,0,2,3
30651,4,2,107344,107344,107346,0,2,2
30652,3,2,107347,107347,107349,0,2,1
30653,6,3,107353,107353,107356,0,3,4
30654,5,3,107358,107358,107361,0,3,2
30655,5,1,107363,107363,107364,0,1,2
30656,6,2,107369,107369,107371,0,2,5
30657,4,3,107373,107373,107376,0,3,2
30658,5,1,107378,107378,107379,0,1,2
30659,2,1,107380,107380,107381,0,1,1
30660,2,3,107382,107382,107385,0,3,1
30661,6,1,107388,107388,107389,0,1,3
30662,1,1,107389,107389,107390,0,1,0
30663,6,2,107395,107395,107397,0,2,5
30664,4,1,107399,107399,107400,0,1,2
30665,4,3,107403,107403,107406,0,3,3
30666,4,2,107407,107407,107409,0,2,1
30667,5,1,107412,107412,107413,0,1,3
30668,2,3,107414,107414,107417,0,3,1
30669,6,3,107420,107420,107423,0,3,3
30670,5,3,107425,107425,107428,0,3,2
30671,1,3,107426,107428,107431,2,5,0
30672,2,1,107428,107431,107432,3,4,0
30673,2,1,107430,107432,107433,2,3,0
30674,3,1,107433,107433,107434,0,1,0
30675,2,2,107435,107435,107437,0,2,1
30676,1,1,107436,107437,107438,1,2,0
30677,4,1,107440,107440,107441,0,1,2
30678,4,3,107444,107444,107447,0,3,3
30679,5,2,107449,107449,107451,0,2,2
30680,6,2,107455,107455,107457,0,2,4
30681,2,1,107457,107457,107458,0,1,0
30682,2,1,107459,107459,107460,0,1,1
30683,6,3,107465,107465,107468,0,3,5
30684,1,2,107466,107468,107470,2,4,0
30685,6,3,107472,107472,107475,0,3,2
30686,4,3,107476,107476,107479,0,3,1
30687,2,3,107478,107479,107482,1,4,0
30688,6,2,107484,107484,107486,0,2,2
30689,4,2,107488,107488,107490,0,2,2
30690,3,1,107491,107491,107492,0,1,1
30691,4,1,107495,107495,107496,0,1,3
30692,6,1,107501,107501,107502,0,1,5
30693,4,3,107505,107505,107508,0,3,3
30694,1,2,107506,107508,107510,2,4,0
30695,4,2,107510,107510,107512,0,2,0
30696,5,1,107515,107515,107516,0,1,3
30697,4,3,107519,107519,107522,0,3,3
30698,2,3,107521,107522,107525,1,4,0
30699,3,2,107524,107525,107527,1,3,0
30700,4,1,107528,107528,107529,0,1,1
30701,3,3,107531,107531,107534,0,3,2
30702,4,3,107535,107535,107538,0,3,1
30703,2,1,107537,107538,107539,1,2,0
30704,6,2,107543,107543,107545,0,2,4
30705,5,2,107548,107548,107550,0,2,3
30706,2,3,107550,107550,107553,0,3,0
30707,4,3,107554,107554,107557,0,3,1
30708,1,1,107555,107557,107558,2,3,0
30709,3,3,107558,107558,107561,0,3,0
30710,3,3,107561,107561,107564,0,3,0
30711,6,3,107567,107567,107570,0,3,3
30712,1,3,107568,107570,107573,2,5,0
30713,1,3,107569,107573,107576,4,7,0
30714,4,3,107573,107576,107579,3,6,0
30715,4,1,107577,107579,107580,2,3,0
30716,4,1,107581,107581,107582,0,1,1
30717,5,3,107586,107586,107589,0,3,4
30718,3,1,107589,107589,107590,0,1,0
30719,3,2,107592,107592,107594,0,2,2
30720,1,2,107593,107594,107596,1,3,0
30721,1,2,107594,107596,107598,2,4,0
30722,2,3,107596,107598,107601,2,5,0
30723,2,1,107598,107601,107602,3,4,0
30724,6,3,107604,107604,107607,0,3,2
30725,2,3,107606,107607,107610,1,4,0
30726,3,2,107609,107610,107612,1,3,0
30727,3,1,107612,107612,107613,0,1,0
30728,1,1,107613,107613,107614,0,1,0
30729,3,3,107616,107616,107619,0,3,2
30730,4,2,107620,107620,107622,0,2,1
30731,3,3,107623,107623,107626,0,3,1
30732,3,3,107626,107626,107629,0,3,0
30733,4,2,107630,107630,107632,0,2,1
30734,1,1,107631,107632,107633,1,2,0
30735,4,2,107635,107635,107637,0,2,2
30736,5,3,107640,107640,107643,0,3,3
30737,2,3,107642,107643,107646,1,4,0
30738,2,1,107644,107646,107647,2,3,0
30739,1,1,107645,107647,107648,2,3,0
30740,3,3,107648,107648,107651,0,3,0
30741,1,2,107649,107651,107653,2,4,0
30742,6,1,107655,107655,107656,0,1,2
30743,4,1,107659,107659,107660,0,1,3
30744,4,2,107663,107663,107665,0,2,3
30745,2,1,107665,107665,107666,0,1,0
30746,4,2,107669,107669,107671,0,2,3
30747,2,3,107671,107671,107674,0,3,0
30748,3,2,107674,107674,107676,0,2,0
30749,5,1,107679,107679,107680,0,1,3
30750,2,2,107681,107681,107683,0,2,1
30751,2,2,107683,107683,107685,0,2,0
30752,5,3,107688,107688,107691,0,3,3
30753,2,1,107690,107691,107692,1,2,0
30754,2,3,107692,107692,107695,0,3,0
30755,4,2,107696,107696,107698,0,2,1
30756,5,3,107701,107701,107704,0,3,3
30757,6,1,107707,107707,107708,0,1,3
30758,4,3,107711,107711,107714,0,3,3
30759,1,1,107712,107714,107715,2,3,0
30760,5,2,107717,107717,107719,0,2,2
30761,1,3,107718,107719,107722,1,4,0
30762,2,1,107720,107722,107723,2,3,0
30763,6,1,107726,107726,107727,0,1,3
30764,6,3,107732,107732,107735,0,3,5
30765,6,2,107738,107738,107740,0,2,3
30766,3,1,107741,107741,107742,0,1,1
30767,1,1,107742,107742,107743,0,1,0
30768,5,3,107747,107747,107750,0,3,4
30769,3,2,107750,107750,107752,0,2,0
30770,6,3,107756,107756,107759,0,3,4
30771,6,1,107762,107762,107763,0,1,3
30772,3,2,107765,107765,107767,0,2,2
30773,2,1,107767,107767,107768,0,1,0
30774,6,3,107773,107773,107776,0,3,5
30775,1,2,107774,107776,107778,2,4,0
30776,1,3,107775,107778,107781,3,6,0
30777,1,1,107776,107781,107782,5,6,0
30778,6,1,107782,107782,107783,0,1,0
30779,6,2,107788,107788,107790,0,2,5
30780,4,3,107792,107792,107795,0,3,2
30781,3,3,107795,107795,107798,0,3,0
30782,5,3,107800,107800,107803,0,3,2
30783,6,2,107806,107806,107808,0,2,3
30784,4,1,107810,107810,107811,0,1,2
30785,3,3,107813,107813,107816,0,3,2
30786,3,3,107816,107816,107819,0,3,0
30787,4,3,107820,107820,107823,0,3,1
30788,2,1,107822,107823,107824,1,2,0
30789,6,3,107828,107828,107831,0,3,4
30790,2,1,107830,107831,107832,1,2,0
30791,2,3,107832,107832,107835,0,3,0
30792,5,1,107837,107837,107838,0,1,2
30793,6,3,107843,107843,107846,0,3,5
30794,6,3,107849,107849,107852,0,3,3
30795,6,1,107855,107855,107856,0,1,3
30796,6,1,107861,107861,107862,0,1,5
30797,6,3,107867,107867,107870,0,3,5
30798,4,3,107871,107871,107874,0,3,1
30799,6,1,107877,107877,107878,0,1,3
30800,4,1,107881,107881,107882,0,1,3
30801,5,2,107886,107886,107888,0,2,4
30802,1,1,107887,107888,107889,1,2,0
30803,6,3,107893,107893,107896,0,3,4
30804,4,3,107897,107897,107900,0,3,1
30805,2,3,107899,107900,107903,1,4,0
30806,5,2,107904,107904,107906,0,2,1
30807,1,2,107905,107906,107908,1,3,0
30808,6,3,107911,107911,107914,0,3,3
30809,5,1,107916,107916,107917,0,1,2
30810,4,3,107920,107920,107923,0,3,3
30811,6,3,107926,107926,107929,0,3,3
30812,4,1,107930,107930,107931,0,1,1
30813,1,2,107931,107931,107933,0,2,0
30814,4,3,107935,107935,107938,0,3,2
30815,6,1,107941,107941,107942,0,1,3
30816,1,3,107942,107942,107945,0,3,0
30817,2,3,107944,107945,107948,1,4,0
30818,6,3,107950,107950,107953,0,3,2
30819,4,3,107954,107954,107957,0,3,1
30820,2,1,107956,107957,107958,1,2,0
30821,3,2,107959,107959,107961,0,2,1
30822,2,2,107961,107961,107963,0,2,0
30823,5,2,107966,107966,107968,0,2,3
30824,4,1,107970,107970,107971,0,1,2
30825,4,2,107974,107974,107976,0,2,3
30826,1,3,107975,107976,107979,1,4,0
30827,2,2,107977,107979,107981,2,4,0
30828,1,2,107978,107981,107983,3,5,0
30829,1,3,107979,107983,107986,4,7,0
30830,5,1,107984,107986,107987,2,3,0
30831,5,2,107989,107989,107991,0,2,2
30832,6,3,107995,107995,107998,0,3,4
30833,2,3,107997,107998,108001,1,4,0
30834,1,2,107998,108001,108003,3,5,0
30835,4,3,108002,108003,108006,1,4,0
30836,6,2,108008,108008,108010,0,2,2
30837,6,1,108014,108014,108015,0,1,4
30838,1,3,108015,108015,108018,0,3,0
30839,4,2,108019,108019,108021,0,2,1
30840,2,2,108021,108021,108023,0,2,0
30841,6,2,108027,108027,108029,0,2,4
30842,3,2,108030,108030,108032,0,2,1
30843,2,1,108032,108032,108033,0,1,0
30844,2,1,108034,108034,108035,0,1,1
30845,2,3,108036,108036,108039,0,3,1
30846,3,3,108039,108039,108042,0,3,0
30847,2,1,108041,108042,108043,1,2,0
30848,3,1,108044,108044,108045,0,1,1
30849,4,1,108048,108048,108049,0,1,3
30850,1,2,108049,108049,108051,0,2,0
30851,2,3,108051,108051,108054,0,3,0
30852,4,1,108055,108055,108056,0,1,1
30853,6,2,108061,108061,108063,0,2,5
30854,4,1,108065,108065,108066,0,1,2
30855,3,2,108068,108068,108070,0,2,2
30856,6,1,108074,108074,108075,0,1,4
30857,5,3,108079,108079,108082,0,3,4
30858,6,1,108085,108085,108086,0,1,3
30859,6,2,108091,108091,108093,0,2,5
30860,5,1,108096,108096,108097,0,1,3
30861,4,3,108100,108100,108103,0,3,3
30862,4,3,108104,108104,108107,0,3,1
30863,6,3,108110,108110,108113,0,3,3
30864,1,2,108111,108113,108115,2,4,0
30865,4,3,108115,108115,108118,0,3,0
30866,6,3,108121,108121,108124,0,3,3
30867,6,2,108127,108127,108129,0,2,3
30868,5,1,108132,108132,108133,0,1,3
30869,2,1,108134,108134,108135,0,1,1
30870,3,3,108137,108137,108140,0,3,2
30871,1,1,108138,108140,108141,2,3,0
30872,3,1,108141,108141,108142,0,1,0
30873,3,3,108144,108144,108147,0,3,2
30874,6,1,108150,108150,108151,0,1,3
30875,2,1,108152,108152,108153,0,1,1
30876,3,1,108155,108155,108156,0,1,2
30877,3,3,108158,108158,108161,0,3,2
30878,3,1,108161,108161,108162,0,1,0
30879,1,1,108162,108162,108163,0,1,0
30880,3,2,108165,108165,108167,0,2,2
30881,6,1,108171,108171,108172,0,1,4
30882,5,3,108176,108176,108179,0,3,4
30883,3,2,108179,108179,108181,0,2,0
30884,1,3,108180,108181,108184,1,4,0
30885,1,1,108181,108184,108185,3,4,0
30886,6,2,108187,108187,108189,0,2,2
30887,3,1,108190,108190,108191,0,1,1
30888,2,1,108192,108192,108193,0,1,1
30889,5,1,108197,108197,108198,0,1,4
30890,6,1,108203,108203,108204,0,1,5
30891,5,3,108208,108208,108211,0,3,4
30892,3,1,108211,108211,108212,0,1,0
30893,2,2,108213,108213,108215,0,2,1
30894,3,1,108216,108216,108217,0,1,1
30895,5,1,108221,108221,108222,0,1,4
30896,1,3,108222,108222,108225,0,3,0
30897,2,3,108224,108225,108228,1,4,0
30898,6,3,108230,108230,108233,0,3,2
30899,5,1,108235,108235,108236,0,1,2
30900,5,1,108240,108240,108241,0,1,4
30901,2,3,108242,108242,108245,0,3,1
30902,4,1,108246,108246,108247,0,1,1
30903,4,2,108250,108250,108252,0,2,3
30904,2,2,108252,108252,108254,0,2,0
30905,2,3,108254,108254,108257,0,3,0
30906,4,1,108258,108258,108259,0,1,1
30907,2,2,108260,108260,108262,0,2,1
30908,1,1,108261,108262,108263,1,2,0
30909,1,1,108262,108263,108264,1,2,0
30910,5,1,108267,108267,108268,0,1,3
30911,4,1,108271,108271,108272,0,1,3
30912,3,1,108274,108274,108275,0,1,2
30913,2,3,108276,108276,108279,0,3,1
30914,1,1,108277,108279,108280,2,3,0
30915,3,2,108280,108280,108282,0,2,0
30916,5,3,108285,108285,108288,0,3,3
30917,2,2,108287,108288,108290,1,3,0
30918,3,2,108290,108290,108292,0,2,0
30919,5,1,108295,108295,108296,0,1,3
30920,1,3,108296,108296,108299,0,3,0
30921,6,2,108302,108302,108304,0,2,3
30922,1,1,108303,108304,108305,1,2,0
30923,5,3,108308,108308,108311,0,3,3
30924,6,2,108314,108314,108316,0,2,3
30925,5,3,108319,108319,108322,0,3,3
30926,4,1,108323,108323,108324,0,1,1
30927,1,1,108324,108324,108325,0,1,0
30928,1,2,108325,108325,108327,0,2,0
30929,6,3,108331,108331,108334,0,3,4
30930,5,1,108336,108336,108337,0,1,2
30931,5,1,108341,108341,108342,0,1,4
30932,5,1,108346,108346,108347,0,1,4
30933,1,2,108347,108347,108349,0,2,0
30934,4,2,108351,108351,108353,0,2,2
30935,3,1,108354,108354,108355,0,1,1
30936,3,1,108357,108357,108358,0,1,2
30937,6,3,108363,108363,108366,0,3,5
30938,2,3,108365,108366,108369,1,4,0
30939,6,3,108371,108371,108374,0,3,2
30940,5,2,108376,108376,108378,0,2,2
30941,2,1,108378,108378,108379,0,1,0
30942,2,3,108380,108380,108383,0,3,1
30943,5,1,108385,108385,108386,0,1,2
30944,2,3,108387,108387,108390,0,3,1
30945,3,1,108390,108390,108391,0,1,0
30946,3,2,108393,108393,108395,0,2,2
30947,5,1,108398,108398,108399,0,1,3
30948,5,3,108403,108403,108406,0,3,4
30949,5,1,108408,108408,108409,0,1,2
30950,2,3,108410,108410,108413,0,3,1
30951,2,2,108412,108413,108415,1,3,0
30952,1,1,108413,108415,108416,2,3,0
30953,2,3,108415,108416,108419,1,4,0
30954,6,3,108421,108421,108424,0,3,2
30955,5,2,108426,108426,108428,0,2,2
30956,4,2,108430,108430,108432,0,2,2
30957,1,3,108431,108432,108435,1,4,0
30958,4,3,108435,108435,108438,0,3,0
30959,1,2,108436,108438,108440,2,4,0
30960,1,2,108437,108440,108442,3,5,0
30961,1,3,108438,108442,108445,4,7,0
30962,3,1,108441,108445,108446,4,5,0
30963,5,2,108446,108446,108448,0,2,0
30964,5,1,108451,108451,108452,0,1,3
30965,2,1,108453,108453,108454,0,1,1
30966,6,3,108459,108459,108462,0,3,5
30967,2,3,108461,108462,108465,1,4,0
30968,1,2,108462,108465,108467,3,5,0
30969,5,3,108467,108467,108470,0,3,0
30970,6,1,108473,108473,108474,0,1,3
30971,4,3,108477,108477,108480,0,3,3
30972,3,2,108480,108480,108482,0,2,0
30973,4,3,108484,108484,108487,0,3,2
30974,3,3,108487,108487,108490,0,3,0
30975,6,3,108493,108493,108496,0,3,3
30976,1,1,108494,108496,108497,2,3,0
30977,4,3,108498,108498,108501,0,3,1
30978,5,3,108503,108503,108506,0,3,2
30979,5,2,108508,108508,108510,0,2,2
30980,6,2,108514,108514,108516,0,2,4
30981,2,1,108516,108516,108517,0,1,0
30982,4,2,108520,108520,108522,0,2,3
30983,2,3,108522,108522,108525,0,3,0
30984,4,1,108526,108526,108527,0,1,1
30985,4,3,108530,108530,108533,0,3,3
30986,2,3,108532,108533,108536,1,4,0
30987,6,2,108538,108538,108540,0,2,2
30988,2,3,108540,108540,108543,0,3,0
30989,5,1,108545,108545,108546,0,1,2
30990,6,1,108551,108551,108552,0,1,5
30991,6,1,108557,108557,108558,0,1,5
30992,5,2,108562,108562,108564,0,2,4
30993,3,2,108565,108565,108567,0,2,1
30994,5,2,108570,108570,108572,0,2,3
30995,1,2,108571,108572,108574,1,3,0
30996,4,2,108575,108575,108577,0,2,1
30997,4,3,108579,108579,108582,0,3,2
30998,1,1,108580,108582,108583,2,3,0
30999,4,1,108584,108584,108585,0,1,1
31000,5,2,108589,108589,108591,0,2,4
31001,2,2,108591,108591,108593,0,2,0
31002,4,1,108595,108595,108596,0,1,2
31003,2,1,108597,108597,108598,0,1,1
31004,2,1,108599,108599,108600,0,1,1
31005,6,1,108605,108605,108606,0,1,5
31006,3,2,108608,108608,108610,0,2,2
31007,4,2,108612,108612,108614,0,2,2
31008,4,3,108616,108616,108619,0,3,2
31009,1,2,108617,108619,108621,2,4,0
31010,1,3,108618,108621,108624,3,6,0
31011,4,2,108622,108624,108626,2,4,0
31012,1,2,108623,108626,108628,3,5,0
31013,6,3,108629,108629,108632,0,3,1
31014,2,2,108631,108632,108634,1,3,0
31015,1,3,108632,108634,108637,2,5,0
31016,5,2,108637,108637,108639,0,2,0
31017,5,1,108642,108642,108643,0,1,3
31018,5,3,108647,108647,108650,0,3,4
31019,5,3,108652,108652,108655,0,3,2
31020,1,3,108653,108655,108658,2,5,0
31021,5,3,108658,108658,108661,0,3,0
31022,3,3,108661,108661,108664,0,3,0
31023,2,3,108663,108664,108667,1,4,0
31024,1,3,108664,108667,108670,3,6,0
31025,1,1,108665,108670,108671,5,6,0
31026,6,1,108671,108671,108672,0,1,0
31027,5,3,108676,108676,108679,0,3,4
31028,4,1,108680,108680,108681,0,1,1
31029,3,2,108683,108683,108685,0,2,2
31030,6,3,108689,108689,108692,0,3,4
31031,6,1,108695,108695,108696,0,1,3
31032,4,2,108699,108699,108701,0,2,3
31033,6,2,108705,108705,108707,0,2,4
31034,2,1,108707,108707,108708,0,1,0
31035,5,1,108712,108712,108713,0,1,4
31036,6,1,108718,108718,108719,0,1,5
31037,5,1,108723,108723,108724,0,1,4
31038,4,1,108727,108727,108728,0,1,3
31039,6,1,108733,108733,108734,0,1,5
31040,3,3,108736,108736,108739,0,3,2
31041,4,1,108740,108740,108741,0,1,1
31042,6,2,108746,108746,108748,0,2,5
31043,2,1,108748,108748,108749,0,1,0
31044,4,2,108752,108752,108754,0,2,3
31045,4,1,108756,108756,108757,0,1,2
31046,5,1,108761,108761,108762,0,1,4
31047,3,2,108764,108764,108766,0,2,2
31048,6,2,108770,108770,108772,0,2,4
31049,6,1,108776,108776,108777,0,1,4
31050,2,3,108778,108778,108781,0,3,1
31051,3,3,108781,108781,108784,0,3,0
31052,3,1,108784,108784,108785,0,1,0
31053,6,2,108790,108790,108792,0,2,5
31054,6,1,108796,108796,108797,0,1,4
31055,2,1,108798,108798,108799,0,1,1
31056,4,1,108802,108802,108803,0,1,3
31057,5,3,108807,108807,108810,0,3,4
31058,2,2,108809,108810,108812,1,3,0
31059,5,1,108814,108814,108815,0,1,2
31060,3,1,108817,108817,108818,0,1,2
31061,5,2,108822,108822,108824,0,2,4
31062,5,3,108827,108827,108830,0,3,3
31063,6,3,108833,108833,108836,0,3,3
31064,2,1,108835,108836,108837,1,2,0
31065,2,3,108837,108837,108840,0,3,0
31066,6,1,108843,108843,108844,0,1,3
31067,2,3,108845,108845,108848,0,3,1
31068,3,1,108848,108848,108849,0,1,0
31069,3,2,108851,108851,108853,0,2,2
31070,4,1,108855,108855,108856,0,1,2
31071,1,2,108856,108856,108858,0,2,0
31072,5,2,108861,108861,108863,0,2,3
31073,4,1,108865,108865,108866,0,1,2
31074,6,2,108871,108871,108873,0,2,5
31075,3,1,108874,108874,108875,0,1,1
31076,1,1,108875,108875,108876,0,1,0
31077,1,3,108876,108876,108879,0,3,0
31078,4,2,108880,108880,108882,0,2,1
31079,2,3,108882,108882,108885,0,3,0
31080,2,1,108884,108885,108886,1,2,0
31081,2,3,108886,108886,108889,0,3,0
31082,1,3,108887,108889,108892,2,5,0
31083,1,1,108888,108892,108893,4,5,0
31084,6,1,108894,108894,108895,0,1,1
31085,4,1,108898,108898,108899,0,1,3
31086,3,1,108901,108901,108902,0,1,2
31087,3,1,108904,108904,108905,0,1,2
31088,4,2,108908,108908,108910,0,2,3
31089,4,3,108912,108912,108915,0,3,2
31090,2,1,108914,108915,108916,1,2,0
31091,6,2,108920,108920,108922,0,2,4
31092,5,3,108925,108925,108928,0,3,3
31093,3,2,108928,108928,108930,0,2,0
31094,4,1,108932,108932,108933,0,1,2
31095,5,3,108937,108937,108940,0,3,4
31096,5,2,108942,108942,108944,0,2,2
31097,6,3,108948,108948,108951,0,3,4
31098,6,1,108954,108954,108955,0,1,3
31099,4,3,108958,108958,108961,0,3,3
31100,2,2,108960,108961,108963,1,3,0
31101,5,2,108965,108965,108967,0,2,2
31102,2,1,108967,108967,108968,0,1,0
31103,3,1,108970,108970,108971,0,1,2
31104,3,3,108973,108973,108976,0,3,2
31105,4,1,108977,108977,108978,0,1,1
31106,3,2,108980,108980,108982,0,2,2
31107,6,2,108986,108986,108988,0,2,4
31108,4,3,108990,108990,108993,0,3,2
31109,6,2,108996,108996,108998,0,2,3
31110,3,1,108999,108999,109000,0,1,1
31111,5,3,109004,109004,109007,0,3,4
31112,1,2,109005,109007,109009,2,4,0
31113,6,1,109011,109011,109012,0,1,2
31114,1,2,109012,109012,109014,0,2,0
31115,1,2,109013,109014,109016,1,3,0
31116,6,1,109019,109019,109020,0,1,3
31117,6,3,109025,109025,109028,0,3,5
31118,4,3,109029,109029,109032,0,3,1
31119,3,1,109032,109032,109033,0,1,0
31120,5,2,109037,109037,109039,0,2,4
31121,4,2,109041,109041,109043,0,2,2
31122,2,2,109043,109043,109045,0,2,0
31123,4,2,109047,109047,109049,0,2,2
31124,5,3,109052,109052,109055,0,3,3
31125,3,1,109055,109055,109056,0,1,0
31126,3,2,109058,109058,109060,0,2,2
31127,6,3,109064,109064,109067,0,3,4
31128,1,1,109065,109067,109068,2,3,0
31129,2,1,109067,109068,109069,1,2,0
31130,5,1,109072,109072,109073,0,1,3
31131,5,2,109077,109077,109079,0,2,4
31132,4,2,109081,109081,109083,0,2,2
31133,1,1,109082,109083,109084,1,2,0
31134,3,1,109085,109085,109086,0,1,1
31135,4,1,109089,109089,109090,0,1,3
31136,1,2,109090,109090,109092,0,2,0
31137,2,2,109092,109092,109094,0,2,0
31138,1,3,109093,109094,109097,1,4,0
31139,6,3,109099,109099,109102,0,3,2
31140,1,1,109100,109102,109103,2,3,0
31141,1,2,109101,109103,109105,2,4,0
31142,1,2,109102,109105,109107,3,5,0
31143,3,2,109105,109107,109109,2,4,0
31144,5,2,109110,109110,109112,0,2,1
31145,3,1,109113,109113,109114,0,1,1
31146,1,1,109114,109114,109115,0,1,0
31147,5,2,109119,109119,109121,0,2,4
31148,3,1,109122,109122,109123,0,1,1
31149,2,3,109124,109124,109127,0,3,1
31150,5,3,109129,109129,109132,0,3,2
31151,2,2,109131,109132,109134,1,3,0
31152,3,2,109134,109134,109136,0,2,0
31153,1,2,109135,109136,109138,1,3,0
31154,5,2,109140,109140,109142,0,2,2
31155,6,2,109146,109146,109148,0,2,4
31156,6,2,109152,109152,109154,0,2,4
31157,6,1,109158,109158,109159,0,1,4
31158,3,2,109161,109161,109163,0,2,2
31159,2,1,109163,109163,109164,0,1,0
31160,3,3,109166,109166,109169,0,3,2
31161,1,2,109167,109169,109171,2,4,0
31162,2,3,109169,109171,109174,2,5,0
31163,1,3,109170,109174,109177,4,7,0
31164,3,1,109173,109177,109178,4,5,0
31165,2,2,109175,109178,109180,3,5,0
31166,2,3,109177,109180,109183,3,6,0
31167,1,2,109178,109183,109185,5,7,0
31168,4,3,109182,109185,109188,3,6,0
31169,2,2,109184,109188,109190,4,6,0
31170,2,3,109186,109190,109193,4,7,0
31171,5,2,109191,109193,109195,2,4,0
31172,6,2,109197,109197,109199,0,2,2
31173,1,1,109198,109199,109200,1,2,0
31174,2,2,109200,109200,109202,0,2,0
31175,3,1,109203,109203,109204,0,1,1
31176,6,3,109209,109209,109212,0,3,5
31177,1,3,109210,109212,109215,2,5,0
31178,4,1,109214,109215,109216,1,2,0
31179,3,3,109217,109217,109220,0,3,1
31180,6,3,109223,109223,109226,0,3,3
31181,3,2,109226,109226,109228,0,2,0
31182,3,1,109229,109229,109230,0,1,1
31183,5,3,109234,109234,109237,0,3,4
31184,3,3,109237,109237,109240,0,3,0
31185,6,1,109243,109243,109244,0,1,3
31186,6,2,109249,109249,109251,0,2,5
31187,6,1,109255,109255,109256,0,1,4
31188,3,3,109258,109258,109261,0,3,2
31189,5,3,109263,109263,109266,0,3,2
31190,3,1,109266,109266,109267,0,1,0
31191,5,1,109271,109271,109272,0,1,4
31192,5,3,109276,109276,109279,0,3,4
31193,3,3,109279,109279,109282,0,3,0
31194,5,3,109284,109284,109287,0,3,2
31195,2,3,109286,109287,109290,1,4,0
31196,4,2,109290,109290,109292,0,2,0
31197,3,3,109293,109293,109296,0,3,1
31198,3,1,109296,109296,109297,0,1,0
31199,6,2,109302,109302,109304,0,2,5
31200,3,1,109305,109305,109306,0,1,1
31201,1,3,109306,109306,109309,0,3,0
31202,5,1,109311,109311,109312,0,1,2
31203,4,2,109315,109315,109317,0,2,3
31204,5,1,109320,109320,109321,0,1,3
31205,6,1,109326,109326,109327,0,1,5
31206,2,3,109328,109328,109331,0,3,1
31207,6,2,109334,109334,109336,0,2,3
31208,5,2,109339,109339,109341,0,2,3
31209,3,2,109342,109342,109344,0,2,1
31210,2,1,109344,109344,109345,0,1,0
31211,1,2,109345,109345,109347,0,2,0
31212,3,2,109348,109348,109350,0,2,1
31213,6,3,109354,109354,109357,0,3,4
31214,3,1,109357,109357,109358,0,1,0
31215,4,1,109361,109361,109362,0,1,3
31216,6,3,109367,109367,109370,0,3,5
31217,4,3,109371,109371,109374,0,3,1
31218,2,3,109373,109374,109377,1,4,0
31219,6,1,109379,109379,109380,0,1,2
31220,6,1,109385,109385,109386,0,1,5
31221,5,1,109390,109390,109391,0,1,4
31222,1,3,109391,109391,109394,0,3,0
31223,1,1,109392,109394,109395,2,3,0
31224,6,2,109398,109398,109400,0,2,3
31225,4,1,109402,109402,109403,0,1,2
31226,4,2,109406,109406,109408,0,2,3
31227,6,2,109412,109412,109414,0,2,4
31228,3,3,109415,109415,109418,0,3,1
31229,6,1,109421,109421,109422,0,1,3
31230,5,2,109426,109426,109428,0,2,4
31231,2,3,109428,109428,109431,0,3,0
31232,5,2,109433,109433,109435,0,2,2
31233,1,1,109434,109435,109436,1,2,0
31234,6,3,109440,109440,109443,0,3,4
31235,6,3,109446,109446,109449,0,3,3
31236,6,2,109452,109452,109454,0,2,3
31237,4,1,109456,109456,109457,0,1,2
31238,5,1,109461,109461,109462,0,1,4
31239,4,3,109465,109465,109468,0,3,3
31240,1,2,109466,109468,109470,2,4,0
31241,4,3,109470,109470,109473,0,3,0
31242,6,1,109476,109476,109477,0,1,3
31243,6,2,109482,109482,109484,0,2,5
31244,2,3,109484,109484,109487,0,3,0
31245,2,2,109486,109487,109489,1,3,0
31246,6,1,109492,109492,109493,0,1,3
31247,2,3,109494,109494,109497,0,3,1
31248,4,1,109498,109498,109499,0,1,1
31249,2,2,109500,109500,109502,0,2,1
31250,4,1,109504,109504,109505,0,1,2
31251,2,3,109506,109506,109509,0,3,1
31252,2,3,109508,109509,109512,1,4,0
31253,6,3,109514,109514,109517,0,3,2
31254,1,1,109515,109517,109518,2,3,0
31255,3,3,109518,109518,109521,0,3,0
31256,6,1,109524,109524,109525,0,1,3
31257,1,1,109525,109525,109526,0,1,0
31258,3,3,109528,109528,109531,0,3,2
31259,1,3,109529,109531,109534,2,5,0
31260,6,2,109535,109535,109537,0,2,1
31261,3,2,109538,109538,109540,0,2,1
31262,3,3,109541,109541,109544,0,3,1
31263,1,2,109542,109544,109546,2,4,0
31264,2,1,109544,109546,109547,2,3,0
31265,1,2,109545,109547,109549,2,4,0
31266,5,2,109550,109550,109552,0,2,1
31267,4,1,109554,109554,109555,0,1,2
31268,3,2,109557,109557,109559,0,2,2
31269,5,3,109562,109562,109565,0,3,3
31270,2,1,109564,109565,109566,1,2,0
31271,4,2,109568,109568,109570,0,2,2
31272,2,1,109570,109570,109571,0,1,0
31273,3,2,109573,109573,109575,0,2,2
31274,3,2,109576,109576,109578,0,2,1
31275,5,3,109581,109581,109584,0,3,3
31276,4,1,109585,109585,109586,0,1,1
31277,3,3,109588,109588,109591,0,3,2
31278,5,3,109593,109593,109596,0,3,2
31279,1,1,109594,109596,109597,2,3,0
31280,4,3,109598,109598,109601,0,3,1
31281,2,2,109600,109601,109603,1,3,0
31282,5,3,109605,109605,109608,0,3,2
31283,3,2,109608,109608,109610,0,2,0
31284,3,3,109611,109611,109614,0,3,1
31285,2,3,109613,109614,109617,1,4,0
31286,1,1,109614,109617,109618,3,4,0
31287,6,3,109620,109620,109623,0,3,2
31288,2,1,109622,109623,109624,1,2,0
31289,3,2,109625,109625,109627,0,2,1
31290,1,1,109626,109627,109628,1,2,0
31291,5,3,109631,109631,109634,0,3,3
31292,6,3,109637,109637,109640,0,3,3
31293,3,3,109640,109640,109643,0,3,0
31294,3,3,109643,109643,109646,0,3,0
31295,5,1,109648,109648,109649,0,1,2
31296,4,2,109652,109652,109654,0,2,3
31297,4,2,109656,109656,109658,0,2,2
31298,6,3,109662,109662,109665,0,3,4
31299,4,2,109666,109666,109668,0,2,1
31300,5,1,109671,109671,109672,0,1,3
31301,4,1,109675,109675,109676,0,1,3
31302,5,2,109680,109680,109682,0,2,4
31303,3,3,109683,109683,109686,0,3,1
31304,5,2,109688,109688,109690,0,2,2
31305,6,1,109694,109694,109695,0,1,4
31306,5,3,109699,109699,109702,0,3,4
31307,1,2,109700,109702,109704,2,4,0
31308,5,2,109705,109705,109707,0,2,1
31309,6,1,109711,109711,109712,0,1,4
31310,2,2,109713,109713,109715,0,2,1
31311,4,2,109717,109717,109719,0,2,2
31312,6,3,109723,109723,109726,0,3,4
31313,3,2,109726,109726,109728,0,2,0
31314,5,2,109731,109731,109733,0,2,3
31315,6,1,109737,109737,109738,0,1,4
31316,2,1,109739,109739,109740,0,1,1
31317,4,3,109743,109743,109746,0,3,3
31318,4,2,109747,109747,109749,0,2,1
31319,2,1,109749,109749,109750,0,1,0
31320,6,1,109755,109755,109756,0,1,5
31321,3,1,109758,109758,109759,0,1,2
31322,1,2,109759,109759,109761,0,2,0
31323,2,2,109761,109761,109763,0,2,0
31324,5,2,109766,109766,109768,0,2,3
31325,2,1,109768,109768,109769,0,1,0
31326,2,1,109770,109770,109771,0,1,1
31327,4,1,109774,109774,109775,0,1,3
31328,5,3,109779,109779,109782,0,3,4
31329,1,2,109780,109782,109784,2,4,0
31330,6,2,109786,109786,109788,0,2,2
31331,2,3,109788,109788,109791,0,3,0
31332,3,3,109791,109791,109794,0,3,0
31333,1,1,109792,109794,109795,2,3,0
31334,4,3,109796,109796,109799,0,3,1
31335,3,3,109799,109799,109802,0,3,0
31336,6,3,109805,109805,109808,0,3,3
31337,3,2,109808,109808,109810,0,2,0
31338,6,2,109814,109814,109816,0,2,4
31339,3,1,109817,109817,109818,0,1,1
31340,2,2,109819,109819,109821,0,2,1
31341,2,1,109821,109821,109822,0,1,0
31342,4,1,109825,109825,109826,0,1,3
31343,3,3,109828,109828,109831,0,3,2
31344,1,2,109829,109831,109833,2,4,0
31345,5,2,109834,109834,109836,0,2,1
31346,3,3,109837,109837,109840,0,3,1
31347,4,1,109841,109841,109842,0,1,1
31348,6,1,109847,109847,109848,0,1,5
31349,5,3,109852,109852,109855,0,3,4
31350,6,3,109858,109858,109861,0,3,3
31351,4,1,109862,109862,109863,0,1,1
31352,2,3,109864,109864,109867,0,3,1
31353,5,3,109869,109869,109872,0,3,2
31354,4,1,109873,109873,109874,0,1,1
31355,6,3,109879,109879,109882,0,3,5
31356,1,3,109880,109882,109885,2,5,0
31357,4,2,109884,109885,109887,1,3,0
31358,6,3,109890,109890,109893,0,3,3
31359,6,3,109896,109896,109899,0,3,3
31360,6,3,109902,109902,109905,0,3,3
31361,5,3,109907,109907,109910,0,3,2
31362,1,2,109908,109910,109912,2,4,0
31363,1,2,109909,109912,109914,3,5,0
31364,4,3,109913,109914,109917,1,4,0
31365,5,1,109918,109918,109919,0,1,1
31366,5,1,109923,109923,109924,0,1,4
31367,3,2,109926,109926,109928,0,2,2
31368,5,3,109931,109931,109934,0,3,3
31369,5,3,109936,109936,109939,0,3,2
31370,1,1,109937,109939,109940,2,3,0
31371,3,1,109940,109940,109941,0,1,0
31372,1,3,109941,109941,109944,0,3,0
31373,1,1,109942,109944,109945,2,3,0
31374,5,3,109947,109947,109950,0,3,2
31375,1,3,109948,109950,109953,2,5,0
31376,2,2,109950,109953,109955,3,5,0
31377,5,3,109955,109955,109958,0,3,0
31378,1,1,109956,109958,109959,2,3,0
31379,6,2,109962,109962,109964,0,2,3
31380,2,1,109964,109964,109965,0,1,0
31381,1,1,109965,109965,109966,0,1,0
31382,5,1,109970,109970,109971,0,1,4
31383,6,2,109976,109976,109978,0,2,5
31384,1,3,109977,109978,109981,1,4,0
31385,6,1,109983,109983,109984,0,1,2
31386,1,1,109984,109984,109985,0,1,0
31387,3,3,109987,109987,109990,0,3,2
31388,5,2,109992,109992,109994,0,2,2
31389,3,2,109995,109995,109997,0,2,1
31390,1,2,109996,109997,109999,1,3,0
31391,5,1,110001,110001,110002,0,1,2
31392,1,1,110002,110002,110003,0,1,0
31393,4,2,110006,110006,110008,0,2,3
31394,2,3,110008,110008,110011,0,3,0
31395,4,3,110012,110012,110015,0,3,1
31396,2,2,110014,110015,110017,1,3,0
31397,3,2,110017,110017,110019,0,2,0
31398,4,2,110021,110021,110023,0,2,2
31399,4,1,110025,110025,110026,0,1,2
31400,6,2,110031,110031,110033,0,2,5
31401,6,3,110037,110037,110040,0,3,4
31402,3,2,110040,110040,110042,0,2,0
31403,2,1,110042,110042,110043,0,1,0
31404,5,3,110047,110047,110050,0,3,4
31405,6,1,110053,110053,110054,0,1,3
31406,5,1,110058,110058,110059,0,1,4
31407,3,3,110061,110061,110064,0,3,2
31408,6,2,110067,110067,110069,0,2,3
31409,5,1,110072,110072,110073,0,1,3
31410,4,2,110076,110076,110078,0,2,3
31411,3,2,110079,110079,110081,0,2,1
31412,1,1,110080,110081,110082,1,2,0
31413,3,3,110083,110083,110086,0,3,1
31414,4,1,110087,110087,110088,0,1,1
31415,2,1,110089,110089,110090,0,1,1
31416,1,1,110090,110090,110091,0,1,0
31417,3,2,110093,110093,110095,0,2,2
31418,2,1,110095,110095,110096,0,1,0
31419,5,3,110100,110100,110103,0,3,4
31420,3,1,110103,110103,110104,0,1,0
31421,4,1,110107,110107,110108,0,1,3
31422,6,2,110113,110113,110115,0,2,5
31423,6,1,110119,110119,110120,0,1,4
31424,6,1,110125,110125,110126,0,1,5
31425,5,1,110130,110130,110131,0,1,4
31426,5,3,110135,110135,110138,0,3,4
31427,1,2,110136,110138,110140,2,4,0
31428,5,3,110141,110141,110144,0,3,1
31429,1,1,110142,110144,110145,2,3,0
31430,2,1,110144,110145,110146,1,2,0
31431,5,1,110149,110149,110150,0,1,3
31432,2,3,110151,110151,110154,0,3,1
31433,3,3,110154,110154,110157,0,3,0
31434,2,1,110156,110157,110158,1,2,0
31435,2,1,110158,110158,110159,0,1,0
31436,3,3,110161,110161,110164,0,3,2
31437,4,1,110165,110165,110166,0,1,1
31438,1,1,110166,110166,110167,0,1,0
31439,4,3,110170,110170,110173,0,3,3
31440,4,1,110174,110174,110175,0,1,1
31441,5,1,110179,110179,110180,0,1,4
31442,5,2,110184,110184,110186,0,2,4
31443,2,3,110186,110186,110189,0,3,0
31444,3,3,110189,110189,110192,0,3,0
31445,6,1,110195,110195,110196,0,1,3
31446,4,3,110199,110199,110202,0,3,3
31447,6,3,110205,110205,110208,0,3,3
31448,4,1,110209,110209,110210,0,1,1
31449,5,3,110214,110214,110217,0,3,4
31450,4,3,110218,110218,110221,0,3,1
31451,5,1,110223,110223,110224,0,1,2
31452,5,3,110228,110228,110231,0,3,4
31453,1,3,110229,110231,110234,2,5,0
31454,1,2,110230,110234,110236,4,6,0
31455,6,1,110236,110236,110237,0,1,0
31456,6,1,110242,110242,110243,0,1,5
31457,3,3,110245,110245,110248,0,3,2
31458,1,3,110246,110248,110251,2,5,0
31459,4,2,110250,110251,110253,1,3,0
31460,6,2,110256,110256,110258,0,2,3
31461,6,1,110262,110262,110263,0,1,4
31462,6,3,110268,110268,110271,0,3,5
31463,6,1,110274,110274,110275,0,1,3
31464,6,2,110280,110280,110282,0,2,5
31465,4,1,110284,110284,110285,0,1,2
31466,4,2,110288,110288,110290,0,2,3
31467,2,3,110290,110290,110293,0,3,0
31468,5,2,110295,110295,110297,0,2,2
31469,1,2,110296,110297,110299,1,3,0
31470,3,1,110299,110299,110300,0,1,0
31471,4,2,110303,110303,110305,0,2,3
31472,3,1,110306,110306,110307,0,1,1
31473,3,1,110309,110309,110310,0,1,2
31474,5,1,110314,110314,110315,0,1,4
31475,4,3,110318,110318,110321,0,3,3
31476,1,1,110319,110321,110322,2,3,0
31477,2,3,110321,110322,110325,1,4,0
31478,2,2,110323,110325,110327,2,4,0
31479,6,1,110329,110329,110330,0,1,2
31480,5,3,110334,110334,110337,0,3,4
31481,3,1,110337,110337,110338,0,1,0
31482,3,2,110340,110340,110342,0,2,2
31483,6,3,110346,110346,110349,0,3,4
31484,6,2,110352,110352,110354,0,2,3
31485,2,1,110354,110354,110355,0,1,0
31486,5,1,110359,110359,110360,0,1,4
31487,6,2,110365,110365,110367,0,2,5
31488,4,1,110369,110369,110370,0,1,2
31489,3,2,110372,110372,110374,0,2,2
31490,1,2,110373,110374,110376,1,3,0
31491,4,2,110377,110377,110379,0,2,1
31492,3,2,110380,110380,110382,0,2,1
31493,3,1,110383,110383,110384,0,1,1
31494,3,1,110386,110386,110387,0,1,2
31495,1,3,110387,110387,110390,0,3,0
31496,5,2,110392,110392,110394,0,2,2
31497,1,3,110393,110394,110397,1,4,0
31498,3,1,110396,110397,110398,1,2,0
31499,4,1,110400,110400,110401,0,1,2
31500,3,1,110403,110403,110404,0,1,2
31501,1,2,110404,110404,110406,0,2,0
31502,1,1,110405,110406,110407,1,2,0
31503,3,3,110408,110408,110411,0,3,1
31504,6,1,110414,110414,110415,0,1,3
31505,5,3,110419,110419,110422,0,3,4
31506,4,2,110423,110423,110425,0,2,1
31507,5,2,110428,110428,110430,0,2,3
31508,4,2,110432,110432,110434,0,2,2
31509,6,1,110438,110438,110439,0,1,4
31510,6,2,110444,110444,110446,0,2,5
31511,3,1,110447,110447,110448,0,1,1
31512,5,2,110452,110452,110454,0,2,4
31513,6,1,110458,110458,110459,0,1,4
31514,2,2,110460,110460,110462,0,2,1
31515,1,1,110461,110462,110463,1,2,0
31516,1,3,110462,110463,110466,1,4,0
31517,5,1,110467,110467,110468,0,1,1
31518,4,2,110471,110471,110473,0,2,3
31519,1,3,110472,110473,110476,1,4,0
31520,5,2,110477,110477,110479,0,2,1
31521,1,3,110478,110479,110482,1,4,0
31522,3,3,110481,110482,110485,1,4,0
31523,5,2,110486,110486,110488,0,2,1
31524,2,2,110488,110488,110490,0,2,0
31525,2,2,110490,110490,110492,0,2,0
31526,4,1,110494,110494,110495,0,1,2
31527,4,3,110498,110498,110501,0,3,3
31528,6,3,110504,110504,110507,0,3,3
31529,2,3,110506,110507,110510,1,4,0
31530,1,1,110507,110510,110511,3,4,0
31531,4,1,110511,110511,110512,0,1,0
31532,5,2,110516,110516,110518,0,2,4
31533,1,3,110517,110518,110521,1,4,0
31534,5,2,110522,110522,110524,0,2,1
31535,4,1,110526,110526,110527,0,1,2
31536,4,2,110530,110530,110532,0,2,3
31537,5,3,110535,110535,110538,0,3,3
31538,1,3,110536,110538,110541,2,5,0
31539,5,3,110541,110541,110544,0,3,0
31540,6,2,110547,110547,110549,0,2,3
31541,6,3,110553,110553,110556,0,3,4
31542,5,1,110558,110558,110559,0,1,2
31543,3,2,110561,110561,110563,0,2,2
31544,6,3,110567,110567,110570,0,3,4
31545,2,3,110569,110570,110573,1,4,0
31546,5,3,110574,110574,110577,0,3,1
31547,6,1,110580,110580,110581,0,1,3
31548,4,3,110584,110584,110587,0,3,3
31549,1,2,110585,110587,110589,2,4,0
31550,3,3,110588,110589,110592,1,4,0
31551,1,1,110589,110592,110593,3,4,0
31552,4,1,110593,110593,110594,0,1,0
31553,3,1,110596,110596,110597,0,1,2
31554,2,1,110598,110598,110599,0,1,1
31555,2,1,110600,110600,110601,0,1,1
31556,3,2,110603,110603,110605,0,2,2
31557,6,3,110609,110609,110612,0,3,4
31558,3,3,110612,110612,110615,0,3,0
31559,2,2,110614,110615,110617,1,3,0
31560,3,3,110617,110617,110620,0,3,0
31561,1,1,110618,110620,110621,2,3,0
31562,2,2,110620,110621,110623,1,3,0
31563,2,1,110622,110623,110624,1,2,0
31564,4,1,110626,110626,110627,0,1,2
31565,6,2,110632,110632,110634,0,2,5
31566,3,1,110635,110635,110636,0,1,1
31567,6,2,110641,110641,110643,0,2,5
31568,3,2,110644,110644,110646,0,2,1
31569,2,1,110646,110646,110647,0,1,0
31570,2,1,110648,110648,110649,0,1,1
31571,3,2,110651,110651,110653,0,2,2
31572,3,1,110654,110654,110655,0,1,1
31573,4,2,110658,110658,110660,0,2,3
31574,1,3,110659,110660,110663,1,4,0
31575,4,1,110663,110663,110664,0,1,0
31576,3,3,110666,110666,110669,0,3,2
31577,6,3,110672,110672,110675,0,3,3
31578,5,3,110677,110677,110680,0,3,2
31579,3,3,110680,110680,110683,0,3,0
31580,4,2,110684,110684,110686,0,2,1
31581,3,3,110687,110687,110690,0,3,1
31582,2,2,110689,110690,110692,1,3,0
31583,5,2,110694,110694,110696,0,2,2
31584,1,2,110695,110696,110698,1,3,0
31585,3,2,110698,110698,110700,0,2,0
31586,5,2,110703,110703,110705,0,2,3
31587,6,1,110709,110709,110710,0,1,4
31588,5,2,110714,110714,110716,0,2,4
31589,3,3,110717,110717,110720,0,3,1
31590,4,2,110721,110721,110723,0,2,1
31591,5,2,110726,110726,110728,0,2,3
31592,6,2,110732,110732,110734,0,2,4
31593,3,2,110735,110735,110737,0,2,1
31594,3,2,110738,110738,110740,0,2,1
31595,6,2,110744,110744,110746,0,2,4
31596,4,2,110748,110748,110750,0,2,2
31597,4,2,110752,110752,110754,0,2,2
31598,1,2,110753,110754,110756,1,3,0
31599,6,1,110759,110759,110760,0,1,3
31600,3,1,110762,110762,110763,0,1,2
31601,5,2,110767,110767,110769,0,2,4
31602,3,2,110770,110770,110772,0,2,1
31603,4,1,110774,110774,110775,0,1,2
31604,5,1,110779,110779,110780,0,1,4
31605,1,2,110780,110780,110782,0,2,0
31606,6,2,110786,110786,110788,0,2,4
31607,1,3,110787,110788,110791,1,4,0
31608,6,2,110793,110793,110795,0,2,2
31609,4,2,110797,110797,110799,0,2,2
31610,5,2,110802,110802,110804,0,2,3
31611,3,2,110805,110805,110807,0,2,1
31612,6,1,110811,110811,110812,0,1,4
31613,5,1,110816,110816,110817,0,1,4
31614,4,2,110820,110820,110822,0,2,3
31615,2,1,110822,110822,110823,0,1,0
31616,5,3,110827,110827,110830,0,3,4
31617,1,2,110828,110830,110832,2,4,0
31618,3,2,110831,110832,110834,1,3,0
31619,6,2,110837,110837,110839,0,2,3
31620,3,1,110840,110840,110841,0,1,1
31621,1,2,110841,110841,110843,0,2,0
31622,5,3,110846,110846,110849,0,3,3
31623,1,3,110847,110849,110852,2,5,0
31624,6,1,110853,110853,110854,0,1,1
31625,1,3,110854,110854,110857,0,3,0
31626,3,2,110857,110857,110859,0,2,0
31627,1,2,110858,110859,110861,1,3,0
31628,3,2,110861,110861,110863,0,2,0
31629,6,1,110867,110867,110868,0,1,4
31630,5,3,110872,110872,110875,0,3,4
31631,2,3,110874,110875,110878,1,4,0
31632,5,1,110879,110879,110880,0,1,1
31633,2,3,110881,110881,110884,0,3,1
31634,5,2,110886,110886,110888,0,2,2
31635,2,2,110888,110888,110890,0,2,0
31636,6,2,110894,110894,110896,0,2,4
31637,1,1,110895,110896,110897,1,2,0
31638,4,2,110899,110899,110901,0,2,2
31639,6,1,110905,110905,110906,0,1,4
31640,4,3,110909,110909,110912,0,3,3
31641,5,3,110914,110914,110917,0,3,2
31642,5,2,110919,110919,110921,0,2,2
31643,1,1,110920,110921,110922,1,2,0
31644,3,3,110923,110923,110926,0,3,1
31645,1,1,110924,110926,110927,2,3,0
31646,4,3,110928,110928,110931,0,3,1
31647,1,1,110929,110931,110932,2,3,0
31648,4,1,110933,110933,110934,0,1,1
31649,2,3,110935,110935,110938,0,3,1
31650,6,3,110941,110941,110944,0,3,3
31651,5,1,110946,110946,110947,0,1,2
31652,1,1,110947,110947,110948,0,1,0
31653,3,2,110950,110950,110952,0,2,2
31654,2,3,110952,110952,110955,0,3,0
31655,2,3,110954,110955,110958,1,4,0
31656,5,2,110959,110959,110961,0,2,1
31657,5,2,110964,110964,110966,0,2,3
31658,3,1,110967,110967,110968,0,1,1
31659,3,2,110970,110970,110972,0,2,2
31660,5,1,110975,110975,110976,0,1,3
31661,1,1,110976,110976,110977,0,1,0
31662,6,1,110982,110982,110983,0,1,5
31663,1,1,110983,110983,110984,0,1,0
31664,6,2,110989,110989,110991,0,2,5
31665,3,1,110992,110992,110993,0,1,1
31666,5,2,110997,110997,110999,0,2,4
31667,4,3,111001,111001,111004,0,3,2
31668,6,2,111007,111007,111009,0,2,3
31669,3,3,111010,111010,111013,0,3,1
31670,1,3,111011,111013,111016,2,5,0
31671,1,3,111012,111016,111019,4,7,0
31672,4,2,111016,111019,111021,3,5,0
31673,1,3,111017,111021,111024,4,7,0
31674,6,1,111023,111024,111025,1,2,0
31675,2,1,111025,111025,111026,0,1,0
31676,2,1,111027,111027,111028,0,1,1
31677,3,3,111030,111030,111033,0,3,2
31678,3,1,111033,111033,111034,0,1,0
31679,2,3,111035,111035,111038,0,3,1
31680,3,2,111038,111038,111040,0,2,0
31681,6,1,111044,111044,111045,0,1,4
31682,5,1,111049,111049,111050,0,1,4
31683,5,3,111054,111054,111057,0,3,4
31684,2,3,111056,111057,111060,1,4,0
31685,2,3,111058,111060,111063,2,5,0
31686,2,3,111060,111063,111066,3,6,0
31687,3,3,111063,111066,111069,3,6,0
31688,6,2,111069,111069,111071,0,2,0
31689,6,2,111075,111075,111077,0,2,4
31690,6,3,111081,111081,111084,0,3,4
31691,2,1,111083,111084,111085,1,2,0
31692,3,1,111086,111086,111087,0,1,1
31693,6,2,111092,111092,111094,0,2,5
31694,6,3,111098,111098,111101,0,3,4
31695,3,2,111101,111101,111103,0,2,0
31696,2,1,111103,111103,111104,0,1,0
31697,6,2,111109,111109,111111,0,2,5
31698,3,3,111112,111112,111115,0,3,1
31699,6,3,111118,111118,111121,0,3,3
31700,4,2,111122,111122,111124,0,2,1
31701,1,1,111123,111124,111125,1,2,0
31702,5,3,111128,111128,111131,0,3,3
31703,1,2,111129,111131,111133,2,4,0
31704,2,3,111131,111133,111136,2,5,0
31705,3,2,111134,111136,111138,2,4,0
31706,2,2,111136,111138,111140,2,4,0
31707,2,3,111138,111140,111143,2,5,0
31708,3,2,111141,111143,111145,2,4,0
31709,1,3,111142,111145,111148,3,6,0
31710,6,2,111148,111148,111150,0,2,0
31711,1,3,111149,111150,111153,1,4,0
31712,3,3,111152,111153,111156,1,4,0
31713,3,2,111155,111156,111158,1,3,0
31714,1,1,111156,111158,111159,2,3,0
31715,4,1,111160,111160,111161,0,1,1
31716,2,2,111162,111162,111164,0,2,1
31717,6,1,111168,111168,111169,0,1,4
31718,6,1,111174,111174,111175,0,1,5
31719,6,1,111180,111180,111181,0,1,5
31720,5,1,111185,111185,111186,0,1,4
31721,6,3,111191,111191,111194,0,3,5
31722,1,3,111192,111194,111197,2,5,0
31723,5,1,111197,111197,111198,0,1,0
31724,6,3,111203,111203,111206,0,3,5
31725,3,1,111206,111206,111207,0,1,0
31726,3,3,111209,111209,111212,0,3,2
31727,3,3,111212,111212,111215,0,3,0
31728,1,1,111213,111215,111216,2,3,0
31729,3,2,111216,111216,111218,0,2,0
31730,6,2,111222,111222,111224,0,2,4
31731,2,3,111224,111224,111227,0,3,0
31732,1,2,111225,111227,111229,2,4,0
31733,6,2,111231,111231,111233,0,2,2
31734,4,2,111235,111235,111237,0,2,2
31735,1,1,111236,111237,111238,1,2,0
31736,5,3,111241,111241,111244,0,3,3
31737,6,2,111247,111247,111249,0,2,3
31738,1,1,111248,111249,111250,1,2,0
31739,3,3,111251,111251,111254,0,3,1
31740,5,3,111256,111256,111259,0,3,2
31741,4,2,111260,111260,111262,0,2,1
31742,1,3,111261,111262,111265,1,4,0
31743,2,1,111263,111265,111266,2,3,0
31744,2,1,111265,111266,111267,1,2,0
31745,4,3,111269,111269,111272,0,3,2
31746,3,2,111272,111272,111274,0,2,0
31747,2,3,111274,111274,111277,0,3,0
31748,6,1,111280,111280,111281,0,1,3
31749,1,1,111281,111281,111282,0,1,0
31750,4,3,111285,111285,111288,0,3,3
31751,6,2,111291,111291,111293,0,2,3
31752,6,2,111297,111297,111299,0,2,4
31753,4,1,111301,111301,111302,0,1,2
31754,3,1,111304,111304,111305,0,1,2
31755,6,3,111310,111310,111313,0,3,5
31756,2,1,111312,111313,111314,1,2,0
31757,3,1,111315,111315,111316,0,1,1
31758,4,2,111319,111319,111321,0,2,3
31759,4,1,111323,111323,111324,0,1,2
31760,5,2,111328,111328,111330,0,2,4
31761,6,2,111334,111334,111336,0,2,4
31762,5,2,111339,111339,111341,0,2,3
31763,6,1,111345,111345,111346,0,1,4
31764,4,1,111349,111349,111350,0,1,3
31765,4,3,111353,111353,111356,0,3,3
31766,3,2,111356,111356,111358,0,2,0
31767,1,1,111357,111358,111359,1,2,0
31768,4,2,111361,111361,111363,0,2,2
31769,4,2,111365,111365,111367,0,2,2
31770,2,1,111367,111367,111368,0,1,0
31771,2,2,111369,111369,111371,0,2,1
31772,1,3,111370,111371,111374,1,4,0
31773,5,3,111375,111375,111378,0,3,1
31774,5,2,111380,111380,111382,0,2,2
31775,4,3,111384,111384,111387,0,3,2
31776,4,3,111388,111388,111391,0,3,1
31777,2,3,111390,111391,111394,1,4,0
31778,4,3,111394,111394,111397,0,3,0
31779,2,2,111396,111397,111399,1,3,0
31780,4,3,111400,111400,111403,0,3,1
31781,1,2,111401,111403,111405,2,4,0
31782,1,1,111402,111405,111406,3,4,0
31783,3,3,111405,111406,111409,1,4,0
31784,4,3,111409,111409,111412,0,3,0
31785,5,2,111414,111414,111416,0,2,2
31786,5,2,111419,111419,111421,0,2,3
31787,6,1,111425,111425,111426,0,1,4
31788,5,3,111430,111430,111433,0,3,4
31789,2,2,111432,111433,111435,1,3,0
31790,2,2,111434,111435,111437,1,3,0
31791,1,1,111435,111437,111438,2,3,0
31792,2,1,111437,111438,111439,1,2,0
31793,3,3,111440,111440,111443,0,3,1
31794,5,1,111445,111445,111446,0,1,2
31795,1,1,111446,111446,111447,0,1,0
31796,1,1,111447,111447,111448,0,1,0
31797,6,1,111453,111453,111454,0,1,5
31798,6,3,111459,111459,111462,0,3,5
31799,1,3,111460,111462,111465,2,5,0
31800,5,1,111465,111465,111466,0,1,0
31801,1,2,111466,111466,111468,0,2,0
31802,4,2,111470,111470,111472,0,2,2
31803,6,1,111476,111476,111477,0,1,4
31804,3,2,111479,111479,111481,0,2,2
31805,2,2,111481,111481,111483,0,2,0
31806,1,2,111482,111483,111485,1,3,0
31807,2,3,111484,111485,111488,1,4,0
31808,1,3,111485,111488,111491,3,6,0
31809,2,3,111487,111491,111494,4,7,0
31810,1,1,111488,111494,111495,6,7,0
31811,3,2,111491,111495,111497,4,6,0
31812,1,3,111492,111497,111500,5,8,0
31813,3,1,111495,111500,111501,5,6,0
31814,1,2,111496,111501,111503,5,7,0
31815,5,2,111501,111503,111505,2,4,0
31816,6,1,111507,111507,111508,0,1,2
31817,4,2,111511,111511,111513,0,2,3
31818,2,1,111513,111513,111514,0,1,0
31819,3,2,111516,111516,111518,0,2,2
31820,1,2,111517,111518,111520,1,3,0
31821,6,3,111523,111523,111526,0,3,3
31822,2,3,111525,111526,111529,1,4,0
31823,4,2,111529,111529,111531,0,2,0
31824,1,3,111530,111531,111534,1,4,0
31825,4,2,111534,111534,111536,0,2,0
31826,5,2,111539,111539,111541,0,2,3
31827,6,3,111545,111545,111548,0,3,4
31828,3,3,111548,111548,111551,0,3,0
31829,3,1,111551,111551,111552,0,1,0
31830,4,3,111555,111555,111558,0,3,3
31831,4,2,111559,111559,111561,0,2,1
31832,4,1,111563,111563,111564,0,1,2
31833,4,1,111567,111567,111568,0,1,3
31834,3,3,111570,111570,111573,0,3,2
31835,4,3,111574,111574,111577,0,3,1
31836,6,2,111580,111580,111582,0,2,3
31837,2,3,111582,111582,111585,0,3,0
31838,4,2,111586,111586,111588,0,2,1
31839,1,3,111587,111588,111591,1,4,0
31840,2,3,111589,111591,111594,2,5,0
31841,5,2,111594,111594,111596,0,2,0
31842,2,2,111596,111596,111598,0,2,0
31843,1,3,111597,111598,111601,1,4,0
31844,2,2,111599,111601,111603,2,4,0
31845,4,1,111603,111603,111604,0,1,0
31846,4,1,111607,111607,111608,0,1,3
31847,2,1,111609,111609,111610,0,1,1
31848,1,3,111610,111610,111613,0,3,0
31849,4,1,111614,111614,111615,0,1,1
31850,6,2,111620,111620,111622,0,2,5
31851,6,2,111626,111626,111628,0,2,4
31852,5,2,111631,111631,111633,0,2,3
31853,1,1,111632,111633,111634,1,2,0
31854,5,2,111637,111637,111639,0,2,3
31855,2,2,111639,111639,111641,0,2,0
31856,4,3,111643,111643,111646,0,3,2
31857,1,1,111644,111646,111647,2,3,0
31858,2,3,111646,111647,111650,1,4,0
31859,6,2,111652,111652,111654,0,2,2
31860,2,3,111654,111654,111657,0,3,0
31861,3,3,111657,111657,111660,0,3,0
31862,6,3,111663,111663,111666,0,3,3
31863,3,1,111666,111666,111667,0,1,0
31864,6,1,111672,111672,111673,0,1,5
31865,4,1,111676,111676,111677,0,1,3
31866,6,1,111682,111682,111683,0,1,5
31867,6,3,111688,111688,111691,0,3,5
31868,3,2,111691,111691,111693,0,2,0
31869,2,1,111693,111693,111694,0,1,0
31870,2,2,111695,111695,111697,0,2,1
31871,4,2,111699,111699,111701,0,2,2
31872,1,1,111700,111701,111702,1,2,0
31873,2,3,111702,111702,111705,0,3,0
31874,1,2,111703,111705,111707,2,4,0
31875,3,1,111706,111707,111708,1,2,0
31876,6,2,111712,111712,111714,0,2,4
31877,6,3,111718,111718,111721,0,3,4
31878,6,3,111724,111724,111727,0,3,3
31879,1,1,111725,111727,111728,2,3,0
31880,6,1,111731,111731,111732,0,1,3
31881,4,3,111735,111735,111738,0,3,3
31882,1,1,111736,111738,111739,2,3,0
31883,6,3,111742,111742,111745,0,3,3
31884,1,1,111743,111745,111746,2,3,0
31885,4,2,111747,111747,111749,0,2,1
31886,5,1,111752,111752,111753,0,1,3
31887,4,2,111756,111756,111758,0,2,3
31888,5,2,111761,111761,111763,0,2,3
31889,5,3,111766,111766,111769,0,3,3
31890,2,3,111768,111769,111772,1,4,0
31891,4,2,111772,111772,111774,0,2,0
31892,6,3,111778,111778,111781,0,3,4
31893,5,2,111783,111783,111785,0,2,2
31894,3,1,111786,111786,111787,0,1,1
31895,1,1,111787,111787,111788,0,1,0
31896,2,1,111789,111789,111790,0,1,1
31897,3,2,111792,111792,111794,0,2,2
31898,3,3,111795,111795,111798,0,3,1
31899,1,1,111796,111798,111799,2,3,0
31900,3,3,111799,111799,111802,0,3,0
31901,1,3,111800,111802,111805,2,5,0
31902,4,3,111804,111805,111808,1,4,0
31903,2,3,111806,111808,111811,2,5,0
31904,2,3,111808,111811,111814,3,6,0
31905,3,3,111811,111814,111817,3,6,0
31906,5,2,111816,111817,111819,1,3,0
31907,4,2,111820,111820,111822,0,2,1
31908,2,1,111822,111822,111823,0,1,0
31909,6,1,111828,111828,111829,0,1,5
31910,3,2,111831,111831,111833,0,2,2
31911,5,2,111836,111836,111838,0,2,3
31912,1,2,111837,111838,111840,1,3,0
31913,4,3,111841,111841,111844,0,3,1
31914,4,1,111845,111845,111846,0,1,1
31915,4,3,111849,111849,111852,0,3,3
31916,3,2,111852,111852,111854,0,2,0
31917,6,1,111858,111858,111859,0,1,4
31918,5,2,111863,111863,111865,0,2,4
31919,5,1,111868,111868,111869,0,1,3
31920,4,3,111872,111872,111875,0,3,3
31921,6,3,111878,111878,111881,0,3,3
31922,4,1,111882,111882,111883,0,1,1
31923,6,3,111888,111888,111891,0,3,5
31924,2,2,111890,111891,111893,1,3,0
31925,4,1,111894,111894,111895,0,1,1
31926,5,2,111899,111899,111901,0,2,4
31927,1,2,111900,111901,111903,1,3,0
31928,5,3,111905,111905,111908,0,3,2
31929,1,3,111906,111908,111911,2,5,0
31930,1,3,111907,111911,111914,4,7,0
31931,4,2,111911,111914,111916,3,5,0
31932,3,1,111914,111916,111917,2,3,0
31933,5,3,111919,111919,111922,0,3,2
31934,3,3,111922,111922,111925,0,3,0
31935,6,3,111928,111928,111931,0,3,3
31936,5,3,111933,111933,111936,0,3,2
31937,3,3,111936,111936,111939,0,3,0
31938,1,1,111937,111939,111940,2,3,0
31939,4,3,111941,111941,111944,0,3,1
31940,6,3,111947,111947,111950,0,3,3
31941,1,3,111948,111950,111953,2,5,0
31942,6,2,111954,111954,111956,0,2,1
31943,3,2,111957,111957,111959,0,2,1
31944,6,2,111963,111963,111965,0,2,4
31945,6,1,111969,111969,111970,0,1,4
31946,3,1,111972,111972,111973,0,1,2
31947,5,2,111977,111977,111979,0,2,4
31948,6,3,111983,111983,111986,0,3,4
31949,1,2,111984,111986,111988,2,4,0
31950,6,3,111990,111990,111993,0,3,2
31951,6,2,111996,111996,111998,0,2,3
31952,5,1,112001,112001,112002,0,1,3
31953,2,2,112003,112003,112005,0,2,1
31954,3,2,112006,112006,112008,0,2,1
31955,1,3,112007,112008,112011,1,4,0
31956,4,2,112011,112011,112013,0,2,0
31957,6,1,112017,112017,112018,0,1,4
31958,6,3,112023,112023,112026,0,3,5
31959,3,2,112026,112026,112028,0,2,0
31960,3,1,112029,112029,112030,0,1,1
31961,6,3,112035,112035,112038,0,3,5
31962,3,3,112038,112038,112041,0,3,0
31963,2,2,112040,112041,112043,1,3,0
31964,1,2,112041,112043,112045,2,4,0
31965,1,1,112042,112045,112046,3,4,0
31966,6,2,112048,112048,112050,0,2,2
31967,2,2,112050,112050,112052,0,2,0
31968,1,2,112051,112052,112054,1,3,0
31969,5,2,112056,112056,112058,0,2,2
31970,3,1,112059,112059,112060,0,1,1
31971,3,1,112062,112062,112063,0,1,2
31972,2,1,112064,112064,112065,0,1,1
31973,4,3,112068,112068,112071,0,3,3
31974,2,2,112070,112071,112073,1,3,0
31975,2,2,112072,112073,112075,1,3,0
31976,1,3,112073,112075,112078,2,5,0
31977,4,3,112077,112078,112081,1,4,0
31978,6,1,112083,112083,112084,0,1,2
31979,5,2,112088,112088,112090,0,2,4
31980,4,1,112092,112092,112093,0,1,2
31981,6,1,112098,112098,112099,0,1,5
31982,4,2,112102,112102,112104,0,2,3
31983,1,1,112103,112104,112105,1,2,0
31984,1,1,112104,112105,112106,1,2,0
31985,2,3,112106,112106,112109,0,3,0
31986,6,1,112112,112112,112113,0,1,3
31987,4,1,112116,112116,112117,0,1,3
31988,5,1,112121,112121,112122,0,1,4
31989,2,1,112123,112123,112124,0,1,1
31990,5,1,112128,112128,112129,0,1,4
31991,6,3,112134,112134,112137,0,3,5
31992,1,3,112135,112137,112140,2,5,0
31993,1,1,112136,112140,112141,4,5,0
31994,6,1,112142,112142,112143,0,1,1
31995,4,3,112146,112146,112149,0,3,3
31996,6,2,112152,112152,112154,0,2,3
31997,3,3,112155,112155,112158,0,3,1
31998,6,1,112161,112161,112162,0,1,3
31999,6,1,112167,112167,112168,0,1,5
32000,3,3,112170,112170,112173,0,3,2
32001,3,3,112173,112173,112176,0,3,0
32002,4,2,112177,112177,112179,0,2,1
32003,4,3,112181,112181,112184,0,3,2
32004,1,3,112182,112184,112187,2,5,0
32005,5,1,112187,112187,112188,0,1,0
32006,3,1,112190,112190,112191,0,1,2
32007,6,1,112196,112196,112197,0,1,5
32008,3,3,112199,112199,112202,0,3,2
32009,1,1,112200,112202,112203,2,3,0
32010,4,1,112204,112204,112205,0,1,1
32011,2,2,112206,112206,112208,0,2,1
32012,3,1,112209,112209,112210,0,1,1
32013,5,1,112214,112214,112215,0,1,4
32014,5,2,112219,112219,112221,0,2,4
32015,4,1,112223,112223,112224,0,1,2
32016,4,1,112227,112227,112228,0,1,3
32017,2,2,112229,112229,112231,0,2,1
32018,6,2,112235,112235,112237,0,2,4
32019,5,1,112240,112240,112241,0,1,3
32020,5,3,112245,112245,112248,0,3,4
32021,4,2,112249,112249,112251,0,2,1
32022,4,3,112253,112253,112256,0,3,2
32023,6,3,112259,112259,112262,0,3,3
32024,4,2,112263,112263,112265,0,2,1
32025,2,3,112265,112265,112268,0,3,0
32026,4,2,112269,112269,112271,0,2,1
32027,1,3,112270,112271,112274,1,4,0
32028,1,1,112271,112274,112275,3,4,0
32029,1,3,112272,112275,112278,3,6,0
32030,3,2,112275,112278,112280,3,5,0
32031,5,3,112280,112280,112283,0,3,0
32032,1,1,112281,112283,112284,2,3,0
32033,4,3,112285,112285,112288,0,3,1
32034,6,3,112291,112291,112294,0,3,3
32035,1,2,112292,112294,112296,2,4,0
32036,3,2,112295,112296,112298,1,3,0
32037,1,3,112296,112298,112301,2,5,0
32038,1,3,112297,112301,112304,4,7,0
32039,1,3,112298,112304,112307,6,9,0
32040,5,1,112303,112307,112308,4,5,0
32041,2,1,112305,112308,112309,3,4,0
32042,4,3,112309,112309,112312,0,3,0
32043,2,3,112311,112312,112315,1,4,0
32044,3,2,112314,112315,112317,1,3,0
32045,6,3,112320,112320,112323,0,3,3
32046,2,2,112322,112323,112325,1,3,0
32047,2,1,112324,112325,112326,1,2,0
32048,4,1,112328,112328,112329,0,1,2
32049,4,1,112332,112332,112333,0,1,3
32050,3,1,112335,112335,112336,0,1,2
32051,3,3,112338,112338,112341,0,3,2
32052,1,3,112339,112341,112344,2,5,0
32053,3,3,112342,112344,112347,2,5,0
32054,4,2,112346,112347,112349,1,3,0
32055,3,2,112349,112349,112351,0,2,0
32056,2,3,112351,112351,112354,0,3,0
32057,1,2,112352,112354,112356,2,4,0
32058,1,1,112353,112356,112357,3,4,0
32059,4,1,112357,112357,112358,0,1,0
32060,4,3,112361,112361,112364,0,3,3
32061,5,3,112366,112366,112369,0,3,2
32062,3,1,112369,112369,112370,0,1,0
32063,4,3,112373,112373,112376,0,3,3
32064,6,1,112379,112379,112380,0,1,3
32065,4,3,112383,112383,112386,0,3,3
32066,2,3,112385,112386,112389,1,4,0
32067,1,1,112386,112389,112390,3,4,0
32068,6,3,112392,112392,112395,0,3,2
32069,1,2,112393,112395,112397,2,4,0
32070,5,2,112398,112398,112400,0,2,1
32071,6,1,112404,112404,112405,0,1,4
32072,6,3,112410,112410,112413,0,3,5
32073,2,2,112412,112413,112415,1,3,0
32074,2,3,112414,112415,112418,1,4,0
32075,6,3,112420,112420,112423,0,3,2
32076,5,1,112425,112425,112426,0,1,2
32077,3,1,112428,112428,112429,0,1,2
32078,1,2,112429,112429,112431,0,2,0
32079,6,1,112435,112435,112436,0,1,4
32080,6,2,112441,112441,112443,0,2,5
32081,1,1,112442,112443,112444,1,2,0
32082,6,2,112448,112448,112450,0,2,4
32083,5,3,112453,112453,112456,0,3,3
32084,3,1,112456,112456,112457,0,1,0
32085,5,1,112461,112461,112462,0,1,4
32086,5,1,112466,112466,112467,0,1,4
32087,1,3,112467,112467,112470,0,3,0
32088,6,2,112473,112473,112475,0,2,3
32089,4,2,112477,112477,112479,0,2,2
32090,4,3,112481,112481,112484,0,3,2
32091,2,3,112483,112484,112487,1,4,0
32092,6,2,112489,112489,112491,0,2,2
32093,2,1,112491,112491,112492,0,1,0
32094,6,1,112497,112497,112498,0,1,5
32095,5,2,112502,112502,112504,0,2,4
32096,6,1,112508,112508,112509,0,1,4
32097,4,1,112512,112512,112513,0,1,3
32098,1,1,112513,112513,112514,0,1,0
32099,3,1,112516,112516,112517,0,1,2
32100,5,3,112521,112521,112524,0,3,4
32101,2,2,112523,112524,112526,1,3,0
32102,3,3,112526,112526,112529,0,3,0
32103,3,1,112529,112529,112530,0,1,0
32104,2,2,112531,112531,112533,0,2,1
32105,3,1,112534,112534,112535,0,1,1
32106,4,1,112538,112538,112539,0,1,3
32107,5,3,112543,112543,112546,0,3,4
32108,2,2,112545,112546,112548,1,3,0
32109,4,3,112549,112549,112552,0,3,1
32110,3,1,112552,112552,112553,0,1,0
32111,3,3,112555,112555,112558,0,3,2
32112,2,1,112557,112558,112559,1,2,0
32113,4,2,112561,112561,112563,0,2,2
32114,6,1,112567,112567,112568,0,1,4
32115,1,2,112568,112568,112570,0,2,0
32116,2,1,112570,112570,112571,0,1,0
32117,3,3,112573,112573,112576,0,3,2
32118,2,2,112575,112576,112578,1,3,0
32119,2,1,112577,112578,112579,1,2,0
32120,1,3,112578,112579,112582,1,4,0
32121,1,1,112579,112582,112583,3,4,0
32122,6,1,112585,112585,112586,0,1,2
32123,2,1,112587,112587,112588,0,1,1
32124,5,2,112592,112592,112594,0,2,4
32125,1,1,112593,112594,112595,1,2,0
32126,4,2,112597,112597,112599,0,2,2
32127,6,2,112603,112603,112605,0,2,4
32128,1,3,112604,112605,112608,1,4,0
32129,3,2,112607,112608,112610,1,3,0
32130,1,1,112608,112610,112611,2,3,0
32131,1,1,112609,112611,112612,2,3,0
32132,1,1,112610,112612,112613,2,3,0
32133,5,1,112615,112615,112616,0,1,2
32134,6,2,112621,112621,112623,0,2,5
32135,1,1,112622,112623,112624,1,2,0
32136,6,2,112628,112628,112630,0,2,4
32137,2,3,112630,112630,112633,0,3,0
32138,5,2,112635,112635,112637,0,2,2
32139,4,3,112639,112639,112642,0,3,2
32140,5,1,112644,112644,112645,0,1,2
32141,4,2,112648,112648,112650,0,2,3
32142,6,3,112654,112654,112657,0,3,4
32143,4,2,112658,112658,112660,0,2,1
32144,4,3,112662,112662,112665,0,3,2
32145,6,1,112668,112668,112669,0,1,3
32146,6,1,112674,112674,112675,0,1,5
32147,4,3,112678,112678,112681,0,3,3
32148,6,1,112684,112684,112685,0,1,3
32149,2,3,112686,112686,112689,0,3,1
32150,4,3,112690,112690,112693,0,3,1
32151,2,3,112692,112693,112696,1,4,0
32152,2,2,112694,112696,112698,2,4,0
32153,5,2,112699,112699,112701,0,2,1
32154,3,3,112702,112702,112705,0,3,1
32155,1,1,112703,112705,112706,2,3,0
32156,6,3,112709,112709,112712,0,3,3
32157,1,1,112710,112712,112713,2,3,0
32158,4,3,112714,112714,112717,0,3,1
32159,5,2,112719,112719,112721,0,2,2
32160,1,3,112720,112721,112724,1,4,0
32161,4,2,112724,112724,112726,0,2,0
32162,2,3,112726,112726,112729,0,3,0
32163,3,3,112729,112729,112732,0,3,0
32164,6,1,112735,112735,112736,0,1,3
32165,4,1,112739,112739,112740,0,1,3
32166,2,3,112741,112741,112744,0,3,1
32167,3,2,112744,112744,112746,0,2,0
32168,1,2,112745,112746,112748,1,3,0
32169,4,3,112749,112749,112752,0,3,1
32170,3,2,112752,112752,112754,0,2,0
32171,2,2,112754,112754,112756,0,2,0
32172,6,2,112760,112760,112762,0,2,4
32173,3,2,112763,112763,112765,0,2,1
32174,4,3,112767,112767,112770,0,3,2
32175,1,2,112768,112770,112772,2,4,0
32176,2,3,112770,112772,112775,2,5,0
32177,4,2,112774,112775,112777,1,3,0
32178,4,1,112778,112778,112779,0,1,1
32179,4,2,112782,112782,112784,0,2,3
32180,5,1,112787,112787,112788,0,1,3
32181,2,1,112789,112789,112790,0,1,1
32182,4,2,112793,112793,112795,0,2,3
32183,5,3,112798,112798,112801,0,3,3
32184,5,1,112803,112803,112804,0,1,2
32185,2,1,112805,112805,112806,0,1,1
32186,6,3,112811,112811,112814,0,3,5
32187,3,1,112814,112814,112815,0,1,0
32188,5,3,112819,112819,112822,0,3,4
32189,5,2,112824,112824,112826,0,2,2
32190,1,1,112825,112826,112827,1,2,0
32191,3,2,112828,112828,112830,0,2,1
32192,1,1,112829,112830,112831,1,2,0
32193,6,1,112835,112835,112836,0,1,4
32194,6,1,112841,112841,112842,0,1,5
32195,5,2,112846,112846,112848,0,2,4
32196,6,3,112852,112852,112855,0,3,4
32197,2,3,112854,112855,112858,1,4,0
32198,6,1,112860,112860,112861,0,1,2
32199,1,1,112861,112861,112862,0,1,0
32200,4,3,112865,112865,112868,0,3,3
32201,6,1,112871,112871,112872,0,1,3
32202,5,2,112876,112876,112878,0,2,4
32203,1,3,112877,112878,112881,1,4,0
32204,4,3,112881,112881,112884,0,3,0
32205,5,2,112886,112886,112888,0,2,2
32206,1,1,112887,112888,112889,1,2,0
32207,5,3,112892,112892,112895,0,3,3
32208,3,1,112895,112895,112896,0,1,0
32209,2,1,112897,112897,112898,0,1,1
32210,4,2,112901,112901,112903,0,2,3
32211,3,3,112904,112904,112907,0,3,1
32212,3,2,112907,112907,112909,0,2,0
32213,3,3,112910,112910,112913,0,3,1
32214,6,3,112916,112916,112919,0,3,3
32215,1,1,112917,112919,112920,2,3,0
32216,1,1,112918,112920,112921,2,3,0
32217,2,3,112920,112921,112924,1,4,0
32218,3,3,112923,112924,112927,1,4,0
32219,4,3,112927,112927,112930,0,3,0
32220,5,1,112932,112932,112933,0,1,2
32221,4,3,112936,112936,112939,0,3,3
32222,6,1,112942,112942,112943,0,1,3
32223,3,3,112945,112945,112948,0,3,2
32224,1,1,112946,112948,112949,2,3,0
32225,2,3,112948,112949,112952,1,4,0
32226,4,3,112952,112952,112955,0,3,0
32227,2,2,112954,112955,112957,1,3,0
32228,4,3,112958,112958,112961,0,3,1
32229,4,2,112962,112962,112964,0,2,1
32230,5,3,112967,112967,112970,0,3,3
32231,6,2,112973,112973,112975,0,2,3
32232,6,1,112979,112979,112980,0,1,4
32233,4,1,112983,112983,112984,0,1,3
32234,3,2,112986,112986,112988,0,2,2
32235,5,2,112991,112991,112993,0,2,3
32236,3,1,112994,112994,112995,0,1,1
32237,6,1,113000,113000,113001,0,1,5
32238,5,1,113005,113005,113006,0,1,4
32239,4,3,113009,113009,113012,0,3,3
32240,1,1,113010,113012,113013,2,3,0
32241,4,3,113014,113014,113017,0,3,1
32242,5,2,113019,113019,113021,0,2,2
32243,5,1,113024,113024,113025,0,1,3
32244,5,2,113029,113029,113031,0,2,4
32245,5,2,113034,113034,113036,0,2,3
32246,6,3,113040,113040,113043,0,3,4
32247,2,3,113042,113043,113046,1,4,0
32248,6,2,113048,113048,113050,0,2,2
32249,1,3,113049,113050,113053,1,4,0
32250,3,3,113052,113053,113056,1,4,0
32251,1,3,113053,113056,113059,3,6,0
32252,4,2,113057,113059,113061,2,4,0
32253,1,1,113058,113061,113062,3,4,0
32254,4,2,113062,113062,113064,0,2,0
32255,6,1,113068,113068,113069,0,1,4
32256,3,2,113071,113071,113073,0,2,2
32257,2,1,113073,113073,113074,0,1,0
32258,5,3,113078,113078,113081,0,3,4
32259,5,3,113083,113083,113086,0,3,2
32260,2,1,113085,113086,113087,1,2,0
32261,2,3,113087,113087,113090,0,3,0
32262,5,2,113092,113092,113094,0,2,2
32263,2,2,113094,113094,113096,0,2,0
32264,3,1,113097,113097,113098,0,1,1
32265,6,1,113103,113103,113104,0,1,5
32266,2,2,113105,113105,113107,0,2,1
32267,5,1,113110,113110,113111,0,1,3
32268,1,1,113111,113111,113112,0,1,0
32269,1,1,113112,113112,113113,0,1,0
32270,6,1,113118,113118,113119,0,1,5
32271,3,3,113121,113121,113124,0,3,2
32272,2,3,113123,113124,113127,1,4,0
32273,2,3,113125,113127,113130,2,5,0
32274,5,2,113130,113130,113132,0,2,0
32275,1,2,113131,113132,113134,1,3,0
32276,2,2,113133,113134,113136,1,3,0
32277,6,2,113139,113139,113141,0,2,3
32278,5,2,113144,113144,113146,0,2,3
32279,4,3,113148,113148,113151,0,3,2
32280,4,3,113152,113152,113155,0,3,1
32281,1,1,113153,113155,113156,2,3,0
32282,2,1,113155,113156,113157,1,2,0
32283,3,2,113158,113158,113160,0,2,1
32284,6,1,113164,113164,113165,0,1,4
32285,3,1,113167,113167,113168,0,1,2
32286,5,1,113172,113172,113173,0,1,4
32287,1,1,113173,113173,113174,0,1,0
32288,4,3,113177,113177,113180,0,3,3
32289,2,1,113179,113180,113181,1,2,0
32290,1,3,113180,113181,113184,1,4,0
32291,5,2,113185,113185,113187,0,2,1
32292,2,1,113187,113187,113188,0,1,0
32293,1,3,113188,113188,113191,0,3,0
32294,1,3,113189,113191,113194,2,5,0
32295,4,3,113193,113194,113197,1,4,0
32296,6,2,113199,113199,113201,0,2,2
32297,2,3,113201,113201,113204,0,3,0
32298,5,3,113206,113206,113209,0,3,2
32299,5,3,113211,113211,113214,0,3,2
32300,1,1,113212,113214,113215,2,3,0
32301,6,3,113218,113218,113221,0,3,3
32302,6,3,113224,113224,113227,0,3,3
32303,6,2,113230,113230,113232,0,2,3
32304,4,3,113234,113234,113237,0,3,2
32305,5,3,113239,113239,113242,0,3,2
32306,4,1,113243,113243,113244,0,1,1
32307,1,1,113244,113244,113245,0,1,0
32308,4,3,113248,113248,113251,0,3,3
32309,5,3,113253,113253,113256,0,3,2
32310,1,3,113254,113256,113259,2,5,0
32311,2,3,113256,113259,113262,3,6,0
32312,4,1,113260,113262,113263,2,3,0
32313,5,2,113265,113265,113267,0,2,2
32314,1,2,113266,113267,113269,1,3,0
32315,3,2,113269,113269,113271,0,2,0
32316,6,3,113275,113275,113278,0,3,4
32317,1,1,113276,113278,113279,2,3,0
32318,2,2,113278,113279,113281,1,3,0
32319,6,2,113284,113284,113286,0,2,3
32320,2,3,113286,113286,113289,0,3,0
32321,6,1,113292,113292,113293,0,1,3
32322,6,1,113298,113298,113299,0,1,5
32323,5,2,113303,113303,113305,0,2,4
32324,3,2,113306,113306,113308,0,2,1
32325,1,1,113307,113308,113309,1,2,0
32326,5,2,113312,113312,113314,0,2,3
32327,5,3,113317,113317,113320,0,3,3
32328,5,2,113322,113322,113324,0,2,2
32329,1,1,113323,113324,113325,1,2,0
32330,3,2,113326,113326,113328,0,2,1
32331,6,2,113332,113332,113334,0,2,4
32332,1,3,113333,113334,113337,1,4,0
32333,3,1,113336,113337,113338,1,2,0
32334,4,1,113340,113340,113341,0,1,2
32335,4,3,113344,113344,113347,0,3,3
32336,1,2,113345,113347,113349,2,4,0
32337,6,3,113351,113351,113354,0,3,2
32338,5,2,113356,113356,113358,0,2,2
32339,3,1,113359,113359,113360,0,1,1
32340,4,2,113363,113363,113365,0,2,3
32341,6,2,113369,113369,113371,0,2,4
32342,6,3,113375,113375,113378,0,3,4
32343,5,1,113380,113380,113381,0,1,2
32344,3,1,113383,113383,113384,0,1,2
32345,4,3,113387,113387,113390,0,3,3
32346,6,2,113393,113393,113395,0,2,3
32347,4,2,113397,113397,113399,0,2,2
32348,6,1,113403,113403,113404,0,1,4
32349,5,1,113408,113408,113409,0,1,4
32350,4,3,113412,113412,113415,0,3,3
32351,2,1,113414,113415,113416,1,2,0
32352,5,2,113419,113419,113421,0,2,3
32353,5,2,113424,113424,113426,0,2,3
32354,2,2,113426,113426,113428,0,2,0
32355,2,3,113428,113428,113431,0,3,0
32356,3,1,113431,113431,113432,0,1,0
32357,5,1,113436,113436,113437,0,1,4
32358,4,3,113440,113440,113443,0,3,3
32359,2,3,113442,113443,113446,1,4,0
32360,4,1,113446,113446,113447,0,1,0
32361,2,1,113448,113448,113449,0,1,1
32362,1,2,113449,113449,113451,0,2,0
32363,6,1,113455,113455,113456,0,1,4
32364,6,2,113461,113461,113463,0,2,5
32365,4,2,113465,113465,113467,0,2,2
32366,1,3,113466,113467,113470,1,4,0
32367,4,2,113470,113470,113472,0,2,0
32368,4,2,113474,113474,113476,0,2,2
32369,6,2,113480,113480,113482,0,2,4
32370,3,1,113483,113483,113484,0,1,1
32371,1,3,113484,113484,113487,0,3,0
32372,3,1,113487,113487,113488,0,1,0
32373,6,2,113493,113493,113495,0,2,5
32374,1,2,113494,113495,113497,1,3,0
32375,1,3,113495,113497,113500,2,5,0
32376,4,1,113499,113500,113501,1,2,0
32377,2,2,113501,113501,113503,0,2,0
32378,4,3,113505,113505,113508,0,3,2
32379,1,1,113506,113508,113509,2,3,0
32380,2,1,113508,113509,113510,1,2,0
32381,2,2,113510,113510,113512,0,2,0
32382,5,3,113515,113515,113518,0,3,3
32383,1,3,113516,113518,113521,2,5,0
32384,4,3,113520,113521,113524,1,4,0
32385,4,2,113524,113524,113526,0,2,0
32386,6,3,113530,113530,113533,0,3,4
32387,5,3,113535,113535,113538,0,3,2
32388,1,3,113536,113538,113541,2,5,0
32389,3,2,113539,113541,113543,2,4,0
32390,2,1,113541,113543,113544,2,3,0
32391,4,2,113545,113545,113547,0,2,1
32392,2,1,113547,113547,113548,0,1,0
32393,4,3,113551,113551,113554,0,3,3
32394,5,2,113556,113556,113558,0,2,2
32395,6,2,113562,113562,113564,0,2,4
32396,1,2,113563,113564,113566,1,3,0
32397,5,3,113568,113568,113571,0,3,2
32398,5,1,113573,113573,113574,0,1,2
32399,6,1,113579,113579,113580,0,1,5
32400,3,2,113582,113582,113584,0,2,2
32401,6,1,113588,113588,113589,0,1,4
32402,5,2,113593,113593,113595,0,2,4
32403,2,2,113595,113595,113597,0,2,0
32404,4,2,113599,113599,113601,0,2,2
32405,2,3,113601,113601,113604,0,3,0
32406,4,3,113605,113605,113608,0,3,1
32407,5,2,113610,113610,113612,0,2,2
32408,4,2,113614,113614,113616,0,2,2
32409,3,3,113617,113617,113620,0,3,1
32410,5,3,113622,113622,113625,0,3,2
32411,1,1,113623,113625,113626,2,3,0
32412,6,3,113629,113629,113632,0,3,3
32413,4,3,113633,113633,113636,0,3,1
32414,6,1,113639,113639,113640,0,1,3
32415,4,1,113643,113643,113644,0,1,3
32416,1,1,113644,113644,113645,0,1,0
32417,3,1,113647,113647,113648,0,1,2
32418,4,3,113651,113651,113654,0,3,3
32419,3,1,113654,113654,113655,0,1,0
32420,1,3,113655,113655,113658,0,3,0
32421,3,3,113658,113658,113661,0,3,0
32422,1,1,113659,113661,113662,2,3,0
32423,6,3,113665,113665,113668,0,3,3
32424,6,3,113671,113671,113674,0,3,3
32425,6,1,113677,113677,113678,0,1,3
32426,3,3,113680,113680,113683,0,3,2
32427,4,2,113684,113684,113686,0,2,1
32428,6,3,113690,113690,113693,0,3,4
32429,3,1,113693,113693,113694,0,1,0
32430,3,1,113696,113696,113697,0,1,2
32431,2,1,113698,113698,113699,0,1,1
32432,4,3,113702,113702,113705,0,3,3
32433,4,2,113706,113706,113708,0,2,1
32434,3,2,113709,113709,113711,0,2,1
32435,1,3,113710,113711,113714,1,4,0
32436,6,3,113716,113716,113719,0,3,2
32437,1,3,113717,113719,113722,2,5,0
32438,1,1,113718,113722,113723,4,5,0
32439,2,1,113720,113723,113724,3,4,0
32440,5,2,113725,113725,113727,0,2,1
32441,3,2,113728,113728,113730,0,2,1
32442,3,1,113731,113731,113732,0,1,1
32443,6,2,113737,113737,113739,0,2,5
32444,2,3,113739,113739,113742,0,3,0
32445,1,2,113740,113742,113744,2,4,0
32446,1,1,113741,113744,113745,3,4,0
32447,5,1,113746,113746,113747,0,1,1
32448,1,3,113747,113747,113750,0,3,0
32449,6,3,113753,113753,113756,0,3,3
32450,3,2,113756,113756,113758,0,2,0
32451,2,2,113758,113758,113760,0,2,0
32452,5,3,113763,113763,113766,0,3,3
32453,1,1,113764,113766,113767,2,3,0
32454,3,1,113767,113767,113768,0,1,0
32455,4,1,113771,113771,113772,0,1,3
32456,4,2,113775,113775,113777,0,2,3
32457,2,2,113777,113777,113779,0,2,0
32458,1,1,113778,113779,113780,1,2,0
32459,5,2,113783,113783,113785,0,2,3
32460,4,3,113787,113787,113790,0,3,2
32461,2,3,113789,113790,113793,1,4,0
32462,3,1,113792,113793,113794,1,2,0
32463,5,3,113797,113797,113800,0,3,3
32464,5,3,113802,113802,113805,0,3,2
32465,6,1,113808,113808,113809,0,1,3
32466,2,2,113810,113810,113812,0,2,1
32467,3,2,113813,113813,113815,0,2,1
32468,6,2,113819,113819,113821,0,2,4
32469,5,2,113824,113824,113826,0,2,3
32470,3,3,113827,113827,113830,0,3,1
32471,5,3,113832,113832,113835,0,3,2
32472,4,3,113836,113836,113839,0,3,1
32473,5,1,113841,113841,113842,0,1,2
32474,4,3,113845,113845,113848,0,3,3
32475,6,1,113851,113851,113852,0,1,3
32476,1,3,113852,113852,113855,0,3,0
32477,4,1,113856,113856,113857,0,1,1
32478,2,2,113858,113858,113860,0,2,1
32479,5,3,113863,113863,113866,0,3,3
32480,6,2,113869,113869,113871,0,2,3
32481,1,3,113870,113871,113874,1,4,0
32482,1,1,113871,113874,113875,3,4,0
32483,1,2,113872,113875,113877,3,5,0
32484,4,3,113876,113877,113880,1,4,0
32485,6,1,113882,113882,113883,0,1,2
32486,2,3,113884,113884,113887,0,3,1
32487,5,3,113889,113889,113892,0,3,2
32488,6,3,113895,113895,113898,0,3,3
32489,2,2,113897,113898,113900,1,3,0
32490,6,2,113903,113903,113905,0,2,3
32491,4,3,113907,113907,113910,0,3,2
32492,3,2,113910,113910,113912,0,2,0
32493,1,3,113911,113912,113915,1,4,0
32494,3,3,113914,113915,113918,1,4,0
32495,4,2,113918,113918,113920,0,2,0
32496,1,2,113919,113920,113922,1,3,0
32497,1,2,113920,113922,113924,2,4,0
32498,5,2,113925,113925,113927,0,2,1
32499,6,2,113931,113931,113933,0,2,4
32500,4,3,113935,113935,113938,0,3,2
32501,3,1,113938,113938,113939,0,1,0
32502,4,2,113942,113942,113944,0,2,3
32503,4,1,113946,113946,113947,0,1,2
32504,2,1,113948,113948,113949,0,1,1
32505,6,3,113954,113954,113957,0,3,5
32506,2,3,113956,113957,113960,1,4,0
32507,2,3,113958,113960,113963,2,5,0
32508,3,3,113961,113963,113966,2,5,0
32509,4,1,113965,113966,113967,1,2,0
32510,4,1,113969,113969,113970,0,1,2
32511,1,1,113970,113970,113971,0,1,0
32512,6,2,113976,113976,113978,0,2,5
32513,6,1,113982,113982,113983,0,1,4
32514,2,1,113984,113984,113985,0,1,1
32515,4,1,113988,113988,113989,0,1,3
32516,1,2,113989,113989,113991,0,2,0
32517,3,1,113992,113992,113993,0,1,1
32518,3,1,113995,113995,113996,0,1,2
32519,6,2,114001,114001,114003,0,2,5
32520,3,2,114004,114004,114006,0,2,1
32521,2,2,114006,114006,114008,0,2,0
32522,3,2,114009,114009,114011,0,2,1
32523,6,2,114015,114015,114017,0,2,4
32524,1,1,114016,114017,114018,1,2,0
32525,1,3,114017,114018,114021,1,4,0
32526,5,3,114022,114022,114025,0,3,1
32527,5,1,114027,114027,114028,0,1,2
32528,5,3,114032,114032,114035,0,3,4
32529,6,3,114038,114038,114041,0,3,3
32530,4,2,114042,114042,114044,0,2,1
32531,1,2,114043,114044,114046,1,3,0
32532,5,3,114048,114048,114051,0,3,2
32533,6,2,114054,114054,114056,0,2,3
32534,3,2,114057,114057,114059,0,2,1
32535,5,3,114062,114062,114065,0,3,3
32536,6,2,114068,114068,114070,0,2,3
32537,5,2,114073,114073,114075,0,2,3
32538,2,3,114075,114075,114078,0,3,0
32539,3,3,114078,114078,114081,0,3,0
32540,3,1,114081,114081,114082,0,1,0
32541,2,2,114083,114083,114085,0,2,1
32542,3,1,114086,114086,114087,0,1,1
32543,2,3,114088,114088,114091,0,3,1
32544,6,3,114094,114094,114097,0,3,3
32545,6,3,114100,114100,114103,0,3,3
32546,3,3,114103,114103,114106,0,3,0
32547,6,3,114109,114109,114112,0,3,3
32548,3,2,114112,114112,114114,0,2,0
32549,4,2,114116,114116,114118,0,2,2
32550,6,2,114122,114122,114124,0,2,4
32551,6,2,114128,114128,114130,0,2,4
32552,1,2,114129,114130,114132,1,3,0
32553,3,2,114132,114132,114134,0,2,0
32554,1,3,114133,114134,114137,1,4,0
32555,2,3,114135,114137,114140,2,5,0
32556,2,3,114137,114140,114143,3,6,0
32557,4,2,114141,114143,114145,2,4,0
32558,4,3,114145,114145,114148,0,3,0
32559,5,3,114150,114150,114153,0,3,2
32560,5,2,114155,114155,114157,0,2,2
32561,5,3,114160,114160,114163,0,3,3
32562,1,1,114161,114163,114164,2,3,0
32563,6,1,114167,114167,114168,0,1,3
32564,3,2,114170,114170,114172,0,2,2
32565,6,2,114176,114176,114178,0,2,4
32566,2,3,114178,114178,114181,0,3,0
32567,2,3,114180,114181,114184,1,4,0
32568,1,2,114181,114184,114186,3,5,0
32569,4,2,114185,114186,114188,1,3,0
32570,4,2,114189,114189,114191,0,2,1
32571,6,3,114195,114195,114198,0,3,4
32572,1,2,114196,114198,114200,2,4,0
32573,5,3,114201,114201,114204,0,3,1
32574,3,3,114204,114204,114207,0,3,0
32575,1,2,114205,114207,114209,2,4,0
32576,1,1,114206,114209,114210,3,4,0
32577,1,2,114207,114210,114212,3,5,0
32578,5,2,114212,114212,114214,0,2,0
32579,6,2,114218,114218,114220,0,2,4
32580,2,3,114220,114220,114223,0,3,0
32581,6,1,114226,114226,114227,0,1,3
32582,4,2,114230,114230,114232,0,2,3
32583,6,3,114236,114236,114239,0,3,4
32584,6,3,114242,114242,114245,0,3,3
32585,5,3,114247,114247,114250,0,3,2
32586,5,1,114252,114252,114253,0,1,2
32587,3,2,114255,114255,114257,0,2,2
32588,2,2,114257,114257,114259,0,2,0
32589,2,2,114259,114259,114261,0,2,0
32590,1,3,114260,114261,114264,1,4,0
32591,4,1,114264,114264,114265,0,1,0
32592,4,2,114268,114268,114270,0,2,3
32593,3,2,114271,114271,114273,0,2,1
32594,1,1,114272,114273,114274,1,2,0
32595,4,3,114276,114276,114279,0,3,2
32596,2,1,114278,114279,114280,1,2,0
32597,3,3,114281,114281,114284,0,3,1
32598,1,2,114282,114284,114286,2,4,0
32599,5,3,114287,114287,114290,0,3,1
32600,1,3,114288,114290,114293,2,5,0
32601,2,2,114290,114293,114295,3,5,0
32602,2,3,114292,114295,114298,3,6,0
32603,2,3,114294,114298,114301,4,7,0
32604,4,3,114298,114301,114304,3,6,0
32605,4,3,114302,114304,114307,2,5,0
32606,4,1,114306,114307,114308,1,2,0
32607,1,1,114307,114308,114309,1,2,0
32608,2,3,114309,114309,114312,0,3,0
32609,5,3,114314,114314,114317,0,3,2
32610,5,3,114319,114319,114322,0,3,2
32611,4,2,114323,114323,114325,0,2,1
32612,2,1,114325,114325,114326,0,1,0
32613,5,3,114330,114330,114333,0,3,4
32614,4,3,114334,114334,114337,0,3,1
32615,5,1,114339,114339,114340,0,1,2
32616,5,1,114344,114344,114345,0,1,4
32617,1,2,114345,114345,114347,0,2,0
32618,3,3,114348,114348,114351,0,3,1
32619,5,2,114353,114353,114355,0,2,2
32620,1,2,114354,114355,114357,1,3,0
32621,1,3,114355,114357,114360,2,5,0
32622,1,3,114356,114360,114363,4,7,0
32623,6,1,114362,114363,114364,1,2,0
32624,6,3,114368,114368,114371,0,3,4
32625,1,1,114369,114371,114372,2,3,0
32626,1,1,114370,114372,114373,2,3,0
32627,1,3,114371,114373,114376,2,5,0
32628,6,1,114377,114377,114378,0,1,1
32629,4,2,114381,114381,114383,0,2,3
32630,5,1,114386,114386,114387,0,1,3
32631,6,1,114392,114392,114393,0,1,5
32632,2,1,114394,114394,114395,0,1,1
32633,6,1,114400,114400,114401,0,1,5
32634,1,2,114401,114401,114403,0,2,0
32635,5,3,114406,114406,114409,0,3,3
32636,3,2,114409,114409,114411,0,2,0
32637,4,2,114413,114413,114415,0,2,2
32638,1,1,114414,114415,114416,1,2,0
32639,3,1,114417,114417,114418,0,1,1
32640,4,2,114421,114421,114423,0,2,3
32641,4,2,114425,114425,114427,0,2,2
32642,4,2,114429,114429,114431,0,2,2
32643,3,2,114432,114432,114434,0,2,1
32644,1,3,114433,114434,114437,1,4,0
32645,1,3,114434,114437,114440,3,6,0
32646,5,1,114439,114440,114441,1,2,0
32647,6,2,114445,114445,114447,0,2,4
32648,5,3,114450,114450,114453,0,3,3
32649,2,2,114452,114453,114455,1,3,0
32650,1,1,114453,114455,114456,2,3,0
32651,1,2,114454,114456,114458,2,4,0
32652,6,1,114460,114460,114461,0,1,2
32653,4,2,114464,114464,114466,0,2,3
32654,2,3,114466,114466,114469,0,3,0
32655,3,1,114469,114469,114470,0,1,0
32656,4,1,114473,114473,114474,0,1,3
32657,4,2,114477,114477,114479,0,2,3
32658,6,2,114483,114483,114485,0,2,4
32659,5,1,114488,114488,114489,0,1,3
32660,6,2,114494,114494,114496,0,2,5
32661,6,3,114500,114500,114503,0,3,4
32662,5,3,114505,114505,114508,0,3,2
32663,2,1,114507,114508,114509,1,2,0
32664,5,1,114512,114512,114513,0,1,3
32665,2,1,114514,114514,114515,0,1,1
32666,2,3,114516,114516,114519,0,3,1
32667,6,3,114522,114522,114525,0,3,3
32668,5,2,114527,114527,114529,0,2,2
32669,6,3,114533,114533,114536,0,3,4
32670,4,2,114537,114537,114539,0,2,1
32671,4,2,114541,114541,114543,0,2,2
32672,6,1,114547,114547,114548,0,1,4
32673,2,3,114549,114549,114552,0,3,1
32674,5,1,114554,114554,114555,0,1,2
32675,1,3,114555,114555,114558,0,3,0
32676,4,2,114559,114559,114561,0,2,1
32677,6,2,114565,114565,114567,0,2,4
32678,4,1,114569,114569,114570,0,1,2
32679,5,3,114574,114574,114577,0,3,4
32680,2,2,114576,114577,114579,1,3,0
32681,4,2,114580,114580,114582,0,2,1
32682,6,1,114586,114586,114587,0,1,4
32683,4,2,114590,114590,114592,0,2,3
32684,2,1,114592,114592,114593,0,1,0
32685,1,1,114593,114593,114594,0,1,0
32686,3,1,114596,114596,114597,0,1,2
32687,5,3,114601,114601,114604,0,3,4
32688,3,2,114604,114604,114606,0,2,0
32689,6,2,114610,114610,114612,0,2,4
32690,4,3,114614,114614,114617,0,3,2
32691,4,2,114618,114618,114620,0,2,1
32692,5,1,114623,114623,114624,0,1,3
32693,5,2,114628,114628,114630,0,2,4
32694,6,2,114634,114634,114636,0,2,4
32695,5,1,114639,114639,114640,0,1,3
32696,6,1,114645,114645,114646,0,1,5
32697,6,3,114651,114651,114654,0,3,5
32698,3,3,114654,114654,114657,0,3,0
32699,1,1,114655,114657,114658,2,3,0
32700,5,2,114660,114660,114662,0,2,2
32701,6,1,114666,114666,114667,0,1,4
32702,5,2,114671,114671,114673,0,2,4
32703,1,1,114672,114673,114674,1,2,0
32704,2,1,114674,114674,114675,0,1,0
32705,6,2,114680,114680,114682,0,2,5
32706,6,2,114686,114686,114688,0,2,4
32707,1,3,114687,114688,114691,1,4,0
32708,2,2,114689,114691,114693,2,4,0
32709,1,1,114690,114693,114694,3,4,0
32710,6,3,114696,114696,114699,0,3,2
32711,5,1,114701,114701,114702,0,1,2
32712,3,3,114704,114704,114707,0,3,2
32713,1,2,114705,114707,114709,2,4,0
32714,5,1,114710,114710,114711,0,1,1
32715,5,1,114715,114715,114716,0,1,4
32716,5,3,114720,114720,114723,0,3,4
32717,6,3,114726,114726,114729,0,3,3
32718,1,3,114727,114729,114732,2,5,0
32719,5,1,114732,114732,114733,0,1,0
32720,2,1,114734,114734,114735,0,1,1
32721,1,3,114735,114735,114738,0,3,0
32722,4,2,114739,114739,114741,0,2,1
32723,5,1,114744,114744,114745,0,1,3
32724,4,3,114748,114748,114751,0,3,3
32725,5,3,114753,114753,114756,0,3,2
32726,6,2,114759,114759,114761,0,2,3
32727,3,3,114762,114762,114765,0,3,1
32728,4,1,114766,114766,114767,0,1,1
32729,2,3,114768,114768,114771,0,3,1
32730,4,1,114772,114772,114773,0,1,1
32731,5,3,114777,114777,114780,0,3,4
32732,4,2,114781,114781,114783,0,2,1
32733,2,2,114783,114783,114785,0,2,0
32734,5,3,114788,114788,114791,0,3,3
32735,1,3,114789,114791,114794,2,5,0
32736,6,2,114795,114795,114797,0,2,1
32737,3,3,114798,114798,114801,0,3,1
32738,5,2,114803,114803,114805,0,2,2
32739,1,3,114804,114805,114808,1,4,0
32740,2,1,114806,114808,114809,2,3,0
32741,2,1,114808,114809,114810,1,2,0
32742,5,3,114813,114813,114816,0,3,3
32743,5,2,114818,114818,114820,0,2,2
32744,3,1,114821,114821,114822,0,1,1
32745,2,3,114823,114823,114826,0,3,1
32746,3,3,114826,114826,114829,0,3,0
32747,4,3,114830,114830,114833,0,3,1
32748,6,2,114836,114836,114838,0,2,3
32749,1,2,114837,114838,114840,1,3,0
32750,1,3,114838,114840,114843,2,5,0
32751,6,3,114844,114844,114847,0,3,1
32752,6,3,114850,114850,114853,0,3,3
32753,3,1,114853,114853,114854,0,1,0
32754,2,3,114855,114855,114858,0,3,1
32755,3,3,114858,114858,114861,0,3,0
32756,2,2,114860,114861,114863,1,3,0
32757,4,3,114864,114864,114867,0,3,1
32758,6,2,114870,114870,114872,0,2,3
32759,4,2,114874,114874,114876,0,2,2
32760,3,1,114877,114877,114878,0,1,1
32761,6,1,114883,114883,114884,0,1,5
32762,6,1,114889,114889,114890,0,1,5
32763,5,3,114894,114894,114897,0,3,4
32764,2,2,114896,114897,114899,1,3,0
32765,6,1,114902,114902,114903,0,1,3
32766,2,1,114904,114904,114905,0,1,1
32767,3,2,114907,114907,114909,0,2,2
32768,1,3,114908,114909,114912,1,4,0
32769,6,1,114914,114914,114915,0,1,2
32770,3,3,114917,114917,114920,0,3,2
32771,2,2,114919,114920,114922,1,3,0
32772,3,2,114922,114922,114924,0,2,0
32773,5,3,114927,114927,114930,0,3,3
32774,5,1,114932,114932,114933,0,1,2
32775,5,2,114937,114937,114939,0,2,4
32776,6,1,114943,114943,114944,0,1,4
32777,4,1,114947,114947,114948,0,1,3
32778,6,2,114953,114953,114955,0,2,5
32779,4,3,114957,114957,114960,0,3,2
32780,6,1,114963,114963,114964,0,1,3
32781,6,2,114969,114969,114971,0,2,5
32782,1,1,114970,114971,114972,1,2,0
32783,4,1,114974,114974,114975,0,1,2
32784,1,1,114975,114975,114976,0,1,0
32785,6,2,114981,114981,114983,0,2,5
32786,3,1,114984,114984,114985,0,1,1
32787,5,3,114989,114989,114992,0,3,4
32788,1,2,114990,114992,114994,2,4,0
32789,2,3,114992,114994,114997,2,5,0
32790,5,1,114997,114997,114998,0,1,0
32791,3,1,115000,115000,115001,0,1,2
32792,6,3,115006,115006,115009,0,3,5
32793,2,3,115008,115009,115012,1,4,0
32794,5,3,115013,115013,115016,0,3,1
32795,1,3,115014,115016,115019,2,5,0
32796,2,2,115016,115019,115021,3,5,0
32797,3,1,115019,115021,115022,2,3,0
32798,6,3,115025,115025,115028,0,3,3
32799,6,3,115031,115031,115034,0,3,3
32800,1,1,115032,115034,115035,2,3,0
32801,2,1,115034,115035,115036,1,2,0
32802,5,3,115039,115039,115042,0,3,3
32803,6,1,115045,115045,115046,0,1,3
32804,1,1,115046,115046,115047,0,1,0
32805,4,2,115050,115050,115052,0,2,3
32806,2,3,115052,115052,115055,0,3,0
32807,2,1,115054,115055,115056,1,2,0
32808,6,1,115060,115060,115061,0,1,4
32809,3,3,115063,115063,115066,0,3,2
32810,4,1,115067,115067,115068,0,1,1
32811,5,3,115072,115072,115075,0,3,4
32812,5,2,115077,115077,115079,0,2,2
32813,6,1,115083,115083,115084,0,1,4
32814,5,1,115088,115088,115089,0,1,4
32815,2,2,115090,115090,115092,0,2,1
32816,2,1,115092,115092,115093,0,1,0
32817,3,3,115095,115095,115098,0,3,2
32818,2,2,115097,115098,115100,1,3,0
32819,5,1,115102,115102,115103,0,1,2
32820,5,3,115107,115107,115110,0,3,4
32821,2,2,115109,115110,115112,1,3,0
32822,2,2,115111,115112,115114,1,3,0
32823,1,1,115112,115114,115115,2,3,0
32824,4,3,115116,115116,115119,0,3,1
32825,3,2,115119,115119,115121,0,2,0
32826,1,3,115120,115121,115124,1,4,0
32827,6,1,115126,115126,115127,0,1,2
32828,6,1,115132,115132,115133,0,1,5
32829,1,3,115133,115133,115136,0,3,0
32830,1,1,115134,115136,115137,2,3,0
32831,3,2,115137,115137,115139,0,2,0
32832,3,3,115140,115140,115143,0,3,1
32833,3,3,115143,115143,115146,0,3,0
32834,1,2,115144,115146,115148,2,4,0
32835,6,3,115150,115150,115153,0,3,2
32836,6,1,115156,115156,115157,0,1,3
32837,6,3,115162,115162,115165,0,3,5
32838,2,3,115164,115165,115168,1,4,0
32839,6,1,115170,115170,115171,0,1,2
32840,4,3,115174,115174,115177,0,3,3
32841,6,1,115180,115180,115181,0,1,3
32842,2,3,115182,115182,115185,0,3,1
32843,2,2,115184,115185,115187,1,3,0
32844,5,2,115189,115189,115191,0,2,2
32845,1,1,115190,115191,115192,1,2,0
32846,4,1,115194,115194,115195,0,1,2
32847,6,2,115200,115200,115202,0,2,5
32848,3,1,115203,115203,115204,0,1,1
32849,4,1,115207,115207,115208,0,1,3
32850,6,2,115213,115213,115215,0,2,5
32851,4,3,115217,115217,115220,0,3,2
32852,4,1,115221,115221,115222,0,1,1
32853,3,1,115224,115224,115225,0,1,2
32854,6,1,115230,115230,115231,0,1,5
32855,1,3,115231,115231,115234,0,3,0
32856,6,3,115237,115237,115240,0,3,3
32857,6,3,115243,115243,115246,0,3,3
32858,1,3,115244,115246,115249,2,5,0
32859,1,3,115245,115249,115252,4,7,0
32860,6,2,115251,115252,115254,1,3,0
32861,4,2,115255,115255,115257,0,2,1
32862,1,3,115256,115257,115260,1,4,0
32863,6,3,115262,115262,115265,0,3,2
32864,3,3,115265,115265,115268,0,3,0
32865,2,2,115267,115268,115270,1,3,0
32866,2,2,115269,115270,115272,1,3,0
32867,4,2,115273,115273,115275,0,2,1
32868,5,3,115278,115278,115281,0,3,3
32869,5,1,115283,115283,115284,0,1,2
32870,1,3,115284,115284,115287,0,3,0
32871,5,2,115289,115289,115291,0,2,2
32872,1,3,115290,115291,115294,1,4,0
32873,4,3,115294,115294,115297,0,3,0
32874,2,3,115296,115297,115300,1,4,0
32875,5,3,115301,115301,115304,0,3,1
32876,4,3,115305,115305,115308,0,3,1
32877,6,1,115311,115311,115312,0,1,3
32878,1,1,115312,115312,115313,0,1,0
32879,1,3,115313,115313,115316,0,3,0
32880,3,1,115316,115316,115317,0,1,0
32881,5,2,115321,115321,115323,0,2,4
32882,6,1,115327,115327,115328,0,1,4
32883,4,1,115331,115331,115332,0,1,3
32884,6,2,115337,115337,115339,0,2,5
32885,1,1,115338,115339,115340,1,2,0
32886,1,2,115339,115340,115342,1,3,0
32887,1,1,115340,115342,115343,2,3,0
32888,5,3,115345,115345,115348,0,3,2
32889,2,2,115347,115348,115350,1,3,0
32890,3,2,115350,115350,115352,0,2,0
32891,6,2,115356,115356,115358,0,2,4
32892,4,2,115360,115360,115362,0,2,2
32893,6,2,115366,115366,115368,0,2,4
32894,5,1,115371,115371,115372,0,1,3
32895,5,1,115376,115376,115377,0,1,4
32896,6,3,115382,115382,115385,0,3,5
32897,2,1,115384,115385,115386,1,2,0
32898,4,1,115388,115388,115389,0,1,2
32899,2,1,115390,115390,115391,0,1,1
32900,3,3,115393,115393,115396,0,3,2
32901,1,3,115394,115396,115399,2,5,0
32902,4,1,115398,115399,115400,1,2,0
32903,6,1,115404,115404,115405,0,1,4
32904,5,2,115409,115409,115411,0,2,4
32905,6,2,115415,115415,115417,0,2,4
32906,5,2,115420,115420,115422,0,2,3
32907,3,2,115423,115423,115425,0,2,1
32908,4,3,115427,115427,115430,0,3,2
32909,3,3,115430,115430,115433,0,3,0
32910,1,3,115431,115433,115436,2,5,0
32911,1,2,115432,115436,115438,4,6,0
32912,6,3,115438,115438,115441,0,3,0
32913,2,3,115440,115441,115444,1,4,0
32914,2,2,115442,115444,115446,2,4,0
32915,3,1,115445,115446,115447,1,2,0
32916,4,3,115449,115449,115452,0,3,2
32917,5,2,115454,115454,115456,0,2,2
32918,6,3,115460,115460,115463,0,3,4
32919,1,3,115461,115463,115466,2,5,0
32920,4,3,115465,115466,115469,1,4,0
32921,5,1,115470,115470,115471,0,1,1
32922,2,1,115472,115472,115473,0,1,1
32923,6,2,115478,115478,115480,0,2,5
32924,3,3,115481,115481,115484,0,3,1
32925,3,2,115484,115484,115486,0,2,0
32926,6,2,115490,115490,115492,0,2,4
32927,5,1,115495,115495,115496,0,1,3
32928,4,1,115499,115499,115500,0,1,3
32929,5,2,115504,115504,115506,0,2,4
32930,1,3,115505,115506,115509,1,4,0
32931,1,1,115506,115509,115510,3,4,0
32932,1,3,115507,115510,115513,3,6,0
32933,1,3,115508,115513,115516,5,8,0
32934,6,3,115514,115516,115519,2,5,0
32935,6,3,115520,115520,115523,0,3,1
32936,4,1,115524,115524,115525,0,1,1
32937,4,1,115528,115528,115529,0,1,3
32938,5,3,115533,115533,115536,0,3,4
32939,3,2,115536,115536,115538,0,2,0
32940,3,1,115539,115539,115540,0,1,1
32941,4,3,115543,115543,115546,0,3,3
32942,4,3,115547,115547,115550,0,3,1
32943,1,2,115548,115550,115552,2,4,0
32944,1,2,115549,115552,115554,3,5,0
32945,6,2,115555,115555,115557,0,2,1
32946,1,1,115556,115557,115558,1,2,0
32947,2,1,115558,115558,115559,0,1,0
32948,2,1,115560,115560,115561,0,1,1
32949,2,3,115562,115562,115565,0,3,1
32950,6,3,115568,115568,115571,0,3,3
32951,5,2,115573,115573,115575,0,2,2
32952,5,2,115578,115578,115580,0,2,3
32953,1,3,115579,115580,115583,1,4,0
32954,2,3,115581,115583,115586,2,5,0
32955,3,1,115584,115586,115587,2,3,0
32956,3,2,115587,115587,115589,0,2,0
32957,1,2,115588,115589,115591,1,3,0
32958,3,2,115591,115591,115593,0,2,0
32959,4,3,115595,115595,115598,0,3,2
32960,2,2,115597,115598,115600,1,3,0
32961,2,1,115599,115600,115601,1,2,0
32962,6,2,115605,115605,115607,0,2,4
32963,2,2,115607,115607,115609,0,2,0
32964,3,1,115610,115610,115611,0,1,1
32965,2,1,115612,115612,115613,0,1,1
32966,4,1,115616,115616,115617,0,1,3
32967,3,1,115619,115619,115620,0,1,2
32968,5,3,115624,115624,115627,0,3,4
32969,1,3,115625,115627,115630,2,5,0
32970,6,3,115631,115631,115634,0,3,1
32971,5,2,115636,115636,115638,0,2,2
32972,1,2,115637,115638,115640,1,3,0
32973,1,3,115638,115640,115643,2,5,0
32974,2,1,115640,115643,115644,3,4,0
32975,6,1,115646,115646,115647,0,1,2
32976,1,3,115647,115647,115650,0,3,0
32977,1,3,115648,115650,115653,2,5,0
32978,1,2,115649,115653,115655,4,6,0
32979,5,2,115654,115655,115657,1,3,0
32980,3,3,115657,115657,115660,0,3,0
32981,2,3,115659,115660,115663,1,4,0
32982,5,3,115664,115664,115667,0,3,1
32983,2,3,115666,115667,115670,1,4,0
32984,1,2,115667,115670,115672,3,5,0
32985,6,2,115673,115673,115675,0,2,1
32986,1,2,115674,115675,115677,1,3,0
32987,1,3,115675,115677,115680,2,5,0
32988,2,3,115677,115680,115683,3,6,0
32989,5,2,115682,115683,115685,1,3,0
32990,6,2,115688,115688,115690,0,2,3
32991,1,3,115689,115690,115693,1,4,0
32992,6,1,115695,115695,115696,0,1,2
32993,3,1,115698,115698,115699,0,1,2
32994,3,1,115701,115701,115702,0,1,2
32995,5,3,115706,115706,115709,0,3,4
32996,2,3,115708,115709,115712,1,4,0
32997,1,3,115709,115712,115715,3,6,0
32998,5,2,115714,115715,115717,1,3,0
32999,3,1,115717,115717,115718,0,1,0
33000,6,2,115723,115723,115725,0,2,5
33001,3,2,115726,115726,115728,0,2,1
33002,5,1,115731,115731,115732,0,1,3
33003,4,1,115735,115735,115736,0,1,3
33004,6,1,115741,115741,115742,0,1,5
33005,2,3,115743,115743,115746,0,3,1
33006,1,1,115744,115746,115747,2,3,0
33007,1,2,115745,115747,115749,2,4,0
33008,1,1,115746,115749,115750,3,4,0
33009,1,3,115747,115750,115753,3,6,0
33010,4,1,115751,115753,115754,2,3,0
33011,4,1,115755,115755,115756,0,1,1
33012,3,1,115758,115758,115759,0,1,2
33013,6,1,115764,115764,115765,0,1,5
33014,5,2,115769,115769,115771,0,2,4
33015,3,2,115772,115772,115774,0,2,1
33016,6,1,115778,115778,115779,0,1,4
33017,4,1,115782,115782,115783,0,1,3
33018,3,2,115785,115785,115787,0,2,2
33019,5,2,115790,115790,115792,0,2,3
33020,6,1,115796,115796,115797,0,1,4
33021,5,3,115801,115801,115804,0,3,4
33022,3,1,115804,115804,115805,0,1,0
33023,2,1,115806,115806,115807,0,1,1
33024,2,2,115808,115808,115810,0,2,1
33025,5,2,115813,115813,115815,0,2,3
33026,1,1,115814,115815,115816,1,2,0
33027,6,1,115820,115820,115821,0,1,4
33028,2,3,115822,115822,115825,0,3,1
33029,1,3,115823,115825,115828,2,5,0
33030,5,2,115828,115828,115830,0,2,0
33031,2,3,115830,115830,115833,0,3,0
33032,3,3,115833,115833,115836,0,3,0
33033,1,1,115834,115836,115837,2,3,0
33034,3,3,115837,115837,115840,0,3,0
33035,2,1,115839,115840,115841,1,2,0
33036,1,3,115840,115841,115844,1,4,0
33037,4,2,115844,115844,115846,0,2,0
33038,2,2,115846,115846,115848,0,2,0
33039,5,2,115851,115851,115853,0,2,3
33040,2,2,115853,115853,115855,0,2,0
33041,6,3,115859,115859,115862,0,3,4
33042,3,1,115862,115862,115863,0,1,0
33043,5,2,115867,115867,115869,0,2,4
33044,2,3,115869,115869,115872,0,3,0
33045,3,1,115872,115872,115873,0,1,0
33046,3,2,115875,115875,115877,0,2,2
33047,4,1,115879,115879,115880,0,1,2
33048,3,1,115882,115882,115883,0,1,2
33049,5,1,115887,115887,115888,0,1,4
33050,6,2,115893,115893,115895,0,2,5
33051,1,2,115894,115895,115897,1,3,0
33052,6,1,115900,115900,115901,0,1,3
33053,4,2,115904,115904,115906,0,2,3
33054,1,2,115905,115906,115908,1,3,0
33055,6,2,115911,115911,115913,0,2,3
33056,3,2,115914,115914,115916,0,2,1
33057,5,1,115919,115919,115920,0,1,3
33058,3,1,115922,115922,115923,0,1,2
33059,3,2,115925,115925,115927,0,2,2
33060,5,2,115930,115930,115932,0,2,3
33061,4,2,115934,115934,115936,0,2,2
33062,5,3,115939,115939,115942,0,3,3
33063,4,3,115943,115943,115946,0,3,1
33064,6,3,115949,115949,115952,0,3,3
33065,4,1,115953,115953,115954,0,1,1
33066,2,3,115955,115955,115958,0,3,1
33067,6,3,115961,115961,115964,0,3,3
33068,2,3,115963,115964,115967,1,4,0
33069,1,2,115964,115967,115969,3,5,0
33070,1,3,115965,115969,115972,4,7,0
33071,1,1,115966,115972,115973,6,7,0
33072,6,3,115972,115973,115976,1,4,0
33073,2,3,115974,115976,115979,2,5,0
33074,1,1,115975,115979,115980,4,5,0
33075,5,2,115980,115980,115982,0,2,0
33076,4,2,115984,115984,115986,0,2,2
33077,2,2,115986,115986,115988,0,2,0
33078,2,3,115988,115988,115991,0,3,0
33079,2,1,115990,115991,115992,1,2,0
33080,2,1,115992,115992,115993,0,1,0
33081,1,2,115993,115993,115995,0,2,0
33082,6,3,115999,115999,116002,0,3,4
33083,6,3,116005,116005,116008,0,3,3
33084,5,1,116010,116010,116011,0,1,2
33085,5,3,116015,116015,116018,0,3,4
33086,6,3,116021,116021,116024,0,3,3
33087,6,3,116027,116027,116030,0,3,3
33088,6,3,116033,116033,116036,0,3,3
33089,5,1,116038,116038,116039,0,1,2
33090,6,2,116044,116044,116046,0,2,5
33091,3,3,116047,116047,116050,0,3,1
33092,6,3,116053,116053,116056,0,3,3
33093,3,2,116056,116056,116058,0,2,0
33094,4,1,116060,116060,116061,0,1,2
33095,4,1,116064,116064,116065,0,1,3
33096,1,3,116065,116065,116068,0,3,0
33097,2,1,116067,116068,116069,1,2,0
33098,5,2,116072,116072,116074,0,2,3
33099,6,2,116078,116078,116080,0,2,4
33100,4,1,116082,116082,116083,0,1,2
33101,2,3,116084,116084,116087,0,3,1
33102,2,3,116086,116087,116090,1,4,0
33103,5,3,116091,116091,116094,0,3,1
33104,1,1,116092,116094,116095,2,3,0
33105,3,3,116095,116095,116098,0,3,0
33106,2,1,116097,116098,116099,1,2,0
33107,6,1,116103,116103,116104,0,1,4
33108,4,1,116107,116107,116108,0,1,3
33109,3,1,116110,116110,116111,0,1,2
33110,2,2,116112,116112,116114,0,2,1
33111,1,2,116113,116114,116116,1,3,0
33112,2,2,116115,116116,116118,1,3,0
33113,5,1,116120,116120,116121,0,1,2
33114,1,2,116121,116121,116123,0,2,0
33115,6,1,116127,116127,116128,0,1,4
33116,4,2,116131,116131,116133,0,2,3
33117,6,1,116137,116137,116138,0,1,4
33118,4,1,116141,116141,116142,0,1,3
33119,3,2,116144,116144,116146,0,2,2
33120,2,2,116146,116146,116148,0,2,0
33121,4,1,116150,116150,116151,0,1,2
33122,6,3,116156,116156,116159,0,3,5
33123,1,2,116157,116159,116161,2,4,0
33124,3,2,116160,116161,116163,1,3,0
33125,4,3,116164,116164,116167,0,3,1
33126,5,3,116169,116169,116172,0,3,2
33127,5,2,116174,116174,116176,0,2,2
33128,1,1,116175,116176,116177,1,2,0
33129,4,2,116179,116179,116181,0,2,2
33130,1,3,116180,116181,116184,1,4,0
33131,3,3,116183,116184,116187,1,4,0
33132,4,2,116187,116187,116189,0,2,0
33133,5,1,116192,116192,116193,0,1,3
33134,6,2,116198,116198,116200,0,2,5
33135,6,3,116204,116204,116207,0,3,4
33136,4,2,116208,116208,116210,0,2,1
33137,1,1,116209,116210,116211,1,2,0
33138,6,3,116215,116215,116218,0,3,4
33139,4,2,116219,116219,116221,0,2,1
33140,3,3,116222,116222,116225,0,3,1
33141,6,1,116228,116228,116229,0,1,3
33142,5,2,116233,116233,116235,0,2,4
33143,6,3,116239,116239,116242,0,3,4
33144,5,1,116244,116244,116245,0,1,2
33145,3,1,116247,116247,116248,0,1,2
33146,6,1,116253,116253,116254,0,1,5
33147,5,1,116258,116258,116259,0,1,4
33148,4,3,116262,116262,116265,0,3,3
33149,3,3,116265,116265,116268,0,3,0
33150,3,2,116268,116268,116270,0,2,0
33151,4,1,116272,116272,116273,0,1,2
33152,6,2,116278,116278,116280,0,2,5
33153,3,3,116281,116281,116284,0,3,1
33154,5,1,116286,116286,116287,0,1,2
33155,1,3,116287,116287,116290,0,3,0
33156,5,3,116292,116292,116295,0,3,2
33157,2,2,116294,116295,116297,1,3,0
33158,4,1,116298,116298,116299,0,1,1
33159,1,2,116299,116299,116301,0,2,0
33160,3,3,116302,116302,116305,0,3,1
33161,2,1,116304,116305,116306,1,2,0
33162,5,2,116309,116309,116311,0,2,3
33163,5,1,116314,116314,116315,0,1,3
33164,2,2,116316,116316,116318,0,2,1
33165,6,2,116322,116322,116324,0,2,4
33166,1,3,116323,116324,116327,1,4,0
33167,1,3,116324,116327,116330,3,6,0
33168,5,2,116329,116330,116332,1,3,0
33169,6,2,116335,116335,116337,0,2,3
33170,6,1,116341,116341,116342,0,1,4
33171,4,2,116345,116345,116347,0,2,3
33172,2,2,116347,116347,116349,0,2,0
33173,6,1,116353,116353,116354,0,1,4
33174,4,3,116357,116357,116360,0,3,3
33175,3,2,116360,116360,116362,0,2,0
33176,1,1,116361,116362,116363,1,2,0
33177,1,1,116362,116363,116364,1,2,0
33178,3,1,116365,116365,116366,0,1,1
33179,2,3,116367,116367,116370,0,3,1
33180,1,1,116368,116370,116371,2,3,0
33181,4,2,116372,116372,116374,0,2,1
33182,1,1,116373,116374,116375,1,2,0
33183,1,3,116374,116375,116378,1,4,0
33184,4,3,116378,116378,116381,0,3,0
33185,2,2,116380,116381,116383,1,3,0
33186,3,1,116383,116383,116384,0,1,0
33187,5,1,116388,116388,116389,0,1,4
33188,3,1,116391,116391,116392,0,1,2
33189,6,2,116397,116397,116399,0,2,5
33190,2,1,116399,116399,116400,0,1,0
33191,6,2,116405,116405,116407,0,2,5
33192,6,1,116411,116411,116412,0,1,4
33193,3,3,116414,116414,116417,0,3,2
33194,1,3,116415,116417,116420,2,5,0
33195,4,2,116419,116420,116422,1,3,0
33196,5,3,116424,116424,116427,0,3,2
33197,3,2,116427,116427,116429,0,2,0
33198,6,2,116433,116433,116435,0,2,4
33199,2,1,116435,116435,116436,0,1,0
33200,2,1,116437,116437,116438,0,1,1
33201,5,3,116442,116442,116445,0,3,4
33202,2,3,116444,116445,116448,1,4,0
33203,4,3,116448,116448,116451,0,3,0
33204,5,2,116453,116453,116455,0,2,2
33205,3,1,116456,116456,116457,0,1,1
33206,1,3,116457,116457,116460,0,3,0
33207,6,3,116463,116463,116466,0,3,3
33208,3,3,116466,116466,116469,0,3,0
33209,1,3,116467,116469,116472,2,5,0
33210,6,2,116473,116473,116475,0,2,1
33211,6,3,116479,116479,116482,0,3,4
33212,3,3,116482,116482,116485,0,3,0
33213,5,1,116487,116487,116488,0,1,2
33214,1,2,116488,116488,116490,0,2,0
33215,3,2,116491,116491,116493,0,2,1
33216,6,2,116497,116497,116499,0,2,4
33217,1,1,116498,116499,116500,1,2,0
33218,1,3,116499,116500,116503,1,4,0
33219,5,2,116504,116504,116506,0,2,1
33220,3,2,116507,116507,116509,0,2,1
33221,2,3,116509,116509,116512,0,3,0
33222,3,3,116512,116512,116515,0,3,0
33223,3,1,116515,116515,116516,0,1,0
33224,4,1,116519,116519,116520,0,1,3
33225,4,1,116523,116523,116524,0,1,3
33226,3,3,116526,116526,116529,0,3,2
33227,4,3,116530,116530,116533,0,3,1
33228,3,2,116533,116533,116535,0,2,0
33229,4,3,116537,116537,116540,0,3,2
33230,5,2,116542,116542,116544,0,2,2
33231,4,1,116546,116546,116547,0,1,2
33232,6,3,116552,116552,116555,0,3,5
33233,1,1,116553,116555,116556,2,3,0
33234,5,3,116558,116558,116561,0,3,2
33235,1,2,116559,116561,116563,2,4,0
33236,1,3,116560,116563,116566,3,6,0
33237,2,2,116562,116566,116568,4,6,0
33238,1,1,116563,116568,116569,5,6,0
33239,6,1,116569,116569,116570,0,1,0
33240,4,1,116573,116573,116574,0,1,3
33241,3,1,116576,116576,116577,0,1,2
33242,6,3,116582,116582,116585,0,3,5
33243,6,3,116588,116588,116591,0,3,3
33244,4,2,116592,116592,116594,0,2,1
33245,3,1,116595,116595,116596,0,1,1
33246,4,2,116599,116599,116601,0,2,3
33247,1,2,116600,116601,116603,1,3,0
33248,2,2,116602,116603,116605,1,3,0
33249,3,2,116605,116605,116607,0,2,0
33250,2,2,116607,116607,116609,0,2,0
33251,2,2,116609,116609,116611,0,2,0
33252,2,1,116611,116611,116612,0,1,0
33253,6,3,116617,116617,116620,0,3,5
33254,2,3,116619,116620,116623,1,4,0
33255,1,3,116620,116623,116626,3,6,0
33256,6,1,116626,116626,116627,0,1,0
33257,4,2,116630,116630,116632,0,2,3
33258,1,3,116631,116632,116635,1,4,0
33259,4,2,116635,116635,116637,0,2,0
33260,5,2,116640,116640,116642,0,2,3
33261,1,2,116641,116642,116644,1,3,0
33262,5,1,116646,116646,116647,0,1,2
33263,6,2,116652,116652,116654,0,2,5
33264,2,1,116654,116654,116655,0,1,0
33265,3,3,116657,116657,116660,0,3,2
33266,3,2,116660,116660,116662,0,2,0
33267,4,2,116664,116664,116666,0,2,2
33268,5,3,116669,116669,116672,0,3,3
33269,6,1,116675,116675,116676,0,1,3
33270,5,2,116680,116680,116682,0,2,4
33271,2,3,116682,116682,116685,0,3,0
33272,6,3,116688,116688,116691,0,3,3
33273,3,3,116691,116691,116694,0,3,0
33274,3,1,116694,116694,116695,0,1,0
33275,6,2,116700,116700,116702,0,2,5
33276,5,3,116705,116705,116708,0,3,3
33277,4,1,116709,116709,116710,0,1,1
33278,3,1,116712,116712,116713,0,1,2
33279,1,1,116713,116713,116714,0,1,0
33280,6,3,116719,116719,116722,0,3,5
33281,4,2,116723,116723,116725,0,2,1
33282,3,1,116726,116726,116727,0,1,1
33283,6,2,116732,116732,116734,0,2,5
33284,2,1,116734,116734,116735,0,1,0
33285,1,2,116735,116735,116737,0,2,0
33286,4,2,116739,116739,116741,0,2,2
33287,2,1,116741,116741,116742,0,1,0
33288,2,2,116743,116743,116745,0,2,1
33289,5,2,116748,116748,116750,0,2,3
33290,1,2,116749,116750,116752,1,3,0
33291,5,2,116754,116754,116756,0,2,2
33292,4,1,116758,116758,116759,0,1,2
33293,3,1,116761,116761,116762,0,1,2
33294,6,3,116767,116767,116770,0,3,5
33295,6,3,116773,116773,116776,0,3,3
33296,2,3,116775,116776,116779,1,4,0
33297,2,3,116777,116779,116782,2,5,0
33298,6,2,116783,116783,116785,0,2,1
33299,2,1,116785,116785,116786,0,1,0
33300,2,1,116787,116787,116788,0,1,1
33301,1,3,116788,116788,116791,0,3,0
33302,3,1,116791,116791,116792,0,1,0
33303,4,2,116795,116795,116797,0,2,3
33304,1,2,116796,116797,116799,1,3,0
33305,5,1,116801,116801,116802,0,1,2
33306,6,3,116807,116807,116810,0,3,5
33307,2,3,116809,116810,116813,1,4,0
33308,5,1,116814,116814,116815,0,1,1
33309,6,1,116820,116820,116821,0,1,5
33310,2,2,116822,116822,116824,0,2,1
33311,3,3,116825,116825,116828,0,3,1
33312,3,3,116828,116828,116831,0,3,0
33313,2,1,116830,116831,116832,1,2,0
33314,1,2,116831,116832,116834,1,3,0
33315,5,3,116836,116836,116839,0,3,2
33316,2,3,116838,116839,116842,1,4,0
33317,6,3,116844,116844,116847,0,3,2
33318,3,3,116847,116847,116850,0,3,0
33319,1,1,116848,116850,116851,2,3,0
33320,5,1,116853,116853,116854,0,1,2
33321,4,1,116857,116857,116858,0,1,3
33322,4,1,116861,116861,116862,0,1,3
33323,3,2,116864,116864,116866,0,2,2
33324,1,2,116865,116866,116868,1,3,0
33325,5,1,116870,116870,116871,0,1,2
33326,2,1,116872,116872,116873,0,1,1
33327,6,3,116878,116878,116881,0,3,5
33328,6,2,116884,116884,116886,0,2,3
33329,1,1,116885,116886,116887,1,2,0
33330,6,2,116891,116891,116893,0,2,4
33331,5,1,116896,116896,116897,0,1,3
33332,4,1,116900,116900,116901,0,1,3
33333,6,2,116906,116906,116908,0,2,5
33334,3,3,116909,116909,116912,0,3,1
33335,2,1,116911,116912,116913,1,2,0
33336,4,3,116915,116915,116918,0,3,2
33337,1,3,116916,116918,116921,2,5,0
33338,4,2,116920,116921,116923,1,3,0
33339,2,2,116922,116923,116925,1,3,0
33340,3,1,116925,116925,116926,0,1,0
33341,2,2,116927,116927,116929,0,2,1
33342,2,2,116929,116929,116931,0,2,0
33343,2,3,116931,116931,116934,0,3,0
33344,2,3,116933,116934,116937,1,4,0
33345,1,3,116934,116937,116940,3,6,0
33346,1,1,116935,116940,116941,5,6,0
33347,6,1,116941,116941,116942,0,1,0
33348,2,2,116943,116943,116945,0,2,1
33349,5,2,116948,116948,116950,0,2,3
33350,3,1,116951,116951,116952,0,1,1
33351,6,3,116957,116957,116960,0,3,5
33352,6,3,116963,116963,116966,0,3,3
33353,4,2,116967,116967,116969,0,2,1
33354,4,3,116971,116971,116974,0,3,2
33355,1,1,116972,116974,116975,2,3,0
33356,6,2,116978,116978,116980,0,2,3
33357,6,3,116984,116984,116987,0,3,4
33358,4,2,116988,116988,116990,0,2,1
33359,2,3,116990,116990,116993,0,3,0
33360,5,3,116995,116995,116998,0,3,2
33361,2,3,116997,116998,117001,1,4,0
33362,1,2,116998,117001,117003,3,5,0
33363,5,2,117003,117003,117005,0,2,0
33364,5,1,117008,117008,117009,0,1,3
33365,3,1,117011,117011,117012,0,1,2
33366,5,2,117016,117016,117018,0,2,4
33367,4,3,117020,117020,117023,0,3,2
33368,5,2,117025,117025,117027,0,2,2
33369,6,2,117031,117031,117033,0,2,4
33370,4,3,117035,117035,117038,0,3,2
33371,1,3,117036,117038,117041,2,5,0
33372,4,1,117040,117041,117042,1,2,0
33373,2,2,117042,117042,117044,0,2,0
33374,5,1,117047,117047,117048,0,1,3
33375,3,3,117050,117050,117053,0,3,2
33376,3,1,117053,117053,117054,0,1,0
33377,2,3,117055,117055,117058,0,3,1
33378,5,2,117060,117060,117062,0,2,2
33379,4,1,117064,117064,117065,0,1,2
33380,6,3,117070,117070,117073,0,3,5
33381,1,3,117071,117073,117076,2,5,0
33382,3,3,117074,117076,117079,2,5,0
33383,1,3,117075,117079,117082,4,7,0
33384,1,3,117076,117082,117085,6,9,0
33385,5,2,117081,117085,117087,4,6,0
33386,6,2,117087,117087,117089,0,2,0
33387,5,1,117092,117092,117093,0,1,3
33388,2,2,117094,117094,117096,0,2,1
33389,2,2,117096,117096,117098,0,2,0
33390,4,2,117100,117100,117102,0,2,2
33391,2,2,117102,117102,117104,0,2,0
33392,5,2,117107,117107,117109,0,2,3
33393,2,1,117109,117109,117110,0,1,0
33394,1,1,117110,117110,117111,0,1,0
33395,6,3,117116,117116,117119,0,3,5
33396,3,2,117119,117119,117121,0,2,0
33397,6,3,117125,117125,117128,0,3,4
33398,3,1,117128,117128,117129,0,1,0
33399,1,1,117129,117129,117130,0,1,0
33400,5,2,117134,117134,117136,0,2,4
33401,2,1,117136,117136,117137,0,1,0
33402,4,1,117140,117140,117141,0,1,3
33403,1,1,117141,117141,117142,0,1,0
33404,6,2,117147,117147,117149,0,2,5
33405,5,1,117152,117152,117153,0,1,3
33406,1,2,117153,117153,117155,0,2,0
33407,5,1,117158,117158,117159,0,1,3
33408,1,1,117159,117159,117160,0,1,0
33409,4,1,117163,117163,117164,0,1,3
33410,4,3,117167,117167,117170,0,3,3
33411,2,1,117169,117170,117171,1,2,0
33412,3,2,117172,117172,117174,0,2,1
33413,3,3,117175,117175,117178,0,3,1
33414,2,1,117177,117178,117179,1,2,0
33415,6,2,117183,117183,117185,0,2,4
33416,2,1,117185,117185,117186,0,1,0
33417,3,3,117188,117188,117191,0,3,2
33418,4,3,117192,117192,117195,0,3,1
33419,6,2,117198,117198,117200,0,2,3
33420,6,1,117204,117204,117205,0,1,4
33421,3,1,117207,117207,117208,0,1,2
33422,6,1,117213,117213,117214,0,1,5
33423,3,1,117216,117216,117217,0,1,2
33424,3,3,117219,117219,117222,0,3,2
33425,5,3,117224,117224,117227,0,3,2
33426,4,1,117228,117228,117229,0,1,1
33427,3,1,117231,117231,117232,0,1,2
33428,5,3,117236,117236,117239,0,3,4
33429,5,3,117241,117241,117244,0,3,2
33430,6,3,117247,117247,117250,0,3,3
33431,2,3,117249,117250,117253,1,4,0
33432,4,1,117253,117253,117254,0,1,0
33433,1,2,117254,117254,117256,0,2,0
33434,6,2,117260,117260,117262,0,2,4
33435,1,2,117261,117262,117264,1,3,0
33436,4,3,117265,117265,117268,0,3,1
33437,1,3,117266,117268,117271,2,5,0
33438,6,1,117272,117272,117273,0,1,1
33439,2,1,117274,117274,117275,0,1,1
33440,3,1,117277,117277,117278,0,1,2
33441,4,2,117281,117281,117283,0,2,3
33442,5,1,117286,117286,117287,0,1,3
33443,4,3,117290,117290,117293,0,3,3
33444,6,1,117296,117296,117297,0,1,3
33445,1,2,117297,117297,117299,0,2,0
33446,1,2,117298,117299,117301,1,3,0
33447,5,2,117303,117303,117305,0,2,2
33448,4,3,117307,117307,117310,0,3,2
33449,2,2,117309,117310,117312,1,3,0
33450,5,2,117314,117314,117316,0,2,2
33451,1,1,117315,117316,117317,1,2,0
33452,5,1,117320,117320,117321,0,1,3
33453,2,1,117322,117322,117323,0,1,1
33454,6,1,117328,117328,117329,0,1,5
33455,3,3,117331,117331,117334,0,3,2
33456,5,2,117336,117336,117338,0,2,2
33457,4,3,117340,117340,117343,0,3,2
33458,4,3,117344,117344,117347,0,3,1
33459,5,1,117349,117349,117350,0,1,2
33460,6,2,117355,117355,117357,0,2,5
33461,3,2,117358,117358,117360,0,2,1
33462,2,2,117360,117360,117362,0,2,0
33463,5,3,117365,117365,117368,0,3,3
33464,2,1,117367,117368,117369,1,2,0
33465,4,3,117371,117371,117374,0,3,2
33466,6,1,117377,117377,117378,0,1,3
33467,6,3,117383,117383,117386,0,3,5
33468,3,3,117386,117386,117389,0,3,0
33469,6,2,117392,117392,117394,0,2,3
33470,1,3,117393,117394,117397,1,4,0
33471,3,3,117396,117397,117400,1,4,0
33472,6,1,117402,117402,117403,0,1,2
33473,3,1,117405,117405,117406,0,1,2
33474,5,3,117410,117410,117413,0,3,4
33475,5,1,117415,117415,117416,0,1,2
33476,3,1,117418,117418,117419,0,1,2
33477,5,3,117423,117423,117426,0,3,4
33478,2,1,117425,117426,117427,1,2,0
33479,1,2,117426,117427,117429,1,3,0
33480,3,3,117429,117429,117432,0,3,0
33481,5,2,117434,117434,117436,0,2,2
33482,3,1,117437,117437,117438,0,1,1
33483,5,1,117442,117442,117443,0,1,4
33484,6,2,117448,117448,117450,0,2,5
33485,2,1,117450,117450,117451,0,1,0
33486,5,2,117455,117455,117457,0,2,4
33487,5,3,117460,117460,117463,0,3,3
33488,6,1,117466,117466,117467,0,1,3
33489,5,3,117471,117471,117474,0,3,4
33490,6,3,117477,117477,117480,0,3,3
33491,4,3,117481,117481,117484,0,3,1
33492,1,2,117482,117484,117486,2,4,0
33493,5,2,117487,117487,117489,0,2,1
33494,5,2,117492,117492,117494,0,2,3
33495,3,2,117495,117495,117497,0,2,1
33496,1,2,117496,117497,117499,1,3,0
33497,2,2,117498,117499,117501,1,3,0
33498,1,2,117499,117501,117503,2,4,0
33499,3,2,117502,117503,117505,1,3,0
33500,2,1,117504,117505,117506,1,2,0
33501,1,3,117505,117506,117509,1,4,0
33502,4,2,117509,117509,117511,0,2,0
33503,3,1,117512,117512,117513,0,1,1
33504,6,1,117518,117518,117519,0,1,5
33505,1,2,117519,117519,117521,0,2,0
33506,1,3,117520,117521,117524,1,4,0
33507,4,3,117524,117524,117527,0,3,0
33508,2,2,117526,117527,117529,1,3,0
33509,2,3,117528,117529,117532,1,4,0
33510,3,2,117531,117532,117534,1,3,0
33511,3,1,117534,117534,117535,0,1,0
33512,1,2,117535,117535,117537,0,2,0
33513,4,1,117539,117539,117540,0,1,2
33514,1,3,117540,117540,117543,0,3,0
33515,6,2,117546,117546,117548,0,2,3
33516,5,3,117551,117551,117554,0,3,3
33517,2,1,117553,117554,117555,1,2,0
33518,3,3,117556,117556,117559,0,3,1
33519,2,1,117558,117559,117560,1,2,0
33520,4,1,117562,117562,117563,0,1,2
33521,3,3,117565,117565,117568,0,3,2
33522,5,2,117570,117570,117572,0,2,2
33523,2,3,117572,117572,117575,0,3,0
33524,2,1,117574,117575,117576,1,2,0
33525,2,1,117576,117576,117577,0,1,0
33526,3,1,117579,117579,117580,0,1,2
33527,5,1,117584,117584,117585,0,1,4
33528,1,3,117585,117585,117588,0,3,0
33529,4,2,117589,117589,117591,0,2,1
33530,2,3,117591,117591,117594,0,3,0
33531,4,1,117595,117595,117596,0,1,1
33532,4,1,117599,117599,117600,0,1,3
33533,2,3,117601,117601,117604,0,3,1
33534,4,3,117605,117605,117608,0,3,1
33535,1,1,117606,117608,117609,2,3,0
33536,5,2,117611,117611,117613,0,2,2
33537,3,1,117614,117614,117615,0,1,1
33538,6,3,117620,117620,117623,0,3,5
33539,4,3,117624,117624,117627,0,3,1
33540,1,1,117625,117627,117628,2,3,0
33541,6,2,117631,117631,117633,0,2,3
33542,3,1,117634,117634,117635,0,1,1
33543,6,2,117640,117640,117642,0,2,5
33544,1,1,117641,117642,117643,1,2,0
33545,4,1,117645,117645,117646,0,1,2
33546,5,1,117650,117650,117651,0,1,4
33547,6,1,117656,117656,117657,0,1,5
33548,1,2,117657,117657,117659,0,2,0
33549,5,1,117662,117662,117663,0,1,3
33550,3,2,117665,117665,117667,0,2,2
33551,4,2,117669,117669,117671,0,2,2
33552,4,3,117673,117673,117676,0,3,2
33553,5,3,117678,117678,117681,0,3,2
33554,1,2,117679,117681,117683,2,4,0
33555,5,3,117684,117684,117687,0,3,1
33556,5,3,117689,117689,117692,0,3,2
33557,6,2,117695,117695,117697,0,2,3
33558,6,3,117701,117701,117704,0,3,4
33559,2,2,117703,117704,117706,1,3,0
33560,4,2,117707,117707,117709,0,2,1
33561,1,2,117708,117709,117711,1,3,0
33562,3,3,117711,117711,117714,0,3,0
33563,4,1,117715,117715,117716,0,1,1
33564,5,3,117720,117720,117723,0,3,4
33565,5,1,117725,117725,117726,0,1,2
33566,4,3,117729,117729,117732,0,3,3
33567,6,2,117735,117735,117737,0,2,3
33568,4,2,117739,117739,117741,0,2,2
33569,3,2,117742,117742,117744,0,2,1
33570,6,3,117748,117748,117751,0,3,4
33571,4,2,117752,117752,117754,0,2,1
33572,1,1,117753,117754,117755,1,2,0
33573,1,2,117754,117755,117757,1,3,0
33574,6,3,117760,117760,117763,0,3,3
33575,4,3,117764,117764,117767,0,3,1
33576,5,2,117769,117769,117771,0,2,2
33577,5,1,117774,117774,117775,0,1,3
33578,1,1,117775,117775,117776,0,1,0
33579,6,2,117781,117781,117783,0,2,5
33580,2,1,117783,117783,117784,0,1,0
33581,6,3,117789,117789,117792,0,3,5
33582,5,3,117794,117794,117797,0,3,2
33583,5,1,117799,117799,117800,0,1,2
33584,6,3,117805,117805,117808,0,3,5
33585,4,2,117809,117809,117811,0,2,1
33586,5,3,117814,117814,117817,0,3,3
33587,2,1,117816,117817,117818,1,2,0
33588,5,2,117821,117821,117823,0,2,3
33589,2,2,117823,117823,117825,0,2,0
33590,6,3,117829,117829,117832,0,3,4
33591,3,1,117832,117832,117833,0,1,0
33592,1,1,117833,117833,117834,0,1,0
33593,5,3,117838,117838,117841,0,3,4
33594,5,3,117843,117843,117846,0,3,2
33595,5,1,117848,117848,117849,0,1,2
33596,3,1,117851,117851,117852,0,1,2
33597,1,3,117852,117852,117855,0,3,0
33598,5,3,117857,117857,117860,0,3,2
33599,2,3,117859,117860,117863,1,4,0
33600,3,2,117862,117863,117865,1,3,0
33601,1,2,117863,117865,117867,2,4,0
33602,1,2,117864,117867,117869,3,5,0
33603,3,2,117867,117869,117871,2,4,0
33604,2,3,117869,117871,117874,2,5,0
33605,6,1,117875,117875,117876,0,1,1
33606,2,2,117877,117877,117879,0,2,1
33607,4,1,117881,117881,117882,0,1,2
33608,5,2,117886,117886,117888,0,2,4
33609,3,1,117889,117889,117890,0,1,1
33610,4,1,117893,117893,117894,0,1,3
33611,2,1,117895,117895,117896,0,1,1
33612,2,1,117897,117897,117898,0,1,1
33613,2,1,117899,117899,117900,0,1,1
33614,1,3,117900,117900,117903,0,3,0
33615,2,1,117902,117903,117904,1,2,0
33616,1,2,117903,117904,117906,1,3,0
33617,2,2,117905,117906,117908,1,3,0
33618,5,2,117910,117910,117912,0,2,2
33619,6,1,117916,117916,117917,0,1,4
33620,5,1,117921,117921,117922,0,1,4
33621,1,3,117922,117922,117925,0,3,0
33622,5,1,117927,117927,117928,0,1,2
33623,4,1,117931,117931,117932,0,1,3
33624,2,2,117933,117933,117935,0,2,1
33625,6,1,117939,117939,117940,0,1,4
33626,1,3,117940,117940,117943,0,3,0
33627,5,2,117945,117945,117947,0,2,2
33628,2,3,117947,117947,117950,0,3,0
33629,4,2,117951,117951,117953,0,2,1
33630,5,2,117956,117956,117958,0,2,3
33631,1,1,117957,117958,117959,1,2,0
33632,6,2,117963,117963,117965,0,2,4
33633,2,2,117965,117965,117967,0,2,0
33634,5,1,117970,117970,117971,0,1,3
33635,5,2,117975,117975,117977,0,2,4
33636,4,1,117979,117979,117980,0,1,2
33637,4,3,117983,117983,117986,0,3,3
33638,3,2,117986,117986,117988,0,2,0
33639,6,1,117992,117992,117993,0,1,4
33640,6,3,117998,117998,118001,0,3,5
33641,4,2,118002,118002,118004,0,2,1
33642,6,3,118008,118008,118011,0,3,4
33643,4,3,118012,118012,118015,0,3,1
33644,5,3,118017,118017,118020,0,3,2
33645,4,2,118021,118021,118023,0,2,1
33646,5,3,118026,118026,118029,0,3,3
33647,5,3,118031,118031,118034,0,3,2
33648,1,3,118032,118034,118037,2,5,0
33649,1,1,118033,118037,118038,4,5,0
33650,5,3,118038,118038,118041,0,3,0
33651,6,1,118044,118044,118045,0,1,3
33652,3,2,118047,118047,118049,0,2,2
33653,3,3,118050,118050,118053,0,3,1
33654,5,3,118055,118055,118058,0,3,2
33655,4,3,118059,118059,118062,0,3,1
33656,3,3,118062,118062,118065,0,3,0
33657,2,2,118064,118065,118067,1,3,0
33658,4,3,118068,118068,118071,0,3,1
33659,5,3,118073,118073,118076,0,3,2
33660,4,1,118077,118077,118078,0,1,1
33661,1,1,118078,118078,118079,0,1,0
33662,1,2,118079,118079,118081,0,2,0
33663,5,3,118084,118084,118087,0,3,3
33664,1,3,118085,118087,118090,2,5,0
33665,1,2,118086,118090,118092,4,6,0
33666,3,3,118089,118092,118095,3,6,0
33667,4,2,118093,118095,118097,2,4,0
33668,4,1,118097,118097,118098,0,1,0
33669,6,2,118103,118103,118105,0,2,5
33670,4,1,118107,118107,118108,0,1,2
33671,6,3,118113,118113,118116,0,3,5
33672,5,2,118118,118118,118120,0,2,2
33673,6,1,118124,118124,118125,0,1,4
33674,1,1,118125,118125,118126,0,1,0
33675,4,3,118129,118129,118132,0,3,3
33676,4,2,118133,118133,118135,0,2,1
33677,6,1,118139,118139,118140,0,1,4
33678,4,3,118143,118143,118146,0,3,3
33679,3,3,118146,118146,118149,0,3,0
33680,5,3,118151,118151,118154,0,3,2
33681,1,2,118152,118154,118156,2,4,0
33682,6,1,118158,118158,118159,0,1,2
33683,2,3,118160,118160,118163,0,3,1
33684,6,3,118166,118166,118169,0,3,3
33685,3,1,118169,118169,118170,0,1,0
33686,6,1,118175,118175,118176,0,1,5
33687,3,3,118178,118178,118181,0,3,2
33688,4,2,118182,118182,118184,0,2,1
33689,1,1,118183,118184,118185,1,2,0
33690,1,3,118184,118185,118188,1,4,0
33691,5,1,118189,118189,118190,0,1,1
33692,5,2,118194,118194,118196,0,2,4
33693,6,1,118200,118200,118201,0,1,4
33694,4,3,118204,118204,118207,0,3,3
33695,6,3,118210,118210,118213,0,3,3
33696,1,1,118211,118213,118214,2,3,0
33697,2,3,118213,118214,118217,1,4,0
33698,2,3,118215,118217,118220,2,5,0
33699,6,2,118221,118221,118223,0,2,1
33700,4,2,118225,118225,118227,0,2,2
33701,3,2,118228,118228,118230,0,2,1
33702,4,2,118232,118232,118234,0,2,2
33703,6,2,118238,118238,118240,0,2,4
33704,4,2,118242,118242,118244,0,2,2
33705,5,3,118247,118247,118250,0,3,3
33706,1,2,118248,118250,118252,2,4,0
33707,2,2,118250,118252,118254,2,4,0
33708,2,1,118252,118254,118255,2,3,0
33709,2,2,118254,118255,118257,1,3,0
33710,6,3,118260,118260,118263,0,3,3
33711,1,3,118261,118263,118266,2,5,0
33712,1,3,118262,118266,118269,4,7,0
33713,1,2,118263,118269,118271,6,8,0
33714,2,2,118265,118271,118273,6,8,0
33715,2,1,118267,118273,118274,6,7,0
33716,1,2,118268,118274,118276,6,8,0
33717,4,2,118272,118276,118278,4,6,0
33718,1,2,118273,118278,118280,5,7,0
33719,4,1,118277,118280,118281,3,4,0
33720,6,1,118283,118283,118284,0,1,2
33721,6,2,118289,118289,118291,0,2,5
33722,6,2,118295,118295,118297,0,2,4
33723,5,1,118300,118300,118301,0,1,3
33724,3,3,118303,118303,118306,0,3,2
33725,6,3,118309,118309,118312,0,3,3
33726,2,3,118311,118312,118315,1,4,0
33727,5,1,118316,118316,118317,0,1,1
33728,1,1,118317,118317,118318,0,1,0
33729,6,3,118323,118323,118326,0,3,5
33730,4,2,118327,118327,118329,0,2,1
33731,5,3,118332,118332,118335,0,3,3
33732,1,2,118333,118335,118337,2,4,0
33733,5,3,118338,118338,118341,0,3,1
33734,5,1,118343,118343,118344,0,1,2
33735,6,3,118349,118349,118352,0,3,5
33736,5,3,118354,118354,118357,0,3,2
33737,1,3,118355,118357,118360,2,5,0
33738,4,3,118359,118360,118363,1,4,0
33739,4,1,118363,118363,118364,0,1,0
33740,2,3,118365,118365,118368,0,3,1
33741,3,1,118368,118368,118369,0,1,0
33742,5,3,118373,118373,118376,0,3,4
33743,2,3,118375,118376,118379,1,4,0
33744,6,3,118381,118381,118384,0,3,2
33745,4,2,118385,118385,118387,0,2,1
33746,1,3,118386,118387,118390,1,4,0
33747,3,3,118389,118390,118393,1,4,0
33748,3,3,118392,118393,118396,1,4,0
33749,6,2,118398,118398,118400,0,2,2
33750,1,2,118399,118400,118402,1,3,0
33751,4,3,118403,118403,118406,0,3,1
33752,3,2,118406,118406,118408,0,2,0
33753,1,1,118407,118408,118409,1,2,0
33754,2,2,118409,118409,118411,0,2,0
33755,5,1,118414,118414,118415,0,1,3
33756,2,3,118416,118416,118419,0,3,1
33757,6,3,118422,118422,118425,0,3,3
33758,5,2,118427,118427,118429,0,2,2
33759,1,1,118428,118429,118430,1,2,0
33760,2,2,118430,118430,118432,0,2,0
33761,5,2,118435,118435,118437,0,2,3
33762,6,3,118441,118441,118444,0,3,4
33763,1,3,118442,118444,118447,2,5,0
33764,5,3,118447,118447,118450,0,3,0
33765,4,3,118451,118451,118454,0,3,1
33766,3,3,118454,118454,118457,0,3,0
33767,4,3,118458,118458,118461,0,3,1
33768,6,1,118464,118464,118465,0,1,3
33769,3,1,118467,118467,118468,0,1,2
33770,2,1,118469,118469,118470,0,1,1
33771,6,2,118475,118475,118477,0,2,5
33772,1,2,118476,118477,118479,1,3,0
33773,3,1,118479,118479,118480,0,1,0
33774,2,1,118481,118481,118482,0,1,1
33775,5,1,118486,118486,118487,0,1,4
33776,3,3,118489,118489,118492,0,3,2
33777,3,3,118492,118492,118495,0,3,0
33778,4,3,118496,118496,118499,0,3,1
33779,6,3,118502,118502,118505,0,3,3
33780,3,1,118505,118505,118506,0,1,0
33781,3,3,118508,118508,118511,0,3,2
33782,5,3,118513,118513,118516,0,3,2
33783,4,3,118517,118517,118520,0,3,1
33784,4,2,118521,118521,118523,0,2,1
33785,1,1,118522,118523,118524,1,2,0
33786,3,2,118525,118525,118527,0,2,1
33787,2,2,118527,118527,118529,0,2,0
33788,4,2,118531,118531,118533,0,2,2
33789,5,2,118536,118536,118538,0,2,3
33790,4,1,118540,118540,118541,0,1,2
33791,5,1,118545,118545,118546,0,1,4
33792,6,2,118551,118551,118553,0,2,5
33793,4,3,118555,118555,118558,0,3,2
33794,3,2,118558,118558,118560,0,2,0
33795,1,1,118559,118560,118561,1,2,0
33796,4,1,118563,118563,118564,0,1,2
33797,4,3,118567,118567,118570,0,3,3
33798,1,3,118568,118570,118573,2,5,0
33799,5,3,118573,118573,118576,0,3,0
33800,5,2,118578,118578,118580,0,2,2
33801,6,2,118584,118584,118586,0,2,4
33802,1,3,118585,118586,118589,1,4,0
33803,2,3,118587,118589,118592,2,5,0
33804,4,2,118591,118592,118594,1,3,0
33805,3,1,118594,118594,118595,0,1,0
33806,3,3,118597,118597,118600,0,3,2
33807,2,3,118599,118600,118603,1,4,0
33808,1,3,118600,118603,118606,3,6,0
33809,3,1,118603,118606,118607,3,4,0
33810,4,1,118607,118607,118608,0,1,0
33811,6,3,118613,118613,118616,0,3,5
33812,6,3,118619,118619,118622,0,3,3
33813,2,1,118621,118622,118623,1,2,0
33814,5,1,118626,118626,118627,0,1,3
33815,6,3,118632,118632,118635,0,3,5
33816,3,1,118635,118635,118636,0,1,0
33817,4,3,118639,118639,118642,0,3,3
33818,4,2,118643,118643,118645,0,2,1
33819,1,1,118644,118645,118646,1,2,0
33820,1,1,118645,118646,118647,1,2,0
33821,4,2,118649,118649,118651,0,2,2
33822,1,3,118650,118651,118654,1,4,0
33823,2,1,118652,118654,118655,2,3,0
33824,6,1,118658,118658,118659,0,1,3
33825,3,2,118661,118661,118663,0,2,2
33826,2,1,118663,118663,118664,0,1,0
33827,2,2,118665,118665,118667,0,2,1
33828,4,1,118669,118669,118670,0,1,2
33829,2,2,118671,118671,118673,0,2,1
33830,2,3,118673,118673,118676,0,3,0
33831,5,3,118678,118678,118681,0,3,2
33832,5,2,118683,118683,118685,0,2,2
33833,4,3,118687,118687,118690,0,3,2
33834,4,2,118691,118691,118693,0,2,1
33835,1,2,118692,118693,118695,1,3,0
33836,2,2,118694,118695,118697,1,3,0
33837,5,2,118699,118699,118701,0,2,2
33838,2,2,118701,118701,118703,0,2,0
33839,6,2,118707,118707,118709,0,2,4
33840,3,1,118710,118710,118711,0,1,1
33841,1,1,118711,118711,118712,0,1,0
33842,3,3,118714,118714,118717,0,3,2
33843,1,3,118715,118717,118720,2,5,0
33844,5,2,118720,118720,118722,0,2,0
33845,3,3,118723,118723,118726,0,3,1
33846,5,2,118728,118728,118730,0,2,2
33847,4,2,118732,118732,118734,0,2,2
33848,4,2,118736,118736,118738,0,2,2
33849,5,2,118741,118741,118743,0,2,3
33850,4,1,118745,118745,118746,0,1,2
33851,1,3,118746,118746,118749,0,3,0
33852,4,3,118750,118750,118753,0,3,1
33853,2,3,118752,118753,118756,1,4,0
33854,2,3,118754,118756,118759,2,5,0
33855,3,3,118757,118759,118762,2,5,0
33856,3,2,118760,118762,118764,2,4,0
33857,2,2,118762,118764,118766,2,4,0
33858,6,2,118768,118768,118770,0,2,2
33859,3,2,118771,118771,118773,0,2,1
33860,5,3,118776,118776,118779,0,3,3
33861,5,2,118781,118781,118783,0,2,2
33862,5,1,118786,118786,118787,0,1,3
33863,1,1,118787,118787,118788,0,1,0
33864,6,3,118793,118793,118796,0,3,5
33865,2,2,118795,118796,118798,1,3,0
33866,1,1,118796,118798,118799,2,3,0
33867,3,3,118799,118799,118802,0,3,0
33868,2,3,118801,118802,118805,1,4,0
33869,3,1,118804,118805,118806,1,2,0
33870,4,1,118808,118808,118809,0,1,2
33871,1,1,118809,118809,118810,0,1,0
33872,2,2,118811,118811,118813,0,2,1
33873,4,1,118815,118815,118816,0,1,2
33874,6,3,118821,118821,118824,0,3,5
33875,2,1,118823,118824,118825,1,2,0
33876,1,1,118824,118825,118826,1,2,0
33877,4,1,118828,118828,118829,0,1,2
33878,6,3,118834,118834,118837,0,3,5
33879,1,1,118835,118837,118838,2,3,0
33880,2,1,118837,118838,118839,1,2,0
33881,6,2,118843,118843,118845,0,2,4
33882,6,1,118849,118849,118850,0,1,4
33883,3,3,118852,118852,118855,0,3,2
33884,4,3,118856,118856,118859,0,3,1
33885,2,3,118858,118859,118862,1,4,0
33886,4,3,118862,118862,118865,0,3,0
33887,1,2,118863,118865,118867,2,4,0
33888,6,1,118869,118869,118870,0,1,2
33889,4,3,118873,118873,118876,0,3,3
33890,2,1,118875,118876,118877,1,2,0
33891,3,1,118878,118878,118879,0,1,1
33892,2,3,118880,118880,118883,0,3,1
33893,5,3,118885,118885,118888,0,3,2
33894,5,2,118890,118890,118892,0,2,2
33895,3,3,118893,118893,118896,0,3,1
33896,1,2,118894,118896,118898,2,4,0
33897,1,2,118895,118898,118900,3,5,0
33898,1,2,118896,118900,118902,4,6,0
33899,6,2,118902,118902,118904,0,2,0
33900,2,2,118904,118904,118906,0,2,0
33901,6,3,118910,118910,118913,0,3,4
33902,6,3,118916,118916,118919,0,3,3
33903,1,3,118917,118919,118922,2,5,0
33904,6,1,118923,118923,118924,0,1,1
33905,3,2,118926,118926,118928,0,2,2
33906,4,2,118930,118930,118932,0,2,2
33907,1,2,118931,118932,118934,1,3,0
33908,6,2,118937,118937,118939,0,2,3
33909,2,1,118939,118939,118940,0,1,0
33910,4,3,118943,118943,118946,0,3,3
33911,2,3,118945,118946,118949,1,4,0
33912,2,3,118947,118949,118952,2,5,0
33913,6,3,118953,118953,118956,0,3,1
33914,3,3,118956,118956,118959,0,3,0
33915,3,1,118959,118959,118960,0,1,0
33916,3,3,118962,118962,118965,0,3,2
33917,3,3,118965,118965,118968,0,3,0
33918,4,1,118969,118969,118970,0,1,1
33919,3,1,118972,118972,118973,0,1,2
33920,1,2,118973,118973,118975,0,2,0
33921,5,3,118978,118978,118981,0,3,3
33922,6,1,118984,118984,118985,0,1,3
33923,2,3,118986,118986,118989,0,3,1
33924,4,3,118990,118990,118993,0,3,1
33925,1,3,118991,118993,118996,2,5,0
33926,6,1,118997,118997,118998,0,1,1
33927,3,1,119000,119000,119001,0,1,2
33928,4,1,119004,119004,119005,0,1,3
33929,4,3,119008,119008,119011,0,3,3
33930,5,1,119013,119013,119014,0,1,2
33931,6,2,119019,119019,119021,0,2,5
33932,4,3,119023,119023,119026,0,3,2
33933,6,2,119029,119029,119031,0,2,3
33934,6,2,119035,119035,119037,0,2,4
33935,1,3,119036,119037,119040,1,4,0
33936,5,1,119041,119041,119042,0,1,1
33937,4,2,119045,119045,119047,0,2,3
33938,6,2,119051,119051,119053,0,2,4
33939,2,1,119053,119053,119054,0,1,0
33940,6,3,119059,119059,119062,0,3,5
33941,5,1,119064,119064,119065,0,1,2
33942,3,1,119067,119067,119068,0,1,2
33943,1,3,119068,119068,119071,0,3,0
33944,4,1,119072,119072,119073,0,1,1
33945,2,1,119074,119074,119075,0,1,1
33946,5,2,119079,119079,119081,0,2,4
33947,6,2,119085,119085,119087,0,2,4
33948,4,2,119089,119089,119091,0,2,2
33949,6,3,119095,119095,119098,0,3,4
33950,3,1,119098,119098,119099,0,1,0
33951,6,3,119104,119104,119107,0,3,5
33952,6,1,119110,119110,119111,0,1,3
33953,4,2,119114,119114,119116,0,2,3
33954,4,1,119118,119118,119119,0,1,2
33955,2,2,119120,119120,119122,0,2,1
33956,2,1,119122,119122,119123,0,1,0
33957,4,2,119126,119126,119128,0,2,3
33958,3,3,119129,119129,119132,0,3,1
33959,1,3,119130,119132,119135,2,5,0
33960,6,1,119136,119136,119137,0,1,1
33961,6,3,119142,119142,119145,0,3,5
33962,6,2,119148,119148,119150,0,2,3
33963,2,1,119150,119150,119151,0,1,0
33964,1,1,119151,119151,119152,0,1,0
33965,1,1,119152,119152,119153,0,1,0
33966,1,2,119153,119153,119155,0,2,0
33967,4,3,119157,119157,119160,0,3,2
33968,5,2,119162,119162,119164,0,2,2
33969,2,2,119164,119164,119166,0,2,0
33970,2,2,119166,119166,119168,0,2,0
33971,6,3,119172,119172,119175,0,3,4
33972,6,1,119178,119178,119179,0,1,3
33973,2,2,119180,119180,119182,0,2,1
33974,6,2,119186,119186,119188,0,2,4
33975,2,1,119188,119188,119189,0,1,0
33976,5,2,119193,119193,119195,0,2,4
33977,5,2,119198,119198,119200,0,2,3
33978,4,2,119202,119202,119204,0,2,2
33979,3,1,119205,119205,119206,0,1,1
33980,5,2,119210,119210,119212,0,2,4
33981,4,3,119214,119214,119217,0,3,2
33982,5,3,119219,119219,119222,0,3,2
33983,2,2,119221,119222,119224,1,3,0
33984,3,1,119224,119224,119225,0,1,0
33985,1,1,119225,119225,119226,0,1,0
33986,4,1,119229,119229,119230,0,1,3
33987,3,3,119232,119232,119235,0,3,2
33988,4,1,119236,119236,119237,0,1,1
33989,5,3,119241,119241,119244,0,3,4
33990,1,3,119242,119244,119247,2,5,0
33991,4,3,119246,119247,119250,1,4,0
33992,5,3,119251,119251,119254,0,3,1
33993,3,1,119254,119254,119255,0,1,0
33994,1,1,119255,119255,119256,0,1,0
33995,6,2,119261,119261,119263,0,2,5
33996,5,1,119266,119266,119267,0,1,3
33997,2,1,119268,119268,119269,0,1,1
33998,1,2,119269,119269,119271,0,2,0
33999,4,3,119273,119273,119276,0,3,2
34000,4,3,119277,119277,119280,0,3,1
34001,6,1,119283,119283,119284,0,1,3
34002,6,2,119289,119289,119291,0,2,5
34003,3,3,119292,119292,119295,0,3,1
34004,5,1,119297,119297,119298,0,1,2
34005,4,3,119301,119301,119304,0,3,3
34006,3,3,119304,119304,119307,0,3,0
34007,6,1,119310,119310,119311,0,1,3
34008,2,2,119312,119312,119314,0,2,1
34009,6,2,119318,119318,119320,0,2,4
34010,2,1,119320,119320,119321,0,1,0
34011,4,2,119324,119324,119326,0,2,3
34012,5,3,119329,119329,119332,0,3,3
34013,2,1,119331,119332,119333,1,2,0
34014,4,2,119335,119335,119337,0,2,2
34015,4,1,119339,119339,119340,0,1,2
34016,5,2,119344,119344,119346,0,2,4
34017,1,1,119345,119346,119347,1,2,0
34018,3,3,119348,119348,119351,0,3,1
34019,2,2,119350,119351,119353,1,3,0
34020,5,2,119355,119355,119357,0,2,2
34021,1,3,119356,119357,119360,1,4,0
34022,1,1,119357,119360,119361,3,4,0
34023,3,1,119360,119361,119362,1,2,0
34024,3,3,119363,119363,119366,0,3,1
34025,6,3,119369,119369,119372,0,3,3
34026,5,2,119374,119374,119376,0,2,2
34027,1,2,119375,119376,119378,1,3,0
34028,3,2,119378,119378,119380,0,2,0
34029,1,3,119379,119380,119383,1,4,0
34030,3,2,119382,119383,119385,1,3,0
34031,6,2,119388,119388,119390,0,2,3
34032,2,3,119390,119390,119393,0,3,0
34033,3,2,119393,119393,119395,0,2,0
34034,2,3,119395,119395,119398,0,3,0
34035,1,1,119396,119398,119399,2,3,0
34036,6,1,119402,119402,119403,0,1,3
34037,1,1,119403,119403,119404,0,1,0
34038,4,1,119407,119407,119408,0,1,3
34039,5,2,119412,119412,119414,0,2,4
34040,4,2,119416,119416,119418,0,2,2
34041,2,1,119418,119418,119419,0,1,0
34042,2,3,119420,119420,119423,0,3,1
34043,3,3,119423,119423,119426,0,3,0
34044,6,1,119429,119429,119430,0,1,3
34045,4,1,119433,119433,119434,0,1,3
34046,5,2,119438,119438,119440,0,2,4
34047,1,1,119439,119440,119441,1,2,0
34048,5,3,119444,119444,119447,0,3,3
34049,1,1,119445,119447,119448,2,3,0
34050,2,3,119447,119448,119451,1,4,0
34051,5,3,119452,119452,119455,0,3,1
34052,2,3,119454,119455,119458,1,4,0
34053,6,1,119460,119460,119461,0,1,2
34054,6,2,119466,119466,119468,0,2,5
34055,4,3,119470,119470,119473,0,3,2
34056,1,2,119471,119473,119475,2,4,0
34057,2,3,119473,119475,119478,2,5,0
34058,6,3,119479,119479,119482,0,3,1
34059,4,2,119483,119483,119485,0,2,1
34060,6,1,119489,119489,119490,0,1,4
34061,2,3,119491,119491,119494,0,3,1
34062,3,1,119494,119494,119495,0,1,0
34063,2,3,119496,119496,119499,0,3,1
34064,2,1,119498,119499,119500,1,2,0
34065,3,2,119501,119501,119503,0,2,1
34066,3,3,119504,119504,119507,0,3,1
34067,1,3,119505,119507,119510,2,5,0
34068,6,3,119511,119511,119514,0,3,1
34069,5,2,119516,119516,119518,0,2,2
34070,2,3,119518,119518,119521,0,3,0
34071,4,2,119522,119522,119524,0,2,1
34072,1,1,119523,119524,119525,1,2,0
34073,6,1,119529,119529,119530,0,1,4
34074,4,1,119533,119533,119534,0,1,3
34075,4,2,119537,119537,119539,0,2,3
34076,1,3,119538,119539,119542,1,4,0
34077,6,3,119544,119544,119547,0,3,2
34078,3,2,119547,119547,119549,0,2,0
34079,2,3,119549,119549,119552,0,3,0
34080,1,3,119550,119552,119555,2,5,0
34081,6,3,119556,119556,119559,0,3,1
34082,1,2,119557,119559,119561,2,4,0
34083,3,2,119560,119561,119563,1,3,0
34084,2,2,119562,119563,119565,1,3,0
34085,6,3,119568,119568,119571,0,3,3
34086,2,2,119570,119571,119573,1,3,0
34087,3,3,119573,119573,119576,0,3,0
34088,1,2,119574,119576,119578,2,4,0
34089,2,3,119576,119578,119581,2,5,0
34090,3,1,119579,119581,119582,2,3,0
34091,2,1,119581,119582,119583,1,2,0
34092,4,1,119585,119585,119586,0,1,2
34093,5,2,119590,119590,119592,0,2,4
34094,1,2,119591,119592,119594,1,3,0
34095,1,2,119592,119594,119596,2,4,0
34096,3,2,119595,119596,119598,1,3,0
34097,6,2,119601,119601,119603,0,2,3
34098,2,2,119603,119603,119605,0,2,0
34099,3,3,119606,119606,119609,0,3,1
34100,2,3,119608,119609,119612,1,4,0
34101,6,2,119614,119614,119616,0,2,2
34102,3,2,119617,119617,119619,0,2,1
34103,1,1,119618,119619,119620,1,2,0
34104,6,3,119624,119624,119627,0,3,4
34105,6,2,119630,119630,119632,0,2,3
34106,4,3,119634,119634,119637,0,3,2
34107,5,3,119639,119639,119642,0,3,2
34108,1,3,119640,119642,119645,2,5,0
34109,4,3,119644,119645,119648,1,4,0
34110,3,2,119647,119648,119650,1,3,0
34111,6,2,119653,119653,119655,0,2,3
34112,5,2,119658,119658,119660,0,2,3
34113,3,1,119661,119661,119662,0,1,1
34114,6,2,119667,119667,119669,0,2,5
34115,3,3,119670,119670,119673,0,3,1
34116,6,1,119676,119676,119677,0,1,3
34117,6,2,119682,119682,119684,0,2,5
34118,2,2,119684,119684,119686,0,2,0
34119,4,2,119688,119688,119690,0,2,2
34120,6,1,119694,119694,119695,0,1,4
34121,5,2,119699,119699,119701,0,2,4
34122,1,2,119700,119701,119703,1,3,0
34123,6,2,119706,119706,119708,0,2,3
34124,3,2,119709,119709,119711,0,2,1
34125,3,1,119712,119712,119713,0,1,1
34126,6,2,119718,119718,119720,0,2,5
34127,2,2,119720,119720,119722,0,2,0
34128,4,1,119724,119724,119725,0,1,2
34129,4,2,119728,119728,119730,0,2,3
34130,6,1,119734,119734,119735,0,1,4
34131,5,1,119739,119739,119740,0,1,4
34132,6,2,119745,119745,119747,0,2,5
34133,5,2,119750,119750,119752,0,2,3
34134,6,3,119756,119756,119759,0,3,4
34135,5,1,119761,119761,119762,0,1,2
34136,6,2,119767,119767,119769,0,2,5
34137,2,2,119769,119769,119771,0,2,0
34138,2,2,119771,119771,119773,0,2,0
34139,3,3,119774,119774,119777,0,3,1
34140,2,1,119776,119777,119778,1,2,0
34141,3,1,119779,119779,119780,0,1,1
34142,6,2,119785,119785,119787,0,2,5
34143,5,2,119790,119790,119792,0,2,3
34144,4,1,119794,119794,119795,0,1,2
34145,3,2,119797,119797,119799,0,2,2
34146,1,2,119798,119799,119801,1,3,0
34147,2,3,119800,119801,119804,1,4,0
34148,4,1,119804,119804,119805,0,1,0
34149,2,2,119806,119806,119808,0,2,1
34150,1,2,119807,119808,119810,1,3,0
34151,1,2,119808,119810,119812,2,4,0
34152,2,3,119810,119812,119815,2,5,0
34153,5,1,119815,119815,119816,0,1,0
34154,2,2,119817,119817,119819,0,2,1
34155,3,1,119820,119820,119821,0,1,1
34156,6,2,119826,119826,119828,0,2,5
34157,5,3,119831,119831,119834,0,3,3
34158,5,2,119836,119836,119838,0,2,2
34159,5,2,119841,119841,119843,0,2,3
34160,1,3,119842,119843,119846,1,4,0
34161,1,3,119843,119846,119849,3,6,0
34162,2,3,119845,119849,119852,4,7,0
34163,4,1,119849,119852,119853,3,4,0
34164,6,3,119855,119855,119858,0,3,2
34165,1,1,119856,119858,119859,2,3,0
34166,2,3,119858,119859,119862,1,4,0
34167,1,1,119859,119862,119863,3,4,0
34168,4,3,119863,119863,119866,0,3,0
34169,3,1,119866,119866,119867,0,1,0
34170,1,3,119867,119867,119870,0,3,0
34171,6,2,119873,119873,119875,0,2,3
34172,5,2,119878,119878,119880,0,2,3
34173,2,3,119880,119880,119883,0,3,0
34174,6,2,119886,119886,119888,0,2,3
34175,2,3,119888,119888,119891,0,3,0
34176,6,2,119894,119894,119896,0,2,3
34177,3,3,119897,119897,119900,0,3,1
34178,4,2,119901,119901,119903,0,2,1
34179,6,3,119907,119907,119910,0,3,4
34180,6,2,119913,119913,119915,0,2,3
34181,4,2,119917,119917,119919,0,2,2
34182,6,3,119923,119923,119926,0,3,4
34183,4,1,119927,119927,119928,0,1,1
34184,3,2,119930,119930,119932,0,2,2
34185,1,2,119931,119932,119934,1,3,0
34186,4,2,119935,119935,119937,0,2,1
34187,2,2,119937,119937,119939,0,2,0
34188,1,1,119938,119939,119940,1,2,0
34189,4,1,119942,119942,119943,0,1,2
34190,6,1,119948,119948,119949,0,1,5
34191,6,1,119954,119954,119955,0,1,5
34192,4,2,119958,119958,119960,0,2,3
34193,1,1,119959,119960,119961,1,2,0
34194,1,1,119960,119961,119962,1,2,0
34195,6,3,119966,119966,119969,0,3,4
34196,6,1,119972,119972,119973,0,1,3
34197,1,1,119973,119973,119974,0,1,0
34198,5,1,119978,119978,119979,0,1,4
34199,2,1,119980,119980,119981,0,1,1
34200,2,2,119982,119982,119984,0,2,1
34201,2,1,119984,119984,119985,0,1,0
34202,1,3,119985,119985,119988,0,3,0
34203,3,1,119988,119988,119989,0,1,0
34204,5,2,119993,119993,119995,0,2,4
34205,6,3,119999,119999,120002,0,3,4
34206,6,1,120005,120005,120006,0,1,3
34207,1,1,120006,120006,120007,0,1,0
34208,5,3,120011,120011,120014,0,3,4
34209,3,1,120014,120014,120015,0,1,0
34210,2,2,120016,120016,120018,0,2,1
34211,5,2,120021,120021,120023,0,2,3
34212,6,2,120027,120027,120029,0,2,4
34213,6,1,120033,120033,120034,0,1,4
34214,4,1,120037,120037,120038,0,1,3
34215,6,2,120043,120043,120045,0,2,5
34216,6,2,120049,120049,120051,0,2,4
34217,2,2,120051,120051,120053,0,2,0
34218,5,3,120056,120056,120059,0,3,3
34219,1,2,120057,120059,120061,2,4,0
34220,5,3,120062,120062,120065,0,3,1
34221,1,2,120063,120065,120067,2,4,0
34222,5,2,120068,120068,120070,0,2,1
34223,6,2,120074,120074,120076,0,2,4
34224,5,3,120079,120079,120082,0,3,3
34225,2,1,120081,120082,120083,1,2,0
34226,1,2,120082,120083,120085,1,3,0
34227,4,3,120086,120086,120089,0,3,1
34228,1,1,120087,120089,120090,2,3,0
34229,6,1,120093,120093,120094,0,1,3
34230,1,1,120094,120094,120095,0,1,0
34231,4,2,120098,120098,120100,0,2,3
34232,1,3,120099,120100,120103,1,4,0
34233,4,3,120103,120103,120106,0,3,0
34234,5,1,120108,120108,120109,0,1,2
34235,3,2,120111,120111,120113,0,2,2
34236,2,3,120113,120113,120116,0,3,0
34237,5,2,120118,120118,120120,0,2,2
34238,6,3,120124,120124,120127,0,3,4
34239,3,3,120127,120127,120130,0,3,0
34240,5,3,120132,120132,120135,0,3,2
34241,2,3,120134,120135,120138,1,4,0
34242,2,3,120136,120138,120141,2,5,0
34243,2,1,120138,120141,120142,3,4,0
34244,5,1,120143,120143,120144,0,1,1
34245,3,1,120146,120146,120147,0,1,2
34246,5,1,120151,120151,120152,0,1,4
34247,2,1,120153,120153,120154,0,1,1
34248,1,3,120154,120154,120157,0,3,0
34249,6,1,120160,120160,120161,0,1,3
34250,3,1,120163,120163,120164,0,1,2
34251,1,1,120164,120164,120165,0,1,0
34252,4,3,120168,120168,120171,0,3,3
34253,3,2,120171,120171,120173,0,2,0
34254,5,1,120176,120176,120177,0,1,3
34255,6,1,120182,120182,120183,0,1,5
34256,5,1,120187,120187,120188,0,1,4
34257,6,2,120193,120193,120195,0,2,5
34258,6,2,120199,120199,120201,0,2,4
34259,1,2,120200,120201,120203,1,3,0
34260,4,1,120204,120204,120205,0,1,1
34261,6,3,120210,120210,120213,0,3,5
34262,2,2,120212,120213,120215,1,3,0
34263,5,2,120217,120217,120219,0,2,2
34264,6,1,120223,120223,120224,0,1,4
34265,2,2,120225,120225,120227,0,2,1
34266,4,3,120229,120229,120232,0,3,2
34267,1,3,120230,120232,120235,2,5,0
34268,3,2,120233,120235,120237,2,4,0
34269,2,1,120235,120237,120238,2,3,0
34270,5,1,120240,120240,120241,0,1,2
34271,5,1,120245,120245,120246,0,1,4
34272,4,2,120249,120249,120251,0,2,3
34273,4,2,120253,120253,120255,0,2,2
34274,4,2,120257,120257,120259,0,2,2
34275,2,1,120259,120259,120260,0,1,0
34276,5,2,120264,120264,120266,0,2,4
34277,5,3,120269,120269,120272,0,3,3
34278,1,3,120270,120272,120275,2,5,0
34279,5,2,120275,120275,120277,0,2,0
34280,3,1,120278,120278,120279,0,1,1
34281,1,3,120279,120279,120282,0,3,0
34282,4,3,120283,120283,120286,0,3,1
34283,3,2,120286,120286,120288,0,2,0
34284,3,3,120289,120289,120292,0,3,1
34285,1,3,120290,120292,120295,2,5,0
34286,5,2,120295,120295,120297,0,2,0
34287,4,1,120299,120299,120300,0,1,2
34288,2,2,120301,120301,120303,0,2,1
34289,4,2,120305,120305,120307,0,2,2
34290,3,1,120308,120308,120309,0,1,1
34291,4,2,120312,120312,120314,0,2,3
34292,3,1,120315,120315,120316,0,1,1
34293,4,2,120319,120319,120321,0,2,3
34294,6,1,120325,120325,120326,0,1,4
34295,1,3,120326,120326,120329,0,3,0
34296,4,1,120330,120330,120331,0,1,1
34297,5,2,120335,120335,120337,0,2,4
34298,6,3,120341,120341,120344,0,3,4
34299,1,3,120342,120344,120347,2,5,0
34300,3,1,120345,120347,120348,2,3,0
34301,1,2,120346,120348,120350,2,4,0
34302,3,3,120349,120350,120353,1,4,0
34303,5,3,120354,120354,120357,0,3,1
34304,1,3,120355,120357,120360,2,5,0
34305,2,1,120357,120360,120361,3,4,0
34306,6,3,120363,120363,120366,0,3,2
34307,6,3,120369,120369,120372,0,3,3
34308,6,3,120375,120375,120378,0,3,3
34309,2,1,120377,120378,120379,1,2,0
34310,5,3,120382,120382,120385,0,3,3
34311,6,1,120388,120388,120389,0,1,3
34312,2,3,120390,120390,120393,0,3,1
34313,1,2,120391,120393,120395,2,4,0
34314,5,1,120396,120396,120397,0,1,1
34315,6,2,120402,120402,120404,0,2,5
34316,3,1,120405,120405,120406,0,1,1
34317,3,2,120408,120408,120410,0,2,2
34318,3,1,120411,120411,120412,0,1,1
34319,2,3,120413,120413,120416,0,3,1
34320,2,3,120415,120416,120419,1,4,0
34321,4,2,120419,120419,120421,0,2,0
34322,2,3,120421,120421,120424,0,3,0
34323,5,2,120426,120426,120428,0,2,2
34324,6,1,120432,120432,120433,0,1,4
34325,5,2,120437,120437,120439,0,2,4
34326,5,1,120442,120442,120443,0,1,3
34327,5,1,120447,120447,120448,0,1,4
34328,5,3,120452,120452,120455,0,3,4
34329,5,3,120457,120457,120460,0,3,2
34330,4,1,120461,120461,120462,0,1,1
34331,6,1,120467,120467,120468,0,1,5
34332,3,2,120470,120470,120472,0,2,2
34333,2,2,120472,120472,120474,0,2,0
34334,5,3,120477,120477,120480,0,3,3
34335,6,3,120483,120483,120486,0,3,3
34336,3,1,120486,120486,120487,0,1,0
34337,5,3,120491,120491,120494,0,3,4
34338,3,1,120494,120494,120495,0,1,0
34339,2,1,120496,120496,120497,0,1,1
34340,5,2,120501,120501,120503,0,2,4
34341,6,2,120507,120507,120509,0,2,4
34342,1,3,120508,120509,120512,1,4,0
34343,6,1,120514,120514,120515,0,1,2
34344,2,2,120516,120516,120518,0,2,1
34345,3,3,120519,120519,120522,0,3,1
34346,3,2,120522,120522,120524,0,2,0
34347,2,2,120524,120524,120526,0,2,0
34348,1,1,120525,120526,120527,1,2,0
34349,3,3,120528,120528,120531,0,3,1
34350,5,2,120533,120533,120535,0,2,2
34351,6,2,120539,120539,120541,0,2,4
34352,6,2,120545,120545,120547,0,2,4
34353,4,3,120549,120549,120552,0,3,2
34354,2,2,120551,120552,120554,1,3,0
34355,6,3,120557,120557,120560,0,3,3
34356,3,1,120560,120560,120561,0,1,0
34357,4,1,120564,120564,120565,0,1,3
34358,5,3,120569,120569,120572,0,3,4
34359,6,3,120575,120575,120578,0,3,3
34360,3,1,120578,120578,120579,0,1,0
34361,4,3,120582,120582,120585,0,3,3
34362,2,2,120584,120585,120587,1,3,0
34363,2,1,120586,120587,120588,1,2,0
34364,6,1,120592,120592,120593,0,1,4
34365,1,1,120593,120593,120594,0,1,0
34366,2,3,120595,120595,120598,0,3,1
34367,6,2,120601,120601,120603,0,2,3
34368,5,1,120606,120606,120607,0,1,3
34369,5,1,120611,120611,120612,0,1,4
34370,6,3,120617,120617,120620,0,3,5
34371,4,1,120621,120621,120622,0,1,1
34372,5,1,120626,120626,120627,0,1,4
34373,4,1,120630,120630,120631,0,1,3
34374,1,1,120631,120631,120632,0,1,0
34375,2,3,120633,120633,120636,0,3,1
34376,6,3,120639,120639,120642,0,3,3
34377,1,2,120640,120642,120644,2,4,0
34378,1,3,120641,120644,120647,3,6,0
34379,1,2,120642,120647,120649,5,7,0
34380,6,3,120648,120649,120652,1,4,0
34381,3,1,120651,120652,120653,1,2,0
34382,4,2,120655,120655,120657,0,2,2
34383,1,1,120656,120657,120658,1,2,0
34384,2,2,120658,120658,120660,0,2,0
34385,6,2,120664,120664,120666,0,2,4
34386,4,2,120668,120668,120670,0,2,2
34387,5,1,120673,120673,120674,0,1,3
34388,4,2,120677,120677,120679,0,2,3
34389,1,3,120678,120679,120682,1,4,0
34390,3,3,120681,120682,120685,1,4,0
34391,1,2,120682,120685,120687,3,5,0
34392,2,3,120684,120687,120690,3,6,0
34393,1,2,120685,120690,120692,5,7,0
34394,4,1,120689,120692,120693,3,4,0
34395,1,3,120690,120693,120696,3,6,0
34396,6,2,120696,120696,120698,0,2,0
34397,1,2,120697,120698,120700,1,3,0
34398,5,1,120702,120702,120703,0,1,2
34399,3,2,120705,120705,120707,0,2,2
34400,2,2,120707,120707,120709,0,2,0
34401,3,1,120710,120710,120711,0,1,1
34402,2,1,120712,120712,120713,0,1,1
34403,3,1,120715,120715,120716,0,1,2
34404,1,2,120716,120716,120718,0,2,0
34405,3,2,120719,120719,120721,0,2,1
34406,1,1,120720,120721,120722,1,2,0
34407,3,1,120723,120723,120724,0,1,1
34408,6,1,120729,120729,120730,0,1,5
34409,2,2,120731,120731,120733,0,2,1
34410,1,2,120732,120733,120735,1,3,0
34411,3,1,120735,120735,120736,0,1,0
34412,5,1,120740,120740,120741,0,1,4
34413,6,3,120746,120746,120749,0,3,5
34414,2,2,120748,120749,120751,1,3,0
34415,2,1,120750,120751,120752,1,2,0
34416,3,2,120753,120753,120755,0,2,1
34417,6,3,120759,120759,120762,0,3,4
34418,5,1,120764,120764,120765,0,1,2
34419,6,2,120770,120770,120772,0,2,5
34420,2,1,120772,120772,120773,0,1,0
34421,4,3,120776,120776,120779,0,3,3
34422,3,3,120779,120779,120782,0,3,0
34423,5,3,120784,120784,120787,0,3,2
34424,3,2,120787,120787,120789,0,2,0
34425,3,2,120790,120790,120792,0,2,1
34426,6,2,120796,120796,120798,0,2,4
34427,6,2,120802,120802,120804,0,2,4
34428,6,2,120808,120808,120810,0,2,4
34429,4,1,120812,120812,120813,0,1,2
34430,3,1,120815,120815,120816,0,1,2
34431,2,2,120817,120817,120819,0,2,1
34432,1,2,120818,120819,120821,1,3,0
34433,6,3,120824,120824,120827,0,3,3
34434,6,1,120830,120830,120831,0,1,3
34435,5,1,120835,120835,120836,0,1,4
34436,4,2,120839,120839,120841,0,2,3
34437,3,3,120842,120842,120845,0,3,1
34438,6,1,120848,120848,120849,0,1,3
34439,5,1,120853,120853,120854,0,1,4
34440,5,3,120858,120858,120861,0,3,4
34441,1,3,120859,120861,120864,2,5,0
34442,5,3,120864,120864,120867,0,3,0
34443,3,1,120867,120867,120868,0,1,0
34444,2,2,120869,120869,120871,0,2,1
34445,5,3,120874,120874,120877,0,3,3
34446,6,2,120880,120880,120882,0,2,3
34447,1,1,120881,120882,120883,1,2,0
34448,5,3,120886,120886,120889,0,3,3
34449,4,3,120890,120890,120893,0,3,1
34450,3,3,120893,120893,120896,0,3,0
34451,3,2,120896,120896,120898,0,2,0
34452,6,2,120902,120902,120904,0,2,4
34453,1,1,120903,120904,120905,1,2,0
34454,5,3,120908,120908,120911,0,3,3
34455,3,3,120911,120911,120914,0,3,0
34456,2,2,120913,120914,120916,1,3,0
34457,1,1,120914,120916,120917,2,3,0
34458,2,3,120916,120917,120920,1,4,0
34459,4,3,120920,120920,120923,0,3,0
34460,4,2,120924,120924,120926,0,2,1
34461,2,3,120926,120926,120929,0,3,0
34462,4,2,120930,120930,120932,0,2,1
34463,6,2,120936,120936,120938,0,2,4
34464,4,3,120940,120940,120943,0,3,2
34465,6,3,120946,120946,120949,0,3,3
34466,4,1,120950,120950,120951,0,1,1
34467,3,3,120953,120953,120956,0,3,2
34468,5,1,120958,120958,120959,0,1,2
34469,6,1,120964,120964,120965,0,1,5
34470,4,2,120968,120968,120970,0,2,3
34471,5,2,120973,120973,120975,0,2,3
34472,5,1,120978,120978,120979,0,1,3
34473,6,2,120984,120984,120986,0,2,5
34474,1,3,120985,120986,120989,1,4,0
34475,1,1,120986,120989,120990,3,4,0
34476,5,2,120991,120991,120993,0,2,1
34477,3,1,120994,120994,120995,0,1,1
34478,4,1,120998,120998,120999,0,1,3
34479,6,2,121004,121004,121006,0,2,5
34480,4,3,121008,121008,121011,0,3,2
34481,3,1,121011,121011,121012,0,1,0
34482,5,3,121016,121016,121019,0,3,4
34483,5,3,121021,121021,121024,0,3,2
34484,5,2,121026,121026,121028,0,2,2
34485,5,1,121031,121031,121032,0,1,3
34486,6,2,121037,121037,121039,0,2,5
34487,4,3,121041,121041,121044,0,3,2
34488,5,1,121046,121046,121047,0,1,2
34489,2,1,121048,121048,121049,0,1,1
34490,6,3,121054,121054,121057,0,3,5
34491,5,1,121059,121059,121060,0,1,2
34492,6,2,121065,121065,121067,0,2,5
34493,5,3,121070,121070,121073,0,3,3
34494,5,1,121075,121075,121076,0,1,2
34495,6,3,121081,121081,121084,0,3,5
34496,4,2,121085,121085,121087,0,2,1
34497,1,3,121086,121087,121090,1,4,0
34498,1,3,121087,121090,121093,3,6,0
34499,4,2,121091,121093,121095,2,4,0
34500,5,2,121096,121096,121098,0,2,1
34501,2,1,121098,121098,121099,0,1,0
34502,1,3,121099,121099,121102,0,3,0
34503,1,3,121100,121102,121105,2,5,0
34504,1,1,121101,121105,121106,4,5,0
34505,2,2,121103,121106,121108,3,5,0
34506,5,2,121108,121108,121110,0,2,0
34507,6,1,121114,121114,121115,0,1,4
34508,2,2,121116,121116,121118,0,2,1
34509,6,3,121122,121122,121125,0,3,4
34510,5,2,121127,121127,121129,0,2,2
34511,6,2,121133,121133,121135,0,2,4
34512,6,2,121139,121139,121141,0,2,4
34513,2,3,121141,121141,121144,0,3,0
34514,5,1,121146,121146,121147,0,1,2
34515,2,2,121148,121148,121150,0,2,1
34516,2,3,121150,121150,121153,0,3,0
34517,6,3,121156,121156,121159,0,3,3
34518,5,2,121161,121161,121163,0,2,2
34519,5,3,121166,121166,121169,0,3,3
34520,1,3,121167,121169,121172,2,5,0
34521,5,1,121172,121172,121173,0,1,0
34522,4,1,121176,121176,121177,0,1,3
34523,4,1,121180,121180,121181,0,1,3
34524,5,1,121185,121185,121186,0,1,4
34525,6,3,121191,121191,121194,0,3,5
34526,1,2,121192,121194,121196,2,4,0
34527,6,3,121198,121198,121201,0,3,2
34528,6,1,121204,121204,121205,0,1,3
34529,3,2,121207,121207,121209,0,2,2
34530,4,2,121211,121211,121213,0,2,2
34531,2,3,121213,121213,121216,0,3,0
34532,1,3,121214,121216,121219,2,5,0
34533,6,1,121220,121220,121221,0,1,1
34534,6,3,121226,121226,121229,0,3,5
34535,4,2,121230,121230,121232,0,2,1
34536,6,2,121236,121236,121238,0,2,4
34537,3,1,121239,121239,121240,0,1,1
34538,5,2,121244,121244,121246,0,2,4
34539,1,2,121245,121246,121248,1,3,0
34540,4,3,121249,121249,121252,0,3,1
34541,3,2,121252,121252,121254,0,2,0
34542,1,1,121253,121254,121255,1,2,0
34543,2,2,121255,121255,121257,0,2,0
34544,1,2,121256,121257,121259,1,3,0
34545,1,2,121257,121259,121261,2,4,0
34546,6,2,121263,121263,121265,0,2,2
34547,3,1,121266,121266,121267,0,1,1
34548,5,3,121271,121271,121274,0,3,4
34549,2,1,121273,121274,121275,1,2,0
34550,4,3,121277,121277,121280,0,3,2
34551,5,3,121282,121282,121285,0,3,2
34552,6,2,121288,121288,121290,0,2,3
34553,6,1,121294,121294,121295,0,1,4
34554,3,1,121297,121297,121298,0,1,2
34555,2,3,121299,121299,121302,0,3,1
34556,2,2,121301,121302,121304,1,3,0
34557,2,2,121303,121304,121306,1,3,0
34558,6,1,121309,121309,121310,0,1,3
34559,5,1,121314,121314,121315,0,1,4
34560,6,1,121320,121320,121321,0,1,5
34561,2,2,121322,121322,121324,0,2,1
34562,3,1,121325,121325,121326,0,1,1
34563,6,3,121331,121331,121334,0,3,5
34564,2,3,121333,121334,121337,1,4,0
34565,5,3,121338,121338,121341,0,3,1
34566,6,1,121344,121344,121345,0,1,3
34567,2,1,121346,121346,121347,0,1,1
34568,1,2,121347,121347,121349,0,2,0
34569,3,3,121350,121350,121353,0,3,1
34570,3,2,121353,121353,121355,0,2,0
34571,2,2,121355,121355,121357,0,2,0
34572,3,3,121358,121358,121361,0,3,1
34573,6,3,121364,121364,121367,0,3,3
34574,3,3,121367,121367,121370,0,3,0
34575,4,3,121371,121371,121374,0,3,1
34576,2,2,121373,121374,121376,1,3,0
34577,1,3,121374,121376,121379,2,5,0
34578,4,3,121378,121379,121382,1,4,0
34579,6,2,121384,121384,121386,0,2,2
34580,5,2,121389,121389,121391,0,2,3
34581,2,1,121391,121391,121392,0,1,0
34582,3,2,121394,121394,121396,0,2,2
34583,1,3,121395,121396,121399,1,4,0
34584,4,1,121399,121399,121400,0,1,0
34585,4,2,121403,121403,121405,0,2,3
34586,4,3,121407,121407,121410,0,3,2
34587,6,3,121413,121413,121416,0,3,3
34588,1,3,121414,121416,121419,2,5,0
34589,6,1,121420,121420,121421,0,1,1
34590,3,2,121423,121423,121425,0,2,2
34591,1,3,121424,121425,121428,1,4,0
34592,1,1,121425,121428,121429,3,4,0
34593,4,3,121429,121429,121432,0,3,0
34594,2,3,121431,121432,121435,1,4,0
34595,2,2,121433,121435,121437,2,4,0
34596,6,1,121439,121439,121440,0,1,2
34597,3,3,121442,121442,121445,0,3,2
34598,6,1,121448,121448,121449,0,1,3
34599,4,2,121452,121452,121454,0,2,3
34600,3,1,121455,121455,121456,0,1,1
34601,3,2,121458,121458,121460,0,2,2
34602,5,3,121463,121463,121466,0,3,3
34603,5,2,121468,121468,121470,0,2,2
34604,2,2,121470,121470,121472,0,2,0
34605,1,2,121471,121472,121474,1,3,0
34606,2,3,121473,121474,121477,1,4,0
34607,3,3,121476,121477,121480,1,4,0
34608,2,2,121478,121480,121482,2,4,0
34609,6,3,121484,121484,121487,0,3,2
34610,3,1,121487,121487,121488,0,1,0
34611,5,1,121492,121492,121493,0,1,4
34612,3,2,121495,121495,121497,0,2,2
34613,6,2,121501,121501,121503,0,2,4
34614,6,3,121507,121507,121510,0,3,4
34615,2,3,121509,121510,121513,1,4,0
34616,5,2,121514,121514,121516,0,2,1
34617,3,2,121517,121517,121519,0,2,1
34618,6,1,121523,121523,121524,0,1,4
34619,4,1,121527,121527,121528,0,1,3
34620,1,1,121528,121528,121529,0,1,0
34621,6,2,121534,121534,121536,0,2,5
34622,1,2,121535,121536,121538,1,3,0
34623,1,3,121536,121538,121541,2,5,0
34624,3,3,121539,121541,121544,2,5,0
34625,6,1,121545,121545,121546,0,1,1
34626,3,3,121548,121548,121551,0,3,2
34627,4,3,121552,121552,121555,0,3,1
34628,2,1,121554,121555,121556,1,2,0
34629,4,1,121558,121558,121559,0,1,2
34630,1,2,121559,121559,121561,0,2,0
34631,1,3,121560,121561,121564,1,4,0
34632,3,1,121563,121564,121565,1,2,0
34633,3,3,121566,121566,121569,0,3,1
34634,6,1,121572,121572,121573,0,1,3
34635,3,2,121575,121575,121577,0,2,2
34636,4,2,121579,121579,121581,0,2,2
34637,2,2,121581,121581,121583,0,2,0
34638,4,1,121585,121585,121586,0,1,2
34639,4,2,121589,121589,121591,0,2,3
34640,4,2,121593,121593,121595,0,2,2
34641,5,3,121598,121598,121601,0,3,3
34642,5,2,121603,121603,121605,0,2,2
34643,4,2,121607,121607,121609,0,2,2
34644,3,3,121610,121610,121613,0,3,1
34645,5,2,121615,121615,121617,0,2,2
34646,4,1,121619,121619,121620,0,1,2
34647,4,2,121623,121623,121625,0,2,3
34648,1,2,121624,121625,121627,1,3,0
34649,5,3,121629,121629,121632,0,3,2
34650,2,3,121631,121632,121635,1,4,0
34651,1,1,121632,121635,121636,3,4,0
34652,3,1,121635,121636,121637,1,2,0
34653,5,1,121640,121640,121641,0,1,3
34654,5,1,121645,121645,121646,0,1,4
34655,1,1,121646,121646,121647,0,1,0
34656,3,2,121649,121649,121651,0,2,2
34657,5,3,121654,121654,121657,0,3,3
34658,5,2,121659,121659,121661,0,2,2
34659,1,2,121660,121661,121663,1,3,0
34660,2,1,121662,121663,121664,1,2,0
34661,6,3,121668,121668,121671,0,3,4
34662,5,3,121673,121673,121676,0,3,2
34663,1,1,121674,121676,121677,2,3,0
34664,6,2,121680,121680,121682,0,2,3
34665,2,1,121682,121682,121683,0,1,0
34666,3,3,121685,121685,121688,0,3,2
34667,3,2,121688,121688,121690,0,2,0
34668,2,1,121690,121690,121691,0,1,0
34669,1,2,121691,121691,121693,0,2,0
34670,4,3,121695,121695,121698,0,3,2
34671,4,3,121699,121699,121702,0,3,1
34672,1,1,121700,121702,121703,2,3,0
34673,2,2,121702,121703,121705,1,3,0
34674,5,2,121707,121707,121709,0,2,2
34675,2,1,121709,121709,121710,0,1,0
34676,2,3,121711,121711,121714,0,3,1
34677,4,2,121715,121715,121717,0,2,1
34678,6,2,121721,121721,121723,0,2,4
34679,2,3,121723,121723,121726,0,3,0
34680,6,1,121729,121729,121730,0,1,3
34681,2,2,121731,121731,121733,0,2,1
34682,2,1,121733,121733,121734,0,1,0
34683,6,3,121739,121739,121742,0,3,5
34684,2,3,121741,121742,121745,1,4,0
34685,2,2,121743,121745,121747,2,4,0
34686,6,2,121749,121749,121751,0,2,2
34687,2,3,121751,121751,121754,0,3,0
34688,6,1,121757,121757,121758,0,1,3
34689,5,2,121762,121762,121764,0,2,4
34690,4,3,121766,121766,121769,0,3,2
34691,2,1,121768,121769,121770,1,2,0
34692,4,2,121772,121772,121774,0,2,2
34693,3,1,121775,121775,121776,0,1,1
34694,4,1,121779,121779,121780,0,1,3
34695,4,3,121783,121783,121786,0,3,3
34696,2,1,121785,121786,121787,1,2,0
34697,6,2,121791,121791,121793,0,2,4
34698,2,1,121793,121793,121794,0,1,0
34699,4,3,121797,121797,121800,0,3,3
34700,6,1,121803,121803,121804,0,1,3
34701,3,2,121806,121806,121808,0,2,2
34702,1,1,121807,121808,121809,1,2,0
34703,4,1,121811,121811,121812,0,1,2
34704,5,3,121816,121816,121819,0,3,4
34705,2,3,121818,121819,121822,1,4,0
34706,5,3,121823,121823,121826,0,3,1
34707,3,3,121826,121826,121829,0,3,0
34708,3,2,121829,121829,121831,0,2,0
34709,1,3,121830,121831,121834,1,4,0
34710,1,1,121831,121834,121835,3,4,0
34711,1,2,121832,121835,121837,3,5,0
34712,2,2,121834,121837,121839,3,5,0
34713,2,1,121836,121839,121840,3,4,0
34714,4,2,121840,121840,121842,0,2,0
34715,1,1,121841,121842,121843,1,2,0
34716,6,2,121847,121847,121849,0,2,4
34717,4,3,121851,121851,121854,0,3,2
34718,2,1,121853,121854,121855,1,2,0
34719,1,2,121854,121855,121857,1,3,0
34720,4,1,121858,121858,121859,0,1,1
34721,1,1,121859,121859,121860,0,1,0
34722,6,1,121865,121865,121866,0,1,5
34723,4,3,121869,121869,121872,0,3,3
34724,2,1,121871,121872,121873,1,2,0
34725,6,1,121877,121877,121878,0,1,4
34726,3,3,121880,121880,121883,0,3,2
34727,6,2,121886,121886,121888,0,2,3
34728,3,3,121889,121889,121892,0,3,1
34729,4,2,121893,121893,121895,0,2,1
34730,2,1,121895,121895,121896,0,1,0
34731,1,3,121896,121896,121899,0,3,0
34732,2,3,121898,121899,121902,1,4,0
34733,5,3,121903,121903,121906,0,3,1
34734,2,1,121905,121906,121907,1,2,0
34735,3,1,121908,121908,121909,0,1,1
34736,3,2,121911,121911,121913,0,2,2
34737,4,1,121915,121915,121916,0,1,2
34738,1,1,121916,121916,121917,0,1,0
34739,3,1,121919,121919,121920,0,1,2
34740,5,2,121924,121924,121926,0,2,4
34741,6,2,121930,121930,121932,0,2,4
34742,6,3,121936,121936,121939,0,3,4
34743,3,1,121939,121939,121940,0,1,0
34744,5,1,121944,121944,121945,0,1,4
34745,1,3,121945,121945,121948,0,3,0
34746,6,2,121951,121951,121953,0,2,3
34747,3,1,121954,121954,121955,0,1,1
34748,4,1,121958,121958,121959,0,1,3
34749,1,1,121959,121959,121960,0,1,0
34750,1,3,121960,121960,121963,0,3,0
34751,2,3,121962,121963,121966,1,4,0
34752,6,1,121968,121968,121969,0,1,2
34753,5,2,121973,121973,121975,0,2,4
34754,1,1,121974,121975,121976,1,2,0
34755,5,1,121979,121979,121980,0,1,3
34756,2,2,121981,121981,121983,0,2,1
34757,1,3,121982,121983,121986,1,4,0
34758,5,1,121987,121987,121988,0,1,1
34759,4,1,121991,121991,121992,0,1,3
34760,2,1,121993,121993,121994,0,1,1
34761,3,1,121996,121996,121997,0,1,2
34762,2,3,121998,121998,122001,0,3,1
34763,2,1,122000,122001,122002,1,2,0
34764,2,2,122002,122002,122004,0,2,0
34765,2,2,122004,122004,122006,0,2,0
34766,5,1,122009,122009,122010,0,1,3
34767,1,1,122010,122010,122011,0,1,0
34768,3,3,122013,122013,122016,0,3,2
34769,6,3,122019,122019,122022,0,3,3
34770,3,3,122022,122022,122025,0,3,0
34771,5,2,122027,122027,122029,0,2,2
34772,6,3,122033,122033,122036,0,3,4
34773,6,1,122039,122039,122040,0,1,3
34774,4,1,122043,122043,122044,0,1,3
34775,3,3,122046,122046,122049,0,3,2
34776,5,3,122051,122051,122054,0,3,2
34777,5,1,122056,122056,122057,0,1,2
34778,2,2,122058,122058,122060,0,2,1
34779,3,2,122061,122061,122063,0,2,1
34780,2,2,122063,122063,122065,0,2,0
34781,2,1,122065,122065,122066,0,1,0
34782,5,1,122070,122070,122071,0,1,4
34783,3,3,122073,122073,122076,0,3,2
34784,3,3,122076,122076,122079,0,3,0
34785,4,1,122080,122080,122081,0,1,1
34786,6,2,122086,122086,122088,0,2,5
34787,3,1,122089,122089,122090,0,1,1
34788,4,2,122093,122093,122095,0,2,3
34789,4,1,122097,122097,122098,0,1,2
34790,4,3,122101,122101,122104,0,3,3
34791,2,1,122103,122104,122105,1,2,0
34792,4,1,122107,122107,122108,0,1,2
34793,2,1,122109,122109,122110,0,1,1
34794,5,2,122114,122114,122116,0,2,4
34795,4,2,122118,122118,122120,0,2,2
34796,4,2,122122,122122,122124,0,2,2
34797,3,2,122125,122125,122127,0,2,1
34798,3,1,122128,122128,122129,0,1,1
34799,6,2,122134,122134,122136,0,2,5
34800,4,2,122138,122138,122140,0,2,2
34801,3,1,122141,122141,122142,0,1,1
34802,2,2,122143,122143,122145,0,2,1
34803,1,1,122144,122145,122146,1,2,0
34804,5,1,122149,122149,122150,0,1,3
34805,3,2,122152,122152,122154,0,2,2
34806,6,2,122158,122158,122160,0,2,4
34807,6,3,122164,122164,122167,0,3,4
34808,6,2,122170,122170,122172,0,2,3
34809,4,2,122174,122174,122176,0,2,2
34810,2,1,122176,122176,122177,0,1,0
34811,3,2,122179,122179,122181,0,2,2
34812,6,3,122185,122185,122188,0,3,4
34813,5,2,122190,122190,122192,0,2,2
34814,3,1,122193,122193,122194,0,1,1
34815,4,3,122197,122197,122200,0,3,3
34816,3,3,122200,122200,122203,0,3,0
34817,5,3,122205,122205,122208,0,3,2
34818,2,3,122207,122208,122211,1,4,0
34819,6,1,122213,122213,122214,0,1,2
34820,2,3,122215,122215,122218,0,3,1
34821,1,1,122216,122218,122219,2,3,0
34822,1,2,122217,122219,122221,2,4,0
34823,4,1,122221,122221,122222,0,1,0
34824,6,3,122227,122227,122230,0,3,5
34825,5,1,122232,122232,122233,0,1,2
34826,4,1,122236,122236,122237,0,1,3
34827,5,2,122241,122241,122243,0,2,4
34828,4,2,122245,122245,122247,0,2,2
34829,5,1,122250,122250,122251,0,1,3
34830,1,2,122251,122251,122253,0,2,0
34831,4,1,122255,122255,122256,0,1,2
34832,4,1,122259,122259,122260,0,1,3
34833,2,3,122261,122261,122264,0,3,1
34834,2,2,122263,122264,122266,1,3,0
34835,6,2,122269,122269,122271,0,2,3
34836,5,2,122274,122274,122276,0,2,3
34837,2,1,122276,122276,122277,0,1,0
34838,2,3,122278,122278,122281,0,3,1
34839,2,1,122280,122281,122282,1,2,0
34840,1,3,122281,122282,122285,1,4,0
34841,1,2,122282,122285,122287,3,5,0
34842,6,1,122288,122288,122289,0,1,1
34843,4,2,122292,122292,122294,0,2,3
34844,3,3,122295,122295,122298,0,3,1
34845,1,2,122296,122298,122300,2,4,0
34846,3,2,122299,122300,122302,1,3,0
34847,1,2,122300,122302,122304,2,4,0
34848,2,2,122302,122304,122306,2,4,0
34849,4,3,122306,122306,122309,0,3,0
34850,2,1,122308,122309,122310,1,2,0
34851,3,1,122311,122311,122312,0,1,1
34852,2,3,122313,122313,122316,0,3,1
34853,4,1,122317,122317,122318,0,1,1
34854,4,1,122321,122321,122322,0,1,3
34855,1,3,122322,122322,122325,0,3,0
34856,4,2,122326,122326,122328,0,2,1
34857,6,3,122332,122332,122335,0,3,4
34858,2,1,122334,122335,122336,1,2,0
34859,2,1,122336,122336,122337,0,1,0
34860,4,1,122340,122340,122341,0,1,3
34861,2,2,122342,122342,122344,0,2,1
34862,5,1,122347,122347,122348,0,1,3
34863,6,1,122353,122353,122354,0,1,5
34864,6,1,122359,122359,122360,0,1,5
34865,4,2,122363,122363,122365,0,2,3
34866,5,2,122368,122368,122370,0,2,3
34867,2,1,122370,122370,122371,0,1,0
34868,3,2,122373,122373,122375,0,2,2
34869,5,2,122378,122378,122380,0,2,3
34870,5,2,122383,122383,122385,0,2,3
34871,6,2,122389,122389,122391,0,2,4
34872,6,3,122395,122395,122398,0,3,4
34873,4,2,122399,122399,122401,0,2,1
34874,1,3,122400,122401,122404,1,4,0
34875,6,3,122406,122406,122409,0,3,2
34876,6,2,122412,122412,122414,0,2,3
34877,1,2,122413,122414,122416,1,3,0
34878,3,1,122416,122416,122417,0,1,0
34879,3,2,122419,122419,122421,0,2,2
34880,5,2,122424,122424,122426,0,2,3
34881,3,2,122427,122427,122429,0,2,1
34882,4,3,122431,122431,122434,0,3,2
34883,4,3,122435,122435,122438,0,3,1
34884,4,3,122439,122439,122442,0,3,1
34885,4,1,122443,122443,122444,0,1,1
34886,5,1,122448,122448,122449,0,1,4
34887,2,2,122450,122450,122452,0,2,1
34888,1,1,122451,122452,122453,1,2,0
34889,4,1,122455,122455,122456,0,1,2
34890,4,1,122459,122459,122460,0,1,3
34891,5,2,122464,122464,122466,0,2,4
34892,2,3,122466,122466,122469,0,3,0
34893,2,3,122468,122469,122472,1,4,0
34894,4,1,122472,122472,122473,0,1,0
34895,3,1,122475,122475,122476,0,1,2
34896,1,1,122476,122476,122477,0,1,0
34897,3,1,122479,122479,122480,0,1,2
34898,6,1,122485,122485,122486,0,1,5
34899,1,2,122486,122486,122488,0,2,0
34900,4,3,122490,122490,122493,0,3,2
34901,1,2,122491,122493,122495,2,4,0
34902,4,1,122495,122495,122496,0,1,0
34903,1,2,122496,122496,122498,0,2,0
34904,1,2,122497,122498,122500,1,3,0
34905,5,1,122502,122502,122503,0,1,2
34906,4,3,122506,122506,122509,0,3,3
34907,6,3,122512,122512,122515,0,3,3
34908,5,2,122517,122517,122519,0,2,2
34909,1,3,122518,122519,122522,1,4,0
34910,4,2,122522,122522,122524,0,2,0
34911,5,3,122527,122527,122530,0,3,3
34912,5,2,122532,122532,122534,0,2,2
34913,2,3,122534,122534,122537,0,3,0
34914,5,3,122539,122539,122542,0,3,2
34915,3,1,122542,122542,122543,0,1,0
34916,6,1,122548,122548,122549,0,1,5
34917,1,1,122549,122549,122550,0,1,0
34918,1,3,122550,122550,122553,0,3,0
34919,6,1,122556,122556,122557,0,1,3
34920,1,2,122557,122557,122559,0,2,0
34921,1,1,122558,122559,122560,1,2,0
34922,2,3,122560,122560,122563,0,3,0
34923,3,3,122563,122563,122566,0,3,0
34924,5,3,122568,122568,122571,0,3,2
34925,1,3,122569,122571,122574,2,5,0
34926,1,1,122570,122574,122575,4,5,0
34927,3,3,122573,122575,122578,2,5,0
34928,6,1,122579,122579,122580,0,1,1
34929,1,1,122580,122580,122581,0,1,0
34930,1,3,122581,122581,122584,0,3,0
34931,3,3,122584,122584,122587,0,3,0
34932,3,1,122587,122587,122588,0,1,0
34933,2,1,122589,122589,122590,0,1,1
34934,5,2,122594,122594,122596,0,2,4
34935,1,1,122595,122596,122597,1,2,0
34936,5,1,122600,122600,122601,0,1,3
34937,2,2,122602,122602,122604,0,2,1
34938,1,3,122603,122604,122607,1,4,0
34939,2,2,122605,122607,122609,2,4,0
34940,1,1,122606,122609,122610,3,4,0
34941,2,1,122608,122610,122611,2,3,0
34942,3,3,122611,122611,122614,0,3,0
34943,2,1,122613,122614,122615,1,2,0
34944,3,3,122616,122616,122619,0,3,1
34945,1,1,122617,122619,122620,2,3,0
34946,5,2,122622,122622,122624,0,2,2
34947,1,2,122623,122624,122626,1,3,0
34948,1,2,122624,122626,122628,2,4,0
34949,2,2,122626,122628,122630,2,4,0
34950,3,1,122629,122630,122631,1,2,0
34951,1,2,122630,122631,122633,1,3,0
34952,5,1,122635,122635,122636,0,1,2
34953,1,3,122636,122636,122639,0,3,0
34954,4,1,122640,122640,122641,0,1,1
34955,6,3,122646,122646,122649,0,3,5
34956,5,3,122651,122651,122654,0,3,2
34957,6,1,122657,122657,122658,0,1,3
34958,3,2,122660,122660,122662,0,2,2
34959,1,3,122661,122662,122665,1,4,0
34960,5,1,122666,122666,122667,0,1,1
34961,3,3,122669,122669,122672,0,3,2
34962,4,3,122673,122673,122676,0,3,1
34963,2,1,122675,122676,122677,1,2,0
34964,4,1,122679,122679,122680,0,1,2
34965,4,3,122683,122683,122686,0,3,3
34966,6,3,122689,122689,122692,0,3,3
34967,1,2,122690,122692,122694,2,4,0
34968,2,2,122692,122694,122696,2,4,0
34969,4,1,122696,122696,122697,0,1,0
34970,1,1,122697,122697,122698,0,1,0
34971,6,1,122703,122703,122704,0,1,5
34972,6,2,122709,122709,122711,0,2,5
34973,1,2,122710,122711,122713,1,3,0
34974,3,2,122713,122713,122715,0,2,0
34975,4,3,122717,122717,122720,0,3,2
34976,6,2,122723,122723,122725,0,2,3
34977,6,3,122729,122729,122732,0,3,4
34978,5,2,122734,122734,122736,0,2,2
34979,4,2,122738,122738,122740,0,2,2
34980,3,3,122741,122741,122744,0,3,1
34981,1,1,122742,122744,122745,2,3,0
34982,5,2,122747,122747,122749,0,2,2
34983,1,2,122748,122749,122751,1,3,0
34984,6,2,122754,122754,122756,0,2,3
34985,6,1,122760,122760,122761,0,1,4
34986,3,3,122763,122763,122766,0,3,2
34987,5,1,122768,122768,122769,0,1,2
34988,4,3,122772,122772,122775,0,3,3
34989,5,1,122777,122777,122778,0,1,2
34990,3,1,122780,122780,122781,0,1,2
34991,3,1,122783,122783,122784,0,1,2
34992,4,1,122787,122787,122788,0,1,3
34993,3,3,122790,122790,122793,0,3,2
34994,4,1,122794,122794,122795,0,1,1
34995,3,2,122797,122797,122799,0,2,2
34996,6,3,122803,122803,122806,0,3,4
34997,1,3,122804,122806,122809,2,5,0
34998,1,1,122805,122809,122810,4,5,0
34999,4,1,122809,122810,122811,1,2,0
35000,1,3,122810,122811,122814,1,4,0
35001,3,3,122813,122814,122817,1,4,0
35002,1,3,122814,122817,122820,3,6,0
35003,6,2,122820,122820,122822,0,2,0
35004,1,2,122821,122822,122824,1,3,0
35005,4,2,122825,122825,122827,0,2,1
35006,1,2,122826,122827,122829,1,3,0
35007,3,1,122829,122829,122830,0,1,0
35008,2,2,122831,122831,122833,0,2,1
35009,5,3,122836,122836,122839,0,3,3
35010,2,2,122838,122839,122841,1,3,0
35011,4,2,122842,122842,122844,0,2,1
35012,2,1,122844,122844,122845,0,1,0
35013,6,2,122850,122850,122852,0,2,5
35014,1,2,122851,122852,122854,1,3,0
35015,3,1,122854,122854,122855,0,1,0
35016,2,2,122856,122856,122858,0,2,1
35017,4,1,122860,122860,122861,0,1,2
35018,5,3,122865,122865,122868,0,3,4
35019,1,1,122866,122868,122869,2,3,0
35020,1,1,122867,122869,122870,2,3,0
35021,5,2,122872,122872,122874,0,2,2
35022,2,1,122874,122874,122875,0,1,0
35023,5,2,122879,122879,122881,0,2,4
35024,6,3,122885,122885,122888,0,3,4
35025,2,1,122887,122888,122889,1,2,0
35026,4,2,122891,122891,122893,0,2,2
35027,3,3,122894,122894,122897,0,3,1
35028,1,2,122895,122897,122899,2,4,0
35029,3,3,122898,122899,122902,1,4,0
35030,5,1,122903,122903,122904,0,1,1
35031,3,1,122906,122906,122907,0,1,2
35032,2,1,122908,122908,122909,0,1,1
35033,6,2,122914,122914,122916,0,2,5
35034,1,3,122915,122916,122919,1,4,0
35035,6,1,122921,122921,122922,0,1,2
35036,1,1,122922,122922,122923,0,1,0
35037,2,1,122924,122924,122925,0,1,1
35038,1,1,122925,122925,122926,0,1,0
35039,4,1,122929,122929,122930,0,1,3
35040,2,1,122931,122931,122932,0,1,1
35041,1,2,122932,122932,122934,0,2,0
35042,4,1,122936,122936,122937,0,1,2
35043,5,3,122941,122941,122944,0,3,4
35044,5,1,122946,122946,122947,0,1,2
35045,4,3,122950,122950,122953,0,3,3
35046,4,3,122954,122954,122957,0,3,1
35047,1,2,122955,122957,122959,2,4,0
35048,2,2,122957,122959,122961,2,4,0
35049,5,2,122962,122962,122964,0,2,1
35050,4,2,122966,122966,122968,0,2,2
35051,5,2,122971,122971,122973,0,2,3
35052,2,1,122973,122973,122974,0,1,0
35053,3,2,122976,122976,122978,0,2,2
35054,6,2,122982,122982,122984,0,2,4
35055,6,1,122988,122988,122989,0,1,4
35056,6,1,122994,122994,122995,0,1,5
35057,1,2,122995,122995,122997,0,2,0
35058,5,2,123000,123000,123002,0,2,3
35059,6,3,123006,123006,123009,0,3,4
35060,5,1,123011,123011,123012,0,1,2
35061,2,1,123013,123013,123014,0,1,1
35062,3,2,123016,123016,123018,0,2,2
35063,2,2,123018,123018,123020,0,2,0
35064,5,1,123023,123023,123024,0,1,3
35065,2,1,123025,123025,123026,0,1,1
35066,2,2,123027,123027,123029,0,2,1
35067,2,1,123029,123029,123030,0,1,0
35068,2,2,123031,123031,123033,0,2,1
35069,4,3,123035,123035,123038,0,3,2
35070,1,2,123036,123038,123040,2,4,0
35071,1,1,123037,123040,123041,3,4,0
35072,1,3,123038,123041,123044,3,6,0
35073,2,2,123040,123044,123046,4,6,0
35074,1,3,123041,123046,123049,5,8,0
35075,5,1,123046,123049,123050,3,4,0
35076,3,1,123049,123050,123051,1,2,0
35077,3,1,123052,123052,123053,0,1,1
35078,3,1,123055,123055,123056,0,1,2
35079,2,1,123057,123057,123058,0,1,1
35080,3,2,123060,123060,123062,0,2,2
35081,6,1,123066,123066,123067,0,1,4
35082,2,2,123068,123068,123070,0,2,1
35083,1,3,123069,123070,123073,1,4,0
35084,6,2,123075,123075,123077,0,2,2
35085,1,3,123076,123077,123080,1,4,0
35086,6,1,123082,123082,123083,0,1,2
35087,2,2,123084,123084,123086,0,2,1
35088,4,2,123088,123088,123090,0,2,2
35089,6,2,123094,123094,123096,0,2,4
35090,2,2,123096,123096,123098,0,2,0
35091,5,3,123101,123101,123104,0,3,3
35092,3,1,123104,123104,123105,0,1,0
35093,6,2,123110,123110,123112,0,2,5
35094,1,3,123111,123112,123115,1,4,0
35095,2,1,123113,123115,123116,2,3,0
35096,6,2,123119,123119,123121,0,2,3
35097,4,1,123123,123123,123124,0,1,2
35098,6,1,123129,123129,123130,0,1,5
35099,5,3,123134,123134,123137,0,3,4
35100,3,3,123137,123137,123140,0,3,0
35101,3,3,123140,123140,123143,0,3,0
35102,6,3,123146,123146,123149,0,3,3
35103,4,1,123150,123150,123151,0,1,1
35104,5,3,123155,123155,123158,0,3,4
35105,2,1,123157,123158,123159,1,2,0
35106,1,1,123158,123159,123160,1,2,0
35107,3,2,123161,123161,123163,0,2,1
35108,5,3,123166,123166,123169,0,3,3
35109,2,2,123168,123169,123171,1,3,0
35110,3,3,123171,123171,123174,0,3,0
35111,4,2,123175,123175,123177,0,2,1
35112,4,3,123179,123179,123182,0,3,2
35113,4,1,123183,123183,123184,0,1,1
35114,5,1,123188,123188,123189,0,1,4
35115,3,1,123191,123191,123192,0,1,2
35116,3,3,123194,123194,123197,0,3,2
35117,6,3,123200,123200,123203,0,3,3
35118,5,2,123205,123205,123207,0,2,2
35119,6,2,123211,123211,123213,0,2,4
35120,5,2,123216,123216,123218,0,2,3
35121,3,1,123219,123219,123220,0,1,1
35122,5,2,123224,123224,123226,0,2,4
35123,6,3,123230,123230,123233,0,3,4
35124,1,3,123231,123233,123236,2,5,0
35125,5,1,123236,123236,123237,0,1,0
35126,3,2,123239,123239,123241,0,2,2
35127,6,2,123245,123245,123247,0,2,4
35128,5,2,123250,123250,123252,0,2,3
35129,3,3,123253,123253,123256,0,3,1
35130,4,3,123257,123257,123260,0,3,1
35131,6,1,123263,123263,123264,0,1,3
35132,5,3,123268,123268,123271,0,3,4
35133,4,2,123272,123272,123274,0,2,1
35134,3,2,123275,123275,123277,0,2,1
35135,3,3,123278,123278,123281,0,3,1
35136,3,1,123281,123281,123282,0,1,0
35137,4,3,123285,123285,123288,0,3,3
35138,1,3,123286,123288,123291,2,5,0
35139,3,2,123289,123291,123293,2,4,0
35140,2,1,123291,123293,123294,2,3,0
35141,4,1,123295,123295,123296,0,1,1
35142,3,2,123298,123298,123300,0,2,2
35143,3,1,123301,123301,123302,0,1,1
35144,6,2,123307,123307,123309,0,2,5
35145,4,2,123311,123311,123313,0,2,2
35146,6,2,123317,123317,123319,0,2,4
35147,2,3,123319,123319,123322,0,3,0
35148,3,1,123322,123322,123323,0,1,0
35149,2,1,123324,123324,123325,0,1,1
35150,4,1,123328,123328,123329,0,1,3
35151,4,1,123332,123332,123333,0,1,3
35152,1,2,123333,123333,123335,0,2,0
35153,3,1,123336,123336,123337,0,1,1
35154,2,1,123338,123338,123339,0,1,1
35155,2,1,123340,123340,123341,0,1,1
35156,5,3,123345,123345,123348,0,3,4
35157,4,3,123349,123349,123352,0,3,1
35158,6,2,123355,123355,123357,0,2,3
35159,1,2,123356,123357,123359,1,3,0
35160,1,3,123357,123359,123362,2,5,0
35161,5,1,123362,123362,123363,0,1,0
35162,5,2,123367,123367,123369,0,2,4
35163,3,1,123370,123370,123371,0,1,1
35164,2,1,123372,123372,123373,0,1,1
35165,2,1,123374,123374,123375,0,1,1
35166,6,1,123380,123380,123381,0,1,5
35167,1,3,123381,123381,123384,0,3,0
35168,1,2,123382,123384,123386,2,4,0
35169,6,2,123388,123388,123390,0,2,2
35170,2,2,123390,123390,123392,0,2,0
35171,2,1,123392,123392,123393,0,1,0
35172,2,1,123394,123394,123395,0,1,1
35173,5,2,123399,123399,123401,0,2,4
35174,1,3,123400,123401,123404,1,4,0
35175,5,2,123405,123405,123407,0,2,1
35176,5,2,123410,123410,123412,0,2,3
35177,1,1,123411,123412,123413,1,2,0
35178,4,1,123415,123415,123416,0,1,2
35179,1,3,123416,123416,123419,0,3,0
35180,4,1,123420,123420,123421,0,1,1
35181,5,3,123425,123425,123428,0,3,4
35182,1,1,123426,123428,123429,2,3,0
35183,6,1,123432,123432,123433,0,1,3
35184,4,2,123436,123436,123438,0,2,3
35185,2,1,123438,123438,123439,0,1,0
35186,5,3,123443,123443,123446,0,3,4
35187,4,3,123447,123447,123450,0,3,1
35188,3,1,123450,123450,123451,0,1,0
35189,6,3,123456,123456,123459,0,3,5
35190,1,1,123457,123459,123460,2,3,0
35191,2,3,123459,123460,123463,1,4,0
35192,2,2,123461,123463,123465,2,4,0
35193,2,3,123463,123465,123468,2,5,0
35194,4,3,123467,123468,123471,1,4,0
35195,1,3,123468,123471,123474,3,6,0
35196,2,1,123470,123474,123475,4,5,0
35197,6,2,123476,123476,123478,0,2,1
35198,1,2,123477,123478,123480,1,3,0
35199,3,1,123480,123480,123481,0,1,0
35200,5,1,123485,123485,123486,0,1,4
35201,5,2,123490,123490,123492,0,2,4
35202,5,3,123495,123495,123498,0,3,3
35203,1,3,123496,123498,123501,2,5,0
35204,4,2,123500,123501,123503,1,3,0
35205,1,1,123501,123503,123504,2,3,0
35206,2,3,123503,123504,123507,1,4,0
35207,3,3,123506,123507,123510,1,4,0
35208,3,1,123509,123510,123511,1,2,0
35209,3,3,123512,123512,123515,0,3,1
35210,4,3,123516,123516,123519,0,3,1
35211,6,1,123522,123522,123523,0,1,3
35212,4,3,123526,123526,123529,0,3,3
35213,3,3,123529,123529,123532,0,3,0
35214,6,2,123535,123535,123537,0,2,3
35215,6,2,123541,123541,123543,0,2,4
35216,6,2,123547,123547,123549,0,2,4
35217,6,3,123553,123553,123556,0,3,4
35218,4,2,123557,123557,123559,0,2,1
35219,4,2,123561,123561,123563,0,2,2
35220,1,2,123562,123563,123565,1,3,0
35221,1,2,123563,123565,123567,2,4,0
35222,3,3,123566,123567,123570,1,4,0
35223,4,3,123570,123570,123573,0,3,0
35224,6,3,123576,123576,123579,0,3,3
35225,4,2,123580,123580,123582,0,2,1
35226,2,3,123582,123582,123585,0,3,0
35227,6,2,123588,123588,123590,0,2,3
35228,2,1,123590,123590,123591,0,1,0
35229,1,3,123591,123591,123594,0,3,0
35230,5,2,123596,123596,123598,0,2,2
35231,5,2,123601,123601,123603,0,2,3
35232,2,1,123603,123603,123604,0,1,0
35233,5,3,123608,123608,123611,0,3,4
35234,4,3,123612,123612,123615,0,3,1
35235,2,1,123614,123615,123616,1,2,0
35236,6,1,123620,123620,123621,0,1,4
35237,6,3,123626,123626,123629,0,3,5
35238,4,1,123630,123630,123631,0,1,1
35239,5,3,123635,123635,123638,0,3,4
35240,6,1,123641,123641,123642,0,1,3
35241,4,3,123645,123645,123648,0,3,3
35242,1,1,123646,123648,123649,2,3,0
35243,3,3,123649,123649,123652,0,3,0
35244,4,3,123653,123653,123656,0,3,1
35245,2,2,123655,123656,123658,1,3,0
35246,5,2,123660,123660,123662,0,2,2
35247,5,3,123665,123665,123668,0,3,3
35248,5,3,123670,123670,123673,0,3,2
35249,6,3,123676,123676,123679,0,3,3
35250,1,3,123677,123679,123682,2,5,0
35251,2,3,123679,123682,123685,3,6,0
35252,6,1,123685,123685,123686,0,1,0
35253,5,1,123690,123690,123691,0,1,4
35254,2,2,123692,123692,123694,0,2,1
35255,6,1,123698,123698,123699,0,1,4
35256,6,3,123704,123704,123707,0,3,5
35257,4,2,123708,123708,123710,0,2,1
35258,1,2,123709,123710,123712,1,3,0
35259,2,2,123711,123712,123714,1,3,0
35260,4,3,123715,123715,123718,0,3,1
35261,3,3,123718,123718,123721,0,3,0
35262,3,1,123721,123721,123722,0,1,0
35263,5,3,123726,123726,123729,0,3,4
35264,3,2,123729,123729,123731,0,2,0
35265,1,1,123730,123731,123732,1,2,0
35266,3,1,123733,123733,123734,0,1,1
35267,4,1,123737,123737,123738,0,1,3
35268,3,3,123740,123740,123743,0,3,2
35269,3,2,123743,123743,123745,0,2,0
35270,3,3,123746,123746,123749,0,3,1
35271,1,1,123747,123749,123750,2,3,0
35272,4,3,123751,123751,123754,0,3,1
35273,1,2,123752,123754,123756,2,4,0
35274,3,3,123755,123756,123759,1,4,0
35275,1,1,123756,123759,123760,3,4,0
35276,4,2,123760,123760,123762,0,2,0
35277,6,1,123766,123766,123767,0,1,4
35278,1,3,123767,123767,123770,0,3,0
35279,2,3,123769,123770,123773,1,4,0
35280,4,3,123773,123773,123776,0,3,0
35281,5,2,123778,123778,123780,0,2,2
35282,6,1,123784,123784,123785,0,1,4
35283,4,2,123788,123788,123790,0,2,3
35284,1,1,123789,123790,123791,1,2,0
35285,2,3,123791,123791,123794,0,3,0
35286,6,1,123797,123797,123798,0,1,3
35287,1,3,123798,123798,123801,0,3,0
35288,5,3,123803,123803,123806,0,3,2
35289,2,3,123805,123806,123809,1,4,0
35290,2,2,123807,123809,123811,2,4,0
35291,3,3,123810,123811,123814,1,4,0
35292,6,1,123816,123816,123817,0,1,2
35293,1,2,123817,123817,123819,0,2,0
35294,2,2,123819,123819,123821,0,2,0
35295,3,1,123822,123822,123823,0,1,1
35296,4,2,123826,123826,123828,0,2,3
35297,3,1,123829,123829,123830,0,1,1
35298,6,1,123835,123835,123836,0,1,5
35299,1,1,123836,123836,123837,0,1,0
35300,1,3,123837,123837,123840,0,3,0
35301,5,2,123842,123842,123844,0,2,2
35302,2,1,123844,123844,123845,0,1,0
35303,1,3,123845,123845,123848,0,3,0
35304,1,1,123846,123848,123849,2,3,0
35305,3,1,123849,123849,123850,0,1,0
35306,6,1,123855,123855,123856,0,1,5
35307,1,1,123856,123856,123857,0,1,0
35308,1,1,123857,123857,123858,0,1,0
35309,4,2,123861,123861,123863,0,2,3
35310,2,2,123863,123863,123865,0,2,0
35311,4,1,123867,123867,123868,0,1,2
35312,1,3,123868,123868,123871,0,3,0
35313,5,1,123873,123873,123874,0,1,2
35314,4,3,123877,123877,123880,0,3,3
35315,6,1,123883,123883,123884,0,1,3
35316,4,1,123887,123887,123888,0,1,3
35317,3,2,123890,123890,123892,0,2,2
35318,3,1,123893,123893,123894,0,1,1
35319,4,1,123897,123897,123898,0,1,3
35320,6,2,123903,123903,123905,0,2,5
35321,3,3,123906,123906,123909,0,3,1
35322,6,3,123912,123912,123915,0,3,3
35323,5,1,123917,123917,123918,0,1,2
35324,6,3,123923,123923,123926,0,3,5
35325,5,3,123928,123928,123931,0,3,2
35326,3,3,123931,123931,123934,0,3,0
35327,1,2,123932,123934,123936,2,4,0
35328,3,1,123935,123936,123937,1,2,0
35329,3,1,123938,123938,123939,0,1,1
35330,4,3,123942,123942,123945,0,3,3
35331,6,3,123948,123948,123951,0,3,3
35332,3,1,123951,123951,123952,0,1,0
35333,6,1,123957,123957,123958,0,1,5
35334,2,3,123959,123959,123962,0,3,1
35335,2,1,123961,123962,123963,1,2,0
35336,6,3,123967,123967,123970,0,3,4
35337,6,2,123973,123973,123975,0,2,3
35338,4,2,123977,123977,123979,0,2,2
35339,2,3,123979,123979,123982,0,3,0
35340,5,2,123984,123984,123986,0,2,2
35341,2,3,123986,123986,123989,0,3,0
35342,1,2,123987,123989,123991,2,4,0
35343,3,2,123990,123991,123993,1,3,0
35344,1,3,123991,123993,123996,2,5,0
35345,1,2,123992,123996,123998,4,6,0
35346,1,2,123993,123998,124000,5,7,0
35347,6,3,123999,124000,124003,1,4,0
35348,4,3,124003,124003,124006,0,3,0
35349,5,2,124008,124008,124010,0,2,2
35350,4,1,124012,124012,124013,0,1,2
35351,2,1,124014,124014,124015,0,1,1
35352,3,3,124017,124017,124020,0,3,2
35353,6,3,124023,124023,124026,0,3,3
35354,1,2,124024,124026,124028,2,4,0
35355,4,2,124028,124028,124030,0,2,0
35356,3,2,124031,124031,124033,0,2,1
35357,3,2,124034,124034,124036,0,2,1
35358,1,1,124035,124036,124037,1,2,0
35359,4,3,124039,124039,124042,0,3,2
35360,2,3,124041,124042,124045,1,4,0
35361,5,2,124046,124046,124048,0,2,1
35362,2,1,124048,124048,124049,0,1,0
35363,3,1,124051,124051,124052,0,1,2
35364,1,1,124052,124052,124053,0,1,0
35365,2,2,124054,124054,124056,0,2,1
35366,5,3,124059,124059,124062,0,3,3
35367,4,1,124063,124063,124064,0,1,1
35368,3,2,124066,124066,124068,0,2,2
35369,1,3,124067,124068,124071,1,4,0
35370,1,1,124068,124071,124072,3,4,0
35371,4,1,124072,124072,124073,0,1,0
35372,3,3,124075,124075,124078,0,3,2
35373,6,2,124081,124081,124083,0,2,3
35374,5,2,124086,124086,124088,0,2,3
35375,2,2,124088,124088,124090,0,2,0
35376,6,1,124094,124094,124095,0,1,4
35377,4,1,124098,124098,124099,0,1,3
35378,4,1,124102,124102,124103,0,1,3
35379,6,3,124108,124108,124111,0,3,5
35380,1,1,124109,124111,124112,2,3,0
35381,3,2,124112,124112,124114,0,2,0
35382,3,1,124115,124115,124116,0,1,1
35383,3,1,124118,124118,124119,0,1,2
35384,4,3,124122,124122,124125,0,3,3
35385,2,2,124124,124125,124127,1,3,0
35386,5,1,124129,124129,124130,0,1,2
35387,4,3,124133,124133,124136,0,3,3
35388,1,3,124134,124136,124139,2,5,0
35389,2,3,124136,124139,124142,3,6,0
35390,5,1,124141,124142,124143,1,2,0
35391,1,2,124142,124143,124145,1,3,0
35392,5,1,124147,124147,124148,0,1,2
35393,6,3,124153,124153,124156,0,3,5
35394,6,3,124159,124159,124162,0,3,3
35395,3,1,124162,124162,124163,0,1,0
35396,6,3,124168,124168,124171,0,3,5
35397,2,3,124170,124171,124174,1,4,0
35398,4,3,124174,124174,124177,0,3,0
35399,2,2,124176,124177,124179,1,3,0
35400,3,3,124179,124179,124182,0,3,0
35401,2,1,124181,124182,124183,1,2,0
35402,5,3,124186,124186,124189,0,3,3
35403,4,3,124190,124190,124193,0,3,1
35404,4,1,124194,124194,124195,0,1,1
35405,2,3,124196,124196,124199,0,3,1
35406,6,2,124202,124202,124204,0,2,3
35407,4,1,124206,124206,124207,0,1,2
35408,4,3,124210,124210,124213,0,3,3
35409,6,3,124216,124216,124219,0,3,3
35410,5,2,124221,124221,124223,0,2,2
35411,6,1,124227,124227,124228,0,1,4
35412,4,3,124231,124231,124234,0,3,3
35413,1,1,124232,124234,124235,2,3,0
35414,3,1,124235,124235,124236,0,1,0
35415,5,3,124240,124240,124243,0,3,4
35416,6,2,124246,124246,124248,0,2,3
35417,6,1,124252,124252,124253,0,1,4
35418,2,1,124254,124254,124255,0,1,1
35419,3,1,124257,124257,124258,0,1,2
35420,4,2,124261,124261,124263,0,2,3
35421,4,1,124265,124265,124266,0,1,2
35422,6,2,124271,124271,124273,0,2,5
35423,2,1,124273,124273,124274,0,1,0
35424,2,2,124275,124275,124277,0,2,1
35425,2,2,124277,124277,124279,0,2,0
35426,1,3,124278,124279,124282,1,4,0
35427,2,1,124280,124282,124283,2,3,0
35428,1,1,124281,124283,124284,2,3,0
35429,4,2,124285,124285,124287,0,2,1
35430,1,2,124286,124287,124289,1,3,0
35431,2,2,124288,124289,124291,1,3,0
35432,1,3,124289,124291,124294,2,5,0
35433,5,3,124294,124294,124297,0,3,0
35434,6,2,124300,124300,124302,0,2,3
35435,6,1,124306,124306,124307,0,1,4
35436,3,3,124309,124309,124312,0,3,2
35437,5,3,124314,124314,124317,0,3,2
35438,3,2,124317,124317,124319,0,2,0
35439,1,3,124318,124319,124322,1,4,0
35440,6,2,124324,124324,124326,0,2,2
35441,1,2,124325,124326,124328,1,3,0
35442,6,3,124331,124331,124334,0,3,3
35443,2,2,124333,124334,124336,1,3,0
35444,6,3,124339,124339,124342,0,3,3
35445,5,2,124344,124344,124346,0,2,2
35446,5,2,124349,124349,124351,0,2,3
35447,5,3,124354,124354,124357,0,3,3
35448,5,2,124359,124359,124361,0,2,2
35449,2,2,124361,124361,124363,0,2,0
35450,6,2,124367,124367,124369,0,2,4
35451,3,3,124370,124370,124373,0,3,1
35452,5,1,124375,124375,124376,0,1,2
35453,6,3,124381,124381,124384,0,3,5
35454,2,2,124383,124384,124386,1,3,0
35455,3,3,124386,124386,124389,0,3,0
35456,6,1,124392,124392,124393,0,1,3
35457,3,3,124395,124395,124398,0,3,2
35458,4,3,124399,124399,124402,0,3,1
35459,1,1,124400,124402,124403,2,3,0
35460,1,2,124401,124403,124405,2,4,0
35461,4,1,124405,124405,124406,0,1,0
35462,4,1,124409,124409,124410,0,1,3
35463,4,1,124413,124413,124414,0,1,3
35464,6,2,124419,124419,124421,0,2,5
35465,4,3,124423,124423,124426,0,3,2
35466,2,2,124425,124426,124428,1,3,0
35467,6,3,124431,124431,124434,0,3,3
35468,4,2,124435,124435,124437,0,2,1
35469,2,2,124437,124437,124439,0,2,0
35470,2,3,124439,124439,124442,0,3,0
35471,3,2,124442,124442,124444,0,2,0
35472,6,3,124448,124448,124451,0,3,4
35473,1,3,124449,124451,124454,2,5,0
35474,4,1,124453,124454,124455,1,2,0
35475,5,1,124458,124458,124459,0,1,3
35476,1,1,124459,124459,124460,0,1,0
35477,1,3,124460,124460,124463,0,3,0
35478,3,3,124463,124463,124466,0,3,0
35479,1,1,124464,124466,124467,2,3,0
35480,1,2,124465,124467,124469,2,4,0
35481,1,1,124466,124469,124470,3,4,0
35482,1,3,124467,124470,124473,3,6,0
35483,6,3,124473,124473,124476,0,3,0
35484,2,1,124475,124476,124477,1,2,0
35485,3,3,124478,124478,124481,0,3,1
35486,1,3,124479,124481,124484,2,5,0
35487,4,1,124483,124484,124485,1,2,0
35488,5,2,124488,124488,124490,0,2,3
35489,1,1,124489,124490,124491,1,2,0
35490,5,1,124494,124494,124495,0,1,3
35491,2,3,124496,124496,124499,0,3,1
35492,6,3,124502,124502,124505,0,3,3
35493,6,1,124508,124508,124509,0,1,3
35494,5,3,124513,124513,124516,0,3,4
35495,3,1,124516,124516,124517,0,1,0
35496,5,1,124521,124521,124522,0,1,4
35497,3,2,124524,124524,124526,0,2,2
35498,6,3,124530,124530,124533,0,3,4
35499,6,3,124536,124536,124539,0,3,3
35500,5,3,124541,124541,124544,0,3,2
35501,3,3,124544,124544,124547,0,3,0
35502,4,2,124548,124548,124550,0,2,1
35503,2,3,124550,124550,124553,0,3,0
35504,4,2,124554,124554,124556,0,2,1
35505,5,2,124559,124559,124561,0,2,3
35506,2,1,124561,124561,124562,0,1,0
35507,6,2,124567,124567,124569,0,2,5
35508,2,2,124569,124569,124571,0,2,0
35509,3,2,124572,124572,124574,0,2,1
35510,6,2,124578,124578,124580,0,2,4
35511,1,1,124579,124580,124581,1,2,0
35512,2,3,124581,124581,124584,0,3,0
35513,1,2,124582,124584,124586,2,4,0
35514,2,3,124584,124586,124589,2,5,0
35515,2,3,124586,124589,124592,3,6,0
35516,1,2,124587,124592,124594,5,7,0
35517,4,2,124591,124594,124596,3,5,0
35518,4,2,124595,124596,124598,1,3,0
35519,1,3,124596,124598,124601,2,5,0
35520,6,2,124602,124602,124604,0,2,1
35521,5,3,124607,124607,124610,0,3,3
35522,4,1,124611,124611,124612,0,1,1
35523,1,3,124612,124612,124615,0,3,0
35524,4,2,124616,124616,124618,0,2,1
35525,1,2,124617,124618,124620,1,3,0
35526,3,3,124620,124620,124623,0,3,0
35527,5,3,124625,124625,124628,0,3,2
35528,2,3,124627,124628,124631,1,4,0
35529,3,3,124630,124631,124634,1,4,0
35530,1,2,124631,124634,124636,3,5,0
35531,5,3,124636,124636,124639,0,3,0
35532,4,1,124640,124640,124641,0,1,1
35533,6,2,124646,124646,124648,0,2,5
35534,1,2,124647,124648,124650,1,3,0
35535,3,3,124650,124650,124653,0,3,0
35536,3,2,124653,124653,124655,0,2,0
35537,3,3,124656,124656,124659,0,3,1
35538,1,3,124657,124659,124662,2,5,0
35539,3,3,124660,124662,124665,2,5,0
35540,4,2,124664,124665,124667,1,3,0
35541,6,3,124670,124670,124673,0,3,3
35542,6,2,124676,124676,124678,0,2,3
35543,5,3,124681,124681,124684,0,3,3
35544,1,2,124682,124684,124686,2,4,0
35545,5,3,124687,124687,124690,0,3,1
35546,6,3,124693,124693,124696,0,3,3
35547,6,2,124699,124699,124701,0,2,3
35548,3,3,124702,124702,124705,0,3,1
35549,2,3,124704,124705,124708,1,4,0
35550,5,3,124709,124709,124712,0,3,1
35551,6,2,124715,124715,124717,0,2,3
35552,5,1,124720,124720,124721,0,1,3
35553,5,3,124725,124725,124728,0,3,4
35554,6,2,124731,124731,124733,0,2,3
35555,2,2,124733,124733,124735,0,2,0
35556,4,1,124737,124737,124738,0,1,2
35557,3,3,124740,124740,124743,0,3,2
35558,1,3,124741,124743,124746,2,5,0
35559,1,3,124742,124746,124749,4,7,0
35560,3,3,124745,124749,124752,4,7,0
35561,1,1,124746,124752,124753,6,7,0
35562,6,1,124752,124753,124754,1,2,0
35563,2,3,124754,124754,124757,0,3,0
35564,3,3,124757,124757,124760,0,3,0
35565,5,1,124762,124762,124763,0,1,2
35566,2,3,124764,124764,124767,0,3,1
35567,3,2,124767,124767,124769,0,2,0
35568,4,1,124771,124771,124772,0,1,2
35569,6,1,124777,124777,124778,0,1,5
35570,4,3,124781,124781,124784,0,3,3
35571,4,2,124785,124785,124787,0,2,1
35572,2,1,124787,124787,124788,0,1,0
35573,4,1,124791,124791,124792,0,1,3
35574,4,2,124795,124795,124797,0,2,3
35575,2,2,124797,124797,124799,0,2,0
35576,5,3,124802,124802,124805,0,3,3
35577,6,1,124808,124808,124809,0,1,3
35578,5,3,124813,124813,124816,0,3,4
35579,1,1,124814,124816,124817,2,3,0
35580,1,1,124815,124817,124818,2,3,0
35581,5,1,124820,124820,124821,0,1,2
35582,1,3,124821,124821,124824,0,3,0
35583,6,1,124827,124827,124828,0,1,3
35584,5,1,124832,124832,124833,0,1,4
35585,3,3,124835,124835,124838,0,3,2
35586,5,1,124840,124840,124841,0,1,2
35587,4,2,124844,124844,124846,0,2,3
35588,1,2,124845,124846,124848,1,3,0
35589,5,3,124850,124850,124853,0,3,2
35590,4,2,124854,124854,124856,0,2,1
35591,1,1,124855,124856,124857,1,2,0
35592,3,1,124858,124858,124859,0,1,1
35593,1,3,124859,124859,124862,0,3,0
35594,4,3,124863,124863,124866,0,3,1
35595,1,2,124864,124866,124868,2,4,0
35596,4,3,124868,124868,124871,0,3,0
35597,1,1,124869,124871,124872,2,3,0
35598,4,3,124873,124873,124876,0,3,1
35599,4,1,124877,124877,124878,0,1,1
35600,2,1,124879,124879,124880,0,1,1
35601,6,2,124885,124885,124887,0,2,5
35602,5,3,124890,124890,124893,0,3,3
35603,5,2,124895,124895,124897,0,2,2
35604,5,2,124900,124900,124902,0,2,3
35605,2,1,124902,124902,124903,0,1,0
35606,2,1,124904,124904,124905,0,1,1
35607,1,2,124905,124905,124907,0,2,0
35608,1,1,124906,124907,124908,1,2,0
35609,5,2,124911,124911,124913,0,2,3
35610,4,3,124915,124915,124918,0,3,2
35611,3,3,124918,124918,124921,0,3,0
35612,4,2,124922,124922,124924,0,2,1
35613,5,2,124927,124927,124929,0,2,3
35614,1,3,124928,124929,124932,1,4,0
35615,2,3,124930,124932,124935,2,5,0
35616,5,1,124935,124935,124936,0,1,0
35617,3,2,124938,124938,124940,0,2,2
35618,1,3,124939,124940,124943,1,4,0
35619,6,1,124945,124945,124946,0,1,2
35620,4,1,124949,124949,124950,0,1,3
35621,1,3,124950,124950,124953,0,3,0
35622,4,1,124954,124954,124955,0,1,1
35623,4,3,124958,124958,124961,0,3,3
35624,5,2,124963,124963,124965,0,2,2
35625,3,2,124966,124966,124968,0,2,1
35626,3,3,124969,124969,124972,0,3,1
35627,6,3,124975,124975,124978,0,3,3
35628,6,3,124981,124981,124984,0,3,3
35629,4,2,124985,124985,124987,0,2,1
35630,5,2,124990,124990,124992,0,2,3
35631,1,1,124991,124992,124993,1,2,0
35632,1,3,124992,124993,124996,1,4,0
35633,6,3,124998,124998,125001,0,3,2
35634,4,3,125002,125002,125005,0,3,1
35635,4,1,125006,125006,125007,0,1,1
35636,6,2,125012,125012,125014,0,2,5
35637,4,2,125016,125016,125018,0,2,2
35638,2,2,125018,125018,125020,0,2,0
35639,1,3,125019,125020,125023,1,4,0
35640,4,1,125023,125023,125024,0,1,0
35641,5,1,125028,125028,125029,0,1,4
35642,1,3,125029,125029,125032,0,3,0
35643,4,2,125033,125033,125035,0,2,1
35644,1,2,125034,125035,125037,1,3,0
35645,3,2,125037,125037,125039,0,2,0
35646,4,3,125041,125041,125044,0,3,2
35647,1,2,125042,125044,125046,2,4,0
35648,5,1,125047,125047,125048,0,1,1
35649,4,3,125051,125051,125054,0,3,3
35650,1,2,125052,125054,125056,2,4,0
35651,3,1,125055,125056,125057,1,2,0
35652,1,3,125056,125057,125060,1,4,0
35653,2,2,125058,125060,125062,2,4,0
35654,1,1,125059,125062,125063,3,4,0
35655,5,1,125064,125064,125065,0,1,1
35656,1,2,125065,125065,125067,0,2,0
35657,1,2,125066,125067,125069,1,3,0
35658,6,1,125072,125072,125073,0,1,3
35659,2,1,125074,125074,125075,0,1,1
35660,2,2,125076,125076,125078,0,2,1
35661,5,3,125081,125081,125084,0,3,3
35662,3,1,125084,125084,125085,0,1,0
35663,2,2,125086,125086,125088,0,2,1
35664,5,1,125091,125091,125092,0,1,3
35665,4,3,125095,125095,125098,0,3,3
35666,3,3,125098,125098,125101,0,3,0
35667,1,3,125099,125101,125104,2,5,0
35668,2,3,125101,125104,125107,3,6,0
35669,6,2,125107,125107,125109,0,2,0
35670,2,2,125109,125109,125111,0,2,0
35671,1,3,125110,125111,125114,1,4,0
35672,1,2,125111,125114,125116,3,5,0
35673,4,2,125115,125116,125118,1,3,0
35674,6,2,125121,125121,125123,0,2,3
35675,1,3,125122,125123,125126,1,4,0
35676,4,3,125126,125126,125129,0,3,0
35677,5,3,125131,125131,125134,0,3,2
35678,5,2,125136,125136,125138,0,2,2
35679,5,1,125141,125141,125142,0,1,3
35680,6,2,125147,125147,125149,0,2,5
35681,1,1,125148,125149,125150,1,2,0
35682,2,3,125150,125150,125153,0,3,0
35683,4,3,125154,125154,125157,0,3,1
35684,3,1,125157,125157,125158,0,1,0
35685,2,2,125159,125159,125161,0,2,1
35686,6,3,125165,125165,125168,0,3,4
35687,1,2,125166,125168,125170,2,4,0
35688,5,2,125171,125171,125173,0,2,1
35689,5,3,125176,125176,125179,0,3,3
35690,1,1,125177,125179,125180,2,3,0
35691,6,1,125183,125183,125184,0,1,3
35692,2,3,125185,125185,125188,0,3,1
35693,6,3,125191,125191,125194,0,3,3
35694,6,2,125197,125197,125199,0,2,3
35695,2,3,125199,125199,125202,0,3,0
35696,4,1,125203,125203,125204,0,1,1
35697,2,2,125205,125205,125207,0,2,1
35698,3,3,125208,125208,125211,0,3,1
35699,6,2,125214,125214,125216,0,2,3
35700,5,1,125219,125219,125220,0,1,3
35701,6,2,125225,125225,125227,0,2,5
35702,1,2,125226,125227,125229,1,3,0
35703,6,1,125232,125232,125233,0,1,3
35704,6,3,125238,125238,125241,0,3,5
35705,4,2,125242,125242,125244,0,2,1
35706,2,3,125244,125244,125247,0,3,0
35707,5,3,125249,125249,125252,0,3,2
35708,4,3,125253,125253,125256,0,3,1
35709,2,3,125255,125256,125259,1,4,0
35710,6,1,125261,125261,125262,0,1,2
35711,5,3,125266,125266,125269,0,3,4
35712,2,2,125268,125269,125271,1,3,0
35713,2,2,125270,125271,125273,1,3,0
35714,6,1,125276,125276,125277,0,1,3
35715,1,3,125277,125277,125280,0,3,0
35716,3,3,125280,125280,125283,0,3,0
35717,1,3,125281,125283,125286,2,5,0
35718,3,1,125284,125286,125287,2,3,0
35719,2,3,125286,125287,125290,1,4,0
35720,5,3,125291,125291,125294,0,3,1
35721,1,2,125292,125294,125296,2,4,0
35722,6,1,125298,125298,125299,0,1,2
35723,2,3,125300,125300,125303,0,3,1
35724,4,1,125304,125304,125305,0,1,1
35725,4,1,125308,125308,125309,0,1,3
35726,3,3,125311,125311,125314,0,3,2
35727,6,2,125317,125317,125319,0,2,3
35728,4,2,125321,125321,125323,0,2,2
35729,3,1,125324,125324,125325,0,1,1
35730,1,2,125325,125325,125327,0,2,0
35731,2,2,125327,125327,125329,0,2,0
35732,5,1,125332,125332,125333,0,1,3
35733,1,3,125333,125333,125336,0,3,0
35734,5,2,125338,125338,125340,0,2,2
35735,3,3,125341,125341,125344,0,3,1
35736,3,1,125344,125344,125345,0,1,0
35737,3,3,125347,125347,125350,0,3,2
35738,1,1,125348,125350,125351,2,3,0
35739,1,1,125349,125351,125352,2,3,0
35740,1,2,125350,125352,125354,2,4,0
35741,1,1,125351,125354,125355,3,4,0
35742,4,2,125355,125355,125357,0,2,0
35743,6,2,125361,125361,125363,0,2,4
35744,5,2,125366,125366,125368,0,2,3
35745,2,2,125368,125368,125370,0,2,0
35746,6,1,125374,125374,125375,0,1,4
35747,2,1,125376,125376,125377,0,1,1
35748,5,1,125381,125381,125382,0,1,4
35749,4,2,125385,125385,125387,0,2,3
35750,2,3,125387,125387,125390,0,3,0
35751,2,1,125389,125390,125391,1,2,0
35752,1,2,125390,125391,125393,1,3,0
35753,4,2,125394,125394,125396,0,2,1
35754,3,1,125397,125397,125398,0,1,1
35755,1,2,125398,125398,125400,0,2,0
35756,4,2,125402,125402,125404,0,2,2
35757,2,3,125404,125404,125407,0,3,0
35758,3,1,125407,125407,125408,0,1,0
35759,5,3,125412,125412,125415,0,3,4
35760,3,2,125415,125415,125417,0,2,0
35761,2,3,125417,125417,125420,0,3,0
35762,6,2,125423,125423,125425,0,2,3
35763,1,2,125424,125425,125427,1,3,0
35764,1,3,125425,125427,125430,2,5,0
35765,3,3,125428,125430,125433,2,5,0
35766,3,2,125431,125433,125435,2,4,0
35767,5,3,125436,125436,125439,0,3,1
35768,4,2,125440,125440,125442,0,2,1
35769,3,2,125443,125443,125445,0,2,1
35770,6,3,125449,125449,125452,0,3,4
35771,1,2,125450,125452,125454,2,4,0
35772,1,1,125451,125454,125455,3,4,0
35773,3,2,125454,125455,125457,1,3,0
35774,2,3,125456,125457,125460,1,4,0
35775,3,1,125459,125460,125461,1,2,0
35776,6,1,125465,125465,125466,0,1,4
35777,2,1,125467,125467,125468,0,1,1
35778,3,1,125470,125470,125471,0,1,2
35779,5,2,125475,125475,125477,0,2,4
35780,3,1,125478,125478,125479,0,1,1
35781,2,3,125480,125480,125483,0,3,1
35782,6,2,125486,125486,125488,0,2,3
35783,4,3,125490,125490,125493,0,3,2
35784,6,3,125496,125496,125499,0,3,3
35785,6,3,125502,125502,125505,0,3,3
35786,4,1,125506,125506,125507,0,1,1
35787,6,3,125512,125512,125515,0,3,5
35788,5,3,125517,125517,125520,0,3,2
35789,5,3,125522,125522,125525,0,3,2
35790,6,2,125528,125528,125530,0,2,3
35791,3,1,125531,125531,125532,0,1,1
35792,2,3,125533,125533,125536,0,3,1
35793,4,3,125537,125537,125540,0,3,1
35794,3,2,125540,125540,125542,0,2,0
35795,6,2,125546,125546,125548,0,2,4
35796,3,2,125549,125549,125551,0,2,1
35797,2,3,125551,125551,125554,0,3,0
35798,4,1,125555,125555,125556,0,1,1
35799,2,1,125557,125557,125558,0,1,1
35800,1,1,125558,125558,125559,0,1,0
35801,5,1,125563,125563,125564,0,1,4
35802,4,3,125567,125567,125570,0,3,3
35803,1,3,125568,125570,125573,2,5,0
35804,4,3,125572,125573,125576,1,4,0
35805,3,2,125575,125576,125578,1,3,0
35806,1,2,125576,125578,125580,2,4,0
35807,1,3,125577,125580,125583,3,6,0
35808,5,1,125582,125583,125584,1,2,0
35809,2,1,125584,125584,125585,0,1,0
35810,2,1,125586,125586,125587,0,1,1
35811,1,1,125587,125587,125588,0,1,0
35812,3,3,125590,125590,125593,0,3,2
35813,4,2,125594,125594,125596,0,2,1
35814,6,3,125600,125600,125603,0,3,4
35815,2,2,125602,125603,125605,1,3,0
35816,6,1,125608,125608,125609,0,1,3
35817,3,2,125611,125611,125613,0,2,2
35818,3,3,125614,125614,125617,0,3,1
35819,2,2,125616,125617,125619,1,3,0
35820,4,1,125620,125620,125621,0,1,1
35821,3,2,125623,125623,125625,0,2,2
35822,1,1,125624,125625,125626,1,2,0
35823,2,1,125626,125626,125627,0,1,0
35824,4,2,125630,125630,125632,0,2,3
35825,2,2,125632,125632,125634,0,2,0
35826,6,1,125638,125638,125639,0,1,4
35827,5,3,125643,125643,125646,0,3,4
35828,1,1,125644,125646,125647,2,3,0
35829,5,2,125649,125649,125651,0,2,2
35830,6,2,125655,125655,125657,0,2,4
35831,2,1,125657,125657,125658,0,1,0
35832,3,2,125660,125660,125662,0,2,2
35833,6,2,125666,125666,125668,0,2,4
35834,5,1,125671,125671,125672,0,1,3
35835,1,1,125672,125672,125673,0,1,0
35836,6,3,125678,125678,125681,0,3,5
35837,1,1,125679,125681,125682,2,3,0
35838,1,3,125680,125682,125685,2,5,0
35839,1,2,125681,125685,125687,4,6,0
35840,3,1,125684,125687,125688,3,4,0
35841,5,3,125689,125689,125692,0,3,1
35842,3,3,125692,125692,125695,0,3,0
35843,1,1,125693,125695,125696,2,3,0
35844,2,3,125695,125696,125699,1,4,0
35845,6,2,125701,125701,125703,0,2,2
35846,5,1,125706,125706,125707,0,1,3
35847,5,1,125711,125711,125712,0,1,4
35848,1,2,125712,125712,125714,0,2,0
35849,5,1,125717,125717,125718,0,1,3
35850,5,1,125722,125722,125723,0,1,4
35851,3,1,125725,125725,125726,0,1,2
35852,1,2,125726,125726,125728,0,2,0
35853,1,3,125727,125728,125731,1,4,0
35854,1,3,125728,125731,125734,3,6,0
35855,3,1,125731,125734,125735,3,4,0
35856,5,2,125736,125736,125738,0,2,1
35857,4,3,125740,125740,125743,0,3,2
35858,6,2,125746,125746,125748,0,2,3
35859,2,3,125748,125748,125751,0,3,0
35860,4,1,125752,125752,125753,0,1,1
35861,4,1,125756,125756,125757,0,1,3
35862,3,2,125759,125759,125761,0,2,2
35863,1,3,125760,125761,125764,1,4,0
35864,6,3,125766,125766,125769,0,3,2
35865,4,2,125770,125770,125772,0,2,1
35866,3,1,125773,125773,125774,0,1,1
35867,2,1,125775,125775,125776,0,1,1
35868,1,1,125776,125776,125777,0,1,0
35869,3,3,125779,125779,125782,0,3,2
35870,3,1,125782,125782,125783,0,1,0
35871,3,2,125785,125785,125787,0,2,2
35872,6,2,125791,125791,125793,0,2,4
35873,6,2,125797,125797,125799,0,2,4
35874,1,2,125798,125799,125801,1,3,0
35875,3,3,125801,125801,125804,0,3,0
35876,4,3,125805,125805,125808,0,3,1
35877,6,3,125811,125811,125814,0,3,3
35878,5,2,125816,125816,125818,0,2,2
35879,6,3,125822,125822,125825,0,3,4
35880,1,1,125823,125825,125826,2,3,0
35881,5,1,125828,125828,125829,0,1,2
35882,2,1,125830,125830,125831,0,1,1
35883,2,3,125832,125832,125835,0,3,1
35884,6,2,125838,125838,125840,0,2,3
35885,3,2,125841,125841,125843,0,2,1
35886,5,2,125846,125846,125848,0,2,3
35887,5,2,125851,125851,125853,0,2,3
35888,2,1,125853,125853,125854,0,1,0
35889,3,1,125856,125856,125857,0,1,2
35890,6,3,125862,125862,125865,0,3,5
35891,3,3,125865,125865,125868,0,3,0
35892,4,3,125869,125869,125872,0,3,1
35893,4,2,125873,125873,125875,0,2,1
35894,4,1,125877,125877,125878,0,1,2
35895,4,1,125881,125881,125882,0,1,3
35896,2,1,125883,125883,125884,0,1,1
35897,4,1,125887,125887,125888,0,1,3
35898,6,1,125893,125893,125894,0,1,5
35899,1,1,125894,125894,125895,0,1,0
35900,4,1,125898,125898,125899,0,1,3
35901,5,1,125903,125903,125904,0,1,4
35902,5,3,125908,125908,125911,0,3,4
35903,2,3,125910,125911,125914,1,4,0
35904,2,3,125912,125914,125917,2,5,0
35905,5,1,125917,125917,125918,0,1,0
35906,1,3,125918,125918,125921,0,3,0
35907,2,3,125920,125921,125924,1,4,0
35908,4,1,125924,125924,125925,0,1,0
35909,5,2,125929,125929,125931,0,2,4
35910,4,2,125933,125933,125935,0,2,2
35911,4,3,125937,125937,125940,0,3,2
35912,1,2,125938,125940,125942,2,4,0
35913,4,1,125942,125942,125943,0,1,0
35914,1,1,125943,125943,125944,0,1,0
35915,4,2,125947,125947,125949,0,2,3
35916,5,2,125952,125952,125954,0,2,3
35917,5,3,125957,125957,125960,0,3,3
35918,1,3,125958,125960,125963,2,5,0
35919,5,3,125963,125963,125966,0,3,0
35920,4,2,125967,125967,125969,0,2,1
35921,5,3,125972,125972,125975,0,3,3
35922,5,3,125977,125977,125980,0,3,2
35923,3,2,125980,125980,125982,0,2,0
35924,4,1,125984,125984,125985,0,1,2
35925,2,1,125986,125986,125987,0,1,1
35926,4,3,125990,125990,125993,0,3,3
35927,5,1,125995,125995,125996,0,1,2
35928,3,1,125998,125998,125999,0,1,2
35929,4,3,126002,126002,126005,0,3,3
35930,6,2,126008,126008,126010,0,2,3
35931,2,2,126010,126010,126012,0,2,0
35932,5,2,126015,126015,126017,0,2,3
35933,2,1,126017,126017,126018,0,1,0
35934,1,3,126018,126018,126021,0,3,0
35935,4,1,126022,126022,126023,0,1,1
35936,5,3,126027,126027,126030,0,3,4
35937,6,1,126033,126033,126034,0,1,3
35938,2,2,126035,126035,126037,0,2,1
35939,3,3,126038,126038,126041,0,3,1
35940,3,1,126041,126041,126042,0,1,0
35941,1,1,126042,126042,126043,0,1,0
35942,4,2,126046,126046,126048,0,2,3
35943,3,1,126049,126049,126050,0,1,1
35944,5,3,126054,126054,126057,0,3,4
35945,3,3,126057,126057,126060,0,3,0
35946,4,2,126061,126061,126063,0,2,1
35947,5,3,126066,126066,126069,0,3,3
35948,6,3,126072,126072,126075,0,3,3
35949,6,2,126078,126078,126080,0,2,3
35950,6,3,126084,126084,126087,0,3,4
35951,1,3,126085,126087,126090,2,5,0
35952,6,2,126091,126091,126093,0,2,1
35953,5,2,126096,126096,126098,0,2,3
35954,2,2,126098,126098,126100,0,2,0
35955,6,2,126104,126104,126106,0,2,4
35956,4,1,126108,126108,126109,0,1,2
35957,4,2,126112,126112,126114,0,2,3
35958,5,3,126117,126117,126120,0,3,3
35959,2,2,126119,126120,126122,1,3,0
35960,2,2,126121,126122,126124,1,3,0
35961,3,3,126124,126124,126127,0,3,0
35962,2,2,126126,126127,126129,1,3,0
35963,4,3,126130,126130,126133,0,3,1
35964,1,1,126131,126133,126134,2,3,0
35965,1,1,126132,126134,126135,2,3,0
35966,3,2,126135,126135,126137,0,2,0
35967,3,2,126138,126138,126140,0,2,1
35968,4,3,126142,126142,126145,0,3,2
35969,2,3,126144,126145,126148,1,4,0
35970,5,1,126149,126149,126150,0,1,1
35971,1,2,126150,126150,126152,0,2,0
35972,4,1,126154,126154,126155,0,1,2
35973,6,2,126160,126160,126162,0,2,5
35974,6,2,126166,126166,126168,0,2,4
35975,5,1,126171,126171,126172,0,1,3
35976,5,3,126176,126176,126179,0,3,4
35977,6,3,126182,126182,126185,0,3,3
35978,1,3,126183,126185,126188,2,5,0
35979,3,3,126186,126188,126191,2,5,0
35980,3,1,126189,126191,126192,2,3,0
35981,2,2,126191,126192,126194,1,3,0
35982,3,1,126194,126194,126195,0,1,0
35983,4,3,126198,126198,126201,0,3,3
35984,6,3,126204,126204,126207,0,3,3
35985,3,3,126207,126207,126210,0,3,0
35986,5,1,126212,126212,126213,0,1,2
35987,6,2,126218,126218,126220,0,2,5
35988,3,2,126221,126221,126223,0,2,1
35989,1,1,126222,126223,126224,1,2,0
35990,3,1,126225,126225,126226,0,1,1
35991,1,3,126226,126226,126229,0,3,0
35992,6,2,126232,126232,126234,0,2,3
35993,3,2,126235,126235,126237,0,2,1
35994,1,2,126236,126237,126239,1,3,0
35995,5,3,126241,126241,126244,0,3,2
35996,4,2,126245,126245,126247,0,2,1
35997,4,2,126249,126249,126251,0,2,2
35998,6,3,126255,126255,126258,0,3,4
35999,6,2,126261,126261,126263,0,2,3
36000,6,2,126267,126267,126269,0,2,4
36001,3,3,126270,126270,126273,0,3,1
36002,6,1,126276,126276,126277,0,1,3
36003,4,3,126280,126280,126283,0,3,3
36004,4,2,126284,126284,126286,0,2,1
36005,1,1,126285,126286,126287,1,2,0
36006,1,1,126286,126287,126288,1,2,0
36007,3,1,126289,126289,126290,0,1,1
36008,6,1,126295,126295,126296,0,1,5
36009,1,3,126296,126296,126299,0,3,0
36010,2,1,126298,126299,126300,1,2,0
36011,3,1,126301,126301,126302,0,1,1
36012,1,3,126302,126302,126305,0,3,0
36013,5,3,126307,126307,126310,0,3,2
36014,6,1,126313,126313,126314,0,1,3
36015,4,3,126317,126317,126320,0,3,3
36016,2,1,126319,126320,126321,1,2,0
36017,3,1,126322,126322,126323,0,1,1
36018,1,3,126323,126323,126326,0,3,0
36019,1,1,126324,126326,126327,2,3,0
36020,2,1,126326,126327,126328,1,2,0
36021,3,3,126329,126329,126332,0,3,1
36022,5,1,126334,126334,126335,0,1,2
36023,2,1,126336,126336,126337,0,1,1
36024,3,2,126339,126339,126341,0,2,2
36025,1,3,126340,126341,126344,1,4,0
36026,4,2,126344,126344,126346,0,2,0
36027,3,2,126347,126347,126349,0,2,1
36028,5,1,126352,126352,126353,0,1,3
36029,1,3,126353,126353,126356,0,3,0
36030,3,3,126356,126356,126359,0,3,0
36031,5,1,126361,126361,126362,0,1,2
36032,4,3,126365,126365,126368,0,3,3
36033,1,2,126366,126368,126370,2,4,0
36034,1,1,126367,126370,126371,3,4,0
36035,3,2,126370,126371,126373,1,3,0
36036,6,3,126376,126376,126379,0,3,3
36037,4,1,126380,126380,126381,0,1,1
36038,3,1,126383,126383,126384,0,1,2
36039,4,3,126387,126387,126390,0,3,3
36040,3,3,126390,126390,126393,0,3,0
36041,6,1,126396,126396,126397,0,1,3
36042,1,3,126397,126397,126400,0,3,0
36043,6,1,126403,126403,126404,0,1,3
36044,5,3,126408,126408,126411,0,3,4
36045,6,1,126414,126414,126415,0,1,3
36046,3,1,126417,126417,126418,0,1,2
36047,4,3,126421,126421,126424,0,3,3
36048,6,2,126427,126427,126429,0,2,3
36049,4,1,126431,126431,126432,0,1,2
36050,6,2,126437,126437,126439,0,2,5
36051,4,2,126441,126441,126443,0,2,2
36052,4,1,126445,126445,126446,0,1,2
36053,4,1,126449,126449,126450,0,1,3
36054,4,2,126453,126453,126455,0,2,3
36055,1,3,126454,126455,126458,1,4,0
36056,5,1,126459,126459,126460,0,1,1
36057,1,2,126460,126460,126462,0,2,0
36058,4,3,126464,126464,126467,0,3,2
36059,4,1,126468,126468,126469,0,1,1
36060,4,2,126472,126472,126474,0,2,3
36061,2,3,126474,126474,126477,0,3,0
36062,3,1,126477,126477,126478,0,1,0
36063,4,1,126481,126481,126482,0,1,3
36064,3,1,126484,126484,126485,0,1,2
36065,2,1,126486,126486,126487,0,1,1
36066,2,1,126488,126488,126489,0,1,1
36067,5,2,126493,126493,126495,0,2,4
36068,4,3,126497,126497,126500,0,3,2
36069,4,2,126501,126501,126503,0,2,1
36070,5,1,126506,126506,126507,0,1,3
36071,3,2,126509,126509,126511,0,2,2
36072,4,1,126513,126513,126514,0,1,2
36073,4,2,126517,126517,126519,0,2,3
36074,1,2,126518,126519,126521,1,3,0
36075,2,3,126520,126521,126524,1,4,0
36076,6,2,126526,126526,126528,0,2,2
36077,2,1,126528,126528,126529,0,1,0
36078,3,2,126531,126531,126533,0,2,2
36079,6,3,126537,126537,126540,0,3,4
36080,1,2,126538,126540,126542,2,4,0
36081,5,3,126543,126543,126546,0,3,1
36082,2,1,126545,126546,126547,1,2,0
36083,1,3,126546,126547,126550,1,4,0
36084,5,3,126551,126551,126554,0,3,1
36085,5,3,126556,126556,126559,0,3,2
36086,1,1,126557,126559,126560,2,3,0
36087,3,3,126560,126560,126563,0,3,0
36088,6,2,126566,126566,126568,0,2,3
36089,5,1,126571,126571,126572,0,1,3
36090,5,2,126576,126576,126578,0,2,4
36091,6,3,126582,126582,126585,0,3,4
36092,1,1,126583,126585,126586,2,3,0
36093,5,3,126588,126588,126591,0,3,2
36094,4,2,126592,126592,126594,0,2,1
36095,6,3,126598,126598,126601,0,3,4
36096,6,2,126604,126604,126606,0,2,3
36097,2,1,126606,126606,126607,0,1,0
36098,2,2,126608,126608,126610,0,2,1
36099,5,3,126613,126613,126616,0,3,3
36100,3,3,126616,126616,126619,0,3,0
36101,2,3,126618,126619,126622,1,4,0
36102,3,1,126621,126622,126623,1,2,0
36103,4,3,126625,126625,126628,0,3,2
36104,5,1,126630,126630,126631,0,1,2
36105,4,3,126634,126634,126637,0,3,3
36106,2,2,126636,126637,126639,1,3,0
36107,4,2,126640,126640,126642,0,2,1
36108,2,3,126642,126642,126645,0,3,0
36109,4,1,126646,126646,126647,0,1,1
36110,6,3,126652,126652,126655,0,3,5
36111,5,3,126657,126657,126660,0,3,2
36112,2,1,126659,126660,126661,1,2,0
36113,6,3,126665,126665,126668,0,3,4
36114,5,2,126670,126670,126672,0,2,2
36115,6,3,126676,126676,126679,0,3,4
36116,6,1,126682,126682,126683,0,1,3
36117,3,2,126685,126685,126687,0,2,2
36118,5,3,126690,126690,126693,0,3,3
36119,5,1,126695,126695,126696,0,1,2
36120,2,2,126697,126697,126699,0,2,1
36121,2,1,126699,126699,126700,0,1,0
36122,4,2,126703,126703,126705,0,2,3
36123,4,1,126707,126707,126708,0,1,2
36124,2,1,126709,126709,126710,0,1,1
36125,1,3,126710,126710,126713,0,3,0
36126,2,3,126712,126713,126716,1,4,0
36127,6,1,126718,126718,126719,0,1,2
36128,1,3,126719,126719,126722,0,3,0
36129,3,3,126722,126722,126725,0,3,0
36130,3,2,126725,126725,126727,0,2,0
36131,5,2,126730,126730,126732,0,2,3
36132,5,1,126735,126735,126736,0,1,3
36133,6,3,126741,126741,126744,0,3,5
36134,3,2,126744,126744,126746,0,2,0
36135,1,1,126745,126746,126747,1,2,0
36136,6,3,126751,126751,126754,0,3,4
36137,1,2,126752,126754,126756,2,4,0
36138,6,3,126758,126758,126761,0,3,2
36139,6,3,126764,126764,126767,0,3,3
36140,6,1,126770,126770,126771,0,1,3
36141,2,3,126772,126772,126775,0,3,1
36142,4,2,126776,126776,126778,0,2,1
36143,5,1,126781,126781,126782,0,1,3
36144,2,1,126783,126783,126784,0,1,1
36145,2,2,126785,126785,126787,0,2,1
36146,3,2,126788,126788,126790,0,2,1
36147,2,3,126790,126790,126793,0,3,0
36148,3,3,126793,126793,126796,0,3,0
36149,5,1,126798,126798,126799,0,1,2
36150,6,1,126804,126804,126805,0,1,5
36151,4,1,126808,126808,126809,0,1,3
36152,1,1,126809,126809,126810,0,1,0
36153,1,3,126810,126810,126813,0,3,0
36154,1,2,126811,126813,126815,2,4,0
36155,1,1,126812,126815,126816,3,4,0
36156,3,3,126815,126816,126819,1,4,0
36157,4,2,126819,126819,126821,0,2,0
36158,6,3,126825,126825,126828,0,3,4
36159,4,2,126829,126829,126831,0,2,1
36160,2,2,126831,126831,126833,0,2,0
36161,3,3,126834,126834,126837,0,3,1
36162,6,3,126840,126840,126843,0,3,3
36163,4,2,126844,126844,126846,0,2,1
36164,1,3,126845,126846,126849,1,4,0
36165,1,3,126846,126849,126852,3,6,0
36166,4,3,126850,126852,126855,2,5,0
36167,3,2,126853,126855,126857,2,4,0
36168,6,1,126859,126859,126860,0,1,2
36169,1,2,126860,126860,126862,0,2,0
36170,1,3,126861,126862,126865,1,4,0
36171,3,2,126864,126865,126867,1,3,0
36172,5,2,126869,126869,126871,0,2,2
36173,3,3,126872,126872,126875,0,3,1
36174,3,1,126875,126875,126876,0,1,0
36175,2,3,126877,126877,126880,0,3,1
36176,1,1,126878,126880,126881,2,3,0
36177,3,2,126881,126881,126883,0,2,0
36178,4,1,126885,126885,126886,0,1,2
36179,2,1,126887,126887,126888,0,1,1
36180,3,1,126890,126890,126891,0,1,2
36181,2,1,126892,126892,126893,0,1,1
36182,5,1,126897,126897,126898,0,1,4
36183,4,1,126901,126901,126902,0,1,3
36184,6,3,126907,126907,126910,0,3,5
36185,5,1,126912,126912,126913,0,1,2
36186,2,3,126914,126914,126917,0,3,1
36187,3,1,126917,126917,126918,0,1,0
36188,2,3,126919,126919,126922,0,3,1
36189,1,3,126920,126922,126925,2,5,0
36190,6,1,126926,126926,126927,0,1,1
36191,4,3,126930,126930,126933,0,3,3
36192,6,3,126936,126936,126939,0,3,3
36193,6,3,126942,126942,126945,0,3,3
36194,5,2,126947,126947,126949,0,2,2
36195,3,2,126950,126950,126952,0,2,1
36196,6,3,126956,126956,126959,0,3,4
36197,3,3,126959,126959,126962,0,3,0
36198,2,2,126961,126962,126964,1,3,0
36199,1,3,126962,126964,126967,2,5,0
36200,4,1,126966,126967,126968,1,2,0
36201,4,3,126970,126970,126973,0,3,2
36202,2,2,126972,126973,126975,1,3,0
36203,1,2,126973,126975,126977,2,4,0
36204,4,2,126977,126977,126979,0,2,0
36205,2,1,126979,126979,126980,0,1,0
36206,1,3,126980,126980,126983,0,3,0
36207,1,2,126981,126983,126985,2,4,0
36208,4,1,126985,126985,126986,0,1,0
36209,1,1,126986,126986,126987,0,1,0
36210,1,3,126987,126987,126990,0,3,0
36211,4,2,126991,126991,126993,0,2,1
36212,1,2,126992,126993,126995,1,3,0
36213,3,2,126995,126995,126997,0,2,0
36214,2,1,126997,126997,126998,0,1,0
36215,3,1,127000,127000,127001,0,1,2
36216,1,2,127001,127001,127003,0,2,0
36217,2,3,127003,127003,127006,0,3,0
36218,1,2,127004,127006,127008,2,4,0
36219,2,2,127006,127008,127010,2,4,0
36220,1,1,127007,127010,127011,3,4,0
36221,1,3,127008,127011,127014,3,6,0
36222,3,1,127011,127014,127015,3,4,0
36223,5,3,127016,127016,127019,0,3,1
36224,1,2,127017,127019,127021,2,4,0
36225,6,1,127023,127023,127024,0,1,2
36226,3,1,127026,127026,127027,0,1,2
36227,2,3,127028,127028,127031,0,3,1
36228,5,3,127033,127033,127036,0,3,2
36229,3,2,127036,127036,127038,0,2,0
36230,4,3,127040,127040,127043,0,3,2
36231,5,1,127045,127045,127046,0,1,2
36232,2,3,127047,127047,127050,0,3,1
36233,1,1,127048,127050,127051,2,3,0
36234,2,3,127050,127051,127054,1,4,0
36235,1,2,127051,127054,127056,3,5,0
36236,3,1,127054,127056,127057,2,3,0
36237,4,3,127058,127058,127061,0,3,1
36238,2,1,127060,127061,127062,1,2,0
36239,5,1,127065,127065,127066,0,1,3
36240,4,2,127069,127069,127071,0,2,3
36241,6,3,127075,127075,127078,0,3,4
36242,5,1,127080,127080,127081,0,1,2
36243,1,2,127081,127081,127083,0,2,0
36244,3,1,127084,127084,127085,0,1,1
36245,6,3,127090,127090,127093,0,3,5
36246,6,3,127096,127096,127099,0,3,3
36247,2,2,127098,127099,127101,1,3,0
36248,2,2,127100,127101,127103,1,3,0
36249,1,2,127101,127103,127105,2,4,0
36250,1,1,127102,127105,127106,3,4,0
36251,1,1,127103,127106,127107,3,4,0
36252,6,2,127109,127109,127111,0,2,2
36253,1,1,127110,127111,127112,1,2,0
36254,3,3,127113,127113,127116,0,3,1
36255,6,3,127119,127119,127122,0,3,3
36256,3,3,127122,127122,127125,0,3,0
36257,5,3,127127,127127,127130,0,3,2
36258,2,2,127129,127130,127132,1,3,0
36259,6,1,127135,127135,127136,0,1,3
36260,5,3,127140,127140,127143,0,3,4
36261,4,2,127144,127144,127146,0,2,1
36262,3,3,127147,127147,127150,0,3,1
36263,3,1,127150,127150,127151,0,1,0
36264,6,3,127156,127156,127159,0,3,5
36265,3,3,127159,127159,127162,0,3,0
36266,5,3,127164,127164,127167,0,3,2
36267,3,3,127167,127167,127170,0,3,0
36268,6,1,127173,127173,127174,0,1,3
36269,1,3,127174,127174,127177,0,3,0
36270,3,3,127177,127177,127180,0,3,0
36271,2,2,127179,127180,127182,1,3,0
36272,2,2,127181,127182,127184,1,3,0
36273,3,3,127184,127184,127187,0,3,0
36274,1,2,127185,127187,127189,2,4,0
36275,4,3,127189,127189,127192,0,3,0
36276,3,1,127192,127192,127193,0,1,0
36277,2,3,127194,127194,127197,0,3,1
36278,6,2,127200,127200,127202,0,2,3
36279,4,3,127204,127204,127207,0,3,2
36280,1,1,127205,127207,127208,2,3,0
36281,2,2,127207,127208,127210,1,3,0
36282,3,1,127210,127210,127211,0,1,0
36283,5,1,127215,127215,127216,0,1,4
36284,3,1,127218,127218,127219,0,1,2
36285,3,3,127221,127221,127224,0,3,2
36286,5,3,127226,127226,127229,0,3,2
36287,4,1,127230,127230,127231,0,1,1
36288,4,3,127234,127234,127237,0,3,3
36289,6,2,127240,127240,127242,0,2,3
36290,1,1,127241,127242,127243,1,2,0
36291,5,1,127246,127246,127247,0,1,3
36292,2,3,127248,127248,127251,0,3,1
36293,5,1,127253,127253,127254,0,1,2
36294,5,1,127258,127258,127259,0,1,4
36295,5,2,127263,127263,127265,0,2,4
36296,4,1,127267,127267,127268,0,1,2
36297,6,3,127273,127273,127276,0,3,5
36298,3,2,127276,127276,127278,0,2,0
36299,5,3,127281,127281,127284,0,3,3
36300,3,2,127284,127284,127286,0,2,0
36301,3,2,127287,127287,127289,0,2,1
36302,1,1,127288,127289,127290,1,2,0
36303,4,2,127292,127292,127294,0,2,2
36304,2,3,127294,127294,127297,0,3,0
36305,5,3,127299,127299,127302,0,3,2
36306,4,1,127303,127303,127304,0,1,1
36307,4,3,127307,127307,127310,0,3,3
36308,1,1,127308,127310,127311,2,3,0
36309,5,1,127313,127313,127314,0,1,2
36310,6,3,127319,127319,127322,0,3,5
36311,6,1,127325,127325,127326,0,1,3
36312,1,3,127326,127326,127329,0,3,0
36313,4,2,127330,127330,127332,0,2,1
36314,1,1,127331,127332,127333,1,2,0
36315,6,3,127337,127337,127340,0,3,4
36316,2,3,127339,127340,127343,1,4,0
36317,2,1,127341,127343,127344,2,3,0
36318,2,1,127343,127344,127345,1,2,0
36319,5,3,127348,127348,127351,0,3,3
36320,6,1,127354,127354,127355,0,1,3
36321,3,3,127357,127357,127360,0,3,2
36322,5,1,127362,127362,127363,0,1,2
36323,2,3,127364,127364,127367,0,3,1
36324,1,3,127365,127367,127370,2,5,0
36325,2,2,127367,127370,127372,3,5,0
36326,5,2,127372,127372,127374,0,2,0
36327,3,3,127375,127375,127378,0,3,1
36328,4,2,127379,127379,127381,0,2,1
36329,1,3,127380,127381,127384,1,4,0
36330,5,3,127385,127385,127388,0,3,1
36331,4,3,127389,127389,127392,0,3,1
36332,4,2,127393,127393,127395,0,2,1
36333,1,1,127394,127395,127396,1,2,0
36334,4,2,127398,127398,127400,0,2,2
36335,2,2,127400,127400,127402,0,2,0
36336,2,1,127402,127402,127403,0,1,0
36337,3,2,127405,127405,127407,0,2,2
36338,2,1,127407,127407,127408,0,1,0
36339,2,1,127409,127409,127410,0,1,1
36340,1,1,127410,127410,127411,0,1,0
36341,4,2,127414,127414,127416,0,2,3
36342,2,1,127416,127416,127417,0,1,0
36343,5,2,127421,127421,127423,0,2,4
36344,1,1,127422,127423,127424,1,2,0
36345,3,1,127425,127425,127426,0,1,1
36346,2,3,127427,127427,127430,0,3,1
36347,1,2,127428,127430,127432,2,4,0
36348,3,2,127431,127432,127434,1,3,0
36349,1,1,127432,127434,127435,2,3,0
36350,1,1,127433,127435,127436,2,3,0
36351,1,1,127434,127436,127437,2,3,0
36352,2,3,127436,127437,127440,1,4,0
36353,5,3,127441,127441,127444,0,3,1
36354,4,1,127445,127445,127446,0,1,1
36355,2,3,127447,127447,127450,0,3,1
36356,1,1,127448,127450,127451,2,3,0
36357,3,1,127451,127451,127452,0,1,0
36358,5,2,127456,127456,127458,0,2,4
36359,2,3,127458,127458,127461,0,3,0
36360,5,1,127463,127463,127464,0,1,2
36361,6,2,127469,127469,127471,0,2,5
36362,6,3,127475,127475,127478,0,3,4
36363,3,1,127478,127478,127479,0,1,0
36364,4,2,127482,127482,127484,0,2,3
36365,2,3,127484,127484,127487,0,3,0
36366,4,1,127488,127488,127489,0,1,1
36367,3,2,127491,127491,127493,0,2,2
36368,4,2,127495,127495,127497,0,2,2
36369,3,1,127498,127498,127499,0,1,1
36370,2,3,127500,127500,127503,0,3,1
36371,2,1,127502,127503,127504,1,2,0
36372,4,2,127506,127506,127508,0,2,2
36373,6,3,127512,127512,127515,0,3,4
36374,1,1,127513,127515,127516,2,3,0
36375,6,3,127519,127519,127522,0,3,3
36376,1,1,127520,127522,127523,2,3,0
36377,1,1,127521,127523,127524,2,3,0
36378,5,3,127526,127526,127529,0,3,2
36379,6,3,127532,127532,127535,0,3,3
36380,2,1,127534,127535,127536,1,2,0
36381,2,1,127536,127536,127537,0,1,0
36382,4,3,127540,127540,127543,0,3,3
36383,3,3,127543,127543,127546,0,3,0
36384,4,2,127547,127547,127549,0,2,1
36385,3,1,127550,127550,127551,0,1,1
36386,6,3,127556,127556,127559,0,3,5
36387,5,2,127561,127561,127563,0,2,2
36388,6,3,127567,127567,127570,0,3,4
36389,2,2,127569,127570,127572,1,3,0
36390,3,3,127572,127572,127575,0,3,0
36391,2,1,127574,127575,127576,1,2,0
36392,6,2,127580,127580,127582,0,2,4
36393,5,1,127585,127585,127586,0,1,3
36394,5,1,127590,127590,127591,0,1,4
36395,4,2,127594,127594,127596,0,2,3
36396,3,1,127597,127597,127598,0,1,1
36397,1,3,127598,127598,127601,0,3,0
36398,2,3,127600,127601,127604,1,4,0
36399,6,3,127606,127606,127609,0,3,2
36400,1,1,127607,127609,127610,2,3,0
36401,5,1,127612,127612,127613,0,1,2
36402,6,2,127618,127618,127620,0,2,5
36403,1,1,127619,127620,127621,1,2,0
36404,4,2,127623,127623,127625,0,2,2
36405,4,3,127627,127627,127630,0,3,2
36406,4,1,127631,127631,127632,0,1,1
36407,2,3,127633,127633,127636,0,3,1
36408,1,3,127634,127636,127639,2,5,0
36409,5,1,127639,127639,127640,0,1,0
36410,6,2,127645,127645,127647,0,2,5
36411,4,3,127649,127649,127652,0,3,2
36412,5,2,127654,127654,127656,0,2,2
36413,1,2,127655,127656,127658,1,3,0
36414,3,2,127658,127658,127660,0,2,0
36415,3,1,127661,127661,127662,0,1,1
36416,4,2,127665,127665,127667,0,2,3
36417,4,2,127669,127669,127671,0,2,2
36418,5,3,127674,127674,127677,0,3,3
36419,3,1,127677,127677,127678,0,1,0
36420,6,2,127683,127683,127685,0,2,5
36421,4,3,127687,127687,127690,0,3,2
36422,2,2,127689,127690,127692,1,3,0
36423,6,2,127695,127695,127697,0,2,3
36424,6,1,127701,127701,127702,0,1,4
36425,2,2,127703,127703,127705,0,2,1
36426,1,3,127704,127705,127708,1,4,0
36427,5,2,127709,127709,127711,0,2,1
36428,3,3,127712,127712,127715,0,3,1
36429,6,1,127718,127718,127719,0,1,3
36430,2,1,127720,127720,127721,0,1,1
36431,2,3,127722,127722,127725,0,3,1
36432,2,2,127724,127725,127727,1,3,0
36433,4,1,127728,127728,127729,0,1,1
36434,4,3,127732,127732,127735,0,3,3
36435,1,3,127733,127735,127738,2,5,0
36436,5,1,127738,127738,127739,0,1,0
36437,3,3,127741,127741,127744,0,3,2
36438,2,1,127743,127744,127745,1,2,0
36439,6,1,127749,127749,127750,0,1,4
36440,6,2,127755,127755,127757,0,2,5
36441,2,3,127757,127757,127760,0,3,0
36442,6,2,127763,127763,127765,0,2,3
36443,5,1,127768,127768,127769,0,1,3
36444,6,2,127774,127774,127776,0,2,5
36445,6,1,127780,127780,127781,0,1,4
36446,4,1,127784,127784,127785,0,1,3
36447,3,2,127787,127787,127789,0,2,2
36448,6,1,127793,127793,127794,0,1,4
36449,2,3,127795,127795,127798,0,3,1
36450,4,3,127799,127799,127802,0,3,1
36451,5,1,127804,127804,127805,0,1,2
36452,4,1,127808,127808,127809,0,1,3
36453,5,3,127813,127813,127816,0,3,4
36454,4,1,127817,127817,127818,0,1,1
36455,3,2,127820,127820,127822,0,2,2
36456,6,3,127826,127826,127829,0,3,4
36457,5,1,127831,127831,127832,0,1,2
36458,5,3,127836,127836,127839,0,3,4
36459,4,2,127840,127840,127842,0,2,1
36460,3,3,127843,127843,127846,0,3,1
36461,6,3,127849,127849,127852,0,3,3
36462,4,2,127853,127853,127855,0,2,1
36463,5,2,127858,127858,127860,0,2,3
36464,3,3,127861,127861,127864,0,3,1
36465,4,3,127865,127865,127868,0,3,1
36466,2,2,127867,127868,127870,1,3,0
36467,2,3,127869,127870,127873,1,4,0
36468,4,1,127873,127873,127874,0,1,0
36469,5,1,127878,127878,127879,0,1,4
36470,4,2,127882,127882,127884,0,2,3
36471,3,2,127885,127885,127887,0,2,1
36472,4,3,127889,127889,127892,0,3,2
36473,2,3,127891,127892,127895,1,4,0
36474,5,1,127896,127896,127897,0,1,1
36475,1,3,127897,127897,127900,0,3,0
36476,3,1,127900,127900,127901,0,1,0
36477,3,1,127903,127903,127904,0,1,2
36478,3,3,127906,127906,127909,0,3,2
36479,5,2,127911,127911,127913,0,2,2
36480,4,2,127915,127915,127917,0,2,2
36481,1,2,127916,127917,127919,1,3,0
36482,1,2,127917,127919,127921,2,4,0
36483,6,1,127923,127923,127924,0,1,2
36484,5,2,127928,127928,127930,0,2,4
36485,1,1,127929,127930,127931,1,2,0
36486,6,2,127935,127935,127937,0,2,4
36487,5,1,127940,127940,127941,0,1,3
36488,4,1,127944,127944,127945,0,1,3
36489,4,3,127948,127948,127951,0,3,3
36490,5,1,127953,127953,127954,0,1,2
36491,6,3,127959,127959,127962,0,3,5
36492,6,2,127965,127965,127967,0,2,3
36493,1,2,127966,127967,127969,1,3,0
36494,1,1,127967,127969,127970,2,3,0
36495,1,1,127968,127970,127971,2,3,0
36496,3,2,127971,127971,127973,0,2,0
36497,2,1,127973,127973,127974,0,1,0
36498,2,2,127975,127975,127977,0,2,1
36499,1,1,127976,127977,127978,1,2,0
36500,6,2,127982,127982,127984,0,2,4
36501,2,1,127984,127984,127985,0,1,0
36502,2,2,127986,127986,127988,0,2,1
36503,5,1,127991,127991,127992,0,1,3
36504,5,2,127996,127996,127998,0,2,4
36505,6,3,128002,128002,128005,0,3,4
36506,3,1,128005,128005,128006,0,1,0
36507,1,1,128006,128006,128007,0,1,0
36508,1,1,128007,128007,128008,0,1,0
36509,5,1,128012,128012,128013,0,1,4
36510,2,1,128014,128014,128015,0,1,1
36511,2,1,128016,128016,128017,0,1,1
36512,2,2,128018,128018,128020,0,2,1
36513,1,3,128019,128020,128023,1,4,0
36514,6,2,128025,128025,128027,0,2,2
36515,6,1,128031,128031,128032,0,1,4
36516,6,3,128037,128037,128040,0,3,5
36517,5,3,128042,128042,128045,0,3,2
36518,4,3,128046,128046,128049,0,3,1
36519,3,3,128049,128049,128052,0,3,0
36520,3,3,128052,128052,128055,0,3,0
36521,3,2,128055,128055,128057,0,2,0
36522,4,2,128059,128059,128061,0,2,2
36523,1,3,128060,128061,128064,1,4,0
36524,2,1,128062,128064,128065,2,3,0
36525,2,1,128064,128065,128066,1,2,0
36526,3,2,128067,128067,128069,0,2,1
36527,3,3,128070,128070,128073,0,3,1
36528,3,2,128073,128073,128075,0,2,0
36529,6,1,128079,128079,128080,0,1,4
36530,3,2,128082,128082,128084,0,2,2
36531,4,3,128086,128086,128089,0,3,2
36532,6,2,128092,128092,128094,0,2,3
36533,6,2,128098,128098,128100,0,2,4
36534,5,2,128103,128103,128105,0,2,3
36535,4,3,128107,128107,128110,0,3,2
36536,2,3,128109,128110,128113,1,4,0
36537,2,1,128111,128113,128114,2,3,0
36538,6,1,128117,128117,128118,0,1,3
36539,4,1,128121,128121,128122,0,1,3
36540,4,2,128125,128125,128127,0,2,3
36541,5,1,128130,128130,128131,0,1,3
36542,1,2,128131,128131,128133,0,2,0
36543,2,2,128133,128133,128135,0,2,0
36544,5,1,128138,128138,128139,0,1,3
36545,4,2,128142,128142,128144,0,2,3
36546,3,2,128145,128145,128147,0,2,1
36547,3,3,128148,128148,128151,0,3,1
36548,6,2,128154,128154,128156,0,2,3
36549,6,2,128160,128160,128162,0,2,4
36550,2,1,128162,128162,128163,0,1,0
36551,2,3,128164,128164,128167,0,3,1
36552,6,1,128170,128170,128171,0,1,3
36553,1,3,128171,128171,128174,0,3,0
36554,4,3,128175,128175,128178,0,3,1
36555,5,3,128180,128180,128183,0,3,2
36556,4,3,128184,128184,128187,0,3,1
36557,6,3,128190,128190,128193,0,3,3
36558,4,1,128194,128194,128195,0,1,1
36559,5,1,128199,128199,128200,0,1,4
36560,5,2,128204,128204,128206,0,2,4
36561,4,3,128208,128208,128211,0,3,2
36562,3,1,128211,128211,128212,0,1,0
36563,3,2,128214,128214,128216,0,2,2
36564,2,1,128216,128216,128217,0,1,0
36565,4,2,128220,128220,128222,0,2,3
36566,5,1,128225,128225,128226,0,1,3
36567,5,2,128230,128230,128232,0,2,4
36568,1,2,128231,128232,128234,1,3,0
36569,5,1,128236,128236,128237,0,1,2
36570,3,3,128239,128239,128242,0,3,2
36571,5,3,128244,128244,128247,0,3,2
36572,5,3,128249,128249,128252,0,3,2
36573,6,2,128255,128255,128257,0,2,3
36574,2,2,128257,128257,128259,0,2,0
36575,1,1,128258,128259,128260,1,2,0
36576,4,1,128262,128262,128263,0,1,2
36577,5,3,128267,128267,128270,0,3,4
36578,2,3,128269,128270,128273,1,4,0
36579,1,2,128270,128273,128275,3,5,0
36580,5,2,128275,128275,128277,0,2,0
36581,1,2,128276,128277,128279,1,3,0
36582,3,1,128279,128279,128280,0,1,0
36583,4,2,128283,128283,128285,0,2,3
36584,1,2,128284,128285,128287,1,3,0
36585,2,1,128286,128287,128288,1,2,0
36586,1,1,128287,128288,128289,1,2,0
36587,1,3,128288,128289,128292,1,4,0
36588,5,2,128293,128293,128295,0,2,1
36589,1,3,128294,128295,128298,1,4,0
36590,6,1,128300,128300,128301,0,1,2
36591,1,3,128301,128301,128304,0,3,0
36592,1,1,128302,128304,128305,2,3,0
36593,3,2,128305,128305,128307,0,2,0
36594,1,2,128306,128307,128309,1,3,0
36595,4,3,128310,128310,128313,0,3,1
36596,3,3,128313,128313,128316,0,3,0
36597,1,2,128314,128316,128318,2,4,0
36598,6,1,128320,128320,128321,0,1,2
36599,5,3,128325,128325,128328,0,3,4
36600,2,2,128327,128328,128330,1,3,0
36601,6,1,128333,128333,128334,0,1,3
36602,4,2,128337,128337,128339,0,2,3
36603,6,3,128343,128343,128346,0,3,4
36604,3,3,128346,128346,128349,0,3,0
36605,1,2,128347,128349,128351,2,4,0
36606,6,2,128353,128353,128355,0,2,2
36607,1,3,128354,128355,128358,1,4,0
36608,6,2,128360,128360,128362,0,2,2
36609,1,3,128361,128362,128365,1,4,0
36610,6,3,128367,128367,128370,0,3,2
36611,5,3,128372,128372,128375,0,3,2
36612,1,2,128373,128375,128377,2,4,0
36613,6,3,128379,128379,128382,0,3,2
36614,2,1,128381,128382,128383,1,2,0
36615,4,1,128385,128385,128386,0,1,2
36616,5,1,128390,128390,128391,0,1,4
36617,2,2,128392,128392,128394,0,2,1
36618,3,3,128395,128395,128398,0,3,1
36619,2,1,128397,128398,128399,1,2,0
36620,6,2,128403,128403,128405,0,2,4
36621,1,1,128404,128405,128406,1,2,0
36622,3,3,128407,128407,128410,0,3,1
36623,1,1,128408,128410,128411,2,3,0
36624,2,2,128410,128411,128413,1,3,0
36625,6,3,128416,128416,128419,0,3,3
36626,1,3,128417,128419,128422,2,5,0
36627,3,3,128420,128422,128425,2,5,0
36628,5,1,128425,128425,128426,0,1,0
36629,5,1,128430,128430,128431,0,1,4
36630,2,3,128432,128432,128435,0,3,1
36631,1,1,128433,128435,128436,2,3,0
36632,2,2,128435,128436,128438,1,3,0
36633,1,1,128436,128438,128439,2,3,0
36634,6,3,128442,128442,128445,0,3,3
36635,4,2,128446,128446,128448,0,2,1
36636,4,3,128450,128450,128453,0,3,2
36637,5,2,128455,128455,128457,0,2,2
36638,1,1,128456,128457,128458,1,2,0
36639,4,2,128460,128460,128462,0,2,2
36640,4,1,128464,128464,128465,0,1,2
36641,2,2,128466,128466,128468,0,2,1
36642,4,1,128470,128470,128471,0,1,2
36643,4,1,128474,128474,128475,0,1,3
36644,2,1,128476,128476,128477,0,1,1
36645,2,3,128478,128478,128481,0,3,1
36646,5,1,128483,128483,128484,0,1,2
36647,4,1,128487,128487,128488,0,1,3
36648,3,1,128490,128490,128491,0,1,2
36649,2,3,128492,128492,128495,0,3,1
36650,5,1,128497,128497,128498,0,1,2
36651,1,2,128498,128498,128500,0,2,0
36652,6,3,128504,128504,128507,0,3,4
36653,3,1,128507,128507,128508,0,1,0
36654,3,3,128510,128510,128513,0,3,2
36655,1,3,128511,128513,128516,2,5,0
36656,6,2,128517,128517,128519,0,2,1
36657,4,2,128521,128521,128523,0,2,2
36658,3,1,128524,128524,128525,0,1,1
36659,5,1,128529,128529,128530,0,1,4
36660,2,3,128531,128531,128534,0,3,1
36661,5,3,128536,128536,128539,0,3,2
36662,2,3,128538,128539,128542,1,4,0
36663,2,1,128540,128542,128543,2,3,0
36664,4,2,128544,128544,128546,0,2,1
36665,5,3,128549,128549,128552,0,3,3
36666,2,2,128551,128552,128554,1,3,0
36667,1,3,128552,128554,128557,2,5,0
36668,3,3,128555,128557,128560,2,5,0
36669,2,1,128557,128560,128561,3,4,0
36670,4,1,128561,128561,128562,0,1,0
36671,2,3,128563,128563,128566,0,3,1
36672,3,1,128566,128566,128567,0,1,0
36673,6,3,128572,128572,128575,0,3,5
36674,2,3,128574,128575,128578,1,4,0
36675,6,2,128580,128580,128582,0,2,2
36676,2,2,128582,128582,128584,0,2,0
36677,5,3,128587,128587,128590,0,3,3
36678,1,1,128588,128590,128591,2,3,0
36679,2,2,128590,128591,128593,1,3,0
36680,1,1,128591,128593,128594,2,3,0
36681,2,1,128593,128594,128595,1,2,0
36682,3,1,128596,128596,128597,0,1,1
36683,5,1,128601,128601,128602,0,1,4
36684,1,1,128602,128602,128603,0,1,0
36685,3,3,128605,128605,128608,0,3,2
36686,4,3,128609,128609,128612,0,3,1
36687,1,3,128610,128612,128615,2,5,0
36688,2,1,128612,128615,128616,3,4,0
36689,4,2,128616,128616,128618,0,2,0
36690,2,3,128618,128618,128621,0,3,0
36691,2,3,128620,128621,128624,1,4,0
36692,2,2,128622,128624,128626,2,4,0
36693,1,3,128623,128626,128629,3,6,0
36694,5,1,128628,128629,128630,1,2,0
36695,2,3,128630,128630,128633,0,3,0
36696,1,1,128631,128633,128634,2,3,0
36697,4,1,128635,128635,128636,0,1,1
36698,1,3,128636,128636,128639,0,3,0
36699,5,1,128641,128641,128642,0,1,2
36700,2,2,128643,128643,128645,0,2,1
36701,2,1,128645,128645,128646,0,1,0
36702,3,1,128648,128648,128649,0,1,2
36703,4,3,128652,128652,128655,0,3,3
36704,3,3,128655,128655,128658,0,3,0
36705,1,3,128656,128658,128661,2,5,0
36706,3,1,128659,128661,128662,2,3,0
36707,6,1,128665,128665,128666,0,1,3
36708,3,3,128668,128668,128671,0,3,2
36709,5,3,128673,128673,128676,0,3,2
36710,2,2,128675,128676,128678,1,3,0
36711,5,2,128680,128680,128682,0,2,2
36712,6,2,128686,128686,128688,0,2,4
36713,4,2,128690,128690,128692,0,2,2
36714,1,3,128691,128692,128695,1,4,0
36715,4,3,128695,128695,128698,0,3,0
36716,3,2,128698,128698,128700,0,2,0
36717,3,3,128701,128701,128704,0,3,1
36718,2,3,128703,128704,128707,1,4,0
36719,2,2,128705,128707,128709,2,4,0
36720,2,2,128707,128709,128711,2,4,0
36721,1,1,128708,128711,128712,3,4,0
36722,3,2,128711,128712,128714,1,3,0
36723,6,1,128717,128717,128718,0,1,3
36724,1,2,128718,128718,128720,0,2,0
36725,6,3,128724,128724,128727,0,3,4
36726,4,2,128728,128728,128730,0,2,1
36727,6,2,128734,128734,128736,0,2,4
36728,3,3,128737,128737,128740,0,3,1
36729,3,2,128740,128740,128742,0,2,0
36730,6,1,128746,128746,128747,0,1,4
36731,1,3,128747,128747,128750,0,3,0
36732,3,3,128750,128750,128753,0,3,0
36733,1,1,128751,128753,128754,2,3,0
36734,1,2,128752,128754,128756,2,4,0
36735,4,1,128756,128756,128757,0,1,0
36736,2,3,128758,128758,128761,0,3,1
36737,2,1,128760,128761,128762,1,2,0
36738,1,3,128761,128762,128765,1,4,0
36739,1,2,128762,128765,128767,3,5,0
36740,5,2,128767,128767,128769,0,2,0
36741,6,2,128773,128773,128775,0,2,4
36742,3,1,128776,128776,128777,0,1,1
36743,3,2,128779,128779,128781,0,2,2
36744,2,3,128781,128781,128784,0,3,0
36745,3,2,128784,128784,128786,0,2,0
36746,1,2,128785,128786,128788,1,3,0
36747,6,3,128791,128791,128794,0,3,3
36748,5,2,128796,128796,128798,0,2,2
36749,2,1,128798,128798,128799,0,1,0
36750,3,1,128801,128801,128802,0,1,2
36751,2,3,128803,128803,128806,0,3,1
36752,2,2,128805,128806,128808,1,3,0
36753,5,1,128810,128810,128811,0,1,2
36754,4,3,128814,128814,128817,0,3,3
36755,1,3,128815,128817,128820,2,5,0
36756,1,1,128816,128820,128821,4,5,0
36757,6,3,128822,128822,128825,0,3,1
36758,1,2,128823,128825,128827,2,4,0
36759,6,2,128829,128829,128831,0,2,2
36760,6,2,128835,128835,128837,0,2,4
36761,2,3,128837,128837,128840,0,3,0
36762,4,1,128841,128841,128842,0,1,1
36763,3,3,128844,128844,128847,0,3,2
36764,2,2,128846,128847,128849,1,3,0
36765,1,3,128847,128849,128852,2,5,0
36766,1,1,128848,128852,128853,4,5,0
36767,1,3,128849,128853,128856,4,7,0
36768,3,1,128852,128856,128857,4,5,0
36769,3,3,128855,128857,128860,2,5,0
36770,2,2,128857,128860,128862,3,5,0
36771,2,1,128859,128862,128863,3,4,0
36772,5,1,128864,128864,128865,0,1,1
36773,1,3,128865,128865,128868,0,3,0
36774,3,2,128868,128868,128870,0,2,0
36775,2,3,128870,128870,128873,0,3,0
36776,2,1,128872,128873,128874,1,2,0
36777,5,3,128877,128877,128880,0,3,3
36778,1,1,128878,128880,128881,2,3,0
36779,1,3,128879,128881,128884,2,5,0
36780,1,3,128880,128884,128887,4,7,0
36781,2,1,128882,128887,128888,5,6,0
36782,3,3,128885,128888,128891,3,6,0
36783,3,1,128888,128891,128892,3,4,0
36784,2,2,128890,128892,128894,2,4,0
36785,5,2,128895,128895,128897,0,2,1
36786,3,3,128898,128898,128901,0,3,1
36787,1,2,128899,128901,128903,2,4,0
36788,2,1,128901,128903,128904,2,3,0
36789,6,3,128907,128907,128910,0,3,3
36790,2,1,128909,128910,128911,1,2,0
36791,5,1,128914,128914,128915,0,1,3
36792,2,1,128916,128916,128917,0,1,1
36793,4,3,128920,128920,128923,0,3,3
36794,5,2,128925,128925,128927,0,2,2
36795,1,3,128926,128927,128930,1,4,0
36796,5,2,128931,128931,128933,0,2,1
36797,5,2,128936,128936,128938,0,2,3
36798,1,3,128937,128938,128941,1,4,0
36799,3,1,128940,128941,128942,1,2,0
36800,6,2,128946,128946,128948,0,2,4
36801,4,3,128950,128950,128953,0,3,2
36802,5,1,128955,128955,128956,0,1,2
36803,2,1,128957,128957,128958,0,1,1
36804,2,1,128959,128959,128960,0,1,1
36805,4,3,128963,128963,128966,0,3,3
36806,6,1,128969,128969,128970,0,1,3
36807,5,3,128974,128974,128977,0,3,4
36808,3,3,128977,128977,128980,0,3,0
36809,2,3,128979,128980,128983,1,4,0
36810,1,3,128980,128983,128986,3,6,0
36811,6,1,128986,128986,128987,0,1,0
36812,1,1,128987,128987,128988,0,1,0
36813,4,3,128991,128991,128994,0,3,3
36814,6,2,128997,128997,128999,0,2,3
36815,4,3,129001,129001,129004,0,3,2
36816,4,1,129005,129005,129006,0,1,1
36817,6,2,129011,129011,129013,0,2,5
36818,2,2,129013,129013,129015,0,2,0
36819,5,3,129018,129018,129021,0,3,3
36820,6,1,129024,129024,129025,0,1,3
36821,5,2,129029,129029,129031,0,2,4
36822,6,2,129035,129035,129037,0,2,4
36823,2,1,129037,129037,129038,0,1,0
36824,4,1,129041,129041,129042,0,1,3
36825,2,1,129043,129043,129044,0,1,1
36826,2,1,129045,129045,129046,0,1,1
36827,3,2,129048,129048,129050,0,2,2
36828,6,2,129054,129054,129056,0,2,4
36829,6,2,129060,129060,129062,0,2,4
36830,1,3,129061,129062,129065,1,4,0
36831,2,2,129063,129065,129067,2,4,0
36832,3,1,129066,129067,129068,1,2,0
36833,1,2,129067,129068,129070,1,3,0
36834,1,1,129068,129070,129071,2,3,0
36835,5,1,129073,129073,129074,0,1,2
36836,6,2,129079,129079,129081,0,2,5
36837,1,1,129080,129081,129082,1,2,0
36838,1,3,129081,129082,129085,1,4,0
36839,3,3,129084,129085,129088,1,4,0
36840,5,2,129089,129089,129091,0,2,1
36841,5,2,129094,129094,129096,0,2,3
36842,5,3,129099,129099,129102,0,3,3
36843,2,3,129101,129102,129105,1,4,0
36844,3,3,129104,129105,129108,1,4,0
36845,1,2,129105,129108,129110,3,5,0
36846,2,1,129107,129110,129111,3,4,0
36847,3,3,129110,129111,129114,1,4,0
36848,3,3,129113,129114,129117,1,4,0
36849,4,2,129117,129117,129119,0,2,0
36850,3,2,129120,129120,129122,0,2,1
36851,5,2,129125,129125,129127,0,2,3
36852,1,3,129126,129127,129130,1,4,0
36853,5,1,129131,129131,129132,0,1,1
36854,5,1,129136,129136,129137,0,1,4
36855,6,3,129142,129142,129145,0,3,5
36856,5,1,129147,129147,129148,0,1,2
36857,5,2,129152,129152,129154,0,2,4
36858,1,3,129153,129154,129157,1,4,0
36859,4,2,129157,129157,129159,0,2,0
36860,6,2,129163,129163,129165,0,2,4
36861,3,3,129166,129166,129169,0,3,1
36862,2,3,129168,129169,129172,1,4,0
36863,6,2,129174,129174,129176,0,2,2
36864,1,1,129175,129176,129177,1,2,0
36865,6,2,129181,129181,129183,0,2,4
36866,1,3,129182,129183,129186,1,4,0
36867,1,1,129183,129186,129187,3,4,0
36868,2,3,129185,129187,129190,2,5,0
36869,2,2,129187,129190,129192,3,5,0
36870,4,1,129191,129192,129193,1,2,0
36871,4,1,129195,129195,129196,0,1,2
36872,4,1,129199,129199,129200,0,1,3
36873,4,1,129203,129203,129204,0,1,3
36874,5,1,129208,129208,129209,0,1,4
36875,3,2,129211,129211,129213,0,2,2
36876,2,1,129213,129213,129214,0,1,0
36877,3,1,129216,129216,129217,0,1,2
36878,1,2,129217,129217,129219,0,2,0
36879,2,2,129219,129219,129221,0,2,0
36880,4,3,129223,129223,129226,0,3,2
36881,2,3,129225,129226,129229,1,4,0
36882,4,3,129229,129229,129232,0,3,0
36883,1,3,129230,129232,129235,2,5,0
36884,5,3,129235,129235,129238,0,3,0
36885,1,1,129236,129238,129239,2,3,0
36886,5,2,129241,129241,129243,0,2,2
36887,5,3,129246,129246,129249,0,3,3
36888,4,2,129250,129250,129252,0,2,1
36889,1,1,129251,129252,129253,1,2,0
36890,6,2,129257,129257,129259,0,2,4
36891,1,1,129258,129259,129260,1,2,0
36892,3,3,129261,129261,129264,0,3,1
36893,2,1,129263,129264,129265,1,2,0
36894,2,3,129265,129265,129268,0,3,0
36895,1,1,129266,129268,129269,2,3,0
36896,4,1,129270,129270,129271,0,1,1
36897,1,1,129271,129271,129272,0,1,0
36898,4,3,129275,129275,129278,0,3,3
36899,2,1,129277,129278,129279,1,2,0
36900,4,3,129281,129281,129284,0,3,2
36901,4,2,129285,129285,129287,0,2,1
36902,2,2,129287,129287,129289,0,2,0
36903,1,2,129288,129289,129291,1,3,0
36904,6,3,129294,129294,129297,0,3,3
36905,1,3,129295,129297,129300,2,5,0
36906,3,2,129298,129300,129302,2,4,0
36907,2,3,129300,129302,129305,2,5,0
36908,3,2,129303,129305,129307,2,4,0
36909,4,1,129307,129307,129308,0,1,0
36910,5,1,129312,129312,129313,0,1,4
36911,3,3,129315,129315,129318,0,3,2
36912,2,3,129317,129318,129321,1,4,0
36913,3,1,129320,129321,129322,1,2,0
36914,2,2,129322,129322,129324,0,2,0
36915,2,2,129324,129324,129326,0,2,0
36916,1,1,129325,129326,129327,1,2,0
36917,3,2,129328,129328,129330,0,2,1
36918,3,3,129331,129331,129334,0,3,1
36919,1,2,129332,129334,129336,2,4,0
36920,2,2,129334,129336,129338,2,4,0
36921,6,3,129340,129340,129343,0,3,2
36922,1,1,129341,129343,129344,2,3,0
36923,1,3,129342,129344,129347,2,5,0
36924,5,1,129347,129347,129348,0,1,0
36925,3,3,129350,129350,129353,0,3,2
36926,2,2,129352,129353,129355,1,3,0
36927,3,2,129355,129355,129357,0,2,0
36928,6,1,129361,129361,129362,0,1,4
36929,1,1,129362,129362,129363,0,1,0
36930,5,2,129367,129367,129369,0,2,4
36931,6,2,129373,129373,129375,0,2,4
36932,4,3,129377,129377,129380,0,3,2
36933,2,3,129379,129380,129383,1,4,0
36934,3,1,129382,129383,129384,1,2,0
36935,6,3,129388,129388,129391,0,3,4
36936,2,2,129390,129391,129393,1,3,0
36937,6,3,129396,129396,129399,0,3,3
36938,6,1,129402,129402,129403,0,1,3
36939,2,1,129404,129404,129405,0,1,1
36940,3,2,129407,129407,129409,0,2,2
36941,6,3,129413,129413,129416,0,3,4
36942,5,3,129418,129418,129421,0,3,2
36943,1,3,129419,129421,129424,2,5,0
36944,6,1,129425,129425,129426,0,1,1
36945,2,3,129427,129427,129430,0,3,1
36946,3,1,129430,129430,129431,0,1,0
36947,5,1,129435,129435,129436,0,1,4
36948,3,2,129438,129438,129440,0,2,2
36949,6,2,129444,129444,129446,0,2,4
36950,6,1,129450,129450,129451,0,1,4
36951,2,1,129452,129452,129453,0,1,1
36952,2,3,129454,129454,129457,0,3,1
36953,1,2,129455,129457,129459,2,4,0
36954,3,2,129458,129459,129461,1,3,0
36955,5,2,129463,129463,129465,0,2,2
36956,5,1,129468,129468,129469,0,1,3
36957,1,1,129469,129469,129470,0,1,0
36958,3,1,129472,129472,129473,0,1,2
36959,2,2,129474,129474,129476,0,2,1
36960,5,1,129479,129479,129480,0,1,3
36961,3,1,129482,129482,129483,0,1,2
36962,1,1,129483,129483,129484,0,1,0
36963,6,2,129489,129489,129491,0,2,5
36964,6,2,129495,129495,129497,0,2,4
36965,4,1,129499,129499,129500,0,1,2
36966,1,3,129500,129500,129503,0,3,0
36967,5,3,129505,129505,129508,0,3,2
36968,4,3,129509,129509,129512,0,3,1
36969,3,3,129512,129512,129515,0,3,0
36970,5,2,129517,129517,129519,0,2,2
36971,6,2,129523,129523,129525,0,2,4
36972,4,2,129527,129527,129529,0,2,2
36973,3,3,129530,129530,129533,0,3,1
36974,2,2,129532,129533,129535,1,3,0
36975,1,1,129533,129535,129536,2,3,0
36976,4,3,129537,129537,129540,0,3,1
36977,6,1,129543,129543,129544,0,1,3
36978,3,1,129546,129546,129547,0,1,2
36979,1,2,129547,129547,129549,0,2,0
36980,3,1,129550,129550,129551,0,1,1
36981,3,2,129553,129553,129555,0,2,2
36982,2,3,129555,129555,129558,0,3,0
36983,3,1,129558,129558,129559,0,1,0
36984,1,3,129559,129559,129562,0,3,0
36985,2,2,129561,129562,129564,1,3,0
36986,5,2,129566,129566,129568,0,2,2
36987,3,3,129569,129569,129572,0,3,1
36988,4,1,129573,129573,129574,0,1,1
36989,4,2,129577,129577,129579,0,2,3
36990,3,1,129580,129580,129581,0,1,1
36991,2,2,129582,129582,129584,0,2,1
36992,5,2,129587,129587,129589,0,2,3
36993,1,3,129588,129589,129592,1,4,0
36994,4,3,129592,129592,129595,0,3,0
36995,4,2,129596,129596,129598,0,2,1
36996,3,2,129599,129599,129601,0,2,1
36997,6,3,129605,129605,129608,0,3,4
36998,5,2,129610,129610,129612,0,2,2
36999,2,2,129612,129612,129614,0,2,0
37000,2,3,129614,129614,129617,0,3,0
37001,6,3,129620,129620,129623,0,3,3
37002,6,1,129626,129626,129627,0,1,3
37003,1,2,129627,129627,129629,0,2,0
37004,5,3,129632,129632,129635,0,3,3
37005,5,2,129637,129637,129639,0,2,2
37006,6,1,129643,129643,129644,0,1,4
37007,4,3,129647,129647,129650,0,3,3
37008,4,3,129651,129651,129654,0,3,1
37009,2,1,129653,129654,129655,1,2,0
37010,2,3,129655,129655,129658,0,3,0
37011,3,2,129658,129658,129660,0,2,0
37012,2,1,129660,129660,129661,0,1,0
37013,2,2,129662,129662,129664,0,2,1
37014,6,2,129668,129668,129670,0,2,4
37015,1,3,129669,129670,129673,1,4,0
37016,4,3,129673,129673,129676,0,3,0
37017,5,2,129678,129678,129680,0,2,2
37018,5,3,129683,129683,129686,0,3,3
37019,1,3,129684,129686,129689,2,5,0
37020,5,3,129689,129689,129692,0,3,0
37021,2,1,129691,129692,129693,1,2,0
37022,4,1,129695,129695,129696,0,1,2
37023,3,2,129698,129698,129700,0,2,2
37024,1,1,129699,129700,129701,1,2,0
37025,1,3,129700,129701,129704,1,4,0
37026,6,3,129706,129706,129709,0,3,2
37027,4,1,129710,129710,129711,0,1,1
37028,1,3,129711,129711,129714,0,3,0
37029,4,1,129715,129715,129716,0,1,1
37030,1,1,129716,129716,129717,0,1,0
37031,3,1,129719,129719,129720,0,1,2
37032,1,2,129720,129720,129722,0,2,0
37033,3,3,129723,129723,129726,0,3,1
37034,3,3,129726,129726,129729,0,3,0
37035,3,3,129729,129729,129732,0,3,0
37036,6,2,129735,129735,129737,0,2,3
37037,2,3,129737,129737,129740,0,3,0
37038,3,3,129740,129740,129743,0,3,0
37039,2,2,129742,129743,129745,1,3,0
37040,4,2,129746,129746,129748,0,2,1
37041,5,2,129751,129751,129753,0,2,3
37042,2,3,129753,129753,129756,0,3,0
37043,6,2,129759,129759,129761,0,2,3
37044,4,2,129763,129763,129765,0,2,2
37045,2,3,129765,129765,129768,0,3,0
37046,6,3,129771,129771,129774,0,3,3
37047,3,1,129774,129774,129775,0,1,0
37048,5,1,129779,129779,129780,0,1,4
37049,4,1,129783,129783,129784,0,1,3
37050,2,3,129785,129785,129788,0,3,1
37051,1,2,129786,129788,129790,2,4,0
37052,5,1,129791,129791,129792,0,1,1
37053,2,3,129793,129793,129796,0,3,1
37054,6,3,129799,129799,129802,0,3,3
37055,1,1,129800,129802,129803,2,3,0
37056,5,3,129805,129805,129808,0,3,2
37057,5,3,129810,129810,129813,0,3,2
37058,1,2,129811,129813,129815,2,4,0
37059,3,2,129814,129815,129817,1,3,0
37060,6,3,129820,129820,129823,0,3,3
37061,6,1,129826,129826,129827,0,1,3
37062,4,1,129830,129830,129831,0,1,3
37063,2,3,129832,129832,129835,0,3,1
37064,5,1,129837,129837,129838,0,1,2
37065,5,1,129842,129842,129843,0,1,4
37066,1,2,129843,129843,129845,0,2,0
37067,6,2,129849,129849,129851,0,2,4
37068,2,3,129851,129851,129854,0,3,0
37069,2,3,129853,129854,129857,1,4,0
37070,3,3,129856,129857,129860,1,4,0
37071,1,2,129857,129860,129862,3,5,0
37072,6,2,129863,129863,129865,0,2,1
37073,5,1,129868,129868,129869,0,1,3
37074,1,1,129869,129869,129870,0,1,0
37075,6,2,129875,129875,129877,0,2,5
37076,2,2,129877,129877,129879,0,2,0
37077,6,2,129883,129883,129885,0,2,4
37078,6,2,129889,129889,129891,0,2,4
37079,3,2,129892,129892,129894,0,2,1
37080,4,3,129896,129896,129899,0,3,2
37081,5,1,129901,129901,129902,0,1,2
37082,5,1,129906,129906,129907,0,1,4
37083,3,1,129909,129909,129910,0,1,2
37084,2,3,129911,129911,129914,0,3,1
37085,3,3,129914,129914,129917,0,3,0
37086,4,1,129918,129918,129919,0,1,1
37087,4,2,129922,129922,129924,0,2,3
37088,6,1,129928,129928,129929,0,1,4
37089,3,2,129931,129931,129933,0,2,2
37090,2,2,129933,129933,129935,0,2,0
37091,4,3,129937,129937,129940,0,3,2
37092,6,3,129943,129943,129946,0,3,3
37093,6,1,129949,129949,129950,0,1,3
37094,3,1,129952,129952,129953,0,1,2
37095,1,3,129953,129953,129956,0,3,0
37096,5,3,129958,129958,129961,0,3,2
37097,5,1,129963,129963,129964,0,1,2
37098,4,3,129967,129967,129970,0,3,3
37099,1,2,129968,129970,129972,2,4,0
37100,4,1,129972,129972,129973,0,1,0
37101,3,2,129975,129975,129977,0,2,2
37102,4,1,129979,129979,129980,0,1,2
37103,4,2,129983,129983,129985,0,2,3
37104,3,1,129986,129986,129987,0,1,1
37105,3,1,129989,129989,129990,0,1,2
37106,3,1,129992,129992,129993,0,1,2
37107,1,1,129993,129993,129994,0,1,0
37108,4,2,129997,129997,129999,0,2,3
37109,1,1,129998,129999,130000,1,2,0
37110,2,3,130000,130000,130003,0,3,0
37111,4,2,130004,130004,130006,0,2,1
37112,6,1,130010,130010,130011,0,1,4
37113,2,3,130012,130012,130015,0,3,1
37114,3,3,130015,130015,130018,0,3,0
37115,1,1,130016,130018,130019,2,3,0
37116,3,3,130019,130019,130022,0,3,0
37117,5,1,130024,130024,130025,0,1,2
37118,1,2,130025,130025,130027,0,2,0
37119,4,1,130029,130029,130030,0,1,2
37120,3,2,130032,130032,130034,0,2,2
37121,1,2,130033,130034,130036,1,3,0
37122,4,1,130037,130037,130038,0,1,1
37123,6,3,130043,130043,130046,0,3,5
37124,3,1,130046,130046,130047,0,1,0
37125,3,2,130049,130049,130051,0,2,2
37126,6,2,130055,130055,130057,0,2,4
37127,3,3,130058,130058,130061,0,3,1
37128,4,1,130062,130062,130063,0,1,1
37129,1,3,130063,130063,130066,0,3,0
37130,3,1,130066,130066,130067,0,1,0
37131,3,3,130069,130069,130072,0,3,2
37132,6,3,130075,130075,130078,0,3,3
37133,1,2,130076,130078,130080,2,4,0
37134,4,3,130080,130080,130083,0,3,0
37135,5,3,130085,130085,130088,0,3,2
37136,2,3,130087,130088,130091,1,4,0
37137,4,1,130091,130091,130092,0,1,0
37138,3,3,130094,130094,130097,0,3,2
37139,2,2,130096,130097,130099,1,3,0
37140,1,2,130097,130099,130101,2,4,0
37141,4,2,130101,130101,130103,0,2,0
37142,4,3,130105,130105,130108,0,3,2
37143,3,2,130108,130108,130110,0,2,0
37144,6,3,130114,130114,130117,0,3,4
37145,1,1,130115,130117,130118,2,3,0
37146,3,1,130118,130118,130119,0,1,0
37147,1,2,130119,130119,130121,0,2,0
37148,3,2,130122,130122,130124,0,2,1
37149,6,3,130128,130128,130131,0,3,4
37150,2,3,130130,130131,130134,1,4,0
37151,4,1,130134,130134,130135,0,1,0
37152,5,2,130139,130139,130141,0,2,4
37153,5,2,130144,130144,130146,0,2,3
37154,5,3,130149,130149,130152,0,3,3
37155,3,1,130152,130152,130153,0,1,0
37156,3,1,130155,130155,130156,0,1,2
37157,3,1,130158,130158,130159,0,1,2
37158,6,1,130164,130164,130165,0,1,5
37159,2,1,130166,130166,130167,0,1,1
37160,4,3,130170,130170,130173,0,3,3
37161,4,3,130174,130174,130177,0,3,1
37162,3,3,130177,130177,130180,0,3,0
37163,4,1,130181,130181,130182,0,1,1
37164,5,2,130186,130186,130188,0,2,4
37165,5,3,130191,130191,130194,0,3,3
37166,3,2,130194,130194,130196,0,2,0
37167,1,2,130195,130196,130198,1,3,0
37168,5,2,130200,130200,130202,0,2,2
37169,5,1,130205,130205,130206,0,1,3
37170,5,2,130210,130210,130212,0,2,4
37171,3,2,130213,130213,130215,0,2,1
37172,5,1,130218,130218,130219,0,1,3
37173,5,1,130223,130223,130224,0,1,4
37174,6,2,130229,130229,130231,0,2,5
37175,5,1,130234,130234,130235,0,1,3
37176,1,3,130235,130235,130238,0,3,0
37177,4,3,130239,130239,130242,0,3,1
37178,3,3,130242,130242,130245,0,3,0
37179,1,3,130243,130245,130248,2,5,0
37180,2,3,130245,130248,130251,3,6,0
37181,1,1,130246,130251,130252,5,6,0
37182,3,1,130249,130252,130253,3,4,0
37183,1,1,130250,130253,130254,3,4,0
37184,2,2,130252,130254,130256,2,4,0
37185,5,2,130257,130257,130259,0,2,1
37186,4,1,130261,130261,130262,0,1,2
37187,1,2,130262,130262,130264,0,2,0
37188,1,1,130263,130264,130265,1,2,0
37189,6,2,130269,130269,130271,0,2,4
37190,6,3,130275,130275,130278,0,3,4
37191,1,2,130276,130278,130280,2,4,0
37192,3,2,130279,130280,130282,1,3,0
37193,5,2,130284,130284,130286,0,2,2
37194,4,1,130288,130288,130289,0,1,2
37195,6,1,130294,130294,130295,0,1,5
37196,3,3,130297,130297,130300,0,3,2
37197,5,1,130302,130302,130303,0,1,2
37198,6,3,130308,130308,130311,0,3,5
37199,1,3,130309,130311,130314,2,5,0
37200,6,1,130315,130315,130316,0,1,1
37201,4,2,130319,130319,130321,0,2,3
37202,2,2,130321,130321,130323,0,2,0
37203,3,2,130324,130324,130326,0,2,1
37204,1,3,130325,130326,130329,1,4,0
37205,3,1,130328,130329,130330,1,2,0
37206,3,3,130331,130331,130334,0,3,1
37207,6,2,130337,130337,130339,0,2,3
37208,3,1,130340,130340,130341,0,1,1
37209,5,1,130345,130345,130346,0,1,4
37210,3,3,130348,130348,130351,0,3,2
37211,2,2,130350,130351,130353,1,3,0
37212,5,2,130355,130355,130357,0,2,2
37213,2,1,130357,130357,130358,0,1,0
37214,6,1,130363,130363,130364,0,1,5
37215,2,3,130365,130365,130368,0,3,1
37216,1,2,130366,130368,130370,2,4,0
37217,1,1,130367,130370,130371,3,4,0
37218,2,1,130369,130371,130372,2,3,0
37219,4,3,130373,130373,130376,0,3,1
37220,3,1,130376,130376,130377,0,1,0
37221,5,2,130381,130381,130383,0,2,4
37222,2,1,130383,130383,130384,0,1,0
37223,6,2,130389,130389,130391,0,2,5
37224,3,2,130392,130392,130394,0,2,1
37225,5,1,130397,130397,130398,0,1,3
37226,2,2,130399,130399,130401,0,2,1
37227,5,1,130404,130404,130405,0,1,3
37228,2,3,130406,130406,130409,0,3,1
37229,2,1,130408,130409,130410,1,2,0
37230,5,3,130413,130413,130416,0,3,3
37231,5,2,130418,130418,130420,0,2,2
37232,3,3,130421,130421,130424,0,3,1
37233,6,2,130427,130427,130429,0,2,3
37234,3,1,130430,130430,130431,0,1,1
37235,4,1,130434,130434,130435,0,1,3
37236,4,1,130438,130438,130439,0,1,3
37237,2,2,130440,130440,130442,0,2,1
37238,3,1,130443,130443,130444,0,1,1
37239,3,1,130446,130446,130447,0,1,2
37240,3,1,130449,130449,130450,0,1,2
37241,4,1,130453,130453,130454,0,1,3
37242,6,2,130459,130459,130461,0,2,5
37243,6,2,130465,130465,130467,0,2,4
37244,1,2,130466,130467,130469,1,3,0
37245,4,2,130470,130470,130472,0,2,1
37246,5,3,130475,130475,130478,0,3,3
37247,4,2,130479,130479,130481,0,2,1
37248,1,2,130480,130481,130483,1,3,0
37249,4,3,130484,130484,130487,0,3,1
37250,4,2,130488,130488,130490,0,2,1
37251,1,3,130489,130490,130493,1,4,0
37252,1,1,130490,130493,130494,3,4,0
37253,1,1,130491,130494,130495,3,4,0
37254,5,1,130496,130496,130497,0,1,1
37255,6,3,130502,130502,130505,0,3,5
37256,1,3,130503,130505,130508,2,5,0
37257,6,1,130509,130509,130510,0,1,1
37258,3,2,130512,130512,130514,0,2,2
37259,5,3,130517,130517,130520,0,3,3
37260,1,3,130518,130520,130523,2,5,0
37261,1,1,130519,130523,130524,4,5,0
37262,4,2,130523,130524,130526,1,3,0
37263,2,1,130525,130526,130527,1,2,0
37264,4,1,130529,130529,130530,0,1,2
37265,4,2,130533,130533,130535,0,2,3
37266,1,1,130534,130535,130536,1,2,0
37267,3,2,130537,130537,130539,0,2,1
37268,1,1,130538,130539,130540,1,2,0
37269,3,1,130541,130541,130542,0,1,1
37270,5,2,130546,130546,130548,0,2,4
37271,5,1,130551,130551,130552,0,1,3
37272,2,3,130553,130553,130556,0,3,1
37273,6,2,130559,130559,130561,0,2,3
37274,3,3,130562,130562,130565,0,3,1
37275,6,2,130568,130568,130570,0,2,3
37276,4,2,130572,130572,130574,0,2,2
37277,1,1,130573,130574,130575,1,2,0
37278,4,2,130577,130577,130579,0,2,2
37279,1,1,130578,130579,130580,1,2,0
37280,6,1,130584,130584,130585,0,1,4
37281,2,1,130586,130586,130587,0,1,1
37282,2,3,130588,130588,130591,0,3,1
37283,2,2,130590,130591,130593,1,3,0
37284,6,3,130596,130596,130599,0,3,3
37285,3,2,130599,130599,130601,0,2,0
37286,3,3,130602,130602,130605,0,3,1
37287,5,1,130607,130607,130608,0,1,2
37288,3,2,130610,130610,130612,0,2,2
37289,1,3,130611,130612,130615,1,4,0
37290,3,1,130614,130615,130616,1,2,0
37291,5,1,130619,130619,130620,0,1,3
37292,1,2,130620,130620,130622,0,2,0
37293,3,2,130623,130623,130625,0,2,1
37294,2,3,130625,130625,130628,0,3,0
37295,5,3,130630,130630,130633,0,3,2
37296,5,3,130635,130635,130638,0,3,2
37297,3,1,130638,130638,130639,0,1,0
37298,5,1,130643,130643,130644,0,1,4
37299,3,2,130646,130646,130648,0,2,2
37300,4,3,130650,130650,130653,0,3,2
37301,5,1,130655,130655,130656,0,1,2
37302,2,2,130657,130657,130659,0,2,1
37303,4,3,130661,130661,130664,0,3,2
37304,5,3,130666,130666,130669,0,3,2
37305,4,2,130670,130670,130672,0,2,1
37306,4,3,130674,130674,130677,0,3,2
37307,5,2,130679,130679,130681,0,2,2
37308,3,1,130682,130682,130683,0,1,1
37309,4,3,130686,130686,130689,0,3,3
37310,6,1,130692,130692,130693,0,1,3
37311,6,2,130698,130698,130700,0,2,5
37312,1,1,130699,130700,130701,1,2,0
37313,1,2,130700,130701,130703,1,3,0
37314,4,2,130704,130704,130706,0,2,1
37315,5,3,130709,130709,130712,0,3,3
37316,5,3,130714,130714,130717,0,3,2
37317,5,1,130719,130719,130720,0,1,2
37318,5,1,130724,130724,130725,0,1,4
37319,1,1,130725,130725,130726,0,1,0
37320,6,2,130731,130731,130733,0,2,5
37321,6,2,130737,130737,130739,0,2,4
37322,1,2,130738,130739,130741,1,3,0
37323,1,3,130739,130741,130744,2,5,0
37324,6,2,130745,130745,130747,0,2,1
37325,3,2,130748,130748,130750,0,2,1
37326,3,1,130751,130751,130752,0,1,1
37327,2,3,130753,130753,130756,0,3,1
37328,2,3,130755,130756,130759,1,4,0
37329,3,3,130758,130759,130762,1,4,0
37330,5,3,130763,130763,130766,0,3,1
37331,3,1,130766,130766,130767,0,1,0
37332,3,3,130769,130769,130772,0,3,2
37333,1,2,130770,130772,130774,2,4,0
37334,2,1,130772,130774,130775,2,3,0
37335,5,2,130777,130777,130779,0,2,2
37336,3,1,130780,130780,130781,0,1,1
37337,5,1,130785,130785,130786,0,1,4
37338,2,1,130787,130787,130788,0,1,1
37339,5,1,130792,130792,130793,0,1,4
37340,3,2,130795,130795,130797,0,2,2
37341,1,2,130796,130797,130799,1,3,0
37342,6,3,130802,130802,130805,0,3,3
37343,5,2,130807,130807,130809,0,2,2
37344,1,3,130808,130809,130812,1,4,0
37345,1,3,130809,130812,130815,3,6,0
37346,5,3,130814,130815,130818,1,4,0
37347,5,1,130819,130819,130820,0,1,1
37348,3,1,130822,130822,130823,0,1,2
37349,6,3,130828,130828,130831,0,3,5
37350,3,3,130831,130831,130834,0,3,0
37351,3,1,130834,130834,130835,0,1,0
37352,4,3,130838,130838,130841,0,3,3
37353,2,2,130840,130841,130843,1,3,0
37354,5,2,130845,130845,130847,0,2,2
37355,5,2,130850,130850,130852,0,2,3
37356,5,1,130855,130855,130856,0,1,3
37357,6,2,130861,130861,130863,0,2,5
37358,6,1,130867,130867,130868,0,1,4
37359,1,2,130868,130868,130870,0,2,0
37360,6,3,130874,130874,130877,0,3,4
37361,4,2,130878,130878,130880,0,2,1
37362,6,2,130884,130884,130886,0,2,4
37363,4,3,130888,130888,130891,0,3,2
37364,2,1,130890,130891,130892,1,2,0
37365,1,3,130891,130892,130895,1,4,0
37366,3,1,130894,130895,130896,1,2,0
37367,3,1,130897,130897,130898,0,1,1
37368,5,1,130902,130902,130903,0,1,4
37369,6,1,130908,130908,130909,0,1,5
37370,6,3,130914,130914,130917,0,3,5
37371,2,1,130916,130917,130918,1,2,0
37372,4,2,130920,130920,130922,0,2,2
37373,3,2,130923,130923,130925,0,2,1
37374,5,1,130928,130928,130929,0,1,3
37375,3,3,130931,130931,130934,0,3,2
37376,5,2,130936,130936,130938,0,2,2
37377,5,1,130941,130941,130942,0,1,3
37378,1,2,130942,130942,130944,0,2,0
37379,1,1,130943,130944,130945,1,2,0
37380,6,1,130949,130949,130950,0,1,4
37381,3,2,130952,130952,130954,0,2,2
37382,3,1,130955,130955,130956,0,1,1
37383,1,1,130956,130956,130957,0,1,0
37384,2,3,130958,130958,130961,0,3,1
37385,4,3,130962,130962,130965,0,3,1
37386,6,2,130968,130968,130970,0,2,3
37387,3,2,130971,130971,130973,0,2,1
37388,6,1,130977,130977,130978,0,1,4
37389,1,3,130978,130978,130981,0,3,0
37390,6,3,130984,130984,130987,0,3,3
37391,2,1,130986,130987,130988,1,2,0
37392,5,2,130991,130991,130993,0,2,3
37393,1,3,130992,130993,130996,1,4,0
37394,3,2,130995,130996,130998,1,3,0
37395,4,3,130999,130999,131002,0,3,1
37396,4,2,131003,131003,131005,0,2,1
37397,1,2,131004,131005,131007,1,3,0
37398,5,2,131009,131009,131011,0,2,2
37399,5,2,131014,131014,131016,0,2,3
37400,3,2,131017,131017,131019,0,2,1
37401,1,1,131018,131019,131020,1,2,0
37402,2,2,131020,131020,131022,0,2,0
37403,6,1,131026,131026,131027,0,1,4
37404,3,2,131029,131029,131031,0,2,2
37405,6,2,131035,131035,131037,0,2,4
37406,2,3,131037,131037,131040,0,3,0
37407,2,2,131039,131040,131042,1,3,0
37408,3,2,131042,131042,131044,0,2,0
37409,3,2,131045,131045,131047,0,2,1
37410,4,3,131049,131049,131052,0,3,2
37411,6,3,131055,131055,131058,0,3,3
37412,4,3,131059,131059,131062,0,3,1
37413,5,3,131064,131064,131067,0,3,2
37414,1,3,131065,131067,131070,2,5,0
37415,5,2,131070,131070,131072,0,2,0
37416,3,3,131073,131073,131076,0,3,1
37417,3,2,131076,131076,131078,0,2,0
37418,3,3,131079,131079,131082,0,3,1
37419,6,1,131085,131085,131086,0,1,3
37420,4,2,131089,131089,131091,0,2,3
37421,5,1,131094,131094,131095,0,1,3
37422,4,3,131098,131098,131101,0,3,3
37423,1,3,131099,131101,131104,2,5,0
37424,5,3,131104,131104,131107,0,3,0
37425,5,1,131109,131109,131110,0,1,2
37426,4,2,131113,131113,131115,0,2,3
37427,6,1,131119,131119,131120,0,1,4
37428,3,3,131122,131122,131125,0,3,2
37429,6,1,131128,131128,131129,0,1,3
37430,5,3,131133,131133,131136,0,3,4
37431,2,2,131135,131136,131138,1,3,0
37432,5,2,131140,131140,131142,0,2,2
37433,3,2,131143,131143,131145,0,2,1
37434,2,2,131145,131145,131147,0,2,0
37435,6,3,131151,131151,131154,0,3,4
37436,2,3,131153,131154,131157,1,4,0
37437,6,2,131159,131159,131161,0,2,2
37438,6,1,131165,131165,131166,0,1,4
37439,1,1,131166,131166,131167,0,1,0
37440,3,3,131169,131169,131172,0,3,2
37441,2,2,131171,131172,131174,1,3,0
37442,2,1,131173,131174,131175,1,2,0
37443,2,2,131175,131175,131177,0,2,0
37444,1,3,131176,131177,131180,1,4,0
37445,6,3,131182,131182,131185,0,3,2
37446,3,2,131185,131185,131187,0,2,0
37447,6,1,131191,131191,131192,0,1,4
37448,6,1,131197,131197,131198,0,1,5
37449,5,3,131202,131202,131205,0,3,4
37450,4,3,131206,131206,131209,0,3,1
37451,6,1,131212,131212,131213,0,1,3
37452,4,1,131216,131216,131217,0,1,3
37453,1,1,131217,131217,131218,0,1,0
37454,2,3,131219,131219,131222,0,3,1
37455,5,3,131224,131224,131227,0,3,2
37456,3,1,131227,131227,131228,0,1,0
37457,4,3,131231,131231,131234,0,3,3
37458,6,2,131237,131237,131239,0,2,3
37459,6,1,131243,131243,131244,0,1,4
37460,5,1,131248,131248,131249,0,1,4
37461,2,3,131250,131250,131253,0,3,1
37462,4,2,131254,131254,131256,0,2,1
37463,5,1,131259,131259,131260,0,1,3
37464,2,1,131261,131261,131262,0,1,1
37465,3,1,131264,131264,131265,0,1,2
37466,5,1,131269,131269,131270,0,1,4
37467,6,1,131275,131275,131276,0,1,5
37468,6,2,131281,131281,131283,0,2,5
37469,6,2,131287,131287,131289,0,2,4
37470,2,1,131289,131289,131290,0,1,0
37471,4,2,131293,131293,131295,0,2,3
37472,3,1,131296,131296,131297,0,1,1
37473,6,1,131302,131302,131303,0,1,5
37474,4,1,131306,131306,131307,0,1,3
37475,5,3,131311,131311,131314,0,3,4
37476,2,2,131313,131314,131316,1,3,0
37477,6,1,131319,131319,131320,0,1,3
37478,5,1,131324,131324,131325,0,1,4
37479,2,2,131326,131326,131328,0,2,1
37480,4,2,131330,131330,131332,0,2,2
37481,2,3,131332,131332,131335,0,3,0
37482,2,2,131334,131335,131337,1,3,0
37483,6,2,131340,131340,131342,0,2,3
37484,2,1,131342,131342,131343,0,1,0
37485,5,1,131347,131347,131348,0,1,4
37486,3,1,131350,131350,131351,0,1,2
37487,4,1,131354,131354,131355,0,1,3
37488,5,1,131359,131359,131360,0,1,4
37489,1,3,131360,131360,131363,0,3,0
37490,2,3,131362,131363,131366,1,4,0
37491,3,1,131365,131366,131367,1,2,0
37492,1,1,131366,131367,131368,1,2,0
37493,1,3,131367,131368,131371,1,4,0
37494,5,2,131372,131372,131374,0,2,1
37495,5,1,131377,131377,131378,0,1,3
37496,5,3,131382,131382,131385,0,3,4
37497,2,3,131384,131385,131388,1,4,0
37498,2,2,131386,131388,131390,2,4,0
37499,6,2,131392,131392,131394,0,2,2
37500,6,3,131398,131398,131401,0,3,4
37501,2,3,131400,131401,131404,1,4,0
37502,6,2,131406,131406,131408,0,2,2
37503,1,3,131407,131408,131411,1,4,0
37504,4,1,131411,131411,131412,0,1,0
37505,3,2,131414,131414,131416,0,2,2
37506,1,2,131415,131416,131418,1,3,0
37507,4,1,131419,131419,131420,0,1,1
37508,4,1,131423,131423,131424,0,1,3
37509,6,1,131429,131429,131430,0,1,5
37510,6,2,131435,131435,131437,0,2,5
37511,1,1,131436,131437,131438,1,2,0
37512,6,3,131442,131442,131445,0,3,4
37513,4,3,131446,131446,131449,0,3,1
37514,1,2,131447,131449,131451,2,4,0
37515,1,2,131448,131451,131453,3,5,0
37516,3,3,131451,131453,131456,2,5,0
37517,1,2,131452,131456,131458,4,6,0
37518,2,3,131454,131458,131461,4,7,0
37519,4,1,131458,131461,131462,3,4,0
37520,6,2,131464,131464,131466,0,2,2
37521,6,2,131470,131470,131472,0,2,4
37522,3,3,131473,131473,131476,0,3,1
37523,5,1,131478,131478,131479,0,1,2
37524,1,1,131479,131479,131480,0,1,0
37525,5,3,131484,131484,131487,0,3,4
37526,3,1,131487,131487,131488,0,1,0
37527,1,3,131488,131488,131491,0,3,0
37528,5,1,131493,131493,131494,0,1,2
37529,5,3,131498,131498,131501,0,3,4
37530,5,3,131503,131503,131506,0,3,2
37531,2,2,131505,131506,131508,1,3,0
37532,5,3,131510,131510,131513,0,3,2
37533,3,1,131513,131513,131514,0,1,0
37534,1,2,131514,131514,131516,0,2,0
37535,2,2,131516,131516,131518,0,2,0
37536,2,2,131518,131518,131520,0,2,0
37537,4,2,131522,131522,131524,0,2,2
37538,2,3,131524,131524,131527,0,3,0
37539,5,3,131529,131529,131532,0,3,2
37540,4,3,131533,131533,131536,0,3,1
37541,4,2,131537,131537,131539,0,2,1
37542,5,2,131542,131542,131544,0,2,3
37543,1,1,131543,131544,131545,1,2,0
37544,3,1,131546,131546,131547,0,1,1
37545,6,3,131552,131552,131555,0,3,5
37546,4,2,131556,131556,131558,0,2,1
37547,2,2,131558,131558,131560,0,2,0
37548,3,2,131561,131561,131563,0,2,1
37549,6,3,131567,131567,131570,0,3,4
37550,2,3,131569,131570,131573,1,4,0
37551,1,2,131570,131573,131575,3,5,0
37552,2,1,131572,131575,131576,3,4,0
37553,6,2,131578,131578,131580,0,2,2
37554,3,2,131581,131581,131583,0,2,1
37555,6,1,131587,131587,131588,0,1,4
37556,2,1,131589,131589,131590,0,1,1
37557,5,3,131594,131594,131597,0,3,4
37558,5,1,131599,131599,131600,0,1,2
37559,1,1,131600,131600,131601,0,1,0
37560,3,3,131603,131603,131606,0,3,2
37561,5,2,131608,131608,131610,0,2,2
37562,5,3,131613,131613,131616,0,3,3
37563,6,2,131619,131619,131621,0,2,3
37564,3,1,131622,131622,131623,0,1,1
37565,5,1,131627,131627,131628,0,1,4
37566,5,1,131632,131632,131633,0,1,4
37567,1,3,131633,131633,131636,0,3,0
37568,3,2,131636,131636,131638,0,2,0
37569,3,3,131639,131639,131642,0,3,1
37570,3,3,131642,131642,131645,0,3,0
37571,1,2,131643,131645,131647,2,4,0
37572,4,2,131647,131647,131649,0,2,0
37573,1,1,131648,131649,131650,1,2,0
37574,6,1,131654,131654,131655,0,1,4
37575,1,3,131655,131655,131658,0,3,0
37576,1,1,131656,131658,131659,2,3,0
37577,1,3,131657,131659,131662,2,5,0
37578,5,2,131662,131662,131664,0,2,0
37579,1,1,131663,131664,131665,1,2,0
37580,2,1,131665,131665,131666,0,1,0
37581,1,2,131666,131666,131668,0,2,0
37582,3,1,131669,131669,131670,0,1,1
37583,3,1,131672,131672,131673,0,1,2
37584,2,2,131674,131674,131676,0,2,1
37585,6,2,131680,131680,131682,0,2,4
37586,4,1,131684,131684,131685,0,1,2
37587,2,2,131686,131686,131688,0,2,1
37588,1,3,131687,131688,131691,1,4,0
37589,6,1,131693,131693,131694,0,1,2
37590,5,1,131698,131698,131699,0,1,4
37591,2,1,131700,131700,131701,0,1,1
37592,5,1,131705,131705,131706,0,1,4
37593,2,1,131707,131707,131708,0,1,1
37594,6,1,131713,131713,131714,0,1,5
37595,2,1,131715,131715,131716,0,1,1
37596,3,2,131718,131718,131720,0,2,2
37597,1,3,131719,131720,131723,1,4,0
37598,1,3,131720,131723,131726,3,6,0
37599,5,2,131725,131726,131728,1,3,0
37600,1,2,131726,131728,131730,2,4,0
37601,5,2,131731,131731,131733,0,2,1
37602,5,1,131736,131736,131737,0,1,3
37603,5,2,131741,131741,131743,0,2,4
37604,3,2,131744,131744,131746,0,2,1
37605,3,1,131747,131747,131748,0,1,1
37606,2,1,131749,131749,131750,0,1,1
37607,3,2,131752,131752,131754,0,2,2
37608,1,2,131753,131754,131756,1,3,0
37609,4,1,131757,131757,131758,0,1,1
37610,1,2,131758,131758,131760,0,2,0
37611,5,1,131763,131763,131764,0,1,3
37612,6,2,131769,131769,131771,0,2,5
37613,2,1,131771,131771,131772,0,1,0
37614,1,3,131772,131772,131775,0,3,0
37615,1,3,131773,131775,131778,2,5,0
37616,6,2,131779,131779,131781,0,2,1
37617,6,1,131785,131785,131786,0,1,4
37618,6,1,131791,131791,131792,0,1,5
37619,6,1,131797,131797,131798,0,1,5
37620,4,3,131801,131801,131804,0,3,3
37621,2,3,131803,131804,131807,1,4,0
37622,4,1,131807,131807,131808,0,1,0
37623,1,2,131808,131808,131810,0,2,0
37624,1,2,131809,131810,131812,1,3,0
37625,1,2,131810,131812,131814,2,4,0
37626,2,1,131812,131814,131815,2,3,0
37627,2,1,131814,131815,131816,1,2,0
37628,3,3,131817,131817,131820,0,3,1
37629,5,1,131822,131822,131823,0,1,2
37630,3,2,131825,131825,131827,0,2,2
37631,1,3,131826,131827,131830,1,4,0
37632,1,2,131827,131830,131832,3,5,0
37633,5,2,131832,131832,131834,0,2,0
37634,3,3,131835,131835,131838,0,3,1
37635,1,1,131836,131838,131839,2,3,0
37636,5,2,131841,131841,131843,0,2,2
37637,1,1,131842,131843,131844,1,2,0
37638,1,3,131843,131844,131847,1,4,0
37639,3,1,131846,131847,131848,1,2,0
37640,2,2,131848,131848,131850,0,2,0
37641,6,3,131854,131854,131857,0,3,4
37642,3,1,131857,131857,131858,0,1,0
37643,1,1,131858,131858,131859,0,1,0
37644,4,3,131862,131862,131865,0,3,3
37645,4,2,131866,131866,131868,0,2,1
37646,4,1,131870,131870,131871,0,1,2
37647,2,3,131872,131872,131875,0,3,1
37648,6,1,131878,131878,131879,0,1,3
37649,2,3,131880,131880,131883,0,3,1
37650,1,3,131881,131883,131886,2,5,0
37651,3,2,131884,131886,131888,2,4,0
37652,5,1,131889,131889,131890,0,1,1
37653,2,3,131891,131891,131894,0,3,1
37654,6,2,131897,131897,131899,0,2,3
37655,5,3,131902,131902,131905,0,3,3
37656,3,3,131905,131905,131908,0,3,0
37657,1,3,131906,131908,131911,2,5,0
37658,5,3,131911,131911,131914,0,3,0
37659,4,3,131915,131915,131918,0,3,1
37660,3,3,131918,131918,131921,0,3,0
37661,5,1,131923,131923,131924,0,1,2
37662,5,1,131928,131928,131929,0,1,4
37663,5,3,131933,131933,131936,0,3,4
37664,4,2,131937,131937,131939,0,2,1
37665,2,3,131939,131939,131942,0,3,0
37666,3,1,131942,131942,131943,0,1,0
37667,1,3,131943,131943,131946,0,3,0
37668,4,3,131947,131947,131950,0,3,1
37669,2,2,131949,131950,131952,1,3,0
37670,1,1,131950,131952,131953,2,3,0
37671,1,2,131951,131953,131955,2,4,0
37672,6,1,131957,131957,131958,0,1,2
37673,6,2,131963,131963,131965,0,2,5
37674,6,1,131969,131969,131970,0,1,4
37675,3,3,131972,131972,131975,0,3,2
37676,2,3,131974,131975,131978,1,4,0
37677,3,1,131977,131978,131979,1,2,0
37678,4,2,131981,131981,131983,0,2,2
37679,1,3,131982,131983,131986,1,4,0
37680,4,3,131986,131986,131989,0,3,0
37681,6,1,131992,131992,131993,0,1,3
37682,5,2,131997,131997,131999,0,2,4
37683,1,2,131998,131999,132001,1,3,0
37684,1,2,131999,132001,132003,2,4,0
37685,3,2,132002,132003,132005,1,3,0
37686,4,2,132006,132006,132008,0,2,1
37687,5,3,132011,132011,132014,0,3,3
37688,3,1,132014,132014,132015,0,1,0
37689,6,1,132020,132020,132021,0,1,5
37690,2,1,132022,132022,132023,0,1,1
37691,4,2,132026,132026,132028,0,2,3
37692,6,2,132032,132032,132034,0,2,4
37693,4,2,132036,132036,132038,0,2,2
37694,3,1,132039,132039,132040,0,1,1
37695,6,1,132045,132045,132046,0,1,5
37696,1,3,132046,132046,132049,0,3,0
37697,4,2,132050,132050,132052,0,2,1
37698,5,3,132055,132055,132058,0,3,3
37699,2,3,132057,132058,132061,1,4,0
37700,5,1,132062,132062,132063,0,1,1
37701,4,2,132066,132066,132068,0,2,3
37702,3,2,132069,132069,132071,0,2,1
37703,5,3,132074,132074,132077,0,3,3
37704,1,1,132075,132077,132078,2,3,0
37705,1,2,132076,132078,132080,2,4,0
37706,1,1,132077,132080,132081,3,4,0
37707,1,3,132078,132081,132084,3,6,0
37708,1,1,132079,132084,132085,5,6,0
37709,2,2,132081,132085,132087,4,6,0
37710,2,3,132083,132087,132090,4,7,0
37711,6,3,132089,132090,132093,1,4,0
37712,5,3,132094,132094,132097,0,3,1
37713,5,2,132099,132099,132101,0,2,2
37714,4,2,132103,132103,132105,0,2,2
37715,3,2,132106,132106,132108,0,2,1
37716,4,3,132110,132110,132113,0,3,2
37717,6,3,132116,132116,132119,0,3,3
37718,6,2,132122,132122,132124,0,2,3
37719,1,1,132123,132124,132125,1,2,0
37720,6,1,132129,132129,132130,0,1,4
37721,1,1,132130,132130,132131,0,1,0
37722,6,1,132136,132136,132137,0,1,5
37723,3,1,132139,132139,132140,0,1,2
37724,2,3,132141,132141,132144,0,3,1
37725,2,2,132143,132144,132146,1,3,0
37726,4,1,132147,132147,132148,0,1,1
37727,6,3,132153,132153,132156,0,3,5
37728,3,1,132156,132156,132157,0,1,0
37729,6,3,132162,132162,132165,0,3,5
37730,3,2,132165,132165,132167,0,2,0
37731,4,2,132169,132169,132171,0,2,2
37732,3,3,132172,132172,132175,0,3,1
37733,4,1,132176,132176,132177,0,1,1
37734,6,2,132182,132182,132184,0,2,5
37735,4,2,132186,132186,132188,0,2,2
37736,6,2,132192,132192,132194,0,2,4
37737,2,2,132194,132194,132196,0,2,0
37738,5,2,132199,132199,132201,0,2,3
37739,1,3,132200,132201,132204,1,4,0
37740,2,3,132202,132204,132207,2,5,0
37741,5,1,132207,132207,132208,0,1,0
37742,5,3,132212,132212,132215,0,3,4
37743,3,3,132215,132215,132218,0,3,0
37744,3,2,132218,132218,132220,0,2,0
37745,3,1,132221,132221,132222,0,1,1
37746,2,1,132223,132223,132224,0,1,1
37747,4,2,132227,132227,132229,0,2,3
37748,4,1,132231,132231,132232,0,1,2
37749,4,2,132235,132235,132237,0,2,3
37750,6,2,132241,132241,132243,0,2,4
37751,2,1,132243,132243,132244,0,1,0
37752,4,1,132247,132247,132248,0,1,3
37753,2,1,132249,132249,132250,0,1,1
37754,2,2,132251,132251,132253,0,2,1
37755,3,2,132254,132254,132256,0,2,1
37756,2,3,132256,132256,132259,0,3,0
37757,1,2,132257,132259,132261,2,4,0
37758,5,3,132262,132262,132265,0,3,1
37759,4,3,132266,132266,132269,0,3,1
37760,2,2,132268,132269,132271,1,3,0
37761,5,1,132273,132273,132274,0,1,2
37762,6,1,132279,132279,132280,0,1,5
37763,5,1,132284,132284,132285,0,1,4
37764,6,2,132290,132290,132292,0,2,5
37765,2,3,132292,132292,132295,0,3,0
37766,3,2,132295,132295,132297,0,2,0
37767,5,3,132300,132300,132303,0,3,3
37768,6,1,132306,132306,132307,0,1,3
37769,3,2,132309,132309,132311,0,2,2
37770,5,3,132314,132314,132317,0,3,3
37771,4,3,132318,132318,132321,0,3,1
37772,2,1,132320,132321,132322,1,2,0
37773,6,3,132326,132326,132329,0,3,4
37774,6,3,132332,132332,132335,0,3,3
37775,3,1,132335,132335,132336,0,1,0
37776,6,3,132341,132341,132344,0,3,5
37777,3,3,132344,132344,132347,0,3,0
37778,5,2,132349,132349,132351,0,2,2
37779,4,2,132353,132353,132355,0,2,2
37780,6,1,132359,132359,132360,0,1,4
37781,5,2,132364,132364,132366,0,2,4
37782,2,2,132366,132366,132368,0,2,0
37783,3,1,132369,132369,132370,0,1,1
37784,2,2,132371,132371,132373,0,2,1
37785,3,1,132374,132374,132375,0,1,1
37786,2,2,132376,132376,132378,0,2,1
37787,2,2,132378,132378,132380,0,2,0
37788,5,2,132383,132383,132385,0,2,3
37789,3,3,132386,132386,132389,0,3,1
37790,6,3,132392,132392,132395,0,3,3
37791,3,1,132395,132395,132396,0,1,0
37792,6,3,132401,132401,132404,0,3,5
37793,1,1,132402,132404,132405,2,3,0
37794,3,3,132405,132405,132408,0,3,0
37795,1,3,132406,132408,132411,2,5,0
37796,1,3,132407,132411,132414,4,7,0
37797,6,1,132413,132414,132415,1,2,0
37798,5,1,132418,132418,132419,0,1,3
37799,6,1,132424,132424,132425,0,1,5
37800,6,3,132430,132430,132433,0,3,5
37801,5,2,132435,132435,132437,0,2,2
37802,3,1,132438,132438,132439,0,1,1
37803,6,2,132444,132444,132446,0,2,5
37804,6,2,132450,132450,132452,0,2,4
37805,2,3,132452,132452,132455,0,3,0
37806,4,2,132456,132456,132458,0,2,1
37807,4,1,132460,132460,132461,0,1,2
37808,5,2,132465,132465,132467,0,2,4
37809,5,2,132470,132470,132472,0,2,3
37810,2,2,132472,132472,132474,0,2,0
37811,5,1,132477,132477,132478,0,1,3
37812,4,3,132481,132481,132484,0,3,3
37813,3,1,132484,132484,132485,0,1,0
37814,5,1,132489,132489,132490,0,1,4
37815,4,2,132493,132493,132495,0,2,3
37816,1,2,132494,132495,132497,1,3,0
37817,1,2,132495,132497,132499,2,4,0
37818,2,2,132497,132499,132501,2,4,0
37819,5,3,132502,132502,132505,0,3,1
37820,1,3,132503,132505,132508,2,5,0
37821,5,2,132508,132508,132510,0,2,0
37822,6,1,132514,132514,132515,0,1,4
37823,5,2,132519,132519,132521,0,2,4
37824,4,3,132523,132523,132526,0,3,2
37825,2,1,132525,132526,132527,1,2,0
37826,1,1,132526,132527,132528,1,2,0
37827,2,2,132528,132528,132530,0,2,0
37828,6,2,132534,132534,132536,0,2,4
37829,5,3,132539,132539,132542,0,3,3
37830,2,2,132541,132542,132544,1,3,0
37831,3,1,132544,132544,132545,0,1,0
37832,3,2,132547,132547,132549,0,2,2
37833,3,1,132550,132550,132551,0,1,1
37834,3,3,132553,132553,132556,0,3,2
37835,5,1,132558,132558,132559,0,1,2
37836,1,3,132559,132559,132562,0,3,0
37837,6,3,132565,132565,132568,0,3,3
37838,2,3,132567,132568,132571,1,4,0
37839,4,2,132571,132571,132573,0,2,0
37840,5,1,132576,132576,132577,0,1,3
37841,5,1,132581,132581,132582,0,1,4
37842,4,1,132585,132585,132586,0,1,3
37843,4,3,132589,132589,132592,0,3,3
37844,5,2,132594,132594,132596,0,2,2
37845,2,2,132596,132596,132598,0,2,0
37846,1,3,132597,132598,132601,1,4,0
37847,5,2,132602,132602,132604,0,2,1
37848,3,3,132605,132605,132608,0,3,1
37849,2,1,132607,132608,132609,1,2,0
37850,5,3,132612,132612,132615,0,3,3
37851,3,2,132615,132615,132617,0,2,0
37852,4,2,132619,132619,132621,0,2,2
37853,6,3,132625,132625,132628,0,3,4
37854,1,2,132626,132628,132630,2,4,0
37855,1,2,132627,132630,132632,3,5,0
37856,5,2,132632,132632,132634,0,2,0
37857,6,2,132638,132638,132640,0,2,4
37858,3,3,132641,132641,132644,0,3,1
37859,4,1,132645,132645,132646,0,1,1
37860,2,2,132647,132647,132649,0,2,1
37861,1,1,132648,132649,132650,1,2,0
37862,5,1,132653,132653,132654,0,1,3
37863,4,1,132657,132657,132658,0,1,3
37864,5,2,132662,132662,132664,0,2,4
37865,2,2,132664,132664,132666,0,2,0
37866,1,2,132665,132666,132668,1,3,0
37867,3,1,132668,132668,132669,0,1,0
37868,3,2,132671,132671,132673,0,2,2
37869,4,1,132675,132675,132676,0,1,2
37870,4,2,132679,132679,132681,0,2,3
37871,6,2,132685,132685,132687,0,2,4
37872,6,3,132691,132691,132694,0,3,4
37873,5,3,132696,132696,132699,0,3,2
37874,3,3,132699,132699,132702,0,3,0
37875,4,3,132703,132703,132706,0,3,1
37876,1,2,132704,132706,132708,2,4,0
37877,3,3,132707,132708,132711,1,4,0
37878,5,2,132712,132712,132714,0,2,1
37879,3,3,132715,132715,132718,0,3,1
37880,5,3,132720,132720,132723,0,3,2
37881,2,3,132722,132723,132726,1,4,0
37882,6,2,132728,132728,132730,0,2,2
37883,2,3,132730,132730,132733,0,3,0
37884,4,1,132734,132734,132735,0,1,1
37885,3,3,132737,132737,132740,0,3,2
37886,4,3,132741,132741,132744,0,3,1
37887,6,2,132747,132747,132749,0,2,3
37888,2,2,132749,132749,132751,0,2,0
37889,4,3,132753,132753,132756,0,3,2
37890,6,1,132759,132759,132760,0,1,3
37891,2,2,132761,132761,132763,0,2,1
37892,2,2,132763,132763,132765,0,2,0
37893,1,3,132764,132765,132768,1,4,0
37894,5,3,132769,132769,132772,0,3,1
37895,2,3,132771,132772,132775,1,4,0
37896,5,2,132776,132776,132778,0,2,1
37897,4,3,132780,132780,132783,0,3,2
37898,3,2,132783,132783,132785,0,2,0
37899,2,3,132785,132785,132788,0,3,0
37900,1,2,132786,132788,132790,2,4,0
37901,6,2,132792,132792,132794,0,2,2
37902,3,1,132795,132795,132796,0,1,1
37903,4,2,132799,132799,132801,0,2,3
37904,4,2,132803,132803,132805,0,2,2
37905,1,1,132804,132805,132806,1,2,0
37906,3,2,132807,132807,132809,0,2,1
37907,3,3,132810,132810,132813,0,3,1
37908,4,2,132814,132814,132816,0,2,1
37909,3,2,132817,132817,132819,0,2,1
37910,4,3,132821,132821,132824,0,3,2
37911,2,3,132823,132824,132827,1,4,0
37912,3,3,132826,132827,132830,1,4,0
37913,3,1,132829,132830,132831,1,2,0
37914,3,3,132832,132832,132835,0,3,1
37915,4,1,132836,132836,132837,0,1,1
37916,4,2,132840,132840,132842,0,2,3
37917,4,2,132844,132844,132846,0,2,2
37918,2,1,132846,132846,132847,0,1,0
37919,6,1,132852,132852,132853,0,1,5
37920,5,2,132857,132857,132859,0,2,4
37921,6,3,132863,132863,132866,0,3,4
37922,6,3,132869,132869,132872,0,3,3
37923,1,1,132870,132872,132873,2,3,0
37924,6,2,132876,132876,132878,0,2,3
37925,3,2,132879,132879,132881,0,2,1
37926,6,1,132885,132885,132886,0,1,4
37927,6,1,132891,132891,132892,0,1,5
37928,4,1,132895,132895,132896,0,1,3
37929,2,3,132897,132897,132900,0,3,1
37930,2,2,132899,132900,132902,1,3,0
37931,5,3,132904,132904,132907,0,3,2
37932,1,3,132905,132907,132910,2,5,0
37933,6,2,132911,132911,132913,0,2,1
37934,3,1,132914,132914,132915,0,1,1
37935,1,1,132915,132915,132916,0,1,0
37936,3,2,132918,132918,132920,0,2,2
37937,2,2,132920,132920,132922,0,2,0
37938,6,1,132926,132926,132927,0,1,4
37939,2,3,132928,132928,132931,0,3,1
37940,5,2,132933,132933,132935,0,2,2
37941,4,2,132937,132937,132939,0,2,2
37942,3,1,132940,132940,132941,0,1,1
37943,6,3,132946,132946,132949,0,3,5
37944,4,3,132950,132950,132953,0,3,1
37945,5,2,132955,132955,132957,0,2,2
37946,1,1,132956,132957,132958,1,2,0
37947,2,3,132958,132958,132961,0,3,0
37948,3,2,132961,132961,132963,0,2,0
37949,6,3,132967,132967,132970,0,3,4
37950,4,1,132971,132971,132972,0,1,1
37951,1,3,132972,132972,132975,0,3,0
37952,3,2,132975,132975,132977,0,2,0
37953,3,3,132978,132978,132981,0,3,1
37954,4,1,132982,132982,132983,0,1,1
37955,6,3,132988,132988,132991,0,3,5
37956,6,2,132994,132994,132996,0,2,3
37957,1,1,132995,132996,132997,1,2,0
37958,1,3,132996,132997,133000,1,4,0
37959,1,3,132997,133000,133003,3,6,0
37960,5,1,133002,133003,133004,1,2,0
37961,3,1,133005,133005,133006,0,1,1
37962,2,3,133007,133007,133010,0,3,1
37963,6,2,133013,133013,133015,0,2,3
37964,1,3,133014,133015,133018,1,4,0
37965,2,2,133016,133018,133020,2,4,0
37966,2,3,133018,133020,133023,2,5,0
37967,2,3,133020,133023,133026,3,6,0
37968,5,2,133025,133026,133028,1,3,0
37969,1,2,133026,133028,133030,2,4,0
37970,3,2,133029,133030,133032,1,3,0
37971,5,2,133034,133034,133036,0,2,2
37972,2,2,133036,133036,133038,0,2,0
37973,2,2,133038,133038,133040,0,2,0
37974,5,2,133043,133043,133045,0,2,3
37975,5,3,133048,133048,133051,0,3,3
37976,1,2,133049,133051,133053,2,4,0
37977,3,2,133052,133053,133055,1,3,0
37978,5,2,133057,133057,133059,0,2,2
37979,1,2,133058,133059,133061,1,3,0
37980,4,1,133062,133062,133063,0,1,1
37981,1,1,133063,133063,133064,0,1,0
37982,5,1,133068,133068,133069,0,1,4
37983,3,3,133071,133071,133074,0,3,2
37984,6,3,133077,133077,133080,0,3,3
37985,5,3,133082,133082,133085,0,3,2
37986,6,2,133088,133088,133090,0,2,3
37987,2,3,133090,133090,133093,0,3,0
37988,4,2,133094,133094,133096,0,2,1
37989,4,1,133098,133098,133099,0,1,2
37990,5,2,133103,133103,133105,0,2,4
37991,1,3,133104,133105,133108,1,4,0
37992,1,3,133105,133108,133111,3,6,0
37993,3,2,133108,133111,133113,3,5,0
37994,3,1,133111,133113,133114,2,3,0
37995,2,2,133113,133114,133116,1,3,0
37996,6,2,133119,133119,133121,0,2,3
37997,4,3,133123,133123,133126,0,3,2
37998,1,1,133124,133126,133127,2,3,0
37999,3,2,133127,133127,133129,0,2,0
38000,4,3,133131,133131,133134,0,3,2
38001,3,3,133134,133134,133137,0,3,0
38002,5,1,133139,133139,133140,0,1,2
38003,5,3,133144,133144,133147,0,3,4
38004,5,2,133149,133149,133151,0,2,2
38005,6,3,133155,133155,133158,0,3,4
38006,4,2,133159,133159,133161,0,2,1
38007,1,3,133160,133161,133164,1,4,0
38008,2,1,133162,133164,133165,2,3,0
38009,4,1,133166,133166,133167,0,1,1
38010,3,1,133169,133169,133170,0,1,2
38011,6,3,133175,133175,133178,0,3,5
38012,5,3,133180,133180,133183,0,3,2
38013,6,2,133186,133186,133188,0,2,3
38014,5,3,133191,133191,133194,0,3,3
38015,3,3,133194,133194,133197,0,3,0
38016,6,3,133200,133200,133203,0,3,3
38017,2,2,133202,133203,133205,1,3,0
38018,3,3,133205,133205,133208,0,3,0
38019,6,3,133211,133211,133214,0,3,3
38020,2,3,133213,133214,133217,1,4,0
38021,1,1,133214,133217,133218,3,4,0
38022,4,3,133218,133218,133221,0,3,0
38023,2,3,133220,133221,133224,1,4,0
38024,2,3,133222,133224,133227,2,5,0
38025,5,2,133227,133227,133229,0,2,0
38026,5,2,133232,133232,133234,0,2,3
38027,6,3,133238,133238,133241,0,3,4
38028,2,2,133240,133241,133243,1,3,0
38029,3,1,133243,133243,133244,0,1,0
38030,5,2,133248,133248,133250,0,2,4
38031,5,2,133253,133253,133255,0,2,3
38032,5,3,133258,133258,133261,0,3,3
38033,4,2,133262,133262,133264,0,2,1
38034,3,2,133265,133265,133267,0,2,1
38035,6,1,133271,133271,133272,0,1,4
38036,6,2,133277,133277,133279,0,2,5
38037,5,2,133282,133282,133284,0,2,3
38038,5,3,133287,133287,133290,0,3,3
38039,5,2,133292,133292,133294,0,2,2
38040,6,3,133298,133298,133301,0,3,4
38041,4,2,133302,133302,133304,0,2,1
38042,1,1,133303,133304,133305,1,2,0
38043,4,3,133307,133307,133310,0,3,2
38044,4,3,133311,133311,133314,0,3,1
38045,3,1,133314,133314,133315,0,1,0
38046,1,2,133315,133315,133317,0,2,0
38047,5,1,133320,133320,133321,0,1,3
38048,2,1,133322,133322,133323,0,1,1
38049,4,2,133326,133326,133328,0,2,3
38050,5,2,133331,133331,133333,0,2,3
38051,4,3,133335,133335,133338,0,3,2
38052,2,2,133337,133338,133340,1,3,0
38053,5,2,133342,133342,133344,0,2,2
38054,1,3,133343,133344,133347,1,4,0
38055,6,1,133349,133349,133350,0,1,2
38056,4,2,133353,133353,133355,0,2,3
38057,5,2,133358,133358,133360,0,2,3
38058,5,2,133363,133363,133365,0,2,3
38059,2,2,133365,133365,133367,0,2,0
38060,5,3,133370,133370,133373,0,3,3
38061,2,3,133372,133373,133376,1,4,0
38062,4,3,133376,133376,133379,0,3,0
38063,2,2,133378,133379,133381,1,3,0
38064,2,1,133380,133381,133382,1,2,0
38065,4,3,133384,133384,133387,0,3,2
38066,4,1,133388,133388,133389,0,1,1
38067,5,2,133393,133393,133395,0,2,4
38068,5,1,133398,133398,133399,0,1,3
38069,5,2,133403,133403,133405,0,2,4
38070,4,3,133407,133407,133410,0,3,2
38071,6,2,133413,133413,133415,0,2,3
38072,1,3,133414,133415,133418,1,4,0
38073,6,1,133420,133420,133421,0,1,2
38074,2,1,133422,133422,133423,0,1,1
38075,3,3,133425,133425,133428,0,3,2
38076,5,2,133430,133430,133432,0,2,2
38077,6,3,133436,133436,133439,0,3,4
38078,6,3,133442,133442,133445,0,3,3
38079,1,2,133443,133445,133447,2,4,0
38080,5,3,133448,133448,133451,0,3,1
38081,5,1,133453,133453,133454,0,1,2
38082,1,2,133454,133454,133456,0,2,0
38083,5,3,133459,133459,133462,0,3,3
38084,6,3,133465,133465,133468,0,3,3
38085,4,1,133469,133469,133470,0,1,1
38086,1,1,133470,133470,133471,0,1,0
38087,2,3,133472,133472,133475,0,3,1
38088,4,1,133476,133476,133477,0,1,1
38089,6,2,133482,133482,133484,0,2,5
38090,2,1,133484,133484,133485,0,1,0
38091,2,3,133486,133486,133489,0,3,1
38092,3,2,133489,133489,133491,0,2,0
38093,5,2,133494,133494,133496,0,2,3
38094,3,2,133497,133497,133499,0,2,1
38095,4,3,133501,133501,133504,0,3,2
38096,3,3,133504,133504,133507,0,3,0
38097,1,1,133505,133507,133508,2,3,0
38098,3,3,133508,133508,133511,0,3,0
38099,3,3,133511,133511,133514,0,3,0
38100,6,1,133517,133517,133518,0,1,3
38101,5,3,133522,133522,133525,0,3,4
38102,1,3,133523,133525,133528,2,5,0
38103,5,3,133528,133528,133531,0,3,0
38104,3,1,133531,133531,133532,0,1,0
38105,3,2,133534,133534,133536,0,2,2
38106,3,2,133537,133537,133539,0,2,1
38107,2,3,133539,133539,133542,0,3,0
38108,4,1,133543,133543,133544,0,1,1
38109,2,3,133545,133545,133548,0,3,1
38110,4,2,133549,133549,133551,0,2,1
38111,3,2,133552,133552,133554,0,2,1
38112,5,2,133557,133557,133559,0,2,3
38113,1,1,133558,133559,133560,1,2,0
38114,4,3,133562,133562,133565,0,3,2
38115,1,2,133563,133565,133567,2,4,0
38116,1,1,133564,133567,133568,3,4,0
38117,2,1,133566,133568,133569,2,3,0
38118,5,2,133571,133571,133573,0,2,2
38119,3,2,133574,133574,133576,0,2,1
38120,1,3,133575,133576,133579,1,4,0
38121,1,1,133576,133579,133580,3,4,0
38122,3,3,133579,133580,133583,1,4,0
38123,5,3,133584,133584,133587,0,3,1
38124,6,2,133590,133590,133592,0,2,3
38125,5,1,133595,133595,133596,0,1,3
38126,5,1,133600,133600,133601,0,1,4
38127,1,1,133601,133601,133602,0,1,0
38128,3,1,133604,133604,133605,0,1,2
38129,4,1,133608,133608,133609,0,1,3
38130,2,3,133610,133610,133613,0,3,1
38131,6,1,133616,133616,133617,0,1,3
38132,4,2,133620,133620,133622,0,2,3
38133,5,3,133625,133625,133628,0,3,3
38134,1,2,133626,133628,133630,2,4,0
38135,5,2,133631,133631,133633,0,2,1
38136,4,1,133635,133635,133636,0,1,2
38137,4,3,133639,133639,133642,0,3,3
38138,6,3,133645,133645,133648,0,3,3
38139,1,3,133646,133648,133651,2,5,0
38140,5,3,133651,133651,133654,0,3,0
38141,2,3,133653,133654,133657,1,4,0
38142,6,2,133659,133659,133661,0,2,2
38143,6,3,133665,133665,133668,0,3,4
38144,5,2,133670,133670,133672,0,2,2
38145,4,1,133674,133674,133675,0,1,2
38146,3,2,133677,133677,133679,0,2,2
38147,2,2,133679,133679,133681,0,2,0
38148,3,1,133682,133682,133683,0,1,1
38149,5,3,133687,133687,133690,0,3,4
38150,2,1,133689,133690,133691,1,2,0
38151,3,1,133692,133692,133693,0,1,1
38152,1,3,133693,133693,133696,0,3,0
38153,3,1,133696,133696,133697,0,1,0
38154,6,3,133702,133702,133705,0,3,5
38155,1,3,133703,133705,133708,2,5,0
38156,3,1,133706,133708,133709,2,3,0
38157,6,3,133712,133712,133715,0,3,3
38158,6,3,133718,133718,133721,0,3,3
38159,1,1,133719,133721,133722,2,3,0
38160,6,1,133725,133725,133726,0,1,3
38161,1,1,133726,133726,133727,0,1,0
38162,5,3,133731,133731,133734,0,3,4
38163,1,2,133732,133734,133736,2,4,0
38164,3,3,133735,133736,133739,1,4,0
38165,2,3,133737,133739,133742,2,5,0
38166,2,2,133739,133742,133744,3,5,0
38167,1,3,133740,133744,133747,4,7,0
38168,1,2,133741,133747,133749,6,8,0
38169,2,2,133743,133749,133751,6,8,0
38170,1,2,133744,133751,133753,7,9,0
38171,3,1,133747,133753,133754,6,7,0
38172,3,3,133750,133754,133757,4,7,0
38173,5,2,133755,133757,133759,2,4,0
38174,2,2,133757,133759,133761,2,4,0
38175,6,1,133763,133763,133764,0,1,2
38176,6,2,133769,133769,133771,0,2,5
38177,6,2,133775,133775,133777,0,2,4
38178,3,1,133778,133778,133779,0,1,1
38179,3,1,133781,133781,133782,0,1,2
38180,4,2,133785,133785,133787,0,2,3
38181,2,2,133787,133787,133789,0,2,0
38182,4,1,133791,133791,133792,0,1,2
38183,4,3,133795,133795,133798,0,3,3
38184,4,2,133799,133799,133801,0,2,1
38185,3,3,133802,133802,133805,0,3,1
38186,4,3,133806,133806,133809,0,3,1
38187,3,3,133809,133809,133812,0,3,0
38188,6,3,133815,133815,133818,0,3,3
38189,6,1,133821,133821,133822,0,1,3
38190,4,3,133825,133825,133828,0,3,3
38191,6,1,133831,133831,133832,0,1,3
38192,4,2,133835,133835,133837,0,2,3
38193,3,3,133838,133838,133841,0,3,1
38194,6,3,133844,133844,133847,0,3,3
38195,2,2,133846,133847,133849,1,3,0
38196,3,2,133849,133849,133851,0,2,0
38197,1,2,133850,133851,133853,1,3,0
38198,1,2,133851,133853,133855,2,4,0
38199,4,1,133855,133855,133856,0,1,0
38200,4,2,133859,133859,133861,0,2,3
38201,3,1,133862,133862,133863,0,1,1
38202,1,3,133863,133863,133866,0,3,0
38203,3,3,133866,133866,133869,0,3,0
38204,6,3,133872,133872,133875,0,3,3
38205,4,3,133876,133876,133879,0,3,1
38206,5,2,133881,133881,133883,0,2,2
38207,2,1,133883,133883,133884,0,1,0
38208,4,1,133887,133887,133888,0,1,3
38209,6,2,133893,133893,133895,0,2,5
38210,2,1,133895,133895,133896,0,1,0
38211,2,3,133897,133897,133900,0,3,1
38212,3,2,133900,133900,133902,0,2,0
38213,2,2,133902,133902,133904,0,2,0
38214,5,3,133907,133907,133910,0,3,3
38215,3,2,133910,133910,133912,0,2,0
38216,2,3,133912,133912,133915,0,3,0
38217,5,1,133917,133917,133918,0,1,2
38218,5,1,133922,133922,133923,0,1,4
38219,3,3,133925,133925,133928,0,3,2
38220,2,3,133927,133928,133931,1,4,0
38221,2,3,133929,133931,133934,2,5,0
38222,3,1,133932,133934,133935,2,3,0
38223,2,1,133934,133935,133936,1,2,0
38224,4,2,133938,133938,133940,0,2,2
38225,1,1,133939,133940,133941,1,2,0
38226,5,2,133944,133944,133946,0,2,3
38227,6,3,133950,133950,133953,0,3,4
38228,4,3,133954,133954,133957,0,3,1
38229,2,3,133956,133957,133960,1,4,0
38230,3,1,133959,133960,133961,1,2,0
38231,1,1,133960,133961,133962,1,2,0
38232,5,3,133965,133965,133968,0,3,3
38233,4,2,133969,133969,133971,0,2,1
38234,3,3,133972,133972,133975,0,3,1
38235,3,3,133975,133975,133978,0,3,0
38236,4,1,133979,133979,133980,0,1,1
38237,2,2,133981,133981,133983,0,2,1
38238,3,1,133984,133984,133985,0,1,1
38239,4,2,133988,133988,133990,0,2,3
38240,2,1,133990,133990,133991,0,1,0
38241,1,1,133991,133991,133992,0,1,0
38242,5,2,133996,133996,133998,0,2,4
38243,2,2,133998,133998,134000,0,2,0
38244,1,2,133999,134000,134002,1,3,0
38245,1,3,134000,134002,134005,2,5,0
38246,6,2,134006,134006,134008,0,2,1
38247,2,2,134008,134008,134010,0,2,0
38248,4,2,134012,134012,134014,0,2,2
38249,4,1,134016,134016,134017,0,1,2
38250,1,3,134017,134017,134020,0,3,0
38251,3,3,134020,134020,134023,0,3,0
38252,2,3,134022,134023,134026,1,4,0
38253,2,2,134024,134026,134028,2,4,0
38254,2,3,134026,134028,134031,2,5,0
38255,4,3,134030,134031,134034,1,4,0
38256,5,1,134035,134035,134036,0,1,1
38257,2,3,134037,134037,134040,0,3,1
38258,3,1,134040,134040,134041,0,1,0
38259,1,1,134041,134041,134042,0,1,0
38260,3,1,134044,134044,134045,0,1,2
38261,5,2,134049,134049,134051,0,2,4
38262,4,1,134053,134053,134054,0,1,2
38263,3,2,134056,134056,134058,0,2,2
38264,4,2,134060,134060,134062,0,2,2
38265,2,1,134062,134062,134063,0,1,0
38266,1,2,134063,134063,134065,0,2,0
38267,2,1,134065,134065,134066,0,1,0
38268,6,1,134071,134071,134072,0,1,5
38269,2,3,134073,134073,134076,0,3,1
38270,1,1,134074,134076,134077,2,3,0
38271,2,2,134076,134077,134079,1,3,0
38272,4,1,134080,134080,134081,0,1,1
38273,2,1,134082,134082,134083,0,1,1
38274,2,1,134084,134084,134085,0,1,1
38275,2,2,134086,134086,134088,0,2,1
38276,2,2,134088,134088,134090,0,2,0
38277,2,1,134090,134090,134091,0,1,0
38278,2,2,134092,134092,134094,0,2,1
38279,6,1,134098,134098,134099,0,1,4
38280,4,3,134102,134102,134105,0,3,3
38281,3,2,134105,134105,134107,0,2,0
38282,5,1,134110,134110,134111,0,1,3
38283,3,3,134113,134113,134116,0,3,2
38284,2,3,134115,134116,134119,1,4,0
38285,1,2,134116,134119,134121,3,5,0
38286,3,2,134119,134121,134123,2,4,0
38287,5,3,134124,134124,134127,0,3,1
38288,2,2,134126,134127,134129,1,3,0
38289,5,2,134131,134131,134133,0,2,2
38290,4,3,134135,134135,134138,0,3,2
38291,5,1,134140,134140,134141,0,1,2
38292,2,2,134142,134142,134144,0,2,1
38293,3,3,134145,134145,134148,0,3,1
38294,3,1,134148,134148,134149,0,1,0
38295,6,3,134154,134154,134157,0,3,5
38296,1,1,134155,134157,134158,2,3,0
38297,3,2,134158,134158,134160,0,2,0
38298,1,1,134159,134160,134161,1,2,0
38299,2,3,134161,134161,134164,0,3,0
38300,2,2,134163,134164,134166,1,3,0
38301,5,3,134168,134168,134171,0,3,2
38302,3,1,134171,134171,134172,0,1,0
38303,5,1,134176,134176,134177,0,1,4
38304,3,2,134179,134179,134181,0,2,2
38305,1,1,134180,134181,134182,1,2,0
38306,3,1,134183,134183,134184,0,1,1
38307,3,3,134186,134186,134189,0,3,2
38308,5,2,134191,134191,134193,0,2,2
38309,3,1,134194,134194,134195,0,1,1
38310,1,1,134195,134195,134196,0,1,0
38311,1,3,134196,134196,134199,0,3,0
38312,4,2,134200,134200,134202,0,2,1
38313,5,2,134205,134205,134207,0,2,3
38314,2,3,134207,134207,134210,0,3,0
38315,2,1,134209,134210,134211,1,2,0
38316,5,2,134214,134214,134216,0,2,3
38317,4,3,134218,134218,134221,0,3,2
38318,3,2,134221,134221,134223,0,2,0
38319,4,1,134225,134225,134226,0,1,2
38320,2,1,134227,134227,134228,0,1,1
38321,6,1,134233,134233,134234,0,1,5
38322,3,3,134236,134236,134239,0,3,2
38323,5,1,134241,134241,134242,0,1,2
38324,5,1,134246,134246,134247,0,1,4
38325,2,3,134248,134248,134251,0,3,1
38326,6,1,134254,134254,134255,0,1,3
38327,6,2,134260,134260,134262,0,2,5
38328,2,2,134262,134262,134264,0,2,0
38329,6,3,134268,134268,134271,0,3,4
38330,5,2,134273,134273,134275,0,2,2
38331,1,1,134274,134275,134276,1,2,0
38332,3,1,134277,134277,134278,0,1,1
38333,1,3,134278,134278,134281,0,3,0
38334,4,3,134282,134282,134285,0,3,1
38335,4,3,134286,134286,134289,0,3,1
38336,3,2,134289,134289,134291,0,2,0
38337,6,2,134295,134295,134297,0,2,4
38338,2,1,134297,134297,134298,0,1,0
38339,1,2,134298,134298,134300,0,2,0
38340,1,3,134299,134300,134303,1,4,0
38341,1,2,134300,134303,134305,3,5,0
38342,1,1,134301,134305,134306,4,5,0
38343,5,2,134306,134306,134308,0,2,0
38344,5,1,134311,134311,134312,0,1,3
38345,6,2,134317,134317,134319,0,2,5
38346,4,1,134321,134321,134322,0,1,2
38347,4,3,134325,134325,134328,0,3,3
38348,6,2,134331,134331,134333,0,2,3
38349,1,3,134332,134333,134336,1,4,0
38350,5,2,134337,134337,134339,0,2,1
38351,2,1,134339,134339,134340,0,1,0
38352,2,2,134341,134341,134343,0,2,1
38353,3,3,134344,134344,134347,0,3,1
38354,2,1,134346,134347,134348,1,2,0
38355,5,2,134351,134351,134353,0,2,3
38356,1,3,134352,134353,134356,1,4,0
38357,4,2,134356,134356,134358,0,2,0
38358,6,2,134362,134362,134364,0,2,4
38359,1,3,134363,134364,134367,1,4,0
38360,6,2,134369,134369,134371,0,2,2
38361,4,3,134373,134373,134376,0,3,2
38362,2,2,134375,134376,134378,1,3,0
38363,1,1,134376,134378,134379,2,3,0
38364,1,3,134377,134379,134382,2,5,0
38365,3,1,134380,134382,134383,2,3,0
38366,3,1,134383,134383,134384,0,1,0
38367,6,2,134389,134389,134391,0,2,5
38368,1,1,134390,134391,134392,1,2,0
38369,3,1,134393,134393,134394,0,1,1
38370,4,3,134397,134397,134400,0,3,3
38371,1,2,134398,134400,134402,2,4,0
38372,4,3,134402,134402,134405,0,3,0
38373,4,2,134406,134406,134408,0,2,1
38374,3,3,134409,134409,134412,0,3,1
38375,1,3,134410,134412,134415,2,5,0
38376,6,2,134416,134416,134418,0,2,1
38377,1,2,134417,134418,134420,1,3,0
38378,5,1,134422,134422,134423,0,1,2
38379,5,2,134427,134427,134429,0,2,4
38380,5,3,134432,134432,134435,0,3,3
38381,3,1,134435,134435,134436,0,1,0
38382,1,3,134436,134436,134439,0,3,0
38383,1,2,134437,134439,134441,2,4,0
38384,3,1,134440,134441,134442,1,2,0
38385,5,2,134445,134445,134447,0,2,3
38386,3,2,134448,134448,134450,0,2,1
38387,1,2,134449,134450,134452,1,3,0
38388,5,2,134454,134454,134456,0,2,2
38389,1,2,134455,134456,134458,1,3,0
38390,3,1,134458,134458,134459,0,1,0
38391,4,1,134462,134462,134463,0,1,3
38392,3,3,134465,134465,134468,0,3,2
38393,6,2,134471,134471,134473,0,2,3
38394,5,2,134476,134476,134478,0,2,3
38395,4,2,134480,134480,134482,0,2,2
38396,6,1,134486,134486,134487,0,1,4
38397,6,2,134492,134492,134494,0,2,5
38398,4,1,134496,134496,134497,0,1,2
38399,3,1,134499,134499,134500,0,1,2
38400,5,2,134504,134504,134506,0,2,4
38401,6,1,134510,134510,134511,0,1,4
38402,2,1,134512,134512,134513,0,1,1
38403,6,1,134518,134518,134519,0,1,5
38404,6,2,134524,134524,134526,0,2,5
38405,1,1,134525,134526,134527,1,2,0
38406,4,1,134529,134529,134530,0,1,2
38407,4,1,134533,134533,134534,0,1,3
38408,2,3,134535,134535,134538,0,3,1
38409,3,1,134538,134538,134539,0,1,0
38410,2,1,134540,134540,134541,0,1,1
38411,1,1,134541,134541,134542,0,1,0
38412,4,2,134545,134545,134547,0,2,3
38413,5,1,134550,134550,134551,0,1,3
38414,5,2,134555,134555,134557,0,2,4
38415,2,2,134557,134557,134559,0,2,0
38416,3,3,134560,134560,134563,0,3,1
38417,3,1,134563,134563,134564,0,1,0
38418,2,1,134565,134565,134566,0,1,1
38419,3,3,134568,134568,134571,0,3,2
38420,6,3,134574,134574,134577,0,3,3
38421,3,3,134577,134577,134580,0,3,0
38422,4,3,134581,134581,134584,0,3,1
38423,2,1,134583,134584,134585,1,2,0
38424,3,3,134586,134586,134589,0,3,1
38425,6,1,134592,134592,134593,0,1,3
38426,2,3,134594,134594,134597,0,3,1
38427,5,1,134599,134599,134600,0,1,2
38428,4,3,134603,134603,134606,0,3,3
38429,3,2,134606,134606,134608,0,2,0
38430,1,2,134607,134608,134610,1,3,0
38431,5,3,134612,134612,134615,0,3,2
38432,1,3,134613,134615,134618,2,5,0
38433,5,2,134618,134618,134620,0,2,0
38434,3,1,134621,134621,134622,0,1,1
38435,6,1,134627,134627,134628,0,1,5
38436,4,3,134631,134631,134634,0,3,3
38437,4,3,134635,134635,134638,0,3,1
38438,5,2,134640,134640,134642,0,2,2
38439,2,1,134642,134642,134643,0,1,0
38440,1,2,134643,134643,134645,0,2,0
38441,3,2,134646,134646,134648,0,2,1
38442,2,2,134648,134648,134650,0,2,0
38443,5,2,134653,134653,134655,0,2,3
38444,6,3,134659,134659,134662,0,3,4
38445,5,1,134664,134664,134665,0,1,2
38446,2,2,134666,134666,134668,0,2,1
38447,1,1,134667,134668,134669,1,2,0
38448,2,1,134669,134669,134670,0,1,0
38449,1,3,134670,134670,134673,0,3,0
38450,6,2,134676,134676,134678,0,2,3
38451,4,1,134680,134680,134681,0,1,2
38452,4,2,134684,134684,134686,0,2,3
38453,4,3,134688,134688,134691,0,3,2
38454,6,3,134694,134694,134697,0,3,3
38455,4,2,134698,134698,134700,0,2,1
38456,4,1,134702,134702,134703,0,1,2
38457,6,2,134708,134708,134710,0,2,5
38458,4,1,134712,134712,134713,0,1,2
38459,1,1,134713,134713,134714,0,1,0
38460,4,3,134717,134717,134720,0,3,3
38461,1,3,134718,134720,134723,2,5,0
38462,6,3,134724,134724,134727,0,3,1
38463,5,2,134729,134729,134731,0,2,2
38464,6,2,134735,134735,134737,0,2,4
38465,2,1,134737,134737,134738,0,1,0
38466,1,3,134738,134738,134741,0,3,0
38467,5,3,134743,134743,134746,0,3,2
38468,2,2,134745,134746,134748,1,3,0
38469,4,3,134749,134749,134752,0,3,1
38470,2,2,134751,134752,134754,1,3,0
38471,6,1,134757,134757,134758,0,1,3
38472,1,3,134758,134758,134761,0,3,0
38473,2,3,134760,134761,134764,1,4,0
38474,4,1,134764,134764,134765,0,1,0
38475,1,1,134765,134765,134766,0,1,0
38476,4,1,134769,134769,134770,0,1,3
38477,1,2,134770,134770,134772,0,2,0
38478,1,1,134771,134772,134773,1,2,0
38479,2,3,134773,134773,134776,0,3,0
38480,2,3,134775,134776,134779,1,4,0
38481,3,2,134778,134779,134781,1,3,0
38482,4,3,134782,134782,134785,0,3,1
38483,1,2,134783,134785,134787,2,4,0
38484,3,2,134786,134787,134789,1,3,0
38485,1,3,134787,134789,134792,2,5,0
38486,2,3,134789,134792,134795,3,6,0
38487,4,1,134793,134795,134796,2,3,0
38488,5,3,134798,134798,134801,0,3,2
38489,1,3,134799,134801,134804,2,5,0
38490,3,2,134802,134804,134806,2,4,0
38491,2,1,134804,134806,134807,2,3,0
38492,2,1,134806,134807,134808,1,2,0
38493,1,2,134807,134808,134810,1,3,0
38494,1,2,134808,134810,134812,2,4,0
38495,2,2,134810,134812,134814,2,4,0
38496,4,1,134814,134814,134815,0,1,0
38497,3,3,134817,134817,134820,0,3,2
38498,5,1,134822,134822,134823,0,1,2
38499,4,3,134826,134826,134829,0,3,3
38500,1,3,134827,134829,134832,2,5,0
38501,4,2,134831,134832,134834,1,3,0
38502,1,3,134832,134834,134837,2,5,0
38503,5,3,134837,134837,134840,0,3,0
38504,4,2,134841,134841,134843,0,2,1
38505,4,2,134845,134845,134847,0,2,2
38506,3,2,134848,134848,134850,0,2,1
38507,3,2,134851,134851,134853,0,2,1
38508,6,3,134857,134857,134860,0,3,4
38509,5,1,134862,134862,134863,0,1,2
38510,1,1,134863,134863,134864,0,1,0
38511,5,1,134868,134868,134869,0,1,4
38512,5,2,134873,134873,134875,0,2,4
38513,6,2,134879,134879,134881,0,2,4
38514,4,2,134883,134883,134885,0,2,2
38515,3,3,134886,134886,134889,0,3,1
38516,3,1,134889,134889,134890,0,1,0
38517,6,1,134895,134895,134896,0,1,5
38518,1,2,134896,134896,134898,0,2,0
38519,2,3,134898,134898,134901,0,3,0
38520,3,2,134901,134901,134903,0,2,0
38521,3,3,134904,134904,134907,0,3,1
38522,2,1,134906,134907,134908,1,2,0
38523,3,2,134909,134909,134911,0,2,1
38524,2,2,134911,134911,134913,0,2,0
38525,4,1,134915,134915,134916,0,1,2
38526,3,3,134918,134918,134921,0,3,2
38527,1,2,134919,134921,134923,2,4,0
38528,1,1,134920,134923,134924,3,4,0
38529,2,2,134922,134924,134926,2,4,0
38530,6,2,134928,134928,134930,0,2,2
38531,5,1,134933,134933,134934,0,1,3
38532,1,2,134934,134934,134936,0,2,0
38533,2,1,134936,134936,134937,0,1,0
38534,4,3,134940,134940,134943,0,3,3
38535,1,1,134941,134943,134944,2,3,0
38536,6,2,134947,134947,134949,0,2,3
38537,1,3,134948,134949,134952,1,4,0
38538,2,2,134950,134952,134954,2,4,0
38539,6,2,134956,134956,134958,0,2,2
38540,2,1,134958,134958,134959,0,1,0
38541,4,2,134962,134962,134964,0,2,3
38542,6,3,134968,134968,134971,0,3,4
38543,5,3,134973,134973,134976,0,3,2
38544,3,3,134976,134976,134979,0,3,0
38545,5,1,134981,134981,134982,0,1,2
38546,3,3,134984,134984,134987,0,3,2
38547,3,1,134987,134987,134988,0,1,0
38548,3,2,134990,134990,134992,0,2,2
38549,5,2,134995,134995,134997,0,2,3
38550,6,3,135001,135001,135004,0,3,4
38551,2,3,135003,135004,135007,1,4,0
38552,4,3,135007,135007,135010,0,3,0
38553,6,3,135013,135013,135016,0,3,3
38554,3,1,135016,135016,135017,0,1,0
38555,3,2,135019,135019,135021,0,2,2
38556,2,2,135021,135021,135023,0,2,0
38557,3,2,135024,135024,135026,0,2,1
38558,5,2,135029,135029,135031,0,2,3
38559,1,1,135030,135031,135032,1,2,0
38560,1,1,135031,135032,135033,1,2,0
38561,3,2,135034,135034,135036,0,2,1
38562,6,3,135040,135040,135043,0,3,4
38563,2,1,135042,135043,135044,1,2,0
38564,2,1,135044,135044,135045,0,1,0
38565,1,3,135045,135045,135048,0,3,0
38566,4,1,135049,135049,135050,0,1,1
38567,6,3,135055,135055,135058,0,3,5
38568,3,2,135058,135058,135060,0,2,0
38569,1,3,135059,135060,135063,1,4,0
38570,6,3,135065,135065,135068,0,3,2
38571,1,1,135066,135068,135069,2,3,0
38572,6,1,135072,135072,135073,0,1,3
38573,5,3,135077,135077,135080,0,3,4
38574,2,3,135079,135080,135083,1,4,0
38575,3,1,135082,135083,135084,1,2,0
38576,3,2,135085,135085,135087,0,2,1
38577,5,3,135090,135090,135093,0,3,3
38578,2,3,135092,135093,135096,1,4,0
38579,3,3,135095,135096,135099,1,4,0
38580,4,3,135099,135099,135102,0,3,0
38581,5,2,135104,135104,135106,0,2,2
38582,4,2,135108,135108,135110,0,2,2
38583,1,1,135109,135110,135111,1,2,0
38584,4,2,135113,135113,135115,0,2,2
38585,3,3,135116,135116,135119,0,3,1
38586,3,3,135119,135119,135122,0,3,0
38587,2,1,135121,135122,135123,1,2,0
38588,4,2,135125,135125,135127,0,2,2
38589,4,3,135129,135129,135132,0,3,2
38590,2,1,135131,135132,135133,1,2,0
38591,3,1,135134,135134,135135,0,1,1
38592,6,2,135140,135140,135142,0,2,5
38593,5,2,135145,135145,135147,0,2,3
38594,4,3,135149,135149,135152,0,3,2
38595,6,1,135155,135155,135156,0,1,3
38596,6,1,135161,135161,135162,0,1,5
38597,3,1,135164,135164,135165,0,1,2
38598,2,3,135166,135166,135169,0,3,1
38599,1,3,135167,135169,135172,2,5,0
38600,4,2,135171,135172,135174,1,3,0
38601,2,1,135173,135174,135175,1,2,0
38602,2,3,135175,135175,135178,0,3,0
38603,1,1,135176,135178,135179,2,3,0
38604,3,2,135179,135179,135181,0,2,0
38605,1,1,135180,135181,135182,1,2,0
38606,5,2,135185,135185,135187,0,2,3
38607,2,3,135187,135187,135190,0,3,0
38608,4,2,135191,135191,135193,0,2,1
38609,6,3,135197,135197,135200,0,3,4
38610,1,1,135198,135200,135201,2,3,0
38611,4,1,135202,135202,135203,0,1,1
38612,1,1,135203,135203,135204,0,1,0
38613,2,2,135205,135205,135207,0,2,1
38614,5,1,135210,135210,135211,0,1,3
38615,1,1,135211,135211,135212,0,1,0
38616,6,3,135217,135217,135220,0,3,5
38617,3,1,135220,135220,135221,0,1,0
38618,3,2,135223,135223,135225,0,2,2
38619,4,2,135227,135227,135229,0,2,2
38620,2,2,135229,135229,135231,0,2,0
38621,3,3,135232,135232,135235,0,3,1
38622,6,2,135238,135238,135240,0,2,3
38623,1,2,135239,135240,135242,1,3,0
38624,2,2,135241,135242,135244,1,3,0
38625,6,1,135247,135247,135248,0,1,3
38626,6,1,135253,135253,135254,0,1,5
38627,1,3,135254,135254,135257,0,3,0
38628,3,2,135257,135257,135259,0,2,0
38629,4,3,135261,135261,135264,0,3,2
38630,4,2,135265,135265,135267,0,2,1
38631,2,1,135267,135267,135268,0,1,0
38632,6,3,135273,135273,135276,0,3,5
38633,5,1,135278,135278,135279,0,1,2
38634,5,3,135283,135283,135286,0,3,4
38635,3,1,135286,135286,135287,0,1,0
38636,4,1,135290,135290,135291,0,1,3
38637,2,2,135292,135292,135294,0,2,1
38638,4,2,135296,135296,135298,0,2,2
38639,6,3,135302,135302,135305,0,3,4
38640,1,3,135303,135305,135308,2,5,0
38641,1,3,135304,135308,135311,4,7,0
38642,3,2,135307,135311,135313,4,6,0
38643,2,3,135309,135313,135316,4,7,0
38644,5,2,135314,135316,135318,2,4,0
38645,2,1,135316,135318,135319,2,3,0
38646,3,1,135319,135319,135320,0,1,0
38647,6,2,135325,135325,135327,0,2,5
38648,4,3,135329,135329,135332,0,3,2
38649,2,2,135331,135332,135334,1,3,0
38650,6,2,135337,135337,135339,0,2,3
38651,6,1,135343,135343,135344,0,1,4
38652,5,1,135348,135348,135349,0,1,4
38653,4,3,135352,135352,135355,0,3,3
38654,6,1,135358,135358,135359,0,1,3
38655,1,2,135359,135359,135361,0,2,0
38656,6,3,135365,135365,135368,0,3,4
38657,6,3,135371,135371,135374,0,3,3
38658,5,1,135376,135376,135377,0,1,2
38659,4,1,135380,135380,135381,0,1,3
38660,3,1,135383,135383,135384,0,1,2
38661,4,2,135387,135387,135389,0,2,3
38662,2,3,135389,135389,135392,0,3,0
38663,1,2,135390,135392,135394,2,4,0
38664,1,3,135391,135394,135397,3,6,0
38665,2,2,135393,135397,135399,4,6,0
38666,2,1,135395,135399,135400,4,5,0
38667,2,1,135397,135400,135401,3,4,0
38668,4,3,135401,135401,135404,0,3,0
38669,6,1,135407,135407,135408,0,1,3
38670,3,3,135410,135410,135413,0,3,2
38671,5,1,135415,135415,135416,0,1,2
38672,6,3,135421,135421,135424,0,3,5
38673,4,1,135425,135425,135426,0,1,1
38674,6,2,135431,135431,135433,0,2,5
38675,1,3,135432,135433,135436,1,4,0
38676,1,3,135433,135436,135439,3,6,0
38677,4,2,135437,135439,135441,2,4,0
38678,2,3,135439,135441,135444,2,5,0
38679,2,1,135441,135444,135445,3,4,0
38680,2,2,135443,135445,135447,2,4,0
38681,5,2,135448,135448,135450,0,2,1
38682,5,3,135453,135453,135456,0,3,3
38683,1,3,135454,135456,135459,2,5,0
38684,3,2,135457,135459,135461,2,4,0
38685,4,1,135461,135461,135462,0,1,0
38686,2,1,135463,135463,135464,0,1,1
38687,3,1,135466,135466,135467,0,1,2
38688,4,1,135470,135470,135471,0,1,3
38689,5,1,135475,135475,135476,0,1,4
38690,5,3,135480,135480,135483,0,3,4
38691,5,3,135485,135485,135488,0,3,2
38692,4,2,135489,135489,135491,0,2,1
38693,3,2,135492,135492,135494,0,2,1
38694,6,1,135498,135498,135499,0,1,4
38695,2,1,135500,135500,135501,0,1,1
38696,6,2,135506,135506,135508,0,2,5
38697,5,2,135511,135511,135513,0,2,3
38698,6,1,135517,135517,135518,0,1,4
38699,1,1,135518,135518,135519,0,1,0
38700,3,3,135521,135521,135524,0,3,2
38701,3,1,135524,135524,135525,0,1,0
38702,3,2,135527,135527,135529,0,2,2
38703,6,2,135533,135533,135535,0,2,4
38704,1,2,135534,135535,135537,1,3,0
38705,3,3,135537,135537,135540,0,3,0
38706,2,3,135539,135540,135543,1,4,0
38707,6,1,135545,135545,135546,0,1,2
38708,1,3,135546,135546,135549,0,3,0
38709,2,2,135548,135549,135551,1,3,0
38710,5,2,135553,135553,135555,0,2,2
38711,6,3,135559,135559,135562,0,3,4
38712,6,2,135565,135565,135567,0,2,3
38713,2,3,135567,135567,135570,0,3,0
38714,1,2,135568,135570,135572,2,4,0
38715,3,3,135571,135572,135575,1,4,0
38716,2,1,135573,135575,135576,2,3,0
38717,4,1,135577,135577,135578,0,1,1
38718,5,2,135582,135582,135584,0,2,4
38719,1,2,135583,135584,135586,1,3,0
38720,2,1,135585,135586,135587,1,2,0
38721,5,3,135590,135590,135593,0,3,3
38722,2,1,135592,135593,135594,1,2,0
38723,5,2,135597,135597,135599,0,2,3
38724,6,3,135603,135603,135606,0,3,4
38725,3,1,135606,135606,135607,0,1,0
38726,6,1,135612,135612,135613,0,1,5
38727,2,1,135614,135614,135615,0,1,1
38728,2,2,135616,135616,135618,0,2,1
38729,2,1,135618,135618,135619,0,1,0
38730,4,3,135622,135622,135625,0,3,3
38731,5,1,135627,135627,135628,0,1,2
38732,6,2,135633,135633,135635,0,2,5
38733,4,1,135637,135637,135638,0,1,2
38734,6,2,135643,135643,135645,0,2,5
38735,4,1,135647,135647,135648,0,1,2
38736,1,2,135648,135648,135650,0,2,0
38737,2,3,135650,135650,135653,0,3,0
38738,1,2,135651,135653,135655,2,4,0
38739,5,3,135656,135656,135659,0,3,1
38740,6,1,135662,135662,135663,0,1,3
38741,6,3,135668,135668,135671,0,3,5
38742,1,2,135669,135671,135673,2,4,0
38743,6,3,135675,135675,135678,0,3,2
38744,4,3,135679,135679,135682,0,3,1
38745,5,1,135684,135684,135685,0,1,2
38746,6,1,135690,135690,135691,0,1,5
38747,4,3,135694,135694,135697,0,3,3
38748,4,3,135698,135698,135701,0,3,1
38749,6,1,135704,135704,135705,0,1,3
38750,4,2,135708,135708,135710,0,2,3
38751,1,1,135709,135710,135711,1,2,0
38752,3,1,135712,135712,135713,0,1,1
38753,6,3,135718,135718,135721,0,3,5
38754,5,3,135723,135723,135726,0,3,2
38755,3,3,135726,135726,135729,0,3,0
38756,6,1,135732,135732,135733,0,1,3
38757,4,1,135736,135736,135737,0,1,3
38758,5,1,135741,135741,135742,0,1,4
38759,6,1,135747,135747,135748,0,1,5
38760,3,1,135750,135750,135751,0,1,2
38761,4,3,135754,135754,135757,0,3,3
38762,6,1,135760,135760,135761,0,1,3
38763,5,1,135765,135765,135766,0,1,4
38764,3,2,135768,135768,135770,0,2,2
38765,2,3,135770,135770,135773,0,3,0
38766,1,1,135771,135773,135774,2,3,0
38767,3,2,135774,135774,135776,0,2,0
38768,6,2,135780,135780,135782,0,2,4
38769,2,3,135782,135782,135785,0,3,0
38770,1,1,135783,135785,135786,2,3,0
38771,5,2,135788,135788,135790,0,2,2
38772,5,3,135793,135793,135796,0,3,3
38773,5,1,135798,135798,135799,0,1,2
38774,3,1,135801,135801,135802,0,1,2
38775,2,2,135803,135803,135805,0,2,1
38776,6,3,135809,135809,135812,0,3,4
38777,3,2,135812,135812,135814,0,2,0
38778,5,1,135817,135817,135818,0,1,3
38779,2,1,135819,135819,135820,0,1,1
38780,2,1,135821,135821,135822,0,1,1
38781,3,3,135824,135824,135827,0,3,2
38782,6,2,135830,135830,135832,0,2,3
38783,5,2,135835,135835,135837,0,2,3
38784,1,2,135836,135837,135839,1,3,0
38785,5,3,135841,135841,135844,0,3,2
38786,1,2,135842,135844,135846,2,4,0
38787,5,1,135847,135847,135848,0,1,1
38788,4,2,135851,135851,135853,0,2,3
38789,2,1,135853,135853,135854,0,1,0
38790,3,2,135856,135856,135858,0,2,2
38791,1,3,135857,135858,135861,1,4,0
38792,5,2,135862,135862,135864,0,2,1
38793,6,1,135868,135868,135869,0,1,4
38794,2,3,135870,135870,135873,0,3,1
38795,2,2,135872,135873,135875,1,3,0
38796,1,2,135873,135875,135877,2,4,0
38797,5,3,135878,135878,135881,0,3,1
38798,3,3,135881,135881,135884,0,3,0
38799,4,3,135885,135885,135888,0,3,1
38800,3,2,135888,135888,135890,0,2,0
38801,6,1,135894,135894,135895,0,1,4
38802,4,3,135898,135898,135901,0,3,3
38803,3,3,135901,135901,135904,0,3,0
38804,6,2,135907,135907,135909,0,2,3
38805,2,2,135909,135909,135911,0,2,0
38806,5,1,135914,135914,135915,0,1,3
38807,3,3,135917,135917,135920,0,3,2
38808,3,1,135920,135920,135921,0,1,0
38809,3,1,135923,135923,135924,0,1,2
38810,2,1,135925,135925,135926,0,1,1
38811,4,2,135929,135929,135931,0,2,3
38812,3,1,135932,135932,135933,0,1,1
38813,5,2,135937,135937,135939,0,2,4
38814,3,1,135940,135940,135941,0,1,1
38815,2,3,135942,135942,135945,0,3,1
38816,2,3,135944,135945,135948,1,4,0
38817,4,1,135948,135948,135949,0,1,0
38818,5,1,135953,135953,135954,0,1,4
38819,4,2,135957,135957,135959,0,2,3
38820,3,2,135960,135960,135962,0,2,1
38821,4,3,135964,135964,135967,0,3,2
38822,5,1,135969,135969,135970,0,1,2
38823,6,3,135975,135975,135978,0,3,5
38824,3,3,135978,135978,135981,0,3,0
38825,4,1,135982,135982,135983,0,1,1
38826,2,2,135984,135984,135986,0,2,1
38827,2,1,135986,135986,135987,0,1,0
38828,2,2,135988,135988,135990,0,2,1
38829,5,3,135993,135993,135996,0,3,3
38830,1,1,135994,135996,135997,2,3,0
38831,4,2,135998,135998,136000,0,2,1
38832,3,2,136001,136001,136003,0,2,1
38833,5,3,136006,136006,136009,0,3,3
38834,1,1,136007,136009,136010,2,3,0
38835,3,2,136010,136010,136012,0,2,0
38836,2,2,136012,136012,136014,0,2,0
38837,6,1,136018,136018,136019,0,1,4
38838,6,1,136024,136024,136025,0,1,5
38839,5,2,136029,136029,136031,0,2,4
38840,4,3,136033,136033,136036,0,3,2
38841,3,2,136036,136036,136038,0,2,0
38842,1,2,136037,136038,136040,1,3,0
38843,1,1,136038,136040,136041,2,3,0
38844,5,1,136043,136043,136044,0,1,2
38845,4,2,136047,136047,136049,0,2,3
38846,3,3,136050,136050,136053,0,3,1
38847,2,3,136052,136053,136056,1,4,0
38848,6,1,136058,136058,136059,0,1,2
38849,4,2,136062,136062,136064,0,2,3
38850,1,2,136063,136064,136066,1,3,0
38851,5,1,136068,136068,136069,0,1,2
38852,3,2,136071,136071,136073,0,2,2
38853,5,2,136076,136076,136078,0,2,3
38854,2,1,136078,136078,136079,0,1,0
38855,6,1,136084,136084,136085,0,1,5
38856,3,2,136087,136087,136089,0,2,2
38857,5,3,136092,136092,136095,0,3,3
38858,3,2,136095,136095,136097,0,2,0
38859,5,1,136100,136100,136101,0,1,3
38860,1,1,136101,136101,136102,0,1,0
38861,3,2,136104,136104,136106,0,2,2
38862,5,3,136109,136109,136112,0,3,3
38863,4,3,136113,136113,136116,0,3,1
38864,6,2,136119,136119,136121,0,2,3
38865,5,3,136124,136124,136127,0,3,3
38866,1,2,136125,136127,136129,2,4,0
38867,5,3,136130,136130,136133,0,3,1
38868,1,3,136131,136133,136136,2,5,0
38869,4,3,136135,136136,136139,1,4,0
38870,3,1,136138,136139,136140,1,2,0
38871,6,1,136144,136144,136145,0,1,4
38872,5,2,136149,136149,136151,0,2,4
38873,3,2,136152,136152,136154,0,2,1
38874,4,3,136156,136156,136159,0,3,2
38875,6,2,136162,136162,136164,0,2,3
38876,6,1,136168,136168,136169,0,1,4
38877,1,1,136169,136169,136170,0,1,0
38878,6,1,136175,136175,136176,0,1,5
38879,1,3,136176,136176,136179,0,3,0
38880,2,1,136178,136179,136180,1,2,0
38881,1,2,136179,136180,136182,1,3,0
38882,3,2,136182,136182,136184,0,2,0
38883,3,1,136185,136185,136186,0,1,1
38884,1,1,136186,136186,136187,0,1,0
38885,6,2,136192,136192,136194,0,2,5
38886,6,3,136198,136198,136201,0,3,4
38887,5,3,136203,136203,136206,0,3,2
38888,4,3,136207,136207,136210,0,3,1
38889,4,2,136211,136211,136213,0,2,1
38890,2,2,136213,136213,136215,0,2,0
38891,5,2,136218,136218,136220,0,2,3
38892,6,3,136224,136224,136227,0,3,4
38893,5,2,136229,136229,136231,0,2,2
38894,2,3,136231,136231,136234,0,3,0
38895,3,1,136234,136234,136235,0,1,0
38896,1,1,136235,136235,136236,0,1,0
38897,3,3,136238,136238,136241,0,3,2
38898,3,3,136241,136241,136244,0,3,0
38899,6,2,136247,136247,136249,0,2,3
38900,3,3,136250,136250,136253,0,3,1
38901,1,3,136251,136253,136256,2,5,0
38902,3,2,136254,136256,136258,2,4,0
38903,3,3,136257,136258,136261,1,4,0
38904,1,1,136258,136261,136262,3,4,0
38905,1,3,136259,136262,136265,3,6,0
38906,5,2,136264,136265,136267,1,3,0
38907,6,1,136270,136270,136271,0,1,3
38908,4,1,136274,136274,136275,0,1,3
38909,2,2,136276,136276,136278,0,2,1
38910,3,1,136279,136279,136280,0,1,1
38911,5,2,136284,136284,136286,0,2,4
38912,1,2,136285,136286,136288,1,3,0
38913,4,3,136289,136289,136292,0,3,1
38914,4,2,136293,136293,136295,0,2,1
38915,1,3,136294,136295,136298,1,4,0
38916,1,2,136295,136298,136300,3,5,0
38917,1,2,136296,136300,136302,4,6,0
38918,6,1,136302,136302,136303,0,1,0
38919,3,1,136305,136305,136306,0,1,2
38920,1,1,136306,136306,136307,0,1,0
38921,3,2,136309,136309,136311,0,2,2
38922,4,3,136313,136313,136316,0,3,2
38923,2,2,136315,136316,136318,1,3,0
38924,3,2,136318,136318,136320,0,2,0
38925,4,1,136322,136322,136323,0,1,2
38926,3,2,136325,136325,136327,0,2,2
38927,6,2,136331,136331,136333,0,2,4
38928,6,2,136337,136337,136339,0,2,4
38929,5,3,136342,136342,136345,0,3,3
38930,6,1,136348,136348,136349,0,1,3
38931,4,2,136352,136352,136354,0,2,3
38932,2,1,136354,136354,136355,0,1,0
38933,3,1,136357,136357,136358,0,1,2
38934,2,2,136359,136359,136361,0,2,1
38935,1,1,136360,136361,136362,1,2,0
38936,2,3,136362,136362,136365,0,3,0
38937,1,1,136363,136365,136366,2,3,0
38938,2,1,136365,136366,136367,1,2,0
38939,3,3,136368,136368,136371,0,3,1
38940,1,2,136369,136371,136373,2,4,0
38941,3,3,136372,136373,136376,1,4,0
38942,6,2,136378,136378,136380,0,2,2
38943,3,2,136381,136381,136383,0,2,1
38944,1,1,136382,136383,136384,1,2,0
38945,2,1,136384,136384,136385,0,1,0
38946,2,2,136386,136386,136388,0,2,1
38947,5,2,136391,136391,136393,0,2,3
38948,4,3,136395,136395,136398,0,3,2
38949,5,1,136400,136400,136401,0,1,2
38950,3,2,136403,136403,136405,0,2,2
38951,4,1,136407,136407,136408,0,1,2
38952,6,1,136413,136413,136414,0,1,5
38953,2,1,136415,136415,136416,0,1,1
38954,5,1,136420,136420,136421,0,1,4
38955,4,2,136424,136424,136426,0,2,3
38956,5,1,136429,136429,136430,0,1,3
38957,1,1,136430,136430,136431,0,1,0
38958,6,1,136436,136436,136437,0,1,5
38959,6,3,136442,136442,136445,0,3,5
38960,6,1,136448,136448,136449,0,1,3
38961,6,2,136454,136454,136456,0,2,5
38962,3,1,136457,136457,136458,0,1,1
38963,2,3,136459,136459,136462,0,3,1
38964,6,3,136465,136465,136468,0,3,3
38965,6,3,136471,136471,136474,0,3,3
38966,4,1,136475,136475,136476,0,1,1
38967,6,2,136481,136481,136483,0,2,5
38968,4,1,136485,136485,136486,0,1,2
38969,4,3,136489,136489,136492,0,3,3
38970,3,3,136492,136492,136495,0,3,0
38971,3,3,136495,136495,136498,0,3,0
38972,5,3,136500,136500,136503,0,3,2
38973,3,1,136503,136503,136504,0,1,0
38974,3,1,136506,136506,136507,0,1,2
38975,6,1,136512,136512,136513,0,1,5
38976,1,3,136513,136513,136516,0,3,0
38977,5,1,136518,136518,136519,0,1,2
38978,6,3,136524,136524,136527,0,3,5
38979,1,3,136525,136527,136530,2,5,0
38980,4,1,136529,136530,136531,1,2,0
38981,3,2,136532,136532,136534,0,2,1
38982,1,2,136533,136534,136536,1,3,0
38983,2,2,136535,136536,136538,1,3,0
38984,5,1,136540,136540,136541,0,1,2
38985,4,2,136544,136544,136546,0,2,3
38986,5,2,136549,136549,136551,0,2,3
38987,2,3,136551,136551,136554,0,3,0
38988,1,2,136552,136554,136556,2,4,0
38989,5,1,136557,136557,136558,0,1,1
38990,2,3,136559,136559,136562,0,3,1
38991,6,2,136565,136565,136567,0,2,3
38992,1,2,136566,136567,136569,1,3,0
38993,5,3,136571,136571,136574,0,3,2
38994,3,2,136574,136574,136576,0,2,0
38995,3,2,136577,136577,136579,0,2,1
38996,6,3,136583,136583,136586,0,3,4
38997,6,2,136589,136589,136591,0,2,3
38998,3,3,136592,136592,136595,0,3,1
38999,5,3,136597,136597,136600,0,3,2
39000,6,3,136603,136603,136606,0,3,3
39001,6,2,136609,136609,136611,0,2,3
39002,4,2,136613,136613,136615,0,2,2
39003,6,3,136619,136619,136622,0,3,4
39004,6,1,136625,136625,136626,0,1,3
39005,1,2,136626,136626,136628,0,2,0
39006,2,2,136628,136628,136630,0,2,0
39007,6,2,136634,136634,136636,0,2,4
39008,3,1,136637,136637,136638,0,1,1
39009,1,3,136638,136638,136641,0,3,0
39010,4,2,136642,136642,136644,0,2,1
39011,5,3,136647,136647,136650,0,3,3
39012,4,3,136651,136651,136654,0,3,1
39013,2,3,136653,136654,136657,1,4,0
39014,4,3,136657,136657,136660,0,3,0
39015,4,3,136661,136661,136664,0,3,1
39016,4,3,136665,136665,136668,0,3,1
39017,5,1,136670,136670,136671,0,1,2
39018,5,2,136675,136675,136677,0,2,4
39019,2,3,136677,136677,136680,0,3,0
39020,6,3,136683,136683,136686,0,3,3
39021,2,3,136685,136686,136689,1,4,0
39022,4,2,136689,136689,136691,0,2,0
39023,5,1,136694,136694,136695,0,1,3
39024,1,1,136695,136695,136696,0,1,0
39025,5,2,136700,136700,136702,0,2,4
39026,3,1,136703,136703,136704,0,1,1
39027,1,3,136704,136704,136707,0,3,0
39028,3,2,136707,136707,136709,0,2,0
39029,4,1,136711,136711,136712,0,1,2
39030,5,1,136716,136716,136717,0,1,4
39031,1,2,136717,136717,136719,0,2,0
39032,6,1,136723,136723,136724,0,1,4
39033,5,1,136728,136728,136729,0,1,4
39034,1,3,136729,136729,136732,0,3,0
39035,2,1,136731,136732,136733,1,2,0
39036,6,1,136737,136737,136738,0,1,4
39037,6,3,136743,136743,136746,0,3,5
39038,5,3,136748,136748,136751,0,3,2
39039,1,3,136749,136751,136754,2,5,0
39040,5,1,136754,136754,136755,0,1,0
39041,3,3,136757,136757,136760,0,3,2
39042,6,1,136763,136763,136764,0,1,3
39043,1,2,136764,136764,136766,0,2,0
39044,5,3,136769,136769,136772,0,3,3
39045,3,3,136772,136772,136775,0,3,0
39046,6,1,136778,136778,136779,0,1,3
39047,6,1,136784,136784,136785,0,1,5
39048,5,3,136789,136789,136792,0,3,4
39049,1,3,136790,136792,136795,2,5,0
39050,1,1,136791,136795,136796,4,5,0
39051,2,3,136793,136796,136799,3,6,0
39052,5,2,136798,136799,136801,1,3,0
39053,3,2,136801,136801,136803,0,2,0
39054,2,2,136803,136803,136805,0,2,0
39055,5,2,136808,136808,136810,0,2,3
39056,4,3,136812,136812,136815,0,3,2
39057,4,1,136816,136816,136817,0,1,1
39058,6,1,136822,136822,136823,0,1,5
39059,6,3,136828,136828,136831,0,3,5
39060,5,2,136833,136833,136835,0,2,2
39061,3,2,136836,136836,136838,0,2,1
39062,2,1,136838,136838,136839,0,1,0
39063,5,1,136843,136843,136844,0,1,4
39064,3,1,136846,136846,136847,0,1,2
39065,6,1,136852,136852,136853,0,1,5
39066,2,2,136854,136854,136856,0,2,1
39067,6,2,136860,136860,136862,0,2,4
39068,1,2,136861,136862,136864,1,3,0
39069,1,3,136862,136864,136867,2,5,0
39070,5,3,136867,136867,136870,0,3,0
39071,5,2,136872,136872,136874,0,2,2
39072,5,2,136877,136877,136879,0,2,3
39073,5,1,136882,136882,136883,0,1,3
39074,1,2,136883,136883,136885,0,2,0
39075,3,3,136886,136886,136889,0,3,1
39076,2,2,136888,136889,136891,1,3,0
39077,3,3,136891,136891,136894,0,3,0
39078,5,1,136896,136896,136897,0,1,2
39079,5,3,136901,136901,136904,0,3,4
39080,6,1,136907,136907,136908,0,1,3
39081,1,1,136908,136908,136909,0,1,0
39082,4,3,136912,136912,136915,0,3,3
39083,6,3,136918,136918,136921,0,3,3
39084,3,3,136921,136921,136924,0,3,0
39085,4,3,136925,136925,136928,0,3,1
39086,2,3,136927,136928,136931,1,4,0
39087,4,1,136931,136931,136932,0,1,0
39088,5,1,136936,136936,136937,0,1,4
39089,1,3,136937,136937,136940,0,3,0
39090,6,1,136943,136943,136944,0,1,3
39091,3,1,136946,136946,136947,0,1,2
39092,3,3,136949,136949,136952,0,3,2
39093,4,3,136953,136953,136956,0,3,1
39094,1,3,136954,136956,136959,2,5,0
39095,5,2,136959,136959,136961,0,2,0
39096,1,1,136960,136961,136962,1,2,0
39097,4,1,136964,136964,136965,0,1,2
39098,4,1,136968,136968,136969,0,1,3
39099,3,3,136971,136971,136974,0,3,2
39100,1,1,136972,136974,136975,2,3,0
39101,2,2,136974,136975,136977,1,3,0
39102,4,3,136978,136978,136981,0,3,1
39103,1,2,136979,136981,136983,2,4,0
39104,1,1,136980,136983,136984,3,4,0
39105,2,2,136982,136984,136986,2,4,0
39106,6,2,136988,136988,136990,0,2,2
39107,1,3,136989,136990,136993,1,4,0
39108,5,1,136994,136994,136995,0,1,1
39109,2,1,136996,136996,136997,0,1,1
39110,1,3,136997,136997,137000,0,3,0
39111,2,2,136999,137000,137002,1,3,0
39112,2,1,137001,137002,137003,1,2,0
39113,3,1,137004,137004,137005,0,1,1
39114,6,3,137010,137010,137013,0,3,5
39115,4,2,137014,137014,137016,0,2,1
39116,3,2,137017,137017,137019,0,2,1
39117,2,2,137019,137019,137021,0,2,0
39118,6,1,137025,137025,137026,0,1,4
39119,4,1,137029,137029,137030,0,1,3
39120,1,2,137030,137030,137032,0,2,0
39121,6,3,137036,137036,137039,0,3,4
39122,6,3,137042,137042,137045,0,3,3
39123,2,1,137044,137045,137046,1,2,0
39124,3,3,137047,137047,137050,0,3,1
39125,2,3,137049,137050,137053,1,4,0
39126,5,3,137054,137054,137057,0,3,1
39127,2,2,137056,137057,137059,1,3,0
39128,5,2,137061,137061,137063,0,2,2
39129,2,1,137063,137063,137064,0,1,0
39130,2,1,137065,137065,137066,0,1,1
39131,5,1,137070,137070,137071,0,1,4
39132,4,3,137074,137074,137077,0,3,3
39133,5,2,137079,137079,137081,0,2,2
39134,4,3,137083,137083,137086,0,3,2
39135,1,2,137084,137086,137088,2,4,0
39136,1,2,137085,137088,137090,3,5,0
39137,2,3,137087,137090,137093,3,6,0
39138,3,3,137090,137093,137096,3,6,0
39139,6,2,137096,137096,137098,0,2,0
39140,1,3,137097,137098,137101,1,4,0
39141,6,3,137103,137103,137106,0,3,2
39142,5,1,137108,137108,137109,0,1,2
39143,3,2,137111,137111,137113,0,2,2
39144,5,3,137116,137116,137119,0,3,3
39145,5,1,137121,137121,137122,0,1,2
39146,4,3,137125,137125,137128,0,3,3
39147,3,2,137128,137128,137130,0,2,0
39148,3,1,137131,137131,137132,0,1,1
39149,4,3,137135,137135,137138,0,3,3
39150,6,3,137141,137141,137144,0,3,3
39151,1,2,137142,137144,137146,2,4,0
39152,5,1,137147,137147,137148,0,1,1
39153,1,3,137148,137148,137151,0,3,0
39154,4,1,137152,137152,137153,0,1,1
39155,2,3,137154,137154,137157,0,3,1
39156,1,2,137155,137157,137159,2,4,0
39157,6,2,137161,137161,137163,0,2,2
39158,3,3,137164,137164,137167,0,3,1
39159,1,2,137165,137167,137169,2,4,0
39160,3,1,137168,137169,137170,1,2,0
39161,5,3,137173,137173,137176,0,3,3
39162,4,1,137177,137177,137178,0,1,1
39163,3,3,137180,137180,137183,0,3,2
39164,5,1,137185,137185,137186,0,1,2
39165,6,3,137191,137191,137194,0,3,5
39166,1,1,137192,137194,137195,2,3,0
39167,3,1,137195,137195,137196,0,1,0
39168,6,3,137201,137201,137204,0,3,5
39169,3,3,137204,137204,137207,0,3,0
39170,6,1,137210,137210,137211,0,1,3
39171,6,2,137216,137216,137218,0,2,5
39172,4,2,137220,137220,137222,0,2,2
39173,2,3,137222,137222,137225,0,3,0
39174,4,1,137226,137226,137227,0,1,1
39175,4,1,137230,137230,137231,0,1,3
39176,1,1,137231,137231,137232,0,1,0
39177,6,3,137237,137237,137240,0,3,5
39178,6,1,137243,137243,137244,0,1,3
39179,3,1,137246,137246,137247,0,1,2
39180,1,1,137247,137247,137248,0,1,0
39181,5,3,137252,137252,137255,0,3,4
39182,5,1,137257,137257,137258,0,1,2
39183,6,3,137263,137263,137266,0,3,5
39184,1,3,137264,137266,137269,2,5,0
39185,3,2,137267,137269,137271,2,4,0
39186,4,3,137271,137271,137274,0,3,0
39187,1,1,137272,137274,137275,2,3,0
39188,1,3,137273,137275,137278,2,5,0
39189,5,2,137278,137278,137280,0,2,0
39190,5,1,137283,137283,137284,0,1,3
39191,6,3,137289,137289,137292,0,3,5
39192,5,2,137294,137294,137296,0,2,2
39193,2,2,137296,137296,137298,0,2,0
39194,5,2,137301,137301,137303,0,2,3
39195,6,3,137307,137307,137310,0,3,4
39196,2,1,137309,137310,137311,1,2,0
39197,6,3,137315,137315,137318,0,3,4
39198,6,3,137321,137321,137324,0,3,3
39199,1,3,137322,137324,137327,2,5,0
39200,2,3,137324,137327,137330,3,6,0
39201,6,3,137330,137330,137333,0,3,0
39202,2,3,137332,137333,137336,1,4,0
39203,3,1,137335,137336,137337,1,2,0
39204,2,2,137337,137337,137339,0,2,0
39205,6,1,137343,137343,137344,0,1,4
39206,6,2,137349,137349,137351,0,2,5
39207,3,3,137352,137352,137355,0,3,1
39208,6,2,137358,137358,137360,0,2,3
39209,4,2,137362,137362,137364,0,2,2
39210,5,1,137367,137367,137368,0,1,3
39211,2,1,137369,137369,137370,0,1,1
39212,4,2,137373,137373,137375,0,2,3
39213,4,3,137377,137377,137380,0,3,2
39214,6,2,137383,137383,137385,0,2,3
39215,5,1,137388,137388,137389,0,1,3
39216,3,3,137391,137391,137394,0,3,2
39217,4,2,137395,137395,137397,0,2,1
39218,6,1,137401,137401,137402,0,1,4
39219,5,3,137406,137406,137409,0,3,4
39220,4,1,137410,137410,137411,0,1,1
39221,4,1,137414,137414,137415,0,1,3
39222,2,3,137416,137416,137419,0,3,1
39223,6,3,137422,137422,137425,0,3,3
39224,2,2,137424,137425,137427,1,3,0
39225,5,3,137429,137429,137432,0,3,2
39226,5,2,137434,137434,137436,0,2,2
39227,5,2,137439,137439,137441,0,2,3
39228,4,3,137443,137443,137446,0,3,2
39229,1,1,137444,137446,137447,2,3,0
39230,2,1,137446,137447,137448,1,2,0
39231,3,1,137449,137449,137450,0,1,1
39232,6,3,137455,137455,137458,0,3,5
39233,3,2,137458,137458,137460,0,2,0
39234,5,1,137463,137463,137464,0,1,3
39235,4,3,137467,137467,137470,0,3,3
39236,1,3,137468,137470,137473,2,5,0
39237,6,2,137474,137474,137476,0,2,1
39238,6,3,137480,137480,137483,0,3,4
39239,6,3,137486,137486,137489,0,3,3
39240,3,3,137489,137489,137492,0,3,0
39241,1,1,137490,137492,137493,2,3,0
39242,6,3,137496,137496,137499,0,3,3
39243,4,3,137500,137500,137503,0,3,1
39244,5,2,137505,137505,137507,0,2,2
39245,1,1,137506,137507,137508,1,2,0
39246,4,1,137510,137510,137511,0,1,2
39247,6,3,137516,137516,137519,0,3,5
39248,1,2,137517,137519,137521,2,4,0
39249,1,2,137518,137521,137523,3,5,0
39250,2,3,137520,137523,137526,3,6,0
39251,5,3,137525,137526,137529,1,4,0
39252,5,3,137530,137530,137533,0,3,1
39253,3,3,137533,137533,137536,0,3,0
39254,4,1,137537,137537,137538,0,1,1
39255,6,3,137543,137543,137546,0,3,5
39256,4,3,137547,137547,137550,0,3,1
39257,6,3,137553,137553,137556,0,3,3
39258,3,1,137556,137556,137557,0,1,0
39259,1,2,137557,137557,137559,0,2,0
39260,1,1,137558,137559,137560,1,2,0
39261,2,3,137560,137560,137563,0,3,0
39262,3,1,137563,137563,137564,0,1,0
39263,6,2,137569,137569,137571,0,2,5
39264,1,3,137570,137571,137574,1,4,0
39265,2,2,137572,137574,137576,2,4,0
39266,4,2,137576,137576,137578,0,2,0
39267,2,1,137578,137578,137579,0,1,0
39268,6,3,137584,137584,137587,0,3,5
39269,1,2,137585,137587,137589,2,4,0
39270,2,2,137587,137589,137591,2,4,0
39271,5,3,137592,137592,137595,0,3,1
39272,6,1,137598,137598,137599,0,1,3
39273,1,1,137599,137599,137600,0,1,0
39274,2,1,137601,137601,137602,0,1,1
39275,3,1,137604,137604,137605,0,1,2
39276,1,2,137605,137605,137607,0,2,0
39277,5,3,137610,137610,137613,0,3,3
39278,5,3,137615,137615,137618,0,3,2
39279,2,2,137617,137618,137620,1,3,0
39280,4,2,137621,137621,137623,0,2,1
39281,6,1,137627,137627,137628,0,1,4
39282,1,2,137628,137628,137630,0,2,0
39283,3,2,137631,137631,137633,0,2,1
39284,2,3,137633,137633,137636,0,3,0
39285,4,1,137637,137637,137638,0,1,1
39286,4,2,137641,137641,137643,0,2,3
39287,3,2,137644,137644,137646,0,2,1
39288,1,3,137645,137646,137649,1,4,0
39289,5,1,137650,137650,137651,0,1,1
39290,4,1,137654,137654,137655,0,1,3
39291,5,2,137659,137659,137661,0,2,4
39292,2,3,137661,137661,137664,0,3,0
39293,6,1,137667,137667,137668,0,1,3
39294,5,3,137672,137672,137675,0,3,4
39295,5,3,137677,137677,137680,0,3,2
39296,3,1,137680,137680,137681,0,1,0
39297,3,1,137683,137683,137684,0,1,2
39298,2,3,137685,137685,137688,0,3,1
39299,6,2,137691,137691,137693,0,2,3
39300,2,3,137693,137693,137696,0,3,0
39301,5,2,137698,137698,137700,0,2,2
39302,2,1,137700,137700,137701,0,1,0
39303,6,1,137706,137706,137707,0,1,5
39304,6,1,137712,137712,137713,0,1,5
39305,3,1,137715,137715,137716,0,1,2
39306,2,3,137717,137717,137720,0,3,1
39307,6,3,137723,137723,137726,0,3,3
39308,4,2,137727,137727,137729,0,2,1
39309,3,2,137730,137730,137732,0,2,1
39310,5,3,137735,137735,137738,0,3,3
39311,6,3,137741,137741,137744,0,3,3
39312,6,2,137747,137747,137749,0,2,3
39313,6,1,137753,137753,137754,0,1,4
39314,4,1,137757,137757,137758,0,1,3
39315,2,2,137759,137759,137761,0,2,1
39316,1,2,137760,137761,137763,1,3,0
39317,4,3,137764,137764,137767,0,3,1
39318,5,1,137769,137769,137770,0,1,2
39319,2,1,137771,137771,137772,0,1,1
39320,4,2,137775,137775,137777,0,2,3
39321,1,3,137776,137777,137780,1,4,0
39322,2,3,137778,137780,137783,2,5,0
39323,6,2,137784,137784,137786,0,2,1
39324,3,2,137787,137787,137789,0,2,1
39325,5,2,137792,137792,137794,0,2,3
39326,2,2,137794,137794,137796,0,2,0
39327,4,2,137798,137798,137800,0,2,2
39328,5,2,137803,137803,137805,0,2,3
39329,3,3,137806,137806,137809,0,3,1
39330,4,3,137810,137810,137813,0,3,1
39331,3,2,137813,137813,137815,0,2,0
39332,2,2,137815,137815,137817,0,2,0
39333,1,1,137816,137817,137818,1,2,0
39334,4,1,137820,137820,137821,0,1,2
39335,3,2,137823,137823,137825,0,2,2
39336,2,2,137825,137825,137827,0,2,0
39337,4,2,137829,137829,137831,0,2,2
39338,1,2,137830,137831,137833,1,3,0
39339,1,3,137831,137833,137836,2,5,0
39340,5,3,137836,137836,137839,0,3,0
39341,6,2,137842,137842,137844,0,2,3
39342,6,1,137848,137848,137849,0,1,4
39343,1,1,137849,137849,137850,0,1,0
39344,6,1,137855,137855,137856,0,1,5
39345,1,3,137856,137856,137859,0,3,0
39346,3,1,137859,137859,137860,0,1,0
39347,2,3,137861,137861,137864,0,3,1
39348,5,3,137866,137866,137869,0,3,2
39349,2,1,137868,137869,137870,1,2,0
39350,1,2,137869,137870,137872,1,3,0
39351,6,2,137875,137875,137877,0,2,3
39352,6,1,137881,137881,137882,0,1,4
39353,3,2,137884,137884,137886,0,2,2
39354,1,3,137885,137886,137889,1,4,0
39355,5,3,137890,137890,137893,0,3,1
39356,3,1,137893,137893,137894,0,1,0
39357,6,1,137899,137899,137900,0,1,5
39358,4,2,137903,137903,137905,0,2,3
39359,6,1,137909,137909,137910,0,1,4
39360,1,1,137910,137910,137911,0,1,0
39361,6,3,137916,137916,137919,0,3,5
39362,1,2,137917,137919,137921,2,4,0
39363,1,3,137918,137921,137924,3,6,0
39364,6,1,137924,137924,137925,0,1,0
39365,2,3,137926,137926,137929,0,3,1
39366,5,2,137931,137931,137933,0,2,2
39367,1,3,137932,137933,137936,1,4,0
39368,4,1,137936,137936,137937,0,1,0
39369,5,1,137941,137941,137942,0,1,4
39370,3,2,137944,137944,137946,0,2,2
39371,5,2,137949,137949,137951,0,2,3
39372,4,3,137953,137953,137956,0,3,2
39373,6,2,137959,137959,137961,0,2,3
39374,4,1,137963,137963,137964,0,1,2
39375,5,3,137968,137968,137971,0,3,4
39376,4,3,137972,137972,137975,0,3,1
39377,3,2,137975,137975,137977,0,2,0
39378,6,3,137981,137981,137984,0,3,4
39379,4,3,137985,137985,137988,0,3,1
39380,6,2,137991,137991,137993,0,2,3
39381,5,1,137996,137996,137997,0,1,3
39382,3,1,137999,137999,138000,0,1,2
39383,2,1,138001,138001,138002,0,1,1
39384,1,2,138002,138002,138004,0,2,0
39385,1,1,138003,138004,138005,1,2,0
39386,3,1,138006,138006,138007,0,1,1
39387,5,1,138011,138011,138012,0,1,4
39388,3,1,138014,138014,138015,0,1,2
39389,4,1,138018,138018,138019,0,1,3
39390,1,2,138019,138019,138021,0,2,0
39391,6,3,138025,138025,138028,0,3,4
39392,2,1,138027,138028,138029,1,2,0
39393,5,1,138032,138032,138033,0,1,3
39394,4,1,138036,138036,138037,0,1,3
39395,5,2,138041,138041,138043,0,2,4
39396,6,1,138047,138047,138048,0,1,4
39397,1,2,138048,138048,138050,0,2,0
39398,4,3,138052,138052,138055,0,3,2
39399,4,3,138056,138056,138059,0,3,1
39400,6,2,138062,138062,138064,0,2,3
39401,6,3,138068,138068,138071,0,3,4
39402,5,1,138073,138073,138074,0,1,2
39403,2,1,138075,138075,138076,0,1,1
39404,3,1,138078,138078,138079,0,1,2
39405,6,1,138084,138084,138085,0,1,5
39406,2,3,138086,138086,138089,0,3,1
39407,2,3,138088,138089,138092,1,4,0
39408,3,1,138091,138092,138093,1,2,0
39409,5,2,138096,138096,138098,0,2,3
39410,6,1,138102,138102,138103,0,1,4
39411,1,2,138103,138103,138105,0,2,0
39412,1,3,138104,138105,138108,1,4,0
39413,3,1,138107,138108,138109,1,2,0
39414,1,3,138108,138109,138112,1,4,0
39415,3,3,138111,138112,138115,1,4,0
39416,3,3,138114,138115,138118,1,4,0
39417,3,2,138117,138118,138120,1,3,0
39418,6,3,138123,138123,138126,0,3,3
39419,6,2,138129,138129,138131,0,2,3
39420,6,3,138135,138135,138138,0,3,4
39421,3,3,138138,138138,138141,0,3,0
39422,2,3,138140,138141,138144,1,4,0
39423,1,3,138141,138144,138147,3,6,0
39424,3,3,138144,138147,138150,3,6,0
39425,2,2,138146,138150,138152,4,6,0
39426,3,2,138149,138152,138154,3,5,0
39427,1,1,138150,138154,138155,4,5,0
39428,3,3,138153,138155,138158,2,5,0
39429,1,3,138154,138158,138161,4,7,0
39430,5,2,138159,138161,138163,2,4,0
39431,6,1,138165,138165,138166,0,1,2
39432,2,3,138167,138167,138170,0,3,1
39433,5,3,138172,138172,138175,0,3,2
39434,2,1,138174,138175,138176,1,2,0
39435,6,2,138180,138180,138182,0,2,4
39436,6,2,138186,138186,138188,0,2,4
39437,4,3,138190,138190,138193,0,3,2
39438,5,2,138195,138195,138197,0,2,2
39439,4,3,138199,138199,138202,0,3,2
39440,4,3,138203,138203,138206,0,3,1
39441,1,1,138204,138206,138207,2,3,0
39442,1,1,138205,138207,138208,2,3,0
39443,3,1,138208,138208,138209,0,1,0
39444,3,1,138211,138211,138212,0,1,2
39445,4,2,138215,138215,138217,0,2,3
39446,4,1,138219,138219,138220,0,1,2
39447,4,1,138223,138223,138224,0,1,3
39448,6,3,138229,138229,138232,0,3,5
39449,5,3,138234,138234,138237,0,3,2
39450,3,3,138237,138237,138240,0,3,0
39451,6,2,138243,138243,138245,0,2,3
39452,1,3,138244,138245,138248,1,4,0
39453,3,3,138247,138248,138251,1,4,0
39454,4,2,138251,138251,138253,0,2,0
39455,6,1,138257,138257,138258,0,1,4
39456,6,1,138263,138263,138264,0,1,5
39457,4,3,138267,138267,138270,0,3,3
39458,5,1,138272,138272,138273,0,1,2
39459,4,1,138276,138276,138277,0,1,3
39460,5,3,138281,138281,138284,0,3,4
39461,2,3,138283,138284,138287,1,4,0
39462,2,1,138285,138287,138288,2,3,0
39463,4,3,138289,138289,138292,0,3,1
39464,2,2,138291,138292,138294,1,3,0
39465,1,1,138292,138294,138295,2,3,0
39466,1,2,138293,138295,138297,2,4,0
39467,5,2,138298,138298,138300,0,2,1
39468,3,1,138301,138301,138302,0,1,1
39469,3,2,138304,138304,138306,0,2,2
39470,3,3,138307,138307,138310,0,3,1
39471,1,1,138308,138310,138311,2,3,0
39472,3,3,138311,138311,138314,0,3,0
39473,6,3,138317,138317,138320,0,3,3
39474,3,3,138320,138320,138323,0,3,0
39475,6,3,138326,138326,138329,0,3,3
39476,6,3,138332,138332,138335,0,3,3
39477,1,3,138333,138335,138338,2,5,0
39478,2,1,138335,138338,138339,3,4,0
39479,2,3,138337,138339,138342,2,5,0
39480,5,3,138342,138342,138345,0,3,0
39481,6,2,138348,138348,138350,0,2,3
39482,1,3,138349,138350,138353,1,4,0
39483,1,2,138350,138353,138355,3,5,0
39484,1,3,138351,138355,138358,4,7,0
39485,4,1,138355,138358,138359,3,4,0
39486,6,1,138361,138361,138362,0,1,2
39487,3,2,138364,138364,138366,0,2,2
39488,2,2,138366,138366,138368,0,2,0
39489,3,1,138369,138369,138370,0,1,1
39490,5,3,138374,138374,138377,0,3,4
39491,5,3,138379,138379,138382,0,3,2
39492,2,1,138381,138382,138383,1,2,0
39493,1,1,138382,138383,138384,1,2,0
39494,3,3,138385,138385,138388,0,3,1
39495,3,3,138388,138388,138391,0,3,0
39496,5,1,138393,138393,138394,0,1,2
39497,3,3,138396,138396,138399,0,3,2
39498,4,1,138400,138400,138401,0,1,1
39499,3,3,138403,138403,138406,0,3,2
39500,6,1,138409,138409,138410,0,1,3
39501,4,3,138413,138413,138416,0,3,3
39502,5,2,138418,138418,138420,0,2,2
39503,1,2,138419,138420,138422,1,3,0
39504,6,1,138425,138425,138426,0,1,3
39505,2,2,138427,138427,138429,0,2,1
39506,3,1,138430,138430,138431,0,1,1
39507,4,2,138434,138434,138436,0,2,3
39508,6,3,138440,138440,138443,0,3,4
39509,5,1,138445,138445,138446,0,1,2
39510,4,2,138449,138449,138451,0,2,3
39511,2,1,138451,138451,138452,0,1,0
39512,5,2,138456,138456,138458,0,2,4
39513,1,3,138457,138458,138461,1,4,0
39514,4,2,138461,138461,138463,0,2,0
39515,1,2,138462,138463,138465,1,3,0
39516,5,3,138467,138467,138470,0,3,2
39517,2,2,138469,138470,138472,1,3,0
39518,2,1,138471,138472,138473,1,2,0
39519,5,1,138476,138476,138477,0,1,3
39520,3,2,138479,138479,138481,0,2,2
39521,5,1,138484,138484,138485,0,1,3
39522,3,3,138487,138487,138490,0,3,2
39523,4,2,138491,138491,138493,0,2,1
39524,1,3,138492,138493,138496,1,4,0
39525,3,2,138495,138496,138498,1,3,0
39526,4,1,138499,138499,138500,0,1,1
39527,2,1,138501,138501,138502,0,1,1
39528,5,2,138506,138506,138508,0,2,4
39529,5,2,138511,138511,138513,0,2,3
39530,6,2,138517,138517,138519,0,2,4
39531,2,2,138519,138519,138521,0,2,0
39532,4,3,138523,138523,138526,0,3,2
39533,6,3,138529,138529,138532,0,3,3
39534,3,3,138532,138532,138535,0,3,0
39535,3,3,138535,138535,138538,0,3,0
39536,6,1,138541,138541,138542,0,1,3
39537,3,2,138544,138544,138546,0,2,2
39538,4,1,138548,138548,138549,0,1,2
39539,2,3,138550,138550,138553,0,3,1
39540,1,3,138551,138553,138556,2,5,0
39541,6,1,138557,138557,138558,0,1,1
39542,5,2,138562,138562,138564,0,2,4
39543,5,3,138567,138567,138570,0,3,3
39544,2,1,138569,138570,138571,1,2,0
39545,1,3,138570,138571,138574,1,4,0
39546,3,2,138573,138574,138576,1,3,0
39547,5,1,138578,138578,138579,0,1,2
39548,1,2,138579,138579,138581,0,2,0
39549,2,3,138581,138581,138584,0,3,0
39550,5,3,138586,138586,138589,0,3,2
39551,1,1,138587,138589,138590,2,3,0
39552,6,2,138593,138593,138595,0,2,3
39553,2,1,138595,138595,138596,0,1,0
39554,6,1,138601,138601,138602,0,1,5
39555,2,1,138603,138603,138604,0,1,1
39556,2,3,138605,138605,138608,0,3,1
39557,5,2,138610,138610,138612,0,2,2
39558,3,3,138613,138613,138616,0,3,1
39559,5,3,138618,138618,138621,0,3,2
39560,4,2,138622,138622,138624,0,2,1
39561,1,2,138623,138624,138626,1,3,0
39562,1,2,138624,138626,138628,2,4,0
39563,1,1,138625,138628,138629,3,4,0
39564,3,2,138628,138629,138631,1,3,0
39565,4,3,138632,138632,138635,0,3,1
39566,1,2,138633,138635,138637,2,4,0
39567,1,3,138634,138637,138640,3,6,0
39568,5,1,138639,138640,138641,1,2,0
39569,6,3,138645,138645,138648,0,3,4
39570,6,3,138651,138651,138654,0,3,3
39571,4,3,138655,138655,138658,0,3,1
39572,2,2,138657,138658,138660,1,3,0
39573,3,1,138660,138660,138661,0,1,0
39574,5,2,138665,138665,138667,0,2,4
39575,3,1,138668,138668,138669,0,1,1
39576,5,3,138673,138673,138676,0,3,4
39577,5,1,138678,138678,138679,0,1,2
39578,1,2,138679,138679,138681,0,2,0
39579,4,3,138683,138683,138686,0,3,2
39580,6,1,138689,138689,138690,0,1,3
39581,3,3,138692,138692,138695,0,3,2
39582,1,1,138693,138695,138696,2,3,0
39583,6,1,138699,138699,138700,0,1,3
39584,4,2,138703,138703,138705,0,2,3
39585,3,1,138706,138706,138707,0,1,1
39586,6,1,138712,138712,138713,0,1,5
39587,5,2,138717,138717,138719,0,2,4
39588,5,3,138722,138722,138725,0,3,3
39589,6,2,138728,138728,138730,0,2,3
39590,4,1,138732,138732,138733,0,1,2
39591,3,2,138735,138735,138737,0,2,2
39592,1,1,138736,138737,138738,1,2,0
39593,1,3,138737,138738,138741,1,4,0
39594,6,2,138743,138743,138745,0,2,2
39595,5,1,138748,138748,138749,0,1,3
39596,2,2,138750,138750,138752,0,2,1
39597,1,2,138751,138752,138754,1,3,0
39598,6,2,138757,138757,138759,0,2,3
39599,6,2,138763,138763,138765,0,2,4
39600,1,2,138764,138765,138767,1,3,0
39601,4,2,138768,138768,138770,0,2,1
39602,2,3,138770,138770,138773,0,3,0
39603,4,2,138774,138774,138776,0,2,1
39604,6,2,138780,138780,138782,0,2,4
39605,2,1,138782,138782,138783,0,1,0
39606,2,2,138784,138784,138786,0,2,1
39607,6,2,138790,138790,138792,0,2,4
39608,2,1,138792,138792,138793,0,1,0
39609,2,3,138794,138794,138797,0,3,1
39610,5,1,138799,138799,138800,0,1,2
39611,6,3,138805,138805,138808,0,3,5
39612,5,2,138810,138810,138812,0,2,2
39613,6,3,138816,138816,138819,0,3,4
39614,2,3,138818,138819,138822,1,4,0
39615,2,3,138820,138822,138825,2,5,0
39616,3,1,138823,138825,138826,2,3,0
39617,3,1,138826,138826,138827,0,1,0
39618,6,2,138832,138832,138834,0,2,5
39619,4,3,138836,138836,138839,0,3,2
39620,2,2,138838,138839,138841,1,3,0
39621,4,3,138842,138842,138845,0,3,1
39622,2,3,138844,138845,138848,1,4,0
39623,2,2,138846,138848,138850,2,4,0
39624,5,1,138851,138851,138852,0,1,1
39625,1,2,138852,138852,138854,0,2,0
39626,3,1,138855,138855,138856,0,1,1
39627,2,2,138857,138857,138859,0,2,1
39628,4,3,138861,138861,138864,0,3,2
39629,4,2,138865,138865,138867,0,2,1
39630,1,2,138866,138867,138869,1,3,0
39631,3,1,138869,138869,138870,0,1,0
39632,5,2,138874,138874,138876,0,2,4
39633,4,3,138878,138878,138881,0,3,2
39634,5,1,138883,138883,138884,0,1,2
39635,4,1,138887,138887,138888,0,1,3
39636,3,3,138890,138890,138893,0,3,2
39637,6,1,138896,138896,138897,0,1,3
39638,3,2,138899,138899,138901,0,2,2
39639,2,3,138901,138901,138904,0,3,0
39640,3,2,138904,138904,138906,0,2,0
39641,3,3,138907,138907,138910,0,3,1
39642,3,2,138910,138910,138912,0,2,0
39643,6,2,138916,138916,138918,0,2,4
39644,1,1,138917,138918,138919,1,2,0
39645,2,2,138919,138919,138921,0,2,0
39646,2,1,138921,138921,138922,0,1,0
39647,3,3,138924,138924,138927,0,3,2
39648,2,2,138926,138927,138929,1,3,0
39649,3,2,138929,138929,138931,0,2,0
39650,1,1,138930,138931,138932,1,2,0
39651,3,2,138933,138933,138935,0,2,1
39652,6,3,138939,138939,138942,0,3,4
39653,6,2,138945,138945,138947,0,2,3
39654,2,1,138947,138947,138948,0,1,0
39655,4,2,138951,138951,138953,0,2,3
39656,4,3,138955,138955,138958,0,3,2
39657,2,3,138957,138958,138961,1,4,0
39658,5,3,138962,138962,138965,0,3,1
39659,2,1,138964,138965,138966,1,2,0
39660,5,3,138969,138969,138972,0,3,3
39661,1,2,138970,138972,138974,2,4,0
39662,5,2,138975,138975,138977,0,2,1
39663,5,2,138980,138980,138982,0,2,3
39664,3,3,138983,138983,138986,0,3,1
39665,1,1,138984,138986,138987,2,3,0
39666,3,3,138987,138987,138990,0,3,0
39667,5,1,138992,138992,138993,0,1,2
39668,1,2,138993,138993,138995,0,2,0
39669,1,1,138994,138995,138996,1,2,0
39670,4,2,138998,138998,139000,0,2,2
39671,3,2,139001,139001,139003,0,2,1
39672,3,2,139004,139004,139006,0,2,1
39673,3,1,139007,139007,139008,0,1,1
39674,1,2,139008,139008,139010,0,2,0
39675,1,3,139009,139010,139013,1,4,0
39676,2,2,139011,139013,139015,2,4,0
39677,4,2,139015,139015,139017,0,2,0
39678,2,3,139017,139017,139020,0,3,0
39679,2,1,139019,139020,139021,1,2,0
39680,6,2,139025,139025,139027,0,2,4
39681,6,2,139031,139031,139033,0,2,4
39682,4,2,139035,139035,139037,0,2,2
39683,4,1,139039,139039,139040,0,1,2
39684,2,1,139041,139041,139042,0,1,1
39685,6,2,139047,139047,139049,0,2,5
39686,5,1,139052,139052,139053,0,1,3
39687,2,3,139054,139054,139057,0,3,1
39688,2,1,139056,139057,139058,1,2,0
39689,2,3,139058,139058,139061,0,3,0
39690,4,3,139062,139062,139065,0,3,1
39691,3,3,139065,139065,139068,0,3,0
39692,1,2,139066,139068,139070,2,4,0
39693,3,3,139069,139070,139073,1,4,0
39694,4,3,139073,139073,139076,0,3,0
39695,5,3,139078,139078,139081,0,3,2
39696,5,1,139083,139083,139084,0,1,2
39697,5,1,139088,139088,139089,0,1,4
39698,4,2,139092,139092,139094,0,2,3
39699,5,3,139097,139097,139100,0,3,3
39700,2,2,139099,139100,139102,1,3,0
39701,4,2,139103,139103,139105,0,2,1
39702,2,1,139105,139105,139106,0,1,0
39703,6,2,139111,139111,139113,0,2,5
39704,1,2,139112,139113,139115,1,3,0
39705,3,3,139115,139115,139118,0,3,0
39706,6,3,139121,139121,139124,0,3,3
39707,6,3,139127,139127,139130,0,3,3
39708,3,3,139130,139130,139133,0,3,0
39709,5,2,139135,139135,139137,0,2,2
39710,3,3,139138,139138,139141,0,3,1
39711,3,2,139141,139141,139143,0,2,0
39712,5,3,139146,139146,139149,0,3,3
39713,2,3,139148,139149,139152,1,4,0
39714,5,1,139153,139153,139154,0,1,1
39715,2,2,139155,139155,139157,0,2,1
39716,6,1,139161,139161,139162,0,1,4
39717,4,1,139165,139165,139166,0,1,3
39718,2,1,139167,139167,139168,0,1,1
39719,5,3,139172,139172,139175,0,3,4
39720,6,2,139178,139178,139180,0,2,3
39721,5,2,139183,139183,139185,0,2,3
39722,3,2,139186,139186,139188,0,2,1
39723,1,3,139187,139188,139191,1,4,0
39724,6,1,139193,139193,139194,0,1,2
39725,4,1,139197,139197,139198,0,1,3
39726,1,1,139198,139198,139199,0,1,0
39727,2,2,139200,139200,139202,0,2,1
39728,4,2,139204,139204,139206,0,2,2
39729,5,2,139209,139209,139211,0,2,3
39730,3,3,139212,139212,139215,0,3,1
39731,6,3,139218,139218,139221,0,3,3
39732,2,3,139220,139221,139224,1,4,0
39733,3,1,139223,139224,139225,1,2,0
39734,4,3,139227,139227,139230,0,3,2
39735,3,1,139230,139230,139231,0,1,0
39736,4,3,139234,139234,139237,0,3,3
39737,5,3,139239,139239,139242,0,3,2
39738,1,2,139240,139242,139244,2,4,0
39739,3,1,139243,139244,139245,1,2,0
39740,6,1,139249,139249,139250,0,1,4
39741,5,3,139254,139254,139257,0,3,4
39742,2,3,139256,139257,139260,1,4,0
39743,4,1,139260,139260,139261,0,1,0
39744,6,1,139266,139266,139267,0,1,5
39745,4,3,139270,139270,139273,0,3,3
39746,2,1,139272,139273,139274,1,2,0
39747,1,3,139273,139274,139277,1,4,0
39748,1,2,139274,139277,139279,3,5,0
39749,1,3,139275,139279,139282,4,7,0
39750,5,3,139280,139282,139285,2,5,0
39751,6,2,139286,139286,139288,0,2,1
39752,4,2,139290,139290,139292,0,2,2
39753,2,2,139292,139292,139294,0,2,0
39754,2,3,139294,139294,139297,0,3,0
39755,1,3,139295,139297,139300,2,5,0
39756,4,3,139299,139300,139303,1,4,0
39757,1,1,139300,139303,139304,3,4,0
39758,4,3,139304,139304,139307,0,3,0
39759,4,3,139308,139308,139311,0,3,1
39760,5,2,139313,139313,139315,0,2,2
39761,5,1,139318,139318,139319,0,1,3
39762,2,1,139320,139320,139321,0,1,1
39763,6,1,139326,139326,139327,0,1,5
39764,1,3,139327,139327,139330,0,3,0
39765,6,2,139333,139333,139335,0,2,3
39766,1,3,139334,139335,139338,1,4,0
39767,6,2,139340,139340,139342,0,2,2
39768,1,1,139341,139342,139343,1,2,0
39769,1,3,139342,139343,139346,1,4,0
39770,1,3,139343,139346,139349,3,6,0
39771,5,3,139348,139349,139352,1,4,0
39772,3,1,139351,139352,139353,1,2,0
39773,4,3,139355,139355,139358,0,3,2
39774,6,2,139361,139361,139363,0,2,3
39775,3,2,139364,139364,139366,0,2,1
39776,1,3,139365,139366,139369,1,4,0
39777,4,3,139369,139369,139372,0,3,0
39778,1,2,139370,139372,139374,2,4,0
39779,1,3,139371,139374,139377,3,6,0
39780,1,1,139372,139377,139378,5,6,0
39781,2,3,139374,139378,139381,4,7,0
39782,6,2,139380,139381,139383,1,3,0
39783,3,2,139383,139383,139385,0,2,0
39784,2,1,139385,139385,139386,0,1,0
39785,6,1,139391,139391,139392,0,1,5
39786,5,1,139396,139396,139397,0,1,4
39787,4,2,139400,139400,139402,0,2,3
39788,3,3,139403,139403,139406,0,3,1
39789,4,2,139407,139407,139409,0,2,1
39790,3,2,139410,139410,139412,0,2,1
39791,6,1,139416,139416,139417,0,1,4
39792,2,2,139418,139418,139420,0,2,1
39793,1,3,139419,139420,139423,1,4,0
39794,3,2,139422,139423,139425,1,3,0
39795,6,3,139428,139428,139431,0,3,3
39796,2,1,139430,139431,139432,1,2,0
39797,2,3,139432,139432,139435,0,3,0
39798,5,3,139437,139437,139440,0,3,2
39799,2,2,139439,139440,139442,1,3,0
39800,2,1,139441,139442,139443,1,2,0
39801,4,3,139445,139445,139448,0,3,2
39802,6,2,139451,139451,139453,0,2,3
39803,2,2,139453,139453,139455,0,2,0
39804,3,3,139456,139456,139459,0,3,1
39805,1,1,139457,139459,139460,2,3,0
39806,6,3,139463,139463,139466,0,3,3
39807,6,2,139469,139469,139471,0,2,3
39808,1,1,139470,139471,139472,1,2,0
39809,4,1,139474,139474,139475,0,1,2
39810,4,1,139478,139478,139479,0,1,3
39811,4,2,139482,139482,139484,0,2,3
39812,2,3,139484,139484,139487,0,3,0
39813,1,2,139485,139487,139489,2,4,0
39814,3,1,139488,139489,139490,1,2,0
39815,1,1,139489,139490,139491,1,2,0
39816,5,2,139494,139494,139496,0,2,3
39817,1,3,139495,139496,139499,1,4,0
39818,5,2,139500,139500,139502,0,2,1
39819,6,2,139506,139506,139508,0,2,4
39820,6,2,139512,139512,139514,0,2,4
39821,1,1,139513,139514,139515,1,2,0
39822,3,1,139516,139516,139517,0,1,1
39823,4,3,139520,139520,139523,0,3,3
39824,2,3,139522,139523,139526,1,4,0
39825,6,2,139528,139528,139530,0,2,2
39826,5,3,139533,139533,139536,0,3,3
39827,4,3,139537,139537,139540,0,3,1
39828,2,3,139539,139540,139543,1,4,0
39829,3,3,139542,139543,139546,1,4,0
39830,1,1,139543,139546,139547,3,4,0
39831,4,2,139547,139547,139549,0,2,0
39832,1,1,139548,139549,139550,1,2,0
39833,3,3,139551,139551,139554,0,3,1
39834,4,1,139555,139555,139556,0,1,1
39835,3,3,139558,139558,139561,0,3,2
39836,5,2,139563,139563,139565,0,2,2
39837,4,2,139567,139567,139569,0,2,2
39838,3,1,139570,139570,139571,0,1,1
39839,5,1,139575,139575,139576,0,1,4
39840,1,1,139576,139576,139577,0,1,0
39841,4,2,139580,139580,139582,0,2,3
39842,1,1,139581,139582,139583,1,2,0
39843,4,2,139585,139585,139587,0,2,2
39844,5,1,139590,139590,139591,0,1,3
39845,5,1,139595,139595,139596,0,1,4
39846,5,3,139600,139600,139603,0,3,4
39847,6,1,139606,139606,139607,0,1,3
39848,3,3,139609,139609,139612,0,3,2
39849,5,3,139614,139614,139617,0,3,2
39850,2,3,139616,139617,139620,1,4,0
39851,2,1,139618,139620,139621,2,3,0
39852,6,1,139624,139624,139625,0,1,3
39853,6,1,139630,139630,139631,0,1,5
39854,1,3,139631,139631,139634,0,3,0
39855,2,2,139633,139634,139636,1,3,0
39856,5,2,139638,139638,139640,0,2,2
39857,3,1,139641,139641,139642,0,1,1
39858,6,2,139647,139647,139649,0,2,5
39859,2,3,139649,139649,139652,0,3,0
39860,6,1,139655,139655,139656,0,1,3
39861,4,2,139659,139659,139661,0,2,3
39862,6,2,139665,139665,139667,0,2,4
39863,5,1,139670,139670,139671,0,1,3
39864,4,3,139674,139674,139677,0,3,3
39865,4,3,139678,139678,139681,0,3,1
39866,3,1,139681,139681,139682,0,1,0
39867,3,1,139684,139684,139685,0,1,2
39868,2,3,139686,139686,139689,0,3,1
39869,2,1,139688,139689,139690,1,2,0
39870,6,2,139694,139694,139696,0,2,4
39871,5,3,139699,139699,139702,0,3,3
39872,4,2,139703,139703,139705,0,2,1
39873,4,3,139707,139707,139710,0,3,2
39874,5,1,139712,139712,139713,0,1,2
39875,1,2,139713,139713,139715,0,2,0
39876,2,1,139715,139715,139716,0,1,0
39877,5,3,139720,139720,139723,0,3,4
39878,5,2,139725,139725,139727,0,2,2
39879,4,1,139729,139729,139730,0,1,2
39880,3,1,139732,139732,139733,0,1,2
39881,4,1,139736,139736,139737,0,1,3
39882,3,1,139739,139739,139740,0,1,2
39883,4,3,139743,139743,139746,0,3,3
39884,5,2,139748,139748,139750,0,2,2
39885,4,3,139752,139752,139755,0,3,2
39886,2,1,139754,139755,139756,1,2,0
39887,5,2,139759,139759,139761,0,2,3
39888,2,2,139761,139761,139763,0,2,0
39889,4,2,139765,139765,139767,0,2,2
39890,2,1,139767,139767,139768,0,1,0
39891,5,2,139772,139772,139774,0,2,4
39892,4,1,139776,139776,139777,0,1,2
39893,2,1,139778,139778,139779,0,1,1
39894,5,1,139783,139783,139784,0,1,4
39895,2,2,139785,139785,139787,0,2,1
39896,3,1,139788,139788,139789,0,1,1
39897,5,3,139793,139793,139796,0,3,4
39898,3,3,139796,139796,139799,0,3,0
39899,4,3,139800,139800,139803,0,3,1
39900,4,3,139804,139804,139807,0,3,1
39901,2,1,139806,139807,139808,1,2,0
39902,5,3,139811,139811,139814,0,3,3
39903,1,1,139812,139814,139815,2,3,0
39904,3,2,139815,139815,139817,0,2,0
39905,3,2,139818,139818,139820,0,2,1
39906,2,2,139820,139820,139822,0,2,0
39907,4,1,139824,139824,139825,0,1,2
39908,4,3,139828,139828,139831,0,3,3
39909,1,3,139829,139831,139834,2,5,0
39910,5,1,139834,139834,139835,0,1,0
39911,1,2,139835,139835,139837,0,2,0
39912,2,2,139837,139837,139839,0,2,0
39913,1,1,139838,139839,139840,1,2,0
39914,3,2,139841,139841,139843,0,2,1
39915,2,2,139843,139843,139845,0,2,0
39916,2,3,139845,139845,139848,0,3,0
39917,4,2,139849,139849,139851,0,2,1
39918,1,1,139850,139851,139852,1,2,0
39919,4,2,139854,139854,139856,0,2,2
39920,5,2,139859,139859,139861,0,2,3
39921,3,1,139862,139862,139863,0,1,1
39922,3,3,139865,139865,139868,0,3,2
39923,6,2,139871,139871,139873,0,2,3
39924,5,3,139876,139876,139879,0,3,3
39925,3,2,139879,139879,139881,0,2,0
39926,5,3,139884,139884,139887,0,3,3
39927,2,3,139886,139887,139890,1,4,0
39928,3,1,139889,139890,139891,1,2,0
39929,5,1,139894,139894,139895,0,1,3
39930,4,3,139898,139898,139901,0,3,3
39931,1,3,139899,139901,139904,2,5,0
39932,1,1,139900,139904,139905,4,5,0
39933,6,2,139906,139906,139908,0,2,1
39934,3,2,139909,139909,139911,0,2,1
39935,2,3,139911,139911,139914,0,3,0
39936,2,3,139913,139914,139917,1,4,0
39937,3,2,139916,139917,139919,1,3,0
39938,3,2,139919,139919,139921,0,2,0
39939,6,1,139925,139925,139926,0,1,4
39940,5,3,139930,139930,139933,0,3,4
39941,5,3,139935,139935,139938,0,3,2
39942,6,3,139941,139941,139944,0,3,3
39943,4,1,139945,139945,139946,0,1,1
39944,3,1,139948,139948,139949,0,1,2
39945,4,3,139952,139952,139955,0,3,3
39946,1,2,139953,139955,139957,2,4,0
39947,6,3,139959,139959,139962,0,3,2
39948,5,1,139964,139964,139965,0,1,2
39949,5,2,139969,139969,139971,0,2,4
39950,2,3,139971,139971,139974,0,3,0
39951,1,2,139972,139974,139976,2,4,0
39952,1,3,139973,139976,139979,3,6,0
39953,1,2,139974,139979,139981,5,7,0
39954,1,1,139975,139981,139982,6,7,0
39955,2,2,139977,139982,139984,5,7,0
39956,6,3,139983,139984,139987,1,4,0
39957,1,2,139984,139987,139989,3,5,0
39958,5,1,139989,139989,139990,0,1,0
39959,4,3,139993,139993,139996,0,3,3
39960,4,1,139997,139997,139998,0,1,1
39961,6,3,140003,140003,140006,0,3,5
39962,1,2,140004,140006,140008,2,4,0
39963,1,2,140005,140008,140010,3,5,0
39964,1,2,140006,140010,140012,4,6,0
39965,4,3,140010,140012,140015,2,5,0
39966,6,2,140016,140016,140018,0,2,1
39967,4,2,140020,140020,140022,0,2,2
39968,3,1,140023,140023,140024,0,1,1
39969,5,1,140028,140028,140029,0,1,4
39970,2,3,140030,140030,140033,0,3,1
39971,4,2,140034,140034,140036,0,2,1
39972,3,2,140037,140037,140039,0,2,1
39973,1,3,140038,140039,140042,1,4,0
39974,1,1,140039,140042,140043,3,4,0
39975,1,1,140040,140043,140044,3,4,0
39976,5,2,140045,140045,140047,0,2,1
39977,6,3,140051,140051,140054,0,3,4
39978,6,1,140057,140057,140058,0,1,3
39979,6,2,140063,140063,140065,0,2,5
39980,5,1,140068,140068,140069,0,1,3
39981,2,2,140070,140070,140072,0,2,1
39982,6,3,140076,140076,140079,0,3,4
39983,4,3,140080,140080,140083,0,3,1
39984,6,2,140086,140086,140088,0,2,3
39985,2,2,140088,140088,140090,0,2,0
39986,6,3,140094,140094,140097,0,3,4
39987,2,1,140096,140097,140098,1,2,0
39988,3,1,140099,140099,140100,0,1,1
39989,5,1,140104,140104,140105,0,1,4
39990,2,1,140106,140106,140107,0,1,1
39991,2,1,140108,140108,140109,0,1,1
39992,6,3,140114,140114,140117,0,3,5
39993,2,2,140116,140117,140119,1,3,0
39994,1,2,140117,140119,140121,2,4,0
39995,5,2,140122,140122,140124,0,2,1
39996,3,2,140125,140125,140127,0,2,1
39997,6,2,140131,140131,140133,0,2,4
39998,4,3,140135,140135,140138,0,3,2
39999,1,2,140136,140138,140140,2,4,0
40000,3,1,140139,140140,140141,1,2,0
40001,6,3,140145,140145,140148,0,3,4
40002,2,1,140147,140148,140149,1,2,0
40003,5,2,140152,140152,140154,0,2,3
40004,5,1,140157,140157,140158,0,1,3
40005,4,3,140161,140161,140164,0,3,3
40006,1,1,140162,140164,140165,2,3,0
40007,4,1,140166,140166,140167,0,1,1
40008,5,1,140171,140171,140172,0,1,4
40009,2,3,140173,140173,140176,0,3,1
40010,3,3,140176,140176,140179,0,3,0
40011,3,2,140179,140179,140181,0,2,0
40012,2,2,140181,140181,140183,0,2,0
40013,1,1,140182,140183,140184,1,2,0
40014,1,2,140183,140184,140186,1,3,0
40015,6,2,140189,140189,140191,0,2,3
40016,5,3,140194,140194,140197,0,3,3
40017,1,3,140195,140197,140200,2,5,0
40018,3,3,140198,140200,140203,2,5,0
40019,2,2,140200,140203,140205,3,5,0
40020,1,2,140201,140205,140207,4,6,0
40021,6,3,140207,140207,140210,0,3,0
40022,3,1,140210,140210,140211,0,1,0
40023,2,2,140212,140212,140214,0,2,1
40024,2,3,140214,140214,140217,0,3,0
40025,4,2,140218,140218,140220,0,2,1
40026,3,3,140221,140221,140224,0,3,1
40027,4,1,140225,140225,140226,0,1,1
40028,3,2,140228,140228,140230,0,2,2
40029,5,1,140233,140233,140234,0,1,3
40030,4,2,140237,140237,140239,0,2,3
40031,5,1,140242,140242,140243,0,1,3
40032,2,3,140244,140244,140247,0,3,1
40033,1,1,140245,140247,140248,2,3,0
40034,2,2,140247,140248,140250,1,3,0
40035,2,2,140249,140250,140252,1,3,0
40036,2,1,140251,140252,140253,1,2,0
40037,5,3,140256,140256,140259,0,3,3
40038,6,1,140262,140262,140263,0,1,3
40039,4,2,140266,140266,140268,0,2,3
40040,4,3,140270,140270,140273,0,3,2
40041,4,1,140274,140274,140275,0,1,1
40042,2,2,140276,140276,140278,0,2,1
40043,2,2,140278,140278,140280,0,2,0
40044,3,1,140281,140281,140282,0,1,1
40045,2,2,140283,140283,140285,0,2,1
40046,2,1,140285,140285,140286,0,1,0
40047,2,3,140287,140287,140290,0,3,1
40048,4,1,140291,140291,140292,0,1,1
40049,4,1,140295,140295,140296,0,1,3
40050,6,3,140301,140301,140304,0,3,5
40051,3,1,140304,140304,140305,0,1,0
40052,6,1,140310,140310,140311,0,1,5
40053,4,1,140314,140314,140315,0,1,3
40054,3,1,140317,140317,140318,0,1,2
40055,6,2,140323,140323,140325,0,2,5
40056,5,1,140328,140328,140329,0,1,3
40057,5,1,140333,140333,140334,0,1,4
40058,1,2,140334,140334,140336,0,2,0
40059,3,2,140337,140337,140339,0,2,1
40060,2,3,140339,140339,140342,0,3,0
40061,5,1,140344,140344,140345,0,1,2
40062,2,2,140346,140346,140348,0,2,1
40063,1,2,140347,140348,140350,1,3,0
40064,2,2,140349,140350,140352,1,3,0
40065,5,2,140354,140354,140356,0,2,2
40066,6,2,140360,140360,140362,0,2,4
40067,5,3,140365,140365,140368,0,3,3
40068,2,2,140367,140368,140370,1,3,0
40069,5,2,140372,140372,140374,0,2,2
40070,1,1,140373,140374,140375,1,2,0
40071,5,1,140378,140378,140379,0,1,3
40072,2,3,140380,140380,140383,0,3,1
40073,6,3,140386,140386,140389,0,3,3
40074,2,3,140388,140389,140392,1,4,0
40075,3,3,140391,140392,140395,1,4,0
40076,1,3,140392,140395,140398,3,6,0
40077,3,2,140395,140398,140400,3,5,0
40078,4,3,140399,140400,140403,1,4,0
40079,4,1,140403,140403,140404,0,1,0
40080,1,3,140404,140404,140407,0,3,0
40081,1,3,140405,140407,140410,2,5,0
40082,4,1,140409,140410,140411,1,2,0
40083,2,3,140411,140411,140414,0,3,0
40084,6,3,140417,140417,140420,0,3,3
40085,6,2,140423,140423,140425,0,2,3
40086,6,3,140429,140429,140432,0,3,4
40087,4,1,140433,140433,140434,0,1,1
40088,6,2,140439,140439,140441,0,2,5
40089,6,2,140445,140445,140447,0,2,4
40090,6,3,140451,140451,140454,0,3,4
40091,5,2,140456,140456,140458,0,2,2
40092,2,2,140458,140458,140460,0,2,0
40093,2,3,140460,140460,140463,0,3,0
40094,6,2,140466,140466,140468,0,2,3
40095,2,3,140468,140468,140471,0,3,0
40096,2,1,140470,140471,140472,1,2,0
40097,1,3,140471,140472,140475,1,4,0
40098,2,3,140473,140475,140478,2,5,0
40099,1,2,140474,140478,140480,4,6,0
40100,2,3,140476,140480,140483,4,7,0
40101,4,1,140480,140483,140484,3,4,0
40102,3,2,140483,140484,140486,1,3,0
40103,6,3,140489,140489,140492,0,3,3
40104,4,2,140493,140493,140495,0,2,1
40105,6,2,140499,140499,140501,0,2,4
40106,6,1,140505,140505,140506,0,1,4
40107,5,2,140510,140510,140512,0,2,4
40108,3,2,140513,140513,140515,0,2,1
40109,2,2,140515,140515,140517,0,2,0
40110,2,3,140517,140517,140520,0,3,0
40111,4,3,140521,140521,140524,0,3,1
40112,6,1,140527,140527,140528,0,1,3
40113,1,2,140528,140528,140530,0,2,0
40114,2,3,140530,140530,140533,0,3,0
40115,6,3,140536,140536,140539,0,3,3
40116,1,1,140537,140539,140540,2,3,0
40117,5,1,140542,140542,140543,0,1,2
40118,2,1,140544,140544,140545,0,1,1
40119,5,1,140549,140549,140550,0,1,4
40120,2,1,140551,140551,140552,0,1,1
40121,5,3,140556,140556,140559,0,3,4
40122,3,2,140559,140559,140561,0,2,0
40123,5,2,140564,140564,140566,0,2,3
40124,6,3,140570,140570,140573,0,3,4
40125,3,1,140573,140573,140574,0,1,0
40126,4,2,140577,140577,140579,0,2,3
40127,1,3,140578,140579,140582,1,4,0
40128,5,2,140583,140583,140585,0,2,1
40129,4,3,140587,140587,140590,0,3,2
40130,1,3,140588,140590,140593,2,5,0
40131,1,2,140589,140593,140595,4,6,0
40132,3,1,140592,140595,140596,3,4,0
40133,5,3,140597,140597,140600,0,3,1
40134,1,1,140598,140600,140601,2,3,0
40135,3,2,140601,140601,140603,0,2,0
40136,6,3,140607,140607,140610,0,3,4
40137,1,3,140608,140610,140613,2,5,0
40138,6,3,140614,140614,140617,0,3,1
40139,2,1,140616,140617,140618,1,2,0
40140,6,3,140622,140622,140625,0,3,4
40141,4,1,140626,140626,140627,0,1,1
40142,2,2,140628,140628,140630,0,2,1
40143,4,3,140632,140632,140635,0,3,2
40144,3,2,140635,140635,140637,0,2,0
40145,1,3,140636,140637,140640,1,4,0
40146,1,2,140637,140640,140642,3,5,0
40147,4,2,140641,140642,140644,1,3,0
40148,2,2,140643,140644,140646,1,3,0
40149,4,1,140647,140647,140648,0,1,1
40150,3,1,140650,140650,140651,0,1,2
40151,2,1,140652,140652,140653,0,1,1
40152,2,1,140654,140654,140655,0,1,1
40153,3,2,140657,140657,140659,0,2,2
40154,4,3,140661,140661,140664,0,3,2
40155,5,1,140666,140666,140667,0,1,2
40156,6,2,140672,140672,140674,0,2,5
40157,1,3,140673,140674,140677,1,4,0
40158,5,2,140678,140678,140680,0,2,1
40159,2,1,140680,140680,140681,0,1,0
40160,5,1,140685,140685,140686,0,1,4
40161,1,2,140686,140686,140688,0,2,0
40162,1,3,140687,140688,140691,1,4,0
40163,2,1,140689,140691,140692,2,3,0
40164,2,3,140691,140692,140695,1,4,0
40165,6,2,140697,140697,140699,0,2,2
40166,6,3,140703,140703,140706,0,3,4
40167,4,1,140707,140707,140708,0,1,1
40168,4,1,140711,140711,140712,0,1,3
40169,4,2,140715,140715,140717,0,2,3
40170,3,1,140718,140718,140719,0,1,1
40171,4,3,140722,140722,140725,0,3,3
40172,6,2,140728,140728,140730,0,2,3
40173,3,2,140731,140731,140733,0,2,1
40174,5,3,140736,140736,140739,0,3,3
40175,4,3,140740,140740,140743,0,3,1
40176,4,2,140744,140744,140746,0,2,1
40177,5,1,140749,140749,140750,0,1,3
40178,4,2,140753,140753,140755,0,2,3
40179,4,3,140757,140757,140760,0,3,2
40180,6,1,140763,140763,140764,0,1,3
40181,1,1,140764,140764,140765,0,1,0
40182,5,2,140769,140769,140771,0,2,4
40183,2,1,140771,140771,140772,0,1,0
40184,6,1,140777,140777,140778,0,1,5
40185,3,3,140780,140780,140783,0,3,2
40186,1,1,140781,140783,140784,2,3,0
40187,3,1,140784,140784,140785,0,1,0
40188,4,2,140788,140788,140790,0,2,3
40189,1,3,140789,140790,140793,1,4,0
40190,1,3,140790,140793,140796,3,6,0
40191,5,2,140795,140796,140798,1,3,0
40192,4,2,140799,140799,140801,0,2,1
40193,3,1,140802,140802,140803,0,1,1
40194,6,3,140808,140808,140811,0,3,5
40195,1,2,140809,140811,140813,2,4,0
40196,2,3,140811,140813,140816,2,5,0
40197,5,3,140816,140816,140819,0,3,0
40198,2,2,140818,140819,140821,1,3,0
40199,6,2,140824,140824,140826,0,2,3
40200,2,3,140826,140826,140829,0,3,0
40201,3,2,140829,140829,140831,0,2,0
40202,5,1,140834,140834,140835,0,1,3
40203,1,3,140835,140835,140838,0,3,0
40204,4,1,140839,140839,140840,0,1,1
40205,4,2,140843,140843,140845,0,2,3
40206,2,1,140845,140845,140846,0,1,0
40207,5,2,140850,140850,140852,0,2,4
40208,5,2,140855,140855,140857,0,2,3
40209,1,1,140856,140857,140858,1,2,0
40210,5,1,140861,140861,140862,0,1,3
40211,5,2,140866,140866,140868,0,2,4
40212,2,3,140868,140868,140871,0,3,0
40213,2,1,140870,140871,140872,1,2,0
40214,5,1,140875,140875,140876,0,1,3
40215,2,2,140877,140877,140879,0,2,1
40216,2,3,140879,140879,140882,0,3,0
40217,6,2,140885,140885,140887,0,2,3
40218,1,3,140886,140887,140890,1,4,0
40219,3,2,140889,140890,140892,1,3,0
40220,3,1,140892,140892,140893,0,1,0
40221,3,1,140895,140895,140896,0,1,2
40222,3,3,140898,140898,140901,0,3,2
40223,6,1,140904,140904,140905,0,1,3
40224,1,1,140905,140905,140906,0,1,0
40225,6,1,140911,140911,140912,0,1,5
40226,5,1,140916,140916,140917,0,1,4
40227,6,1,140922,140922,140923,0,1,5
40228,5,2,140927,140927,140929,0,2,4
40229,2,1,140929,140929,140930,0,1,0
40230,5,2,140934,140934,140936,0,2,4
40231,1,2,140935,140936,140938,1,3,0
40232,2,3,140937,140938,140941,1,4,0
40233,4,3,140941,140941,140944,0,3,0
40234,6,2,140947,140947,140949,0,2,3
40235,2,3,140949,140949,140952,0,3,0
40236,5,3,140954,140954,140957,0,3,2
40237,1,3,140955,140957,140960,2,5,0
40238,6,3,140961,140961,140964,0,3,1
40239,1,3,140962,140964,140967,2,5,0
40240,1,1,140963,140967,140968,4,5,0
40241,4,2,140967,140968,140970,1,3,0
40242,6,2,140973,140973,140975,0,2,3
40243,6,3,140979,140979,140982,0,3,4
40244,5,1,140984,140984,140985,0,1,2
40245,4,2,140988,140988,140990,0,2,3
40246,2,3,140990,140990,140993,0,3,0
40247,4,2,140994,140994,140996,0,2,1
40248,5,2,140999,140999,141001,0,2,3
40249,6,2,141005,141005,141007,0,2,4
40250,3,3,141008,141008,141011,0,3,1
40251,1,2,141009,141011,141013,2,4,0
40252,6,3,141015,141015,141018,0,3,2
40253,3,1,141018,141018,141019,0,1,0
40254,5,2,141023,141023,141025,0,2,4
40255,1,2,141024,141025,141027,1,3,0
40256,6,3,141030,141030,141033,0,3,3
40257,4,1,141034,141034,141035,0,1,1
40258,2,1,141036,141036,141037,0,1,1
40259,3,2,141039,141039,141041,0,2,2
40260,6,3,141045,141045,141048,0,3,4
40261,3,1,141048,141048,141049,0,1,0
40262,4,1,141052,141052,141053,0,1,3
40263,2,1,141054,141054,141055,0,1,1
40264,6,1,141060,141060,141061,0,1,5
40265,2,3,141062,141062,141065,0,3,1
40266,4,2,141066,141066,141068,0,2,1
40267,2,1,141068,141068,141069,0,1,0
40268,4,3,141072,141072,141075,0,3,3
40269,5,2,141077,141077,141079,0,2,2
40270,3,3,141080,141080,141083,0,3,1
40271,2,2,141082,141083,141085,1,3,0
40272,2,1,141084,141085,141086,1,2,0
40273,1,2,141085,141086,141088,1,3,0
40274,5,3,141090,141090,141093,0,3,2
40275,2,1,141092,141093,141094,1,2,0
40276,6,1,141098,141098,141099,0,1,4
40277,3,1,141101,141101,141102,0,1,2
40278,4,3,141105,141105,141108,0,3,3
40279,4,3,141109,141109,141112,0,3,1
40280,4,2,141113,141113,141115,0,2,1
40281,2,1,141115,141115,141116,0,1,0
40282,6,1,141121,141121,141122,0,1,5
40283,1,1,141122,141122,141123,0,1,0
40284,5,3,141127,141127,141130,0,3,4
40285,1,2,141128,141130,141132,2,4,0
40286,3,2,141131,141132,141134,1,3,0
40287,4,1,141135,141135,141136,0,1,1
40288,1,2,141136,141136,141138,0,2,0
40289,2,2,141138,141138,141140,0,2,0
40290,1,3,141139,141140,141143,1,4,0
40291,3,3,141142,141143,141146,1,4,0
40292,2,3,141144,141146,141149,2,5,0
40293,4,1,141148,141149,141150,1,2,0
40294,3,3,141151,141151,141154,0,3,1
40295,1,3,141152,141154,141157,2,5,0
40296,6,3,141158,141158,141161,0,3,1
40297,4,3,141162,141162,141165,0,3,1
40298,6,1,141168,141168,141169,0,1,3
40299,2,1,141170,141170,141171,0,1,1
40300,4,3,141174,141174,141177,0,3,3
40301,5,2,141179,141179,141181,0,2,2
40302,5,1,141184,141184,141185,0,1,3
40303,2,2,141186,141186,141188,0,2,1
40304,4,3,141190,141190,141193,0,3,2
40305,4,3,141194,141194,141197,0,3,1
40306,5,2,141199,141199,141201,0,2,2
40307,3,2,141202,141202,141204,0,2,1
40308,6,3,141208,141208,141211,0,3,4
40309,2,2,141210,141211,141213,1,3,0
40310,6,1,141216,141216,141217,0,1,3
40311,5,2,141221,141221,141223,0,2,4
40312,3,2,141224,141224,141226,0,2,1
40313,3,1,141227,141227,141228,0,1,1
40314,5,3,141232,141232,141235,0,3,4
40315,4,3,141236,141236,141239,0,3,1
40316,5,3,141241,141241,141244,0,3,2
40317,5,1,141246,141246,141247,0,1,2
40318,3,1,141249,141249,141250,0,1,2
40319,1,3,141250,141250,141253,0,3,0
40320,4,3,141254,141254,141257,0,3,1
40321,3,2,141257,141257,141259,0,2,0
40322,1,3,141258,141259,141262,1,4,0
40323,2,2,141260,141262,141264,2,4,0
40324,4,3,141264,141264,141267,0,3,0
40325,3,3,141267,141267,141270,0,3,0
40326,3,2,141270,141270,141272,0,2,0
40327,1,1,141271,141272,141273,1,2,0
40328,4,1,141275,141275,141276,0,1,2
40329,4,1,141279,141279,141280,0,1,3
40330,5,2,141284,141284,141286,0,2,4
40331,1,3,141285,141286,141289,1,4,0
40332,2,1,141287,141289,141290,2,3,0
40333,2,2,141289,141290,141292,1,3,0
40334,4,2,141293,141293,141295,0,2,1
40335,2,2,141295,141295,141297,0,2,0
40336,5,2,141300,141300,141302,0,2,3
40337,4,3,141304,141304,141307,0,3,2
40338,4,3,141308,141308,141311,0,3,1
40339,6,2,141314,141314,141316,0,2,3
40340,2,1,141316,141316,141317,0,1,0
40341,1,2,141317,141317,141319,0,2,0
40342,6,1,141323,141323,141324,0,1,4
40343,6,1,141329,141329,141330,0,1,5
40344,3,1,141332,141332,141333,0,1,2
40345,2,1,141334,141334,141335,0,1,1
40346,1,1,141335,141335,141336,0,1,0
40347,5,1,141340,141340,141341,0,1,4
40348,1,1,141341,141341,141342,0,1,0
40349,3,1,141344,141344,141345,0,1,2
40350,5,1,141349,141349,141350,0,1,4
40351,2,3,141351,141351,141354,0,3,1
40352,5,1,141356,141356,141357,0,1,2
40353,2,1,141358,141358,141359,0,1,1
40354,3,3,141361,141361,141364,0,3,2
40355,5,1,141366,141366,141367,0,1,2
40356,5,3,141371,141371,141374,0,3,4
40357,2,3,141373,141374,141377,1,4,0
40358,3,2,141376,141377,141379,1,3,0
40359,1,1,141377,141379,141380,2,3,0
40360,3,3,141380,141380,141383,0,3,0
40361,4,2,141384,141384,141386,0,2,1
40362,5,1,141389,141389,141390,0,1,3
40363,4,3,141393,141393,141396,0,3,3
40364,5,3,141398,141398,141401,0,3,2
40365,5,3,141403,141403,141406,0,3,2
40366,3,3,141406,141406,141409,0,3,0
40367,1,1,141407,141409,141410,2,3,0
40368,1,1,141408,141410,141411,2,3,0
40369,3,1,141411,141411,141412,0,1,0
40370,1,2,141412,141412,141414,0,2,0
40371,3,3,141415,141415,141418,0,3,1
40372,6,2,141421,141421,141423,0,2,3
40373,3,1,141424,141424,141425,0,1,1
40374,4,3,141428,141428,141431,0,3,3
40375,3,1,141431,141431,141432,0,1,0
40376,4,1,141435,141435,141436,0,1,3
40377,1,1,141436,141436,141437,0,1,0
40378,5,3,141441,141441,141444,0,3,4
40379,3,2,141444,141444,141446,0,2,0
40380,2,2,141446,141446,141448,0,2,0
40381,5,3,141451,141451,141454,0,3,3
40382,6,3,141457,141457,141460,0,3,3
40383,1,3,141458,141460,141463,2,5,0
40384,2,2,141460,141463,141465,3,5,0
40385,5,2,141465,141465,141467,0,2,0
40386,4,3,141469,141469,141472,0,3,2
40387,2,1,141471,141472,141473,1,2,0
40388,6,2,141477,141477,141479,0,2,4
40389,5,3,141482,141482,141485,0,3,3
40390,5,1,141487,141487,141488,0,1,2
40391,4,2,141491,141491,141493,0,2,3
40392,2,2,141493,141493,141495,0,2,0
40393,1,1,141494,141495,141496,1,2,0
40394,5,1,141499,141499,141500,0,1,3
40395,5,1,141504,141504,141505,0,1,4
40396,4,1,141508,141508,141509,0,1,3
40397,1,3,141509,141509,141512,0,3,0
40398,2,1,141511,141512,141513,1,2,0
40399,1,2,141512,141513,141515,1,3,0
40400,3,2,141515,141515,141517,0,2,0
40401,4,3,141519,141519,141522,0,3,2
40402,6,1,141525,141525,141526,0,1,3
40403,6,2,141531,141531,141533,0,2,5
40404,6,2,141537,141537,141539,0,2,4
40405,5,1,141542,141542,141543,0,1,3
40406,5,2,141547,141547,141549,0,2,4
40407,4,3,141551,141551,141554,0,3,2
40408,1,1,141552,141554,141555,2,3,0
40409,2,2,141554,141555,141557,1,3,0
40410,3,3,141557,141557,141560,0,3,0
40411,5,3,141562,141562,141565,0,3,2
40412,2,2,141564,141565,141567,1,3,0
40413,5,3,141569,141569,141572,0,3,2
40414,5,3,141574,141574,141577,0,3,2
40415,4,1,141578,141578,141579,0,1,1
40416,5,2,141583,141583,141585,0,2,4
40417,3,1,141586,141586,141587,0,1,1
40418,1,2,141587,141587,141589,0,2,0
40419,3,3,141590,141590,141593,0,3,1
40420,4,3,141594,141594,141597,0,3,1
40421,1,3,141595,141597,141600,2,5,0
40422,3,3,141598,141600,141603,2,5,0
40423,3,2,141601,141603,141605,2,4,0
40424,3,3,141604,141605,141608,1,4,0
40425,3,1,141607,141608,141609,1,2,0
40426,4,2,141611,141611,141613,0,2,2
40427,5,3,141616,141616,141619,0,3,3
40428,1,3,141617,141619,141622,2,5,0
40429,5,1,141622,141622,141623,0,1,0
40430,5,3,141627,141627,141630,0,3,4
40431,1,1,141628,141630,141631,2,3,0
40432,1,2,141629,141631,141633,2,4,0
40433,1,1,141630,141633,141634,3,4,0
40434,1,1,141631,141634,141635,3,4,0
40435,4,3,141635,141635,141638,0,3,0
40436,6,2,141641,141641,141643,0,2,3
40437,6,1,141647,141647,141648,0,1,4
40438,1,1,141648,141648,141649,0,1,0
40439,6,3,141654,141654,141657,0,3,5
40440,6,3,141660,141660,141663,0,3,3
40441,6,3,141666,141666,141669,0,3,3
40442,1,1,141667,141669,141670,2,3,0
40443,1,1,141668,141670,141671,2,3,0
40444,3,3,141671,141671,141674,0,3,0
40445,2,2,141673,141674,141676,1,3,0
40446,2,3,141675,141676,141679,1,4,0
40447,2,1,141677,141679,141680,2,3,0
40448,4,2,141681,141681,141683,0,2,1
40449,6,2,141687,141687,141689,0,2,4
40450,1,2,141688,141689,141691,1,3,0
40451,5,2,141693,141693,141695,0,2,2
40452,3,2,141696,141696,141698,0,2,1
40453,6,1,141702,141702,141703,0,1,4
40454,3,3,141705,141705,141708,0,3,2
40455,4,3,141709,141709,141712,0,3,1
40456,6,2,141715,141715,141717,0,2,3
40457,2,3,141717,141717,141720,0,3,0
40458,5,3,141722,141722,141725,0,3,2
40459,1,2,141723,141725,141727,2,4,0
40460,4,3,141727,141727,141730,0,3,0
40461,2,2,141729,141730,141732,1,3,0
40462,4,2,141733,141733,141735,0,2,1
40463,3,2,141736,141736,141738,0,2,1
40464,5,3,141741,141741,141744,0,3,3
40465,1,1,141742,141744,141745,2,3,0
40466,5,3,141747,141747,141750,0,3,2
40467,5,2,141752,141752,141754,0,2,2
40468,3,3,141755,141755,141758,0,3,1
40469,6,1,141761,141761,141762,0,1,3
40470,1,2,141762,141762,141764,0,2,0
40471,2,2,141764,141764,141766,0,2,0
40472,5,3,141769,141769,141772,0,3,3
40473,3,1,141772,141772,141773,0,1,0
40474,6,1,141778,141778,141779,0,1,5
40475,4,1,141782,141782,141783,0,1,3
40476,1,2,141783,141783,141785,0,2,0
40477,4,3,141787,141787,141790,0,3,2
40478,1,1,141788,141790,141791,2,3,0
40479,6,3,141794,141794,141797,0,3,3
40480,5,2,141799,141799,141801,0,2,2
40481,2,1,141801,141801,141802,0,1,0
40482,5,3,141806,141806,141809,0,3,4
40483,1,3,141807,141809,141812,2,5,0
40484,1,2,141808,141812,141814,4,6,0
40485,3,2,141811,141814,141816,3,5,0
40486,1,2,141812,141816,141818,4,6,0
40487,4,1,141816,141818,141819,2,3,0
40488,1,1,141817,141819,141820,2,3,0
40489,5,1,141822,141822,141823,0,1,2
40490,5,3,141827,141827,141830,0,3,4
40491,4,3,141831,141831,141834,0,3,1
40492,6,3,141837,141837,141840,0,3,3
40493,6,3,141843,141843,141846,0,3,3
40494,2,2,141845,141846,141848,1,3,0
40495,5,3,141850,141850,141853,0,3,2
40496,2,2,141852,141853,141855,1,3,0
40497,5,2,141857,141857,141859,0,2,2
40498,3,2,141860,141860,141862,0,2,1
40499,3,1,141863,141863,141864,0,1,1
40500,3,2,141866,141866,141868,0,2,2
40501,4,3,141870,141870,141873,0,3,2
40502,4,1,141874,141874,141875,0,1,1
40503,6,3,141880,141880,141883,0,3,5
40504,4,2,141884,141884,141886,0,2,1
40505,6,2,141890,141890,141892,0,2,4
40506,2,3,141892,141892,141895,0,3,0
40507,5,3,141897,141897,141900,0,3,2
40508,1,2,141898,141900,141902,2,4,0
40509,6,1,141904,141904,141905,0,1,2
40510,3,2,141907,141907,141909,0,2,2
40511,4,2,141911,141911,141913,0,2,2
40512,5,3,141916,141916,141919,0,3,3
40513,2,3,141918,141919,141922,1,4,0
40514,3,1,141921,141922,141923,1,2,0
40515,5,1,141926,141926,141927,0,1,3
40516,6,1,141932,141932,141933,0,1,5
40517,6,2,141938,141938,141940,0,2,5
40518,3,1,141941,141941,141942,0,1,1
40519,4,2,141945,141945,141947,0,2,3
40520,6,3,141951,141951,141954,0,3,4
40521,1,1,141952,141954,141955,2,3,0
40522,6,3,141958,141958,141961,0,3,3
40523,3,3,141961,141961,141964,0,3,0
40524,6,2,141967,141967,141969,0,2,3
40525,4,1,141971,141971,141972,0,1,2
40526,1,1,141972,141972,141973,0,1,0
40527,3,1,141975,141975,141976,0,1,2
40528,5,2,141980,141980,141982,0,2,4
40529,2,1,141982,141982,141983,0,1,0
40530,4,3,141986,141986,141989,0,3,3
40531,6,3,141992,141992,141995,0,3,3
40532,4,2,141996,141996,141998,0,2,1
40533,6,3,142002,142002,142005,0,3,4
40534,2,3,142004,142005,142008,1,4,0
40535,6,3,142010,142010,142013,0,3,2
40536,1,2,142011,142013,142015,2,4,0
40537,5,3,142016,142016,142019,0,3,1
40538,1,3,142017,142019,142022,2,5,0
40539,3,2,142020,142022,142024,2,4,0
40540,2,1,142022,142024,142025,2,3,0
40541,1,3,142023,142025,142028,2,5,0
40542,1,1,142024,142028,142029,4,5,0
40543,6,1,142030,142030,142031,0,1,1
40544,4,1,142034,142034,142035,0,1,3
40545,2,1,142036,142036,142037,0,1,1
40546,6,1,142042,142042,142043,0,1,5
40547,6,2,142048,142048,142050,0,2,5
40548,1,2,142049,142050,142052,1,3,0
40549,1,3,142050,142052,142055,2,5,0
40550,3,3,142053,142055,142058,2,5,0
40551,2,3,142055,142058,142061,3,6,0
40552,1,2,142056,142061,142063,5,7,0
40553,5,1,142061,142063,142064,2,3,0
40554,2,3,142063,142064,142067,1,4,0
40555,1,1,142064,142067,142068,3,4,0
40556,6,1,142070,142070,142071,0,1,2
40557,2,1,142072,142072,142073,0,1,1
40558,1,2,142073,142073,142075,0,2,0
40559,5,1,142078,142078,142079,0,1,3
40560,1,1,142079,142079,142080,0,1,0
40561,1,2,142080,142080,142082,0,2,0
40562,5,2,142085,142085,142087,0,2,3
40563,6,3,142091,142091,142094,0,3,4
40564,3,2,142094,142094,142096,0,2,0
40565,5,2,142099,142099,142101,0,2,3
40566,4,1,142103,142103,142104,0,1,2
40567,5,2,142108,142108,142110,0,2,4
40568,5,2,142113,142113,142115,0,2,3
40569,4,3,142117,142117,142120,0,3,2
40570,2,1,142119,142120,142121,1,2,0
40571,5,2,142124,142124,142126,0,2,3
40572,1,3,142125,142126,142129,1,4,0
40573,2,2,142127,142129,142131,2,4,0
40574,6,2,142133,142133,142135,0,2,2
40575,4,1,142137,142137,142138,0,1,2
40576,4,2,142141,142141,142143,0,2,3
40577,1,1,142142,142143,142144,1,2,0
40578,5,1,142147,142147,142148,0,1,3
40579,1,3,142148,142148,142151,0,3,0
40580,3,2,142151,142151,142153,0,2,0
40581,1,1,142152,142153,142154,1,2,0
40582,1,3,142153,142154,142157,1,4,0
40583,2,3,142155,142157,142160,2,5,0
40584,2,3,142157,142160,142163,3,6,0
40585,6,3,142163,142163,142166,0,3,0
40586,6,1,142169,142169,142170,0,1,3
40587,2,2,142171,142171,142173,0,2,1
40588,6,3,142177,142177,142180,0,3,4
40589,3,2,142180,142180,142182,0,2,0
40590,6,1,142186,142186,142187,0,1,4
40591,2,3,142188,142188,142191,0,3,1
40592,4,2,142192,142192,142194,0,2,1
40593,6,1,142198,142198,142199,0,1,4
40594,1,3,142199,142199,142202,0,3,0
40595,5,1,142204,142204,142205,0,1,2
40596,1,1,142205,142205,142206,0,1,0
40597,5,3,142210,142210,142213,0,3,4
40598,3,2,142213,142213,142215,0,2,0
40599,3,3,142216,142216,142219,0,3,1
40600,5,2,142221,142221,142223,0,2,2
40601,1,2,142222,142223,142225,1,3,0
40602,4,3,142226,142226,142229,0,3,1
40603,2,3,142228,142229,142232,1,4,0
40604,4,1,142232,142232,142233,0,1,0
40605,5,2,142237,142237,142239,0,2,4
40606,3,2,142240,142240,142242,0,2,1
40607,3,2,142243,142243,142245,0,2,1
40608,6,1,142249,142249,142250,0,1,4
40609,1,3,142250,142250,142253,0,3,0
40610,2,3,142252,142253,142256,1,4,0
40611,5,3,142257,142257,142260,0,3,1
40612,2,1,142259,142260,142261,1,2,0
40613,3,3,142262,142262,142265,0,3,1
40614,2,2,142264,142265,142267,1,3,0
40615,6,3,142270,142270,142273,0,3,3
40616,5,1,142275,142275,142276,0,1,2
40617,2,3,142277,142277,142280,0,3,1
40618,6,2,142283,142283,142285,0,2,3
40619,4,2,142287,142287,142289,0,2,2
40620,3,2,142290,142290,142292,0,2,1
40621,2,3,142292,142292,142295,0,3,0
40622,6,3,142298,142298,142301,0,3,3
40623,3,1,142301,142301,142302,0,1,0
40624,1,2,142302,142302,142304,0,2,0
40625,6,1,142308,142308,142309,0,1,4
40626,3,3,142311,142311,142314,0,3,2
40627,6,3,142317,142317,142320,0,3,3
40628,4,2,142321,142321,142323,0,2,1
40629,1,2,142322,142323,142325,1,3,0
40630,2,1,142324,142325,142326,1,2,0
40631,5,3,142329,142329,142332,0,3,3
40632,2,1,142331,142332,142333,1,2,0
40633,5,3,142336,142336,142339,0,3,3
40634,1,2,142337,142339,142341,2,4,0
40635,5,1,142342,142342,142343,0,1,1
40636,4,3,142346,142346,142349,0,3,3
40637,3,2,142349,142349,142351,0,2,0
40638,6,3,142355,142355,142358,0,3,4
40639,1,1,142356,142358,142359,2,3,0
40640,4,2,142360,142360,142362,0,2,1
40641,3,1,142363,142363,142364,0,1,1
40642,4,3,142367,142367,142370,0,3,3
40643,4,2,142371,142371,142373,0,2,1
40644,1,1,142372,142373,142374,1,2,0
40645,3,1,142375,142375,142376,0,1,1
40646,4,1,142379,142379,142380,0,1,3
40647,1,3,142380,142380,142383,0,3,0
40648,6,1,142386,142386,142387,0,1,3
40649,2,2,142388,142388,142390,0,2,1
40650,1,1,142389,142390,142391,1,2,0
40651,6,2,142395,142395,142397,0,2,4
40652,5,1,142400,142400,142401,0,1,3
40653,5,1,142405,142405,142406,0,1,4
40654,6,1,142411,142411,142412,0,1,5
40655,2,2,142413,142413,142415,0,2,1
40656,4,2,142417,142417,142419,0,2,2
40657,2,1,142419,142419,142420,0,1,0
40658,5,1,142424,142424,142425,0,1,4
40659,1,3,142425,142425,142428,0,3,0
40660,3,3,142428,142428,142431,0,3,0
40661,6,2,142434,142434,142436,0,2,3
40662,1,3,142435,142436,142439,1,4,0
40663,6,1,142441,142441,142442,0,1,2
40664,4,2,142445,142445,142447,0,2,3
40665,5,1,142450,142450,142451,0,1,3
40666,5,1,142455,142455,142456,0,1,4
40667,6,2,142461,142461,142463,0,2,5
40668,5,2,142466,142466,142468,0,2,3
40669,6,2,142472,142472,142474,0,2,4
40670,4,1,142476,142476,142477,0,1,2
40671,4,1,142480,142480,142481,0,1,3
40672,4,3,142484,142484,142487,0,3,3
40673,1,1,142485,142487,142488,2,3,0
40674,4,2,142489,142489,142491,0,2,1
40675,5,3,142494,142494,142497,0,3,3
40676,1,3,142495,142497,142500,2,5,0
40677,2,3,142497,142500,142503,3,6,0
40678,6,1,142503,142503,142504,0,1,0
40679,2,2,142505,142505,142507,0,2,1
40680,3,1,142508,142508,142509,0,1,1
40681,2,1,142510,142510,142511,0,1,1
40682,3,2,142513,142513,142515,0,2,2
40683,3,1,142516,142516,142517,0,1,1
40684,2,1,142518,142518,142519,0,1,1
40685,3,3,142521,142521,142524,0,3,2
40686,4,3,142525,142525,142528,0,3,1
40687,6,2,142531,142531,142533,0,2,3
40688,5,1,142536,142536,142537,0,1,3
40689,6,3,142542,142542,142545,0,3,5
40690,1,3,142543,142545,142548,2,5,0
40691,3,1,142546,142548,142549,2,3,0
40692,4,1,142550,142550,142551,0,1,1
40693,1,2,142551,142551,142553,0,2,0
40694,1,3,142552,142553,142556,1,4,0
40695,4,3,142556,142556,142559,0,3,0
40696,4,2,142560,142560,142562,0,2,1
40697,2,2,142562,142562,142564,0,2,0
40698,3,3,142565,142565,142568,0,3,1
40699,5,1,142570,142570,142571,0,1,2
40700,5,3,142575,142575,142578,0,3,4
40701,6,1,142581,142581,142582,0,1,3
40702,5,3,142586,142586,142589,0,3,4
40703,3,3,142589,142589,142592,0,3,0
40704,6,1,142595,142595,142596,0,1,3
40705,1,1,142596,142596,142597,0,1,0
40706,2,1,142598,142598,142599,0,1,1
40707,3,1,142601,142601,142602,0,1,2
40708,5,2,142606,142606,142608,0,2,4
40709,4,3,142610,142610,142613,0,3,2
40710,1,1,142611,142613,142614,2,3,0
40711,6,1,142617,142617,142618,0,1,3
40712,2,1,142619,142619,142620,0,1,1
40713,5,2,142624,142624,142626,0,2,4
40714,3,3,142627,142627,142630,0,3,1
40715,4,3,142631,142631,142634,0,3,1
40716,6,1,142637,142637,142638,0,1,3
40717,5,3,142642,142642,142645,0,3,4
40718,2,2,142644,142645,142647,1,3,0
40719,6,3,142650,142650,142653,0,3,3
40720,1,2,142651,142653,142655,2,4,0
40721,1,1,142652,142655,142656,3,4,0
40722,5,3,142657,142657,142660,0,3,1
40723,3,2,142660,142660,142662,0,2,0
40724,2,1,142662,142662,142663,0,1,0
40725,2,1,142664,142664,142665,0,1,1
40726,1,1,142665,142665,142666,0,1,0
40727,6,2,142671,142671,142673,0,2,5
40728,6,2,142677,142677,142679,0,2,4
40729,4,3,142681,142681,142684,0,3,2
40730,4,3,142685,142685,142688,0,3,1
40731,6,2,142691,142691,142693,0,2,3
40732,6,1,142697,142697,142698,0,1,4
40733,4,3,142701,142701,142704,0,3,3
40734,5,2,142706,142706,142708,0,2,2
40735,6,1,142712,142712,142713,0,1,4
40736,6,2,142718,142718,142720,0,2,5
40737,3,1,142721,142721,142722,0,1,1
40738,1,1,142722,142722,142723,0,1,0
40739,3,3,142725,142725,142728,0,3,2
40740,2,3,142727,142728,142731,1,4,0
40741,2,2,142729,142731,142733,2,4,0
40742,4,1,142733,142733,142734,0,1,0
40743,3,2,142736,142736,142738,0,2,2
40744,2,3,142738,142738,142741,0,3,0
40745,1,3,142739,142741,142744,2,5,0
40746,1,3,142740,142744,142747,4,7,0
40747,2,2,142742,142747,142749,5,7,0
40748,5,2,142747,142749,142751,2,4,0
40749,5,2,142752,142752,142754,0,2,1
40750,6,3,142758,142758,142761,0,3,4
40751,2,1,142760,142761,142762,1,2,0
40752,4,2,142764,142764,142766,0,2,2
40753,5,2,142769,142769,142771,0,2,3
40754,6,2,142775,142775,142777,0,2,4
40755,1,1,142776,142777,142778,1,2,0
40756,6,2,142782,142782,142784,0,2,4
40757,5,3,142787,142787,142790,0,3,3
40758,3,3,142790,142790,142793,0,3,0
40759,3,2,142793,142793,142795,0,2,0
40760,4,2,142797,142797,142799,0,2,2
40761,6,1,142803,142803,142804,0,1,4
40762,5,1,142808,142808,142809,0,1,4
40763,4,3,142812,142812,142815,0,3,3
40764,4,2,142816,142816,142818,0,2,1
40765,4,3,142820,142820,142823,0,3,2
40766,1,1,142821,142823,142824,2,3,0
40767,5,2,142826,142826,142828,0,2,2
40768,1,3,142827,142828,142831,1,4,0
40769,3,1,142830,142831,142832,1,2,0
40770,6,3,142836,142836,142839,0,3,4
40771,4,1,142840,142840,142841,0,1,1
40772,1,3,142841,142841,142844,0,3,0
40773,2,3,142843,142844,142847,1,4,0
40774,4,2,142847,142847,142849,0,2,0
40775,2,1,142849,142849,142850,0,1,0
40776,3,3,142852,142852,142855,0,3,2
40777,1,3,142853,142855,142858,2,5,0
40778,5,3,142858,142858,142861,0,3,0
40779,1,2,142859,142861,142863,2,4,0
40780,1,1,142860,142863,142864,3,4,0
40781,5,2,142865,142865,142867,0,2,1
40782,2,3,142867,142867,142870,0,3,0
40783,5,1,142872,142872,142873,0,1,2
40784,5,1,142877,142877,142878,0,1,4
40785,2,3,142879,142879,142882,0,3,1
40786,6,2,142885,142885,142887,0,2,3
40787,3,3,142888,142888,142891,0,3,1
40788,4,3,142892,142892,142895,0,3,1
40789,3,1,142895,142895,142896,0,1,0
40790,3,2,142898,142898,142900,0,2,2
40791,1,3,142899,142900,142903,1,4,0
40792,2,3,142901,142903,142906,2,5,0
40793,6,2,142907,142907,142909,0,2,1
40794,6,3,142913,142913,142916,0,3,4
40795,2,1,142915,142916,142917,1,2,0
40796,6,2,142921,142921,142923,0,2,4
40797,2,2,142923,142923,142925,0,2,0
40798,4,1,142927,142927,142928,0,1,2
40799,3,3,142930,142930,142933,0,3,2
40800,2,1,142932,142933,142934,1,2,0
40801,6,1,142938,142938,142939,0,1,4
40802,3,2,142941,142941,142943,0,2,2
40803,6,1,142947,142947,142948,0,1,4
40804,6,2,142953,142953,142955,0,2,5
40805,2,3,142955,142955,142958,0,3,0
40806,1,1,142956,142958,142959,2,3,0
40807,4,2,142960,142960,142962,0,2,1
40808,6,2,142966,142966,142968,0,2,4
40809,4,2,142970,142970,142972,0,2,2
40810,2,1,142972,142972,142973,0,1,0
40811,3,2,142975,142975,142977,0,2,2
40812,1,2,142976,142977,142979,1,3,0
40813,4,1,142980,142980,142981,0,1,1
40814,6,3,142986,142986,142989,0,3,5
40815,1,3,142987,142989,142992,2,5,0
40816,3,1,142990,142992,142993,2,3,0
40817,6,2,142996,142996,142998,0,2,3
40818,1,3,142997,142998,143001,1,4,0
40819,5,2,143002,143002,143004,0,2,1
40820,1,2,143003,143004,143006,1,3,0
40821,4,2,143007,143007,143009,0,2,1
40822,1,2,143008,143009,143011,1,3,0
40823,5,2,143013,143013,143015,0,2,2
40824,4,2,143017,143017,143019,0,2,2
40825,4,1,143021,143021,143022,0,1,2
40826,4,2,143025,143025,143027,0,2,3
40827,4,3,143029,143029,143032,0,3,2
40828,5,3,143034,143034,143037,0,3,2
40829,5,3,143039,143039,143042,0,3,2
40830,5,1,143044,143044,143045,0,1,2
40831,4,3,143048,143048,143051,0,3,3
40832,3,1,143051,143051,143052,0,1,0
40833,2,1,143053,143053,143054,0,1,1
40834,2,1,143055,143055,143056,0,1,1
40835,4,1,143059,143059,143060,0,1,3
40836,1,2,143060,143060,143062,0,2,0
40837,3,3,143063,143063,143066,0,3,1
40838,4,1,143067,143067,143068,0,1,1
40839,4,3,143071,143071,143074,0,3,3
40840,6,2,143077,143077,143079,0,2,3
40841,5,1,143082,143082,143083,0,1,3
40842,4,1,143086,143086,143087,0,1,3
40843,5,3,143091,143091,143094,0,3,4
40844,6,3,143097,143097,143100,0,3,3
40845,3,3,143100,143100,143103,0,3,0
40846,6,1,143106,143106,143107,0,1,3
40847,3,2,143109,143109,143111,0,2,2
40848,6,3,143115,143115,143118,0,3,4
40849,2,1,143117,143118,143119,1,2,0
40850,4,2,143121,143121,143123,0,2,2
40851,6,2,143127,143127,143129,0,2,4
40852,3,2,143130,143130,143132,0,2,1
40853,5,1,143135,143135,143136,0,1,3
40854,4,3,143139,143139,143142,0,3,3
40855,6,1,143145,143145,143146,0,1,3
40856,1,1,143146,143146,143147,0,1,0
40857,1,2,143147,143147,143149,0,2,0
40858,4,1,143151,143151,143152,0,1,2
40859,4,3,143155,143155,143158,0,3,3
40860,1,3,143156,143158,143161,2,5,0
40861,2,3,143158,143161,143164,3,6,0
40862,6,3,143164,143164,143167,0,3,0
40863,4,2,143168,143168,143170,0,2,1
40864,2,1,143170,143170,143171,0,1,0
40865,2,2,143172,143172,143174,0,2,1
40866,5,2,143177,143177,143179,0,2,3
40867,2,1,143179,143179,143180,0,1,0
40868,6,1,143185,143185,143186,0,1,5
40869,2,3,143187,143187,143190,0,3,1
40870,5,3,143192,143192,143195,0,3,2
40871,5,3,143197,143197,143200,0,3,2
40872,5,2,143202,143202,143204,0,2,2
40873,6,1,143208,143208,143209,0,1,4
40874,1,2,143209,143209,143211,0,2,0
40875,1,1,143210,143211,143212,1,2,0
40876,2,1,143212,143212,143213,0,1,0
40877,3,1,143215,143215,143216,0,1,2
40878,5,2,143220,143220,143222,0,2,4
40879,4,3,143224,143224,143227,0,3,2
40880,5,3,143229,143229,143232,0,3,2
40881,2,2,143231,143232,143234,1,3,0
40882,5,3,143236,143236,143239,0,3,2
40883,2,1,143238,143239,143240,1,2,0
40884,3,2,143241,143241,143243,0,2,1
40885,6,1,143247,143247,143248,0,1,4
40886,1,2,143248,143248,143250,0,2,0
40887,1,1,143249,143250,143251,1,2,0
40888,3,1,143252,143252,143253,0,1,1
40889,5,1,143257,143257,143258,0,1,4
40890,5,2,143262,143262,143264,0,2,4
40891,2,3,143264,143264,143267,0,3,0
40892,6,3,143270,143270,143273,0,3,3
40893,6,1,143276,143276,143277,0,1,3
40894,4,2,143280,143280,143282,0,2,3
40895,3,2,143283,143283,143285,0,2,1
40896,5,1,143288,143288,143289,0,1,3
40897,4,1,143292,143292,143293,0,1,3
40898,4,1,143296,143296,143297,0,1,3
40899,5,1,143301,143301,143302,0,1,4
40900,5,2,143306,143306,143308,0,2,4
40901,6,2,143312,143312,143314,0,2,4
40902,2,1,143314,143314,143315,0,1,0
40903,3,2,143317,143317,143319,0,2,2
40904,5,2,143322,143322,143324,0,2,3
40905,3,2,143325,143325,143327,0,2,1
40906,3,1,143328,143328,143329,0,1,1
40907,1,3,143329,143329,143332,0,3,0
40908,2,2,143331,143332,143334,1,3,0
40909,4,2,143335,143335,143337,0,2,1
40910,6,2,143341,143341,143343,0,2,4
40911,2,3,143343,143343,143346,0,3,0
40912,1,1,143344,143346,143347,2,3,0
40913,5,2,143349,143349,143351,0,2,2
40914,4,3,143353,143353,143356,0,3,2
40915,2,2,143355,143356,143358,1,3,0
40916,5,2,143360,143360,143362,0,2,2
40917,2,3,143362,143362,143365,0,3,0
40918,1,3,143363,143365,143368,2,5,0
40919,5,3,143368,143368,143371,0,3,0
40920,2,2,143370,143371,143373,1,3,0
40921,6,3,143376,143376,143379,0,3,3
40922,3,1,143379,143379,143380,0,1,0
40923,6,1,143385,143385,143386,0,1,5
40924,5,2,143390,143390,143392,0,2,4
40925,6,3,143396,143396,143399,0,3,4
40926,1,3,143397,143399,143402,2,5,0
40927,4,1,143401,143402,143403,1,2,0
40928,5,3,143406,143406,143409,0,3,3
40929,1,1,143407,143409,143410,2,3,0
40930,3,3,143410,143410,143413,0,3,0
40931,3,3,143413,143413,143416,0,3,0
40932,6,2,143419,143419,143421,0,2,3
40933,3,2,143422,143422,143424,0,2,1
40934,4,2,143426,143426,143428,0,2,2
40935,4,2,143430,143430,143432,0,2,2
40936,1,1,143431,143432,143433,1,2,0
40937,4,2,143435,143435,143437,0,2,2
40938,4,2,143439,143439,143441,0,2,2
40939,6,1,143445,143445,143446,0,1,4
40940,2,1,143447,143447,143448,0,1,1
40941,2,3,143449,143449,143452,0,3,1
40942,5,2,143454,143454,143456,0,2,2
40943,2,2,143456,143456,143458,0,2,0
40944,5,2,143461,143461,143463,0,2,3
40945,5,3,143466,143466,143469,0,3,3
40946,2,2,143468,143469,143471,1,3,0
40947,5,1,143473,143473,143474,0,1,2
40948,6,2,143479,143479,143481,0,2,5
40949,1,3,143480,143481,143484,1,4,0
40950,1,2,143481,143484,143486,3,5,0
40951,2,2,143483,143486,143488,3,5,0
40952,3,3,143486,143488,143491,2,5,0
40953,5,1,143491,143491,143492,0,1,0
40954,2,2,143493,143493,143495,0,2,1
40955,1,2,143494,143495,143497,1,3,0
40956,1,2,143495,143497,143499,2,4,0
40957,3,1,143498,143499,143500,1,2,0
40958,6,2,143504,143504,143506,0,2,4
40959,1,2,143505,143506,143508,1,3,0
40960,3,2,143508,143508,143510,0,2,0
40961,3,3,143511,143511,143514,0,3,1
40962,4,1,143515,143515,143516,0,1,1
40963,4,1,143519,143519,143520,0,1,3
40964,3,1,143522,143522,143523,0,1,2
40965,4,3,143526,143526,143529,0,3,3
40966,5,3,143531,143531,143534,0,3,2
40967,6,2,143537,143537,143539,0,2,3
40968,4,1,143541,143541,143542,0,1,2
40969,2,1,143543,143543,143544,0,1,1
40970,4,3,143547,143547,143550,0,3,3
40971,1,1,143548,143550,143551,2,3,0
40972,1,1,143549,143551,143552,2,3,0
40973,3,1,143552,143552,143553,0,1,0
40974,1,1,143553,143553,143554,0,1,0
40975,5,1,143558,143558,143559,0,1,4
40976,1,2,143559,143559,143561,0,2,0
40977,1,2,143560,143561,143563,1,3,0
40978,2,2,143562,143563,143565,1,3,0
40979,5,3,143567,143567,143570,0,3,2
40980,6,2,143573,143573,143575,0,2,3
40981,6,2,143579,143579,143581,0,2,4
40982,6,1,143585,143585,143586,0,1,4
40983,5,2,143590,143590,143592,0,2,4
40984,1,2,143591,143592,143594,1,3,0
40985,2,1,143593,143594,143595,1,2,0
40986,6,2,143599,143599,143601,0,2,4
40987,6,1,143605,143605,143606,0,1,4
40988,3,1,143608,143608,143609,0,1,2
40989,3,2,143611,143611,143613,0,2,2
40990,6,2,143617,143617,143619,0,2,4
40991,6,3,143623,143623,143626,0,3,4
40992,6,2,143629,143629,143631,0,2,3
40993,4,2,143633,143633,143635,0,2,2
40994,1,3,143634,143635,143638,1,4,0
40995,5,3,143639,143639,143642,0,3,1
40996,2,3,143641,143642,143645,1,4,0
40997,3,2,143644,143645,143647,1,3,0
40998,6,3,143650,143650,143653,0,3,3
40999,5,1,143655,143655,143656,0,1,2
41000,6,2,143661,143661,143663,0,2,5
41001,3,2,143664,143664,143666,0,2,1
41002,3,1,143667,143667,143668,0,1,1
41003,4,2,143671,143671,143673,0,2,3
41004,4,3,143675,143675,143678,0,3,2
41005,4,3,143679,143679,143682,0,3,1
41006,2,2,143681,143682,143684,1,3,0
41007,6,2,143687,143687,143689,0,2,3
41008,3,3,143690,143690,143693,0,3,1
41009,3,1,143693,143693,143694,0,1,0
41010,1,1,143694,143694,143695,0,1,0
41011,5,3,143699,143699,143702,0,3,4
41012,2,1,143701,143702,143703,1,2,0
41013,2,3,143703,143703,143706,0,3,0
41014,2,3,143705,143706,143709,1,4,0
41015,4,3,143709,143709,143712,0,3,0
41016,5,2,143714,143714,143716,0,2,2
41017,4,3,143718,143718,143721,0,3,2
41018,1,1,143719,143721,143722,2,3,0
41019,6,1,143725,143725,143726,0,1,3
41020,4,3,143729,143729,143732,0,3,3
41021,1,2,143730,143732,143734,2,4,0
41022,4,1,143734,143734,143735,0,1,0
41023,6,2,143740,143740,143742,0,2,5
41024,4,2,143744,143744,143746,0,2,2
41025,6,3,143750,143750,143753,0,3,4
41026,6,3,143756,143756,143759,0,3,3
41027,2,1,143758,143759,143760,1,2,0
41028,1,2,143759,143760,143762,1,3,0
41029,2,1,143761,143762,143763,1,2,0
41030,3,1,143764,143764,143765,0,1,1
41031,4,3,143768,143768,143771,0,3,3
41032,6,1,143774,143774,143775,0,1,3
41033,6,3,143780,143780,143783,0,3,5
41034,4,1,143784,143784,143785,0,1,1
41035,4,3,143788,143788,143791,0,3,3
41036,1,2,143789,143791,143793,2,4,0
41037,6,3,143795,143795,143798,0,3,2
41038,1,3,143796,143798,143801,2,5,0
41039,3,2,143799,143801,143803,2,4,0
41040,4,3,143803,143803,143806,0,3,0
41041,4,3,143807,143807,143810,0,3,1
41042,1,1,143808,143810,143811,2,3,0
41043,6,2,143814,143814,143816,0,2,3
41044,3,3,143817,143817,143820,0,3,1
41045,2,2,143819,143820,143822,1,3,0
41046,3,1,143822,143822,143823,0,1,0
41047,6,2,143828,143828,143830,0,2,5
41048,4,1,143832,143832,143833,0,1,2
41049,5,2,143837,143837,143839,0,2,4
41050,1,2,143838,143839,143841,1,3,0
41051,5,2,143843,143843,143845,0,2,2
41052,6,2,143849,143849,143851,0,2,4
41053,3,3,143852,143852,143855,0,3,1
41054,1,1,143853,143855,143856,2,3,0
41055,4,1,143857,143857,143858,0,1,1
41056,5,2,143862,143862,143864,0,2,4
41057,2,1,143864,143864,143865,0,1,0
41058,2,3,143866,143866,143869,0,3,1
41059,4,2,143870,143870,143872,0,2,1
41060,4,3,143874,143874,143877,0,3,2
41061,3,1,143877,143877,143878,0,1,0
41062,2,3,143879,143879,143882,0,3,1
41063,5,2,143884,143884,143886,0,2,2
41064,3,1,143887,143887,143888,0,1,1
41065,6,2,143893,143893,143895,0,2,5
41066,4,1,143897,143897,143898,0,1,2
41067,1,2,143898,143898,143900,0,2,0
41068,1,2,143899,143900,143902,1,3,0
41069,5,2,143904,143904,143906,0,2,2
41070,3,1,143907,143907,143908,0,1,1
41071,2,1,143909,143909,143910,0,1,1
41072,5,2,143914,143914,143916,0,2,4
41073,1,1,143915,143916,143917,1,2,0
41074,3,1,143918,143918,143919,0,1,1
41075,3,3,143921,143921,143924,0,3,2
41076,1,3,143922,143924,143927,2,5,0
41077,5,2,143927,143927,143929,0,2,0
41078,1,2,143928,143929,143931,1,3,0
41079,1,3,143929,143931,143934,2,5,0
41080,6,2,143935,143935,143937,0,2,1
41081,5,2,143940,143940,143942,0,2,3
41082,1,2,143941,143942,143944,1,3,0
41083,5,1,143946,143946,143947,0,1,2
41084,1,2,143947,143947,143949,0,2,0
41085,4,2,143951,143951,143953,0,2,2
41086,1,2,143952,143953,143955,1,3,0
41087,1,3,143953,143955,143958,2,5,0
41088,2,3,143955,143958,143961,3,6,0
41089,5,3,143960,143961,143964,1,4,0
41090,3,2,143963,143964,143966,1,3,0
41091,3,2,143966,143966,143968,0,2,0
41092,5,1,143971,143971,143972,0,1,3
41093,1,3,143972,143972,143975,0,3,0
41094,5,1,143977,143977,143978,0,1,2
41095,3,1,143980,143980,143981,0,1,2
41096,5,1,143985,143985,143986,0,1,4
41097,2,3,143987,143987,143990,0,3,1
41098,3,1,143990,143990,143991,0,1,0
41099,1,3,143991,143991,143994,0,3,0
41100,4,3,143995,143995,143998,0,3,1
41101,6,1,144001,144001,144002,0,1,3
41102,5,2,144006,144006,144008,0,2,4
41103,1,1,144007,144008,144009,1,2,0
41104,6,3,144013,144013,144016,0,3,4
41105,6,3,144019,144019,144022,0,3,3
41106,3,1,144022,144022,144023,0,1,0
41107,3,2,144025,144025,144027,0,2,2
41108,4,2,144029,144029,144031,0,2,2
41109,4,2,144033,144033,144035,0,2,2
41110,2,1,144035,144035,144036,0,1,0
41111,3,2,144038,144038,144040,0,2,2
41112,5,3,144043,144043,144046,0,3,3
41113,6,2,144049,144049,144051,0,2,3
41114,3,2,144052,144052,144054,0,2,1
41115,2,2,144054,144054,144056,0,2,0
41116,2,1,144056,144056,144057,0,1,0
41117,4,3,144060,144060,144063,0,3,3
41118,4,1,144064,144064,144065,0,1,1
41119,5,1,144069,144069,144070,0,1,4
41120,4,1,144073,144073,144074,0,1,3
41121,1,2,144074,144074,144076,0,2,0
41122,5,2,144079,144079,144081,0,2,3
41123,4,3,144083,144083,144086,0,3,2
41124,6,3,144089,144089,144092,0,3,3
41125,1,1,144090,144092,144093,2,3,0
41126,2,1,144092,144093,144094,1,2,0
41127,6,2,144098,144098,144100,0,2,4
41128,3,1,144101,144101,144102,0,1,1
41129,4,1,144105,144105,144106,0,1,3
41130,4,2,144109,144109,144111,0,2,3
41131,2,2,144111,144111,144113,0,2,0
41132,6,1,144117,144117,144118,0,1,4
41133,4,3,144121,144121,144124,0,3,3
41134,5,2,144126,144126,144128,0,2,2
41135,6,2,144132,144132,144134,0,2,4
41136,3,3,144135,144135,144138,0,3,1
41137,5,1,144140,144140,144141,0,1,2
41138,5,2,144145,144145,144147,0,2,4
41139,1,3,144146,144147,144150,1,4,0
41140,1,3,144147,144150,144153,3,6,0
41141,6,1,144153,144153,144154,0,1,0
41142,4,3,144157,144157,144160,0,3,3
41143,1,3,144158,144160,144163,2,5,0
41144,6,1,144164,144164,144165,0,1,1
41145,4,3,144168,144168,144171,0,3,3
41146,1,2,144169,144171,144173,2,4,0
41147,2,1,144171,144173,144174,2,3,0
41148,5,2,144176,144176,144178,0,2,2
41149,3,2,144179,144179,144181,0,2,1
41150,4,3,144183,144183,144186,0,3,2
41151,2,2,144185,144186,144188,1,3,0
41152,3,2,144188,144188,144190,0,2,0
41153,5,3,144193,144193,144196,0,3,3
41154,4,1,144197,144197,144198,0,1,1
41155,5,2,144202,144202,144204,0,2,4
41156,1,3,144203,144204,144207,1,4,0
41157,3,2,144206,144207,144209,1,3,0
41158,6,2,144212,144212,144214,0,2,3
41159,6,1,144218,144218,144219,0,1,4
41160,1,3,144219,144219,144222,0,3,0
41161,5,1,144224,144224,144225,0,1,2
41162,2,3,144226,144226,144229,0,3,1
41163,2,3,144228,144229,144232,1,4,0
41164,3,1,144231,144232,144233,1,2,0
41165,1,1,144232,144233,144234,1,2,0
41166,1,3,144233,144234,144237,1,4,0
41167,4,2,144237,144237,144239,0,2,0
41168,1,1,144238,144239,144240,1,2,0
41169,6,2,144244,144244,144246,0,2,4
41170,2,2,144246,144246,144248,0,2,0
41171,3,3,144249,144249,144252,0,3,1
41172,4,1,144253,144253,144254,0,1,1
41173,1,2,144254,144254,144256,0,2,0
41174,6,2,144260,144260,144262,0,2,4
41175,2,2,144262,144262,144264,0,2,0
41176,3,2,144265,144265,144267,0,2,1
41177,2,3,144267,144267,144270,0,3,0
41178,5,2,144272,144272,144274,0,2,2
41179,3,1,144275,144275,144276,0,1,1
41180,6,3,144281,144281,144284,0,3,5
41181,4,2,144285,144285,144287,0,2,1
41182,1,1,144286,144287,144288,1,2,0
41183,5,2,144291,144291,144293,0,2,3
41184,5,3,144296,144296,144299,0,3,3
41185,5,2,144301,144301,144303,0,2,2
41186,5,3,144306,144306,144309,0,3,3
41187,4,3,144310,144310,144313,0,3,1
41188,3,1,144313,144313,144314,0,1,0
41189,5,2,144318,144318,144320,0,2,4
41190,4,3,144322,144322,144325,0,3,2
41191,5,1,144327,144327,144328,0,1,2
41192,2,3,144329,144329,144332,0,3,1
41193,5,2,144334,144334,144336,0,2,2
41194,5,2,144339,144339,144341,0,2,3
41195,5,3,144344,144344,144347,0,3,3
41196,1,2,144345,144347,144349,2,4,0
41197,5,2,144350,144350,144352,0,2,1
41198,5,2,144355,144355,144357,0,2,3
41199,5,2,144360,144360,144362,0,2,3
41200,3,1,144363,144363,144364,0,1,1
41201,2,2,144365,144365,144367,0,2,1
41202,6,1,144371,144371,144372,0,1,4
41203,2,2,144373,144373,144375,0,2,1
41204,4,2,144377,144377,144379,0,2,2
41205,3,1,144380,144380,144381,0,1,1
41206,1,2,144381,144381,144383,0,2,0
41207,5,3,144386,144386,144389,0,3,3
41208,2,1,144388,144389,144390,1,2,0
41209,2,3,144390,144390,144393,0,3,0
41210,3,2,144393,144393,144395,0,2,0
41211,3,1,144396,144396,144397,0,1,1
41212,1,2,144397,144397,144399,0,2,0
41213,4,2,144401,144401,144403,0,2,2
41214,1,1,144402,144403,144404,1,2,0
41215,2,2,144404,144404,144406,0,2,0
41216,2,3,144406,144406,144409,0,3,0
41217,2,1,144408,144409,144410,1,2,0
41218,3,2,144411,144411,144413,0,2,1
41219,4,2,144415,144415,144417,0,2,2
41220,2,3,144417,144417,144420,0,3,0
41221,2,3,144419,144420,144423,1,4,0
41222,4,3,144423,144423,144426,0,3,0
41223,4,3,144427,144427,144430,0,3,1
41224,3,1,144430,144430,144431,0,1,0
41225,2,2,144432,144432,144434,0,2,1
41226,5,2,144437,144437,144439,0,2,3
41227,1,2,144438,144439,144441,1,3,0
41228,6,2,144444,144444,144446,0,2,3
41229,4,1,144448,144448,144449,0,1,2
41230,2,3,144450,144450,144453,0,3,1
41231,6,1,144456,144456,144457,0,1,3
41232,3,2,144459,144459,144461,0,2,2
41233,2,3,144461,144461,144464,0,3,0
41234,5,2,144466,144466,144468,0,2,2
41235,5,2,144471,144471,144473,0,2,3
41236,6,2,144477,144477,144479,0,2,4
41237,2,3,144479,144479,144482,0,3,0
41238,6,3,144485,144485,144488,0,3,3
41239,6,1,144491,144491,144492,0,1,3
41240,5,3,144496,144496,144499,0,3,4
41241,1,2,144497,144499,144501,2,4,0
41242,5,3,144502,144502,144505,0,3,1
41243,2,3,144504,144505,144508,1,4,0
41244,4,3,144508,144508,144511,0,3,0
41245,3,3,144511,144511,144514,0,3,0
41246,2,3,144513,144514,144517,1,4,0
41247,4,3,144517,144517,144520,0,3,0
41248,4,1,144521,144521,144522,0,1,1
41249,4,1,144525,144525,144526,0,1,3
41250,6,3,144531,144531,144534,0,3,5
41251,4,2,144535,144535,144537,0,2,1
41252,5,1,144540,144540,144541,0,1,3
41253,3,1,144543,144543,144544,0,1,2
41254,2,1,144545,144545,144546,0,1,1
41255,1,1,144546,144546,144547,0,1,0
41256,3,1,144549,144549,144550,0,1,2
41257,6,1,144555,144555,144556,0,1,5
41258,6,2,144561,144561,144563,0,2,5
41259,4,1,144565,144565,144566,0,1,2
41260,4,2,144569,144569,144571,0,2,3
41261,3,3,144572,144572,144575,0,3,1
41262,2,1,144574,144575,144576,1,2,0
41263,3,2,144577,144577,144579,0,2,1
41264,6,1,144583,144583,144584,0,1,4
41265,4,2,144587,144587,144589,0,2,3
41266,5,3,144592,144592,144595,0,3,3
41267,1,2,144593,144595,144597,2,4,0
41268,3,2,144596,144597,144599,1,3,0
41269,6,3,144602,144602,144605,0,3,3
41270,1,2,144603,144605,144607,2,4,0
41271,1,3,144604,144607,144610,3,6,0
41272,3,2,144607,144610,144612,3,5,0
41273,4,3,144611,144612,144615,1,4,0
41274,4,1,144615,144615,144616,0,1,0
41275,4,3,144619,144619,144622,0,3,3
41276,6,2,144625,144625,144627,0,2,3
41277,4,3,144629,144629,144632,0,3,2
41278,2,2,144631,144632,144634,1,3,0
41279,4,1,144635,144635,144636,0,1,1
41280,4,2,144639,144639,144641,0,2,3
41281,6,2,144645,144645,144647,0,2,4
41282,1,2,144646,144647,144649,1,3,0
41283,5,2,144651,144651,144653,0,2,2
41284,2,3,144653,144653,144656,0,3,0
41285,1,1,144654,144656,144657,2,3,0
41286,4,2,144658,144658,144660,0,2,1
41287,4,2,144662,144662,144664,0,2,2
41288,1,3,144663,144664,144667,1,4,0
41289,3,2,144666,144667,144669,1,3,0
41290,1,2,144667,144669,144671,2,4,0
41291,3,1,144670,144671,144672,1,2,0
41292,4,2,144674,144674,144676,0,2,2
41293,5,1,144679,144679,144680,0,1,3
41294,1,3,144680,144680,144683,0,3,0
41295,2,1,144682,144683,144684,1,2,0
41296,2,1,144684,144684,144685,0,1,0
41297,5,2,144689,144689,144691,0,2,4
41298,6,2,144695,144695,144697,0,2,4
41299,4,1,144699,144699,144700,0,1,2
41300,2,3,144701,144701,144704,0,3,1
41301,5,2,144706,144706,144708,0,2,2
41302,5,1,144711,144711,144712,0,1,3
41303,2,3,144713,144713,144716,0,3,1
41304,5,3,144718,144718,144721,0,3,2
41305,6,2,144724,144724,144726,0,2,3
41306,2,2,144726,144726,144728,0,2,0
41307,6,3,144732,144732,144735,0,3,4
41308,1,3,144733,144735,144738,2,5,0
41309,3,1,144736,144738,144739,2,3,0
41310,3,3,144739,144739,144742,0,3,0
41311,5,1,144744,144744,144745,0,1,2
41312,1,3,144745,144745,144748,0,3,0
41313,6,3,144751,144751,144754,0,3,3
41314,6,1,144757,144757,144758,0,1,3
41315,4,3,144761,144761,144764,0,3,3
41316,1,1,144762,144764,144765,2,3,0
41317,6,3,144768,144768,144771,0,3,3
41318,4,3,144772,144772,144775,0,3,1
41319,4,2,144776,144776,144778,0,2,1
41320,3,3,144779,144779,144782,0,3,1
41321,5,1,144784,144784,144785,0,1,2
41322,5,1,144789,144789,144790,0,1,4
41323,6,3,144795,144795,144798,0,3,5
41324,1,1,144796,144798,144799,2,3,0
41325,6,3,144802,144802,144805,0,3,3
41326,2,2,144804,144805,144807,1,3,0
41327,2,1,144806,144807,144808,1,2,0
41328,3,1,144809,144809,144810,0,1,1
41329,1,3,144810,144810,144813,0,3,0
41330,5,1,144815,144815,144816,0,1,2
41331,2,1,144817,144817,144818,0,1,1
41332,5,2,144822,144822,144824,0,2,4
41333,3,3,144825,144825,144828,0,3,1
41334,6,2,144831,144831,144833,0,2,3
41335,6,2,144837,144837,144839,0,2,4
41336,3,1,144840,144840,144841,0,1,1
41337,2,1,144842,144842,144843,0,1,1
41338,2,2,144844,144844,144846,0,2,1
41339,4,3,144848,144848,144851,0,3,2
41340,1,3,144849,144851,144854,2,5,0
41341,5,3,144854,144854,144857,0,3,0
41342,2,2,144856,144857,144859,1,3,0
41343,5,3,144861,144861,144864,0,3,2
41344,5,3,144866,144866,144869,0,3,2
41345,3,2,144869,144869,144871,0,2,0
41346,2,1,144871,144871,144872,0,1,0
41347,2,3,144873,144873,144876,0,3,1
41348,4,1,144877,144877,144878,0,1,1
41349,4,1,144881,144881,144882,0,1,3
41350,4,1,144885,144885,144886,0,1,3
41351,2,2,144887,144887,144889,0,2,1
41352,6,1,144893,144893,144894,0,1,4
41353,1,2,144894,144894,144896,0,2,0
41354,1,1,144895,144896,144897,1,2,0
41355,6,3,144901,144901,144904,0,3,4
41356,6,3,144907,144907,144910,0,3,3
41357,5,1,144912,144912,144913,0,1,2
41358,1,2,144913,144913,144915,0,2,0
41359,4,3,144917,144917,144920,0,3,2
41360,5,3,144922,144922,144925,0,3,2
41361,1,1,144923,144925,144926,2,3,0
41362,6,2,144929,144929,144931,0,2,3
41363,6,3,144935,144935,144938,0,3,4
41364,2,2,144937,144938,144940,1,3,0
41365,1,3,144938,144940,144943,2,5,0
41366,6,2,144944,144944,144946,0,2,1
41367,4,2,144948,144948,144950,0,2,2
41368,5,2,144953,144953,144955,0,2,3
41369,4,3,144957,144957,144960,0,3,2
41370,5,3,144962,144962,144965,0,3,2
41371,4,2,144966,144966,144968,0,2,1
41372,2,1,144968,144968,144969,0,1,0
41373,2,3,144970,144970,144973,0,3,1
41374,4,2,144974,144974,144976,0,2,1
41375,5,1,144979,144979,144980,0,1,3
41376,4,3,144983,144983,144986,0,3,3
41377,4,2,144987,144987,144989,0,2,1
41378,2,2,144989,144989,144991,0,2,0
41379,4,1,144993,144993,144994,0,1,2
41380,2,1,144995,144995,144996,0,1,1
41381,6,1,145001,145001,145002,0,1,5
41382,6,2,145007,145007,145009,0,2,5
41383,3,3,145010,145010,145013,0,3,1
41384,3,3,145013,145013,145016,0,3,0
41385,2,2,145015,145016,145018,1,3,0
41386,5,3,145020,145020,145023,0,3,2
41387,4,1,145024,145024,145025,0,1,1
41388,5,3,145029,145029,145032,0,3,4
41389,1,2,145030,145032,145034,2,4,0
41390,6,2,145036,145036,145038,0,2,2
41391,6,2,145042,145042,145044,0,2,4
41392,5,3,145047,145047,145050,0,3,3
41393,4,3,145051,145051,145054,0,3,1
41394,5,3,145056,145056,145059,0,3,2
41395,2,1,145058,145059,145060,1,2,0
41396,3,3,145061,145061,145064,0,3,1
41397,2,2,145063,145064,145066,1,3,0
41398,6,3,145069,145069,145072,0,3,3
41399,1,2,145070,145072,145074,2,4,0
41400,2,2,145072,145074,145076,2,4,0
41401,5,2,145077,145077,145079,0,2,1
41402,1,2,145078,145079,145081,1,3,0
41403,4,2,145082,145082,145084,0,2,1
41404,6,2,145088,145088,145090,0,2,4
41405,1,2,145089,145090,145092,1,3,0
41406,6,1,145095,145095,145096,0,1,3
41407,1,1,145096,145096,145097,0,1,0
41408,6,3,145102,145102,145105,0,3,5
41409,2,3,145104,145105,145108,1,4,0
41410,4,3,145108,145108,145111,0,3,0
41411,6,2,145114,145114,145116,0,2,3
41412,3,1,145117,145117,145118,0,1,1
41413,3,3,145120,145120,145123,0,3,2
41414,5,2,145125,145125,145127,0,2,2
41415,6,2,145131,145131,145133,0,2,4
41416,2,1,145133,145133,145134,0,1,0
41417,6,2,145139,145139,145141,0,2,5
41418,6,3,145145,145145,145148,0,3,4
41419,1,2,145146,145148,145150,2,4,0
41420,5,3,145151,145151,145154,0,3,1
41421,2,2,145153,145154,145156,1,3,0
41422,2,2,145155,145156,145158,1,3,0
41423,6,1,145161,145161,145162,0,1,3
41424,3,2,145164,145164,145166,0,2,2
41425,2,2,145166,145166,145168,0,2,0
41426,4,2,145170,145170,145172,0,2,2
41427,1,2,145171,145172,145174,1,3,0
41428,2,3,145173,145174,145177,1,4,0
41429,1,2,145174,145177,145179,3,5,0
41430,1,1,145175,145179,145180,4,5,0
41431,2,3,145177,145180,145183,3,6,0
41432,3,2,145180,145183,145185,3,5,0
41433,6,3,145186,145186,145189,0,3,1
41434,5,2,145191,145191,145193,0,2,2
41435,5,3,145196,145196,145199,0,3,3
41436,2,1,145198,145199,145200,1,2,0
41437,6,2,145204,145204,145206,0,2,4
41438,1,2,145205,145206,145208,1,3,0
41439,5,3,145210,145210,145213,0,3,2
41440,4,3,145214,145214,145217,0,3,1
41441,5,3,145219,145219,145222,0,3,2
41442,3,1,145222,145222,145223,0,1,0
41443,1,1,145223,145223,145224,0,1,0
41444,3,2,145226,145226,145228,0,2,2
41445,6,2,145232,145232,145234,0,2,4
41446,4,1,145236,145236,145237,0,1,2
41447,6,1,145242,145242,145243,0,1,5
41448,6,3,145248,145248,145251,0,3,5
41449,3,2,145251,145251,145253,0,2,0
41450,4,3,145255,145255,145258,0,3,2
41451,2,1,145257,145258,145259,1,2,0
41452,6,3,145263,145263,145266,0,3,4
41453,5,1,145268,145268,145269,0,1,2
41454,4,1,145272,145272,145273,0,1,3
41455,1,2,145273,145273,145275,0,2,0
41456,5,1,145278,145278,145279,0,1,3
41457,3,3,145281,145281,145284,0,3,2
41458,3,1,145284,145284,145285,0,1,0
41459,3,3,145287,145287,145290,0,3,2
41460,3,1,145290,145290,145291,0,1,0
41461,6,2,145296,145296,145298,0,2,5
41462,2,1,145298,145298,145299,0,1,0
41463,4,2,145302,145302,145304,0,2,3
41464,1,1,145303,145304,145305,1,2,0
41465,1,3,145304,145305,145308,1,4,0
41466,6,1,145310,145310,145311,0,1,2
41467,5,1,145315,145315,145316,0,1,4
41468,5,3,145320,145320,145323,0,3,4
41469,4,1,145324,145324,145325,0,1,1
41470,6,2,145330,145330,145332,0,2,5
41471,5,2,145335,145335,145337,0,2,3
41472,5,1,145340,145340,145341,0,1,3
41473,4,1,145344,145344,145345,0,1,3
41474,2,1,145346,145346,145347,0,1,1
41475,4,3,145350,145350,145353,0,3,3
41476,4,3,145354,145354,145357,0,3,1
41477,4,3,145358,145358,145361,0,3,1
41478,6,3,145364,145364,145367,0,3,3
41479,3,1,145367,145367,145368,0,1,0
41480,3,2,145370,145370,145372,0,2,2
41481,5,1,145375,145375,145376,0,1,3
41482,2,3,145377,145377,145380,0,3,1
41483,6,1,145383,145383,145384,0,1,3
41484,5,3,145388,145388,145391,0,3,4
41485,2,3,145390,145391,145394,1,4,0
41486,6,1,145396,145396,145397,0,1,2
41487,6,3,145402,145402,145405,0,3,5
41488,2,2,145404,145405,145407,1,3,0
41489,4,3,145408,145408,145411,0,3,1
41490,1,2,145409,145411,145413,2,4,0
41491,5,3,145414,145414,145417,0,3,1
41492,1,1,145415,145417,145418,2,3,0
41493,1,1,145416,145418,145419,2,3,0
41494,6,2,145422,145422,145424,0,2,3
41495,4,2,145426,145426,145428,0,2,2
41496,6,1,145432,145432,145433,0,1,4
41497,3,1,145435,145435,145436,0,1,2
41498,5,1,145440,145440,145441,0,1,4
41499,4,2,145444,145444,145446,0,2,3
41500,2,2,145446,145446,145448,0,2,0
41501,2,2,145448,145448,145450,0,2,0
41502,6,1,145454,145454,145455,0,1,4
41503,4,1,145458,145458,145459,0,1,3
41504,6,1,145464,145464,145465,0,1,5
41505,6,3,145470,145470,145473,0,3,5
41506,5,3,145475,145475,145478,0,3,2
41507,3,2,145478,145478,145480,0,2,0
41508,6,1,145484,145484,145485,0,1,4
41509,4,1,145488,145488,145489,0,1,3
41510,2,3,145490,145490,145493,0,3,1
41511,2,2,145492,145493,145495,1,3,0
41512,3,2,145495,145495,145497,0,2,0
41513,2,3,145497,145497,145500,0,3,0
41514,5,2,145502,145502,145504,0,2,2
41515,1,1,145503,145504,145505,1,2,0
41516,4,1,145507,145507,145508,0,1,2
41517,3,3,145510,145510,145513,0,3,2
41518,3,3,145513,145513,145516,0,3,0
41519,5,3,145518,145518,145521,0,3,2
41520,2,2,145520,145521,145523,1,3,0
41521,1,1,145521,145523,145524,2,3,0
41522,2,3,145523,145524,145527,1,4,0
41523,6,1,145529,145529,145530,0,1,2
41524,2,1,145531,145531,145532,0,1,1
41525,3,3,145534,145534,145537,0,3,2
41526,4,1,145538,145538,145539,0,1,1
41527,5,3,145543,145543,145546,0,3,4
41528,4,2,145547,145547,145549,0,2,1
41529,6,2,145553,145553,145555,0,2,4
41530,5,3,145558,145558,145561,0,3,3
41531,5,3,145563,145563,145566,0,3,2
41532,1,3,145564,145566,145569,2,5,0
41533,5,1,145569,145569,145570,0,1,0
41534,6,2,145575,145575,145577,0,2,5
41535,1,1,145576,145577,145578,1,2,0
41536,3,3,145579,145579,145582,0,3,1
41537,5,2,145584,145584,145586,0,2,2
41538,2,2,145586,145586,145588,0,2,0
41539,1,1,145587,145588,145589,1,2,0
41540,3,2,145590,145590,145592,0,2,1
41541,4,1,145594,145594,145595,0,1,2
41542,2,2,145596,145596,145598,0,2,1
41543,2,3,145598,145598,145601,0,3,0
41544,6,1,145604,145604,145605,0,1,3
41545,1,3,145605,145605,145608,0,3,0
41546,2,3,145607,145608,145611,1,4,0
41547,3,3,145610,145611,145614,1,4,0
41548,5,3,145615,145615,145618,0,3,1
41549,4,1,145619,145619,145620,0,1,1
41550,3,1,145622,145622,145623,0,1,2
41551,3,2,145625,145625,145627,0,2,2
41552,2,1,145627,145627,145628,0,1,0
41553,5,2,145632,145632,145634,0,2,4
41554,2,2,145634,145634,145636,0,2,0
41555,1,1,145635,145636,145637,1,2,0
41556,4,2,145639,145639,145641,0,2,2
41557,3,2,145642,145642,145644,0,2,1
41558,5,1,145647,145647,145648,0,1,3
41559,6,3,145653,145653,145656,0,3,5
41560,5,2,145658,145658,145660,0,2,2
41561,5,3,145663,145663,145666,0,3,3
41562,2,3,145665,145666,145669,1,4,0
41563,5,3,145670,145670,145673,0,3,1
41564,6,3,145676,145676,145679,0,3,3
41565,2,1,145678,145679,145680,1,2,0
41566,4,2,145682,145682,145684,0,2,2
41567,1,3,145683,145684,145687,1,4,0
41568,2,3,145685,145687,145690,2,5,0
41569,1,1,145686,145690,145691,4,5,0
41570,4,1,145690,145691,145692,1,2,0
41571,5,3,145695,145695,145698,0,3,3
41572,5,1,145700,145700,145701,0,1,2
41573,2,2,145702,145702,145704,0,2,1
41574,2,2,145704,145704,145706,0,2,0
41575,2,3,145706,145706,145709,0,3,0
41576,4,3,145710,145710,145713,0,3,1
41577,6,2,145716,145716,145718,0,2,3
41578,5,3,145721,145721,145724,0,3,3
41579,6,2,145727,145727,145729,0,2,3
41580,4,2,145731,145731,145733,0,2,2
41581,6,2,145737,145737,145739,0,2,4
41582,1,3,145738,145739,145742,1,4,0
41583,6,3,145744,145744,145747,0,3,2
41584,4,2,145748,145748,145750,0,2,1
41585,6,3,145754,145754,145757,0,3,4
41586,5,2,145759,145759,145761,0,2,2
41587,6,1,145765,145765,145766,0,1,4
41588,1,3,145766,145766,145769,0,3,0
41589,4,3,145770,145770,145773,0,3,1
41590,3,2,145773,145773,145775,0,2,0
41591,1,1,145774,145775,145776,1,2,0
41592,2,2,145776,145776,145778,0,2,0
41593,4,1,145780,145780,145781,0,1,2
41594,2,3,145782,145782,145785,0,3,1
41595,2,3,145784,145785,145788,1,4,0
41596,1,3,145785,145788,145791,3,6,0
41597,4,2,145789,145791,145793,2,4,0
41598,1,2,145790,145793,145795,3,5,0
41599,5,2,145795,145795,145797,0,2,0
41600,3,3,145798,145798,145801,0,3,1
41601,5,3,145803,145803,145806,0,3,2
41602,5,2,145808,145808,145810,0,2,2
41603,4,3,145812,145812,145815,0,3,2
41604,1,3,145813,145815,145818,2,5,0
41605,5,3,145818,145818,145821,0,3,0
41606,5,2,145823,145823,145825,0,2,2
41607,4,2,145827,145827,145829,0,2,2
41608,4,1,145831,145831,145832,0,1,2
41609,6,3,145837,145837,145840,0,3,5
41610,2,1,145839,145840,145841,1,2,0
41611,4,2,145843,145843,145845,0,2,2
41612,4,1,145847,145847,145848,0,1,2
41613,5,3,145852,145852,145855,0,3,4
41614,4,2,145856,145856,145858,0,2,1
41615,6,3,145862,145862,145865,0,3,4
41616,6,1,145868,145868,145869,0,1,3
41617,1,2,145869,145869,145871,0,2,0
41618,6,2,145875,145875,145877,0,2,4
41619,3,1,145878,145878,145879,0,1,1
41620,1,2,145879,145879,145881,0,2,0
41621,4,2,145883,145883,145885,0,2,2
41622,5,2,145888,145888,145890,0,2,3
41623,5,3,145893,145893,145896,0,3,3
41624,1,1,145894,145896,145897,2,3,0
41625,6,1,145900,145900,145901,0,1,3
41626,1,3,145901,145901,145904,0,3,0
41627,6,3,145907,145907,145910,0,3,3
41628,1,3,145908,145910,145913,2,5,0
41629,5,2,145913,145913,145915,0,2,0
41630,5,2,145918,145918,145920,0,2,3
41631,4,3,145922,145922,145925,0,3,2
41632,1,3,145923,145925,145928,2,5,0
41633,1,1,145924,145928,145929,4,5,0
41634,2,3,145926,145929,145932,3,6,0
41635,6,2,145932,145932,145934,0,2,0
41636,3,3,145935,145935,145938,0,3,1
41637,5,2,145940,145940,145942,0,2,2
41638,2,2,145942,145942,145944,0,2,0
41639,6,2,145948,145948,145950,0,2,4
41640,6,3,145954,145954,145957,0,3,4
41641,2,1,145956,145957,145958,1,2,0
41642,3,1,145959,145959,145960,0,1,1
41643,6,1,145965,145965,145966,0,1,5
41644,4,2,145969,145969,145971,0,2,3
41645,4,2,145973,145973,145975,0,2,2
41646,3,1,145976,145976,145977,0,1,1
41647,1,1,145977,145977,145978,0,1,0
41648,2,3,145979,145979,145982,0,3,1
41649,4,2,145983,145983,145985,0,2,1
41650,6,2,145989,145989,145991,0,2,4
41651,6,2,145995,145995,145997,0,2,4
41652,3,1,145998,145998,145999,0,1,1
41653,2,2,146000,146000,146002,0,2,1
41654,5,3,146005,146005,146008,0,3,3
41655,1,1,146006,146008,146009,2,3,0
41656,5,2,146011,146011,146013,0,2,2
41657,3,2,146014,146014,146016,0,2,1
41658,4,3,146018,146018,146021,0,3,2
41659,5,3,146023,146023,146026,0,3,2
41660,2,3,146025,146026,146029,1,4,0
41661,3,3,146028,146029,146032,1,4,0
41662,2,1,146030,146032,146033,2,3,0
41663,1,2,146031,146033,146035,2,4,0
41664,4,1,146035,146035,146036,0,1,0
41665,4,3,146039,146039,146042,0,3,3
41666,4,3,146043,146043,146046,0,3,1
41667,2,2,146045,146046,146048,1,3,0
41668,5,1,146050,146050,146051,0,1,2
41669,6,3,146056,146056,146059,0,3,5
41670,5,1,146061,146061,146062,0,1,2
41671,5,3,146066,146066,146069,0,3,4
41672,3,2,146069,146069,146071,0,2,0
41673,2,2,146071,146071,146073,0,2,0
41674,6,1,146077,146077,146078,0,1,4
41675,1,3,146078,146078,146081,0,3,0
41676,2,2,146080,146081,146083,1,3,0
41677,4,3,146084,146084,146087,0,3,1
41678,2,3,146086,146087,146090,1,4,0
41679,6,2,146092,146092,146094,0,2,2
41680,5,2,146097,146097,146099,0,2,3
41681,4,1,146101,146101,146102,0,1,2
41682,6,3,146107,146107,146110,0,3,5
41683,5,3,146112,146112,146115,0,3,2
41684,1,3,146113,146115,146118,2,5,0
41685,5,2,146118,146118,146120,0,2,0
41686,4,2,146122,146122,146124,0,2,2
41687,6,2,146128,146128,146130,0,2,4
41688,1,2,146129,146130,146132,1,3,0
41689,3,3,146132,146132,146135,0,3,0
41690,3,2,146135,146135,146137,0,2,0
41691,3,3,146138,146138,146141,0,3,1
41692,5,3,146143,146143,146146,0,3,2
41693,5,2,146148,146148,146150,0,2,2
41694,2,1,146150,146150,146151,0,1,0
41695,2,2,146152,146152,146154,0,2,1
41696,6,1,146158,146158,146159,0,1,4
41697,2,2,146160,146160,146162,0,2,1
41698,6,1,146166,146166,146167,0,1,4
41699,4,1,146170,146170,146171,0,1,3
41700,3,1,146173,146173,146174,0,1,2
41701,1,1,146174,146174,146175,0,1,0
41702,2,2,146176,146176,146178,0,2,1
41703,3,2,146179,146179,146181,0,2,1
41704,5,2,146184,146184,146186,0,2,3
41705,4,2,146188,146188,146190,0,2,2
41706,3,2,146191,146191,146193,0,2,1
41707,4,1,146195,146195,146196,0,1,2
41708,5,2,146200,146200,146202,0,2,4
41709,2,1,146202,146202,146203,0,1,0
41710,4,1,146206,146206,146207,0,1,3
41711,6,1,146212,146212,146213,0,1,5
41712,4,3,146216,146216,146219,0,3,3
41713,3,3,146219,146219,146222,0,3,0
41714,2,3,146221,146222,146225,1,4,0
41715,6,3,146227,146227,146230,0,3,2
41716,6,1,146233,146233,146234,0,1,3
41717,6,2,146239,146239,146241,0,2,5
41718,1,1,146240,146241,146242,1,2,0
41719,5,1,146245,146245,146246,0,1,3
41720,4,3,146249,146249,146252,0,3,3
41721,2,3,146251,146252,146255,1,4,0
41722,5,2,146256,146256,146258,0,2,1
41723,6,3,146262,146262,146265,0,3,4
41724,2,3,146264,146265,146268,1,4,0
41725,3,2,146267,146268,146270,1,3,0
41726,3,3,146270,146270,146273,0,3,0
41727,5,2,146275,146275,146277,0,2,2
41728,2,3,146277,146277,146280,0,3,0
41729,1,3,146278,146280,146283,2,5,0
41730,3,3,146281,146283,146286,2,5,0
41731,1,3,146282,146286,146289,4,7,0
41732,4,2,146286,146289,146291,3,5,0
41733,5,1,146291,146291,146292,0,1,0
41734,4,2,146295,146295,146297,0,2,3
41735,5,1,146300,146300,146301,0,1,3
41736,5,2,146305,146305,146307,0,2,4
41737,2,1,146307,146307,146308,0,1,0
41738,6,2,146313,146313,146315,0,2,5
41739,1,3,146314,146315,146318,1,4,0
41740,5,2,146319,146319,146321,0,2,1
41741,1,1,146320,146321,146322,1,2,0
41742,5,3,146325,146325,146328,0,3,3
41743,2,3,146327,146328,146331,1,4,0
41744,5,3,146332,146332,146335,0,3,1
41745,5,1,146337,146337,146338,0,1,2
41746,6,3,146343,146343,146346,0,3,5
41747,4,3,146347,146347,146350,0,3,1
41748,1,3,146348,146350,146353,2,5,0
41749,3,2,146351,146353,146355,2,4,0
41750,1,3,146352,146355,146358,3,6,0
41751,4,1,146356,146358,146359,2,3,0
41752,5,3,146361,146361,146364,0,3,2
41753,3,2,146364,146364,146366,0,2,0
41754,5,2,146369,146369,146371,0,2,3
41755,1,2,146370,146371,146373,1,3,0
41756,5,3,146375,146375,146378,0,3,2
41757,1,3,146376,146378,146381,2,5,0
41758,4,2,146380,146381,146383,1,3,0
41759,5,2,146385,146385,146387,0,2,2
41760,2,2,146387,146387,146389,0,2,0
41761,4,1,146391,146391,146392,0,1,2
41762,2,1,146393,146393,146394,0,1,1
41763,3,3,146396,146396,146399,0,3,2
41764,1,3,146397,146399,146402,2,5,0
41765,1,1,146398,146402,146403,4,5,0
41766,3,3,146401,146403,146406,2,5,0
41767,6,1,146407,146407,146408,0,1,1
41768,1,1,146408,146408,146409,0,1,0
41769,3,3,146411,146411,146414,0,3,2
41770,3,3,146414,146414,146417,0,3,0
41771,5,1,146419,146419,146420,0,1,2
41772,2,2,146421,146421,146423,0,2,1
41773,4,3,146425,146425,146428,0,3,2
41774,6,2,146431,146431,146433,0,2,3
41775,5,1,146436,146436,146437,0,1,3
41776,1,2,146437,146437,146439,0,2,0
41777,1,2,146438,146439,146441,1,3,0
41778,3,3,146441,146441,146444,0,3,0
41779,3,2,146444,146444,146446,0,2,0
41780,4,2,146448,146448,146450,0,2,2
41781,2,3,146450,146450,146453,0,3,0
41782,3,1,146453,146453,146454,0,1,0
41783,3,1,146456,146456,146457,0,1,2
41784,5,3,146461,146461,146464,0,3,4
41785,1,3,146462,146464,146467,2,5,0
41786,6,3,146468,146468,146471,0,3,1
41787,5,1,146473,146473,146474,0,1,2
41788,6,3,146479,146479,146482,0,3,5
41789,3,3,146482,146482,146485,0,3,0
41790,6,2,146488,146488,146490,0,2,3
41791,2,1,146490,146490,146491,0,1,0
41792,1,3,146491,146491,146494,0,3,0
41793,6,1,146497,146497,146498,0,1,3
41794,6,2,146503,146503,146505,0,2,5
41795,6,1,146509,146509,146510,0,1,4
41796,1,1,146510,146510,146511,0,1,0
41797,4,1,146514,146514,146515,0,1,3
41798,4,3,146518,146518,146521,0,3,3
41799,4,3,146522,146522,146525,0,3,1
41800,1,1,146523,146525,146526,2,3,0
41801,3,2,146526,146526,146528,0,2,0
41802,4,3,146530,146530,146533,0,3,2
41803,3,1,146533,146533,146534,0,1,0
41804,6,3,146539,146539,146542,0,3,5
41805,6,2,146545,146545,146547,0,2,3
41806,2,2,146547,146547,146549,0,2,0
41807,4,3,146551,146551,146554,0,3,2
41808,5,1,146556,146556,146557,0,1,2
41809,3,2,146559,146559,146561,0,2,2
41810,2,1,146561,146561,146562,0,1,0
41811,5,1,146566,146566,146567,0,1,4
41812,2,1,146568,146568,146569,0,1,1
41813,4,3,146572,146572,146575,0,3,3
41814,2,1,146574,146575,146576,1,2,0
41815,4,1,146578,146578,146579,0,1,2
41816,5,3,146583,146583,146586,0,3,4
41817,4,1,146587,146587,146588,0,1,1
41818,2,2,146589,146589,146591,0,2,1
41819,2,3,146591,146591,146594,0,3,0
41820,1,1,146592,146594,146595,2,3,0
41821,1,3,146593,146595,146598,2,5,0
41822,2,3,146595,146598,146601,3,6,0
41823,3,1,146598,146601,146602,3,4,0
41824,3,1,146601,146602,146603,1,2,0
41825,6,3,146607,146607,146610,0,3,4
41826,4,2,146611,146611,146613,0,2,1
41827,6,1,146617,146617,146618,0,1,4
41828,2,1,146619,146619,146620,0,1,1
41829,4,1,146623,146623,146624,0,1,3
41830,6,3,146629,146629,146632,0,3,5
41831,3,1,146632,146632,146633,0,1,0
41832,1,2,146633,146633,146635,0,2,0
41833,2,3,146635,146635,146638,0,3,0
41834,5,1,146640,146640,146641,0,1,2
41835,5,1,146645,146645,146646,0,1,4
41836,2,2,146647,146647,146649,0,2,1
41837,6,3,146653,146653,146656,0,3,4
41838,1,1,146654,146656,146657,2,3,0
41839,6,1,146660,146660,146661,0,1,3
41840,1,3,146661,146661,146664,0,3,0
41841,1,2,146662,146664,146666,2,4,0
41842,3,1,146665,146666,146667,1,2,0
41843,5,3,146670,146670,146673,0,3,3
41844,3,3,146673,146673,146676,0,3,0
41845,3,3,146676,146676,146679,0,3,0
41846,3,3,146679,146679,146682,0,3,0
41847,6,2,146685,146685,146687,0,2,3
41848,4,3,146689,146689,146692,0,3,2
41849,4,3,146693,146693,146696,0,3,1
41850,6,1,146699,146699,146700,0,1,3
41851,2,3,146701,146701,146704,0,3,1
41852,2,1,146703,146704,146705,1,2,0
41853,6,3,146709,146709,146712,0,3,4
41854,6,1,146715,146715,146716,0,1,3
41855,2,2,146717,146717,146719,0,2,1
41856,3,2,146720,146720,146722,0,2,1
41857,6,1,146726,146726,146727,0,1,4
41858,4,3,146730,146730,146733,0,3,3
41859,2,1,146732,146733,146734,1,2,0
41860,5,2,146737,146737,146739,0,2,3
41861,3,3,146740,146740,146743,0,3,1
41862,3,1,146743,146743,146744,0,1,0
41863,4,1,146747,146747,146748,0,1,3
41864,4,3,146751,146751,146754,0,3,3
41865,2,1,146753,146754,146755,1,2,0
41866,1,2,146754,146755,146757,1,3,0
41867,6,2,146760,146760,146762,0,2,3
41868,1,2,146761,146762,146764,1,3,0
41869,1,2,146762,146764,146766,2,4,0
41870,1,2,146763,146766,146768,3,5,0
41871,3,1,146766,146768,146769,2,3,0
41872,1,1,146767,146769,146770,2,3,0
41873,1,3,146768,146770,146773,2,5,0
41874,2,1,146770,146773,146774,3,4,0
41875,6,2,146776,146776,146778,0,2,2
41876,1,1,146777,146778,146779,1,2,0
41877,3,3,146780,146780,146783,0,3,1
41878,2,3,146782,146783,146786,1,4,0
41879,2,2,146784,146786,146788,2,4,0
41880,5,3,146789,146789,146792,0,3,1
41881,6,2,146795,146795,146797,0,2,3
41882,5,2,146800,146800,146802,0,2,3
41883,5,3,146805,146805,146808,0,3,3
41884,3,1,146808,146808,146809,0,1,0
41885,3,3,146811,146811,146814,0,3,2
41886,2,2,146813,146814,146816,1,3,0
41887,6,2,146819,146819,146821,0,2,3
41888,3,1,146822,146822,146823,0,1,1
41889,2,1,146824,146824,146825,0,1,1
41890,2,1,146826,146826,146827,0,1,1
41891,2,1,146828,146828,146829,0,1,1
41892,2,1,146830,146830,146831,0,1,1
41893,6,1,146836,146836,146837,0,1,5
41894,5,3,146841,146841,146844,0,3,4
41895,3,2,146844,146844,146846,0,2,0
41896,1,1,146845,146846,146847,1,2,0
41897,1,3,146846,146847,146850,1,4,0
41898,5,3,146851,146851,146854,0,3,1
41899,4,1,146855,146855,146856,0,1,1
41900,2,2,146857,146857,146859,0,2,1
41901,6,2,146863,146863,146865,0,2,4
41902,4,1,146867,146867,146868,0,1,2
41903,5,1,146872,146872,146873,0,1,4
41904,2,2,146874,146874,146876,0,2,1
41905,4,1,146878,146878,146879,0,1,2
41906,4,2,146882,146882,146884,0,2,3
41907,2,1,146884,146884,146885,0,1,0
41908,2,3,146886,146886,146889,0,3,1
41909,2,2,146888,146889,146891,1,3,0
41910,4,2,146892,146892,146894,0,2,1
41911,3,3,146895,146895,146898,0,3,1
41912,4,1,146899,146899,146900,0,1,1
41913,5,2,146904,146904,146906,0,2,4
41914,6,2,146910,146910,146912,0,2,4
41915,6,3,146916,146916,146919,0,3,4
41916,2,3,146918,146919,146922,1,4,0
41917,5,3,146923,146923,146926,0,3,1
41918,4,1,146927,146927,146928,0,1,1
41919,6,1,146933,146933,146934,0,1,5
41920,4,2,146937,146937,146939,0,2,3
41921,5,3,146942,146942,146945,0,3,3
41922,5,1,146947,146947,146948,0,1,2
41923,4,2,146951,146951,146953,0,2,3
41924,1,1,146952,146953,146954,1,2,0
41925,2,1,146954,146954,146955,0,1,0
41926,5,3,146959,146959,146962,0,3,4
41927,3,1,146962,146962,146963,0,1,0
41928,5,3,146967,146967,146970,0,3,4
41929,2,3,146969,146970,146973,1,4,0
41930,2,3,146971,146973,146976,2,5,0
41931,3,3,146974,146976,146979,2,5,0
41932,3,1,146977,146979,146980,2,3,0
41933,4,1,146981,146981,146982,0,1,1
41934,3,2,146984,146984,146986,0,2,2
41935,6,2,146990,146990,146992,0,2,4
41936,1,2,146991,146992,146994,1,3,0
41937,1,2,146992,146994,146996,2,4,0
41938,5,2,146997,146997,146999,0,2,1
41939,5,3,147002,147002,147005,0,3,3
41940,4,2,147006,147006,147008,0,2,1
41941,1,2,147007,147008,147010,1,3,0
41942,5,3,147012,147012,147015,0,3,2
41943,5,2,147017,147017,147019,0,2,2
41944,3,3,147020,147020,147023,0,3,1
41945,5,2,147025,147025,147027,0,2,2
41946,6,2,147031,147031,147033,0,2,4
41947,4,1,147035,147035,147036,0,1,2
41948,6,2,147041,147041,147043,0,2,5
41949,1,3,147042,147043,147046,1,4,0
41950,4,2,147046,147046,147048,0,2,0
41951,4,2,147050,147050,147052,0,2,2
41952,2,3,147052,147052,147055,0,3,0
41953,1,3,147053,147055,147058,2,5,0
41954,2,2,147055,147058,147060,3,5,0
41955,2,1,147057,147060,147061,3,4,0
41956,4,2,147061,147061,147063,0,2,0
41957,2,3,147063,147063,147066,0,3,0
41958,4,2,147067,147067,147069,0,2,1
41959,4,2,147071,147071,147073,0,2,2
41960,3,2,147074,147074,147076,0,2,1
41961,1,1,147075,147076,147077,1,2,0
41962,5,3,147080,147080,147083,0,3,3
41963,5,1,147085,147085,147086,0,1,2
41964,4,2,147089,147089,147091,0,2,3
41965,1,1,147090,147091,147092,1,2,0
41966,6,3,147096,147096,147099,0,3,4
41967,3,3,147099,147099,147102,0,3,0
41968,3,2,147102,147102,147104,0,2,0
41969,6,3,147108,147108,147111,0,3,4
41970,5,2,147113,147113,147115,0,2,2
41971,1,1,147114,147115,147116,1,2,0
41972,4,1,147118,147118,147119,0,1,2
41973,3,2,147121,147121,147123,0,2,2
41974,5,3,147126,147126,147129,0,3,3
41975,6,1,147132,147132,147133,0,1,3
41976,3,2,147135,147135,147137,0,2,2
41977,6,2,147141,147141,147143,0,2,4
41978,3,3,147144,147144,147147,0,3,1
41979,1,1,147145,147147,147148,2,3,0
41980,3,3,147148,147148,147151,0,3,0
41981,5,2,147153,147153,147155,0,2,2
41982,6,1,147159,147159,147160,0,1,4
41983,3,1,147162,147162,147163,0,1,2
41984,3,2,147165,147165,147167,0,2,2
41985,6,3,147171,147171,147174,0,3,4
41986,5,1,147176,147176,147177,0,1,2
41987,4,3,147180,147180,147183,0,3,3
41988,1,1,147181,147183,147184,2,3,0
41989,4,3,147185,147185,147188,0,3,1
41990,4,3,147189,147189,147192,0,3,1
41991,5,3,147194,147194,147197,0,3,2
41992,1,2,147195,147197,147199,2,4,0
41993,1,2,147196,147199,147201,3,5,0
41994,5,3,147201,147201,147204,0,3,0
41995,2,3,147203,147204,147207,1,4,0
41996,6,3,147209,147209,147212,0,3,2
41997,5,3,147214,147214,147217,0,3,2
41998,3,2,147217,147217,147219,0,2,0
41999,4,1,147221,147221,147222,0,1,2
42000,6,1,147227,147227,147228,0,1,5
42001,2,1,147229,147229,147230,0,1,1
42002,6,3,147235,147235,147238,0,3,5
42003,4,2,147239,147239,147241,0,2,1
42004,3,1,147242,147242,147243,0,1,1
42005,3,1,147245,147245,147246,0,1,2
42006,6,2,147251,147251,147253,0,2,5
42007,1,3,147252,147253,147256,1,4,0
42008,2,3,147254,147256,147259,2,5,0
42009,3,3,147257,147259,147262,2,5,0
42010,3,1,147260,147262,147263,2,3,0
42011,3,3,147263,147263,147266,0,3,0
42012,1,1,147264,147266,147267,2,3,0
42013,2,1,147266,147267,147268,1,2,0
42014,2,3,147268,147268,147271,0,3,0
42015,4,3,147272,147272,147275,0,3,1
42016,2,1,147274,147275,147276,1,2,0
42017,3,1,147277,147277,147278,0,1,1
42018,3,1,147280,147280,147281,0,1,2
42019,3,3,147283,147283,147286,0,3,2
42020,2,1,147285,147286,147287,1,2,0
42021,6,1,147291,147291,147292,0,1,4
42022,5,1,147296,147296,147297,0,1,4
42023,3,2,147299,147299,147301,0,2,2
42024,6,1,147305,147305,147306,0,1,4
42025,3,1,147308,147308,147309,0,1,2
42026,2,1,147310,147310,147311,0,1,1
42027,6,2,147316,147316,147318,0,2,5
42028,4,1,147320,147320,147321,0,1,2
42029,1,2,147321,147321,147323,0,2,0
42030,1,1,147322,147323,147324,1,2,0
42031,2,1,147324,147324,147325,0,1,0
42032,5,1,147329,147329,147330,0,1,4
42033,6,3,147335,147335,147338,0,3,5
42034,3,1,147338,147338,147339,0,1,0
42035,6,1,147344,147344,147345,0,1,5
42036,6,3,147350,147350,147353,0,3,5
42037,4,1,147354,147354,147355,0,1,1
42038,3,3,147357,147357,147360,0,3,2
42039,3,2,147360,147360,147362,0,2,0
42040,5,1,147365,147365,147366,0,1,3
42041,3,2,147368,147368,147370,0,2,2
42042,2,1,147370,147370,147371,0,1,0
42043,2,3,147372,147372,147375,0,3,1
42044,6,1,147378,147378,147379,0,1,3
42045,2,3,147380,147380,147383,0,3,1
42046,1,3,147381,147383,147386,2,5,0
42047,1,1,147382,147386,147387,4,5,0
42048,5,2,147387,147387,147389,0,2,0
42049,4,2,147391,147391,147393,0,2,2
42050,3,1,147394,147394,147395,0,1,1
42051,5,3,147399,147399,147402,0,3,4
42052,5,3,147404,147404,147407,0,3,2
42053,5,1,147409,147409,147410,0,1,2
42054,1,1,147410,147410,147411,0,1,0
42055,2,3,147412,147412,147415,0,3,1
42056,1,1,147413,147415,147416,2,3,0
42057,3,3,147416,147416,147419,0,3,0
42058,6,1,147422,147422,147423,0,1,3
42059,1,3,147423,147423,147426,0,3,0
42060,3,2,147426,147426,147428,0,2,0
42061,5,3,147431,147431,147434,0,3,3
42062,1,3,147432,147434,147437,2,5,0
42063,4,1,147436,147437,147438,1,2,0
42064,1,2,147437,147438,147440,1,3,0
42065,6,3,147443,147443,147446,0,3,3
42066,2,3,147445,147446,147449,1,4,0
42067,2,3,147447,147449,147452,2,5,0
42068,6,1,147453,147453,147454,0,1,1
42069,1,1,147454,147454,147455,0,1,0
42070,4,2,147458,147458,147460,0,2,3
42071,1,3,147459,147460,147463,1,4,0
42072,3,3,147462,147463,147466,1,4,0
42073,1,2,147463,147466,147468,3,5,0
42074,2,2,147465,147468,147470,3,5,0
42075,3,3,147468,147470,147473,2,5,0
42076,2,2,147470,147473,147475,3,5,0
42077,6,1,147476,147476,147477,0,1,1
42078,2,2,147478,147478,147480,0,2,1
42079,6,2,147484,147484,147486,0,2,4
42080,3,2,147487,147487,147489,0,2,1
42081,5,1,147492,147492,147493,0,1,3
42082,2,1,147494,147494,147495,0,1,1
42083,1,3,147495,147495,147498,0,3,0
42084,6,1,147501,147501,147502,0,1,3
42085,5,1,147506,147506,147507,0,1,4
42086,2,2,147508,147508,147510,0,2,1
42087,1,1,147509,147510,147511,1,2,0
42088,3,1,147512,147512,147513,0,1,1
42089,1,3,147513,147513,147516,0,3,0
42090,3,2,147516,147516,147518,0,2,0
42091,4,1,147520,147520,147521,0,1,2
42092,1,1,147521,147521,147522,0,1,0
42093,6,1,147527,147527,147528,0,1,5
42094,5,2,147532,147532,147534,0,2,4
42095,4,1,147536,147536,147537,0,1,2
42096,5,3,147541,147541,147544,0,3,4
42097,5,2,147546,147546,147548,0,2,2
42098,6,3,147552,147552,147555,0,3,4
42099,1,1,147553,147555,147556,2,3,0
42100,6,3,147559,147559,147562,0,3,3
42101,4,3,147563,147563,147566,0,3,1
42102,3,1,147566,147566,147567,0,1,0
42103,6,1,147572,147572,147573,0,1,5
42104,6,2,147578,147578,147580,0,2,5
42105,4,2,147582,147582,147584,0,2,2
42106,4,2,147586,147586,147588,0,2,2
42107,3,3,147589,147589,147592,0,3,1
42108,6,3,147595,147595,147598,0,3,3
42109,2,1,147597,147598,147599,1,2,0
42110,5,2,147602,147602,147604,0,2,3
42111,6,1,147608,147608,147609,0,1,4
42112,5,1,147613,147613,147614,0,1,4
42113,1,3,147614,147614,147617,0,3,0
42114,1,2,147615,147617,147619,2,4,0
42115,2,2,147617,147619,147621,2,4,0
42116,5,2,147622,147622,147624,0,2,1
42117,5,3,147627,147627,147630,0,3,3
42118,1,1,147628,147630,147631,2,3,0
42119,2,2,147630,147631,147633,1,3,0
42120,3,3,147633,147633,147636,0,3,0
42121,2,3,147635,147636,147639,1,4,0
42122,1,1,147636,147639,147640,3,4,0
42123,5,1,147641,147641,147642,0,1,1
42124,4,3,147645,147645,147648,0,3,3
42125,3,3,147648,147648,147651,0,3,0
42126,6,3,147654,147654,147657,0,3,3
42127,4,3,147658,147658,147661,0,3,1
42128,1,3,147659,147661,147664,2,5,0
42129,1,3,147660,147664,147667,4,7,0
42130,6,3,147666,147667,147670,1,4,0
42131,1,1,147667,147670,147671,3,4,0
42132,5,2,147672,147672,147674,0,2,1
42133,6,3,147678,147678,147681,0,3,4
42134,3,3,147681,147681,147684,0,3,0
42135,2,2,147683,147684,147686,1,3,0
42136,1,3,147684,147686,147689,2,5,0
42137,1,2,147685,147689,147691,4,6,0
42138,5,1,147690,147691,147692,1,2,0
42139,1,1,147691,147692,147693,1,2,0
42140,2,1,147693,147693,147694,0,1,0
42141,2,3,147695,147695,147698,0,3,1
42142,4,3,147699,147699,147702,0,3,1
42143,4,3,147703,147703,147706,0,3,1
42144,4,2,147707,147707,147709,0,2,1
42145,5,3,147712,147712,147715,0,3,3
42146,6,3,147718,147718,147721,0,3,3
42147,5,3,147723,147723,147726,0,3,2
42148,6,1,147729,147729,147730,0,1,3
42149,5,3,147734,147734,147737,0,3,4
42150,2,3,147736,147737,147740,1,4,0
42151,6,3,147742,147742,147745,0,3,2
42152,5,2,147747,147747,147749,0,2,2
42153,5,2,147752,147752,147754,0,2,3
42154,3,2,147755,147755,147757,0,2,1
42155,4,1,147759,147759,147760,0,1,2
42156,2,2,147761,147761,147763,0,2,1
42157,6,1,147767,147767,147768,0,1,4
42158,4,1,147771,147771,147772,0,1,3
42159,6,1,147777,147777,147778,0,1,5
42160,3,1,147780,147780,147781,0,1,2
42161,3,3,147783,147783,147786,0,3,2
42162,3,3,147786,147786,147789,0,3,0
42163,6,2,147792,147792,147794,0,2,3
42164,3,1,147795,147795,147796,0,1,1
42165,1,3,147796,147796,147799,0,3,0
42166,4,3,147800,147800,147803,0,3,1
42167,4,1,147804,147804,147805,0,1,1
42168,1,2,147805,147805,147807,0,2,0
42169,1,3,147806,147807,147810,1,4,0
42170,3,2,147809,147810,147812,1,3,0
42171,2,3,147811,147812,147815,1,4,0
42172,3,1,147814,147815,147816,1,2,0
42173,5,3,147819,147819,147822,0,3,3
42174,6,1,147825,147825,147826,0,1,3
42175,6,1,147831,147831,147832,0,1,5
42176,5,3,147836,147836,147839,0,3,4
42177,5,3,147841,147841,147844,0,3,2
42178,3,1,147844,147844,147845,0,1,0
42179,1,2,147845,147845,147847,0,2,0
42180,4,2,147849,147849,147851,0,2,2
42181,2,2,147851,147851,147853,0,2,0
42182,3,1,147854,147854,147855,0,1,1
42183,5,1,147859,147859,147860,0,1,4
42184,5,3,147864,147864,147867,0,3,4
42185,6,3,147870,147870,147873,0,3,3
42186,1,2,147871,147873,147875,2,4,0
42187,5,1,147876,147876,147877,0,1,1
42188,5,1,147881,147881,147882,0,1,4
42189,5,2,147886,147886,147888,0,2,4
42190,2,2,147888,147888,147890,0,2,0
42191,5,2,147893,147893,147895,0,2,3
42192,4,3,147897,147897,147900,0,3,2
42193,3,3,147900,147900,147903,0,3,0
42194,6,1,147906,147906,147907,0,1,3
42195,2,2,147908,147908,147910,0,2,1
42196,6,2,147914,147914,147916,0,2,4
42197,2,1,147916,147916,147917,0,1,0
42198,2,1,147918,147918,147919,0,1,1
42199,2,2,147920,147920,147922,0,2,1
42200,4,2,147924,147924,147926,0,2,2
42201,6,1,147930,147930,147931,0,1,4
42202,5,1,147935,147935,147936,0,1,4
42203,1,1,147936,147936,147937,0,1,0
42204,3,3,147939,147939,147942,0,3,2
42205,6,1,147945,147945,147946,0,1,3
42206,3,1,147948,147948,147949,0,1,2
42207,2,1,147950,147950,147951,0,1,1
42208,4,2,147954,147954,147956,0,2,3
42209,3,1,147957,147957,147958,0,1,1
42210,1,1,147958,147958,147959,0,1,0
42211,5,2,147963,147963,147965,0,2,4
42212,3,3,147966,147966,147969,0,3,1
42213,4,1,147970,147970,147971,0,1,1
42214,1,2,147971,147971,147973,0,2,0
42215,1,1,147972,147973,147974,1,2,0
42216,1,2,147973,147974,147976,1,3,0
42217,3,3,147976,147976,147979,0,3,0
42218,6,2,147982,147982,147984,0,2,3
42219,2,1,147984,147984,147985,0,1,0
42220,3,3,147987,147987,147990,0,3,2
42221,4,3,147991,147991,147994,0,3,1
42222,6,3,147997,147997,148000,0,3,3
42223,6,2,148003,148003,148005,0,2,3
42224,4,2,148007,148007,148009,0,2,2
42225,5,2,148012,148012,148014,0,2,3
42226,1,2,148013,148014,148016,1,3,0
42227,2,1,148015,148016,148017,1,2,0
42228,2,2,148017,148017,148019,0,2,0
42229,5,1,148022,148022,148023,0,1,3
42230,4,2,148026,148026,148028,0,2,3
42231,2,1,148028,148028,148029,0,1,0
42232,6,3,148034,148034,148037,0,3,5
42233,3,1,148037,148037,148038,0,1,0
42234,4,3,148041,148041,148044,0,3,3
42235,3,3,148044,148044,148047,0,3,0
42236,4,3,148048,148048,148051,0,3,1
42237,1,2,148049,148051,148053,2,4,0
42238,3,2,148052,148053,148055,1,3,0
42239,6,1,148058,148058,148059,0,1,3
42240,4,3,148062,148062,148065,0,3,3
42241,1,3,148063,148065,148068,2,5,0
42242,3,1,148066,148068,148069,2,3,0
42243,1,1,148067,148069,148070,2,3,0
42244,2,1,148069,148070,148071,1,2,0
42245,5,3,148074,148074,148077,0,3,3
42246,4,3,148078,148078,148081,0,3,1
42247,2,2,148080,148081,148083,1,3,0
42248,6,1,148086,148086,148087,0,1,3
42249,1,2,148087,148087,148089,0,2,0
42250,5,1,148092,148092,148093,0,1,3
42251,2,1,148094,148094,148095,0,1,1
42252,5,2,148099,148099,148101,0,2,4
42253,3,2,148102,148102,148104,0,2,1
42254,1,1,148103,148104,148105,1,2,0
42255,1,3,148104,148105,148108,1,4,0
42256,6,3,148110,148110,148113,0,3,2
42257,1,2,148111,148113,148115,2,4,0
42258,1,2,148112,148115,148117,3,5,0
42259,4,1,148116,148117,148118,1,2,0
42260,1,2,148117,148118,148120,1,3,0
42261,3,2,148120,148120,148122,0,2,0
42262,3,2,148123,148123,148125,0,2,1
42263,1,3,148124,148125,148128,1,4,0
42264,1,3,148125,148128,148131,3,6,0
42265,2,1,148127,148131,148132,4,5,0
42266,6,2,148133,148133,148135,0,2,1
42267,3,2,148136,148136,148138,0,2,1
42268,1,3,148137,148138,148141,1,4,0
42269,2,1,148139,148141,148142,2,3,0
42270,6,3,148145,148145,148148,0,3,3
42271,5,1,148150,148150,148151,0,1,2
42272,5,1,148155,148155,148156,0,1,4
42273,3,2,148158,148158,148160,0,2,2
42274,6,3,148164,148164,148167,0,3,4
42275,2,1,148166,148167,148168,1,2,0
42276,5,2,148171,148171,148173,0,2,3
42277,4,1,148175,148175,148176,0,1,2
42278,4,2,148179,148179,148181,0,2,3
42279,6,2,148185,148185,148187,0,2,4
42280,3,3,148188,148188,148191,0,3,1
42281,3,1,148191,148191,148192,0,1,0
42282,5,2,148196,148196,148198,0,2,4
42283,2,1,148198,148198,148199,0,1,0
42284,5,1,148203,148203,148204,0,1,4
42285,1,2,148204,148204,148206,0,2,0
42286,4,1,148208,148208,148209,0,1,2
42287,2,1,148210,148210,148211,0,1,1
42288,1,2,148211,148211,148213,0,2,0
42289,5,1,148216,148216,148217,0,1,3
42290,3,2,148219,148219,148221,0,2,2
42291,6,2,148225,148225,148227,0,2,4
42292,4,1,148229,148229,148230,0,1,2
42293,1,3,148230,148230,148233,0,3,0
42294,6,2,148236,148236,148238,0,2,3
42295,5,3,148241,148241,148244,0,3,3
42296,2,1,148243,148244,148245,1,2,0
42297,6,3,148249,148249,148252,0,3,4
42298,1,2,148250,148252,148254,2,4,0
42299,2,1,148252,148254,148255,2,3,0
42300,1,3,148253,148255,148258,2,5,0
42301,5,1,148258,148258,148259,0,1,0
42302,2,2,148260,148260,148262,0,2,1
42303,6,1,148266,148266,148267,0,1,4
42304,4,2,148270,148270,148272,0,2,3
42305,6,1,148276,148276,148277,0,1,4
42306,4,1,148280,148280,148281,0,1,3
42307,6,1,148286,148286,148287,0,1,5
42308,3,2,148289,148289,148291,0,2,2
42309,4,2,148293,148293,148295,0,2,2
42310,6,1,148299,148299,148300,0,1,4
42311,3,2,148302,148302,148304,0,2,2
42312,4,1,148306,148306,148307,0,1,2
42313,4,1,148310,148310,148311,0,1,3
42314,1,2,148311,148311,148313,0,2,0
42315,2,1,148313,148313,148314,0,1,0
42316,4,1,148317,148317,148318,0,1,3
42317,4,1,148321,148321,148322,0,1,3
42318,2,2,148323,148323,148325,0,2,1
42319,2,1,148325,148325,148326,0,1,0
42320,4,1,148329,148329,148330,0,1,3
42321,2,3,148331,148331,148334,0,3,1
42322,6,2,148337,148337,148339,0,2,3
42323,5,1,148342,148342,148343,0,1,3
42324,3,3,148345,148345,148348,0,3,2
42325,5,3,148350,148350,148353,0,3,2
42326,3,2,148353,148353,148355,0,2,0
42327,3,1,148356,148356,148357,0,1,1
42328,2,2,148358,148358,148360,0,2,1
42329,2,1,148360,148360,148361,0,1,0
42330,1,1,148361,148361,148362,0,1,0
42331,2,1,148363,148363,148364,0,1,1
42332,3,3,148366,148366,148369,0,3,2
42333,3,3,148369,148369,148372,0,3,0
42334,3,1,148372,148372,148373,0,1,0
42335,5,2,148377,148377,148379,0,2,4
42336,6,3,148383,148383,148386,0,3,4
42337,5,3,148388,148388,148391,0,3,2
42338,1,3,148389,148391,148394,2,5,0
42339,5,3,148394,148394,148397,0,3,0
42340,1,2,148395,148397,148399,2,4,0
42341,4,1,148399,148399,148400,0,1,0
42342,4,2,148403,148403,148405,0,2,3
42343,1,1,148404,148405,148406,1,2,0
42344,4,1,148408,148408,148409,0,1,2
42345,1,3,148409,148409,148412,0,3,0
42346,5,2,148414,148414,148416,0,2,2
42347,1,2,148415,148416,148418,1,3,0
42348,6,3,148421,148421,148424,0,3,3
42349,2,3,148423,148424,148427,1,4,0
42350,2,3,148425,148427,148430,2,5,0
42351,3,3,148428,148430,148433,2,5,0
42352,1,1,148429,148433,148434,4,5,0
42353,3,1,148432,148434,148435,2,3,0
42354,5,1,148437,148437,148438,0,1,2
42355,4,1,148441,148441,148442,0,1,3
42356,1,3,148442,148442,148445,0,3,0
42357,3,2,148445,148445,148447,0,2,0
42358,5,1,148450,148450,148451,0,1,3
42359,3,1,148453,148453,148454,0,1,2
42360,1,3,148454,148454,148457,0,3,0
42361,1,3,148455,148457,148460,2,5,0
42362,2,1,148457,148460,148461,3,4,0
42363,3,1,148460,148461,148462,1,2,0
42364,2,3,148462,148462,148465,0,3,0
42365,2,3,148464,148465,148468,1,4,0
42366,3,1,148467,148468,148469,1,2,0
42367,4,1,148471,148471,148472,0,1,2
42368,4,3,148475,148475,148478,0,3,3
42369,1,3,148476,148478,148481,2,5,0
42370,2,1,148478,148481,148482,3,4,0
42371,5,3,148483,148483,148486,0,3,1
42372,6,2,148489,148489,148491,0,2,3
42373,2,1,148491,148491,148492,0,1,0
42374,6,2,148497,148497,148499,0,2,5
42375,5,2,148502,148502,148504,0,2,3
42376,4,2,148506,148506,148508,0,2,2
42377,5,3,148511,148511,148514,0,3,3
42378,1,3,148512,148514,148517,2,5,0
42379,4,1,148516,148517,148518,1,2,0
42380,5,1,148521,148521,148522,0,1,3
42381,4,3,148525,148525,148528,0,3,3
42382,6,3,148531,148531,148534,0,3,3
42383,4,1,148535,148535,148536,0,1,1
42384,1,2,148536,148536,148538,0,2,0
42385,1,1,148537,148538,148539,1,2,0
42386,5,1,148542,148542,148543,0,1,3
42387,2,2,148544,148544,148546,0,2,1
42388,2,3,148546,148546,148549,0,3,0
42389,6,3,148552,148552,148555,0,3,3
42390,2,2,148554,148555,148557,1,3,0
42391,5,3,148559,148559,148562,0,3,2
42392,4,2,148563,148563,148565,0,2,1
42393,1,3,148564,148565,148568,1,4,0
42394,2,3,148566,148568,148571,2,5,0
42395,2,1,148568,148571,148572,3,4,0
42396,2,3,148570,148572,148575,2,5,0
42397,5,2,148575,148575,148577,0,2,0
42398,1,3,148576,148577,148580,1,4,0
42399,2,2,148578,148580,148582,2,4,0
42400,1,3,148579,148582,148585,3,6,0
42401,1,1,148580,148585,148586,5,6,0
42402,3,1,148583,148586,148587,3,4,0
42403,5,1,148588,148588,148589,0,1,1
42404,3,2,148591,148591,148593,0,2,2
42405,4,2,148595,148595,148597,0,2,2
42406,2,2,148597,148597,148599,0,2,0
42407,4,2,148601,148601,148603,0,2,2
42408,5,2,148606,148606,148608,0,2,3
42409,3,3,148609,148609,148612,0,3,1
42410,6,1,148615,148615,148616,0,1,3
42411,2,1,148617,148617,148618,0,1,1
42412,6,1,148623,148623,148624,0,1,5
42413,6,2,148629,148629,148631,0,2,5
42414,2,3,148631,148631,148634,0,3,0
42415,2,1,148633,148634,148635,1,2,0
42416,3,1,148636,148636,148637,0,1,1
42417,4,3,148640,148640,148643,0,3,3
42418,3,2,148643,148643,148645,0,2,0
42419,6,3,148649,148649,148652,0,3,4
42420,4,1,148653,148653,148654,0,1,1
42421,4,2,148657,148657,148659,0,2,3
42422,5,2,148662,148662,148664,0,2,3
42423,3,1,148665,148665,148666,0,1,1
42424,2,2,148667,148667,148669,0,2,1
42425,1,3,148668,148669,148672,1,4,0
42426,3,2,148671,148672,148674,1,3,0
42427,3,2,148674,148674,148676,0,2,0
42428,5,2,148679,148679,148681,0,2,3
42429,2,3,148681,148681,148684,0,3,0
42430,5,2,148686,148686,148688,0,2,2
42431,2,3,148688,148688,148691,0,3,0
42432,1,2,148689,148691,148693,2,4,0
42433,2,3,148691,148693,148696,2,5,0
42434,4,3,148695,148696,148699,1,4,0
42435,3,2,148698,148699,148701,1,3,0
42436,4,2,148702,148702,148704,0,2,1
42437,4,3,148706,148706,148709,0,3,2
42438,2,1,148708,148709,148710,1,2,0
42439,3,3,148711,148711,148714,0,3,1
42440,6,3,148717,148717,148720,0,3,3
42441,2,2,148719,148720,148722,1,3,0
42442,2,3,148721,148722,148725,1,4,0
42443,4,1,148725,148725,148726,0,1,0
42444,4,2,148729,148729,148731,0,2,3
42445,4,3,148733,148733,148736,0,3,2
42446,2,3,148735,148736,148739,1,4,0
42447,5,3,148740,148740,148743,0,3,1
42448,6,2,148746,148746,148748,0,2,3
42449,3,1,148749,148749,148750,0,1,1
42450,1,3,148750,148750,148753,0,3,0
42451,1,1,148751,148753,148754,2,3,0
42452,4,2,148755,148755,148757,0,2,1
42453,1,2,148756,148757,148759,1,3,0
42454,5,2,148761,148761,148763,0,2,2
42455,1,1,148762,148763,148764,1,2,0
42456,6,1,148768,148768,148769,0,1,4
42457,1,1,148769,148769,148770,0,1,0
42458,6,2,148775,148775,148777,0,2,5
42459,3,3,148778,148778,148781,0,3,1
42460,1,2,148779,148781,148783,2,4,0
42461,3,3,148782,148783,148786,1,4,0
42462,3,3,148785,148786,148789,1,4,0
42463,6,3,148791,148791,148794,0,3,2
42464,3,1,148794,148794,148795,0,1,0
42465,3,2,148797,148797,148799,0,2,2
42466,6,2,148803,148803,148805,0,2,4
42467,1,3,148804,148805,148808,1,4,0
42468,3,2,148807,148808,148810,1,3,0
42469,5,2,148812,148812,148814,0,2,2
42470,2,3,148814,148814,148817,0,3,0
42471,3,1,148817,148817,148818,0,1,0
42472,1,3,148818,148818,148821,0,3,0
42473,5,1,148823,148823,148824,0,1,2
42474,1,3,148824,148824,148827,0,3,0
42475,6,1,148830,148830,148831,0,1,3
42476,6,3,148836,148836,148839,0,3,5
42477,2,3,148838,148839,148842,1,4,0
42478,5,1,148843,148843,148844,0,1,1
42479,3,1,148846,148846,148847,0,1,2
42480,5,3,148851,148851,148854,0,3,4
42481,1,1,148852,148854,148855,2,3,0
42482,6,2,148858,148858,148860,0,2,3
42483,6,1,148864,148864,148865,0,1,4
42484,4,1,148868,148868,148869,0,1,3
42485,4,1,148872,148872,148873,0,1,3
42486,1,2,148873,148873,148875,0,2,0
42487,1,3,148874,148875,148878,1,4,0
42488,3,1,148877,148878,148879,1,2,0
42489,6,3,148883,148883,148886,0,3,4
42490,5,1,148888,148888,148889,0,1,2
42491,1,1,148889,148889,148890,0,1,0
42492,4,3,148893,148893,148896,0,3,3
42493,3,2,148896,148896,148898,0,2,0
42494,6,2,148902,148902,148904,0,2,4
42495,6,1,148908,148908,148909,0,1,4
42496,1,3,148909,148909,148912,0,3,0
42497,6,1,148915,148915,148916,0,1,3
42498,6,3,148921,148921,148924,0,3,5
42499,6,3,148927,148927,148930,0,3,3
42500,4,2,148931,148931,148933,0,2,1
42501,1,3,148932,148933,148936,1,4,0
42502,6,1,148938,148938,148939,0,1,2
42503,6,3,148944,148944,148947,0,3,5
42504,1,2,148945,148947,148949,2,4,0
42505,2,3,148947,148949,148952,2,5,0
42506,1,3,148948,148952,148955,4,7,0
42507,1,3,148949,148955,148958,6,9,0
42508,6,1,148955,148958,148959,3,4,0
42509,4,2,148959,148959,148961,0,2,0
42510,6,2,148965,148965,148967,0,2,4
42511,6,3,148971,148971,148974,0,3,4
42512,2,1,148973,148974,148975,1,2,0
42513,6,3,148979,148979,148982,0,3,4
42514,3,1,148982,148982,148983,0,1,0
42515,2,3,148984,148984,148987,0,3,1
42516,3,1,148987,148987,148988,0,1,0
42517,2,3,148989,148989,148992,0,3,1
42518,3,2,148992,148992,148994,0,2,0
42519,3,3,148995,148995,148998,0,3,1
42520,3,1,148998,148998,148999,0,1,0
42521,4,2,149002,149002,149004,0,2,3
42522,1,2,149003,149004,149006,1,3,0
42523,2,2,149005,149006,149008,1,3,0
42524,3,3,149008,149008,149011,0,3,0
42525,2,1,149010,149011,149012,1,2,0
42526,5,1,149015,149015,149016,0,1,3
42527,3,2,149018,149018,149020,0,2,2
42528,2,2,149020,149020,149022,0,2,0
42529,1,3,149021,149022,149025,1,4,0
42530,2,2,149023,149025,149027,2,4,0
42531,3,2,149026,149027,149029,1,3,0
42532,5,1,149031,149031,149032,0,1,2
42533,5,1,149036,149036,149037,0,1,4
42534,5,2,149041,149041,149043,0,2,4
42535,4,2,149045,149045,149047,0,2,2
42536,4,3,149049,149049,149052,0,3,2
42537,4,2,149053,149053,149055,0,2,1
42538,6,1,149059,149059,149060,0,1,4
42539,1,3,149060,149060,149063,0,3,0
42540,3,2,149063,149063,149065,0,2,0
42541,3,1,149066,149066,149067,0,1,1
42542,3,2,149069,149069,149071,0,2,2
42543,1,3,149070,149071,149074,1,4,0
42544,4,3,149074,149074,149077,0,3,0
42545,3,3,149077,149077,149080,0,3,0
42546,2,3,149079,149080,149083,1,4,0
42547,6,3,149085,149085,149088,0,3,2
42548,4,2,149089,149089,149091,0,2,1
42549,6,2,149095,149095,149097,0,2,4
42550,4,3,149099,149099,149102,0,3,2
42551,2,3,149101,149102,149105,1,4,0
42552,1,1,149102,149105,149106,3,4,0
42553,3,1,149105,149106,149107,1,2,0
42554,2,3,149107,149107,149110,0,3,0
42555,4,1,149111,149111,149112,0,1,1
42556,4,1,149115,149115,149116,0,1,3
42557,1,3,149116,149116,149119,0,3,0
42558,1,3,149117,149119,149122,2,5,0
42559,1,2,149118,149122,149124,4,6,0
42560,3,1,149121,149124,149125,3,4,0
42561,1,3,149122,149125,149128,3,6,0
42562,1,3,149123,149128,149131,5,8,0
42563,3,2,149126,149131,149133,5,7,0
42564,5,3,149131,149133,149136,2,5,0
42565,5,1,149136,149136,149137,0,1,0
42566,2,1,149138,149138,149139,0,1,1
42567,6,2,149144,149144,149146,0,2,5
42568,2,3,149146,149146,149149,0,3,0
42569,4,2,149150,149150,149152,0,2,1
42570,3,3,149153,149153,149156,0,3,1
42571,1,2,149154,149156,149158,2,4,0
42572,6,3,149160,149160,149163,0,3,2
42573,5,2,149165,149165,149167,0,2,2
42574,2,3,149167,149167,149170,0,3,0
42575,1,3,149168,149170,149173,2,5,0
42576,4,2,149172,149173,149175,1,3,0
42577,2,2,149174,149175,149177,1,3,0
42578,4,2,149178,149178,149180,0,2,1
42579,3,3,149181,149181,149184,0,3,1
42580,1,2,149182,149184,149186,2,4,0
42581,6,3,149188,149188,149191,0,3,2
42582,3,2,149191,149191,149193,0,2,0
42583,6,2,149197,149197,149199,0,2,4
42584,5,1,149202,149202,149203,0,1,3
42585,5,1,149207,149207,149208,0,1,4
42586,4,1,149211,149211,149212,0,1,3
42587,2,1,149213,149213,149214,0,1,1
42588,6,2,149219,149219,149221,0,2,5
42589,6,1,149225,149225,149226,0,1,4
42590,6,1,149231,149231,149232,0,1,5
42591,6,2,149237,149237,149239,0,2,5
42592,4,3,149241,149241,149244,0,3,2
42593,4,1,149245,149245,149246,0,1,1
42594,1,3,149246,149246,149249,0,3,0
42595,3,3,149249,149249,149252,0,3,0
42596,3,2,149252,149252,149254,0,2,0
42597,5,1,149257,149257,149258,0,1,3
42598,6,3,149263,149263,149266,0,3,5
42599,5,2,149268,149268,149270,0,2,2
42600,5,2,149273,149273,149275,0,2,3
42601,1,3,149274,149275,149278,1,4,0
42602,4,3,149278,149278,149281,0,3,0
42603,1,1,149279,149281,149282,2,3,0
42604,4,2,149283,149283,149285,0,2,1
42605,1,2,149284,149285,149287,1,3,0
42606,6,2,149290,149290,149292,0,2,3
42607,1,2,149291,149292,149294,1,3,0
42608,4,1,149295,149295,149296,0,1,1
42609,1,1,149296,149296,149297,0,1,0
42610,5,3,149301,149301,149304,0,3,4
42611,3,1,149304,149304,149305,0,1,0
42612,6,3,149310,149310,149313,0,3,5
42613,1,2,149311,149313,149315,2,4,0
42614,3,1,149314,149315,149316,1,2,0
42615,5,3,149319,149319,149322,0,3,3
42616,6,3,149325,149325,149328,0,3,3
42617,4,3,149329,149329,149332,0,3,1
42618,1,2,149330,149332,149334,2,4,0
42619,3,2,149333,149334,149336,1,3,0
42620,1,2,149334,149336,149338,2,4,0
42621,3,3,149337,149338,149341,1,4,0
42622,4,2,149341,149341,149343,0,2,0
42623,2,2,149343,149343,149345,0,2,0
42624,6,1,149349,149349,149350,0,1,4
42625,6,2,149355,149355,149357,0,2,5
42626,1,2,149356,149357,149359,1,3,0
42627,3,2,149359,149359,149361,0,2,0
42628,5,2,149364,149364,149366,0,2,3
42629,5,1,149369,149369,149370,0,1,3
42630,5,1,149374,149374,149375,0,1,4
42631,2,2,149376,149376,149378,0,2,1
42632,4,2,149380,149380,149382,0,2,2
42633,6,3,149386,149386,149389,0,3,4
42634,2,1,149388,149389,149390,1,2,0
42635,3,3,149391,149391,149394,0,3,1
42636,6,1,149397,149397,149398,0,1,3
42637,5,1,149402,149402,149403,0,1,4
42638,6,1,149408,149408,149409,0,1,5
42639,6,2,149414,149414,149416,0,2,5
42640,2,3,149416,149416,149419,0,3,0
42641,3,1,149419,149419,149420,0,1,0
42642,2,3,149421,149421,149424,0,3,1
42643,2,1,149423,149424,149425,1,2,0
42644,3,3,149426,149426,149429,0,3,1
42645,5,1,149431,149431,149432,0,1,2
42646,1,1,149432,149432,149433,0,1,0
42647,3,2,149435,149435,149437,0,2,2
42648,1,2,149436,149437,149439,1,3,0
42649,6,3,149442,149442,149445,0,3,3
42650,4,1,149446,149446,149447,0,1,1
42651,3,2,149449,149449,149451,0,2,2
42652,5,2,149454,149454,149456,0,2,3
42653,5,2,149459,149459,149461,0,2,3
42654,5,2,149464,149464,149466,0,2,3
42655,5,2,149469,149469,149471,0,2,3
42656,2,3,149471,149471,149474,0,3,0
42657,3,3,149474,149474,149477,0,3,0
42658,5,1,149479,149479,149480,0,1,2
42659,4,3,149483,149483,149486,0,3,3
42660,1,2,149484,149486,149488,2,4,0
42661,6,1,149490,149490,149491,0,1,2
42662,6,3,149496,149496,149499,0,3,5
42663,4,1,149500,149500,149501,0,1,1
42664,2,1,149502,149502,149503,0,1,1
42665,5,3,149507,149507,149510,0,3,4
42666,4,2,149511,149511,149513,0,2,1
42667,1,1,149512,149513,149514,1,2,0
42668,5,2,149517,149517,149519,0,2,3
42669,5,2,149522,149522,149524,0,2,3
42670,3,1,149525,149525,149526,0,1,1
42671,3,3,149528,149528,149531,0,3,2
42672,6,1,149534,149534,149535,0,1,3
42673,1,1,149535,149535,149536,0,1,0
42674,2,3,149537,149537,149540,0,3,1
42675,5,1,149542,149542,149543,0,1,2
42676,2,1,149544,149544,149545,0,1,1
42677,2,2,149546,149546,149548,0,2,1
42678,2,2,149548,149548,149550,0,2,0
42679,1,1,149549,149550,149551,1,2,0
42680,6,3,149555,149555,149558,0,3,4
42681,1,1,149556,149558,149559,2,3,0
42682,5,3,149561,149561,149564,0,3,2
42683,4,2,149565,149565,149567,0,2,1
42684,4,3,149569,149569,149572,0,3,2
42685,6,2,149575,149575,149577,0,2,3
42686,4,3,149579,149579,149582,0,3,2
42687,6,1,149585,149585,149586,0,1,3
42688,6,3,149591,149591,149594,0,3,5
42689,3,1,149594,149594,149595,0,1,0
42690,3,1,149597,149597,149598,0,1,2
42691,2,3,149599,149599,149602,0,3,1
42692,1,1,149600,149602,149603,2,3,0
42693,4,1,149604,149604,149605,0,1,1
42694,3,1,149607,149607,149608,0,1,2
42695,2,3,149609,149609,149612,0,3,1
42696,2,2,149611,149612,149614,1,3,0
42697,4,2,149615,149615,149617,0,2,1
42698,4,1,149619,149619,149620,0,1,2
42699,4,2,149623,149623,149625,0,2,3
42700,6,1,149629,149629,149630,0,1,4
42701,5,2,149634,149634,149636,0,2,4
42702,1,2,149635,149636,149638,1,3,0
42703,5,2,149640,149640,149642,0,2,2
42704,5,3,149645,149645,149648,0,3,3
42705,4,1,149649,149649,149650,0,1,1
42706,6,3,149655,149655,149658,0,3,5
42707,3,3,149658,149658,149661,0,3,0
42708,1,1,149659,149661,149662,2,3,0
42709,6,3,149665,149665,149668,0,3,3
42710,3,1,149668,149668,149669,0,1,0
42711,3,2,149671,149671,149673,0,2,2
42712,1,1,149672,149673,149674,1,2,0
42713,3,3,149675,149675,149678,0,3,1
42714,4,2,149679,149679,149681,0,2,1
42715,3,3,149682,149682,149685,0,3,1
42716,4,1,149686,149686,149687,0,1,1
42717,4,1,149690,149690,149691,0,1,3
42718,4,1,149694,149694,149695,0,1,3
42719,3,1,149697,149697,149698,0,1,2
42720,4,3,149701,149701,149704,0,3,3
42721,2,1,149703,149704,149705,1,2,0
42722,3,1,149706,149706,149707,0,1,1
42723,2,2,149708,149708,149710,0,2,1
42724,2,1,149710,149710,149711,0,1,0
42725,4,2,149714,149714,149716,0,2,3
42726,5,2,149719,149719,149721,0,2,3
42727,2,2,149721,149721,149723,0,2,0
42728,3,3,149724,149724,149727,0,3,1
42729,5,2,149729,149729,149731,0,2,2
42730,3,1,149732,149732,149733,0,1,1
42731,4,2,149736,149736,149738,0,2,3
42732,1,3,149737,149738,149741,1,4,0
42733,2,2,149739,149741,149743,2,4,0
42734,5,2,149744,149744,149746,0,2,1
42735,3,1,149747,149747,149748,0,1,1
42736,5,1,149752,149752,149753,0,1,4
42737,2,3,149754,149754,149757,0,3,1
42738,5,3,149759,149759,149762,0,3,2
42739,4,3,149763,149763,149766,0,3,1
42740,4,3,149767,149767,149770,0,3,1
42741,5,2,149772,149772,149774,0,2,2
42742,5,2,149777,149777,149779,0,2,3
42743,5,2,149782,149782,149784,0,2,3
42744,1,2,149783,149784,149786,1,3,0
42745,5,2,149788,149788,149790,0,2,2
42746,5,2,149793,149793,149795,0,2,3
42747,3,3,149796,149796,149799,0,3,1
42748,3,3,149799,149799,149802,0,3,0
42749,5,1,149804,149804,149805,0,1,2
42750,4,1,149808,149808,149809,0,1,3
42751,3,1,149811,149811,149812,0,1,2
42752,2,3,149813,149813,149816,0,3,1
42753,6,1,149819,149819,149820,0,1,3
42754,3,1,149822,149822,149823,0,1,2
42755,4,3,149826,149826,149829,0,3,3
42756,2,1,149828,149829,149830,1,2,0
42757,1,2,149829,149830,149832,1,3,0
42758,5,2,149834,149834,149836,0,2,2
42759,6,3,149840,149840,149843,0,3,4
42760,6,1,149846,149846,149847,0,1,3
42761,4,2,149850,149850,149852,0,2,3
42762,2,1,149852,149852,149853,0,1,0
42763,4,1,149856,149856,149857,0,1,3
42764,4,2,149860,149860,149862,0,2,3
42765,2,2,149862,149862,149864,0,2,0
42766,5,1,149867,149867,149868,0,1,3
42767,6,2,149873,149873,149875,0,2,5
42768,5,1,149878,149878,149879,0,1,3
42769,5,2,149883,149883,149885,0,2,4
42770,5,3,149888,149888,149891,0,3,3
42771,3,1,149891,149891,149892,0,1,0
42772,6,3,149897,149897,149900,0,3,5
42773,4,1,149901,149901,149902,0,1,1
42774,3,3,149904,149904,149907,0,3,2
42775,2,3,149906,149907,149910,1,4,0
42776,4,3,149910,149910,149913,0,3,0
42777,4,2,149914,149914,149916,0,2,1
42778,2,2,149916,149916,149918,0,2,0
42779,5,2,149921,149921,149923,0,2,3
42780,2,3,149923,149923,149926,0,3,0
42781,6,2,149929,149929,149931,0,2,3
42782,6,3,149935,149935,149938,0,3,4
42783,6,1,149941,149941,149942,0,1,3
42784,6,2,149947,149947,149949,0,2,5
42785,6,2,149953,149953,149955,0,2,4
42786,5,3,149958,149958,149961,0,3,3
42787,2,1,149960,149961,149962,1,2,0
42788,4,2,149964,149964,149966,0,2,2
42789,5,2,149969,149969,149971,0,2,3
42790,2,1,149971,149971,149972,0,1,0
42791,5,1,149976,149976,149977,0,1,4
42792,5,2,149981,149981,149983,0,2,4
42793,2,1,149983,149983,149984,0,1,0
42794,3,1,149986,149986,149987,0,1,2
42795,2,3,149988,149988,149991,0,3,1
42796,6,3,149994,149994,149997,0,3,3
42797,4,2,149998,149998,150000,0,2,1
42798,6,2,150004,150004,150006,0,2,4
42799,6,3,150010,150010,150013,0,3,4
42800,4,2,150014,150014,150016,0,2,1
42801,3,3,150017,150017,150020,0,3,1
42802,1,1,150018,150020,150021,2,3,0
42803,5,3,150023,150023,150026,0,3,2
42804,2,1,150025,150026,150027,1,2,0
42805,2,1,150027,150027,150028,0,1,0
42806,2,2,150029,150029,150031,0,2,1
42807,5,3,150034,150034,150037,0,3,3
42808,4,1,150038,150038,150039,0,1,1
42809,3,1,150041,150041,150042,0,1,2
42810,6,1,150047,150047,150048,0,1,5
42811,3,1,150050,150050,150051,0,1,2
42812,2,3,150052,150052,150055,0,3,1
42813,6,3,150058,150058,150061,0,3,3
42814,5,3,150063,150063,150066,0,3,2
42815,6,2,150069,150069,150071,0,2,3
42816,6,3,150075,150075,150078,0,3,4
42817,3,2,150078,150078,150080,0,2,0
42818,3,3,150081,150081,150084,0,3,1
42819,1,3,150082,150084,150087,2,5,0
42820,2,3,150084,150087,150090,3,6,0
42821,3,1,150087,150090,150091,3,4,0
42822,1,1,150088,150091,150092,3,4,0
42823,2,2,150090,150092,150094,2,4,0
42824,3,3,150093,150094,150097,1,4,0
42825,1,3,150094,150097,150100,3,6,0
42826,1,2,150095,150100,150102,5,7,0
42827,6,3,150101,150102,150105,1,4,0
42828,4,2,150105,150105,150107,0,2,0
42829,4,1,150109,150109,150110,0,1,2
42830,3,2,150112,150112,150114,0,2,2
42831,2,3,150114,150114,150117,0,3,0
42832,2,3,150116,150117,150120,1,4,0
42833,4,2,150120,150120,150122,0,2,0
42834,1,3,150121,150122,150125,1,4,0
42835,1,2,150122,150125,150127,3,5,0
42836,1,2,150123,150127,150129,4,6,0
42837,6,3,150129,150129,150132,0,3,0
42838,2,2,150131,150132,150134,1,3,0
42839,2,3,150133,150134,150137,1,4,0
42840,5,3,150138,150138,150141,0,3,1
42841,4,1,150142,150142,150143,0,1,1
42842,2,3,150144,150144,150147,0,3,1
42843,6,3,150150,150150,150153,0,3,3
42844,1,2,150151,150153,150155,2,4,0
42845,6,3,150157,150157,150160,0,3,2
42846,5,1,150162,150162,150163,0,1,2
42847,4,3,150166,150166,150169,0,3,3
42848,1,3,150167,150169,150172,2,5,0
42849,4,2,150171,150172,150174,1,3,0
42850,6,3,150177,150177,150180,0,3,3
42851,4,3,150181,150181,150184,0,3,1
42852,6,3,150187,150187,150190,0,3,3
42853,2,3,150189,150190,150193,1,4,0
42854,6,3,150195,150195,150198,0,3,2
42855,6,3,150201,150201,150204,0,3,3
42856,6,1,150207,150207,150208,0,1,3
42857,6,1,150213,150213,150214,0,1,5
42858,3,2,150216,150216,150218,0,2,2
42859,1,1,150217,150218,150219,1,2,0
42860,2,2,150219,150219,150221,0,2,0
42861,4,2,150223,150223,150225,0,2,2
42862,1,2,150224,150225,150227,1,3,0
42863,1,1,150225,150227,150228,2,3,0
42864,2,2,150227,150228,150230,1,3,0
42865,2,1,150229,150230,150231,1,2,0
42866,6,2,150235,150235,150237,0,2,4
42867,1,1,150236,150237,150238,1,2,0
42868,3,1,150239,150239,150240,0,1,1
42869,3,3,150242,150242,150245,0,3,2
42870,6,1,150248,150248,150249,0,1,3
42871,2,2,150250,150250,150252,0,2,1
42872,2,1,150252,150252,150253,0,1,0
42873,1,3,150253,150253,150256,0,3,0
42874,2,3,150255,150256,150259,1,4,0
42875,1,2,150256,150259,150261,3,5,0
42876,5,2,150261,150261,150263,0,2,0
42877,4,1,150265,150265,150266,0,1,2
42878,2,3,150267,150267,150270,0,3,1
42879,1,1,150268,150270,150271,2,3,0
42880,6,3,150274,150274,150277,0,3,3
42881,1,2,150275,150277,150279,2,4,0
42882,2,2,150277,150279,150281,2,4,0
42883,3,3,150280,150281,150284,1,4,0
42884,1,3,150281,150284,150287,3,6,0
42885,1,3,150282,150287,150290,5,8,0
42886,3,2,150285,150290,150292,5,7,0
42887,6,3,150291,150292,150295,1,4,0
42888,2,2,150293,150295,150297,2,4,0
42889,6,1,150299,150299,150300,0,1,2
42890,4,1,150303,150303,150304,0,1,3
42891,3,2,150306,150306,150308,0,2,2
42892,3,1,150309,150309,150310,0,1,1
42893,5,2,150314,150314,150316,0,2,4
42894,2,1,150316,150316,150317,0,1,0
42895,4,2,150320,150320,150322,0,2,3
42896,5,2,150325,150325,150327,0,2,3
42897,3,2,150328,150328,150330,0,2,1
42898,5,3,150333,150333,150336,0,3,3
42899,2,1,150335,150336,150337,1,2,0
42900,2,3,150337,150337,150340,0,3,0
42901,1,2,150338,150340,150342,2,4,0
42902,4,3,150342,150342,150345,0,3,0
42903,4,3,150346,150346,150349,0,3,1
42904,1,1,150347,150349,150350,2,3,0
42905,1,2,150348,150350,150352,2,4,0
42906,1,3,150349,150352,150355,3,6,0
42907,1,2,150350,150355,150357,5,7,0
42908,2,3,150352,150357,150360,5,8,0
42909,1,1,150353,150360,150361,7,8,0
42910,4,3,150357,150361,150364,4,7,0
42911,1,1,150358,150364,150365,6,7,0
42912,3,1,150361,150365,150366,4,5,0
42913,1,1,150362,150366,150367,4,5,0
42914,5,3,150367,150367,150370,0,3,0
42915,4,3,150371,150371,150374,0,3,1
42916,2,2,150373,150374,150376,1,3,0
42917,4,3,150377,150377,150380,0,3,1
42918,5,3,150382,150382,150385,0,3,2
42919,4,3,150386,150386,150389,0,3,1
42920,5,3,150391,150391,150394,0,3,2
42921,5,2,150396,150396,150398,0,2,2
42922,4,2,150400,150400,150402,0,2,2
42923,3,2,150403,150403,150405,0,2,1
42924,2,1,150405,150405,150406,0,1,0
42925,2,2,150407,150407,150409,0,2,1
42926,3,3,150410,150410,150413,0,3,1
42927,5,1,150415,150415,150416,0,1,2
42928,2,2,150417,150417,150419,0,2,1
42929,1,2,150418,150419,150421,1,3,0
42930,5,3,150423,150423,150426,0,3,2
42931,1,2,150424,150426,150428,2,4,0
42932,5,2,150429,150429,150431,0,2,1
42933,1,2,150430,150431,150433,1,3,0
42934,6,3,150436,150436,150439,0,3,3
42935,2,1,150438,150439,150440,1,2,0
42936,1,1,150439,150440,150441,1,2,0
42937,3,2,150442,150442,150444,0,2,1
42938,3,3,150445,150445,150448,0,3,1
42939,3,3,150448,150448,150451,0,3,0
42940,6,3,150454,150454,150457,0,3,3
42941,4,1,150458,150458,150459,0,1,1
42942,1,1,150459,150459,150460,0,1,0
42943,4,1,150463,150463,150464,0,1,3
42944,4,3,150467,150467,150470,0,3,3
42945,4,1,150471,150471,150472,0,1,1
42946,4,2,150475,150475,150477,0,2,3
42947,3,3,150478,150478,150481,0,3,1
42948,6,1,150484,150484,150485,0,1,3
42949,3,3,150487,150487,150490,0,3,2
42950,2,3,150489,150490,150493,1,4,0
42951,5,2,150494,150494,150496,0,2,1
42952,2,1,150496,150496,150497,0,1,0
42953,4,3,150500,150500,150503,0,3,3
42954,3,3,150503,150503,150506,0,3,0
42955,2,3,150505,150506,150509,1,4,0
42956,1,3,150506,150509,150512,3,6,0
42957,2,1,150508,150512,150513,4,5,0
42958,4,1,150512,150513,150514,1,2,0
42959,6,2,150518,150518,150520,0,2,4
42960,6,3,150524,150524,150527,0,3,4
42961,3,3,150527,150527,150530,0,3,0
42962,2,3,150529,150530,150533,1,4,0
42963,1,2,150530,150533,150535,3,5,0
42964,3,1,150533,150535,150536,2,3,0
42965,5,1,150538,150538,150539,0,1,2
42966,6,1,150544,150544,150545,0,1,5
42967,5,2,150549,150549,150551,0,2,4
42968,1,3,150550,150551,150554,1,4,0
42969,5,1,150555,150555,150556,0,1,1
42970,6,3,150561,150561,150564,0,3,5
42971,2,3,150563,150564,150567,1,4,0
42972,4,2,150567,150567,150569,0,2,0
42973,6,1,150573,150573,150574,0,1,4
42974,4,2,150577,150577,150579,0,2,3
42975,4,3,150581,150581,150584,0,3,2
42976,4,1,150585,150585,150586,0,1,1
42977,2,2,150587,150587,150589,0,2,1
42978,2,3,150589,150589,150592,0,3,0
42979,4,1,150593,150593,150594,0,1,1
42980,6,3,150599,150599,150602,0,3,5
42981,5,2,150604,150604,150606,0,2,2
42982,4,3,150608,150608,150611,0,3,2
42983,3,3,150611,150611,150614,0,3,0
42984,5,3,150616,150616,150619,0,3,2
42985,6,2,150622,150622,150624,0,2,3
42986,4,3,150626,150626,150629,0,3,2
42987,5,1,150631,150631,150632,0,1,2
42988,6,2,150637,150637,150639,0,2,5
42989,1,2,150638,150639,150641,1,3,0
42990,1,1,150639,150641,150642,2,3,0
42991,3,1,150642,150642,150643,0,1,0
42992,1,1,150643,150643,150644,0,1,0
42993,4,2,150647,150647,150649,0,2,3
42994,2,3,150649,150649,150652,0,3,0
42995,4,1,150653,150653,150654,0,1,1
42996,3,3,150656,150656,150659,0,3,2
42997,2,1,150658,150659,150660,1,2,0
42998,1,2,150659,150660,150662,1,3,0
42999,6,3,150665,150665,150668,0,3,3
43000,6,1,150671,150671,150672,0,1,3
43001,3,1,150674,150674,150675,0,1,2
43002,6,1,150680,150680,150681,0,1,5
43003,5,2,150685,150685,150687,0,2,4
43004,4,3,150689,150689,150692,0,3,2
43005,3,3,150692,150692,150695,0,3,0
43006,2,1,150694,150695,150696,1,2,0
43007,1,3,150695,150696,150699,1,4,0
43008,5,3,150700,150700,150703,0,3,1
43009,5,2,150705,150705,150707,0,2,2
43010,3,2,150708,150708,150710,0,2,1
43011,4,2,150712,150712,150714,0,2,2
43012,2,3,150714,150714,150717,0,3,0
43013,2,1,150716,150717,150718,1,2,0
43014,3,1,150719,150719,150720,0,1,1
43015,5,1,150724,150724,150725,0,1,4
43016,2,1,150726,150726,150727,0,1,1
43017,2,2,150728,150728,150730,0,2,1
43018,2,1,150730,150730,150731,0,1,0
43019,2,1,150732,150732,150733,0,1,1
43020,5,2,150737,150737,150739,0,2,4
43021,1,1,150738,150739,150740,1,2,0
43022,3,1,150741,150741,150742,0,1,1
43023,3,1,150744,150744,150745,0,1,2
43024,1,3,150745,150745,150748,0,3,0
43025,3,2,150748,150748,150750,0,2,0
43026,4,2,150752,150752,150754,0,2,2
43027,6,1,150758,150758,150759,0,1,4
43028,4,2,150762,150762,150764,0,2,3
43029,5,3,150767,150767,150770,0,3,3
43030,3,2,150770,150770,150772,0,2,0
43031,5,1,150775,150775,150776,0,1,3
43032,1,2,150776,150776,150778,0,2,0
43033,1,3,150777,150778,150781,1,4,0
43034,1,2,150778,150781,150783,3,5,0
43035,3,1,150781,150783,150784,2,3,0
43036,5,1,150786,150786,150787,0,1,2
43037,6,1,150792,150792,150793,0,1,5
43038,3,3,150795,150795,150798,0,3,2
43039,4,3,150799,150799,150802,0,3,1
43040,1,2,150800,150802,150804,2,4,0
43041,4,2,150804,150804,150806,0,2,0
43042,2,1,150806,150806,150807,0,1,0
43043,3,2,150809,150809,150811,0,2,2
43044,2,1,150811,150811,150812,0,1,0
43045,5,1,150816,150816,150817,0,1,4
43046,2,1,150818,150818,150819,0,1,1
43047,1,3,150819,150819,150822,0,3,0
43048,2,2,150821,150822,150824,1,3,0
43049,2,2,150823,150824,150826,1,3,0
43050,2,1,150825,150826,150827,1,2,0
43051,2,2,150827,150827,150829,0,2,0
43052,4,1,150831,150831,150832,0,1,2
43053,2,1,150833,150833,150834,0,1,1
43054,4,3,150837,150837,150840,0,3,3
43055,2,2,150839,150840,150842,1,3,0
43056,5,2,150844,150844,150846,0,2,2
43057,1,1,150845,150846,150847,1,2,0
43058,2,1,150847,150847,150848,0,1,0
43059,5,3,150852,150852,150855,0,3,4
43060,2,3,150854,150855,150858,1,4,0
43061,2,2,150856,150858,150860,2,4,0
43062,6,2,150862,150862,150864,0,2,2
43063,5,3,150867,150867,150870,0,3,3
43064,4,1,150871,150871,150872,0,1,1
43065,2,1,150873,150873,150874,0,1,1
43066,5,3,150878,150878,150881,0,3,4
43067,2,1,150880,150881,150882,1,2,0
43068,6,2,150886,150886,150888,0,2,4
43069,3,2,150889,150889,150891,0,2,1
43070,5,1,150894,150894,150895,0,1,3
43071,3,1,150897,150897,150898,0,1,2
43072,6,2,150903,150903,150905,0,2,5
43073,5,3,150908,150908,150911,0,3,3
43074,3,3,150911,150911,150914,0,3,0
43075,1,2,150912,150914,150916,2,4,0
43076,3,3,150915,150916,150919,1,4,0
43077,2,3,150917,150919,150922,2,5,0
43078,5,1,150922,150922,150923,0,1,0
43079,4,1,150926,150926,150927,0,1,3
43080,2,3,150928,150928,150931,0,3,1
43081,5,1,150933,150933,150934,0,1,2
43082,6,3,150939,150939,150942,0,3,5
43083,6,2,150945,150945,150947,0,2,3
43084,3,2,150948,150948,150950,0,2,1
43085,3,1,150951,150951,150952,0,1,1
43086,3,1,150954,150954,150955,0,1,2
43087,6,1,150960,150960,150961,0,1,5
43088,6,3,150966,150966,150969,0,3,5
43089,6,2,150972,150972,150974,0,2,3
43090,6,2,150978,150978,150980,0,2,4
43091,1,3,150979,150980,150983,1,4,0
43092,5,1,150984,150984,150985,0,1,1
43093,4,1,150988,150988,150989,0,1,3
43094,3,3,150991,150991,150994,0,3,2
43095,2,2,150993,150994,150996,1,3,0
43096,1,2,150994,150996,150998,2,4,0
43097,3,2,150997,150998,151000,1,3,0
43098,2,2,150999,151000,151002,1,3,0
43099,6,3,151005,151005,151008,0,3,3
43100,1,3,151006,151008,151011,2,5,0
43101,4,1,151010,151011,151012,1,2,0
43102,3,1,151013,151013,151014,0,1,1
43103,6,1,151019,151019,151020,0,1,5
43104,6,3,151025,151025,151028,0,3,5
43105,4,2,151029,151029,151031,0,2,1
43106,1,1,151030,151031,151032,1,2,0
43107,4,2,151034,151034,151036,0,2,2
43108,4,1,151038,151038,151039,0,1,2
43109,3,1,151041,151041,151042,0,1,2
43110,2,2,151043,151043,151045,0,2,1
43111,4,2,151047,151047,151049,0,2,2
43112,5,2,151052,151052,151054,0,2,3
43113,3,1,151055,151055,151056,0,1,1
43114,5,1,151060,151060,151061,0,1,4
43115,6,3,151066,151066,151069,0,3,5
43116,4,2,151070,151070,151072,0,2,1
43117,2,1,151072,151072,151073,0,1,0
43118,4,1,151076,151076,151077,0,1,3
43119,1,3,151077,151077,151080,0,3,0
43120,1,2,151078,151080,151082,2,4,0
43121,6,3,151084,151084,151087,0,3,2
43122,2,3,151086,151087,151090,1,4,0
43123,6,3,151092,151092,151095,0,3,2
43124,5,2,151097,151097,151099,0,2,2
43125,1,2,151098,151099,151101,1,3,0
43126,6,1,151104,151104,151105,0,1,3
43127,2,2,151106,151106,151108,0,2,1
43128,6,1,151112,151112,151113,0,1,4
43129,6,3,151118,151118,151121,0,3,5
43130,3,1,151121,151121,151122,0,1,0
43131,2,2,151123,151123,151125,0,2,1
43132,6,3,151129,151129,151132,0,3,4
43133,3,3,151132,151132,151135,0,3,0
43134,4,1,151136,151136,151137,0,1,1
43135,2,2,151138,151138,151140,0,2,1
43136,3,3,151141,151141,151144,0,3,1
43137,4,2,151145,151145,151147,0,2,1
43138,6,1,151151,151151,151152,0,1,4
43139,5,2,151156,151156,151158,0,2,4
43140,4,1,151160,151160,151161,0,1,2
43141,5,1,151165,151165,151166,0,1,4
43142,6,2,151171,151171,151173,0,2,5
43143,5,2,151176,151176,151178,0,2,3
43144,1,2,151177,151178,151180,1,3,0
43145,4,2,151181,151181,151183,0,2,1
43146,1,2,151182,151183,151185,1,3,0
43147,5,1,151187,151187,151188,0,1,2
43148,1,2,151188,151188,151190,0,2,0
43149,1,3,151189,151190,151193,1,4,0
43150,2,2,151191,151193,151195,2,4,0
43151,4,1,151195,151195,151196,0,1,0
43152,2,2,151197,151197,151199,0,2,1
43153,6,2,151203,151203,151205,0,2,4
43154,1,3,151204,151205,151208,1,4,0
43155,6,3,151210,151210,151213,0,3,2
43156,3,3,151213,151213,151216,0,3,0
43157,2,2,151215,151216,151218,1,3,0
43158,2,1,151217,151218,151219,1,2,0
43159,5,3,151222,151222,151225,0,3,3
43160,4,1,151226,151226,151227,0,1,1
43161,4,3,151230,151230,151233,0,3,3
43162,1,3,151231,151233,151236,2,5,0
43163,3,2,151234,151236,151238,2,4,0
43164,2,3,151236,151238,151241,2,5,0
43165,6,2,151242,151242,151244,0,2,1
43166,3,3,151245,151245,151248,0,3,1
43167,5,3,151250,151250,151253,0,3,2
43168,4,2,151254,151254,151256,0,2,1
43169,4,3,151258,151258,151261,0,3,2
43170,4,2,151262,151262,151264,0,2,1
43171,4,2,151266,151266,151268,0,2,2
43172,2,3,151268,151268,151271,0,3,0
43173,6,3,151274,151274,151277,0,3,3
43174,1,2,151275,151277,151279,2,4,0
43175,2,3,151277,151279,151282,2,5,0
43176,5,1,151282,151282,151283,0,1,0
43177,3,1,151285,151285,151286,0,1,2
43178,6,3,151291,151291,151294,0,3,5
43179,2,3,151293,151294,151297,1,4,0
43180,1,1,151294,151297,151298,3,4,0
43181,2,2,151296,151298,151300,2,4,0
43182,5,3,151301,151301,151304,0,3,1
43183,6,3,151307,151307,151310,0,3,3
43184,3,3,151310,151310,151313,0,3,0
43185,3,3,151313,151313,151316,0,3,0
43186,2,1,151315,151316,151317,1,2,0
43187,3,3,151318,151318,151321,0,3,1
43188,1,3,151319,151321,151324,2,5,0
43189,2,2,151321,151324,151326,3,5,0
43190,5,1,151326,151326,151327,0,1,0
43191,1,3,151327,151327,151330,0,3,0
43192,4,3,151331,151331,151334,0,3,1
43193,2,3,151333,151334,151337,1,4,0
43194,3,3,151336,151337,151340,1,4,0
43195,1,2,151337,151340,151342,3,5,0
43196,4,2,151341,151342,151344,1,3,0
43197,3,1,151344,151344,151345,0,1,0
43198,2,3,151346,151346,151349,0,3,1
43199,6,3,151352,151352,151355,0,3,3
43200,6,2,151358,151358,151360,0,2,3
43201,4,1,151362,151362,151363,0,1,2
43202,3,2,151365,151365,151367,0,2,2
43203,2,2,151367,151367,151369,0,2,0
43204,4,2,151371,151371,151373,0,2,2
43205,4,3,151375,151375,151378,0,3,2
43206,3,3,151378,151378,151381,0,3,0
43207,6,1,151384,151384,151385,0,1,3
43208,5,1,151389,151389,151390,0,1,4
43209,4,1,151393,151393,151394,0,1,3
43210,3,1,151396,151396,151397,0,1,2
43211,4,2,151400,151400,151402,0,2,3
43212,2,1,151402,151402,151403,0,1,0
43213,4,3,151406,151406,151409,0,3,3
43214,4,3,151410,151410,151413,0,3,1
43215,6,2,151416,151416,151418,0,2,3
43216,6,2,151422,151422,151424,0,2,4
43217,1,2,151423,151424,151426,1,3,0
43218,1,1,151424,151426,151427,2,3,0
43219,5,3,151429,151429,151432,0,3,2
43220,5,3,151434,151434,151437,0,3,2
43221,4,2,151438,151438,151440,0,2,1
43222,6,3,151444,151444,151447,0,3,4
43223,5,2,151449,151449,151451,0,2,2
43224,3,1,151452,151452,151453,0,1,1
43225,2,2,151454,151454,151456,0,2,1
43226,5,1,151459,151459,151460,0,1,3
43227,2,1,151461,151461,151462,0,1,1
43228,5,2,151466,151466,151468,0,2,4
43229,6,1,151472,151472,151473,0,1,4
43230,2,3,151474,151474,151477,0,3,1
43231,6,3,151480,151480,151483,0,3,3
43232,3,3,151483,151483,151486,0,3,0
43233,2,3,151485,151486,151489,1,4,0
43234,6,2,151491,151491,151493,0,2,2
43235,4,3,151495,151495,151498,0,3,2
43236,4,2,151499,151499,151501,0,2,1
43237,6,3,151505,151505,151508,0,3,4
43238,5,3,151510,151510,151513,0,3,2
43239,1,3,151511,151513,151516,2,5,0
43240,2,2,151513,151516,151518,3,5,0
43241,2,1,151515,151518,151519,3,4,0
43242,2,2,151517,151519,151521,2,4,0
43243,4,1,151521,151521,151522,0,1,0
43244,4,3,151525,151525,151528,0,3,3
43245,5,1,151530,151530,151531,0,1,2
43246,5,3,151535,151535,151538,0,3,4
43247,1,2,151536,151538,151540,2,4,0
43248,2,3,151538,151540,151543,2,5,0
43249,6,3,151544,151544,151547,0,3,1
43250,1,2,151545,151547,151549,2,4,0
43251,5,3,151550,151550,151553,0,3,1
43252,5,3,151555,151555,151558,0,3,2
43253,6,2,151561,151561,151563,0,2,3
43254,4,2,151565,151565,151567,0,2,2
43255,2,2,151567,151567,151569,0,2,0
43256,4,3,151571,151571,151574,0,3,2
43257,5,3,151576,151576,151579,0,3,2
43258,1,3,151577,151579,151582,2,5,0
43259,2,1,151579,151582,151583,3,4,0
43260,4,1,151583,151583,151584,0,1,0
43261,3,2,151586,151586,151588,0,2,2
43262,3,1,151589,151589,151590,0,1,1
43263,5,2,151594,151594,151596,0,2,4
43264,3,3,151597,151597,151600,0,3,1
43265,1,3,151598,151600,151603,2,5,0
43266,6,1,151604,151604,151605,0,1,1
43267,3,3,151607,151607,151610,0,3,2
43268,1,3,151608,151610,151613,2,5,0
43269,4,3,151612,151613,151616,1,4,0
43270,4,3,151616,151616,151619,0,3,0
43271,2,2,151618,151619,151621,1,3,0
43272,2,2,151620,151621,151623,1,3,0
43273,5,3,151625,151625,151628,0,3,2
43274,4,2,151629,151629,151631,0,2,1
43275,4,2,151633,151633,151635,0,2,2
43276,1,2,151634,151635,151637,1,3,0
43277,6,1,151640,151640,151641,0,1,3
43278,1,3,151641,151641,151644,0,3,0
43279,5,1,151646,151646,151647,0,1,2
43280,5,3,151651,151651,151654,0,3,4
43281,6,3,151657,151657,151660,0,3,3
43282,2,3,151659,151660,151663,1,4,0
43283,4,2,151663,151663,151665,0,2,0
43284,1,1,151664,151665,151666,1,2,0
43285,1,2,151665,151666,151668,1,3,0
43286,5,3,151670,151670,151673,0,3,2
43287,3,2,151673,151673,151675,0,2,0
43288,6,3,151679,151679,151682,0,3,4
43289,3,1,151682,151682,151683,0,1,0
43290,4,2,151686,151686,151688,0,2,3
43291,4,2,151690,151690,151692,0,2,2
43292,3,2,151693,151693,151695,0,2,1
43293,3,2,151696,151696,151698,0,2,1
43294,3,3,151699,151699,151702,0,3,1
43295,2,3,151701,151702,151705,1,4,0
43296,6,3,151707,151707,151710,0,3,2
43297,2,2,151709,151710,151712,1,3,0
43298,1,3,151710,151712,151715,2,5,0
43299,6,1,151716,151716,151717,0,1,1
43300,5,3,151721,151721,151724,0,3,4
43301,1,2,151722,151724,151726,2,4,0
43302,3,3,151725,151726,151729,1,4,0
43303,4,1,151729,151729,151730,0,1,0
43304,1,3,151730,151730,151733,0,3,0
43305,4,1,151734,151734,151735,0,1,1
43306,5,3,151739,151739,151742,0,3,4
43307,5,3,151744,151744,151747,0,3,2
43308,2,3,151746,151747,151750,1,4,0
43309,4,2,151750,151750,151752,0,2,0
43310,6,2,151756,151756,151758,0,2,4
43311,4,1,151760,151760,151761,0,1,2
43312,5,3,151765,151765,151768,0,3,4
43313,3,2,151768,151768,151770,0,2,0
43314,4,1,151772,151772,151773,0,1,2
43315,4,2,151776,151776,151778,0,2,3
43316,2,3,151778,151778,151781,0,3,0
43317,4,2,151782,151782,151784,0,2,1
43318,4,1,151786,151786,151787,0,1,2
43319,1,3,151787,151787,151790,0,3,0
43320,3,3,151790,151790,151793,0,3,0
43321,5,2,151795,151795,151797,0,2,2
43322,4,1,151799,151799,151800,0,1,2
43323,5,1,151804,151804,151805,0,1,4
43324,5,3,151809,151809,151812,0,3,4
43325,5,1,151814,151814,151815,0,1,2
43326,3,1,151817,151817,151818,0,1,2
43327,4,2,151821,151821,151823,0,2,3
43328,6,3,151827,151827,151830,0,3,4
43329,2,3,151829,151830,151833,1,4,0
43330,3,3,151832,151833,151836,1,4,0
43331,1,1,151833,151836,151837,3,4,0
43332,6,2,151839,151839,151841,0,2,2
43333,6,3,151845,151845,151848,0,3,4
43334,1,3,151846,151848,151851,2,5,0
43335,5,2,151851,151851,151853,0,2,0
43336,6,1,151857,151857,151858,0,1,4
43337,4,3,151861,151861,151864,0,3,3
43338,1,2,151862,151864,151866,2,4,0
43339,5,3,151867,151867,151870,0,3,1
43340,5,2,151872,151872,151874,0,2,2
43341,6,2,151878,151878,151880,0,2,4
43342,1,2,151879,151880,151882,1,3,0
43343,3,1,151882,151882,151883,0,1,0
43344,4,2,151886,151886,151888,0,2,3
43345,4,1,151890,151890,151891,0,1,2
43346,4,3,151894,151894,151897,0,3,3
43347,5,2,151899,151899,151901,0,2,2
43348,2,3,151901,151901,151904,0,3,0
43349,6,3,151907,151907,151910,0,3,3
43350,1,1,151908,151910,151911,2,3,0
43351,6,1,151914,151914,151915,0,1,3
43352,5,1,151919,151919,151920,0,1,4
43353,2,2,151921,151921,151923,0,2,1
43354,6,2,151927,151927,151929,0,2,4
43355,1,3,151928,151929,151932,1,4,0
43356,2,1,151930,151932,151933,2,3,0
43357,1,2,151931,151933,151935,2,4,0
43358,1,3,151932,151935,151938,3,6,0
43359,6,2,151938,151938,151940,0,2,0
43360,2,1,151940,151940,151941,0,1,0
43361,1,2,151941,151941,151943,0,2,0
43362,6,2,151947,151947,151949,0,2,4
43363,3,2,151950,151950,151952,0,2,1
43364,4,1,151954,151954,151955,0,1,2
43365,4,3,151958,151958,151961,0,3,3
43366,3,3,151961,151961,151964,0,3,0
43367,3,3,151964,151964,151967,0,3,0
43368,4,3,151968,151968,151971,0,3,1
43369,5,3,151973,151973,151976,0,3,2
43370,2,3,151975,151976,151979,1,4,0
43371,5,3,151980,151980,151983,0,3,1
43372,6,2,151986,151986,151988,0,2,3
43373,4,2,151990,151990,151992,0,2,2
43374,3,1,151993,151993,151994,0,1,1
43375,3,1,151996,151996,151997,0,1,2
43376,5,3,152001,152001,152004,0,3,4
43377,1,2,152002,152004,152006,2,4,0
43378,1,2,152003,152006,152008,3,5,0
43379,3,1,152006,152008,152009,2,3,0
43380,5,2,152011,152011,152013,0,2,2
43381,6,2,152017,152017,152019,0,2,4
43382,3,1,152020,152020,152021,0,1,1
43383,2,1,152022,152022,152023,0,1,1
43384,2,1,152024,152024,152025,0,1,1
43385,1,2,152025,152025,152027,0,2,0
43386,2,2,152027,152027,152029,0,2,0
43387,3,2,152030,152030,152032,0,2,1
43388,5,3,152035,152035,152038,0,3,3
43389,1,1,152036,152038,152039,2,3,0
43390,5,2,152041,152041,152043,0,2,2
43391,4,2,152045,152045,152047,0,2,2
43392,6,3,152051,152051,152054,0,3,4
43393,2,3,152053,152054,152057,1,4,0
43394,1,3,152054,152057,152060,3,6,0
43395,5,3,152059,152060,152063,1,4,0
43396,3,1,152062,152063,152064,1,2,0
43397,3,2,152065,152065,152067,0,2,1
43398,5,2,152070,152070,152072,0,2,3
43399,6,1,152076,152076,152077,0,1,4
43400,2,1,152078,152078,152079,0,1,1
43401,3,3,152081,152081,152084,0,3,2
43402,1,2,152082,152084,152086,2,4,0
43403,1,3,152083,152086,152089,3,6,0
43404,2,3,152085,152089,152092,4,7,0
43405,6,2,152091,152092,152094,1,3,0
43406,2,2,152093,152094,152096,1,3,0
43407,2,2,152095,152096,152098,1,3,0
43408,1,3,152096,152098,152101,2,5,0
43409,3,1,152099,152101,152102,2,3,0
43410,5,2,152104,152104,152106,0,2,2
43411,4,2,152108,152108,152110,0,2,2
43412,6,3,152114,152114,152117,0,3,4
43413,5,1,152119,152119,152120,0,1,2
43414,1,2,152120,152120,152122,0,2,0
43415,1,1,152121,152122,152123,1,2,0
43416,5,1,152126,152126,152127,0,1,3
43417,6,2,152132,152132,152134,0,2,5
43418,2,1,152134,152134,152135,0,1,0
43419,3,1,152137,152137,152138,0,1,2
43420,5,2,152142,152142,152144,0,2,4
43421,3,2,152145,152145,152147,0,2,1
43422,5,1,152150,152150,152151,0,1,3
43423,1,3,152151,152151,152154,0,3,0
43424,3,1,152154,152154,152155,0,1,0
43425,2,2,152156,152156,152158,0,2,1
43426,6,3,152162,152162,152165,0,3,4
43427,5,2,152167,152167,152169,0,2,2
43428,2,2,152169,152169,152171,0,2,0
43429,1,1,152170,152171,152172,1,2,0
43430,1,1,152171,152172,152173,1,2,0
43431,2,2,152173,152173,152175,0,2,0
43432,2,1,152175,152175,152176,0,1,0
43433,6,3,152181,152181,152184,0,3,5
43434,5,2,152186,152186,152188,0,2,2
43435,3,2,152189,152189,152191,0,2,1
43436,1,1,152190,152191,152192,1,2,0
43437,5,2,152195,152195,152197,0,2,3
43438,2,1,152197,152197,152198,0,1,0
43439,2,1,152199,152199,152200,0,1,1
43440,2,3,152201,152201,152204,0,3,1
43441,4,3,152205,152205,152208,0,3,1
43442,1,1,152206,152208,152209,2,3,0
43443,6,3,152212,152212,152215,0,3,3
43444,5,3,152217,152217,152220,0,3,2
43445,2,2,152219,152220,152222,1,3,0
43446,2,1,152221,152222,152223,1,2,0
43447,4,3,152225,152225,152228,0,3,2
43448,2,2,152227,152228,152230,1,3,0
43449,2,2,152229,152230,152232,1,3,0
43450,2,2,152231,152232,152234,1,3,0
43451,5,1,152236,152236,152237,0,1,2
43452,5,2,152241,152241,152243,0,2,4
43453,6,1,152247,152247,152248,0,1,4
43454,5,3,152252,152252,152255,0,3,4
43455,3,3,152255,152255,152258,0,3,0
43456,6,3,152261,152261,152264,0,3,3
43457,5,2,152266,152266,152268,0,2,2
43458,6,2,152272,152272,152274,0,2,4
43459,4,3,152276,152276,152279,0,3,2
43460,3,3,152279,152279,152282,0,3,0
43461,3,1,152282,152282,152283,0,1,0
43462,1,2,152283,152283,152285,0,2,0
43463,1,2,152284,152285,152287,1,3,0
43464,2,3,152286,152287,152290,1,4,0
43465,5,1,152291,152291,152292,0,1,1
43466,2,2,152293,152293,152295,0,2,1
43467,5,1,152298,152298,152299,0,1,3
43468,5,3,152303,152303,152306,0,3,4
43469,2,1,152305,152306,152307,1,2,0
43470,2,1,152307,152307,152308,0,1,0
43471,3,1,152310,152310,152311,0,1,2
43472,1,3,152311,152311,152314,0,3,0
43473,3,1,152314,152314,152315,0,1,0
43474,1,1,152315,152315,152316,0,1,0
43475,1,1,152316,152316,152317,0,1,0
43476,2,1,152318,152318,152319,0,1,1
43477,4,1,152322,152322,152323,0,1,3
43478,3,3,152325,152325,152328,0,3,2
43479,1,3,152326,152328,152331,2,5,0
43480,4,2,152330,152331,152333,1,3,0
43481,2,3,152332,152333,152336,1,4,0
43482,4,1,152336,152336,152337,0,1,0
43483,6,1,152342,152342,152343,0,1,5
43484,1,2,152343,152343,152345,0,2,0
43485,1,3,152344,152345,152348,1,4,0
43486,1,3,152345,152348,152351,3,6,0
43487,3,1,152348,152351,152352,3,4,0
43488,4,2,152352,152352,152354,0,2,0
43489,6,2,152358,152358,152360,0,2,4
43490,1,2,152359,152360,152362,1,3,0
43491,2,2,152361,152362,152364,1,3,0
43492,5,2,152366,152366,152368,0,2,2
43493,4,1,152370,152370,152371,0,1,2
43494,6,1,152376,152376,152377,0,1,5
43495,6,3,152382,152382,152385,0,3,5
43496,5,2,152387,152387,152389,0,2,2
43497,5,1,152392,152392,152393,0,1,3
43498,1,2,152393,152393,152395,0,2,0
43499,4,3,152397,152397,152400,0,3,2
43500,1,1,152398,152400,152401,2,3,0
43501,6,2,152404,152404,152406,0,2,3
43502,5,3,152409,152409,152412,0,3,3
43503,5,3,152414,152414,152417,0,3,2
43504,3,2,152417,152417,152419,0,2,0
43505,3,3,152420,152420,152423,0,3,1
43506,5,1,152425,152425,152426,0,1,2
43507,2,1,152427,152427,152428,0,1,1
43508,5,3,152432,152432,152435,0,3,4
43509,3,2,152435,152435,152437,0,2,0
43510,5,1,152440,152440,152441,0,1,3
43511,6,3,152446,152446,152449,0,3,5
43512,4,1,152450,152450,152451,0,1,1
43513,1,1,152451,152451,152452,0,1,0
43514,3,2,152454,152454,152456,0,2,2
43515,5,1,152459,152459,152460,0,1,3
43516,5,3,152464,152464,152467,0,3,4
43517,6,2,152470,152470,152472,0,2,3
43518,6,3,152476,152476,152479,0,3,4
43519,1,3,152477,152479,152482,2,5,0
43520,1,2,152478,152482,152484,4,6,0
43521,3,2,152481,152484,152486,3,5,0
43522,5,2,152486,152486,152488,0,2,0
43523,3,2,152489,152489,152491,0,2,1
43524,6,1,152495,152495,152496,0,1,4
43525,3,2,152498,152498,152500,0,2,2
43526,2,2,152500,152500,152502,0,2,0
43527,4,1,152504,152504,152505,0,1,2
43528,6,3,152510,152510,152513,0,3,5
43529,4,1,152514,152514,152515,0,1,1
43530,1,3,152515,152515,152518,0,3,0
43531,2,1,152517,152518,152519,1,2,0
43532,3,3,152520,152520,152523,0,3,1
43533,1,2,152521,152523,152525,2,4,0
43534,5,1,152526,152526,152527,0,1,1
43535,5,1,152531,152531,152532,0,1,4
43536,3,3,152534,152534,152537,0,3,2
43537,1,1,152535,152537,152538,2,3,0
43538,1,2,152536,152538,152540,2,4,0
43539,5,3,152541,152541,152544,0,3,1
43540,2,3,152543,152544,152547,1,4,0
43541,5,1,152548,152548,152549,0,1,1
43542,1,1,152549,152549,152550,0,1,0
43543,2,2,152551,152551,152553,0,2,1
43544,4,1,152555,152555,152556,0,1,2
43545,6,3,152561,152561,152564,0,3,5
43546,1,3,152562,152564,152567,2,5,0
43547,6,1,152568,152568,152569,0,1,1
43548,3,1,152571,152571,152572,0,1,2
43549,1,2,152572,152572,152574,0,2,0
43550,5,2,152577,152577,152579,0,2,3
43551,6,1,152583,152583,152584,0,1,4
43552,3,3,152586,152586,152589,0,3,2
43553,3,1,152589,152589,152590,0,1,0
43554,1,3,152590,152590,152593,0,3,0
43555,3,2,152593,152593,152595,0,2,0
43556,6,3,152599,152599,152602,0,3,4
43557,3,3,152602,152602,152605,0,3,0
43558,3,2,152605,152605,152607,0,2,0
43559,6,2,152611,152611,152613,0,2,4
43560,5,1,152616,152616,152617,0,1,3
43561,3,1,152619,152619,152620,0,1,2
43562,1,3,152620,152620,152623,0,3,0
43563,4,3,152624,152624,152627,0,3,1
43564,6,3,152630,152630,152633,0,3,3
43565,5,3,152635,152635,152638,0,3,2
43566,5,3,152640,152640,152643,0,3,2
43567,3,3,152643,152643,152646,0,3,0
43568,1,3,152644,152646,152649,2,5,0
43569,3,3,152647,152649,152652,2,5,0
43570,5,2,152652,152652,152654,0,2,0
43571,1,2,152653,152654,152656,1,3,0
43572,6,1,152659,152659,152660,0,1,3
43573,4,1,152663,152663,152664,0,1,3
43574,2,2,152665,152665,152667,0,2,1
43575,4,2,152669,152669,152671,0,2,2
43576,5,1,152674,152674,152675,0,1,3
43577,3,2,152677,152677,152679,0,2,2
43578,5,3,152682,152682,152685,0,3,3
43579,1,3,152683,152685,152688,2,5,0
43580,6,3,152689,152689,152692,0,3,1
43581,3,1,152692,152692,152693,0,1,0
43582,6,3,152698,152698,152701,0,3,5
43583,1,3,152699,152701,152704,2,5,0
43584,6,3,152705,152705,152708,0,3,1
43585,1,3,152706,152708,152711,2,5,0
43586,6,1,152712,152712,152713,0,1,1
43587,4,2,152716,152716,152718,0,2,3
43588,5,2,152721,152721,152723,0,2,3
43589,4,1,152725,152725,152726,0,1,2
43590,1,3,152726,152726,152729,0,3,0
43591,5,2,152731,152731,152733,0,2,2
43592,6,2,152737,152737,152739,0,2,4
43593,2,1,152739,152739,152740,0,1,0
43594,6,1,152745,152745,152746,0,1,5
43595,5,3,152750,152750,152753,0,3,4
43596,6,2,152756,152756,152758,0,2,3
43597,6,2,152762,152762,152764,0,2,4
43598,4,1,152766,152766,152767,0,1,2
43599,6,2,152772,152772,152774,0,2,5
43600,2,2,152774,152774,152776,0,2,0
43601,3,1,152777,152777,152778,0,1,1
43602,3,1,152780,152780,152781,0,1,2
43603,5,2,152785,152785,152787,0,2,4
43604,4,3,152789,152789,152792,0,3,2
43605,1,1,152790,152792,152793,2,3,0
43606,4,2,152794,152794,152796,0,2,1
43607,1,3,152795,152796,152799,1,4,0
43608,5,2,152800,152800,152802,0,2,1
43609,3,1,152803,152803,152804,0,1,1
43610,5,1,152808,152808,152809,0,1,4
43611,6,1,152814,152814,152815,0,1,5
43612,1,3,152815,152815,152818,0,3,0
43613,3,2,152818,152818,152820,0,2,0
43614,6,3,152824,152824,152827,0,3,4
43615,4,3,152828,152828,152831,0,3,1
43616,5,1,152833,152833,152834,0,1,2
43617,4,1,152837,152837,152838,0,1,3
43618,3,3,152840,152840,152843,0,3,2
43619,1,2,152841,152843,152845,2,4,0
43620,2,3,152843,152845,152848,2,5,0
43621,2,3,152845,152848,152851,3,6,0
43622,5,3,152850,152851,152854,1,4,0
43623,1,2,152851,152854,152856,3,5,0
43624,4,3,152855,152856,152859,1,4,0
43625,1,1,152856,152859,152860,3,4,0
43626,1,2,152857,152860,152862,3,5,0
43627,3,3,152860,152862,152865,2,5,0
43628,2,3,152862,152865,152868,3,6,0
43629,1,3,152863,152868,152871,5,8,0
43630,5,3,152868,152871,152874,3,6,0
43631,5,2,152873,152874,152876,1,3,0
43632,4,3,152877,152877,152880,0,3,1
43633,2,2,152879,152880,152882,1,3,0
43634,6,3,152885,152885,152888,0,3,3
43635,3,3,152888,152888,152891,0,3,0
43636,5,1,152893,152893,152894,0,1,2
43637,1,1,152894,152894,152895,0,1,0
43638,5,3,152899,152899,152902,0,3,4
43639,1,3,152900,152902,152905,2,5,0
43640,3,2,152903,152905,152907,2,4,0
43641,1,2,152904,152907,152909,3,5,0
43642,3,1,152907,152909,152910,2,3,0
43643,4,3,152911,152911,152914,0,3,1
43644,1,1,152912,152914,152915,2,3,0
43645,2,2,152914,152915,152917,1,3,0
43646,6,2,152920,152920,152922,0,2,3
43647,4,1,152924,152924,152925,0,1,2
43648,6,3,152930,152930,152933,0,3,5
43649,3,1,152933,152933,152934,0,1,0
43650,5,3,152938,152938,152941,0,3,4
43651,3,3,152941,152941,152944,0,3,0
43652,4,2,152945,152945,152947,0,2,1
43653,3,1,152948,152948,152949,0,1,1
43654,4,3,152952,152952,152955,0,3,3
43655,6,1,152958,152958,152959,0,1,3
43656,6,2,152964,152964,152966,0,2,5
43657,3,2,152967,152967,152969,0,2,1
43658,3,3,152970,152970,152973,0,3,1
43659,6,1,152976,152976,152977,0,1,3
43660,2,3,152978,152978,152981,0,3,1
43661,5,3,152983,152983,152986,0,3,2
43662,5,1,152988,152988,152989,0,1,2
43663,2,3,152990,152990,152993,0,3,1
43664,2,3,152992,152993,152996,1,4,0
43665,2,2,152994,152996,152998,2,4,0
43666,6,2,153000,153000,153002,0,2,2
43667,3,2,153003,153003,153005,0,2,1
43668,4,2,153007,153007,153009,0,2,2
43669,6,1,153013,153013,153014,0,1,4
43670,6,1,153019,153019,153020,0,1,5
43671,5,3,153024,153024,153027,0,3,4
43672,3,2,153027,153027,153029,0,2,0
43673,1,3,153028,153029,153032,1,4,0
43674,6,1,153034,153034,153035,0,1,2
43675,3,3,153037,153037,153040,0,3,2
43676,2,2,153039,153040,153042,1,3,0
43677,6,3,153045,153045,153048,0,3,3
43678,3,3,153048,153048,153051,0,3,0
43679,5,2,153053,153053,153055,0,2,2
43680,4,3,153057,153057,153060,0,3,2
43681,4,1,153061,153061,153062,0,1,1
43682,5,1,153066,153066,153067,0,1,4
43683,1,1,153067,153067,153068,0,1,0
43684,2,3,153069,153069,153072,0,3,1
43685,1,2,153070,153072,153074,2,4,0
43686,6,3,153076,153076,153079,0,3,2
43687,1,1,153077,153079,153080,2,3,0
43688,1,1,153078,153080,153081,2,3,0
43689,2,2,153080,153081,153083,1,3,0
43690,4,3,153084,153084,153087,0,3,1
43691,4,1,153088,153088,153089,0,1,1
43692,1,3,153089,153089,153092,0,3,0
43693,3,3,153092,153092,153095,0,3,0
43694,6,3,153098,153098,153101,0,3,3
43695,1,1,153099,153101,153102,2,3,0
43696,1,1,153100,153102,153103,2,3,0
43697,5,3,153105,153105,153108,0,3,2
43698,5,2,153110,153110,153112,0,2,2
43699,4,3,153114,153114,153117,0,3,2
43700,3,3,153117,153117,153120,0,3,0
43701,4,1,153121,153121,153122,0,1,1
43702,1,1,153122,153122,153123,0,1,0
43703,4,1,153126,153126,153127,0,1,3
43704,2,2,153128,153128,153130,0,2,1
43705,4,3,153132,153132,153135,0,3,2
43706,1,1,153133,153135,153136,2,3,0
43707,2,2,153135,153136,153138,1,3,0
43708,3,3,153138,153138,153141,0,3,0
43709,6,1,153144,153144,153145,0,1,3
43710,4,3,153148,153148,153151,0,3,3
43711,5,2,153153,153153,153155,0,2,2
43712,6,2,153159,153159,153161,0,2,4
43713,6,2,153165,153165,153167,0,2,4
43714,2,1,153167,153167,153168,0,1,0
43715,3,3,153170,153170,153173,0,3,2
43716,5,2,153175,153175,153177,0,2,2
43717,1,2,153176,153177,153179,1,3,0
43718,3,1,153179,153179,153180,0,1,0
43719,3,2,153182,153182,153184,0,2,2
43720,4,2,153186,153186,153188,0,2,2
43721,5,1,153191,153191,153192,0,1,3
43722,6,3,153197,153197,153200,0,3,5
43723,2,1,153199,153200,153201,1,2,0
43724,4,2,153203,153203,153205,0,2,2
43725,1,1,153204,153205,153206,1,2,0
43726,5,2,153209,153209,153211,0,2,3
43727,6,1,153215,153215,153216,0,1,4
43728,3,2,153218,153218,153220,0,2,2
43729,6,3,153224,153224,153227,0,3,4
43730,2,1,153226,153227,153228,1,2,0
43731,1,2,153227,153228,153230,1,3,0
43732,5,2,153232,153232,153234,0,2,2
43733,1,2,153233,153234,153236,1,3,0
43734,5,1,153238,153238,153239,0,1,2
43735,3,2,153241,153241,153243,0,2,2
43736,4,2,153245,153245,153247,0,2,2
43737,6,3,153251,153251,153254,0,3,4
43738,4,1,153255,153255,153256,0,1,1
43739,1,1,153256,153256,153257,0,1,0
43740,6,1,153262,153262,153263,0,1,5
43741,5,2,153267,153267,153269,0,2,4
43742,2,1,153269,153269,153270,0,1,0
43743,3,2,153272,153272,153274,0,2,2
43744,6,1,153278,153278,153279,0,1,4
43745,5,3,153283,153283,153286,0,3,4
43746,6,2,153289,153289,153291,0,2,3
43747,6,1,153295,153295,153296,0,1,4
43748,1,2,153296,153296,153298,0,2,0
43749,4,2,153300,153300,153302,0,2,2
43750,3,3,153303,153303,153306,0,3,1
43751,5,3,153308,153308,153311,0,3,2
43752,2,2,153310,153311,153313,1,3,0
43753,4,1,153314,153314,153315,0,1,1
43754,1,2,153315,153315,153317,0,2,0
43755,3,1,153318,153318,153319,0,1,1
43756,6,3,153324,153324,153327,0,3,5
43757,4,2,153328,153328,153330,0,2,1
43758,4,3,153332,153332,153335,0,3,2
43759,5,3,153337,153337,153340,0,3,2
43760,1,1,153338,153340,153341,2,3,0
43761,4,2,153342,153342,153344,0,2,1
43762,2,1,153344,153344,153345,0,1,0
43763,6,2,153350,153350,153352,0,2,5
43764,5,2,153355,153355,153357,0,2,3
43765,3,2,153358,153358,153360,0,2,1
43766,5,2,153363,153363,153365,0,2,3
43767,1,3,153364,153365,153368,1,4,0
43768,5,3,153369,153369,153372,0,3,1
43769,3,1,153372,153372,153373,0,1,0
43770,5,1,153377,153377,153378,0,1,4
43771,6,2,153383,153383,153385,0,2,5
43772,2,2,153385,153385,153387,0,2,0
43773,5,1,153390,153390,153391,0,1,3
43774,4,2,153394,153394,153396,0,2,3
43775,3,3,153397,153397,153400,0,3,1
43776,2,1,153399,153400,153401,1,2,0
43777,1,1,153400,153401,153402,1,2,0
43778,3,2,153403,153403,153405,0,2,1
43779,4,3,153407,153407,153410,0,3,2
43780,3,3,153410,153410,153413,0,3,0
43781,6,1,153416,153416,153417,0,1,3
43782,5,3,153421,153421,153424,0,3,4
43783,4,3,153425,153425,153428,0,3,1
43784,5,1,153430,153430,153431,0,1,2
43785,3,3,153433,153433,153436,0,3,2
43786,2,2,153435,153436,153438,1,3,0
43787,4,1,153439,153439,153440,0,1,1
43788,5,1,153444,153444,153445,0,1,4
43789,1,1,153445,153445,153446,0,1,0
43790,6,3,153451,153451,153454,0,3,5
43791,1,3,153452,153454,153457,2,5,0
43792,4,1,153456,153457,153458,1,2,0
43793,6,2,153462,153462,153464,0,2,4
43794,4,1,153466,153466,153467,0,1,2
43795,2,2,153468,153468,153470,0,2,1
43796,1,2,153469,153470,153472,1,3,0
43797,5,1,153474,153474,153475,0,1,2
43798,4,2,153478,153478,153480,0,2,3
43799,5,3,153483,153483,153486,0,3,3
43800,6,3,153489,153489,153492,0,3,3
43801,3,1,153492,153492,153493,0,1,0
43802,1,2,153493,153493,153495,0,2,0
43803,4,1,153497,153497,153498,0,1,2
43804,4,2,153501,153501,153503,0,2,3
43805,3,3,153504,153504,153507,0,3,1
43806,2,2,153506,153507,153509,1,3,0
43807,6,2,153512,153512,153514,0,2,3
43808,2,2,153514,153514,153516,0,2,0
43809,4,1,153518,153518,153519,0,1,2
43810,2,1,153520,153520,153521,0,1,1
43811,3,3,153523,153523,153526,0,3,2
43812,2,2,153525,153526,153528,1,3,0
43813,1,2,153526,153528,153530,2,4,0
43814,3,2,153529,153530,153532,1,3,0
43815,5,3,153534,153534,153537,0,3,2
43816,2,1,153536,153537,153538,1,2,0
43817,2,3,153538,153538,153541,0,3,0
43818,5,2,153543,153543,153545,0,2,2
43819,4,1,153547,153547,153548,0,1,2
43820,6,1,153553,153553,153554,0,1,5
43821,2,1,153555,153555,153556,0,1,1
43822,4,1,153559,153559,153560,0,1,3
43823,4,3,153563,153563,153566,0,3,3
43824,4,2,153567,153567,153569,0,2,1
43825,3,2,153570,153570,153572,0,2,1
43826,6,2,153576,153576,153578,0,2,4
43827,4,1,153580,153580,153581,0,1,2
43828,3,2,153583,153583,153585,0,2,2
43829,5,3,153588,153588,153591,0,3,3
43830,3,2,153591,153591,153593,0,2,0
43831,1,1,153592,153593,153594,1,2,0
43832,3,1,153595,153595,153596,0,1,1
43833,2,3,153597,153597,153600,0,3,1
43834,5,2,153602,153602,153604,0,2,2
43835,5,3,153607,153607,153610,0,3,3
43836,3,2,153610,153610,153612,0,2,0
43837,2,1,153612,153612,153613,0,1,0
43838,4,2,153616,153616,153618,0,2,3
43839,2,3,153618,153618,153621,0,3,0
43840,4,3,153622,153622,153625,0,3,1
43841,4,2,153626,153626,153628,0,2,1
43842,5,2,153631,153631,153633,0,2,3
43843,1,3,153632,153633,153636,1,4,0
43844,3,2,153635,153636,153638,1,3,0
43845,2,3,153637,153638,153641,1,4,0
43846,4,2,153641,153641,153643,0,2,0
43847,2,2,153643,153643,153645,0,2,0
43848,1,3,153644,153645,153648,1,4,0
43849,4,1,153648,153648,153649,0,1,0
43850,6,2,153654,153654,153656,0,2,5
43851,6,3,153660,153660,153663,0,3,4
43852,4,1,153664,153664,153665,0,1,1
43853,2,2,153666,153666,153668,0,2,1
43854,5,1,153671,153671,153672,0,1,3
43855,6,2,153677,153677,153679,0,2,5
43856,6,3,153683,153683,153686,0,3,4
43857,2,1,153685,153686,153687,1,2,0
43858,3,3,153688,153688,153691,0,3,1
43859,5,1,153693,153693,153694,0,1,2
43860,2,1,153695,153695,153696,0,1,1
43861,1,2,153696,153696,153698,0,2,0
43862,1,1,153697,153698,153699,1,2,0
43863,4,2,153701,153701,153703,0,2,2
43864,6,3,153707,153707,153710,0,3,4
43865,5,1,153712,153712,153713,0,1,2
43866,4,3,153716,153716,153719,0,3,3
43867,5,2,153721,153721,153723,0,2,2
43868,4,1,153725,153725,153726,0,1,2
43869,4,3,153729,153729,153732,0,3,3
43870,3,3,153732,153732,153735,0,3,0
43871,4,1,153736,153736,153737,0,1,1
43872,1,2,153737,153737,153739,0,2,0
43873,3,1,153740,153740,153741,0,1,1
43874,6,2,153746,153746,153748,0,2,5
43875,5,1,153751,153751,153752,0,1,3
43876,5,1,153756,153756,153757,0,1,4
43877,3,3,153759,153759,153762,0,3,2
43878,6,3,153765,153765,153768,0,3,3
43879,6,3,153771,153771,153774,0,3,3
43880,6,1,153777,153777,153778,0,1,3
43881,2,3,153779,153779,153782,0,3,1
43882,6,2,153785,153785,153787,0,2,3
43883,4,1,153789,153789,153790,0,1,2
43884,3,2,153792,153792,153794,0,2,2
43885,3,1,153795,153795,153796,0,1,1
43886,1,1,153796,153796,153797,0,1,0
43887,6,3,153802,153802,153805,0,3,5
43888,3,3,153805,153805,153808,0,3,0
43889,1,2,153806,153808,153810,2,4,0
43890,2,2,153808,153810,153812,2,4,0
43891,6,1,153814,153814,153815,0,1,2
43892,3,1,153817,153817,153818,0,1,2
43893,1,1,153818,153818,153819,0,1,0
43894,1,2,153819,153819,153821,0,2,0
43895,4,2,153823,153823,153825,0,2,2
43896,5,2,153828,153828,153830,0,2,3
43897,4,2,153832,153832,153834,0,2,2
43898,2,1,153834,153834,153835,0,1,0
43899,6,1,153840,153840,153841,0,1,5
43900,6,2,153846,153846,153848,0,2,5
43901,6,3,153852,153852,153855,0,3,4
43902,5,3,153857,153857,153860,0,3,2
43903,4,1,153861,153861,153862,0,1,1
43904,4,2,153865,153865,153867,0,2,3
43905,1,2,153866,153867,153869,1,3,0
43906,4,3,153870,153870,153873,0,3,1
43907,1,3,153871,153873,153876,2,5,0
43908,5,1,153876,153876,153877,0,1,0
43909,2,1,153878,153878,153879,0,1,1
43910,2,1,153880,153880,153881,0,1,1
43911,4,2,153884,153884,153886,0,2,3
43912,1,1,153885,153886,153887,1,2,0
43913,2,3,153887,153887,153890,0,3,0
43914,6,1,153893,153893,153894,0,1,3
43915,2,3,153895,153895,153898,0,3,1
43916,4,3,153899,153899,153902,0,3,1
43917,2,3,153901,153902,153905,1,4,0
43918,4,3,153905,153905,153908,0,3,0
43919,4,1,153909,153909,153910,0,1,1
43920,2,2,153911,153911,153913,0,2,1
43921,6,1,153917,153917,153918,0,1,4
43922,4,3,153921,153921,153924,0,3,3
43923,3,2,153924,153924,153926,0,2,0
43924,1,3,153925,153926,153929,1,4,0
43925,6,2,153931,153931,153933,0,2,2
43926,1,2,153932,153933,153935,1,3,0
43927,6,2,153938,153938,153940,0,2,3
43928,1,3,153939,153940,153943,1,4,0
43929,6,2,153945,153945,153947,0,2,2
43930,3,3,153948,153948,153951,0,3,1
43931,4,2,153952,153952,153954,0,2,1
43932,1,2,153953,153954,153956,1,3,0
43933,4,3,153957,153957,153960,0,3,1
43934,4,3,153961,153961,153964,0,3,1
43935,2,2,153963,153964,153966,1,3,0
43936,4,3,153967,153967,153970,0,3,1
43937,5,1,153972,153972,153973,0,1,2
43938,4,1,153976,153976,153977,0,1,3
43939,6,1,153982,153982,153983,0,1,5
43940,1,2,153983,153983,153985,0,2,0
43941,1,3,153984,153985,153988,1,4,0
43942,5,3,153989,153989,153992,0,3,1
43943,5,2,153994,153994,153996,0,2,2
43944,6,3,154000,154000,154003,0,3,4
43945,5,3,154005,154005,154008,0,3,2
43946,4,3,154009,154009,154012,0,3,1
43947,3,1,154012,154012,154013,0,1,0
43948,4,2,154016,154016,154018,0,2,3
43949,1,2,154017,154018,154020,1,3,0
43950,3,2,154020,154020,154022,0,2,0
43951,5,2,154025,154025,154027,0,2,3
43952,1,2,154026,154027,154029,1,3,0
43953,5,1,154031,154031,154032,0,1,2
43954,1,3,154032,154032,154035,0,3,0
43955,5,3,154037,154037,154040,0,3,2
43956,3,1,154040,154040,154041,0,1,0
43957,5,1,154045,154045,154046,0,1,4
43958,4,3,154049,154049,154052,0,3,3
43959,3,3,154052,154052,154055,0,3,0
43960,2,3,154054,154055,154058,1,4,0
43961,3,2,154057,154058,154060,1,3,0
43962,1,2,154058,154060,154062,2,4,0
43963,6,1,154064,154064,154065,0,1,2
43964,2,2,154066,154066,154068,0,2,1
43965,5,3,154071,154071,154074,0,3,3
43966,2,1,154073,154074,154075,1,2,0
43967,5,2,154078,154078,154080,0,2,3
43968,3,2,154081,154081,154083,0,2,1
43969,3,2,154084,154084,154086,0,2,1
43970,3,3,154087,154087,154090,0,3,1
43971,4,3,154091,154091,154094,0,3,1
43972,6,3,154097,154097,154100,0,3,3
43973,5,2,154102,154102,154104,0,2,2
43974,6,2,154108,154108,154110,0,2,4
43975,5,2,154113,154113,154115,0,2,3
43976,4,1,154117,154117,154118,0,1,2
43977,3,3,154120,154120,154123,0,3,2
43978,6,1,154126,154126,154127,0,1,3
43979,1,2,154127,154127,154129,0,2,0
43980,2,3,154129,154129,154132,0,3,0
43981,3,3,154132,154132,154135,0,3,0
43982,5,3,154137,154137,154140,0,3,2
43983,2,3,154139,154140,154143,1,4,0
43984,5,3,154144,154144,154147,0,3,1
43985,2,2,154146,154147,154149,1,3,0
43986,4,2,154150,154150,154152,0,2,1
43987,2,1,154152,154152,154153,0,1,0
43988,1,2,154153,154153,154155,0,2,0
43989,5,2,154158,154158,154160,0,2,3
43990,6,3,154164,154164,154167,0,3,4
43991,5,1,154169,154169,154170,0,1,2
43992,4,3,154173,154173,154176,0,3,3
43993,1,3,154174,154176,154179,2,5,0
43994,5,3,154179,154179,154182,0,3,0
43995,6,1,154185,154185,154186,0,1,3
43996,4,1,154189,154189,154190,0,1,3
43997,1,1,154190,154190,154191,0,1,0
43998,1,2,154191,154191,154193,0,2,0
43999,2,3,154193,154193,154196,0,3,0
44000,5,1,154198,154198,154199,0,1,2
44001,4,2,154202,154202,154204,0,2,3
44002,2,2,154204,154204,154206,0,2,0
44003,6,1,154210,154210,154211,0,1,4
44004,5,1,154215,154215,154216,0,1,4
44005,6,3,154221,154221,154224,0,3,5
44006,3,3,154224,154224,154227,0,3,0
44007,6,1,154230,154230,154231,0,1,3
44008,4,2,154234,154234,154236,0,2,3
44009,6,1,154240,154240,154241,0,1,4
44010,2,1,154242,154242,154243,0,1,1
44011,5,3,154247,154247,154250,0,3,4
44012,3,1,154250,154250,154251,0,1,0
44013,4,2,154254,154254,154256,0,2,3
44014,2,1,154256,154256,154257,0,1,0
44015,6,2,154262,154262,154264,0,2,5
44016,1,2,154263,154264,154266,1,3,0
44017,5,2,154268,154268,154270,0,2,2
44018,2,1,154270,154270,154271,0,1,0
44019,5,1,154275,154275,154276,0,1,4
44020,5,1,154280,154280,154281,0,1,4
44021,2,2,154282,154282,154284,0,2,1
44022,4,1,154286,154286,154287,0,1,2
44023,4,3,154290,154290,154293,0,3,3
44024,6,1,154296,154296,154297,0,1,3
44025,5,2,154301,154301,154303,0,2,4
44026,4,1,154305,154305,154306,0,1,2
44027,1,2,154306,154306,154308,0,2,0
44028,3,3,154309,154309,154312,0,3,1
44029,5,2,154314,154314,154316,0,2,2
44030,2,2,154316,154316,154318,0,2,0
44031,2,3,154318,154318,154321,0,3,0
44032,3,1,154321,154321,154322,0,1,0
44033,5,1,154326,154326,154327,0,1,4
44034,5,1,154331,154331,154332,0,1,4
44035,4,3,154335,154335,154338,0,3,3
44036,4,2,154339,154339,154341,0,2,1
44037,4,1,154343,154343,154344,0,1,2
44038,2,1,154345,154345,154346,0,1,1
44039,6,1,154351,154351,154352,0,1,5
44040,5,2,154356,154356,154358,0,2,4
44041,6,2,154362,154362,154364,0,2,4
44042,6,2,154368,154368,154370,0,2,4
44043,4,1,154372,154372,154373,0,1,2
44044,6,1,154378,154378,154379,0,1,5
44045,3,1,154381,154381,154382,0,1,2
44046,2,1,154383,154383,154384,0,1,1
44047,4,2,154387,154387,154389,0,2,3
44048,5,3,154392,154392,154395,0,3,3
44049,5,2,154397,154397,154399,0,2,2
44050,4,2,154401,154401,154403,0,2,2
44051,2,2,154403,154403,154405,0,2,0
44052,3,1,154406,154406,154407,0,1,1
44053,6,1,154412,154412,154413,0,1,5
44054,3,3,154415,154415,154418,0,3,2
44055,3,3,154418,154418,154421,0,3,0
44056,5,2,154423,154423,154425,0,2,2
44057,2,3,154425,154425,154428,0,3,0
44058,4,3,154429,154429,154432,0,3,1
44059,2,3,154431,154432,154435,1,4,0
44060,6,3,154437,154437,154440,0,3,2
44061,3,2,154440,154440,154442,0,2,0
44062,4,3,154444,154444,154447,0,3,2
44063,1,3,154445,154447,154450,2,5,0
44064,3,2,154448,154450,154452,2,4,0
44065,1,1,154449,154452,154453,3,4,0
44066,3,3,154452,154453,154456,1,4,0
44067,1,2,154453,154456,154458,3,5,0
44068,1,3,154454,154458,154461,4,7,0
44069,5,1,154459,154461,154462,2,3,0
44070,5,2,154464,154464,154466,0,2,2
44071,4,1,154468,154468,154469,0,1,2
44072,6,3,154474,154474,154477,0,3,5
44073,5,2,154479,154479,154481,0,2,2
44074,2,2,154481,154481,154483,0,2,0
44075,1,1,154482,154483,154484,1,2,0
44076,5,3,154487,154487,154490,0,3,3
44077,5,3,154492,154492,154495,0,3,2
44078,6,1,154498,154498,154499,0,1,3
44079,1,1,154499,154499,154500,0,1,0
44080,4,2,154503,154503,154505,0,2,3
44081,3,3,154506,154506,154509,0,3,1
44082,4,2,154510,154510,154512,0,2,1
44083,6,2,154516,154516,154518,0,2,4
44084,1,1,154517,154518,154519,1,2,0
44085,2,2,154519,154519,154521,0,2,0
44086,4,3,154523,154523,154526,0,3,2
44087,2,2,154525,154526,154528,1,3,0
44088,2,1,154527,154528,154529,1,2,0
44089,6,3,154533,154533,154536,0,3,4
44090,5,3,154538,154538,154541,0,3,2
44091,4,2,154542,154542,154544,0,2,1
44092,5,1,154547,154547,154548,0,1,3
44093,5,3,154552,154552,154555,0,3,4
44094,2,1,154554,154555,154556,1,2,0
44095,4,3,154558,154558,154561,0,3,2
44096,5,3,154563,154563,154566,0,3,2
44097,6,2,154569,154569,154571,0,2,3
44098,2,2,154571,154571,154573,0,2,0
44099,1,1,154572,154573,154574,1,2,0
44100,6,1,154578,154578,154579,0,1,4
44101,5,3,154583,154583,154586,0,3,4
44102,6,3,154589,154589,154592,0,3,3
44103,3,3,154592,154592,154595,0,3,0
44104,1,3,154593,154595,154598,2,5,0
44105,4,3,154597,154598,154601,1,4,0
44106,5,3,154602,154602,154605,0,3,1
44107,3,1,154605,154605,154606,0,1,0
44108,3,1,154608,154608,154609,0,1,2
44109,6,1,154614,154614,154615,0,1,5
44110,6,3,154620,154620,154623,0,3,5
44111,4,3,154624,154624,154627,0,3,1
44112,4,1,154628,154628,154629,0,1,1
44113,2,1,154630,154630,154631,0,1,1
44114,4,2,154634,154634,154636,0,2,3
44115,2,1,154636,154636,154637,0,1,0
44116,2,1,154638,154638,154639,0,1,1
44117,6,2,154644,154644,154646,0,2,5
44118,6,2,154650,154650,154652,0,2,4
44119,4,2,154654,154654,154656,0,2,2
44120,5,2,154659,154659,154661,0,2,3
44121,4,2,154663,154663,154665,0,2,2
44122,3,1,154666,154666,154667,0,1,1
44123,4,1,154670,154670,154671,0,1,3
44124,1,3,154671,154671,154674,0,3,0
44125,6,3,154677,154677,154680,0,3,3
44126,5,1,154682,154682,154683,0,1,2
44127,2,3,154684,154684,154687,0,3,1
44128,5,3,154689,154689,154692,0,3,2
44129,3,1,154692,154692,154693,0,1,0
44130,3,1,154695,154695,154696,0,1,2
44131,1,2,154696,154696,154698,0,2,0
44132,2,1,154698,154698,154699,0,1,0
44133,3,2,154701,154701,154703,0,2,2
44134,2,2,154703,154703,154705,0,2,0
44135,6,3,154709,154709,154712,0,3,4
44136,4,1,154713,154713,154714,0,1,1
44137,3,1,154716,154716,154717,0,1,2
44138,4,3,154720,154720,154723,0,3,3
44139,2,2,154722,154723,154725,1,3,0
44140,3,3,154725,154725,154728,0,3,0
44141,3,3,154728,154728,154731,0,3,0
44142,6,3,154734,154734,154737,0,3,3
44143,1,3,154735,154737,154740,2,5,0
44144,5,1,154740,154740,154741,0,1,0
44145,5,3,154745,154745,154748,0,3,4
44146,6,2,154751,154751,154753,0,2,3
44147,4,2,154755,154755,154757,0,2,2
44148,6,3,154761,154761,154764,0,3,4
44149,1,3,154762,154764,154767,2,5,0
44150,1,2,154763,154767,154769,4,6,0
44151,5,2,154768,154769,154771,1,3,0
44152,1,3,154769,154771,154774,2,5,0
44153,1,3,154770,154774,154777,4,7,0
44154,3,3,154773,154777,154780,4,7,0
44155,6,1,154779,154780,154781,1,2,0
44156,6,1,154785,154785,154786,0,1,4
44157,4,3,154789,154789,154792,0,3,3
44158,1,1,154790,154792,154793,2,3,0
44159,1,2,154791,154793,154795,2,4,0
44160,5,1,154796,154796,154797,0,1,1
44161,5,3,154801,154801,154804,0,3,4
44162,6,2,154807,154807,154809,0,2,3
44163,4,3,154811,154811,154814,0,3,2
44164,2,1,154813,154814,154815,1,2,0
44165,1,1,154814,154815,154816,1,2,0
44166,4,2,154818,154818,154820,0,2,2
44167,5,2,154823,154823,154825,0,2,3
44168,1,1,154824,154825,154826,1,2,0
44169,2,3,154826,154826,154829,0,3,0
44170,5,3,154831,154831,154834,0,3,2
44171,2,1,154833,154834,154835,1,2,0
44172,5,2,154838,154838,154840,0,2,3
44173,4,2,154842,154842,154844,0,2,2
44174,3,2,154845,154845,154847,0,2,1
44175,1,1,154846,154847,154848,1,2,0
44176,1,2,154847,154848,154850,1,3,0
44177,5,1,154852,154852,154853,0,1,2
44178,4,2,154856,154856,154858,0,2,3
44179,3,1,154859,154859,154860,0,1,1
44180,1,1,154860,154860,154861,0,1,0
44181,4,1,154864,154864,154865,0,1,3
44182,4,3,154868,154868,154871,0,3,3
44183,5,2,154873,154873,154875,0,2,2
44184,6,2,154879,154879,154881,0,2,4
44185,4,2,154883,154883,154885,0,2,2
44186,5,2,154888,154888,154890,0,2,3
44187,3,1,154891,154891,154892,0,1,1
44188,2,2,154893,154893,154895,0,2,1
44189,4,3,154897,154897,154900,0,3,2
44190,1,1,154898,154900,154901,2,3,0
44191,6,2,154904,154904,154906,0,2,3
44192,5,2,154909,154909,154911,0,2,3
44193,5,3,154914,154914,154917,0,3,3
44194,2,3,154916,154917,154920,1,4,0
44195,3,2,154919,154920,154922,1,3,0
44196,6,3,154925,154925,154928,0,3,3
44197,4,2,154929,154929,154931,0,2,1
44198,5,1,154934,154934,154935,0,1,3
44199,2,2,154936,154936,154938,0,2,1
44200,6,1,154942,154942,154943,0,1,4
44201,5,3,154947,154947,154950,0,3,4
44202,3,3,154950,154950,154953,0,3,0
44203,1,2,154951,154953,154955,2,4,0
44204,5,3,154956,154956,154959,0,3,1
44205,4,1,154960,154960,154961,0,1,1
44206,3,3,154963,154963,154966,0,3,2
44207,6,3,154969,154969,154972,0,3,3
44208,3,1,154972,154972,154973,0,1,0
44209,2,2,154974,154974,154976,0,2,1
44210,4,3,154978,154978,154981,0,3,2
44211,4,1,154982,154982,154983,0,1,1
44212,3,3,154985,154985,154988,0,3,2
44213,1,1,154986,154988,154989,2,3,0
44214,1,3,154987,154989,154992,2,5,0
44215,3,3,154990,154992,154995,2,5,0
44216,3,1,154993,154995,154996,2,3,0
44217,5,1,154998,154998,154999,0,1,2
44218,6,3,155004,155004,155007,0,3,5
44219,5,1,155009,155009,155010,0,1,2
44220,1,3,155010,155010,155013,0,3,0
44221,2,3,155012,155013,155016,1,4,0
44222,6,3,155018,155018,155021,0,3,2
44223,3,3,155021,155021,155024,0,3,0
44224,5,2,155026,155026,155028,0,2,2
44225,1,1,155027,155028,155029,1,2,0
44226,5,1,155032,155032,155033,0,1,3
44227,6,3,155038,155038,155041,0,3,5
44228,6,1,155044,155044,155045,0,1,3
44229,4,1,155048,155048,155049,0,1,3
44230,6,3,155054,155054,155057,0,3,5
44231,4,1,155058,155058,155059,0,1,1
44232,4,2,155062,155062,155064,0,2,3
44233,3,2,155065,155065,155067,0,2,1
44234,6,3,155071,155071,155074,0,3,4
44235,3,3,155074,155074,155077,0,3,0
44236,3,3,155077,155077,155080,0,3,0
44237,6,2,155083,155083,155085,0,2,3
44238,4,1,155087,155087,155088,0,1,2
44239,4,2,155091,155091,155093,0,2,3
44240,2,1,155093,155093,155094,0,1,0
44241,2,2,155095,155095,155097,0,2,1
44242,2,1,155097,155097,155098,0,1,0
44243,2,2,155099,155099,155101,0,2,1
44244,2,2,155101,155101,155103,0,2,0
44245,6,3,155107,155107,155110,0,3,4
44246,2,3,155109,155110,155113,1,4,0
44247,2,2,155111,155113,155115,2,4,0
44248,6,1,155117,155117,155118,0,1,2
44249,3,1,155120,155120,155121,0,1,2
44250,6,2,155126,155126,155128,0,2,5
44251,4,2,155130,155130,155132,0,2,2
44252,3,2,155133,155133,155135,0,2,1
44253,6,2,155139,155139,155141,0,2,4
44254,2,1,155141,155141,155142,0,1,0
44255,2,2,155143,155143,155145,0,2,1
44256,3,3,155146,155146,155149,0,3,1
44257,3,2,155149,155149,155151,0,2,0
44258,2,2,155151,155151,155153,0,2,0
44259,5,1,155156,155156,155157,0,1,3
44260,6,3,155162,155162,155165,0,3,5
44261,6,2,155168,155168,155170,0,2,3
44262,2,2,155170,155170,155172,0,2,0
44263,2,2,155172,155172,155174,0,2,0
44264,4,3,155176,155176,155179,0,3,2
44265,2,3,155178,155179,155182,1,4,0
44266,2,3,155180,155182,155185,2,5,0
44267,6,2,155186,155186,155188,0,2,1
44268,1,1,155187,155188,155189,1,2,0
44269,4,3,155191,155191,155194,0,3,2
44270,2,2,155193,155194,155196,1,3,0
44271,1,2,155194,155196,155198,2,4,0
44272,4,1,155198,155198,155199,0,1,0
44273,2,3,155200,155200,155203,0,3,1
44274,1,1,155201,155203,155204,2,3,0
44275,4,2,155205,155205,155207,0,2,1
44276,4,3,155209,155209,155212,0,3,2
44277,3,3,155212,155212,155215,0,3,0
44278,3,2,155215,155215,155217,0,2,0
44279,1,1,155216,155217,155218,1,2,0
44280,4,2,155220,155220,155222,0,2,2
44281,1,3,155221,155222,155225,1,4,0
44282,2,3,155223,155225,155228,2,5,0
44283,3,3,155226,155228,155231,2,5,0
44284,4,2,155230,155231,155233,1,3,0
44285,3,3,155233,155233,155236,0,3,0
44286,1,1,155234,155236,155237,2,3,0
44287,1,1,155235,155237,155238,2,3,0
44288,2,1,155237,155238,155239,1,2,0
44289,4,2,155241,155241,155243,0,2,2
44290,1,3,155242,155243,155246,1,4,0
44291,5,3,155247,155247,155250,0,3,1
44292,2,1,155249,155250,155251,1,2,0
44293,1,1,155250,155251,155252,1,2,0
44294,5,3,155255,155255,155258,0,3,3
44295,3,2,155258,155258,155260,0,2,0
44296,2,1,155260,155260,155261,0,1,0
44297,5,1,155265,155265,155266,0,1,4
44298,3,2,155268,155268,155270,0,2,2
44299,1,1,155269,155270,155271,1,2,0
44300,4,1,155273,155273,155274,0,1,2
44301,5,2,155278,155278,155280,0,2,4
44302,6,1,155284,155284,155285,0,1,4
44303,4,2,155288,155288,155290,0,2,3
44304,3,1,155291,155291,155292,0,1,1
44305,5,1,155296,155296,155297,0,1,4
44306,4,1,155300,155300,155301,0,1,3
44307,1,3,155301,155301,155304,0,3,0
44308,1,1,155302,155304,155305,2,3,0
44309,3,2,155305,155305,155307,0,2,0
44310,2,2,155307,155307,155309,0,2,0
44311,3,2,155310,155310,155312,0,2,1
44312,4,3,155314,155314,155317,0,3,2
44313,5,1,155319,155319,155320,0,1,2
44314,1,2,155320,155320,155322,0,2,0
44315,6,3,155326,155326,155329,0,3,4
44316,5,2,155331,155331,155333,0,2,2
44317,4,1,155335,155335,155336,0,1,2
44318,5,1,155340,155340,155341,0,1,4
44319,5,3,155345,155345,155348,0,3,4
44320,3,3,155348,155348,155351,0,3,0
44321,1,1,155349,155351,155352,2,3,0
44322,1,2,155350,155352,155354,2,4,0
44323,5,2,155355,155355,155357,0,2,1
44324,1,2,155356,155357,155359,1,3,0
44325,6,2,155362,155362,155364,0,2,3
44326,3,3,155365,155365,155368,0,3,1
44327,4,1,155369,155369,155370,0,1,1
44328,3,1,155372,155372,155373,0,1,2
44329,3,3,155375,155375,155378,0,3,2
44330,1,2,155376,155378,155380,2,4,0
44331,3,3,155379,155380,155383,1,4,0
44332,1,3,155380,155383,155386,3,6,0
44333,4,1,155384,155386,155387,2,3,0
44334,2,2,155386,155387,155389,1,3,0
44335,6,2,155392,155392,155394,0,2,3
44336,5,3,155397,155397,155400,0,3,3
44337,2,2,155399,155400,155402,1,3,0
44338,6,1,155405,155405,155406,0,1,3
44339,1,2,155406,155406,155408,0,2,0
44340,2,2,155408,155408,155410,0,2,0
44341,1,1,155409,155410,155411,1,2,0
44342,2,1,155411,155411,155412,0,1,0
44343,3,3,155414,155414,155417,0,3,2
44344,1,1,155415,155417,155418,2,3,0
44345,2,3,155417,155418,155421,1,4,0
44346,3,2,155420,155421,155423,1,3,0
44347,5,1,155425,155425,155426,0,1,2
44348,3,2,155428,155428,155430,0,2,2
44349,2,2,155430,155430,155432,0,2,0
44350,4,1,155434,155434,155435,0,1,2
44351,3,1,155437,155437,155438,0,1,2
44352,6,3,155443,155443,155446,0,3,5
44353,4,2,155447,155447,155449,0,2,1
44354,2,2,155449,155449,155451,0,2,0
44355,6,1,155455,155455,155456,0,1,4
44356,4,1,155459,155459,155460,0,1,3
44357,4,3,155463,155463,155466,0,3,3
44358,4,3,155467,155467,155470,0,3,1
44359,5,3,155472,155472,155475,0,3,2
44360,4,3,155476,155476,155479,0,3,1
44361,4,3,155480,155480,155483,0,3,1
44362,6,3,155486,155486,155489,0,3,3
44363,4,1,155490,155490,155491,0,1,1
44364,2,1,155492,155492,155493,0,1,1
44365,2,3,155494,155494,155497,0,3,1
44366,6,2,155500,155500,155502,0,2,3
44367,1,3,155501,155502,155505,1,4,0
44368,2,2,155503,155505,155507,2,4,0
44369,5,2,155508,155508,155510,0,2,1
44370,2,1,155510,155510,155511,0,1,0
44371,1,2,155511,155511,155513,0,2,0
44372,4,1,155515,155515,155516,0,1,2
44373,4,3,155519,155519,155522,0,3,3
44374,6,3,155525,155525,155528,0,3,3
44375,1,3,155526,155528,155531,2,5,0
44376,3,1,155529,155531,155532,2,3,0
44377,1,2,155530,155532,155534,2,4,0
44378,6,1,155536,155536,155537,0,1,2
44379,2,3,155538,155538,155541,0,3,1
44380,6,3,155544,155544,155547,0,3,3
44381,5,1,155549,155549,155550,0,1,2
44382,2,3,155551,155551,155554,0,3,1
44383,3,1,155554,155554,155555,0,1,0
44384,3,3,155557,155557,155560,0,3,2
44385,6,3,155563,155563,155566,0,3,3
44386,6,2,155569,155569,155571,0,2,3
44387,6,1,155575,155575,155576,0,1,4
44388,2,1,155577,155577,155578,0,1,1
44389,6,1,155583,155583,155584,0,1,5
44390,2,3,155585,155585,155588,0,3,1
44391,4,2,155589,155589,155591,0,2,1
44392,5,3,155594,155594,155597,0,3,3
44393,1,1,155595,155597,155598,2,3,0
44394,5,1,155600,155600,155601,0,1,2
44395,5,3,155605,155605,155608,0,3,4
44396,4,3,155609,155609,155612,0,3,1
44397,6,2,155615,155615,155617,0,2,3
44398,1,3,155616,155617,155620,1,4,0
44399,2,1,155618,155620,155621,2,3,0
44400,5,1,155623,155623,155624,0,1,2
44401,2,3,155625,155625,155628,0,3,1
44402,4,3,155629,155629,155632,0,3,1
44403,1,1,155630,155632,155633,2,3,0
44404,1,2,155631,155633,155635,2,4,0
44405,3,2,155634,155635,155637,1,3,0
44406,5,3,155639,155639,155642,0,3,2
44407,4,3,155643,155643,155646,0,3,1
44408,1,3,155644,155646,155649,2,5,0
44409,4,3,155648,155649,155652,1,4,0
44410,4,1,155652,155652,155653,0,1,0
44411,5,2,155657,155657,155659,0,2,4
44412,6,1,155663,155663,155664,0,1,4
44413,6,1,155669,155669,155670,0,1,5
44414,1,1,155670,155670,155671,0,1,0
44415,4,3,155674,155674,155677,0,3,3
44416,2,2,155676,155677,155679,1,3,0
44417,4,2,155680,155680,155682,0,2,1
44418,1,2,155681,155682,155684,1,3,0
44419,2,3,155683,155684,155687,1,4,0
44420,3,2,155686,155687,155689,1,3,0
44421,1,1,155687,155689,155690,2,3,0
44422,6,3,155693,155693,155696,0,3,3
44423,3,3,155696,155696,155699,0,3,0
44424,4,2,155700,155700,155702,0,2,1
44425,5,2,155705,155705,155707,0,2,3
44426,6,2,155711,155711,155713,0,2,4
44427,4,2,155715,155715,155717,0,2,2
44428,1,3,155716,155717,155720,1,4,0
44429,6,3,155722,155722,155725,0,3,2
44430,1,3,155723,155725,155728,2,5,0
44431,1,1,155724,155728,155729,4,5,0
44432,6,2,155730,155730,155732,0,2,1
44433,4,2,155734,155734,155736,0,2,2
44434,1,1,155735,155736,155737,1,2,0
44435,1,1,155736,155737,155738,1,2,0
44436,4,3,155740,155740,155743,0,3,2
44437,3,1,155743,155743,155744,0,1,0
44438,3,1,155746,155746,155747,0,1,2
44439,3,2,155749,155749,155751,0,2,2
44440,1,2,155750,155751,155753,1,3,0
44441,2,2,155752,155753,155755,1,3,0
44442,3,3,155755,155755,155758,0,3,0
44443,6,3,155761,155761,155764,0,3,3
44444,4,3,155765,155765,155768,0,3,1
44445,2,2,155767,155768,155770,1,3,0
44446,6,1,155773,155773,155774,0,1,3
44447,2,1,155775,155775,155776,0,1,1
44448,5,2,155780,155780,155782,0,2,4
44449,5,1,155785,155785,155786,0,1,3
44450,1,2,155786,155786,155788,0,2,0
44451,4,3,155790,155790,155793,0,3,2
44452,2,2,155792,155793,155795,1,3,0
44453,5,1,155797,155797,155798,0,1,2
44454,2,3,155799,155799,155802,0,3,1
44455,5,1,155804,155804,155805,0,1,2
44456,3,2,155807,155807,155809,0,2,2
44457,3,2,155810,155810,155812,0,2,1
44458,4,2,155814,155814,155816,0,2,2
44459,5,1,155819,155819,155820,0,1,3
44460,4,2,155823,155823,155825,0,2,3
44461,1,3,155824,155825,155828,1,4,0
44462,4,3,155828,155828,155831,0,3,0
44463,2,2,155830,155831,155833,1,3,0
44464,3,1,155833,155833,155834,0,1,0
44465,2,2,155835,155835,155837,0,2,1
44466,4,3,155839,155839,155842,0,3,2
44467,1,1,155840,155842,155843,2,3,0
44468,3,1,155843,155843,155844,0,1,0
44469,6,2,155849,155849,155851,0,2,5
44470,5,1,155854,155854,155855,0,1,3
44471,1,3,155855,155855,155858,0,3,0
44472,3,3,155858,155858,155861,0,3,0
44473,4,1,155862,155862,155863,0,1,1
44474,2,3,155864,155864,155867,0,3,1
44475,5,3,155869,155869,155872,0,3,2
44476,5,1,155874,155874,155875,0,1,2
44477,5,3,155879,155879,155882,0,3,4
44478,1,1,155880,155882,155883,2,3,0
44479,6,1,155886,155886,155887,0,1,3
44480,3,3,155889,155889,155892,0,3,2
44481,4,3,155893,155893,155896,0,3,1
44482,3,2,155896,155896,155898,0,2,0
44483,6,1,155902,155902,155903,0,1,4
44484,2,2,155904,155904,155906,0,2,1
44485,5,1,155909,155909,155910,0,1,3
44486,3,1,155912,155912,155913,0,1,2
44487,4,2,155916,155916,155918,0,2,3
44488,4,2,155920,155920,155922,0,2,2
44489,3,2,155923,155923,155925,0,2,1
44490,6,2,155929,155929,155931,0,2,4
44491,5,3,155934,155934,155937,0,3,3
44492,5,3,155939,155939,155942,0,3,2
44493,3,2,155942,155942,155944,0,2,0
44494,4,1,155946,155946,155947,0,1,2
44495,2,2,155948,155948,155950,0,2,1
44496,3,2,155951,155951,155953,0,2,1
44497,4,2,155955,155955,155957,0,2,2
44498,4,3,155959,155959,155962,0,3,2
44499,5,2,155964,155964,155966,0,2,2
44500,6,3,155970,155970,155973,0,3,4
44501,1,3,155971,155973,155976,2,5,0
44502,3,1,155974,155976,155977,2,3,0
44503,5,1,155979,155979,155980,0,1,2
44504,1,1,155980,155980,155981,0,1,0
44505,3,3,155983,155983,155986,0,3,2
44506,1,1,155984,155986,155987,2,3,0
44507,2,3,155986,155987,155990,1,4,0
44508,6,1,155992,155992,155993,0,1,2
44509,2,2,155994,155994,155996,0,2,1
44510,6,1,156000,156000,156001,0,1,4
44511,2,3,156002,156002,156005,0,3,1
44512,2,2,156004,156005,156007,1,3,0
44513,5,2,156009,156009,156011,0,2,2
44514,1,1,156010,156011,156012,1,2,0
44515,6,2,156016,156016,156018,0,2,4
44516,1,1,156017,156018,156019,1,2,0
44517,5,3,156022,156022,156025,0,3,3
44518,3,3,156025,156025,156028,0,3,0
44519,2,2,156027,156028,156030,1,3,0
44520,2,3,156029,156030,156033,1,4,0
44521,1,1,156030,156033,156034,3,4,0
44522,3,1,156033,156034,156035,1,2,0
44523,6,1,156039,156039,156040,0,1,4
44524,4,2,156043,156043,156045,0,2,3
44525,2,1,156045,156045,156046,0,1,0
44526,5,1,156050,156050,156051,0,1,4
44527,6,1,156056,156056,156057,0,1,5
44528,3,2,156059,156059,156061,0,2,2
44529,4,1,156063,156063,156064,0,1,2
44530,1,2,156064,156064,156066,0,2,0
44531,6,1,156070,156070,156071,0,1,4
44532,4,1,156074,156074,156075,0,1,3
44533,1,1,156075,156075,156076,0,1,0
44534,2,2,156077,156077,156079,0,2,1
44535,1,1,156078,156079,156080,1,2,0
44536,2,1,156080,156080,156081,0,1,0
44537,2,3,156082,156082,156085,0,3,1
44538,5,2,156087,156087,156089,0,2,2
44539,1,1,156088,156089,156090,1,2,0
44540,4,1,156092,156092,156093,0,1,2
44541,3,3,156095,156095,156098,0,3,2
44542,5,1,156100,156100,156101,0,1,2
44543,2,1,156102,156102,156103,0,1,1
44544,6,2,156108,156108,156110,0,2,5
44545,4,3,156112,156112,156115,0,3,2
44546,1,2,156113,156115,156117,2,4,0
44547,5,2,156118,156118,156120,0,2,1
44548,5,1,156123,156123,156124,0,1,3
44549,2,2,156125,156125,156127,0,2,1
44550,3,1,156128,156128,156129,0,1,1
44551,4,3,156132,156132,156135,0,3,3
44552,5,3,156137,156137,156140,0,3,2
44553,5,2,156142,156142,156144,0,2,2
44554,3,1,156145,156145,156146,0,1,1
44555,3,3,156148,156148,156151,0,3,2
44556,1,3,156149,156151,156154,2,5,0
44557,4,3,156153,156154,156157,1,4,0
44558,5,3,156158,156158,156161,0,3,1
44559,5,1,156163,156163,156164,0,1,2
44560,3,2,156166,156166,156168,0,2,2
44561,6,1,156172,156172,156173,0,1,4
44562,4,3,156176,156176,156179,0,3,3
44563,6,3,156182,156182,156185,0,3,3
44564,6,2,156188,156188,156190,0,2,3
44565,2,3,156190,156190,156193,0,3,0
44566,5,3,156195,156195,156198,0,3,2
44567,6,1,156201,156201,156202,0,1,3
44568,3,3,156204,156204,156207,0,3,2
44569,1,2,156205,156207,156209,2,4,0
44570,4,1,156209,156209,156210,0,1,0
44571,2,2,156211,156211,156213,0,2,1
44572,5,1,156216,156216,156217,0,1,3
44573,1,3,156217,156217,156220,0,3,0
44574,4,3,156221,156221,156224,0,3,1
44575,1,1,156222,156224,156225,2,3,0
44576,4,1,156226,156226,156227,0,1,1
44577,3,3,156229,156229,156232,0,3,2
44578,5,3,156234,156234,156237,0,3,2
44579,1,3,156235,156237,156240,2,5,0
44580,5,1,156240,156240,156241,0,1,0
44581,4,1,156244,156244,156245,0,1,3
44582,6,1,156250,156250,156251,0,1,5
44583,5,2,156255,156255,156257,0,2,4
44584,4,2,156259,156259,156261,0,2,2
44585,5,3,156264,156264,156267,0,3,3
44586,2,1,156266,156267,156268,1,2,0
44587,4,1,156270,156270,156271,0,1,2
44588,6,2,156276,156276,156278,0,2,5
44589,4,2,156280,156280,156282,0,2,2
44590,2,2,156282,156282,156284,0,2,0
44591,4,2,156286,156286,156288,0,2,2
44592,6,2,156292,156292,156294,0,2,4
44593,3,1,156295,156295,156296,0,1,1
44594,3,2,156298,156298,156300,0,2,2
44595,4,3,156302,156302,156305,0,3,2
44596,5,1,156307,156307,156308,0,1,2
44597,3,3,156310,156310,156313,0,3,2
44598,4,2,156314,156314,156316,0,2,1
44599,3,2,156317,156317,156319,0,2,1
44600,6,3,156323,156323,156326,0,3,4
44601,2,2,156325,156326,156328,1,3,0
44602,5,3,156330,156330,156333,0,3,2
44603,3,3,156333,156333,156336,0,3,0
44604,1,3,156334,156336,156339,2,5,0
44605,4,3,156338,156339,156342,1,4,0
44606,6,1,156344,156344,156345,0,1,2
44607,6,2,156350,156350,156352,0,2,5
44608,5,3,156355,156355,156358,0,3,3
44609,1,1,156356,156358,156359,2,3,0
44610,3,2,156359,156359,156361,0,2,0
44611,3,2,156362,156362,156364,0,2,1
44612,2,3,156364,156364,156367,0,3,0
44613,5,3,156369,156369,156372,0,3,2
44614,2,2,156371,156372,156374,1,3,0
44615,5,1,156376,156376,156377,0,1,2
44616,3,1,156379,156379,156380,0,1,2
44617,6,1,156385,156385,156386,0,1,5
44618,4,1,156389,156389,156390,0,1,3
44619,6,3,156395,156395,156398,0,3,5
44620,3,1,156398,156398,156399,0,1,0
44621,5,2,156403,156403,156405,0,2,4
44622,1,1,156404,156405,156406,1,2,0
44623,5,1,156409,156409,156410,0,1,3
44624,2,1,156411,156411,156412,0,1,1
44625,1,3,156412,156412,156415,0,3,0
44626,4,1,156416,156416,156417,0,1,1
44627,5,2,156421,156421,156423,0,2,4
44628,2,1,156423,156423,156424,0,1,0
44629,4,3,156427,156427,156430,0,3,3
44630,2,3,156429,156430,156433,1,4,0
44631,4,2,156433,156433,156435,0,2,0
44632,2,3,156435,156435,156438,0,3,0
44633,1,1,156436,156438,156439,2,3,0
44634,1,3,156437,156439,156442,2,5,0
44635,4,3,156441,156442,156445,1,4,0
44636,1,3,156442,156445,156448,3,6,0
44637,5,2,156447,156448,156450,1,3,0
44638,5,3,156452,156452,156455,0,3,2
44639,5,2,156457,156457,156459,0,2,2
44640,5,2,156462,156462,156464,0,2,3
44641,2,1,156464,156464,156465,0,1,0
44642,5,2,156469,156469,156471,0,2,4
44643,1,3,156470,156471,156474,1,4,0
44644,2,2,156472,156474,156476,2,4,0
44645,2,1,156474,156476,156477,2,3,0
44646,4,3,156478,156478,156481,0,3,1
44647,3,1,156481,156481,156482,0,1,0
44648,3,3,156484,156484,156487,0,3,2
44649,6,3,156490,156490,156493,0,3,3
44650,2,1,156492,156493,156494,1,2,0
44651,4,1,156496,156496,156497,0,1,2
44652,5,2,156501,156501,156503,0,2,4
44653,3,3,156504,156504,156507,0,3,1
44654,1,2,156505,156507,156509,2,4,0
44655,6,2,156511,156511,156513,0,2,2
44656,2,2,156513,156513,156515,0,2,0
44657,6,1,156519,156519,156520,0,1,4
44658,1,3,156520,156520,156523,0,3,0
44659,6,1,156526,156526,156527,0,1,3
44660,3,3,156529,156529,156532,0,3,2
44661,4,1,156533,156533,156534,0,1,1
44662,2,2,156535,156535,156537,0,2,1
44663,6,1,156541,156541,156542,0,1,4
44664,5,3,156546,156546,156549,0,3,4
44665,2,3,156548,156549,156552,1,4,0
44666,4,1,156552,156552,156553,0,1,0
44667,4,2,156556,156556,156558,0,2,3
44668,4,1,156560,156560,156561,0,1,2
44669,6,2,156566,156566,156568,0,2,5
44670,3,2,156569,156569,156571,0,2,1
44671,3,1,156572,156572,156573,0,1,1
44672,1,3,156573,156573,156576,0,3,0
44673,6,3,156579,156579,156582,0,3,3
44674,4,1,156583,156583,156584,0,1,1
44675,3,1,156586,156586,156587,0,1,2
44676,3,2,156589,156589,156591,0,2,2
44677,3,3,156592,156592,156595,0,3,1
44678,5,2,156597,156597,156599,0,2,2
44679,3,1,156600,156600,156601,0,1,1
44680,1,2,156601,156601,156603,0,2,0
44681,3,3,156604,156604,156607,0,3,1
44682,1,3,156605,156607,156610,2,5,0
44683,1,1,156606,156610,156611,4,5,0
44684,5,1,156611,156611,156612,0,1,0
44685,3,2,156614,156614,156616,0,2,2
44686,5,2,156619,156619,156621,0,2,3
44687,6,1,156625,156625,156626,0,1,4
44688,6,3,156631,156631,156634,0,3,5
44689,6,3,156637,156637,156640,0,3,3
44690,1,3,156638,156640,156643,2,5,0
44691,3,3,156641,156643,156646,2,5,0
44692,3,1,156644,156646,156647,2,3,0
44693,6,3,156650,156650,156653,0,3,3
44694,2,3,156652,156653,156656,1,4,0
44695,6,1,156658,156658,156659,0,1,2
44696,2,2,156660,156660,156662,0,2,1
44697,4,1,156664,156664,156665,0,1,2
44698,3,3,156667,156667,156670,0,3,2
44699,1,3,156668,156670,156673,2,5,0
44700,2,3,156670,156673,156676,3,6,0
44701,5,3,156675,156676,156679,1,4,0
44702,6,2,156681,156681,156683,0,2,2
44703,3,3,156684,156684,156687,0,3,1
44704,1,2,156685,156687,156689,2,4,0
44705,5,1,156690,156690,156691,0,1,1
44706,3,3,156693,156693,156696,0,3,2
44707,3,3,156696,156696,156699,0,3,0
44708,6,1,156702,156702,156703,0,1,3
44709,4,3,156706,156706,156709,0,3,3
44710,1,2,156707,156709,156711,2,4,0
44711,2,3,156709,156711,156714,2,5,0
44712,4,2,156713,156714,156716,1,3,0
44713,6,1,156719,156719,156720,0,1,3
44714,3,1,156722,156722,156723,0,1,2
44715,3,2,156725,156725,156727,0,2,2
44716,1,3,156726,156727,156730,1,4,0
44717,6,1,156732,156732,156733,0,1,2
44718,3,3,156735,156735,156738,0,3,2
44719,1,3,156736,156738,156741,2,5,0
44720,5,2,156741,156741,156743,0,2,0
44721,5,3,156746,156746,156749,0,3,3
44722,5,2,156751,156751,156753,0,2,2
44723,6,3,156757,156757,156760,0,3,4
44724,1,1,156758,156760,156761,2,3,0
44725,4,3,156762,156762,156765,0,3,1
44726,6,3,156768,156768,156771,0,3,3
44727,4,3,156772,156772,156775,0,3,1
44728,6,1,156778,156778,156779,0,1,3
44729,3,2,156781,156781,156783,0,2,2
44730,6,3,156787,156787,156790,0,3,4
44731,5,2,156792,156792,156794,0,2,2
44732,5,1,156797,156797,156798,0,1,3
44733,6,1,156803,156803,156804,0,1,5
44734,6,1,156809,156809,156810,0,1,5
44735,1,1,156810,156810,156811,0,1,0
44736,6,3,156816,156816,156819,0,3,5
44737,6,2,156822,156822,156824,0,2,3
44738,1,3,156823,156824,156827,1,4,0
44739,3,3,156826,156827,156830,1,4,0
44740,5,2,156831,156831,156833,0,2,1
44741,6,1,156837,156837,156838,0,1,4
44742,3,3,156840,156840,156843,0,3,2
44743,6,3,156846,156846,156849,0,3,3
44744,2,3,156848,156849,156852,1,4,0
44745,3,3,156851,156852,156855,1,4,0
44746,2,2,156853,156855,156857,2,4,0
44747,2,2,156855,156857,156859,2,4,0
44748,4,2,156859,156859,156861,0,2,0
44749,5,2,156864,156864,156866,0,2,3
44750,3,3,156867,156867,156870,0,3,1
44751,2,1,156869,156870,156871,1,2,0
44752,6,1,156875,156875,156876,0,1,4
44753,2,1,156877,156877,156878,0,1,1
44754,4,2,156881,156881,156883,0,2,3
44755,1,1,156882,156883,156884,1,2,0
44756,1,1,156883,156884,156885,1,2,0
44757,1,3,156884,156885,156888,1,4,0
44758,2,3,156886,156888,156891,2,5,0
44759,3,2,156889,156891,156893,2,4,0
44760,6,2,156895,156895,156897,0,2,2
44761,1,3,156896,156897,156900,1,4,0
44762,4,1,156900,156900,156901,0,1,0
44763,6,3,156906,156906,156909,0,3,5
44764,5,1,156911,156911,156912,0,1,2
44765,1,3,156912,156912,156915,0,3,0
44766,4,2,156916,156916,156918,0,2,1
44767,5,2,156921,156921,156923,0,2,3
44768,1,2,156922,156923,156925,1,3,0
44769,6,1,156928,156928,156929,0,1,3
44770,5,3,156933,156933,156936,0,3,4
44771,2,2,156935,156936,156938,1,3,0
44772,4,1,156939,156939,156940,0,1,1
44773,2,3,156941,156941,156944,0,3,1
44774,2,1,156943,156944,156945,1,2,0
44775,2,3,156945,156945,156948,0,3,0
44776,4,2,156949,156949,156951,0,2,1
44777,5,2,156954,156954,156956,0,2,3
44778,5,2,156959,156959,156961,0,2,3
44779,4,2,156963,156963,156965,0,2,2
44780,1,2,156964,156965,156967,1,3,0
44781,5,3,156969,156969,156972,0,3,2
44782,6,2,156975,156975,156977,0,2,3
44783,5,2,156980,156980,156982,0,2,3
44784,6,1,156986,156986,156987,0,1,4
44785,2,2,156988,156988,156990,0,2,1
44786,1,3,156989,156990,156993,1,4,0
44787,4,3,156993,156993,156996,0,3,0
44788,3,2,156996,156996,156998,0,2,0
44789,2,2,156998,156998,157000,0,2,0
44790,6,2,157004,157004,157006,0,2,4
44791,6,2,157010,157010,157012,0,2,4
44792,2,3,157012,157012,157015,0,3,0
44793,3,1,157015,157015,157016,0,1,0
44794,3,3,157018,157018,157021,0,3,2
44795,5,2,157023,157023,157025,0,2,2
44796,4,2,157027,157027,157029,0,2,2
44797,6,1,157033,157033,157034,0,1,4
44798,3,2,157036,157036,157038,0,2,2
44799,5,2,157041,157041,157043,0,2,3
44800,4,2,157045,157045,157047,0,2,2
44801,6,2,157051,157051,157053,0,2,4
44802,5,2,157056,157056,157058,0,2,3
44803,2,3,157058,157058,157061,0,3,0
44804,2,3,157060,157061,157064,1,4,0
44805,4,2,157064,157064,157066,0,2,0
44806,4,3,157068,157068,157071,0,3,2
44807,5,1,157073,157073,157074,0,1,2
44808,1,2,157074,157074,157076,0,2,0
44809,2,3,157076,157076,157079,0,3,0
44810,4,2,157080,157080,157082,0,2,1
44811,5,2,157085,157085,157087,0,2,3
44812,5,3,157090,157090,157093,0,3,3
44813,2,3,157092,157093,157096,1,4,0
44814,1,2,157093,157096,157098,3,5,0
44815,2,1,157095,157098,157099,3,4,0
44816,6,1,157101,157101,157102,0,1,2
44817,6,3,157107,157107,157110,0,3,5
44818,1,3,157108,157110,157113,2,5,0
44819,4,3,157112,157113,157116,1,4,0
44820,4,1,157116,157116,157117,0,1,0
44821,3,2,157119,157119,157121,0,2,2
44822,2,1,157121,157121,157122,0,1,0
44823,3,1,157124,157124,157125,0,1,2
44824,1,1,157125,157125,157126,0,1,0
44825,5,2,157130,157130,157132,0,2,4
44826,5,1,157135,157135,157136,0,1,3
44827,1,2,157136,157136,157138,0,2,0
44828,4,2,157140,157140,157142,0,2,2
44829,5,3,157145,157145,157148,0,3,3
44830,5,1,157150,157150,157151,0,1,2
44831,6,2,157156,157156,157158,0,2,5
44832,5,2,157161,157161,157163,0,2,3
44833,1,2,157162,157163,157165,1,3,0
44834,6,3,157168,157168,157171,0,3,3
44835,6,2,157174,157174,157176,0,2,3
44836,5,1,157179,157179,157180,0,1,3
44837,5,2,157184,157184,157186,0,2,4
44838,2,2,157186,157186,157188,0,2,0
44839,6,1,157192,157192,157193,0,1,4
44840,2,2,157194,157194,157196,0,2,1
44841,6,1,157200,157200,157201,0,1,4
44842,1,1,157201,157201,157202,0,1,0
44843,4,3,157205,157205,157208,0,3,3
44844,1,3,157206,157208,157211,2,5,0
44845,6,3,157212,157212,157215,0,3,1
44846,6,1,157218,157218,157219,0,1,3
44847,4,3,157222,157222,157225,0,3,3
44848,4,3,157226,157226,157229,0,3,1
44849,4,2,157230,157230,157232,0,2,1
44850,5,3,157235,157235,157238,0,3,3
44851,3,3,157238,157238,157241,0,3,0
44852,5,1,157243,157243,157244,0,1,2
44853,6,1,157249,157249,157250,0,1,5
44854,5,3,157254,157254,157257,0,3,4
44855,5,2,157259,157259,157261,0,2,2
44856,3,3,157262,157262,157265,0,3,1
44857,1,1,157263,157265,157266,2,3,0
44858,6,2,157269,157269,157271,0,2,3
44859,4,2,157273,157273,157275,0,2,2
44860,2,1,157275,157275,157276,0,1,0
44861,4,3,157279,157279,157282,0,3,3
44862,3,3,157282,157282,157285,0,3,0
44863,4,1,157286,157286,157287,0,1,1
44864,5,3,157291,157291,157294,0,3,4
44865,3,3,157294,157294,157297,0,3,0
44866,1,3,157295,157297,157300,2,5,0
44867,5,1,157300,157300,157301,0,1,0
44868,4,3,157304,157304,157307,0,3,3
44869,3,2,157307,157307,157309,0,2,0
44870,4,3,157311,157311,157314,0,3,2
44871,5,1,157316,157316,157317,0,1,2
44872,2,3,157318,157318,157321,0,3,1
44873,1,1,157319,157321,157322,2,3,0
44874,1,3,157320,157322,157325,2,5,0
44875,4,1,157324,157325,157326,1,2,0
44876,2,3,157326,157326,157329,0,3,0
44877,4,2,157330,157330,157332,0,2,1
44878,4,1,157334,157334,157335,0,1,2
44879,5,3,157339,157339,157342,0,3,4
44880,5,2,157344,157344,157346,0,2,2
44881,4,3,157348,157348,157351,0,3,2
44882,3,1,157351,157351,157352,0,1,0
44883,4,1,157355,157355,157356,0,1,3
44884,1,2,157356,157356,157358,0,2,0
44885,6,2,157362,157362,157364,0,2,4
44886,5,2,157367,157367,157369,0,2,3
44887,4,3,157371,157371,157374,0,3,2
44888,4,2,157375,157375,157377,0,2,1
44889,4,3,157379,157379,157382,0,3,2
44890,2,2,157381,157382,157384,1,3,0
44891,3,1,157384,157384,157385,0,1,0
44892,2,2,157386,157386,157388,0,2,1
44893,5,1,157391,157391,157392,0,1,3
44894,5,1,157396,157396,157397,0,1,4
44895,6,3,157402,157402,157405,0,3,5
44896,5,1,157407,157407,157408,0,1,2
44897,1,1,157408,157408,157409,0,1,0
44898,5,2,157413,157413,157415,0,2,4
44899,5,3,157418,157418,157421,0,3,3
44900,2,2,157420,157421,157423,1,3,0
44901,5,1,157425,157425,157426,0,1,2
44902,5,3,157430,157430,157433,0,3,4
44903,5,3,157435,157435,157438,0,3,2
44904,3,1,157438,157438,157439,0,1,0
44905,2,3,157440,157440,157443,0,3,1
44906,3,3,157443,157443,157446,0,3,0
44907,3,2,157446,157446,157448,0,2,0
44908,2,1,157448,157448,157449,0,1,0
44909,4,3,157452,157452,157455,0,3,3
44910,2,3,157454,157455,157458,1,4,0
44911,6,2,157460,157460,157462,0,2,2
44912,3,1,157463,157463,157464,0,1,1
44913,3,3,157466,157466,157469,0,3,2
44914,4,3,157470,157470,157473,0,3,1
44915,6,2,157476,157476,157478,0,2,3
44916,6,1,157482,157482,157483,0,1,4
44917,5,3,157487,157487,157490,0,3,4
44918,2,3,157489,157490,157493,1,4,0
44919,2,3,157491,157493,157496,2,5,0
44920,6,2,157497,157497,157499,0,2,1
44921,6,1,157503,157503,157504,0,1,4
44922,6,3,157509,157509,157512,0,3,5
44923,2,1,157511,157512,157513,1,2,0
44924,3,1,157514,157514,157515,0,1,1
44925,5,2,157519,157519,157521,0,2,4
44926,2,3,157521,157521,157524,0,3,0
44927,5,2,157526,157526,157528,0,2,2
44928,4,3,157530,157530,157533,0,3,2
44929,3,2,157533,157533,157535,0,2,0
44930,6,1,157539,157539,157540,0,1,4
44931,6,3,157545,157545,157548,0,3,5
44932,4,3,157549,157549,157552,0,3,1
44933,4,2,157553,157553,157555,0,2,1
44934,2,2,157555,157555,157557,0,2,0
44935,6,2,157561,157561,157563,0,2,4
44936,2,2,157563,157563,157565,0,2,0
44937,2,1,157565,157565,157566,0,1,0
44938,1,3,157566,157566,157569,0,3,0
44939,2,3,157568,157569,157572,1,4,0
44940,6,3,157574,157574,157577,0,3,2
44941,6,2,157580,157580,157582,0,2,3
44942,4,2,157584,157584,157586,0,2,2
44943,4,1,157588,157588,157589,0,1,2
44944,2,1,157590,157590,157591,0,1,1
44945,3,2,157593,157593,157595,0,2,2
44946,5,3,157598,157598,157601,0,3,3
44947,6,2,157604,157604,157606,0,2,3
44948,2,3,157606,157606,157609,0,3,0
44949,2,1,157608,157609,157610,1,2,0
44950,1,3,157609,157610,157613,1,4,0
44951,5,3,157614,157614,157617,0,3,1
44952,5,3,157619,157619,157622,0,3,2
44953,4,2,157623,157623,157625,0,2,1
44954,2,3,157625,157625,157628,0,3,0
44955,2,3,157627,157628,157631,1,4,0
44956,1,2,157628,157631,157633,3,5,0
44957,6,3,157634,157634,157637,0,3,1
44958,6,3,157640,157640,157643,0,3,3
44959,5,3,157645,157645,157648,0,3,2
44960,3,3,157648,157648,157651,0,3,0
44961,1,3,157649,157651,157654,2,5,0
44962,4,3,157653,157654,157657,1,4,0
44963,5,2,157658,157658,157660,0,2,1
44964,5,2,157663,157663,157665,0,2,3
44965,4,2,157667,157667,157669,0,2,2
44966,6,1,157673,157673,157674,0,1,4
44967,6,1,157679,157679,157680,0,1,5
44968,2,3,157681,157681,157684,0,3,1
44969,2,1,157683,157684,157685,1,2,0
44970,4,1,157687,157687,157688,0,1,2
44971,5,3,157692,157692,157695,0,3,4
44972,6,2,157698,157698,157700,0,2,3
44973,4,1,157702,157702,157703,0,1,2
44974,4,1,157706,157706,157707,0,1,3
44975,3,1,157709,157709,157710,0,1,2
44976,4,1,157713,157713,157714,0,1,3
44977,3,1,157716,157716,157717,0,1,2
44978,4,2,157720,157720,157722,0,2,3
44979,4,3,157724,157724,157727,0,3,2
44980,2,3,157726,157727,157730,1,4,0
44981,2,2,157728,157730,157732,2,4,0
44982,5,1,157733,157733,157734,0,1,1
44983,3,3,157736,157736,157739,0,3,2
44984,5,3,157741,157741,157744,0,3,2
44985,5,2,157746,157746,157748,0,2,2
44986,3,2,157749,157749,157751,0,2,1
44987,4,2,157753,157753,157755,0,2,2
44988,6,1,157759,157759,157760,0,1,4
44989,3,2,157762,157762,157764,0,2,2
44990,6,1,157768,157768,157769,0,1,4
44991,2,1,157770,157770,157771,0,1,1
44992,6,3,157776,157776,157779,0,3,5
44993,5,2,157781,157781,157783,0,2,2
44994,2,1,157783,157783,157784,0,1,0
44995,1,3,157784,157784,157787,0,3,0
44996,3,1,157787,157787,157788,0,1,0
44997,5,2,157792,157792,157794,0,2,4
44998,2,3,157794,157794,157797,0,3,0
44999,1,1,157795,157797,157798,2,3,0
45000,4,2,157799,157799,157801,0,2,1
45001,3,1,157802,157802,157803,0,1,1
45002,5,3,157807,157807,157810,0,3,4
45003,1,3,157808,157810,157813,2,5,0
45004,3,1,157811,157813,157814,2,3,0
45005,3,2,157814,157814,157816,0,2,0
45006,4,3,157818,157818,157821,0,3,2
45007,5,2,157823,157823,157825,0,2,2
45008,5,3,157828,157828,157831,0,3,3
45009,6,1,157834,157834,157835,0,1,3
45010,4,3,157838,157838,157841,0,3,3
45011,6,2,157844,157844,157846,0,2,3
45012,2,3,157846,157846,157849,0,3,0
45013,4,3,157850,157850,157853,0,3,1
45014,3,1,157853,157853,157854,0,1,0
45015,2,2,157855,157855,157857,0,2,1
45016,5,3,157860,157860,157863,0,3,3
45017,5,2,157865,157865,157867,0,2,2
45018,4,1,157869,157869,157870,0,1,2
45019,2,3,157871,157871,157874,0,3,1
45020,4,2,157875,157875,157877,0,2,1
45021,1,3,157876,157877,157880,1,4,0
45022,5,1,157881,157881,157882,0,1,1
45023,6,3,157887,157887,157890,0,3,5
45024,4,3,157891,157891,157894,0,3,1
45025,3,1,157894,157894,157895,0,1,0
45026,3,2,157897,157897,157899,0,2,2
45027,2,2,157899,157899,157901,0,2,0
45028,6,3,157905,157905,157908,0,3,4
45029,6,3,157911,157911,157914,0,3,3
45030,4,1,157915,157915,157916,0,1,1
45031,5,3,157920,157920,157923,0,3,4
45032,2,1,157922,157923,157924,1,2,0
45033,3,3,157925,157925,157928,0,3,1
45034,3,3,157928,157928,157931,0,3,0
45035,2,1,157930,157931,157932,1,2,0
45036,6,1,157936,157936,157937,0,1,4
45037,5,2,157941,157941,157943,0,2,4
45038,6,2,157947,157947,157949,0,2,4
45039,5,3,157952,157952,157955,0,3,3
45040,1,3,157953,157955,157958,2,5,0
45041,5,1,157958,157958,157959,0,1,0
45042,2,2,157960,157960,157962,0,2,1
45043,4,1,157964,157964,157965,0,1,2
45044,3,3,157967,157967,157970,0,3,2
45045,2,3,157969,157970,157973,1,4,0
45046,6,2,157975,157975,157977,0,2,2
45047,3,3,157978,157978,157981,0,3,1
45048,2,2,157980,157981,157983,1,3,0
45049,5,3,157985,157985,157988,0,3,2
45050,2,1,157987,157988,157989,1,2,0
45051,3,3,157990,157990,157993,0,3,1
45052,6,1,157996,157996,157997,0,1,3
45053,1,3,157997,157997,158000,0,3,0
45054,3,2,158000,158000,158002,0,2,0
45055,5,3,158005,158005,158008,0,3,3
45056,4,3,158009,158009,158012,0,3,1
45057,3,3,158012,158012,158015,0,3,0
45058,6,2,158018,158018,158020,0,2,3
45059,1,3,158019,158020,158023,1,4,0
45060,2,2,158021,158023,158025,2,4,0
45061,3,2,158024,158025,158027,1,3,0
45062,6,3,158030,158030,158033,0,3,3
45063,5,1,158035,158035,158036,0,1,2
45064,6,1,158041,158041,158042,0,1,5
45065,5,3,158046,158046,158049,0,3,4
45066,1,1,158047,158049,158050,2,3,0
45067,2,3,158049,158050,158053,1,4,0
45068,6,2,158055,158055,158057,0,2,2
45069,3,2,158058,158058,158060,0,2,1
45070,1,1,158059,158060,158061,1,2,0
45071,2,1,158061,158061,158062,0,1,0
45072,4,3,158065,158065,158068,0,3,3
45073,3,1,158068,158068,158069,0,1,0
45074,1,1,158069,158069,158070,0,1,0
45075,3,3,158072,158072,158075,0,3,2
45076,4,3,158076,158076,158079,0,3,1
45077,6,3,158082,158082,158085,0,3,3
45078,4,1,158086,158086,158087,0,1,1
45079,5,2,158091,158091,158093,0,2,4
45080,3,3,158094,158094,158097,0,3,1
45081,4,1,158098,158098,158099,0,1,1
45082,5,3,158103,158103,158106,0,3,4
45083,5,3,158108,158108,158111,0,3,2
45084,2,3,158110,158111,158114,1,4,0
45085,1,2,158111,158114,158116,3,5,0
45086,2,2,158113,158116,158118,3,5,0
45087,6,1,158119,158119,158120,0,1,1
45088,4,2,158123,158123,158125,0,2,3
45089,3,3,158126,158126,158129,0,3,1
45090,4,2,158130,158130,158132,0,2,1
45091,5,2,158135,158135,158137,0,2,3
45092,4,2,158139,158139,158141,0,2,2
45093,1,1,158140,158141,158142,1,2,0
45094,3,1,158143,158143,158144,0,1,1
45095,3,1,158146,158146,158147,0,1,2
45096,3,1,158149,158149,158150,0,1,2
45097,5,2,158154,158154,158156,0,2,4
45098,5,2,158159,158159,158161,0,2,3
45099,4,2,158163,158163,158165,0,2,2
45100,6,3,158169,158169,158172,0,3,4
45101,2,2,158171,158172,158174,1,3,0
45102,5,3,158176,158176,158179,0,3,2
45103,5,1,158181,158181,158182,0,1,2
45104,1,3,158182,158182,158185,0,3,0
45105,1,2,158183,158185,158187,2,4,0
45106,1,3,158184,158187,158190,3,6,0
45107,4,3,158188,158190,158193,2,5,0
45108,4,1,158192,158193,158194,1,2,0
45109,5,2,158197,158197,158199,0,2,3
45110,2,1,158199,158199,158200,0,1,0
45111,2,2,158201,158201,158203,0,2,1
45112,2,2,158203,158203,158205,0,2,0
45113,5,1,158208,158208,158209,0,1,3
45114,2,3,158210,158210,158213,0,3,1
45115,2,1,158212,158213,158214,1,2,0
45116,4,3,158216,158216,158219,0,3,2
45117,4,2,158220,158220,158222,0,2,1
45118,6,1,158226,158226,158227,0,1,4
45119,4,2,158230,158230,158232,0,2,3
45120,5,3,158235,158235,158238,0,3,3
45121,5,3,158240,158240,158243,0,3,2
45122,6,2,158246,158246,158248,0,2,3
45123,5,1,158251,158251,158252,0,1,3
45124,6,3,158257,158257,158260,0,3,5
45125,6,3,158263,158263,158266,0,3,3
45126,4,3,158267,158267,158270,0,3,1
45127,5,2,158272,158272,158274,0,2,2
45128,1,3,158273,158274,158277,1,4,0
45129,4,3,158277,158277,158280,0,3,0
45130,1,1,158278,158280,158281,2,3,0
45131,6,2,158284,158284,158286,0,2,3
45132,1,3,158285,158286,158289,1,4,0
45133,1,1,158286,158289,158290,3,4,0
45134,2,2,158288,158290,158292,2,4,0
45135,3,3,158291,158292,158295,1,4,0
45136,3,3,158294,158295,158298,1,4,0
45137,2,1,158296,158298,158299,2,3,0
45138,5,1,158301,158301,158302,0,1,2
45139,2,3,158303,158303,158306,0,3,1
45140,6,3,158309,158309,158312,0,3,3
45141,4,2,158313,158313,158315,0,2,1
45142,5,3,158318,158318,158321,0,3,3
45143,5,3,158323,158323,158326,0,3,2
45144,3,3,158326,158326,158329,0,3,0
45145,4,3,158330,158330,158333,0,3,1
45146,1,2,158331,158333,158335,2,4,0
45147,4,3,158335,158335,158338,0,3,0
45148,2,3,158337,158338,158341,1,4,0
45149,4,1,158341,158341,158342,0,1,0
45150,3,3,158344,158344,158347,0,3,2
45151,4,1,158348,158348,158349,0,1,1
45152,1,2,158349,158349,158351,0,2,0
45153,5,1,158354,158354,158355,0,1,3
45154,1,1,158355,158355,158356,0,1,0
45155,6,3,158361,158361,158364,0,3,5
45156,6,2,158367,158367,158369,0,2,3
45157,4,3,158371,158371,158374,0,3,2
45158,3,3,158374,158374,158377,0,3,0
45159,6,1,158380,158380,158381,0,1,3
45160,5,1,158385,158385,158386,0,1,4
45161,6,1,158391,158391,158392,0,1,5
45162,5,1,158396,158396,158397,0,1,4
45163,1,1,158397,158397,158398,0,1,0
45164,3,3,158400,158400,158403,0,3,2
45165,1,3,158401,158403,158406,2,5,0
45166,3,3,158404,158406,158409,2,5,0
45167,3,2,158407,158409,158411,2,4,0
45168,6,1,158413,158413,158414,0,1,2
45169,2,2,158415,158415,158417,0,2,1
45170,6,3,158421,158421,158424,0,3,4
45171,3,2,158424,158424,158426,0,2,0
45172,1,3,158425,158426,158429,1,4,0
45173,4,3,158429,158429,158432,0,3,0
45174,1,3,158430,158432,158435,2,5,0
45175,3,3,158433,158435,158438,2,5,0
45176,2,1,158435,158438,158439,3,4,0
45177,1,2,158436,158439,158441,3,5,0
45178,2,1,158438,158441,158442,3,4,0
45179,2,1,158440,158442,158443,2,3,0
45180,3,1,158443,158443,158444,0,1,0
45181,2,2,158445,158445,158447,0,2,1
45182,3,1,158448,158448,158449,0,1,1
45183,1,3,158449,158449,158452,0,3,0
45184,2,1,158451,158452,158453,1,2,0
45185,6,1,158457,158457,158458,0,1,4
45186,1,2,158458,158458,158460,0,2,0
45187,1,2,158459,158460,158462,1,3,0
45188,1,1,158460,158462,158463,2,3,0
45189,4,2,158464,158464,158466,0,2,1
45190,2,2,158466,158466,158468,0,2,0
45191,5,3,158471,158471,158474,0,3,3
45192,4,3,158475,158475,158478,0,3,1
45193,1,2,158476,158478,158480,2,4,0
45194,2,2,158478,158480,158482,2,4,0
45195,6,1,158484,158484,158485,0,1,2
45196,4,1,158488,158488,158489,0,1,3
45197,2,2,158490,158490,158492,0,2,1
45198,1,3,158491,158492,158495,1,4,0
45199,2,2,158493,158495,158497,2,4,0
45200,5,3,158498,158498,158501,0,3,1
45201,6,1,158504,158504,158505,0,1,3
45202,3,1,158507,158507,158508,0,1,2
45203,6,1,158513,158513,158514,0,1,5
45204,5,1,158518,158518,158519,0,1,4
45205,4,2,158522,158522,158524,0,2,3
45206,4,3,158526,158526,158529,0,3,2
45207,4,3,158530,158530,158533,0,3,1
45208,3,2,158533,158533,158535,0,2,0
45209,6,1,158539,158539,158540,0,1,4
45210,4,3,158543,158543,158546,0,3,3
45211,2,1,158545,158546,158547,1,2,0
45212,2,3,158547,158547,158550,0,3,0
45213,4,1,158551,158551,158552,0,1,1
45214,4,3,158555,158555,158558,0,3,3
45215,3,3,158558,158558,158561,0,3,0
45216,6,1,158564,158564,158565,0,1,3
45217,5,1,158569,158569,158570,0,1,4
45218,5,3,158574,158574,158577,0,3,4
45219,1,2,158575,158577,158579,2,4,0
45220,5,2,158580,158580,158582,0,2,1
45221,5,3,158585,158585,158588,0,3,3
45222,1,2,158586,158588,158590,2,4,0
45223,1,1,158587,158590,158591,3,4,0
45224,6,1,158593,158593,158594,0,1,2
45225,6,1,158599,158599,158600,0,1,5
45226,1,3,158600,158600,158603,0,3,0
45227,1,1,158601,158603,158604,2,3,0
45228,1,2,158602,158604,158606,2,4,0
45229,5,1,158607,158607,158608,0,1,1
45230,3,2,158610,158610,158612,0,2,2
45231,3,2,158613,158613,158615,0,2,1
45232,1,2,158614,158615,158617,1,3,0
45233,1,3,158615,158617,158620,2,5,0
45234,5,2,158620,158620,158622,0,2,0
45235,1,3,158621,158622,158625,1,4,0
45236,2,2,158623,158625,158627,2,4,0
45237,1,3,158624,158627,158630,3,6,0
45238,6,1,158630,158630,158631,0,1,0
45239,2,2,158632,158632,158634,0,2,1
45240,3,3,158635,158635,158638,0,3,1
45241,5,3,158640,158640,158643,0,3,2
45242,1,3,158641,158643,158646,2,5,0
45243,3,1,158644,158646,158647,2,3,0
45244,5,1,158649,158649,158650,0,1,2
45245,4,2,158653,158653,158655,0,2,3
45246,5,3,158658,158658,158661,0,3,3
45247,4,2,158662,158662,158664,0,2,1
45248,1,3,158663,158664,158667,1,4,0
45249,4,3,158667,158667,158670,0,3,0
45250,2,2,158669,158670,158672,1,3,0
45251,6,3,158675,158675,158678,0,3,3
45252,5,3,158680,158680,158683,0,3,2
45253,2,1,158682,158683,158684,1,2,0
45254,2,2,158684,158684,158686,0,2,0
45255,3,3,158687,158687,158690,0,3,1
45256,4,3,158691,158691,158694,0,3,1
45257,6,3,158697,158697,158700,0,3,3
45258,5,2,158702,158702,158704,0,2,2
45259,5,2,158707,158707,158709,0,2,3
45260,6,2,158713,158713,158715,0,2,4
45261,5,2,158718,158718,158720,0,2,3
45262,4,2,158722,158722,158724,0,2,2
45263,4,3,158726,158726,158729,0,3,2
45264,3,1,158729,158729,158730,0,1,0
45265,6,2,158735,158735,158737,0,2,5
45266,5,2,158740,158740,158742,0,2,3
45267,6,1,158746,158746,158747,0,1,4
45268,5,3,158751,158751,158754,0,3,4
45269,5,3,158756,158756,158759,0,3,2
45270,2,1,158758,158759,158760,1,2,0
45271,1,2,158759,158760,158762,1,3,0
45272,3,1,158762,158762,158763,0,1,0
45273,4,1,158766,158766,158767,0,1,3
45274,5,1,158771,158771,158772,0,1,4
45275,6,3,158777,158777,158780,0,3,5
45276,3,3,158780,158780,158783,0,3,0
45277,2,1,158782,158783,158784,1,2,0
45278,5,2,158787,158787,158789,0,2,3
45279,2,1,158789,158789,158790,0,1,0
45280,3,3,158792,158792,158795,0,3,2
45281,3,3,158795,158795,158798,0,3,0
45282,6,3,158801,158801,158804,0,3,3
45283,6,3,158807,158807,158810,0,3,3
45284,3,2,158810,158810,158812,0,2,0
45285,3,3,158813,158813,158816,0,3,1
45286,5,3,158818,158818,158821,0,3,2
45287,1,1,158819,158821,158822,2,3,0
45288,1,3,158820,158822,158825,2,5,0
45289,6,1,158826,158826,158827,0,1,1
45290,3,2,158829,158829,158831,0,2,2
45291,1,1,158830,158831,158832,1,2,0
45292,6,1,158836,158836,158837,0,1,4
45293,1,3,158837,158837,158840,0,3,0
45294,6,3,158843,158843,158846,0,3,3
45295,3,1,158846,158846,158847,0,1,0
45296,2,1,158848,158848,158849,0,1,1
45297,6,1,158854,158854,158855,0,1,5
45298,6,2,158860,158860,158862,0,2,5
45299,1,2,158861,158862,158864,1,3,0
45300,5,1,158866,158866,158867,0,1,2
45301,3,3,158869,158869,158872,0,3,2
45302,1,2,158870,158872,158874,2,4,0
45303,1,1,158871,158874,158875,3,4,0
45304,1,2,158872,158875,158877,3,5,0
45305,5,1,158877,158877,158878,0,1,0
45306,2,3,158879,158879,158882,0,3,1
45307,2,2,158881,158882,158884,1,3,0
45308,2,3,158883,158884,158887,1,4,0
45309,4,3,158887,158887,158890,0,3,0
45310,2,1,158889,158890,158891,1,2,0
45311,6,2,158895,158895,158897,0,2,4
45312,4,3,158899,158899,158902,0,3,2
45313,2,3,158901,158902,158905,1,4,0
45314,1,3,158902,158905,158908,3,6,0
45315,2,3,158904,158908,158911,4,7,0
45316,2,1,158906,158911,158912,5,6,0
45317,4,3,158910,158912,158915,2,5,0
45318,6,2,158916,158916,158918,0,2,1
45319,6,1,158922,158922,158923,0,1,4
45320,1,3,158923,158923,158926,0,3,0
45321,4,1,158927,158927,158928,0,1,1
45322,4,3,158931,158931,158934,0,3,3
45323,1,2,158932,158934,158936,2,4,0
45324,4,2,158936,158936,158938,0,2,0
45325,3,1,158939,158939,158940,0,1,1
45326,5,1,158944,158944,158945,0,1,4
45327,5,3,158949,158949,158952,0,3,4
45328,4,2,158953,158953,158955,0,2,1
45329,5,2,158958,158958,158960,0,2,3
45330,3,2,158961,158961,158963,0,2,1
45331,1,2,158962,158963,158965,1,3,0
45332,1,2,158963,158965,158967,2,4,0
45333,6,2,158969,158969,158971,0,2,2
45334,6,3,158975,158975,158978,0,3,4
45335,3,2,158978,158978,158980,0,2,0
45336,1,1,158979,158980,158981,1,2,0
45337,3,1,158982,158982,158983,0,1,1
45338,6,2,158988,158988,158990,0,2,5
45339,2,3,158990,158990,158993,0,3,0
45340,4,3,158994,158994,158997,0,3,1
45341,6,2,159000,159000,159002,0,2,3
45342,3,3,159003,159003,159006,0,3,1
45343,1,1,159004,159006,159007,2,3,0
45344,2,2,159006,159007,159009,1,3,0
45345,4,1,159010,159010,159011,0,1,1
45346,3,3,159013,159013,159016,0,3,2
45347,6,2,159019,159019,159021,0,2,3
45348,6,3,159025,159025,159028,0,3,4
45349,2,1,159027,159028,159029,1,2,0
45350,1,2,159028,159029,159031,1,3,0
45351,1,2,159029,159031,159033,2,4,0
45352,4,1,159033,159033,159034,0,1,0
45353,1,1,159034,159034,159035,0,1,0
45354,4,3,159038,159038,159041,0,3,3
45355,3,2,159041,159041,159043,0,2,0
45356,6,2,159047,159047,159049,0,2,4
45357,3,3,159050,159050,159053,0,3,1
45358,1,3,159051,159053,159056,2,5,0
45359,6,2,159057,159057,159059,0,2,1
45360,5,3,159062,159062,159065,0,3,3
45361,5,1,159067,159067,159068,0,1,2
45362,3,2,159070,159070,159072,0,2,2
45363,3,1,159073,159073,159074,0,1,1
45364,2,3,159075,159075,159078,0,3,1
45365,3,1,159078,159078,159079,0,1,0
45366,2,3,159080,159080,159083,0,3,1
45367,2,1,159082,159083,159084,1,2,0
45368,4,3,159086,159086,159089,0,3,2
45369,4,2,159090,159090,159092,0,2,1
45370,4,1,159094,159094,159095,0,1,2
45371,1,2,159095,159095,159097,0,2,0
45372,2,2,159097,159097,159099,0,2,0
45373,5,2,159102,159102,159104,0,2,3
45374,3,3,159105,159105,159108,0,3,1
45375,1,1,159106,159108,159109,2,3,0
45376,1,1,159107,159109,159110,2,3,0
45377,1,1,159108,159110,159111,2,3,0
45378,6,3,159114,159114,159117,0,3,3
45379,6,1,159120,159120,159121,0,1,3
45380,5,3,159125,159125,159128,0,3,4
45381,1,3,159126,159128,159131,2,5,0
45382,3,3,159129,159131,159134,2,5,0
45383,2,2,159131,159134,159136,3,5,0
45384,1,2,159132,159136,159138,4,6,0
45385,2,3,159134,159138,159141,4,7,0
45386,1,2,159135,159141,159143,6,8,0
45387,1,3,159136,159143,159146,7,10,0
45388,3,3,159139,159146,159149,7,10,0
45389,2,3,159141,159149,159152,8,11,0
45390,1,3,159142,159152,159155,10,13,0
45391,6,1,159148,159155,159156,7,8,0
45392,2,3,159150,159156,159159,6,9,0
45393,3,2,159153,159159,159161,6,8,0
45394,3,1,159156,159161,159162,5,6,0
45395,6,1,159162,159162,159163,0,1,0
45396,2,2,159164,159164,159166,0,2,1
45397,5,1,159169,159169,159170,0,1,3
45398,2,3,159171,159171,159174,0,3,1
45399,5,1,159176,159176,159177,0,1,2
45400,2,3,159178,159178,159181,0,3,1
45401,6,2,159184,159184,159186,0,2,3
45402,5,1,159189,159189,159190,0,1,3
45403,1,2,159190,159190,159192,0,2,0
45404,3,3,159193,159193,159196,0,3,1
45405,3,1,159196,159196,159197,0,1,0
45406,2,3,159198,159198,159201,0,3,1
45407,6,1,159204,159204,159205,0,1,3
45408,2,2,159206,159206,159208,0,2,1
45409,6,1,159212,159212,159213,0,1,4
45410,1,2,159213,159213,159215,0,2,0
45411,1,2,159214,159215,159217,1,3,0
45412,1,3,159215,159217,159220,2,5,0
45413,4,1,159219,159220,159221,1,2,0
45414,4,3,159223,159223,159226,0,3,2
45415,4,2,159227,159227,159229,0,2,1
45416,3,1,159230,159230,159231,0,1,1
45417,2,3,159232,159232,159235,0,3,1
45418,3,2,159235,159235,159237,0,2,0
45419,2,3,159237,159237,159240,0,3,0
45420,4,3,159241,159241,159244,0,3,1
45421,3,1,159244,159244,159245,0,1,0
45422,1,2,159245,159245,159247,0,2,0
45423,6,2,159251,159251,159253,0,2,4
45424,2,2,159253,159253,159255,0,2,0
45425,5,2,159258,159258,159260,0,2,3
45426,6,3,159264,159264,159267,0,3,4
45427,5,2,159269,159269,159271,0,2,2
45428,4,3,159273,159273,159276,0,3,2
45429,5,2,159278,159278,159280,0,2,2
45430,6,3,159284,159284,159287,0,3,4
45431,4,3,159288,159288,159291,0,3,1
45432,6,3,159294,159294,159297,0,3,3
45433,4,2,159298,159298,159300,0,2,1
45434,6,1,159304,159304,159305,0,1,4
45435,3,3,159307,159307,159310,0,3,2
45436,1,1,159308,159310,159311,2,3,0
45437,3,2,159311,159311,159313,0,2,0
45438,1,3,159312,159313,159316,1,4,0
45439,3,3,159315,159316,159319,1,4,0
45440,3,2,159318,159319,159321,1,3,0
45441,6,1,159324,159324,159325,0,1,3
45442,4,1,159328,159328,159329,0,1,3
45443,6,2,159334,159334,159336,0,2,5
45444,2,3,159336,159336,159339,0,3,0
45445,1,1,159337,159339,159340,2,3,0
45446,2,2,159339,159340,159342,1,3,0
45447,5,1,159344,159344,159345,0,1,2
45448,6,2,159350,159350,159352,0,2,5
45449,5,1,159355,159355,159356,0,1,3
45450,4,3,159359,159359,159362,0,3,3
45451,6,1,159365,159365,159366,0,1,3
45452,1,3,159366,159366,159369,0,3,0
45453,2,1,159368,159369,159370,1,2,0
45454,6,1,159374,159374,159375,0,1,4
45455,3,1,159377,159377,159378,0,1,2
45456,2,1,159379,159379,159380,0,1,1
45457,6,3,159385,159385,159388,0,3,5
45458,3,3,159388,159388,159391,0,3,0
45459,4,1,159392,159392,159393,0,1,1
45460,4,1,159396,159396,159397,0,1,3
45461,5,1,159401,159401,159402,0,1,4
45462,4,1,159405,159405,159406,0,1,3
45463,3,2,159408,159408,159410,0,2,2
45464,4,3,159412,159412,159415,0,3,2
45465,6,1,159418,159418,159419,0,1,3
45466,2,2,159420,159420,159422,0,2,1
45467,2,2,159422,159422,159424,0,2,0
45468,3,3,159425,159425,159428,0,3,1
45469,5,2,159430,159430,159432,0,2,2
45470,3,1,159433,159433,159434,0,1,1
45471,4,1,159437,159437,159438,0,1,3
45472,4,2,159441,159441,159443,0,2,3
45473,2,2,159443,159443,159445,0,2,0
45474,1,1,159444,159445,159446,1,2,0
45475,1,1,159445,159446,159447,1,2,0
45476,3,3,159448,159448,159451,0,3,1
45477,3,2,159451,159451,159453,0,2,0
45478,4,1,159455,159455,159456,0,1,2
45479,3,1,159458,159458,159459,0,1,2
45480,1,3,159459,159459,159462,0,3,0
45481,6,3,159465,159465,159468,0,3,3
45482,1,3,159466,159468,159471,2,5,0
45483,5,1,159471,159471,159472,0,1,0
45484,6,2,159477,159477,159479,0,2,5
45485,4,3,159481,159481,159484,0,3,2
45486,6,1,159487,159487,159488,0,1,3
45487,5,2,159492,159492,159494,0,2,4
45488,5,1,159497,159497,159498,0,1,3
45489,2,3,159499,159499,159502,0,3,1
45490,3,1,159502,159502,159503,0,1,0
45491,6,1,159508,159508,159509,0,1,5
45492,3,1,159511,159511,159512,0,1,2
45493,1,3,159512,159512,159515,0,3,0
45494,4,3,159516,159516,159519,0,3,1
45495,1,2,159517,159519,159521,2,4,0
45496,1,3,159518,159521,159524,3,6,0
45497,3,2,159521,159524,159526,3,5,0
45498,4,3,159525,159526,159529,1,4,0
45499,2,3,159527,159529,159532,2,5,0
45500,3,2,159530,159532,159534,2,4,0
45501,2,1,159532,159534,159535,2,3,0
45502,4,3,159536,159536,159539,0,3,1
45503,1,2,159537,159539,159541,2,4,0
45504,5,1,159542,159542,159543,0,1,1
45505,3,3,159545,159545,159548,0,3,2
45506,2,3,159547,159548,159551,1,4,0
45507,1,3,159548,159551,159554,3,6,0
45508,5,2,159553,159554,159556,1,3,0
45509,3,1,159556,159556,159557,0,1,0
45510,2,2,159558,159558,159560,0,2,1
45511,1,1,159559,159560,159561,1,2,0
45512,5,1,159564,159564,159565,0,1,3
45513,2,2,159566,159566,159568,0,2,1
45514,1,3,159567,159568,159571,1,4,0
45515,5,1,159572,159572,159573,0,1,1
45516,2,3,159574,159574,159577,0,3,1
45517,2,3,159576,159577,159580,1,4,0
45518,3,3,159579,159580,159583,1,4,0
45519,2,2,159581,159583,159585,2,4,0
45520,3,1,159584,159585,159586,1,2,0
45521,3,3,159587,159587,159590,0,3,1
45522,6,3,159593,159593,159596,0,3,3
45523,4,1,159597,159597,159598,0,1,1
45524,6,2,159603,159603,159605,0,2,5
45525,6,2,159609,159609,159611,0,2,4
45526,1,3,159610,159611,159614,1,4,0
45527,1,3,159611,159614,159617,3,6,0
45528,6,1,159617,159617,159618,0,1,0
45529,3,2,159620,159620,159622,0,2,2
45530,1,2,159621,159622,159624,1,3,0
45531,3,2,159624,159624,159626,0,2,0
45532,4,1,159628,159628,159629,0,1,2
45533,4,2,159632,159632,159634,0,2,3
45534,6,1,159638,159638,159639,0,1,4
45535,3,3,159641,159641,159644,0,3,2
45536,5,3,159646,159646,159649,0,3,2
45537,1,1,159647,159649,159650,2,3,0
45538,4,3,159651,159651,159654,0,3,1
45539,3,3,159654,159654,159657,0,3,0
45540,2,3,159656,159657,159660,1,4,0
45541,5,2,159661,159661,159663,0,2,1
45542,6,3,159667,159667,159670,0,3,4
45543,5,2,159672,159672,159674,0,2,2
45544,5,1,159677,159677,159678,0,1,3
45545,4,2,159681,159681,159683,0,2,3
45546,2,2,159683,159683,159685,0,2,0
45547,3,2,159686,159686,159688,0,2,1
45548,6,3,159692,159692,159695,0,3,4
45549,6,2,159698,159698,159700,0,2,3
45550,4,2,159702,159702,159704,0,2,2
45551,4,2,159706,159706,159708,0,2,2
45552,4,1,159710,159710,159711,0,1,2
45553,6,2,159716,159716,159718,0,2,5
45554,3,2,159719,159719,159721,0,2,1
45555,3,3,159722,159722,159725,0,3,1
45556,5,2,159727,159727,159729,0,2,2
45557,5,3,159732,159732,159735,0,3,3
45558,3,2,159735,159735,159737,0,2,0
45559,1,3,159736,159737,159740,1,4,0
45560,2,1,159738,159740,159741,2,3,0
45561,2,1,159740,159741,159742,1,2,0
45562,5,3,159745,159745,159748,0,3,3
45563,2,2,159747,159748,159750,1,3,0
45564,6,1,159753,159753,159754,0,1,3
45565,3,2,159756,159756,159758,0,2,2
45566,2,2,159758,159758,159760,0,2,0
45567,4,3,159762,159762,159765,0,3,2
45568,3,3,159765,159765,159768,0,3,0
45569,3,1,159768,159768,159769,0,1,0
45570,3,1,159771,159771,159772,0,1,2
45571,3,2,159774,159774,159776,0,2,2
45572,6,1,159780,159780,159781,0,1,4
45573,1,1,159781,159781,159782,0,1,0
45574,2,1,159783,159783,159784,0,1,1
45575,3,1,159786,159786,159787,0,1,2
45576,5,1,159791,159791,159792,0,1,4
45577,1,1,159792,159792,159793,0,1,0
45578,6,1,159798,159798,159799,0,1,5
45579,1,1,159799,159799,159800,0,1,0
45580,6,2,159805,159805,159807,0,2,5
45581,1,3,159806,159807,159810,1,4,0
45582,3,1,159809,159810,159811,1,2,0
45583,2,3,159811,159811,159814,0,3,0
45584,5,1,159816,159816,159817,0,1,2
45585,4,3,159820,159820,159823,0,3,3
45586,2,3,159822,159823,159826,1,4,0
45587,4,2,159826,159826,159828,0,2,0
45588,1,2,159827,159828,159830,1,3,0
45589,5,3,159832,159832,159835,0,3,2
45590,4,2,159836,159836,159838,0,2,1
45591,3,2,159839,159839,159841,0,2,1
45592,2,2,159841,159841,159843,0,2,0
45593,4,2,159845,159845,159847,0,2,2
45594,5,2,159850,159850,159852,0,2,3
45595,2,2,159852,159852,159854,0,2,0
45596,6,3,159858,159858,159861,0,3,4
45597,1,3,159859,159861,159864,2,5,0
45598,5,2,159864,159864,159866,0,2,0
45599,5,3,159869,159869,159872,0,3,3
45600,2,2,159871,159872,159874,1,3,0
45601,2,1,159873,159874,159875,1,2,0
45602,6,3,159879,159879,159882,0,3,4
45603,1,1,159880,159882,159883,2,3,0
45604,4,1,159884,159884,159885,0,1,1
45605,3,2,159887,159887,159889,0,2,2
45606,6,2,159893,159893,159895,0,2,4
45607,3,2,159896,159896,159898,0,2,1
45608,1,3,159897,159898,159901,1,4,0
45609,1,1,159898,159901,159902,3,4,0
45610,2,3,159900,159902,159905,2,5,0
45611,6,3,159906,159906,159909,0,3,1
45612,4,2,159910,159910,159912,0,2,1
45613,2,3,159912,159912,159915,0,3,0
45614,6,1,159918,159918,159919,0,1,3
45615,1,2,159919,159919,159921,0,2,0
45616,3,3,159922,159922,159925,0,3,1
45617,2,2,159924,159925,159927,1,3,0
45618,6,1,159930,159930,159931,0,1,3
45619,1,1,159931,159931,159932,0,1,0
45620,2,2,159933,159933,159935,0,2,1
45621,1,1,159934,159935,159936,1,2,0
45622,5,3,159939,159939,159942,0,3,3
45623,6,1,159945,159945,159946,0,1,3
45624,1,1,159946,159946,159947,0,1,0
45625,1,2,159947,159947,159949,0,2,0
45626,3,1,159950,159950,159951,0,1,1
45627,2,2,159952,159952,159954,0,2,1
45628,2,3,159954,159954,159957,0,3,0
45629,5,1,159959,159959,159960,0,1,2
45630,4,1,159963,159963,159964,0,1,3
45631,4,3,159967,159967,159970,0,3,3
45632,6,2,159973,159973,159975,0,2,3
45633,2,1,159975,159975,159976,0,1,0
45634,1,3,159976,159976,159979,0,3,0
45635,2,3,159978,159979,159982,1,4,0
45636,2,3,159980,159982,159985,2,5,0
45637,5,2,159985,159985,159987,0,2,0
45638,4,3,159989,159989,159992,0,3,2
45639,1,1,159990,159992,159993,2,3,0
45640,2,1,159992,159993,159994,1,2,0
45641,3,2,159995,159995,159997,0,2,1
45642,2,1,159997,159997,159998,0,1,0
45643,3,2,160000,160000,160002,0,2,2
45644,5,2,160005,160005,160007,0,2,3
45645,4,3,160009,160009,160012,0,3,2
45646,3,2,160012,160012,160014,0,2,0
45647,6,2,160018,160018,160020,0,2,4
45648,4,1,160022,160022,160023,0,1,2
45649,5,3,160027,160027,160030,0,3,4
45650,3,1,160030,160030,160031,0,1,0
45651,1,1,160031,160031,160032,0,1,0
45652,6,1,160037,160037,160038,0,1,5
45653,5,3,160042,160042,160045,0,3,4
45654,2,2,160044,160045,160047,1,3,0
45655,2,3,160046,160047,160050,1,4,0
45656,3,2,160049,160050,160052,1,3,0
45657,1,1,160050,160052,160053,2,3,0
45658,5,1,160055,160055,160056,0,1,2
45659,4,2,160059,160059,160061,0,2,3
45660,2,3,160061,160061,160064,0,3,0
45661,6,1,160067,160067,160068,0,1,3
45662,2,3,160069,160069,160072,0,3,1
45663,1,2,160070,160072,160074,2,4,0
45664,4,3,160074,160074,160077,0,3,0
45665,2,2,160076,160077,160079,1,3,0
45666,1,1,160077,160079,160080,2,3,0
45667,1,1,160078,160080,160081,2,3,0
45668,3,2,160081,160081,160083,0,2,0
45669,5,2,160086,160086,160088,0,2,3
45670,3,3,160089,160089,160092,0,3,1
45671,3,2,160092,160092,160094,0,2,0
45672,6,2,160098,160098,160100,0,2,4
45673,6,2,160104,160104,160106,0,2,4
45674,3,3,160107,160107,160110,0,3,1
45675,2,3,160109,160110,160113,1,4,0
45676,5,2,160114,160114,160116,0,2,1
45677,3,1,160117,160117,160118,0,1,1
45678,2,3,160119,160119,160122,0,3,1
45679,4,1,160123,160123,160124,0,1,1
45680,1,3,160124,160124,160127,0,3,0
45681,4,3,160128,160128,160131,0,3,1
45682,5,3,160133,160133,160136,0,3,2
45683,3,1,160136,160136,160137,0,1,0
45684,2,1,160138,160138,160139,0,1,1
45685,1,2,160139,160139,160141,0,2,0
45686,2,3,160141,160141,160144,0,3,0
45687,2,1,160143,160144,160145,1,2,0
45688,1,3,160144,160145,160148,1,4,0
45689,2,2,160146,160148,160150,2,4,0
45690,1,1,160147,160150,160151,3,4,0
45691,2,2,160149,160151,160153,2,4,0
45692,1,3,160150,160153,160156,3,6,0
45693,1,3,160151,160156,160159,5,8,0
45694,5,1,160156,160159,160160,3,4,0
45695,1,1,160157,160160,160161,3,4,0
45696,2,3,160159,160161,160164,2,5,0
45697,3,1,160162,160164,160165,2,3,0
45698,1,2,160163,160165,160167,2,4,0
45699,5,3,160168,160168,160171,0,3,1
45700,6,3,160174,160174,160177,0,3,3
45701,5,1,160179,160179,160180,0,1,2
45702,6,2,160185,160185,160187,0,2,5
45703,3,3,160188,160188,160191,0,3,1
45704,1,1,160189,160191,160192,2,3,0
45705,6,1,160195,160195,160196,0,1,3
45706,6,3,160201,160201,160204,0,3,5
45707,6,3,160207,160207,160210,0,3,3
45708,1,2,160208,160210,160212,2,4,0
45709,5,2,160213,160213,160215,0,2,1
45710,5,3,160218,160218,160221,0,3,3
45711,3,2,160221,160221,160223,0,2,0
45712,1,1,160222,160223,160224,1,2,0
45713,4,2,160226,160226,160228,0,2,2
45714,6,1,160232,160232,160233,0,1,4
45715,1,3,160233,160233,160236,0,3,0
45716,3,1,160236,160236,160237,0,1,0
45717,1,2,160237,160237,160239,0,2,0
45718,5,3,160242,160242,160245,0,3,3
45719,2,1,160244,160245,160246,1,2,0
45720,6,3,160250,160250,160253,0,3,4
45721,4,3,160254,160254,160257,0,3,1
45722,3,3,160257,160257,160260,0,3,0
45723,4,2,160261,160261,160263,0,2,1
45724,3,1,160264,160264,160265,0,1,1
45725,3,3,160267,160267,160270,0,3,2
45726,3,2,160270,160270,160272,0,2,0
45727,1,1,160271,160272,160273,1,2,0
45728,4,1,160275,160275,160276,0,1,2
45729,1,3,160276,160276,160279,0,3,0
45730,4,1,160280,160280,160281,0,1,1
45731,3,2,160283,160283,160285,0,2,2
45732,2,1,160285,160285,160286,0,1,0
45733,3,2,160288,160288,160290,0,2,2
45734,1,2,160289,160290,160292,1,3,0
45735,3,1,160292,160292,160293,0,1,0
45736,2,3,160294,160294,160297,0,3,1
45737,1,3,160295,160297,160300,2,5,0
45738,5,1,160300,160300,160301,0,1,0
45739,3,2,160303,160303,160305,0,2,2
45740,3,1,160306,160306,160307,0,1,1
45741,2,3,160308,160308,160311,0,3,1
45742,4,1,160312,160312,160313,0,1,1
45743,4,3,160316,160316,160319,0,3,3
45744,2,1,160318,160319,160320,1,2,0
45745,6,2,160324,160324,160326,0,2,4
45746,6,3,160330,160330,160333,0,3,4
45747,3,3,160333,160333,160336,0,3,0
45748,1,1,160334,160336,160337,2,3,0
45749,6,1,160340,160340,160341,0,1,3
45750,3,1,160343,160343,160344,0,1,2
45751,2,2,160345,160345,160347,0,2,1
45752,3,3,160348,160348,160351,0,3,1
45753,3,2,160351,160351,160353,0,2,0
45754,4,1,160355,160355,160356,0,1,2
45755,6,3,160361,160361,160364,0,3,5
45756,3,3,160364,160364,160367,0,3,0
45757,6,1,160370,160370,160371,0,1,3
45758,1,3,160371,160371,160374,0,3,0
45759,4,1,160375,160375,160376,0,1,1
45760,4,3,160379,160379,160382,0,3,3
45761,3,1,160382,160382,160383,0,1,0
45762,2,2,160384,160384,160386,0,2,1
45763,5,1,160389,160389,160390,0,1,3
45764,5,1,160394,160394,160395,0,1,4
45765,1,2,160395,160395,160397,0,2,0
45766,2,1,160397,160397,160398,0,1,0
45767,4,2,160401,160401,160403,0,2,3
45768,2,1,160403,160403,160404,0,1,0
45769,6,3,160409,160409,160412,0,3,5
45770,5,2,160414,160414,160416,0,2,2
45771,6,3,160420,160420,160423,0,3,4
45772,4,1,160424,160424,160425,0,1,1
45773,5,1,160429,160429,160430,0,1,4
45774,1,2,160430,160430,160432,0,2,0
45775,3,1,160433,160433,160434,0,1,1
45776,5,2,160438,160438,160440,0,2,4
45777,4,3,160442,160442,160445,0,3,2
45778,5,1,160447,160447,160448,0,1,2
45779,4,2,160451,160451,160453,0,2,3
45780,6,1,160457,160457,160458,0,1,4
45781,6,1,160463,160463,160464,0,1,5
45782,5,3,160468,160468,160471,0,3,4
45783,2,1,160470,160471,160472,1,2,0
45784,3,2,160473,160473,160475,0,2,1
45785,3,1,160476,160476,160477,0,1,1
45786,6,1,160482,160482,160483,0,1,5
45787,4,3,160486,160486,160489,0,3,3
45788,1,3,160487,160489,160492,2,5,0
45789,2,3,160489,160492,160495,3,6,0
45790,5,1,160494,160495,160496,1,2,0
45791,6,2,160500,160500,160502,0,2,4
45792,4,2,160504,160504,160506,0,2,2
45793,4,1,160508,160508,160509,0,1,2
45794,1,1,160509,160509,160510,0,1,0
45795,2,3,160511,160511,160514,0,3,1
45796,4,2,160515,160515,160517,0,2,1
45797,4,3,160519,160519,160522,0,3,2
45798,4,1,160523,160523,160524,0,1,1
45799,1,3,160524,160524,160527,0,3,0
45800,3,2,160527,160527,160529,0,2,0
45801,6,2,160533,160533,160535,0,2,4
45802,2,2,160535,160535,160537,0,2,0
45803,5,1,160540,160540,160541,0,1,3
45804,6,3,160546,160546,160549,0,3,5
45805,5,1,160551,160551,160552,0,1,2
45806,5,2,160556,160556,160558,0,2,4
45807,6,2,160562,160562,160564,0,2,4
45808,3,1,160565,160565,160566,0,1,1
45809,4,3,160569,160569,160572,0,3,3
45810,4,2,160573,160573,160575,0,2,1
45811,2,2,160575,160575,160577,0,2,0
45812,2,2,160577,160577,160579,0,2,0
45813,6,1,160583,160583,160584,0,1,4
45814,1,3,160584,160584,160587,0,3,0
45815,2,1,160586,160587,160588,1,2,0
45816,4,3,160590,160590,160593,0,3,2
45817,6,3,160596,160596,160599,0,3,3
45818,3,1,160599,160599,160600,0,1,0
45819,6,3,160605,160605,160608,0,3,5
45820,6,3,160611,160611,160614,0,3,3
45821,5,1,160616,160616,160617,0,1,2
45822,6,2,160622,160622,160624,0,2,5
45823,1,1,160623,160624,160625,1,2,0
45824,2,2,160625,160625,160627,0,2,0
45825,3,2,160628,160628,160630,0,2,1
45826,6,3,160634,160634,160637,0,3,4
45827,3,2,160637,160637,160639,0,2,0
45828,5,2,160642,160642,160644,0,2,3
45829,2,1,160644,160644,160645,0,1,0
45830,1,2,160645,160645,160647,0,2,0
45831,4,3,160649,160649,160652,0,3,2
45832,2,3,160651,160652,160655,1,4,0
45833,3,2,160654,160655,160657,1,3,0
45834,1,1,160655,160657,160658,2,3,0
45835,1,3,160656,160658,160661,2,5,0
45836,5,3,160661,160661,160664,0,3,0
45837,3,3,160664,160664,160667,0,3,0
45838,4,2,160668,160668,160670,0,2,1
45839,4,3,160672,160672,160675,0,3,2
45840,3,1,160675,160675,160676,0,1,0
45841,1,2,160676,160676,160678,0,2,0
45842,2,2,160678,160678,160680,0,2,0
45843,1,1,160679,160680,160681,1,2,0
45844,3,1,160682,160682,160683,0,1,1
45845,1,1,160683,160683,160684,0,1,0
45846,4,3,160687,160687,160690,0,3,3
45847,5,3,160692,160692,160695,0,3,2
45848,3,2,160695,160695,160697,0,2,0
45849,5,3,160700,160700,160703,0,3,3
45850,5,1,160705,160705,160706,0,1,2
45851,1,1,160706,160706,160707,0,1,0
45852,3,2,160709,160709,160711,0,2,2
45853,3,3,160712,160712,160715,0,3,1
45854,4,2,160716,160716,160718,0,2,1
45855,3,2,160719,160719,160721,0,2,1
45856,5,2,160724,160724,160726,0,2,3
45857,2,1,160726,160726,160727,0,1,0
45858,3,2,160729,160729,160731,0,2,2
45859,2,2,160731,160731,160733,0,2,0
45860,3,2,160734,160734,160736,0,2,1
45861,6,1,160740,160740,160741,0,1,4
45862,2,1,160742,160742,160743,0,1,1
45863,2,3,160744,160744,160747,0,3,1
45864,5,1,160749,160749,160750,0,1,2
45865,5,2,160754,160754,160756,0,2,4
45866,3,1,160757,160757,160758,0,1,1
45867,6,2,160763,160763,160765,0,2,5
45868,6,3,160769,160769,160772,0,3,4
45869,4,1,160773,160773,160774,0,1,1
45870,3,1,160776,160776,160777,0,1,2
45871,5,1,160781,160781,160782,0,1,4
45872,6,1,160787,160787,160788,0,1,5
45873,2,1,160789,160789,160790,0,1,1
45874,5,1,160794,160794,160795,0,1,4
45875,5,1,160799,160799,160800,0,1,4
45876,5,2,160804,160804,160806,0,2,4
45877,1,1,160805,160806,160807,1,2,0
45878,4,3,160809,160809,160812,0,3,2
45879,2,2,160811,160812,160814,1,3,0
45880,4,1,160815,160815,160816,0,1,1
45881,4,2,160819,160819,160821,0,2,3
45882,1,1,160820,160821,160822,1,2,0
45883,6,1,160826,160826,160827,0,1,4
45884,1,2,160827,160827,160829,0,2,0
45885,1,3,160828,160829,160832,1,4,0
45886,2,2,160830,160832,160834,2,4,0
45887,4,3,160834,160834,160837,0,3,0
45888,4,2,160838,160838,160840,0,2,1
45889,3,2,160841,160841,160843,0,2,1
45890,2,3,160843,160843,160846,0,3,0
45891,3,1,160846,160846,160847,0,1,0
45892,6,3,160852,160852,160855,0,3,5
45893,1,3,160853,160855,160858,2,5,0
45894,2,3,160855,160858,160861,3,6,0
45895,6,2,160861,160861,160863,0,2,0
45896,4,1,160865,160865,160866,0,1,2
45897,6,3,160871,160871,160874,0,3,5
45898,1,2,160872,160874,160876,2,4,0
45899,1,1,160873,160876,160877,3,4,0
45900,6,2,160879,160879,160881,0,2,2
45901,6,1,160885,160885,160886,0,1,4
45902,6,2,160891,160891,160893,0,2,5
45903,2,2,160893,160893,160895,0,2,0
45904,1,1,160894,160895,160896,1,2,0
45905,2,1,160896,160896,160897,0,1,0
45906,2,3,160898,160898,160901,0,3,1
45907,5,2,160903,160903,160905,0,2,2
45908,6,1,160909,160909,160910,0,1,4
45909,5,3,160914,160914,160917,0,3,4
45910,6,3,160920,160920,160923,0,3,3
45911,2,2,160922,160923,160925,1,3,0
45912,6,1,160928,160928,160929,0,1,3
45913,2,3,160930,160930,160933,0,3,1
45914,3,3,160933,160933,160936,0,3,0
45915,3,2,160936,160936,160938,0,2,0
45916,4,3,160940,160940,160943,0,3,2
45917,2,3,160942,160943,160946,1,4,0
45918,3,1,160945,160946,160947,1,2,0
45919,3,1,160948,160948,160949,0,1,1
45920,3,2,160951,160951,160953,0,2,2
45921,2,3,160953,160953,160956,0,3,0
45922,1,2,160954,160956,160958,2,4,0
45923,4,3,160958,160958,160961,0,3,0
45924,1,1,160959,160961,160962,2,3,0
45925,3,1,160962,160962,160963,0,1,0
45926,3,3,160965,160965,160968,0,3,2
45927,2,1,160967,160968,160969,1,2,0
45928,1,2,160968,160969,160971,1,3,0
45929,5,2,160973,160973,160975,0,2,2
45930,1,2,160974,160975,160977,1,3,0
45931,2,2,160976,160977,160979,1,3,0
45932,5,3,160981,160981,160984,0,3,2
45933,5,3,160986,160986,160989,0,3,2
45934,4,1,160990,160990,160991,0,1,1
45935,1,3,160991,160991,160994,0,3,0
45936,4,2,160995,160995,160997,0,2,1
45937,5,2,161000,161000,161002,0,2,3
45938,6,1,161006,161006,161007,0,1,4
45939,5,1,161011,161011,161012,0,1,4
45940,4,1,161015,161015,161016,0,1,3
45941,3,3,161018,161018,161021,0,3,2
45942,3,2,161021,161021,161023,0,2,0
45943,6,2,161027,161027,161029,0,2,4
45944,4,3,161031,161031,161034,0,3,2
45945,5,1,161036,161036,161037,0,1,2
45946,5,1,161041,161041,161042,0,1,4
45947,2,2,161043,161043,161045,0,2,1
45948,5,2,161048,161048,161050,0,2,3
45949,2,3,161050,161050,161053,0,3,0
45950,5,1,161055,161055,161056,0,1,2
45951,4,1,161059,161059,161060,0,1,3
45952,4,1,161063,161063,161064,0,1,3
45953,6,2,161069,161069,161071,0,2,5
45954,6,1,161075,161075,161076,0,1,4
45955,5,1,161080,161080,161081,0,1,4
45956,5,2,161085,161085,161087,0,2,4
45957,1,1,161086,161087,161088,1,2,0
45958,1,3,161087,161088,161091,1,4,0
45959,6,3,161093,161093,161096,0,3,2
45960,1,1,161094,161096,161097,2,3,0
45961,1,2,161095,161097,161099,2,4,0
45962,5,3,161100,161100,161103,0,3,1
45963,1,3,161101,161103,161106,2,5,0
45964,1,1,161102,161106,161107,4,5,0
45965,1,3,161103,161107,161110,4,7,0
45966,5,2,161108,161110,161112,2,4,0
45967,2,3,161110,161112,161115,2,5,0
45968,2,2,161112,161115,161117,3,5,0
45969,5,2,161117,161117,161119,0,2,0
45970,1,3,161118,161119,161122,1,4,0
45971,3,3,161121,161122,161125,1,4,0
45972,4,2,161125,161125,161127,0,2,0
45973,6,1,161131,161131,161132,0,1,4
45974,2,1,161133,161133,161134,0,1,1
45975,1,2,161134,161134,161136,0,2,0
45976,3,3,161137,161137,161140,0,3,1
45977,2,1,161139,161140,161141,1,2,0
45978,5,2,161144,161144,161146,0,2,3
45979,4,3,161148,161148,161151,0,3,2
45980,1,3,161149,161151,161154,2,5,0
45981,5,1,161154,161154,161155,0,1,0
45982,4,1,161158,161158,161159,0,1,3
45983,6,1,161164,161164,161165,0,1,5
45984,5,1,161169,161169,161170,0,1,4
45985,6,2,161175,161175,161177,0,2,5
45986,6,3,161181,161181,161184,0,3,4
45987,4,3,161185,161185,161188,0,3,1
45988,5,2,161190,161190,161192,0,2,2
45989,2,2,161192,161192,161194,0,2,0
45990,1,3,161193,161194,161197,1,4,0
45991,3,3,161196,161197,161200,1,4,0
45992,2,3,161198,161200,161203,2,5,0
45993,2,2,161200,161203,161205,3,5,0
45994,6,2,161206,161206,161208,0,2,1
45995,2,2,161208,161208,161210,0,2,0
45996,6,3,161214,161214,161217,0,3,4
45997,6,3,161220,161220,161223,0,3,3
45998,3,1,161223,161223,161224,0,1,0
45999,2,2,161225,161225,161227,0,2,1
46000,6,2,161231,161231,161233,0,2,4
46001,2,2,161233,161233,161235,0,2,0
46002,6,1,161239,161239,161240,0,1,4
46003,5,1,161244,161244,161245,0,1,4
46004,5,2,161249,161249,161251,0,2,4
46005,1,2,161250,161251,161253,1,3,0
46006,3,2,161253,161253,161255,0,2,0
46007,3,1,161256,161256,161257,0,1,1
46008,1,3,161257,161257,161260,0,3,0
46009,2,1,161259,161260,161261,1,2,0
46010,6,1,161265,161265,161266,0,1,4
46011,2,3,161267,161267,161270,0,3,1
46012,5,1,161272,161272,161273,0,1,2
46013,6,1,161278,161278,161279,0,1,5
46014,5,1,161283,161283,161284,0,1,4
46015,1,1,161284,161284,161285,0,1,0
46016,4,2,161288,161288,161290,0,2,3
46017,1,2,161289,161290,161292,1,3,0
46018,5,3,161294,161294,161297,0,3,2
46019,2,1,161296,161297,161298,1,2,0
46020,2,1,161298,161298,161299,0,1,0
46021,4,2,161302,161302,161304,0,2,3
46022,1,3,161303,161304,161307,1,4,0
46023,4,3,161307,161307,161310,0,3,0
46024,3,3,161310,161310,161313,0,3,0
46025,1,2,161311,161313,161315,2,4,0
46026,5,2,161316,161316,161318,0,2,1
46027,3,1,161319,161319,161320,0,1,1
46028,5,2,161324,161324,161326,0,2,4
46029,4,3,161328,161328,161331,0,3,2
46030,1,1,161329,161331,161332,2,3,0
46031,5,2,161334,161334,161336,0,2,2
46032,3,3,161337,161337,161340,0,3,1
46033,6,1,161343,161343,161344,0,1,3
46034,4,3,161347,161347,161350,0,3,3
46035,6,2,161353,161353,161355,0,2,3
46036,3,3,161356,161356,161359,0,3,1
46037,2,2,161358,161359,161361,1,3,0
46038,3,1,161361,161361,161362,0,1,0
46039,1,3,161362,161362,161365,0,3,0
46040,5,3,161367,161367,161370,0,3,2
46041,6,2,161373,161373,161375,0,2,3
46042,5,1,161378,161378,161379,0,1,3
46043,3,2,161381,161381,161383,0,2,2
46044,5,1,161386,161386,161387,0,1,3
46045,2,3,161388,161388,161391,0,3,1
46046,1,3,161389,161391,161394,2,5,0
46047,3,3,161392,161394,161397,2,5,0
46048,3,3,161395,161397,161400,2,5,0
46049,5,3,161400,161400,161403,0,3,0
46050,5,2,161405,161405,161407,0,2,2
46051,3,2,161408,161408,161410,0,2,1
46052,2,3,161410,161410,161413,0,3,0
46053,3,1,161413,161413,161414,0,1,0
46054,4,3,161417,161417,161420,0,3,3
46055,4,3,161421,161421,161424,0,3,1
46056,4,1,161425,161425,161426,0,1,1
46057,5,3,161430,161430,161433,0,3,4
46058,2,2,161432,161433,161435,1,3,0
46059,2,3,161434,161435,161438,1,4,0
46060,3,3,161437,161438,161441,1,4,0
46061,2,2,161439,161441,161443,2,4,0
46062,2,2,161441,161443,161445,2,4,0
46063,2,3,161443,161445,161448,2,5,0
46064,4,2,161447,161448,161450,1,3,0
46065,4,3,161451,161451,161454,0,3,1
46066,3,2,161454,161454,161456,0,2,0
46067,6,1,161460,161460,161461,0,1,4
46068,1,1,161461,161461,161462,0,1,0
46069,6,2,161467,161467,161469,0,2,5
46070,5,2,161472,161472,161474,0,2,3
46071,1,3,161473,161474,161477,1,4,0
46072,2,1,161475,161477,161478,2,3,0
46073,6,2,161481,161481,161483,0,2,3
46074,3,2,161484,161484,161486,0,2,1
46075,2,1,161486,161486,161487,0,1,0
46076,4,3,161490,161490,161493,0,3,3
46077,3,2,161493,161493,161495,0,2,0
46078,4,2,161497,161497,161499,0,2,2
46079,3,2,161500,161500,161502,0,2,1
46080,3,3,161503,161503,161506,0,3,1
46081,4,1,161507,161507,161508,0,1,1
46082,4,1,161511,161511,161512,0,1,3
46083,2,2,161513,161513,161515,0,2,1
46084,1,1,161514,161515,161516,1,2,0
46085,4,2,161518,161518,161520,0,2,2
46086,2,1,161520,161520,161521,0,1,0
46087,2,3,161522,161522,161525,0,3,1
46088,1,1,161523,161525,161526,2,3,0
46089,1,2,161524,161526,161528,2,4,0
46090,2,2,161526,161528,161530,2,4,0
46091,5,2,161531,161531,161533,0,2,1
46092,6,1,161537,161537,161538,0,1,4
46093,4,2,161541,161541,161543,0,2,3
46094,6,2,161547,161547,161549,0,2,4
46095,1,3,161548,161549,161552,1,4,0
46096,1,2,161549,161552,161554,3,5,0
46097,4,3,161553,161554,161557,1,4,0
46098,5,1,161558,161558,161559,0,1,1
46099,4,1,161562,161562,161563,0,1,3
46100,2,2,161564,161564,161566,0,2,1
46101,6,1,161570,161570,161571,0,1,4
46102,3,1,161573,161573,161574,0,1,2
46103,5,2,161578,161578,161580,0,2,4
46104,4,1,161582,161582,161583,0,1,2
46105,2,2,161584,161584,161586,0,2,1
46106,2,3,161586,161586,161589,0,3,0
46107,1,2,161587,161589,161591,2,4,0
46108,1,3,161588,161591,161594,3,6,0
46109,5,3,161593,161594,161597,1,4,0
46110,2,2,161595,161597,161599,2,4,0
46111,6,1,161601,161601,161602,0,1,2
46112,3,2,161604,161604,161606,0,2,2
46113,3,3,161607,161607,161610,0,3,1
46114,1,2,161608,161610,161612,2,4,0
46115,2,3,161610,161612,161615,2,5,0
46116,3,2,161613,161615,161617,2,4,0
46117,1,1,161614,161617,161618,3,4,0
46118,2,2,161616,161618,161620,2,4,0
46119,1,1,161617,161620,161621,3,4,0
46120,2,3,161619,161621,161624,2,5,0
46121,4,1,161623,161624,161625,1,2,0
46122,4,3,161627,161627,161630,0,3,2
46123,5,1,161632,161632,161633,0,1,2
46124,5,2,161637,161637,161639,0,2,4
46125,3,2,161640,161640,161642,0,2,1
46126,1,3,161641,161642,161645,1,4,0
46127,4,2,161645,161645,161647,0,2,0
46128,1,3,161646,161647,161650,1,4,0
46129,5,2,161651,161651,161653,0,2,1
46130,5,1,161656,161656,161657,0,1,3
46131,3,2,161659,161659,161661,0,2,2
46132,6,2,161665,161665,161667,0,2,4
46133,3,2,161668,161668,161670,0,2,1
46134,3,3,161671,161671,161674,0,3,1
46135,2,1,161673,161674,161675,1,2,0
46136,1,2,161674,161675,161677,1,3,0
46137,6,1,161680,161680,161681,0,1,3
46138,1,2,161681,161681,161683,0,2,0
46139,6,2,161687,161687,161689,0,2,4
46140,6,1,161693,161693,161694,0,1,4
46141,4,1,161697,161697,161698,0,1,3
46142,3,1,161700,161700,161701,0,1,2
46143,5,3,161705,161705,161708,0,3,4
46144,4,1,161709,161709,161710,0,1,1
46145,6,2,161715,161715,161717,0,2,5
46146,5,3,161720,161720,161723,0,3,3
46147,5,1,161725,161725,161726,0,1,2
46148,1,2,161726,161726,161728,0,2,0
46149,3,1,161729,161729,161730,0,1,1
46150,1,2,161730,161730,161732,0,2,0
46151,6,1,161736,161736,161737,0,1,4
46152,2,3,161738,161738,161741,0,3,1
46153,5,2,161743,161743,161745,0,2,2
46154,2,1,161745,161745,161746,0,1,0
46155,5,2,161750,161750,161752,0,2,4
46156,6,3,161756,161756,161759,0,3,4
46157,4,1,161760,161760,161761,0,1,1
46158,3,3,161763,161763,161766,0,3,2
46159,2,1,161765,161766,161767,1,2,0
46160,3,3,161768,161768,161771,0,3,1
46161,2,2,161770,161771,161773,1,3,0
46162,5,1,161775,161775,161776,0,1,2
46163,1,2,161776,161776,161778,0,2,0
46164,1,1,161777,161778,161779,1,2,0
46165,1,3,161778,161779,161782,1,4,0
46166,5,3,161783,161783,161786,0,3,1
46167,4,1,161787,161787,161788,0,1,1
46168,1,3,161788,161788,161791,0,3,0
46169,5,3,161793,161793,161796,0,3,2
46170,1,3,161794,161796,161799,2,5,0
46171,6,3,161800,161800,161803,0,3,1
46172,4,3,161804,161804,161807,0,3,1
46173,2,2,161806,161807,161809,1,3,0
46174,2,2,161808,161809,161811,1,3,0
46175,4,1,161812,161812,161813,0,1,1
46176,5,3,161817,161817,161820,0,3,4
46177,4,3,161821,161821,161824,0,3,1
46178,5,1,161826,161826,161827,0,1,2
46179,5,1,161831,161831,161832,0,1,4
46180,6,3,161837,161837,161840,0,3,5
46181,2,2,161839,161840,161842,1,3,0
46182,1,1,161840,161842,161843,2,3,0
46183,5,3,161845,161845,161848,0,3,2
46184,3,1,161848,161848,161849,0,1,0
46185,3,2,161851,161851,161853,0,2,2
46186,1,2,161852,161853,161855,1,3,0
46187,2,1,161854,161855,161856,1,2,0
46188,3,1,161857,161857,161858,0,1,1
46189,5,3,161862,161862,161865,0,3,4
46190,4,3,161866,161866,161869,0,3,1
46191,5,1,161871,161871,161872,0,1,2
46192,6,1,161877,161877,161878,0,1,5
46193,1,2,161878,161878,161880,0,2,0
46194,6,1,161884,161884,161885,0,1,4
46195,1,1,161885,161885,161886,0,1,0
46196,1,2,161886,161886,161888,0,2,0
46197,4,3,161890,161890,161893,0,3,2
46198,5,1,161895,161895,161896,0,1,2
46199,4,1,161899,161899,161900,0,1,3
46200,6,3,161905,161905,161908,0,3,5
46201,1,2,161906,161908,161910,2,4,0
46202,3,3,161909,161910,161913,1,4,0
46203,1,3,161910,161913,161916,3,6,0
46204,3,2,161913,161916,161918,3,5,0
46205,5,2,161918,161918,161920,0,2,0
46206,4,3,161922,161922,161925,0,3,2
46207,5,3,161927,161927,161930,0,3,2
46208,2,1,161929,161930,161931,1,2,0
46209,1,1,161930,161931,161932,1,2,0
46210,3,3,161933,161933,161936,0,3,1
46211,2,2,161935,161936,161938,1,3,0
46212,2,2,161937,161938,161940,1,3,0
46213,2,3,161939,161940,161943,1,4,0
46214,4,2,161943,161943,161945,0,2,0
46215,4,3,161947,161947,161950,0,3,2
46216,3,1,161950,161950,161951,0,1,0
46217,1,1,161951,161951,161952,0,1,0
46218,4,1,161955,161955,161956,0,1,3
46219,5,3,161960,161960,161963,0,3,4
46220,4,3,161964,161964,161967,0,3,1
46221,2,3,161966,161967,161970,1,4,0
46222,4,2,161970,161970,161972,0,2,0
46223,1,3,161971,161972,161975,1,4,0
46224,2,1,161973,161975,161976,2,3,0
46225,2,3,161975,161976,161979,1,4,0
46226,4,2,161979,161979,161981,0,2,0
46227,6,2,161985,161985,161987,0,2,4
46228,2,3,161987,161987,161990,0,3,0
46229,4,3,161991,161991,161994,0,3,1
46230,6,3,161997,161997,162000,0,3,3
46231,2,3,161999,162000,162003,1,4,0
46232,4,3,162003,162003,162006,0,3,0
46233,5,2,162008,162008,162010,0,2,2
46234,1,1,162009,162010,162011,1,2,0
46235,2,2,162011,162011,162013,0,2,0
46236,6,1,162017,162017,162018,0,1,4
46237,1,1,162018,162018,162019,0,1,0
46238,4,2,162022,162022,162024,0,2,3
46239,3,2,162025,162025,162027,0,2,1
46240,1,3,162026,162027,162030,1,4,0
46241,4,3,162030,162030,162033,0,3,0
46242,2,2,162032,162033,162035,1,3,0
46243,2,3,162034,162035,162038,1,4,0
46244,4,2,162038,162038,162040,0,2,0
46245,4,3,162042,162042,162045,0,3,2
46246,2,3,162044,162045,162048,1,4,0
46247,1,2,162045,162048,162050,3,5,0
46248,4,2,162049,162050,162052,1,3,0
46249,5,3,162054,162054,162057,0,3,2
46250,2,2,162056,162057,162059,1,3,0
46251,2,2,162058,162059,162061,1,3,0
46252,4,2,162062,162062,162064,0,2,1
46253,1,3,162063,162064,162067,1,4,0
46254,2,1,162065,162067,162068,2,3,0
46255,2,3,162067,162068,162071,1,4,0
46256,1,2,162068,162071,162073,3,5,0
46257,2,2,162070,162073,162075,3,5,0
46258,5,3,162075,162075,162078,0,3,0
46259,4,3,162079,162079,162082,0,3,1
46260,4,3,162083,162083,162086,0,3,1
46261,2,1,162085,162086,162087,1,2,0
46262,2,2,162087,162087,162089,0,2,0
46263,6,2,162093,162093,162095,0,2,4
46264,1,1,162094,162095,162096,1,2,0
46265,1,1,162095,162096,162097,1,2,0
46266,4,3,162099,162099,162102,0,3,2
46267,1,3,162100,162102,162105,2,5,0
46268,4,1,162104,162105,162106,1,2,0
46269,4,2,162108,162108,162110,0,2,2
46270,5,1,162113,162113,162114,0,1,3
46271,6,3,162119,162119,162122,0,3,5
46272,4,3,162123,162123,162126,0,3,1
46273,3,3,162126,162126,162129,0,3,0
46274,3,1,162129,162129,162130,0,1,0
46275,1,1,162130,162130,162131,0,1,0
46276,6,3,162136,162136,162139,0,3,5
46277,6,2,162142,162142,162144,0,2,3
46278,1,1,162143,162144,162145,1,2,0
46279,4,1,162147,162147,162148,0,1,2
46280,3,1,162150,162150,162151,0,1,2
46281,3,1,162153,162153,162154,0,1,2
46282,1,2,162154,162154,162156,0,2,0
46283,5,3,162159,162159,162162,0,3,3
46284,6,3,162165,162165,162168,0,3,3
46285,5,1,162170,162170,162171,0,1,2
46286,6,2,162176,162176,162178,0,2,5
46287,5,2,162181,162181,162183,0,2,3
46288,4,1,162185,162185,162186,0,1,2
46289,1,2,162186,162186,162188,0,2,0
46290,1,2,162187,162188,162190,1,3,0
46291,6,3,162193,162193,162196,0,3,3
46292,3,2,162196,162196,162198,0,2,0
46293,1,3,162197,162198,162201,1,4,0
46294,1,3,162198,162201,162204,3,6,0
46295,3,1,162201,162204,162205,3,4,0
46296,6,3,162207,162207,162210,0,3,2
46297,2,1,162209,162210,162211,1,2,0
46298,1,3,162210,162211,162214,1,4,0
46299,6,1,162216,162216,162217,0,1,2
46300,2,3,162218,162218,162221,0,3,1
46301,1,3,162219,162221,162224,2,5,0
46302,2,1,162221,162224,162225,3,4,0
46303,1,3,162222,162225,162228,3,6,0
46304,1,1,162223,162228,162229,5,6,0
46305,2,3,162225,162229,162232,4,7,0
46306,5,1,162230,162232,162233,2,3,0
46307,3,1,162233,162233,162234,0,1,0
46308,3,3,162236,162236,162239,0,3,2
46309,3,3,162239,162239,162242,0,3,0
46310,2,2,162241,162242,162244,1,3,0
46311,3,1,162244,162244,162245,0,1,0
46312,4,3,162248,162248,162251,0,3,3
46313,1,2,162249,162251,162253,2,4,0
46314,2,1,162251,162253,162254,2,3,0
46315,5,3,162256,162256,162259,0,3,2
46316,5,3,162261,162261,162264,0,3,2
46317,3,2,162264,162264,162266,0,2,0
46318,6,2,162270,162270,162272,0,2,4
46319,5,2,162275,162275,162277,0,2,3
46320,5,1,162280,162280,162281,0,1,3
46321,3,2,162283,162283,162285,0,2,2
46322,2,2,162285,162285,162287,0,2,0
46323,2,3,162287,162287,162290,0,3,0
46324,2,1,162289,162290,162291,1,2,0
46325,6,2,162295,162295,162297,0,2,4
46326,4,3,162299,162299,162302,0,3,2
46327,4,2,162303,162303,162305,0,2,1
46328,5,2,162308,162308,162310,0,2,3
46329,6,1,162314,162314,162315,0,1,4
46330,4,3,162318,162318,162321,0,3,3
46331,1,3,162319,162321,162324,2,5,0
46332,3,3,162322,162324,162327,2,5,0
46333,6,1,162328,162328,162329,0,1,1
46334,6,2,162334,162334,162336,0,2,5
46335,4,3,162338,162338,162341,0,3,2
46336,1,1,162339,162341,162342,2,3,0
46337,2,3,162341,162342,162345,1,4,0
46338,6,1,162347,162347,162348,0,1,2
46339,4,1,162351,162351,162352,0,1,3
46340,3,1,162354,162354,162355,0,1,2
46341,2,2,162356,162356,162358,0,2,1
46342,4,1,162360,162360,162361,0,1,2
46343,5,3,162365,162365,162368,0,3,4
46344,6,3,162371,162371,162374,0,3,3
46345,2,2,162373,162374,162376,1,3,0
46346,1,3,162374,162376,162379,2,5,0
46347,2,3,162376,162379,162382,3,6,0
46348,1,2,162377,162382,162384,5,7,0
46349,2,2,162379,162384,162386,5,7,0
46350,2,1,162381,162386,162387,5,6,0
46351,3,3,162384,162387,162390,3,6,0
46352,3,1,162387,162390,162391,3,4,0
46353,4,3,162391,162391,162394,0,3,0
46354,1,1,162392,162394,162395,2,3,0
46355,4,3,162396,162396,162399,0,3,1
46356,5,3,162401,162401,162404,0,3,2
46357,1,3,162402,162404,162407,2,5,0
46358,3,3,162405,162407,162410,2,5,0
46359,6,3,162411,162411,162414,0,3,1
46360,5,2,162416,162416,162418,0,2,2
46361,6,3,162422,162422,162425,0,3,4
46362,6,2,162428,162428,162430,0,2,3
46363,1,2,162429,162430,162432,1,3,0
46364,3,1,162432,162432,162433,0,1,0
46365,2,2,162434,162434,162436,0,2,1
46366,1,2,162435,162436,162438,1,3,0
46367,5,3,162440,162440,162443,0,3,2
46368,2,3,162442,162443,162446,1,4,0
46369,1,2,162443,162446,162448,3,5,0
46370,1,2,162444,162448,162450,4,6,0
46371,5,2,162449,162450,162452,1,3,0
46372,5,3,162454,162454,162457,0,3,2
46373,5,3,162459,162459,162462,0,3,2
46374,2,1,162461,162462,162463,1,2,0
46375,6,2,162467,162467,162469,0,2,4
46376,5,3,162472,162472,162475,0,3,3
46377,2,2,162474,162475,162477,1,3,0
46378,3,1,162477,162477,162478,0,1,0
46379,6,3,162483,162483,162486,0,3,5
46380,5,1,162488,162488,162489,0,1,2
46381,1,3,162489,162489,162492,0,3,0
46382,4,3,162493,162493,162496,0,3,1
46383,5,2,162498,162498,162500,0,2,2
46384,5,2,162503,162503,162505,0,2,3
46385,6,2,162509,162509,162511,0,2,4
46386,5,3,162514,162514,162517,0,3,3
46387,1,3,162515,162517,162520,2,5,0
46388,6,2,162521,162521,162523,0,2,1
46389,2,1,162523,162523,162524,0,1,0
46390,1,1,162524,162524,162525,0,1,0
46391,4,2,162528,162528,162530,0,2,3
46392,4,1,162532,162532,162533,0,1,2
46393,1,3,162533,162533,162536,0,3,0
46394,6,2,162539,162539,162541,0,2,3
46395,6,2,162545,162545,162547,0,2,4
46396,1,2,162546,162547,162549,1,3,0
46397,2,3,162548,162549,162552,1,4,0
46398,3,1,162551,162552,162553,1,2,0
46399,1,1,162552,162553,162554,1,2,0
46400,1,2,162553,162554,162556,1,3,0
46401,1,3,162554,162556,162559,2,5,0
46402,4,1,162558,162559,162560,1,2,0
46403,6,2,162564,162564,162566,0,2,4
46404,1,1,162565,162566,162567,1,2,0
46405,1,3,162566,162567,162570,1,4,0
46406,2,3,162568,162570,162573,2,5,0
46407,5,2,162573,162573,162575,0,2,0
46408,5,1,162578,162578,162579,0,1,3
46409,2,1,162580,162580,162581,0,1,1
46410,1,1,162581,162581,162582,0,1,0
46411,3,3,162584,162584,162587,0,3,2
46412,6,2,162590,162590,162592,0,2,3
46413,6,2,162596,162596,162598,0,2,4
46414,5,3,162601,162601,162604,0,3,3
46415,3,2,162604,162604,162606,0,2,0
46416,6,3,162610,162610,162613,0,3,4
46417,5,2,162615,162615,162617,0,2,2
46418,2,2,162617,162617,162619,0,2,0
46419,1,1,162618,162619,162620,1,2,0
46420,3,2,162621,162621,162623,0,2,1
46421,3,1,162624,162624,162625,0,1,1
46422,1,1,162625,162625,162626,0,1,0
46423,4,3,162629,162629,162632,0,3,3
46424,5,1,162634,162634,162635,0,1,2
46425,6,1,162640,162640,162641,0,1,5
46426,1,1,162641,162641,162642,0,1,0
46427,2,2,162643,162643,162645,0,2,1
46428,3,1,162646,162646,162647,0,1,1
46429,3,1,162649,162649,162650,0,1,2
46430,4,1,162653,162653,162654,0,1,3
46431,5,3,162658,162658,162661,0,3,4
46432,4,1,162662,162662,162663,0,1,1
46433,3,3,162665,162665,162668,0,3,2
46434,2,2,162667,162668,162670,1,3,0
46435,5,2,162672,162672,162674,0,2,2
46436,5,2,162677,162677,162679,0,2,3
46437,1,3,162678,162679,162682,1,4,0
46438,2,1,162680,162682,162683,2,3,0
46439,6,1,162686,162686,162687,0,1,3
46440,3,2,162689,162689,162691,0,2,2
46441,1,1,162690,162691,162692,1,2,0
46442,1,2,162691,162692,162694,1,3,0
46443,3,1,162694,162694,162695,0,1,0
46444,1,3,162695,162695,162698,0,3,0
46445,5,1,162700,162700,162701,0,1,2
46446,2,1,162702,162702,162703,0,1,1
46447,2,2,162704,162704,162706,0,2,1
46448,3,2,162707,162707,162709,0,2,1
46449,1,3,162708,162709,162712,1,4,0
46450,3,3,162711,162712,162715,1,4,0
46451,2,3,162713,162715,162718,2,5,0
46452,4,2,162717,162718,162720,1,3,0
46453,3,2,162720,162720,162722,0,2,0
46454,5,2,162725,162725,162727,0,2,3
46455,1,1,162726,162727,162728,1,2,0
46456,2,3,162728,162728,162731,0,3,0
46457,1,2,162729,162731,162733,2,4,0
46458,4,1,162733,162733,162734,0,1,0
46459,3,2,162736,162736,162738,0,2,2
46460,1,2,162737,162738,162740,1,3,0
46461,3,1,162740,162740,162741,0,1,0
46462,3,1,162743,162743,162744,0,1,2
46463,6,3,162749,162749,162752,0,3,5
46464,6,1,162755,162755,162756,0,1,3
46465,1,1,162756,162756,162757,0,1,0
46466,6,3,162762,162762,162765,0,3,5
46467,4,3,162766,162766,162769,0,3,1
46468,1,3,162767,162769,162772,2,5,0
46469,4,2,162771,162772,162774,1,3,0
46470,2,2,162773,162774,162776,1,3,0
46471,3,2,162776,162776,162778,0,2,0
46472,1,3,162777,162778,162781,1,4,0
46473,5,2,162782,162782,162784,0,2,1
46474,5,1,162787,162787,162788,0,1,3
46475,5,2,162792,162792,162794,0,2,4
46476,3,2,162795,162795,162797,0,2,1
46477,2,1,162797,162797,162798,0,1,0
46478,4,2,162801,162801,162803,0,2,3
46479,2,3,162803,162803,162806,0,3,0
46480,4,3,162807,162807,162810,0,3,1
46481,6,3,162813,162813,162816,0,3,3
46482,4,2,162817,162817,162819,0,2,1
46483,4,3,162821,162821,162824,0,3,2
46484,3,1,162824,162824,162825,0,1,0
46485,2,1,162826,162826,162827,0,1,1
46486,5,3,162831,162831,162834,0,3,4
46487,2,3,162833,162834,162837,1,4,0
46488,4,1,162837,162837,162838,0,1,0
46489,2,2,162839,162839,162841,0,2,1
46490,1,1,162840,162841,162842,1,2,0
46491,1,2,162841,162842,162844,1,3,0
46492,4,3,162845,162845,162848,0,3,1
46493,5,1,162850,162850,162851,0,1,2
46494,4,2,162854,162854,162856,0,2,3
46495,3,3,162857,162857,162860,0,3,1
46496,1,2,162858,162860,162862,2,4,0
46497,3,1,162861,162862,162863,1,2,0
46498,2,1,162863,162863,162864,0,1,0
46499,2,2,162865,162865,162867,0,2,1
46500,2,3,162867,162867,162870,0,3,0
46501,5,3,162872,162872,162875,0,3,2
46502,2,1,162874,162875,162876,1,2,0
46503,3,1,162877,162877,162878,0,1,1
46504,4,1,162881,162881,162882,0,1,3
46505,1,3,162882,162882,162885,0,3,0
46506,3,3,162885,162885,162888,0,3,0
46507,4,2,162889,162889,162891,0,2,1
46508,4,3,162893,162893,162896,0,3,2
46509,4,1,162897,162897,162898,0,1,1
46510,4,1,162901,162901,162902,0,1,3
46511,1,1,162902,162902,162903,0,1,0
46512,5,1,162907,162907,162908,0,1,4
46513,1,3,162908,162908,162911,0,3,0
46514,6,3,162914,162914,162917,0,3,3
46515,5,3,162919,162919,162922,0,3,2
46516,1,2,162920,162922,162924,2,4,0
46517,4,3,162924,162924,162927,0,3,0
46518,5,3,162929,162929,162932,0,3,2
46519,4,3,162933,162933,162936,0,3,1
46520,5,2,162938,162938,162940,0,2,2
46521,1,3,162939,162940,162943,1,4,0
46522,6,3,162945,162945,162948,0,3,2
46523,4,1,162949,162949,162950,0,1,1
46524,1,1,162950,162950,162951,0,1,0
46525,1,3,162951,162951,162954,0,3,0
46526,3,1,162954,162954,162955,0,1,0
46527,2,3,162956,162956,162959,0,3,1
46528,6,2,162962,162962,162964,0,2,3
46529,2,3,162964,162964,162967,0,3,0
46530,4,3,162968,162968,162971,0,3,1
46531,3,1,162971,162971,162972,0,1,0
46532,3,3,162974,162974,162977,0,3,2
46533,4,3,162978,162978,162981,0,3,1
46534,5,3,162983,162983,162986,0,3,2
46535,5,3,162988,162988,162991,0,3,2
46536,4,3,162992,162992,162995,0,3,1
46537,6,3,162998,162998,163001,0,3,3
46538,6,3,163004,163004,163007,0,3,3
46539,4,3,163008,163008,163011,0,3,1
46540,1,2,163009,163011,163013,2,4,0
46541,4,2,163013,163013,163015,0,2,0
46542,1,3,163014,163015,163018,1,4,0
46543,3,1,163017,163018,163019,1,2,0
46544,6,1,163023,163023,163024,0,1,4
46545,5,2,163028,163028,163030,0,2,4
46546,4,1,163032,163032,163033,0,1,2
46547,2,2,163034,163034,163036,0,2,1
46548,1,3,163035,163036,163039,1,4,0
46549,6,1,163041,163041,163042,0,1,2
46550,3,1,163044,163044,163045,0,1,2
46551,2,1,163046,163046,163047,0,1,1
46552,5,1,163051,163051,163052,0,1,4
46553,5,2,163056,163056,163058,0,2,4
46554,4,3,163060,163060,163063,0,3,2
46555,4,2,163064,163064,163066,0,2,1
46556,4,3,163068,163068,163071,0,3,2
46557,6,3,163074,163074,163077,0,3,3
46558,2,3,163076,163077,163080,1,4,0
46559,5,3,163081,163081,163084,0,3,1
46560,3,3,163084,163084,163087,0,3,0
46561,6,2,163090,163090,163092,0,2,3
46562,1,2,163091,163092,163094,1,3,0
46563,2,1,163093,163094,163095,1,2,0
46564,2,1,163095,163095,163096,0,1,0
46565,3,1,163098,163098,163099,0,1,2
46566,4,3,163102,163102,163105,0,3,3
46567,3,3,163105,163105,163108,0,3,0
46568,6,3,163111,163111,163114,0,3,3
46569,2,2,163113,163114,163116,1,3,0
46570,4,3,163117,163117,163120,0,3,1
46571,4,1,163121,163121,163122,0,1,1
46572,6,1,163127,163127,163128,0,1,5
46573,6,3,163133,163133,163136,0,3,5
46574,1,3,163134,163136,163139,2,5,0
46575,1,2,163135,163139,163141,4,6,0
46576,2,3,163137,163141,163144,4,7,0
46577,5,1,163142,163144,163145,2,3,0
46578,4,3,163146,163146,163149,0,3,1
46579,1,1,163147,163149,163150,2,3,0
46580,2,3,163149,163150,163153,1,4,0
46581,5,2,163154,163154,163156,0,2,1
46582,3,3,163157,163157,163160,0,3,1
46583,2,2,163159,163160,163162,1,3,0
46584,3,1,163162,163162,163163,0,1,0
46585,3,1,163165,163165,163166,0,1,2
46586,2,2,163167,163167,163169,0,2,1
46587,4,3,163171,163171,163174,0,3,2
46588,5,1,163176,163176,163177,0,1,2
46589,1,3,163177,163177,163180,0,3,0
46590,4,1,163181,163181,163182,0,1,1
46591,5,2,163186,163186,163188,0,2,4
46592,6,2,163192,163192,163194,0,2,4
46593,6,1,163198,163198,163199,0,1,4
46594,6,2,163204,163204,163206,0,2,5
46595,3,3,163207,163207,163210,0,3,1
46596,6,3,163213,163213,163216,0,3,3
46597,4,3,163217,163217,163220,0,3,1
46598,5,1,163222,163222,163223,0,1,2
46599,4,3,163226,163226,163229,0,3,3
46600,5,2,163231,163231,163233,0,2,2
46601,5,3,163236,163236,163239,0,3,3
46602,2,3,163238,163239,163242,1,4,0
46603,6,3,163244,163244,163247,0,3,2
46604,4,3,163248,163248,163251,0,3,1
46605,5,3,163253,163253,163256,0,3,2
46606,1,3,163254,163256,163259,2,5,0
46607,2,3,163256,163259,163262,3,6,0
46608,4,3,163260,163262,163265,2,5,0
46609,2,1,163262,163265,163266,3,4,0
46610,4,3,163266,163266,163269,0,3,0
46611,3,3,163269,163269,163272,0,3,0
46612,5,1,163274,163274,163275,0,1,2
46613,5,3,163279,163279,163282,0,3,4
46614,2,3,163281,163282,163285,1,4,0
46615,6,3,163287,163287,163290,0,3,2
46616,2,3,163289,163290,163293,1,4,0
46617,5,2,163294,163294,163296,0,2,1
46618,1,2,163295,163296,163298,1,3,0
46619,1,1,163296,163298,163299,2,3,0
46620,5,1,163301,163301,163302,0,1,2
46621,1,1,163302,163302,163303,0,1,0
46622,2,1,163304,163304,163305,0,1,1
46623,2,3,163306,163306,163309,0,3,1
46624,5,3,163311,163311,163314,0,3,2
46625,4,1,163315,163315,163316,0,1,1
46626,5,1,163320,163320,163321,0,1,4
46627,4,3,163324,163324,163327,0,3,3
46628,1,3,163325,163327,163330,2,5,0
46629,2,3,163327,163330,163333,3,6,0
46630,6,3,163333,163333,163336,0,3,0
46631,5,3,163338,163338,163341,0,3,2
46632,6,2,163344,163344,163346,0,2,3
46633,2,1,163346,163346,163347,0,1,0
46634,1,2,163347,163347,163349,0,2,0
46635,6,3,163353,163353,163356,0,3,4
46636,5,1,163358,163358,163359,0,1,2
46637,5,3,163363,163363,163366,0,3,4
46638,6,1,163369,163369,163370,0,1,3
46639,4,3,163373,163373,163376,0,3,3
46640,3,3,163376,163376,163379,0,3,0
46641,3,2,163379,163379,163381,0,2,0
46642,1,3,163380,163381,163384,1,4,0
46643,3,3,163383,163384,163387,1,4,0
46644,3,3,163386,163387,163390,1,4,0
46645,1,3,163387,163390,163393,3,6,0
46646,2,3,163389,163393,163396,4,7,0
46647,4,3,163393,163396,163399,3,6,0
46648,4,1,163397,163399,163400,2,3,0
46649,3,1,163400,163400,163401,0,1,0
46650,2,3,163402,163402,163405,0,3,1
46651,3,1,163405,163405,163406,0,1,0
46652,1,2,163406,163406,163408,0,2,0
46653,5,2,163411,163411,163413,0,2,3
46654,5,2,163416,163416,163418,0,2,3
46655,5,2,163421,163421,163423,0,2,3
46656,3,3,163424,163424,163427,0,3,1
46657,4,2,163428,163428,163430,0,2,1
46658,1,2,163429,163430,163432,1,3,0
46659,5,1,163434,163434,163435,0,1,2
46660,1,3,163435,163435,163438,0,3,0
46661,4,2,163439,163439,163441,0,2,1
46662,5,2,163444,163444,163446,0,2,3
46663,2,1,163446,163446,163447,0,1,0
46664,4,3,163450,163450,163453,0,3,3
46665,6,1,163456,163456,163457,0,1,3
46666,1,2,163457,163457,163459,0,2,0
46667,5,1,163462,163462,163463,0,1,3
46668,2,2,163464,163464,163466,0,2,1
46669,3,1,163467,163467,163468,0,1,1
46670,6,3,163473,163473,163476,0,3,5
46671,6,3,163479,163479,163482,0,3,3
46672,3,2,163482,163482,163484,0,2,0
46673,4,1,163486,163486,163487,0,1,2
46674,2,2,163488,163488,163490,0,2,1
46675,6,3,163494,163494,163497,0,3,4
46676,1,1,163495,163497,163498,2,3,0
46677,3,2,163498,163498,163500,0,2,0
46678,2,1,163500,163500,163501,0,1,0
46679,1,2,163501,163501,163503,0,2,0
46680,6,2,163507,163507,163509,0,2,4
46681,6,2,163513,163513,163515,0,2,4
46682,4,2,163517,163517,163519,0,2,2
46683,3,2,163520,163520,163522,0,2,1
46684,3,1,163523,163523,163524,0,1,1
46685,1,2,163524,163524,163526,0,2,0
46686,3,2,163527,163527,163529,0,2,1
46687,4,2,163531,163531,163533,0,2,2
46688,5,2,163536,163536,163538,0,2,3
46689,1,1,163537,163538,163539,1,2,0
46690,2,3,163539,163539,163542,0,3,0
46691,2,1,163541,163542,163543,1,2,0
46692,1,1,163542,163543,163544,1,2,0
46693,6,2,163548,163548,163550,0,2,4
46694,3,2,163551,163551,163553,0,2,1
46695,1,3,163552,163553,163556,1,4,0
46696,6,2,163558,163558,163560,0,2,2
46697,6,3,163564,163564,163567,0,3,4
46698,4,2,163568,163568,163570,0,2,1
46699,4,3,163572,163572,163575,0,3,2
46700,3,3,163575,163575,163578,0,3,0
46701,3,2,163578,163578,163580,0,2,0
46702,6,1,163584,163584,163585,0,1,4
46703,4,3,163588,163588,163591,0,3,3
46704,6,2,163594,163594,163596,0,2,3
46705,3,3,163597,163597,163600,0,3,1
46706,1,2,163598,163600,163602,2,4,0
46707,4,3,163602,163602,163605,0,3,0
46708,2,1,163604,163605,163606,1,2,0
46709,1,3,163605,163606,163609,1,4,0
46710,5,1,163610,163610,163611,0,1,1
46711,5,2,163615,163615,163617,0,2,4
46712,2,3,163617,163617,163620,0,3,0
46713,2,1,163619,163620,163621,1,2,0
46714,3,1,163622,163622,163623,0,1,1
46715,4,2,163626,163626,163628,0,2,3
46716,6,3,163632,163632,163635,0,3,4
46717,1,3,163633,163635,163638,2,5,0
46718,4,2,163637,163638,163640,1,3,0
46719,5,3,163642,163642,163645,0,3,2
46720,2,1,163644,163645,163646,1,2,0
46721,3,2,163647,163647,163649,0,2,1
46722,5,1,163652,163652,163653,0,1,3
46723,1,3,163653,163653,163656,0,3,0
46724,6,2,163659,163659,163661,0,2,3
46725,6,1,163665,163665,163666,0,1,4
46726,3,3,163668,163668,163671,0,3,2
46727,2,2,163670,163671,163673,1,3,0
46728,2,1,163672,163673,163674,1,2,0
46729,1,2,163673,163674,163676,1,3,0
46730,3,3,163676,163676,163679,0,3,0
46731,4,1,163680,163680,163681,0,1,1
46732,5,2,163685,163685,163687,0,2,4
46733,4,2,163689,163689,163691,0,2,2
46734,3,3,163692,163692,163695,0,3,1
46735,5,2,163697,163697,163699,0,2,2
46736,1,3,163698,163699,163702,1,4,0
46737,5,2,163703,163703,163705,0,2,1
46738,4,3,163707,163707,163710,0,3,2
46739,2,2,163709,163710,163712,1,3,0
46740,6,3,163715,163715,163718,0,3,3
46741,6,3,163721,163721,163724,0,3,3
46742,4,2,163725,163725,163727,0,2,1
46743,1,1,163726,163727,163728,1,2,0
46744,4,3,163730,163730,163733,0,3,2
46745,2,3,163732,163733,163736,1,4,0
46746,2,3,163734,163736,163739,2,5,0
46747,4,3,163738,163739,163742,1,4,0
46748,1,1,163739,163742,163743,3,4,0
46749,5,3,163744,163744,163747,0,3,1
46750,4,3,163748,163748,163751,0,3,1
46751,6,2,163754,163754,163756,0,2,3
46752,1,3,163755,163756,163759,1,4,0
46753,3,1,163758,163759,163760,1,2,0
46754,6,3,163764,163764,163767,0,3,4
46755,3,3,163767,163767,163770,0,3,0
46756,1,2,163768,163770,163772,2,4,0
46757,2,3,163770,163772,163775,2,5,0
46758,1,1,163771,163775,163776,4,5,0
46759,5,1,163776,163776,163777,0,1,0
46760,6,3,163782,163782,163785,0,3,5
46761,5,2,163787,163787,163789,0,2,2
46762,2,3,163789,163789,163792,0,3,0
46763,5,2,163794,163794,163796,0,2,2
46764,3,1,163797,163797,163798,0,1,1
46765,4,1,163801,163801,163802,0,1,3
46766,6,2,163807,163807,163809,0,2,5
46767,2,1,163809,163809,163810,0,1,0
46768,3,2,163812,163812,163814,0,2,2
46769,3,1,163815,163815,163816,0,1,1
46770,4,1,163819,163819,163820,0,1,3
46771,5,1,163824,163824,163825,0,1,4
46772,3,1,163827,163827,163828,0,1,2
46773,1,1,163828,163828,163829,0,1,0
46774,6,2,163834,163834,163836,0,2,5
46775,5,3,163839,163839,163842,0,3,3
46776,5,1,163844,163844,163845,0,1,2
46777,5,1,163849,163849,163850,0,1,4
46778,3,3,163852,163852,163855,0,3,2
46779,1,1,163853,163855,163856,2,3,0
46780,4,1,163857,163857,163858,0,1,1
46781,2,3,163859,163859,163862,0,3,1
46782,6,2,163865,163865,163867,0,2,3
46783,6,2,163871,163871,163873,0,2,4
46784,4,3,163875,163875,163878,0,3,2
46785,5,1,163880,163880,163881,0,1,2
46786,5,2,163885,163885,163887,0,2,4
46787,1,1,163886,163887,163888,1,2,0
46788,3,1,163889,163889,163890,0,1,1
46789,6,1,163895,163895,163896,0,1,5
46790,3,3,163898,163898,163901,0,3,2
46791,3,1,163901,163901,163902,0,1,0
46792,3,2,163904,163904,163906,0,2,2
46793,4,3,163908,163908,163911,0,3,2
46794,1,1,163909,163911,163912,2,3,0
46795,1,1,163910,163912,163913,2,3,0
46796,4,3,163914,163914,163917,0,3,1
46797,4,1,163918,163918,163919,0,1,1
46798,1,3,163919,163919,163922,0,3,0
46799,4,3,163923,163923,163926,0,3,1
46800,6,3,163929,163929,163932,0,3,3
46801,3,1,163932,163932,163933,0,1,0
46802,4,3,163936,163936,163939,0,3,3
46803,1,3,163937,163939,163942,2,5,0
46804,6,2,163943,163943,163945,0,2,1
46805,5,3,163948,163948,163951,0,3,3
46806,2,1,163950,163951,163952,1,2,0
46807,4,2,163954,163954,163956,0,2,2
46808,3,2,163957,163957,163959,0,2,1
46809,3,1,163960,163960,163961,0,1,1
46810,6,3,163966,163966,163969,0,3,5
46811,6,2,163972,163972,163974,0,2,3
46812,2,1,163974,163974,163975,0,1,0
46813,5,1,163979,163979,163980,0,1,4
46814,3,3,163982,163982,163985,0,3,2
46815,6,2,163988,163988,163990,0,2,3
46816,4,2,163992,163992,163994,0,2,2
46817,2,3,163994,163994,163997,0,3,0
46818,6,2,164000,164000,164002,0,2,3
46819,3,1,164003,164003,164004,0,1,1
46820,4,1,164007,164007,164008,0,1,3
46821,2,2,164009,164009,164011,0,2,1
46822,6,3,164015,164015,164018,0,3,4
46823,6,1,164021,164021,164022,0,1,3
46824,6,1,164027,164027,164028,0,1,5
46825,3,2,164030,164030,164032,0,2,2
46826,4,2,164034,164034,164036,0,2,2
46827,3,3,164037,164037,164040,0,3,1
46828,5,1,164042,164042,164043,0,1,2
46829,2,1,164044,164044,164045,0,1,1
46830,5,3,164049,164049,164052,0,3,4
46831,1,3,164050,164052,164055,2,5,0
46832,6,3,164056,164056,164059,0,3,1
46833,4,1,164060,164060,164061,0,1,1
46834,1,2,164061,164061,164063,0,2,0
46835,4,1,164065,164065,164066,0,1,2
46836,4,2,164069,164069,164071,0,2,3
46837,6,1,164075,164075,164076,0,1,4
46838,5,2,164080,164080,164082,0,2,4
46839,4,2,164084,164084,164086,0,2,2
46840,2,2,164086,164086,164088,0,2,0
46841,2,1,164088,164088,164089,0,1,0
46842,1,3,164089,164089,164092,0,3,0
46843,4,3,164093,164093,164096,0,3,1
46844,6,3,164099,164099,164102,0,3,3
46845,1,3,164100,164102,164105,2,5,0
46846,3,2,164103,164105,164107,2,4,0
46847,4,2,164107,164107,164109,0,2,0
46848,6,3,164113,164113,164116,0,3,4
46849,2,2,164115,164116,164118,1,3,0
46850,1,3,164116,164118,164121,2,5,0
46851,3,2,164119,164121,164123,2,4,0
46852,4,3,164123,164123,164126,0,3,0
46853,3,2,164126,164126,164128,0,2,0
46854,2,2,164128,164128,164130,0,2,0
46855,4,3,164132,164132,164135,0,3,2
46856,2,3,164134,164135,164138,1,4,0
46857,4,3,164138,164138,164141,0,3,0
46858,4,1,164142,164142,164143,0,1,1
46859,2,2,164144,164144,164146,0,2,1
46860,2,1,164146,164146,164147,0,1,0
46861,4,3,164150,164150,164153,0,3,3
46862,2,2,164152,164153,164155,1,3,0
46863,5,2,164157,164157,164159,0,2,2
46864,4,2,164161,164161,164163,0,2,2
46865,4,3,164165,164165,164168,0,3,2
46866,4,3,164169,164169,164172,0,3,1
46867,5,2,164174,164174,164176,0,2,2
46868,4,3,164178,164178,164181,0,3,2
46869,1,3,164179,164181,164184,2,5,0
46870,4,3,164183,164184,164187,1,4,0
46871,6,3,164189,164189,164192,0,3,2
46872,3,2,164192,164192,164194,0,2,0
46873,4,1,164196,164196,164197,0,1,2
46874,5,1,164201,164201,164202,0,1,4
46875,5,2,164206,164206,164208,0,2,4
46876,2,1,164208,164208,164209,0,1,0
46877,2,1,164210,164210,164211,0,1,1
46878,2,1,164212,164212,164213,0,1,1
46879,1,3,164213,164213,164216,0,3,0
46880,3,2,164216,164216,164218,0,2,0
46881,5,1,164221,164221,164222,0,1,3
46882,5,2,164226,164226,164228,0,2,4
46883,5,2,164231,164231,164233,0,2,3
46884,2,1,164233,164233,164234,0,1,0
46885,3,1,164236,164236,164237,0,1,2
46886,6,2,164242,164242,164244,0,2,5
46887,2,3,164244,164244,164247,0,3,0
46888,5,2,164249,164249,164251,0,2,2
46889,1,1,164250,164251,164252,1,2,0
46890,2,1,164252,164252,164253,0,1,0
46891,1,1,164253,164253,164254,0,1,0
46892,6,2,164259,164259,164261,0,2,5
46893,4,3,164263,164263,164266,0,3,2
46894,2,3,164265,164266,164269,1,4,0
46895,1,2,164266,164269,164271,3,5,0
46896,5,1,164271,164271,164272,0,1,0
46897,4,2,164275,164275,164277,0,2,3
46898,1,3,164276,164277,164280,1,4,0
46899,4,2,164280,164280,164282,0,2,0
46900,3,3,164283,164283,164286,0,3,1
46901,3,1,164286,164286,164287,0,1,0
46902,1,2,164287,164287,164289,0,2,0
46903,5,3,164292,164292,164295,0,3,3
46904,1,1,164293,164295,164296,2,3,0
46905,6,3,164299,164299,164302,0,3,3
46906,3,2,164302,164302,164304,0,2,0
46907,3,3,164305,164305,164308,0,3,1
46908,6,3,164311,164311,164314,0,3,3
46909,4,3,164315,164315,164318,0,3,1
46910,4,1,164319,164319,164320,0,1,1
46911,3,3,164322,164322,164325,0,3,2
46912,1,2,164323,164325,164327,2,4,0
46913,4,3,164327,164327,164330,0,3,0
46914,3,2,164330,164330,164332,0,2,0
46915,3,3,164333,164333,164336,0,3,1
46916,5,3,164338,164338,164341,0,3,2
46917,2,2,164340,164341,164343,1,3,0
46918,3,1,164343,164343,164344,0,1,0
46919,5,1,164348,164348,164349,0,1,4
46920,5,1,164353,164353,164354,0,1,4
46921,3,3,164356,164356,164359,0,3,2
46922,4,3,164360,164360,164363,0,3,1
46923,5,2,164365,164365,164367,0,2,2
46924,1,3,164366,164367,164370,1,4,0
46925,4,1,164370,164370,164371,0,1,0
46926,5,3,164375,164375,164378,0,3,4
46927,2,3,164377,164378,164381,1,4,0
46928,3,1,164380,164381,164382,1,2,0
46929,5,2,164385,164385,164387,0,2,3
46930,4,1,164389,164389,164390,0,1,2
46931,1,2,164390,164390,164392,0,2,0
46932,5,3,164395,164395,164398,0,3,3
46933,2,2,164397,164398,164400,1,3,0
46934,2,2,164399,164400,164402,1,3,0
46935,4,1,164403,164403,164404,0,1,1
46936,6,3,164409,164409,164412,0,3,5
46937,1,2,164410,164412,164414,2,4,0
46938,1,2,164411,164414,164416,3,5,0
46939,5,2,164416,164416,164418,0,2,0
46940,4,2,164420,164420,164422,0,2,2
46941,2,3,164422,164422,164425,0,3,0
46942,5,3,164427,164427,164430,0,3,2
46943,1,2,164428,164430,164432,2,4,0
46944,2,3,164430,164432,164435,2,5,0
46945,3,3,164433,164435,164438,2,5,0
46946,6,2,164439,164439,164441,0,2,1
46947,6,1,164445,164445,164446,0,1,4
46948,6,3,164451,164451,164454,0,3,5
46949,3,2,164454,164454,164456,0,2,0
46950,6,3,164460,164460,164463,0,3,4
46951,2,3,164462,164463,164466,1,4,0
46952,3,1,164465,164466,164467,1,2,0
46953,2,1,164467,164467,164468,0,1,0
46954,2,3,164469,164469,164472,0,3,1
46955,2,2,164471,164472,164474,1,3,0
46956,1,3,164472,164474,164477,2,5,0
46957,3,2,164475,164477,164479,2,4,0
46958,1,3,164476,164479,164482,3,6,0
46959,2,3,164478,164482,164485,4,7,0
46960,5,3,164483,164485,164488,2,5,0
46961,1,1,164484,164488,164489,4,5,0
46962,6,1,164490,164490,164491,0,1,1
46963,1,3,164491,164491,164494,0,3,0
46964,4,3,164495,164495,164498,0,3,1
46965,4,2,164499,164499,164501,0,2,1
46966,2,1,164501,164501,164502,0,1,0
46967,6,2,164507,164507,164509,0,2,5
46968,3,3,164510,164510,164513,0,3,1
46969,3,1,164513,164513,164514,0,1,0
46970,4,2,164517,164517,164519,0,2,3
46971,3,1,164520,164520,164521,0,1,1
46972,2,1,164522,164522,164523,0,1,1
46973,2,3,164524,164524,164527,0,3,1
46974,4,2,164528,164528,164530,0,2,1
46975,1,2,164529,164530,164532,1,3,0
46976,5,2,164534,164534,164536,0,2,2
46977,2,3,164536,164536,164539,0,3,0
46978,3,2,164539,164539,164541,0,2,0
46979,1,1,164540,164541,164542,1,2,0
46980,2,3,164542,164542,164545,0,3,0
46981,1,3,164543,164545,164548,2,5,0
46982,3,3,164546,164548,164551,2,5,0
46983,1,1,164547,164551,164552,4,5,0
46984,2,2,164549,164552,164554,3,5,0
46985,3,2,164552,164554,164556,2,4,0
46986,4,2,164556,164556,164558,0,2,0
46987,1,3,164557,164558,164561,1,4,0
46988,3,1,164560,164561,164562,1,2,0
46989,2,1,164562,164562,164563,0,1,0
46990,2,2,164564,164564,164566,0,2,1
46991,4,1,164568,164568,164569,0,1,2
46992,1,3,164569,164569,164572,0,3,0
46993,5,2,164574,164574,164576,0,2,2
46994,2,3,164576,164576,164579,0,3,0
46995,5,1,164581,164581,164582,0,1,2
46996,6,2,164587,164587,164589,0,2,5
46997,2,3,164589,164589,164592,0,3,0
46998,6,2,164595,164595,164597,0,2,3
46999,5,1,164600,164600,164601,0,1,3
47000,4,1,164604,164604,164605,0,1,3
47001,4,3,164608,164608,164611,0,3,3
47002,3,3,164611,164611,164614,0,3,0
47003,2,2,164613,164614,164616,1,3,0
47004,3,3,164616,164616,164619,0,3,0
47005,3,1,164619,164619,164620,0,1,0
47006,6,1,164625,164625,164626,0,1,5
47007,4,2,164629,164629,164631,0,2,3
47008,6,1,164635,164635,164636,0,1,4
47009,6,2,164641,164641,164643,0,2,5
47010,6,3,164647,164647,164650,0,3,4
47011,3,1,164650,164650,164651,0,1,0
47012,6,1,164656,164656,164657,0,1,5
47013,3,3,164659,164659,164662,0,3,2
47014,2,2,164661,164662,164664,1,3,0
47015,5,2,164666,164666,164668,0,2,2
47016,1,2,164667,164668,164670,1,3,0
47017,4,3,164671,164671,164674,0,3,1
47018,5,3,164676,164676,164679,0,3,2
47019,1,1,164677,164679,164680,2,3,0
47020,1,2,164678,164680,164682,2,4,0
47021,5,1,164683,164683,164684,0,1,1
47022,3,1,164686,164686,164687,0,1,2
47023,2,1,164688,164688,164689,0,1,1
47024,4,1,164692,164692,164693,0,1,3
47025,2,1,164694,164694,164695,0,1,1
47026,5,3,164699,164699,164702,0,3,4
47027,1,3,164700,164702,164705,2,5,0
47028,4,1,164704,164705,164706,1,2,0
47029,5,3,164709,164709,164712,0,3,3
47030,2,1,164711,164712,164713,1,2,0
47031,4,3,164715,164715,164718,0,3,2
47032,4,3,164719,164719,164722,0,3,1
47033,1,1,164720,164722,164723,2,3,0
47034,6,2,164726,164726,164728,0,2,3
47035,6,2,164732,164732,164734,0,2,4
47036,3,1,164735,164735,164736,0,1,1
47037,5,1,164740,164740,164741,0,1,4
47038,3,3,164743,164743,164746,0,3,2
47039,5,2,164748,164748,164750,0,2,2
47040,4,1,164752,164752,164753,0,1,2
47041,5,3,164757,164757,164760,0,3,4
47042,3,1,164760,164760,164761,0,1,0
47043,6,1,164766,164766,164767,0,1,5
47044,6,2,164772,164772,164774,0,2,5
47045,1,2,164773,164774,164776,1,3,0
47046,1,3,164774,164776,164779,2,5,0
47047,5,2,164779,164779,164781,0,2,0
47048,6,1,164785,164785,164786,0,1,4
47049,2,3,164787,164787,164790,0,3,1
47050,2,3,164789,164790,164793,1,4,0
47051,1,3,164790,164793,164796,3,6,0
47052,2,1,164792,164796,164797,4,5,0
47053,4,3,164796,164797,164800,1,4,0
47054,6,2,164802,164802,164804,0,2,2
47055,5,1,164807,164807,164808,0,1,3
47056,3,1,164810,164810,164811,0,1,2
47057,5,3,164815,164815,164818,0,3,4
47058,5,2,164820,164820,164822,0,2,2
47059,2,3,164822,164822,164825,0,3,0
47060,4,2,164826,164826,164828,0,2,1
47061,4,1,164830,164830,164831,0,1,2
47062,1,2,164831,164831,164833,0,2,0
47063,4,1,164835,164835,164836,0,1,2
47064,6,2,164841,164841,164843,0,2,5
47065,6,2,164847,164847,164849,0,2,4
47066,6,1,164853,164853,164854,0,1,4
47067,6,3,164859,164859,164862,0,3,5
47068,2,2,164861,164862,164864,1,3,0
47069,2,2,164863,164864,164866,1,3,0
47070,6,3,164869,164869,164872,0,3,3
47071,2,1,164871,164872,164873,1,2,0
47072,2,3,164873,164873,164876,0,3,0
47073,1,2,164874,164876,164878,2,4,0
47074,6,2,164880,164880,164882,0,2,2
47075,3,3,164883,164883,164886,0,3,1
47076,5,1,164888,164888,164889,0,1,2
47077,6,1,164894,164894,164895,0,1,5
47078,1,2,164895,164895,164897,0,2,0
47079,6,3,164901,164901,164904,0,3,4
47080,3,2,164904,164904,164906,0,2,0
47081,6,3,164910,164910,164913,0,3,4
47082,3,2,164913,164913,164915,0,2,0
47083,3,2,164916,164916,164918,0,2,1
47084,2,1,164918,164918,164919,0,1,0
47085,5,2,164923,164923,164925,0,2,4
47086,5,1,164928,164928,164929,0,1,3
47087,1,2,164929,164929,164931,0,2,0
47088,2,2,164931,164931,164933,0,2,0
47089,4,1,164935,164935,164936,0,1,2
47090,1,3,164936,164936,164939,0,3,0
47091,4,1,164940,164940,164941,0,1,1
47092,1,1,164941,164941,164942,0,1,0
47093,2,3,164943,164943,164946,0,3,1
47094,2,3,164945,164946,164949,1,4,0
47095,4,2,164949,164949,164951,0,2,0
47096,4,3,164953,164953,164956,0,3,2
47097,2,1,164955,164956,164957,1,2,0
47098,5,2,164960,164960,164962,0,2,3
47099,3,1,164963,164963,164964,0,1,1
47100,1,3,164964,164964,164967,0,3,0
47101,3,2,164967,164967,164969,0,2,0
47102,2,1,164969,164969,164970,0,1,0
47103,2,1,164971,164971,164972,0,1,1
47104,1,1,164972,164972,164973,0,1,0
47105,1,1,164973,164973,164974,0,1,0
47106,5,3,164978,164978,164981,0,3,4
47107,6,3,164984,164984,164987,0,3,3
47108,4,3,164988,164988,164991,0,3,1
47109,5,1,164993,164993,164994,0,1,2
47110,6,3,164999,164999,165002,0,3,5
47111,5,3,165004,165004,165007,0,3,2
47112,3,3,165007,165007,165010,0,3,0
47113,3,1,165010,165010,165011,0,1,0
47114,2,2,165012,165012,165014,0,2,1
47115,2,2,165014,165014,165016,0,2,0
47116,2,1,165016,165016,165017,0,1,0
47117,6,2,165022,165022,165024,0,2,5
47118,1,2,165023,165024,165026,1,3,0
47119,6,3,165029,165029,165032,0,3,3
47120,2,1,165031,165032,165033,1,2,0
47121,3,1,165034,165034,165035,0,1,1
47122,1,2,165035,165035,165037,0,2,0
47123,3,3,165038,165038,165041,0,3,1
47124,2,1,165040,165041,165042,1,2,0
47125,2,3,165042,165042,165045,0,3,0
47126,3,2,165045,165045,165047,0,2,0
47127,3,2,165048,165048,165050,0,2,1
47128,1,2,165049,165050,165052,1,3,0
47129,4,1,165053,165053,165054,0,1,1
47130,6,1,165059,165059,165060,0,1,5
47131,6,3,165065,165065,165068,0,3,5
47132,1,3,165066,165068,165071,2,5,0
47133,6,2,165072,165072,165074,0,2,1
47134,4,1,165076,165076,165077,0,1,2
47135,2,1,165078,165078,165079,0,1,1
47136,3,2,165081,165081,165083,0,2,2
47137,4,3,165085,165085,165088,0,3,2
47138,1,2,165086,165088,165090,2,4,0
47139,5,2,165091,165091,165093,0,2,1
47140,1,1,165092,165093,165094,1,2,0
47141,2,3,165094,165094,165097,0,3,0
47142,1,2,165095,165097,165099,2,4,0
47143,1,1,165096,165099,165100,3,4,0
47144,5,1,165101,165101,165102,0,1,1
47145,4,3,165105,165105,165108,0,3,3
47146,2,3,165107,165108,165111,1,4,0
47147,3,2,165110,165111,165113,1,3,0
47148,1,3,165111,165113,165116,2,5,0
47149,6,1,165117,165117,165118,0,1,1
47150,6,2,165123,165123,165125,0,2,5
47151,6,2,165129,165129,165131,0,2,4
47152,1,1,165130,165131,165132,1,2,0
47153,4,2,165134,165134,165136,0,2,2
47154,6,1,165140,165140,165141,0,1,4
47155,6,2,165146,165146,165148,0,2,5
47156,1,3,165147,165148,165151,1,4,0
47157,3,1,165150,165151,165152,1,2,0
47158,2,1,165152,165152,165153,0,1,0
47159,3,3,165155,165155,165158,0,3,2
47160,4,3,165159,165159,165162,0,3,1
47161,3,3,165162,165162,165165,0,3,0
47162,3,3,165165,165165,165168,0,3,0
47163,3,2,165168,165168,165170,0,2,0
47164,4,2,165172,165172,165174,0,2,2
47165,3,2,165175,165175,165177,0,2,1
47166,5,2,165180,165180,165182,0,2,3
47167,3,1,165183,165183,165184,0,1,1
47168,3,3,165186,165186,165189,0,3,2
47169,5,3,165191,165191,165194,0,3,2
47170,5,1,165196,165196,165197,0,1,2
47171,3,1,165199,165199,165200,0,1,2
47172,5,3,165204,165204,165207,0,3,4
47173,4,3,165208,165208,165211,0,3,1
47174,1,1,165209,165211,165212,2,3,0
47175,1,2,165210,165212,165214,2,4,0
47176,3,1,165213,165214,165215,1,2,0
47177,2,2,165215,165215,165217,0,2,0
47178,3,3,165218,165218,165221,0,3,1
47179,3,3,165221,165221,165224,0,3,0
47180,6,2,165227,165227,165229,0,2,3
47181,1,1,165228,165229,165230,1,2,0
47182,3,2,165231,165231,165233,0,2,1
47183,3,1,165234,165234,165235,0,1,1
47184,5,1,165239,165239,165240,0,1,4
47185,3,2,165242,165242,165244,0,2,2
47186,2,1,165244,165244,165245,0,1,0
47187,1,3,165245,165245,165248,0,3,0
47188,6,1,165251,165251,165252,0,1,3
47189,6,2,165257,165257,165259,0,2,5
47190,2,1,165259,165259,165260,0,1,0
47191,3,3,165262,165262,165265,0,3,2
47192,6,2,165268,165268,165270,0,2,3
47193,6,1,165274,165274,165275,0,1,4
47194,2,2,165276,165276,165278,0,2,1
47195,2,3,165278,165278,165281,0,3,0
47196,1,3,165279,165281,165284,2,5,0
47197,2,2,165281,165284,165286,3,5,0
47198,4,2,165285,165286,165288,1,3,0
47199,5,2,165290,165290,165292,0,2,2
47200,2,2,165292,165292,165294,0,2,0
47201,5,1,165297,165297,165298,0,1,3
47202,2,1,165299,165299,165300,0,1,1
47203,4,1,165303,165303,165304,0,1,3
47204,5,3,165308,165308,165311,0,3,4
47205,2,1,165310,165311,165312,1,2,0
47206,3,3,165313,165313,165316,0,3,1
47207,1,1,165314,165316,165317,2,3,0
47208,4,3,165318,165318,165321,0,3,1
47209,4,3,165322,165322,165325,0,3,1
47210,5,2,165327,165327,165329,0,2,2
47211,3,3,165330,165330,165333,0,3,1
47212,6,3,165336,165336,165339,0,3,3
47213,4,1,165340,165340,165341,0,1,1
47214,4,3,165344,165344,165347,0,3,3
47215,1,1,165345,165347,165348,2,3,0
47216,3,1,165348,165348,165349,0,1,0
47217,5,3,165353,165353,165356,0,3,4
47218,5,1,165358,165358,165359,0,1,2
47219,2,2,165360,165360,165362,0,2,1
47220,1,2,165361,165362,165364,1,3,0
47221,5,3,165366,165366,165369,0,3,2
47222,6,2,165372,165372,165374,0,2,3
47223,4,3,165376,165376,165379,0,3,2
47224,6,3,165382,165382,165385,0,3,3
47225,2,1,165384,165385,165386,1,2,0
47226,4,1,165388,165388,165389,0,1,2
47227,3,1,165391,165391,165392,0,1,2
47228,4,1,165395,165395,165396,0,1,3
47229,1,2,165396,165396,165398,0,2,0
47230,6,1,165402,165402,165403,0,1,4
47231,4,2,165406,165406,165408,0,2,3
47232,2,3,165408,165408,165411,0,3,0
47233,2,1,165410,165411,165412,1,2,0
47234,3,1,165413,165413,165414,0,1,1
47235,2,3,165415,165415,165418,0,3,1
47236,2,2,165417,165418,165420,1,3,0
47237,4,1,165421,165421,165422,0,1,1
47238,2,2,165423,165423,165425,0,2,1
47239,4,3,165427,165427,165430,0,3,2
47240,5,1,165432,165432,165433,0,1,2
47241,4,1,165436,165436,165437,0,1,3
47242,4,2,165440,165440,165442,0,2,3
47243,6,1,165446,165446,165447,0,1,4
47244,5,3,165451,165451,165454,0,3,4
47245,4,2,165455,165455,165457,0,2,1
47246,6,3,165461,165461,165464,0,3,4
47247,2,3,165463,165464,165467,1,4,0
47248,1,3,165464,165467,165470,3,6,0
47249,2,3,165466,165470,165473,4,7,0
47250,6,3,165472,165473,165476,1,4,0
47251,2,2,165474,165476,165478,2,4,0
47252,1,2,165475,165478,165480,3,5,0
47253,1,1,165476,165480,165481,4,5,0
47254,2,3,165478,165481,165484,3,6,0
47255,4,3,165482,165484,165487,2,5,0
47256,3,1,165485,165487,165488,2,3,0
47257,3,3,165488,165488,165491,0,3,0
47258,3,2,165491,165491,165493,0,2,0
47259,4,1,165495,165495,165496,0,1,2
47260,4,1,165499,165499,165500,0,1,3
47261,6,1,165505,165505,165506,0,1,5
47262,2,3,165507,165507,165510,0,3,1
47263,4,3,165511,165511,165514,0,3,1
47264,2,3,165513,165514,165517,1,4,0
47265,2,2,165515,165517,165519,2,4,0
47266,5,1,165520,165520,165521,0,1,1
47267,6,1,165526,165526,165527,0,1,5
47268,3,3,165529,165529,165532,0,3,2
47269,1,3,165530,165532,165535,2,5,0
47270,1,1,165531,165535,165536,4,5,0
47271,2,3,165533,165536,165539,3,6,0
47272,1,2,165534,165539,165541,5,7,0
47273,4,3,165538,165541,165544,3,6,0
47274,5,3,165543,165544,165547,1,4,0
47275,5,1,165548,165548,165549,0,1,1
47276,3,3,165551,165551,165554,0,3,2
47277,1,3,165552,165554,165557,2,5,0
47278,1,3,165553,165557,165560,4,7,0
47279,4,2,165557,165560,165562,3,5,0
47280,3,3,165560,165562,165565,2,5,0
47281,4,3,165564,165565,165568,1,4,0
47282,4,3,165568,165568,165571,0,3,0
47283,1,1,165569,165571,165572,2,3,0
47284,5,2,165574,165574,165576,0,2,2
47285,1,2,165575,165576,165578,1,3,0
47286,2,1,165577,165578,165579,1,2,0
47287,5,3,165582,165582,165585,0,3,3
47288,1,3,165583,165585,165588,2,5,0
47289,2,3,165585,165588,165591,3,6,0
47290,4,1,165589,165591,165592,2,3,0
47291,4,3,165593,165593,165596,0,3,1
47292,2,2,165595,165596,165598,1,3,0
47293,6,2,165601,165601,165603,0,2,3
47294,2,1,165603,165603,165604,0,1,0
47295,1,3,165604,165604,165607,0,3,0
47296,2,2,165606,165607,165609,1,3,0
47297,4,1,165610,165610,165611,0,1,1
47298,6,2,165616,165616,165618,0,2,5
47299,2,1,165618,165618,165619,0,1,0
47300,5,3,165623,165623,165626,0,3,4
47301,5,2,165628,165628,165630,0,2,2
47302,2,1,165630,165630,165631,0,1,0
47303,4,2,165634,165634,165636,0,2,3
47304,6,2,165640,165640,165642,0,2,4
47305,3,3,165643,165643,165646,0,3,1
47306,4,1,165647,165647,165648,0,1,1
47307,3,2,165650,165650,165652,0,2,2
47308,3,3,165653,165653,165656,0,3,1
47309,1,2,165654,165656,165658,2,4,0
47310,3,3,165657,165658,165661,1,4,0
47311,6,2,165663,165663,165665,0,2,2
47312,4,3,165667,165667,165670,0,3,2
47313,2,2,165669,165670,165672,1,3,0
47314,3,2,165672,165672,165674,0,2,0
47315,3,2,165675,165675,165677,0,2,1
47316,2,1,165677,165677,165678,0,1,0
47317,4,3,165681,165681,165684,0,3,3
47318,3,1,165684,165684,165685,0,1,0
47319,6,3,165690,165690,165693,0,3,5
47320,1,3,165691,165693,165696,2,5,0
47321,2,1,165693,165696,165697,3,4,0
47322,1,3,165694,165697,165700,3,6,0
47323,3,3,165697,165700,165703,3,6,0
47324,4,2,165701,165703,165705,2,4,0
47325,2,2,165703,165705,165707,2,4,0
47326,6,2,165709,165709,165711,0,2,2
47327,1,3,165710,165711,165714,1,4,0
47328,6,1,165716,165716,165717,0,1,2
47329,2,3,165718,165718,165721,0,3,1
47330,3,2,165721,165721,165723,0,2,0
47331,1,1,165722,165723,165724,1,2,0
47332,5,1,165727,165727,165728,0,1,3
47333,3,2,165730,165730,165732,0,2,2
47334,3,3,165733,165733,165736,0,3,1
47335,3,3,165736,165736,165739,0,3,0
47336,6,2,165742,165742,165744,0,2,3
47337,3,1,165745,165745,165746,0,1,1
47338,3,2,165748,165748,165750,0,2,2
47339,2,1,165750,165750,165751,0,1,0
47340,5,1,165755,165755,165756,0,1,4
47341,4,3,165759,165759,165762,0,3,3
47342,1,2,165760,165762,165764,2,4,0
47343,1,2,165761,165764,165766,3,5,0
47344,6,1,165767,165767,165768,0,1,1
47345,3,1,165770,165770,165771,0,1,2
47346,2,3,165772,165772,165775,0,3,1
47347,6,1,165778,165778,165779,0,1,3
47348,5,1,165783,165783,165784,0,1,4
47349,3,1,165786,165786,165787,0,1,2
47350,5,2,165791,165791,165793,0,2,4
47351,1,1,165792,165793,165794,1,2,0
47352,3,2,165795,165795,165797,0,2,1
47353,3,3,165798,165798,165801,0,3,1
47354,2,3,165800,165801,165804,1,4,0
47355,5,3,165805,165805,165808,0,3,1
47356,6,1,165811,165811,165812,0,1,3
47357,6,1,165817,165817,165818,0,1,5
47358,3,3,165820,165820,165823,0,3,2
47359,6,2,165826,165826,165828,0,2,3
47360,4,3,165830,165830,165833,0,3,2
47361,6,1,165836,165836,165837,0,1,3
47362,1,3,165837,165837,165840,0,3,0
47363,3,2,165840,165840,165842,0,2,0
47364,6,1,165846,165846,165847,0,1,4
47365,3,2,165849,165849,165851,0,2,2
47366,6,2,165855,165855,165857,0,2,4
47367,1,1,165856,165857,165858,1,2,0
47368,3,3,165859,165859,165862,0,3,1
47369,2,1,165861,165862,165863,1,2,0
47370,5,2,165866,165866,165868,0,2,3
47371,5,3,165871,165871,165874,0,3,3
47372,3,3,165874,165874,165877,0,3,0
47373,3,1,165877,165877,165878,0,1,0
47374,6,3,165883,165883,165886,0,3,5
47375,2,1,165885,165886,165887,1,2,0
47376,5,3,165890,165890,165893,0,3,3
47377,2,1,165892,165893,165894,1,2,0
47378,1,2,165893,165894,165896,1,3,0
47379,2,2,165895,165896,165898,1,3,0
47380,3,2,165898,165898,165900,0,2,0
47381,1,2,165899,165900,165902,1,3,0
47382,4,3,165903,165903,165906,0,3,1
47383,1,2,165904,165906,165908,2,4,0
47384,1,1,165905,165908,165909,3,4,0
47385,3,2,165908,165909,165911,1,3,0
47386,6,1,165914,165914,165915,0,1,3
47387,2,1,165916,165916,165917,0,1,1
47388,1,2,165917,165917,165919,0,2,0
47389,6,3,165923,165923,165926,0,3,4
47390,5,1,165928,165928,165929,0,1,2
47391,6,1,165934,165934,165935,0,1,5
47392,6,1,165940,165940,165941,0,1,5
47393,1,2,165941,165941,165943,0,2,0
47394,6,3,165947,165947,165950,0,3,4
47395,1,3,165948,165950,165953,2,5,0
47396,3,3,165951,165953,165956,2,5,0
47397,5,3,165956,165956,165959,0,3,0
47398,5,1,165961,165961,165962,0,1,2
47399,4,3,165965,165965,165968,0,3,3
47400,5,1,165970,165970,165971,0,1,2
47401,5,3,165975,165975,165978,0,3,4
47402,4,3,165979,165979,165982,0,3,1
47403,2,3,165981,165982,165985,1,4,0
47404,6,3,165987,165987,165990,0,3,2
47405,1,3,165988,165990,165993,2,5,0
47406,1,2,165989,165993,165995,4,6,0
47407,1,2,165990,165995,165997,5,7,0
47408,5,2,165995,165997,165999,2,4,0
47409,2,3,165997,165999,166002,2,5,0
47410,5,3,166002,166002,166005,0,3,0
47411,3,3,166005,166005,166008,0,3,0
47412,6,3,166011,166011,166014,0,3,3
47413,6,2,166017,166017,166019,0,2,3
47414,4,3,166021,166021,166024,0,3,2
47415,5,1,166026,166026,166027,0,1,2
47416,2,2,166028,166028,166030,0,2,1
47417,2,1,166030,166030,166031,0,1,0
47418,5,3,166035,166035,166038,0,3,4
47419,3,1,166038,166038,166039,0,1,0
47420,5,1,166043,166043,166044,0,1,4
47421,6,3,166049,166049,166052,0,3,5
47422,5,2,166054,166054,166056,0,2,2
47423,4,3,166058,166058,166061,0,3,2
47424,6,1,166064,166064,166065,0,1,3
47425,1,2,166065,166065,166067,0,2,0
47426,6,3,166071,166071,166074,0,3,4
47427,1,1,166072,166074,166075,2,3,0
47428,5,1,166077,166077,166078,0,1,2
47429,3,2,166080,166080,166082,0,2,2
47430,4,1,166084,166084,166085,0,1,2
47431,5,1,166089,166089,166090,0,1,4
47432,3,3,166092,166092,166095,0,3,2
47433,6,1,166098,166098,166099,0,1,3
47434,2,2,166100,166100,166102,0,2,1
47435,6,2,166106,166106,166108,0,2,4
47436,1,3,166107,166108,166111,1,4,0
47437,6,1,166113,166113,166114,0,1,2
47438,4,1,166117,166117,166118,0,1,3
47439,6,3,166123,166123,166126,0,3,5
47440,2,3,166125,166126,166129,1,4,0
47441,4,1,166129,166129,166130,0,1,0
47442,3,3,166132,166132,166135,0,3,2
47443,3,2,166135,166135,166137,0,2,0
47444,4,3,166139,166139,166142,0,3,2
47445,3,3,166142,166142,166145,0,3,0
47446,3,3,166145,166145,166148,0,3,0
47447,1,2,166146,166148,166150,2,4,0
47448,1,3,166147,166150,166153,3,6,0
47449,1,1,166148,166153,166154,5,6,0
47450,6,1,166154,166154,166155,0,1,0
47451,2,1,166156,166156,166157,0,1,1
47452,3,1,166159,166159,166160,0,1,2
47453,1,3,166160,166160,166163,0,3,0
47454,3,3,166163,166163,166166,0,3,0
47455,3,2,166166,166166,166168,0,2,0
47456,3,2,166169,166169,166171,0,2,1
47457,2,1,166171,166171,166172,0,1,0
47458,1,3,166172,166172,166175,0,3,0
47459,1,2,166173,166175,166177,2,4,0
47460,3,1,166176,166177,166178,1,2,0
47461,4,2,166180,166180,166182,0,2,2
47462,5,3,166185,166185,166188,0,3,3
47463,1,3,166186,166188,166191,2,5,0
47464,5,2,166191,166191,166193,0,2,0
47465,2,3,166193,166193,166196,0,3,0
47466,5,1,166198,166198,166199,0,1,2
47467,2,1,166200,166200,166201,0,1,1
47468,2,2,166202,166202,166204,0,2,1
47469,1,2,166203,166204,166206,1,3,0
47470,3,3,166206,166206,166209,0,3,0
47471,6,2,166212,166212,166214,0,2,3
47472,2,2,166214,166214,166216,0,2,0
47473,6,1,166220,166220,166221,0,1,4
47474,1,1,166221,166221,166222,0,1,0
47475,3,1,166224,166224,166225,0,1,2
47476,2,2,166226,166226,166228,0,2,1
47477,5,1,166231,166231,166232,0,1,3
47478,2,3,166233,166233,166236,0,3,1
47479,1,1,166234,166236,166237,2,3,0
47480,2,3,166236,166237,166240,1,4,0
47481,6,1,166242,166242,166243,0,1,2
47482,2,2,166244,166244,166246,0,2,1
47483,2,2,166246,166246,166248,0,2,0
47484,4,2,166250,166250,166252,0,2,2
47485,4,2,166254,166254,166256,0,2,2
47486,1,1,166255,166256,166257,1,2,0
47487,4,1,166259,166259,166260,0,1,2
47488,1,3,166260,166260,166263,0,3,0
47489,3,2,166263,166263,166265,0,2,0
47490,5,3,166268,166268,166271,0,3,3
47491,4,1,166272,166272,166273,0,1,1
47492,3,2,166275,166275,166277,0,2,2
47493,4,2,166279,166279,166281,0,2,2
47494,2,2,166281,166281,166283,0,2,0
47495,2,1,166283,166283,166284,0,1,0
47496,1,1,166284,166284,166285,0,1,0
47497,6,3,166290,166290,166293,0,3,5
47498,6,2,166296,166296,166298,0,2,3
47499,2,1,166298,166298,166299,0,1,0
47500,1,3,166299,166299,166302,0,3,0
47501,3,1,166302,166302,166303,0,1,0
47502,5,3,166307,166307,166310,0,3,4
47503,3,1,166310,166310,166311,0,1,0
47504,2,3,166312,166312,166315,0,3,1
47505,1,2,166313,166315,166317,2,4,0
47506,6,1,166319,166319,166320,0,1,2
47507,2,2,166321,166321,166323,0,2,1
47508,1,3,166322,166323,166326,1,4,0
47509,6,3,166328,166328,166331,0,3,2
47510,1,1,166329,166331,166332,2,3,0
47511,4,3,166333,166333,166336,0,3,1
47512,6,1,166339,166339,166340,0,1,3
47513,3,2,166342,166342,166344,0,2,2
47514,6,1,166348,166348,166349,0,1,4
47515,5,1,166353,166353,166354,0,1,4
47516,1,1,166354,166354,166355,0,1,0
47517,4,2,166358,166358,166360,0,2,3
47518,4,2,166362,166362,166364,0,2,2
47519,1,1,166363,166364,166365,1,2,0
47520,5,3,166368,166368,166371,0,3,3
47521,2,1,166370,166371,166372,1,2,0
47522,3,3,166373,166373,166376,0,3,1
47523,6,2,166379,166379,166381,0,2,3
47524,3,3,166382,166382,166385,0,3,1
47525,6,3,166388,166388,166391,0,3,3
47526,5,3,166393,166393,166396,0,3,2
47527,1,2,166394,166396,166398,2,4,0
47528,6,1,166400,166400,166401,0,1,2
47529,6,3,166406,166406,166409,0,3,5
47530,5,1,166411,166411,166412,0,1,2
47531,1,1,166412,166412,166413,0,1,0
47532,6,1,166418,166418,166419,0,1,5
47533,2,1,166420,166420,166421,0,1,1
47534,2,1,166422,166422,166423,0,1,1
47535,6,3,166428,166428,166431,0,3,5
47536,6,2,166434,166434,166436,0,2,3
47537,2,3,166436,166436,166439,0,3,0
47538,6,3,166442,166442,166445,0,3,3
47539,6,3,166448,166448,166451,0,3,3
47540,1,2,166449,166451,166453,2,4,0
47541,3,1,166452,166453,166454,1,2,0
47542,6,2,166458,166458,166460,0,2,4
47543,1,3,166459,166460,166463,1,4,0
47544,1,2,166460,166463,166465,3,5,0
47545,5,3,166465,166465,166468,0,3,0
47546,2,3,166467,166468,166471,1,4,0
47547,4,1,166471,166471,166472,0,1,0
47548,6,2,166477,166477,166479,0,2,5
47549,2,3,166479,166479,166482,0,3,0
47550,3,3,166482,166482,166485,0,3,0
47551,4,1,166486,166486,166487,0,1,1
47552,5,3,166491,166491,166494,0,3,4
47553,6,2,166497,166497,166499,0,2,3
47554,1,3,166498,166499,166502,1,4,0
47555,3,1,166501,166502,166503,1,2,0
47556,5,2,166506,166506,166508,0,2,3
47557,4,2,166510,166510,166512,0,2,2
47558,3,1,166513,166513,166514,0,1,1
47559,3,2,166516,166516,166518,0,2,2
47560,2,1,166518,166518,166519,0,1,0
47561,6,3,166524,166524,166527,0,3,5
47562,5,1,166529,166529,166530,0,1,2
47563,2,3,166531,166531,166534,0,3,1
47564,4,1,166535,166535,166536,0,1,1
47565,3,1,166538,166538,166539,0,1,2
47566,5,2,166543,166543,166545,0,2,4
47567,4,2,166547,166547,166549,0,2,2
47568,5,3,166552,166552,166555,0,3,3
47569,6,3,166558,166558,166561,0,3,3
47570,3,1,166561,166561,166562,0,1,0
47571,4,2,166565,166565,166567,0,2,3
47572,6,2,166571,166571,166573,0,2,4
47573,3,1,166574,166574,166575,0,1,1
47574,1,3,166575,166575,166578,0,3,0
47575,1,3,166576,166578,166581,2,5,0
47576,1,1,166577,166581,166582,4,5,0
47577,6,1,166583,166583,166584,0,1,1
47578,1,1,166584,166584,166585,0,1,0
47579,2,1,166586,166586,166587,0,1,1
47580,2,2,166588,166588,166590,0,2,1
47581,1,2,166589,166590,166592,1,3,0
47582,6,2,166595,166595,166597,0,2,3
47583,6,3,166601,166601,166604,0,3,4
47584,5,3,166606,166606,166609,0,3,2
47585,2,2,166608,166609,166611,1,3,0
47586,1,2,166609,166611,166613,2,4,0
47587,4,1,166613,166613,166614,0,1,0
47588,4,3,166617,166617,166620,0,3,3
47589,5,2,166622,166622,166624,0,2,2
47590,6,3,166628,166628,166631,0,3,4
47591,1,2,166629,166631,166633,2,4,0
47592,3,3,166632,166633,166636,1,4,0
47593,3,3,166635,166636,166639,1,4,0
47594,6,3,166641,166641,166644,0,3,2
47595,6,2,166647,166647,166649,0,2,3
47596,6,2,166653,166653,166655,0,2,4
47597,3,1,166656,166656,166657,0,1,1
47598,2,3,166658,166658,166661,0,3,1
47599,4,3,166662,166662,166665,0,3,1
47600,4,2,166666,166666,166668,0,2,1
47601,4,3,166670,166670,166673,0,3,2
47602,3,1,166673,166673,166674,0,1,0
47603,5,1,166678,166678,166679,0,1,4
47604,2,3,166680,166680,166683,0,3,1
47605,6,3,166686,166686,166689,0,3,3
47606,4,2,166690,166690,166692,0,2,1
47607,4,2,166694,166694,166696,0,2,2
47608,4,1,166698,166698,166699,0,1,2
47609,5,1,166703,166703,166704,0,1,4
47610,1,2,166704,166704,166706,0,2,0
47611,5,3,166709,166709,166712,0,3,3
47612,6,3,166715,166715,166718,0,3,3
47613,5,1,166720,166720,166721,0,1,2
47614,5,2,166725,166725,166727,0,2,4
47615,5,1,166730,166730,166731,0,1,3
47616,4,3,166734,166734,166737,0,3,3
47617,5,3,166739,166739,166742,0,3,2
47618,4,2,166743,166743,166745,0,2,1
47619,4,2,166747,166747,166749,0,2,2
47620,5,3,166752,166752,166755,0,3,3
47621,2,3,166754,166755,166758,1,4,0
47622,4,2,166758,166758,166760,0,2,0
47623,4,3,166762,166762,166765,0,3,2
47624,4,1,166766,166766,166767,0,1,1
47625,4,1,166770,166770,166771,0,1,3
47626,1,1,166771,166771,166772,0,1,0
47627,2,2,166773,166773,166775,0,2,1
47628,4,1,166777,166777,166778,0,1,2
47629,4,1,166781,166781,166782,0,1,3
47630,2,3,166783,166783,166786,0,3,1
47631,3,1,166786,166786,166787,0,1,0
47632,4,2,166790,166790,166792,0,2,3
47633,2,1,166792,166792,166793,0,1,0
47634,3,3,166795,166795,166798,0,3,2
47635,6,2,166801,166801,166803,0,2,3
47636,5,1,166806,166806,166807,0,1,3
47637,6,2,166812,166812,166814,0,2,5
47638,5,3,166817,166817,166820,0,3,3
47639,2,3,166819,166820,166823,1,4,0
47640,1,1,166820,166823,166824,3,4,0
47641,4,3,166824,166824,166827,0,3,0
47642,3,3,166827,166827,166830,0,3,0
47643,4,1,166831,166831,166832,0,1,1
47644,1,2,166832,166832,166834,0,2,0
47645,5,2,166837,166837,166839,0,2,3
47646,4,3,166841,166841,166844,0,3,2
47647,4,3,166845,166845,166848,0,3,1
47648,6,2,166851,166851,166853,0,2,3
47649,2,3,166853,166853,166856,0,3,0
47650,6,1,166859,166859,166860,0,1,3
47651,4,1,166863,166863,166864,0,1,3
47652,5,2,166868,166868,166870,0,2,4
47653,6,3,166874,166874,166877,0,3,4
47654,1,2,166875,166877,166879,2,4,0
47655,6,2,166881,166881,166883,0,2,2
47656,2,2,166883,166883,166885,0,2,0
47657,2,1,166885,166885,166886,0,1,0
47658,1,3,166886,166886,166889,0,3,0
47659,3,3,166889,166889,166892,0,3,0
47660,6,1,166895,166895,166896,0,1,3
47661,5,1,166900,166900,166901,0,1,4
47662,3,1,166903,166903,166904,0,1,2
47663,2,2,166905,166905,166907,0,2,1
47664,6,2,166911,166911,166913,0,2,4
47665,5,1,166916,166916,166917,0,1,3
47666,1,2,166917,166917,166919,0,2,0
47667,3,3,166920,166920,166923,0,3,1
47668,1,2,166921,166923,166925,2,4,0
47669,1,1,166922,166925,166926,3,4,0
47670,1,2,166923,166926,166928,3,5,0
47671,4,3,166927,166928,166931,1,4,0
47672,5,1,166932,166932,166933,0,1,1
47673,2,1,166934,166934,166935,0,1,1
47674,6,1,166940,166940,166941,0,1,5
47675,6,2,166946,166946,166948,0,2,5
47676,5,2,166951,166951,166953,0,2,3
47677,1,3,166952,166953,166956,1,4,0
47678,3,2,166955,166956,166958,1,3,0
47679,5,2,166960,166960,166962,0,2,2
47680,1,2,166961,166962,166964,1,3,0
47681,1,3,166962,166964,166967,2,5,0
47682,1,3,166963,166967,166970,4,7,0
47683,4,2,166967,166970,166972,3,5,0
47684,5,2,166972,166972,166974,0,2,0
47685,3,3,166975,166975,166978,0,3,1
47686,4,2,166979,166979,166981,0,2,1
47687,1,1,166980,166981,166982,1,2,0
47688,3,1,166983,166983,166984,0,1,1
47689,3,3,166986,166986,166989,0,3,2
47690,2,1,166988,166989,166990,1,2,0
47691,3,1,166991,166991,166992,0,1,1
47692,4,1,166995,166995,166996,0,1,3
47693,3,1,166998,166998,166999,0,1,2
47694,2,3,167000,167000,167003,0,3,1
47695,6,2,167006,167006,167008,0,2,3
47696,6,3,167012,167012,167015,0,3,4
47697,3,2,167015,167015,167017,0,2,0
47698,3,3,167018,167018,167021,0,3,1
47699,3,1,167021,167021,167022,0,1,0
47700,2,1,167023,167023,167024,0,1,1
47701,6,2,167029,167029,167031,0,2,5
47702,6,3,167035,167035,167038,0,3,4
47703,6,3,167041,167041,167044,0,3,3
47704,1,3,167042,167044,167047,2,5,0
47705,6,1,167048,167048,167049,0,1,1
47706,1,1,167049,167049,167050,0,1,0
47707,4,2,167053,167053,167055,0,2,3
47708,2,2,167055,167055,167057,0,2,0
47709,4,2,167059,167059,167061,0,2,2
47710,3,3,167062,167062,167065,0,3,1
47711,4,2,167066,167066,167068,0,2,1
47712,1,2,167067,167068,167070,1,3,0
47713,2,2,167069,167070,167072,1,3,0
47714,5,1,167074,167074,167075,0,1,2
47715,4,2,167078,167078,167080,0,2,3
47716,2,2,167080,167080,167082,0,2,0
47717,4,1,167084,167084,167085,0,1,2
47718,1,2,167085,167085,167087,0,2,0
47719,3,2,167088,167088,167090,0,2,1
47720,2,3,167090,167090,167093,0,3,0
47721,3,3,167093,167093,167096,0,3,0
47722,1,1,167094,167096,167097,2,3,0
47723,3,3,167097,167097,167100,0,3,0
47724,5,1,167102,167102,167103,0,1,2
47725,5,3,167107,167107,167110,0,3,4
47726,3,2,167110,167110,167112,0,2,0
47727,3,3,167113,167113,167116,0,3,1
47728,6,2,167119,167119,167121,0,2,3
47729,3,2,167122,167122,167124,0,2,1
47730,1,2,167123,167124,167126,1,3,0
47731,3,2,167126,167126,167128,0,2,0
47732,4,1,167130,167130,167131,0,1,2
47733,3,3,167133,167133,167136,0,3,2
47734,3,2,167136,167136,167138,0,2,0
47735,2,3,167138,167138,167141,0,3,0
47736,2,2,167140,167141,167143,1,3,0
47737,6,3,167146,167146,167149,0,3,3
47738,3,1,167149,167149,167150,0,1,0
47739,3,3,167152,167152,167155,0,3,2
47740,4,2,167156,167156,167158,0,2,1
47741,3,1,167159,167159,167160,0,1,1
47742,4,1,167163,167163,167164,0,1,3
47743,5,1,167168,167168,167169,0,1,4
47744,6,2,167174,167174,167176,0,2,5
47745,1,2,167175,167176,167178,1,3,0
47746,5,3,167180,167180,167183,0,3,2
47747,6,2,167186,167186,167188,0,2,3
47748,2,2,167188,167188,167190,0,2,0
47749,4,1,167192,167192,167193,0,1,2
47750,4,1,167196,167196,167197,0,1,3
47751,5,1,167201,167201,167202,0,1,4
47752,6,1,167207,167207,167208,0,1,5
47753,6,1,167213,167213,167214,0,1,5
47754,1,3,167214,167214,167217,0,3,0
47755,1,2,167215,167217,167219,2,4,0
47756,3,1,167218,167219,167220,1,2,0
47757,4,1,167222,167222,167223,0,1,2
47758,6,3,167228,167228,167231,0,3,5
47759,5,1,167233,167233,167234,0,1,2
47760,1,1,167234,167234,167235,0,1,0
47761,6,1,167240,167240,167241,0,1,5
47762,3,2,167243,167243,167245,0,2,2
47763,6,2,167249,167249,167251,0,2,4
47764,3,1,167252,167252,167253,0,1,1
47765,5,2,167257,167257,167259,0,2,4
47766,1,1,167258,167259,167260,1,2,0
47767,4,1,167262,167262,167263,0,1,2
47768,2,3,167264,167264,167267,0,3,1
47769,2,1,167266,167267,167268,1,2,0
47770,5,1,167271,167271,167272,0,1,3
47771,1,3,167272,167272,167275,0,3,0
47772,4,3,167276,167276,167279,0,3,1
47773,6,2,167282,167282,167284,0,2,3
47774,5,2,167287,167287,167289,0,2,3
47775,4,2,167291,167291,167293,0,2,2
47776,1,2,167292,167293,167295,1,3,0
47777,6,2,167298,167298,167300,0,2,3
47778,3,2,167301,167301,167303,0,2,1
47779,1,2,167302,167303,167305,1,3,0
47780,6,1,167308,167308,167309,0,1,3
47781,6,2,167314,167314,167316,0,2,5
47782,2,2,167316,167316,167318,0,2,0
47783,5,2,167321,167321,167323,0,2,3
47784,5,3,167326,167326,167329,0,3,3
47785,5,1,167331,167331,167332,0,1,2
47786,2,2,167333,167333,167335,0,2,1
47787,6,2,167339,167339,167341,0,2,4
47788,6,1,167345,167345,167346,0,1,4
47789,6,2,167351,167351,167353,0,2,5
47790,4,2,167355,167355,167357,0,2,2
47791,1,2,167356,167357,167359,1,3,0
47792,2,1,167358,167359,167360,1,2,0
47793,1,2,167359,167360,167362,1,3,0
47794,6,2,167365,167365,167367,0,2,3
47795,6,3,167371,167371,167374,0,3,4
47796,5,1,167376,167376,167377,0,1,2
47797,6,1,167382,167382,167383,0,1,5
47798,1,3,167383,167383,167386,0,3,0
47799,3,3,167386,167386,167389,0,3,0
47800,6,3,167392,167392,167395,0,3,3
47801,2,1,167394,167395,167396,1,2,0
47802,6,1,167400,167400,167401,0,1,4
47803,5,2,167405,167405,167407,0,2,4
47804,6,2,167411,167411,167413,0,2,4
47805,2,2,167413,167413,167415,0,2,0
47806,5,1,167418,167418,167419,0,1,3
47807,5,3,167423,167423,167426,0,3,4
47808,4,1,167427,167427,167428,0,1,1
47809,3,2,167430,167430,167432,0,2,2
47810,2,3,167432,167432,167435,0,3,0
47811,6,1,167438,167438,167439,0,1,3
47812,5,2,167443,167443,167445,0,2,4
47813,4,3,167447,167447,167450,0,3,2
47814,4,1,167451,167451,167452,0,1,1
47815,1,2,167452,167452,167454,0,2,0
47816,1,1,167453,167454,167455,1,2,0
47817,1,2,167454,167455,167457,1,3,0
47818,3,3,167457,167457,167460,0,3,0
47819,5,3,167462,167462,167465,0,3,2
47820,2,2,167464,167465,167467,1,3,0
47821,3,1,167467,167467,167468,0,1,0
47822,4,2,167471,167471,167473,0,2,3
47823,4,3,167475,167475,167478,0,3,2
47824,2,2,167477,167478,167480,1,3,0
47825,6,3,167483,167483,167486,0,3,3
47826,5,2,167488,167488,167490,0,2,2
47827,1,2,167489,167490,167492,1,3,0
47828,2,2,167491,167492,167494,1,3,0
47829,6,3,167497,167497,167500,0,3,3
47830,3,3,167500,167500,167503,0,3,0
47831,2,2,167502,167503,167505,1,3,0
47832,3,1,167505,167505,167506,0,1,0
47833,2,1,167507,167507,167508,0,1,1
47834,6,1,167513,167513,167514,0,1,5
47835,4,3,167517,167517,167520,0,3,3
47836,1,3,167518,167520,167523,2,5,0
47837,2,2,167520,167523,167525,3,5,0
47838,3,2,167523,167525,167527,2,4,0
47839,3,3,167526,167527,167530,1,4,0
47840,5,1,167531,167531,167532,0,1,1
47841,3,3,167534,167534,167537,0,3,2
47842,3,1,167537,167537,167538,0,1,0
47843,5,2,167542,167542,167544,0,2,4
47844,4,3,167546,167546,167549,0,3,2
47845,5,3,167551,167551,167554,0,3,2
47846,3,3,167554,167554,167557,0,3,0
47847,1,3,167555,167557,167560,2,5,0
47848,2,1,167557,167560,167561,3,4,0
47849,5,3,167562,167562,167565,0,3,1
47850,1,3,167563,167565,167568,2,5,0
47851,5,3,167568,167568,167571,0,3,0
47852,2,3,167570,167571,167574,1,4,0
47853,6,3,167576,167576,167579,0,3,2
47854,3,3,167579,167579,167582,0,3,0
47855,2,2,167581,167582,167584,1,3,0
47856,6,2,167587,167587,167589,0,2,3
47857,6,3,167593,167593,167596,0,3,4
47858,3,2,167596,167596,167598,0,2,0
47859,1,1,167597,167598,167599,1,2,0
47860,5,1,167602,167602,167603,0,1,3
47861,5,2,167607,167607,167609,0,2,4
47862,1,3,167608,167609,167612,1,4,0
47863,5,1,167613,167613,167614,0,1,1
47864,4,3,167617,167617,167620,0,3,3
47865,1,2,167618,167620,167622,2,4,0
47866,2,3,167620,167622,167625,2,5,0
47867,1,2,167621,167625,167627,4,6,0
47868,4,2,167625,167627,167629,2,4,0
47869,2,1,167627,167629,167630,2,3,0
47870,5,3,167632,167632,167635,0,3,2
47871,5,2,167637,167637,167639,0,2,2
47872,4,3,167641,167641,167644,0,3,2
47873,1,3,167642,167644,167647,2,5,0
47874,4,2,167646,167647,167649,1,3,0
47875,6,2,167652,167652,167654,0,2,3
47876,5,2,167657,167657,167659,0,2,3
47877,4,1,167661,167661,167662,0,1,2
47878,4,3,167665,167665,167668,0,3,3
47879,1,3,167666,167668,167671,2,5,0
47880,6,2,167672,167672,167674,0,2,1
47881,5,2,167677,167677,167679,0,2,3
47882,3,2,167680,167680,167682,0,2,1
47883,1,1,167681,167682,167683,1,2,0
47884,1,3,167682,167683,167686,1,4,0
47885,1,1,167683,167686,167687,3,4,0
47886,6,2,167689,167689,167691,0,2,2
47887,6,3,167695,167695,167698,0,3,4
47888,5,1,167700,167700,167701,0,1,2
47889,1,2,167701,167701,167703,0,2,0
47890,1,3,167702,167703,167706,1,4,0
47891,4,1,167706,167706,167707,0,1,0
47892,3,2,167709,167709,167711,0,2,2
47893,1,1,167710,167711,167712,1,2,0
47894,4,1,167714,167714,167715,0,1,2
47895,2,1,167716,167716,167717,0,1,1
47896,1,3,167717,167717,167720,0,3,0
47897,3,1,167720,167720,167721,0,1,0
47898,3,2,167723,167723,167725,0,2,2
47899,2,3,167725,167725,167728,0,3,0
47900,1,2,167726,167728,167730,2,4,0
47901,4,2,167730,167730,167732,0,2,0
47902,6,1,167736,167736,167737,0,1,4
47903,2,1,167738,167738,167739,0,1,1
47904,3,1,167741,167741,167742,0,1,2
47905,4,3,167745,167745,167748,0,3,3
47906,1,1,167746,167748,167749,2,3,0
47907,2,1,167748,167749,167750,1,2,0
47908,5,2,167753,167753,167755,0,2,3
47909,1,3,167754,167755,167758,1,4,0
47910,1,1,167755,167758,167759,3,4,0
47911,2,3,167757,167759,167762,2,5,0
47912,4,1,167761,167762,167763,1,2,0
47913,5,1,167766,167766,167767,0,1,3
47914,1,2,167767,167767,167769,0,2,0
47915,1,3,167768,167769,167772,1,4,0
47916,6,3,167774,167774,167777,0,3,2
47917,2,1,167776,167777,167778,1,2,0
47918,3,1,167779,167779,167780,0,1,1
47919,5,1,167784,167784,167785,0,1,4
47920,5,2,167789,167789,167791,0,2,4
47921,5,1,167794,167794,167795,0,1,3
47922,4,3,167798,167798,167801,0,3,3
47923,5,3,167803,167803,167806,0,3,2
47924,5,2,167808,167808,167810,0,2,2
47925,2,1,167810,167810,167811,0,1,0
47926,5,2,167815,167815,167817,0,2,4
47927,5,1,167820,167820,167821,0,1,3
47928,6,1,167826,167826,167827,0,1,5
47929,1,2,167827,167827,167829,0,2,0
47930,3,1,167830,167830,167831,0,1,1
47931,6,1,167836,167836,167837,0,1,5
47932,5,3,167841,167841,167844,0,3,4
47933,5,2,167846,167846,167848,0,2,2
47934,1,1,167847,167848,167849,1,2,0
47935,6,3,167853,167853,167856,0,3,4
47936,3,2,167856,167856,167858,0,2,0
47937,5,1,167861,167861,167862,0,1,3
47938,3,2,167864,167864,167866,0,2,2
47939,1,1,167865,167866,167867,1,2,0
47940,6,2,167871,167871,167873,0,2,4
47941,2,1,167873,167873,167874,0,1,0
47942,6,1,167879,167879,167880,0,1,5
47943,4,1,167883,167883,167884,0,1,3
47944,3,3,167886,167886,167889,0,3,2
47945,5,1,167891,167891,167892,0,1,2
47946,3,3,167894,167894,167897,0,3,2
47947,1,2,167895,167897,167899,2,4,0
47948,5,1,167900,167900,167901,0,1,1
47949,6,1,167906,167906,167907,0,1,5
47950,4,1,167910,167910,167911,0,1,3
47951,5,2,167915,167915,167917,0,2,4
47952,3,3,167918,167918,167921,0,3,1
47953,4,3,167922,167922,167925,0,3,1
47954,4,3,167926,167926,167929,0,3,1
47955,1,1,167927,167929,167930,2,3,0
47956,2,1,167929,167930,167931,1,2,0
47957,5,1,167934,167934,167935,0,1,3
47958,5,2,167939,167939,167941,0,2,4
47959,5,1,167944,167944,167945,0,1,3
47960,6,3,167950,167950,167953,0,3,5
47961,5,1,167955,167955,167956,0,1,2
47962,1,3,167956,167956,167959,0,3,0
47963,4,3,167960,167960,167963,0,3,1
47964,4,2,167964,167964,167966,0,2,1
47965,1,1,167965,167966,167967,1,2,0
47966,6,2,167971,167971,167973,0,2,4
47967,3,2,167974,167974,167976,0,2,1
47968,4,1,167978,167978,167979,0,1,2
47969,2,2,167980,167980,167982,0,2,1
47970,4,1,167984,167984,167985,0,1,2
47971,6,3,167990,167990,167993,0,3,5
47972,2,2,167992,167993,167995,1,3,0
47973,6,3,167998,167998,168001,0,3,3
47974,2,2,168000,168001,168003,1,3,0
47975,1,3,168001,168003,168006,2,5,0
47976,2,3,168003,168006,168009,3,6,0
47977,3,3,168006,168009,168012,3,6,0
47978,6,1,168012,168012,168013,0,1,0
47979,1,1,168013,168013,168014,0,1,0
47980,6,2,168019,168019,168021,0,2,5
47981,6,2,168025,168025,168027,0,2,4
47982,3,3,168028,168028,168031,0,3,1
47983,3,1,168031,168031,168032,0,1,0
47984,6,2,168037,168037,168039,0,2,5
47985,3,3,168040,168040,168043,0,3,1
47986,4,3,168044,168044,168047,0,3,1
47987,2,1,168046,168047,168048,1,2,0
47988,3,1,168049,168049,168050,0,1,1
47989,3,1,168052,168052,168053,0,1,2
47990,4,3,168056,168056,168059,0,3,3
47991,1,2,168057,168059,168061,2,4,0
47992,1,1,168058,168061,168062,3,4,0
47993,3,1,168061,168062,168063,1,2,0
47994,3,2,168064,168064,168066,0,2,1
47995,4,2,168068,168068,168070,0,2,2
47996,1,1,168069,168070,168071,1,2,0
47997,5,3,168074,168074,168077,0,3,3
47998,2,3,168076,168077,168080,1,4,0
47999,3,2,168079,168080,168082,1,3,0
48000,2,3,168081,168082,168085,1,4,0
48001,6,2,168087,168087,168089,0,2,2
48002,6,3,168093,168093,168096,0,3,4
48003,3,1,168096,168096,168097,0,1,0
48004,3,2,168099,168099,168101,0,2,2
48005,2,1,168101,168101,168102,0,1,0
48006,1,2,168102,168102,168104,0,2,0
48007,1,1,168103,168104,168105,1,2,0
48008,6,3,168109,168109,168112,0,3,4
48009,4,3,168113,168113,168116,0,3,1
48010,5,3,168118,168118,168121,0,3,2
48011,2,1,168120,168121,168122,1,2,0
48012,2,2,168122,168122,168124,0,2,0
48013,1,3,168123,168124,168127,1,4,0
48014,1,2,168124,168127,168129,3,5,0
48015,6,2,168130,168130,168132,0,2,1
48016,6,2,168136,168136,168138,0,2,4
48017,2,2,168138,168138,168140,0,2,0
48018,1,1,168139,168140,168141,1,2,0
48019,3,2,168142,168142,168144,0,2,1
48020,6,1,168148,168148,168149,0,1,4
48021,3,1,168151,168151,168152,0,1,2
48022,2,3,168153,168153,168156,0,3,1
48023,4,1,168157,168157,168158,0,1,1
48024,3,2,168160,168160,168162,0,2,2
48025,5,2,168165,168165,168167,0,2,3
48026,6,3,168171,168171,168174,0,3,4
48027,1,1,168172,168174,168175,2,3,0
48028,1,1,168173,168175,168176,2,3,0
48029,2,3,168175,168176,168179,1,4,0
48030,1,1,168176,168179,168180,3,4,0
48031,1,1,168177,168180,168181,3,4,0
48032,1,2,168178,168181,168183,3,5,0
48033,3,1,168181,168183,168184,2,3,0
48034,3,2,168184,168184,168186,0,2,0
48035,6,2,168190,168190,168192,0,2,4
48036,1,3,168191,168192,168195,1,4,0
48037,3,3,168194,168195,168198,1,4,0
48038,5,1,168199,168199,168200,0,1,1
48039,1,1,168200,168200,168201,0,1,0
48040,5,1,168205,168205,168206,0,1,4
48041,6,2,168211,168211,168213,0,2,5
48042,6,2,168217,168217,168219,0,2,4
48043,4,1,168221,168221,168222,0,1,2
48044,3,3,168224,168224,168227,0,3,2
48045,3,2,168227,168227,168229,0,2,0
48046,5,1,168232,168232,168233,0,1,3
48047,6,2,168238,168238,168240,0,2,5
48048,6,3,168244,168244,168247,0,3,4
48049,5,3,168249,168249,168252,0,3,2
48050,3,1,168252,168252,168253,0,1,0
48051,4,2,168256,168256,168258,0,2,3
48052,1,1,168257,168258,168259,1,2,0
48053,5,3,168262,168262,168265,0,3,3
48054,5,1,168267,168267,168268,0,1,2
48055,1,1,168268,168268,168269,0,1,0
48056,2,3,168270,168270,168273,0,3,1
48057,2,2,168272,168273,168275,1,3,0
48058,6,2,168278,168278,168280,0,2,3
48059,6,1,168284,168284,168285,0,1,4
48060,3,3,168287,168287,168290,0,3,2
48061,3,3,168290,168290,168293,0,3,0
48062,2,3,168292,168293,168296,1,4,0
48063,6,1,168298,168298,168299,0,1,2
48064,4,2,168302,168302,168304,0,2,3
48065,1,2,168303,168304,168306,1,3,0
48066,3,3,168306,168306,168309,0,3,0
48067,5,1,168311,168311,168312,0,1,2
48068,3,1,168314,168314,168315,0,1,2
48069,4,3,168318,168318,168321,0,3,3
48070,3,3,168321,168321,168324,0,3,0
48071,3,3,168324,168324,168327,0,3,0
48072,5,3,168329,168329,168332,0,3,2
48073,3,1,168332,168332,168333,0,1,0
48074,2,2,168334,168334,168336,0,2,1
48075,3,3,168337,168337,168340,0,3,1
48076,2,1,168339,168340,168341,1,2,0
48077,4,3,168343,168343,168346,0,3,2
48078,6,3,168349,168349,168352,0,3,3
48079,6,2,168355,168355,168357,0,2,3
48080,4,2,168359,168359,168361,0,2,2
48081,6,1,168365,168365,168366,0,1,4
48082,6,1,168371,168371,168372,0,1,5
48083,1,3,168372,168372,168375,0,3,0
48084,2,3,168374,168375,168378,1,4,0
48085,4,2,168378,168378,168380,0,2,0
48086,6,2,168384,168384,168386,0,2,4
48087,4,3,168388,168388,168391,0,3,2
48088,3,3,168391,168391,168394,0,3,0
48089,5,2,168396,168396,168398,0,2,2
48090,2,2,168398,168398,168400,0,2,0
48091,2,2,168400,168400,168402,0,2,0
48092,6,2,168406,168406,168408,0,2,4
48093,2,1,168408,168408,168409,0,1,0
48094,3,2,168411,168411,168413,0,2,2
48095,6,3,168417,168417,168420,0,3,4
48096,5,3,168422,168422,168425,0,3,2
48097,2,1,168424,168425,168426,1,2,0
48098,3,1,168427,168427,168428,0,1,1
48099,4,2,168431,168431,168433,0,2,3
48100,6,3,168437,168437,168440,0,3,4
48101,4,3,168441,168441,168444,0,3,1
48102,2,1,168443,168444,168445,1,2,0
48103,1,3,168444,168445,168448,1,4,0
48104,2,3,168446,168448,168451,2,5,0
48105,3,3,168449,168451,168454,2,5,0
48106,4,1,168453,168454,168455,1,2,0
48107,6,2,168459,168459,168461,0,2,4
48108,6,2,168465,168465,168467,0,2,4
48109,5,1,168470,168470,168471,0,1,3
48110,1,1,168471,168471,168472,0,1,0
48111,5,1,168476,168476,168477,0,1,4
48112,3,3,168479,168479,168482,0,3,2
48113,6,2,168485,168485,168487,0,2,3
48114,2,1,168487,168487,168488,0,1,0
48115,2,3,168489,168489,168492,0,3,1
48116,5,3,168494,168494,168497,0,3,2
48117,5,2,168499,168499,168501,0,2,2
48118,3,2,168502,168502,168504,0,2,1
48119,5,2,168507,168507,168509,0,2,3
48120,2,3,168509,168509,168512,0,3,0
48121,2,1,168511,168512,168513,1,2,0
48122,3,2,168514,168514,168516,0,2,1
48123,4,2,168518,168518,168520,0,2,2
48124,6,1,168524,168524,168525,0,1,4
48125,2,3,168526,168526,168529,0,3,1
48126,4,3,168530,168530,168533,0,3,1
48127,6,3,168536,168536,168539,0,3,3
48128,2,3,168538,168539,168542,1,4,0
48129,5,2,168543,168543,168545,0,2,1
48130,5,3,168548,168548,168551,0,3,3
48131,5,3,168553,168553,168556,0,3,2
48132,2,1,168555,168556,168557,1,2,0
48133,1,2,168556,168557,168559,1,3,0
48134,3,1,168559,168559,168560,0,1,0
48135,1,2,168560,168560,168562,0,2,0
48136,6,2,168566,168566,168568,0,2,4
48137,2,1,168568,168568,168569,0,1,0
48138,4,2,168572,168572,168574,0,2,3
48139,4,2,168576,168576,168578,0,2,2
48140,3,2,168579,168579,168581,0,2,1
48141,4,2,168583,168583,168585,0,2,2
48142,1,2,168584,168585,168587,1,3,0
48143,4,1,168588,168588,168589,0,1,1
48144,4,2,168592,168592,168594,0,2,3
48145,3,3,168595,168595,168598,0,3,1
48146,1,1,168596,168598,168599,2,3,0
48147,3,2,168599,168599,168601,0,2,0
48148,5,2,168604,168604,168606,0,2,3
48149,1,2,168605,168606,168608,1,3,0
48150,5,1,168610,168610,168611,0,1,2
48151,6,1,168616,168616,168617,0,1,5
48152,1,2,168617,168617,168619,0,2,0
48153,3,1,168620,168620,168621,0,1,1
48154,6,1,168626,168626,168627,0,1,5
48155,5,1,168631,168631,168632,0,1,4
48156,3,3,168634,168634,168637,0,3,2
48157,1,3,168635,168637,168640,2,5,0
48158,5,3,168640,168640,168643,0,3,0
48159,1,3,168641,168643,168646,2,5,0
48160,2,2,168643,168646,168648,3,5,0
48161,4,1,168647,168648,168649,1,2,0
48162,5,3,168652,168652,168655,0,3,3
48163,3,1,168655,168655,168656,0,1,0
48164,5,2,168660,168660,168662,0,2,4
48165,4,2,168664,168664,168666,0,2,2
48166,6,3,168670,168670,168673,0,3,4
48167,4,1,168674,168674,168675,0,1,1
48168,3,2,168677,168677,168679,0,2,2
48169,5,3,168682,168682,168685,0,3,3
48170,5,1,168687,168687,168688,0,1,2
48171,6,2,168693,168693,168695,0,2,5
48172,4,1,168697,168697,168698,0,1,2
48173,3,2,168700,168700,168702,0,2,2
48174,2,2,168702,168702,168704,0,2,0
48175,6,2,168708,168708,168710,0,2,4
48176,6,3,168714,168714,168717,0,3,4
48177,6,2,168720,168720,168722,0,2,3
48178,4,1,168724,168724,168725,0,1,2
48179,1,3,168725,168725,168728,0,3,0
48180,2,1,168727,168728,168729,1,2,0
48181,4,1,168731,168731,168732,0,1,2
48182,2,1,168733,168733,168734,0,1,1
48183,4,1,168737,168737,168738,0,1,3
48184,1,1,168738,168738,168739,0,1,0
48185,6,3,168744,168744,168747,0,3,5
48186,3,3,168747,168747,168750,0,3,0
48187,4,2,168751,168751,168753,0,2,1
48188,5,1,168756,168756,168757,0,1,3
48189,3,1,168759,168759,168760,0,1,2
48190,5,3,168764,168764,168767,0,3,4
48191,6,3,168770,168770,168773,0,3,3
48192,5,1,168775,168775,168776,0,1,2
48193,5,3,168780,168780,168783,0,3,4
48194,3,2,168783,168783,168785,0,2,0
48195,6,1,168789,168789,168790,0,1,4
48196,6,3,168795,168795,168798,0,3,5
48197,4,2,168799,168799,168801,0,2,1
48198,2,3,168801,168801,168804,0,3,0
48199,2,2,168803,168804,168806,1,3,0
48200,2,3,168805,168806,168809,1,4,0
48201,3,1,168808,168809,168810,1,2,0
48202,1,3,168809,168810,168813,1,4,0
48203,6,3,168815,168815,168818,0,3,2
48204,3,1,168818,168818,168819,0,1,0
48205,1,2,168819,168819,168821,0,2,0
48206,4,2,168823,168823,168825,0,2,2
48207,6,2,168829,168829,168831,0,2,4
48208,4,3,168833,168833,168836,0,3,2
48209,5,2,168838,168838,168840,0,2,2
48210,1,2,168839,168840,168842,1,3,0
48211,2,3,168841,168842,168845,1,4,0
48212,1,3,168842,168845,168848,3,6,0
48213,1,2,168843,168848,168850,5,7,0
48214,6,3,168849,168850,168853,1,4,0
48215,1,3,168850,168853,168856,3,6,0
48216,1,1,168851,168856,168857,5,6,0
48217,5,3,168856,168857,168860,1,4,0
48218,3,2,168859,168860,168862,1,3,0
48219,5,3,168864,168864,168867,0,3,2
48220,5,2,168869,168869,168871,0,2,2
48221,1,2,168870,168871,168873,1,3,0
48222,1,1,168871,168873,168874,2,3,0
48223,2,1,168873,168874,168875,1,2,0
48224,4,2,168877,168877,168879,0,2,2
48225,3,1,168880,168880,168881,0,1,1
48226,4,3,168884,168884,168887,0,3,3
48227,6,2,168890,168890,168892,0,2,3
48228,1,1,168891,168892,168893,1,2,0
48229,2,3,168893,168893,168896,0,3,0
48230,3,3,168896,168896,168899,0,3,0
48231,3,2,168899,168899,168901,0,2,0
48232,1,1,168900,168901,168902,1,2,0
48233,4,3,168904,168904,168907,0,3,2
48234,5,3,168909,168909,168912,0,3,2
48235,2,2,168911,168912,168914,1,3,0
48236,6,1,168917,168917,168918,0,1,3
48237,4,2,168921,168921,168923,0,2,3
48238,5,3,168926,168926,168929,0,3,3
48239,5,1,168931,168931,168932,0,1,2
48240,1,2,168932,168932,168934,0,2,0
48241,4,3,168936,168936,168939,0,3,2
48242,5,1,168941,168941,168942,0,1,2
48243,4,2,168945,168945,168947,0,2,3
48244,3,2,168948,168948,168950,0,2,1
48245,2,2,168950,168950,168952,0,2,0
48246,6,3,168956,168956,168959,0,3,4
48247,5,2,168961,168961,168963,0,2,2
48248,5,3,168966,168966,168969,0,3,3
48249,5,3,168971,168971,168974,0,3,2
48250,3,2,168974,168974,168976,0,2,0
48251,5,1,168979,168979,168980,0,1,3
48252,2,3,168981,168981,168984,0,3,1
48253,6,3,168987,168987,168990,0,3,3
48254,5,2,168992,168992,168994,0,2,2
48255,1,1,168993,168994,168995,1,2,0
48256,6,1,168999,168999,169000,0,1,4
48257,3,3,169002,169002,169005,0,3,2
48258,4,2,169006,169006,169008,0,2,1
48259,4,3,169010,169010,169013,0,3,2
48260,2,2,169012,169013,169015,1,3,0
48261,3,2,169015,169015,169017,0,2,0
48262,5,1,169020,169020,169021,0,1,3
48263,6,1,169026,169026,169027,0,1,5
48264,6,2,169032,169032,169034,0,2,5
48265,3,1,169035,169035,169036,0,1,1
48266,6,2,169041,169041,169043,0,2,5
48267,5,2,169046,169046,169048,0,2,3
48268,4,1,169050,169050,169051,0,1,2
48269,6,3,169056,169056,169059,0,3,5
48270,2,1,169058,169059,169060,1,2,0
48271,4,2,169062,169062,169064,0,2,2
48272,6,2,169068,169068,169070,0,2,4
48273,3,2,169071,169071,169073,0,2,1
48274,1,1,169072,169073,169074,1,2,0
48275,1,2,169073,169074,169076,1,3,0
48276,6,1,169079,169079,169080,0,1,3
48277,2,3,169081,169081,169084,0,3,1
48278,1,3,169082,169084,169087,2,5,0
48279,3,2,169085,169087,169089,2,4,0
48280,2,3,169087,169089,169092,2,5,0
48281,5,1,169092,169092,169093,0,1,0
48282,5,2,169097,169097,169099,0,2,4
48283,6,2,169103,169103,169105,0,2,4
48284,4,1,169107,169107,169108,0,1,2
48285,5,3,169112,169112,169115,0,3,4
48286,2,3,169114,169115,169118,1,4,0
48287,1,2,169115,169118,169120,3,5,0
48288,6,2,169121,169121,169123,0,2,1
48289,4,2,169125,169125,169127,0,2,2
48290,1,3,169126,169127,169130,1,4,0
48291,5,1,169131,169131,169132,0,1,1
48292,3,3,169134,169134,169137,0,3,2
48293,5,1,169139,169139,169140,0,1,2
48294,1,1,169140,169140,169141,0,1,0
48295,4,2,169144,169144,169146,0,2,3
48296,6,2,169150,169150,169152,0,2,4
48297,4,3,169154,169154,169157,0,3,2
48298,6,3,169160,169160,169163,0,3,3
48299,1,1,169161,169163,169164,2,3,0
48300,6,3,169167,169167,169170,0,3,3
48301,3,2,169170,169170,169172,0,2,0
48302,1,3,169171,169172,169175,1,4,0
48303,2,3,169173,169175,169178,2,5,0
48304,3,2,169176,169178,169180,2,4,0
48305,3,1,169179,169180,169181,1,2,0
48306,6,3,169185,169185,169188,0,3,4
48307,3,2,169188,169188,169190,0,2,0
48308,6,2,169194,169194,169196,0,2,4
48309,6,3,169200,169200,169203,0,3,4
48310,4,2,169204,169204,169206,0,2,1
48311,6,2,169210,169210,169212,0,2,4
48312,6,2,169216,169216,169218,0,2,4
48313,5,2,169221,169221,169223,0,2,3
48314,5,3,169226,169226,169229,0,3,3
48315,2,2,169228,169229,169231,1,3,0
48316,1,3,169229,169231,169234,2,5,0
48317,4,2,169233,169234,169236,1,3,0
48318,6,3,169239,169239,169242,0,3,3
48319,1,2,169240,169242,169244,2,4,0
48320,2,1,169242,169244,169245,2,3,0
48321,1,3,169243,169245,169248,2,5,0
48322,4,3,169247,169248,169251,1,4,0
48323,4,2,169251,169251,169253,0,2,0
48324,2,3,169253,169253,169256,0,3,0
48325,1,1,169254,169256,169257,2,3,0
48326,4,3,169258,169258,169261,0,3,1
48327,3,2,169261,169261,169263,0,2,0
48328,4,1,169265,169265,169266,0,1,2
48329,2,3,169267,169267,169270,0,3,1
48330,4,3,169271,169271,169274,0,3,1
48331,3,3,169274,169274,169277,0,3,0
48332,6,2,169280,169280,169282,0,2,3
48333,2,3,169282,169282,169285,0,3,0
48334,6,3,169288,169288,169291,0,3,3
48335,4,2,169292,169292,169294,0,2,1
48336,3,3,169295,169295,169298,0,3,1
48337,5,1,169300,169300,169301,0,1,2
48338,6,1,169306,169306,169307,0,1,5
48339,4,2,169310,169310,169312,0,2,3
48340,2,2,169312,169312,169314,0,2,0
48341,4,3,169316,169316,169319,0,3,2
48342,1,3,169317,169319,169322,2,5,0
48343,1,2,169318,169322,169324,4,6,0
48344,5,3,169323,169324,169327,1,4,0
48345,5,1,169328,169328,169329,0,1,1
48346,4,2,169332,169332,169334,0,2,3
48347,3,2,169335,169335,169337,0,2,1
48348,5,3,169340,169340,169343,0,3,3
48349,2,1,169342,169343,169344,1,2,0
48350,4,1,169346,169346,169347,0,1,2
48351,3,2,169349,169349,169351,0,2,2
48352,3,1,169352,169352,169353,0,1,1
48353,3,3,169355,169355,169358,0,3,2
48354,4,3,169359,169359,169362,0,3,1
48355,5,2,169364,169364,169366,0,2,2
48356,2,1,169366,169366,169367,0,1,0
48357,5,1,169371,169371,169372,0,1,4
48358,1,3,169372,169372,169375,0,3,0
48359,5,1,169377,169377,169378,0,1,2
48360,3,3,169380,169380,169383,0,3,2
48361,2,3,169382,169383,169386,1,4,0
48362,6,1,169388,169388,169389,0,1,2
48363,1,2,169389,169389,169391,0,2,0
48364,3,2,169392,169392,169394,0,2,1
48365,1,2,169393,169394,169396,1,3,0
48366,5,1,169398,169398,169399,0,1,2
48367,6,1,169404,169404,169405,0,1,5
48368,4,1,169408,169408,169409,0,1,3
48369,6,1,169414,169414,169415,0,1,5
48370,1,3,169415,169415,169418,0,3,0
48371,3,1,169418,169418,169419,0,1,0
48372,6,3,169424,169424,169427,0,3,5
48373,1,1,169425,169427,169428,2,3,0
48374,2,1,169427,169428,169429,1,2,0
48375,4,3,169431,169431,169434,0,3,2
48376,2,1,169433,169434,169435,1,2,0
48377,2,2,169435,169435,169437,0,2,0
48378,3,1,169438,169438,169439,0,1,1
48379,3,1,169441,169441,169442,0,1,2
48380,3,1,169444,169444,169445,0,1,2
48381,6,1,169450,169450,169451,0,1,5
48382,6,1,169456,169456,169457,0,1,5
48383,6,2,169462,169462,169464,0,2,5
48384,2,3,169464,169464,169467,0,3,0
48385,4,2,169468,169468,169470,0,2,1
48386,4,2,169472,169472,169474,0,2,2
48387,4,1,169476,169476,169477,0,1,2
48388,2,1,169478,169478,169479,0,1,1
48389,4,2,169482,169482,169484,0,2,3
48390,5,3,169487,169487,169490,0,3,3
48391,2,1,169489,169490,169491,1,2,0
48392,6,2,169495,169495,169497,0,2,4
48393,1,2,169496,169497,169499,1,3,0
48394,5,1,169501,169501,169502,0,1,2
48395,1,1,169502,169502,169503,0,1,0
48396,2,2,169504,169504,169506,0,2,1
48397,2,1,169506,169506,169507,0,1,0
48398,2,2,169508,169508,169510,0,2,1
48399,2,3,169510,169510,169513,0,3,0
48400,1,3,169511,169513,169516,2,5,0
48401,1,3,169512,169516,169519,4,7,0
48402,2,2,169514,169519,169521,5,7,0
48403,1,3,169515,169521,169524,6,9,0
48404,3,3,169518,169524,169527,6,9,0
48405,6,1,169524,169527,169528,3,4,0
48406,3,3,169527,169528,169531,1,4,0
48407,3,3,169530,169531,169534,1,4,0
48408,3,2,169533,169534,169536,1,3,0
48409,2,1,169535,169536,169537,1,2,0
48410,3,3,169538,169538,169541,0,3,1
48411,5,1,169543,169543,169544,0,1,2
48412,2,2,169545,169545,169547,0,2,1
48413,3,3,169548,169548,169551,0,3,1
48414,3,2,169551,169551,169553,0,2,0
48415,4,1,169555,169555,169556,0,1,2
48416,1,1,169556,169556,169557,0,1,0
48417,6,2,169562,169562,169564,0,2,5
48418,4,2,169566,169566,169568,0,2,2
48419,5,2,169571,169571,169573,0,2,3
48420,3,1,169574,169574,169575,0,1,1
48421,6,1,169580,169580,169581,0,1,5
48422,6,1,169586,169586,169587,0,1,5
48423,1,3,169587,169587,169590,0,3,0
48424,1,3,169588,169590,169593,2,5,0
48425,2,2,169590,169593,169595,3,5,0
48426,2,1,169592,169595,169596,3,4,0
48427,5,3,169597,169597,169600,0,3,1
48428,4,3,169601,169601,169604,0,3,1
48429,4,1,169605,169605,169606,0,1,1
48430,4,3,169609,169609,169612,0,3,3
48431,3,2,169612,169612,169614,0,2,0
48432,5,3,169617,169617,169620,0,3,3
48433,5,2,169622,169622,169624,0,2,2
48434,6,3,169628,169628,169631,0,3,4
48435,1,2,169629,169631,169633,2,4,0
48436,2,3,169631,169633,169636,2,5,0
48437,3,2,169634,169636,169638,2,4,0
48438,6,2,169640,169640,169642,0,2,2
48439,1,3,169641,169642,169645,1,4,0
48440,5,2,169646,169646,169648,0,2,1
48441,5,3,169651,169651,169654,0,3,3
48442,2,2,169653,169654,169656,1,3,0
48443,6,1,169659,169659,169660,0,1,3
48444,1,2,169660,169660,169662,0,2,0
48445,1,1,169661,169662,169663,1,2,0
48446,1,2,169662,169663,169665,1,3,0
48447,1,1,169663,169665,169666,2,3,0
48448,6,1,169669,169669,169670,0,1,3
48449,4,1,169673,169673,169674,0,1,3
48450,2,2,169675,169675,169677,0,2,1
48451,2,3,169677,169677,169680,0,3,0
48452,1,3,169678,169680,169683,2,5,0
48453,1,1,169679,169683,169684,4,5,0
48454,1,1,169680,169684,169685,4,5,0
48455,1,2,169681,169685,169687,4,6,0
48456,2,2,169683,169687,169689,4,6,0
48457,6,3,169689,169689,169692,0,3,0
48458,2,3,169691,169692,169695,1,4,0
48459,1,3,169692,169695,169698,3,6,0
48460,3,1,169695,169698,169699,3,4,0
48461,6,3,169701,169701,169704,0,3,2
48462,5,2,169706,169706,169708,0,2,2
48463,5,2,169711,169711,169713,0,2,3
48464,4,3,169715,169715,169718,0,3,2
48465,2,3,169717,169718,169721,1,4,0
48466,3,3,169720,169721,169724,1,4,0
48467,6,2,169726,169726,169728,0,2,2
48468,2,1,169728,169728,169729,0,1,0
48469,5,3,169733,169733,169736,0,3,4
48470,3,3,169736,169736,169739,0,3,0
48471,1,1,169737,169739,169740,2,3,0
48472,1,3,169738,169740,169743,2,5,0
48473,1,1,169739,169743,169744,4,5,0
48474,4,2,169743,169744,169746,1,3,0
48475,5,2,169748,169748,169750,0,2,2
48476,5,2,169753,169753,169755,0,2,3
48477,6,1,169759,169759,169760,0,1,4
48478,3,3,169762,169762,169765,0,3,2
48479,6,1,169768,169768,169769,0,1,3
48480,1,2,169769,169769,169771,0,2,0
48481,4,3,169773,169773,169776,0,3,2
48482,3,1,169776,169776,169777,0,1,0
48483,6,1,169782,169782,169783,0,1,5
48484,2,2,169784,169784,169786,0,2,1
48485,6,2,169790,169790,169792,0,2,4
48486,4,2,169794,169794,169796,0,2,2
48487,3,3,169797,169797,169800,0,3,1
48488,3,2,169800,169800,169802,0,2,0
48489,4,2,169804,169804,169806,0,2,2
48490,6,2,169810,169810,169812,0,2,4
48491,3,2,169813,169813,169815,0,2,1
48492,6,1,169819,169819,169820,0,1,4
48493,3,3,169822,169822,169825,0,3,2
48494,1,1,169823,169825,169826,2,3,0
48495,6,3,169829,169829,169832,0,3,3
48496,2,3,169831,169832,169835,1,4,0
48497,3,3,169834,169835,169838,1,4,0
48498,1,1,169835,169838,169839,3,4,0
48499,4,1,169839,169839,169840,0,1,0
48500,2,1,169841,169841,169842,0,1,1
48501,6,1,169847,169847,169848,0,1,5
48502,2,2,169849,169849,169851,0,2,1
48503,2,3,169851,169851,169854,0,3,0
48504,6,2,169857,169857,169859,0,2,3
48505,4,3,169861,169861,169864,0,3,2
48506,6,3,169867,169867,169870,0,3,3
48507,5,2,169872,169872,169874,0,2,2
48508,5,1,169877,169877,169878,0,1,3
48509,1,3,169878,169878,169881,0,3,0
48510,6,3,169884,169884,169887,0,3,3
48511,4,1,169888,169888,169889,0,1,1
48512,5,3,169893,169893,169896,0,3,4
48513,6,1,169899,169899,169900,0,1,3
48514,5,2,169904,169904,169906,0,2,4
48515,1,3,169905,169906,169909,1,4,0
48516,2,1,169907,169909,169910,2,3,0
48517,1,2,169908,169910,169912,2,4,0
48518,3,1,169911,169912,169913,1,2,0
48519,4,1,169915,169915,169916,0,1,2
48520,6,3,169921,169921,169924,0,3,5
48521,6,1,169927,169927,169928,0,1,3
48522,5,1,169932,169932,169933,0,1,4
48523,2,3,169934,169934,169937,0,3,1
48524,4,1,169938,169938,169939,0,1,1
48525,2,1,169940,169940,169941,0,1,1
48526,1,1,169941,169941,169942,0,1,0
48527,6,3,169947,169947,169950,0,3,5
48528,1,2,169948,169950,169952,2,4,0
48529,2,1,169950,169952,169953,2,3,0
48530,1,2,169951,169953,169955,2,4,0
48531,4,3,169955,169955,169958,0,3,0
48532,5,1,169960,169960,169961,0,1,2
48533,2,3,169962,169962,169965,0,3,1
48534,4,1,169966,169966,169967,0,1,1
48535,5,2,169971,169971,169973,0,2,4
48536,5,2,169976,169976,169978,0,2,3
48537,3,1,169979,169979,169980,0,1,1
48538,1,2,169980,169980,169982,0,2,0
48539,1,3,169981,169982,169985,1,4,0
48540,5,1,169986,169986,169987,0,1,1
48541,3,3,169989,169989,169992,0,3,2
48542,2,1,169991,169992,169993,1,2,0
48543,1,2,169992,169993,169995,1,3,0
48544,3,2,169995,169995,169997,0,2,0
48545,5,3,170000,170000,170003,0,3,3
48546,2,1,170002,170003,170004,1,2,0
48547,6,2,170008,170008,170010,0,2,4
48548,6,3,170014,170014,170017,0,3,4
48549,5,2,170019,170019,170021,0,2,2
48550,2,3,170021,170021,170024,0,3,0
48551,1,1,170022,170024,170025,2,3,0
48552,1,3,170023,170025,170028,2,5,0
48553,5,2,170028,170028,170030,0,2,0
48554,2,2,170030,170030,170032,0,2,0
48555,3,3,170033,170033,170036,0,3,1
48556,6,3,170039,170039,170042,0,3,3
48557,3,2,170042,170042,170044,0,2,0
48558,2,3,170044,170044,170047,0,3,0
48559,1,1,170045,170047,170048,2,3,0
48560,5,1,170050,170050,170051,0,1,2
48561,3,1,170053,170053,170054,0,1,2
48562,4,2,170057,170057,170059,0,2,3
48563,5,1,170062,170062,170063,0,1,3
48564,6,2,170068,170068,170070,0,2,5
48565,4,1,170072,170072,170073,0,1,2
48566,2,2,170074,170074,170076,0,2,1
48567,1,3,170075,170076,170079,1,4,0
48568,5,2,170080,170080,170082,0,2,1
48569,1,1,170081,170082,170083,1,2,0
48570,4,2,170085,170085,170087,0,2,2
48571,6,2,170091,170091,170093,0,2,4
48572,6,3,170097,170097,170100,0,3,4
48573,1,3,170098,170100,170103,2,5,0
48574,1,2,170099,170103,170105,4,6,0
48575,3,2,170102,170105,170107,3,5,0
48576,5,1,170107,170107,170108,0,1,0
48577,4,1,170111,170111,170112,0,1,3
48578,4,1,170115,170115,170116,0,1,3
48579,3,1,170118,170118,170119,0,1,2
48580,4,3,170122,170122,170125,0,3,3
48581,2,2,170124,170125,170127,1,3,0
48582,5,2,170129,170129,170131,0,2,2
48583,6,1,170135,170135,170136,0,1,4
48584,1,2,170136,170136,170138,0,2,0
48585,6,1,170142,170142,170143,0,1,4
48586,3,2,170145,170145,170147,0,2,2
48587,4,3,170149,170149,170152,0,3,2
48588,1,1,170150,170152,170153,2,3,0
48589,6,2,170156,170156,170158,0,2,3
48590,2,2,170158,170158,170160,0,2,0
48591,2,3,170160,170160,170163,0,3,0
48592,2,3,170162,170163,170166,1,4,0
48593,3,2,170165,170166,170168,1,3,0
48594,3,2,170168,170168,170170,0,2,0
48595,5,2,170173,170173,170175,0,2,3
48596,4,2,170177,170177,170179,0,2,2
48597,6,2,170183,170183,170185,0,2,4
48598,6,3,170189,170189,170192,0,3,4
48599,2,2,170191,170192,170194,1,3,0
48600,1,2,170192,170194,170196,2,4,0
48601,6,1,170198,170198,170199,0,1,2
48602,6,3,170204,170204,170207,0,3,5
48603,2,3,170206,170207,170210,1,4,0
48604,6,2,170212,170212,170214,0,2,2
48605,3,2,170215,170215,170217,0,2,1
48606,6,2,170221,170221,170223,0,2,4
48607,1,2,170222,170223,170225,1,3,0
48608,3,1,170225,170225,170226,0,1,0
48609,3,2,170228,170228,170230,0,2,2
48610,2,1,170230,170230,170231,0,1,0
48611,2,1,170232,170232,170233,0,1,1
48612,6,1,170238,170238,170239,0,1,5
48613,6,2,170244,170244,170246,0,2,5
48614,1,3,170245,170246,170249,1,4,0
48615,6,1,170251,170251,170252,0,1,2
48616,2,1,170253,170253,170254,0,1,1
48617,2,3,170255,170255,170258,0,3,1
48618,4,3,170259,170259,170262,0,3,1
48619,3,3,170262,170262,170265,0,3,0
48620,1,2,170263,170265,170267,2,4,0
48621,3,3,170266,170267,170270,1,4,0
48622,6,2,170272,170272,170274,0,2,2
48623,1,3,170273,170274,170277,1,4,0
48624,6,3,170279,170279,170282,0,3,2
48625,6,3,170285,170285,170288,0,3,3
48626,4,2,170289,170289,170291,0,2,1
48627,3,3,170292,170292,170295,0,3,1
48628,4,3,170296,170296,170299,0,3,1
48629,3,1,170299,170299,170300,0,1,0
48630,4,2,170303,170303,170305,0,2,3
48631,4,2,170307,170307,170309,0,2,2
48632,4,1,170311,170311,170312,0,1,2
48633,5,2,170316,170316,170318,0,2,4
48634,4,3,170320,170320,170323,0,3,2
48635,5,1,170325,170325,170326,0,1,2
48636,3,3,170328,170328,170331,0,3,2
48637,6,2,170334,170334,170336,0,2,3
48638,1,3,170335,170336,170339,1,4,0
48639,1,3,170336,170339,170342,3,6,0
48640,5,1,170341,170342,170343,1,2,0
48641,2,1,170343,170343,170344,0,1,0
48642,5,2,170348,170348,170350,0,2,4
48643,6,3,170354,170354,170357,0,3,4
48644,5,3,170359,170359,170362,0,3,2
48645,5,1,170364,170364,170365,0,1,2
48646,6,1,170370,170370,170371,0,1,5
48647,1,1,170371,170371,170372,0,1,0
48648,3,3,170374,170374,170377,0,3,2
48649,5,3,170379,170379,170382,0,3,2
48650,2,3,170381,170382,170385,1,4,0
48651,6,1,170387,170387,170388,0,1,2
48652,1,1,170388,170388,170389,0,1,0
48653,4,1,170392,170392,170393,0,1,3
48654,5,2,170397,170397,170399,0,2,4
48655,3,3,170400,170400,170403,0,3,1
48656,3,3,170403,170403,170406,0,3,0
48657,4,3,170407,170407,170410,0,3,1
48658,3,1,170410,170410,170411,0,1,0
48659,6,3,170416,170416,170419,0,3,5
48660,2,1,170418,170419,170420,1,2,0
48661,3,1,170421,170421,170422,0,1,1
48662,6,2,170427,170427,170429,0,2,5
48663,5,1,170432,170432,170433,0,1,3
48664,2,2,170434,170434,170436,0,2,1
48665,3,3,170437,170437,170440,0,3,1
48666,5,1,170442,170442,170443,0,1,2
48667,5,3,170447,170447,170450,0,3,4
48668,5,3,170452,170452,170455,0,3,2
48669,5,2,170457,170457,170459,0,2,2
48670,3,1,170460,170460,170461,0,1,1
48671,4,1,170464,170464,170465,0,1,3
48672,5,1,170469,170469,170470,0,1,4
48673,2,1,170471,170471,170472,0,1,1
48674,6,3,170477,170477,170480,0,3,5
48675,6,1,170483,170483,170484,0,1,3
48676,4,2,170487,170487,170489,0,2,3
48677,6,2,170493,170493,170495,0,2,4
48678,6,1,170499,170499,170500,0,1,4
48679,2,1,170501,170501,170502,0,1,1
48680,4,3,170505,170505,170508,0,3,3
48681,2,1,170507,170508,170509,1,2,0
48682,2,1,170509,170509,170510,0,1,0
48683,5,2,170514,170514,170516,0,2,4
48684,1,1,170515,170516,170517,1,2,0
48685,2,3,170517,170517,170520,0,3,0
48686,2,2,170519,170520,170522,1,3,0
48687,5,3,170524,170524,170527,0,3,2
48688,3,3,170527,170527,170530,0,3,0
48689,1,1,170528,170530,170531,2,3,0
48690,6,2,170534,170534,170536,0,2,3
48691,5,1,170539,170539,170540,0,1,3
48692,1,2,170540,170540,170542,0,2,0
48693,5,2,170545,170545,170547,0,2,3
48694,1,3,170546,170547,170550,1,4,0
48695,1,1,170547,170550,170551,3,4,0
48696,4,2,170551,170551,170553,0,2,0
48697,3,3,170554,170554,170557,0,3,1
48698,2,3,170556,170557,170560,1,4,0
48699,5,2,170561,170561,170563,0,2,1
48700,3,1,170564,170564,170565,0,1,1
48701,3,2,170567,170567,170569,0,2,2
48702,4,1,170571,170571,170572,0,1,2
48703,5,2,170576,170576,170578,0,2,4
48704,2,1,170578,170578,170579,0,1,0
48705,1,1,170579,170579,170580,0,1,0
48706,2,3,170581,170581,170584,0,3,1
48707,4,1,170585,170585,170586,0,1,1
48708,6,2,170591,170591,170593,0,2,5
48709,2,3,170593,170593,170596,0,3,0
48710,1,3,170594,170596,170599,2,5,0
48711,6,3,170600,170600,170603,0,3,1
48712,3,2,170603,170603,170605,0,2,0
48713,6,2,170609,170609,170611,0,2,4
48714,4,2,170613,170613,170615,0,2,2
48715,5,3,170618,170618,170621,0,3,3
48716,4,2,170622,170622,170624,0,2,1
48717,1,1,170623,170624,170625,1,2,0
48718,1,1,170624,170625,170626,1,2,0
48719,6,2,170630,170630,170632,0,2,4
48720,4,1,170634,170634,170635,0,1,2
48721,2,1,170636,170636,170637,0,1,1
48722,6,1,170642,170642,170643,0,1,5
48723,3,3,170645,170645,170648,0,3,2
48724,4,1,170649,170649,170650,0,1,1
48725,4,2,170653,170653,170655,0,2,3
48726,1,2,170654,170655,170657,1,3,0
48727,4,3,170658,170658,170661,0,3,1
48728,1,2,170659,170661,170663,2,4,0
48729,6,1,170665,170665,170666,0,1,2
48730,4,3,170669,170669,170672,0,3,3
48731,5,2,170674,170674,170676,0,2,2
48732,1,1,170675,170676,170677,1,2,0
48733,5,1,170680,170680,170681,0,1,3
48734,5,2,170685,170685,170687,0,2,4
48735,3,2,170688,170688,170690,0,2,1
48736,1,3,170689,170690,170693,1,4,0
48737,6,1,170695,170695,170696,0,1,2
48738,5,1,170700,170700,170701,0,1,4
48739,6,1,170706,170706,170707,0,1,5
48740,3,1,170709,170709,170710,0,1,2
48741,1,3,170710,170710,170713,0,3,0
48742,4,3,170714,170714,170717,0,3,1
48743,6,2,170720,170720,170722,0,2,3
48744,1,3,170721,170722,170725,1,4,0
48745,2,2,170723,170725,170727,2,4,0
48746,1,2,170724,170727,170729,3,5,0
48747,2,1,170726,170729,170730,3,4,0
48748,2,3,170728,170730,170733,2,5,0
48749,1,1,170729,170733,170734,4,5,0
48750,4,2,170733,170734,170736,1,3,0
48751,1,3,170734,170736,170739,2,5,0
48752,6,1,170740,170740,170741,0,1,1
48753,4,3,170744,170744,170747,0,3,3
48754,3,1,170747,170747,170748,0,1,0
48755,6,1,170753,170753,170754,0,1,5
48756,3,3,170756,170756,170759,0,3,2
48757,6,2,170762,170762,170764,0,2,3
48758,2,3,170764,170764,170767,0,3,0
48759,6,1,170770,170770,170771,0,1,3
48760,3,1,170773,170773,170774,0,1,2
48761,2,2,170775,170775,170777,0,2,1
48762,5,3,170780,170780,170783,0,3,3
48763,3,2,170783,170783,170785,0,2,0
48764,2,2,170785,170785,170787,0,2,0
48765,2,3,170787,170787,170790,0,3,0
48766,4,2,170791,170791,170793,0,2,1
48767,5,1,170796,170796,170797,0,1,3
48768,6,3,170802,170802,170805,0,3,5
48769,2,1,170804,170805,170806,1,2,0
48770,6,1,170810,170810,170811,0,1,4
48771,4,3,170814,170814,170817,0,3,3
48772,1,1,170815,170817,170818,2,3,0
48773,3,3,170818,170818,170821,0,3,0
48774,2,2,170820,170821,170823,1,3,0
48775,2,1,170822,170823,170824,1,2,0
48776,5,3,170827,170827,170830,0,3,3
48777,3,2,170830,170830,170832,0,2,0
48778,2,2,170832,170832,170834,0,2,0
48779,3,1,170835,170835,170836,0,1,1
48780,1,3,170836,170836,170839,0,3,0
48781,4,3,170840,170840,170843,0,3,1
48782,1,2,170841,170843,170845,2,4,0
48783,2,3,170843,170845,170848,2,5,0
48784,6,1,170849,170849,170850,0,1,1
48785,4,1,170853,170853,170854,0,1,3
48786,5,3,170858,170858,170861,0,3,4
48787,3,1,170861,170861,170862,0,1,0
48788,1,1,170862,170862,170863,0,1,0
48789,5,1,170867,170867,170868,0,1,4
48790,5,3,170872,170872,170875,0,3,4
48791,1,1,170873,170875,170876,2,3,0
48792,2,2,170875,170876,170878,1,3,0
48793,1,1,170876,170878,170879,2,3,0
48794,1,1,170877,170879,170880,2,3,0
48795,4,1,170881,170881,170882,0,1,1
48796,5,3,170886,170886,170889,0,3,4
48797,2,3,170888,170889,170892,1,4,0
48798,5,2,170893,170893,170895,0,2,1
48799,2,1,170895,170895,170896,0,1,0
48800,2,3,170897,170897,170900,0,3,1
48801,2,3,170899,170900,170903,1,4,0
48802,4,2,170903,170903,170905,0,2,0
48803,6,3,170909,170909,170912,0,3,4
48804,3,1,170912,170912,170913,0,1,0
48805,1,1,170913,170913,170914,0,1,0
48806,4,2,170917,170917,170919,0,2,3
48807,5,2,170922,170922,170924,0,2,3
48808,4,3,170926,170926,170929,0,3,2
48809,6,1,170932,170932,170933,0,1,3
48810,4,2,170936,170936,170938,0,2,3
48811,3,2,170939,170939,170941,0,2,1
48812,5,2,170944,170944,170946,0,2,3
48813,2,3,170946,170946,170949,0,3,0
48814,5,3,170951,170951,170954,0,3,2
48815,4,3,170955,170955,170958,0,3,1
48816,2,1,170957,170958,170959,1,2,0
48817,3,2,170960,170960,170962,0,2,1
48818,2,2,170962,170962,170964,0,2,0
48819,6,2,170968,170968,170970,0,2,4
48820,1,1,170969,170970,170971,1,2,0
48821,5,1,170974,170974,170975,0,1,3
48822,3,2,170977,170977,170979,0,2,2
48823,2,2,170979,170979,170981,0,2,0
48824,2,1,170981,170981,170982,0,1,0
48825,6,1,170987,170987,170988,0,1,5
48826,6,3,170993,170993,170996,0,3,5
48827,1,1,170994,170996,170997,2,3,0
48828,3,2,170997,170997,170999,0,2,0
48829,6,1,171003,171003,171004,0,1,4
48830,3,1,171006,171006,171007,0,1,2
48831,2,1,171008,171008,171009,0,1,1
48832,5,1,171013,171013,171014,0,1,4
48833,3,2,171016,171016,171018,0,2,2
48834,5,3,171021,171021,171024,0,3,3
48835,4,3,171025,171025,171028,0,3,1
48836,2,1,171027,171028,171029,1,2,0
48837,1,1,171028,171029,171030,1,2,0
48838,5,2,171033,171033,171035,0,2,3
48839,1,3,171034,171035,171038,1,4,0
48840,2,2,171036,171038,171040,2,4,0
48841,5,1,171041,171041,171042,0,1,1
48842,5,1,171046,171046,171047,0,1,4
48843,6,2,171052,171052,171054,0,2,5
48844,3,1,171055,171055,171056,0,1,1
48845,3,1,171058,171058,171059,0,1,2
48846,6,2,171064,171064,171066,0,2,5
48847,3,2,171067,171067,171069,0,2,1
48848,3,1,171070,171070,171071,0,1,1
48849,6,3,171076,171076,171079,0,3,5
48850,6,3,171082,171082,171085,0,3,3
48851,4,3,171086,171086,171089,0,3,1
48852,2,1,171088,171089,171090,1,2,0
48853,3,3,171091,171091,171094,0,3,1
48854,4,2,171095,171095,171097,0,2,1
48855,3,3,171098,171098,171101,0,3,1
48856,3,2,171101,171101,171103,0,2,0
48857,3,3,171104,171104,171107,0,3,1
48858,6,2,171110,171110,171112,0,2,3
48859,1,1,171111,171112,171113,1,2,0
48860,6,3,171117,171117,171120,0,3,4
48861,5,3,171122,171122,171125,0,3,2
48862,5,3,171127,171127,171130,0,3,2
48863,2,3,171129,171130,171133,1,4,0
48864,3,3,171132,171133,171136,1,4,0
48865,1,2,171133,171136,171138,3,5,0
48866,1,1,171134,171138,171139,4,5,0
48867,6,3,171140,171140,171143,0,3,1
48868,4,1,171144,171144,171145,0,1,1
48869,2,1,171146,171146,171147,0,1,1
48870,4,1,171150,171150,171151,0,1,3
48871,2,2,171152,171152,171154,0,2,1
48872,3,2,171155,171155,171157,0,2,1
48873,3,3,171158,171158,171161,0,3,1
48874,5,1,171163,171163,171164,0,1,2
48875,6,2,171169,171169,171171,0,2,5
48876,1,1,171170,171171,171172,1,2,0
48877,4,2,171174,171174,171176,0,2,2
48878,5,3,171179,171179,171182,0,3,3
48879,3,2,171182,171182,171184,0,2,0
48880,6,2,171188,171188,171190,0,2,4
48881,5,1,171193,171193,171194,0,1,3
48882,2,3,171195,171195,171198,0,3,1
48883,1,3,171196,171198,171201,2,5,0
48884,4,3,171200,171201,171204,1,4,0
48885,6,1,171206,171206,171207,0,1,2
48886,3,2,171209,171209,171211,0,2,2
48887,1,1,171210,171211,171212,1,2,0
48888,4,2,171214,171214,171216,0,2,2
48889,1,3,171215,171216,171219,1,4,0
48890,5,2,171220,171220,171222,0,2,1
48891,3,1,171223,171223,171224,0,1,1
48892,6,1,171229,171229,171230,0,1,5
48893,5,2,171234,171234,171236,0,2,4
48894,4,1,171238,171238,171239,0,1,2
48895,5,1,171243,171243,171244,0,1,4
48896,5,1,171248,171248,171249,0,1,4
48897,6,2,171254,171254,171256,0,2,5
48898,3,2,171257,171257,171259,0,2,1
48899,5,1,171262,171262,171263,0,1,3
48900,1,3,171263,171263,171266,0,3,0
48901,6,1,171269,171269,171270,0,1,3
48902,2,1,171271,171271,171272,0,1,1
48903,3,1,171274,171274,171275,0,1,2
48904,6,1,171280,171280,171281,0,1,5
48905,4,2,171284,171284,171286,0,2,3
48906,3,3,171287,171287,171290,0,3,1
48907,3,1,171290,171290,171291,0,1,0
48908,5,1,171295,171295,171296,0,1,4
48909,5,1,171300,171300,171301,0,1,4
48910,2,3,171302,171302,171305,0,3,1
48911,1,2,171303,171305,171307,2,4,0
48912,5,1,171308,171308,171309,0,1,1
48913,3,1,171311,171311,171312,0,1,2
48914,1,2,171312,171312,171314,0,2,0
48915,6,1,171318,171318,171319,0,1,4
48916,5,2,171323,171323,171325,0,2,4
48917,4,3,171327,171327,171330,0,3,2
48918,1,1,171328,171330,171331,2,3,0
48919,6,2,171334,171334,171336,0,2,3
48920,2,1,171336,171336,171337,0,1,0
48921,2,3,171338,171338,171341,0,3,1
48922,4,2,171342,171342,171344,0,2,1
48923,4,1,171346,171346,171347,0,1,2
48924,3,1,171349,171349,171350,0,1,2
48925,4,2,171353,171353,171355,0,2,3
48926,4,2,171357,171357,171359,0,2,2
48927,3,2,171360,171360,171362,0,2,1
48928,6,1,171366,171366,171367,0,1,4
48929,5,2,171371,171371,171373,0,2,4
48930,3,3,171374,171374,171377,0,3,1
48931,1,1,171375,171377,171378,2,3,0
48932,5,3,171380,171380,171383,0,3,2
48933,6,2,171386,171386,171388,0,2,3
48934,1,3,171387,171388,171391,1,4,0
48935,4,2,171391,171391,171393,0,2,0
48936,3,1,171394,171394,171395,0,1,1
48937,2,3,171396,171396,171399,0,3,1
48938,2,3,171398,171399,171402,1,4,0
48939,1,1,171399,171402,171403,3,4,0
48940,4,2,171403,171403,171405,0,2,0
48941,3,1,171406,171406,171407,0,1,1
48942,5,1,171411,171411,171412,0,1,4
48943,6,3,171417,171417,171420,0,3,5
48944,4,1,171421,171421,171422,0,1,1
48945,6,3,171427,171427,171430,0,3,5
48946,2,2,171429,171430,171432,1,3,0
48947,1,1,171430,171432,171433,2,3,0
48948,3,3,171433,171433,171436,0,3,0
48949,1,2,171434,171436,171438,2,4,0
48950,5,3,171439,171439,171442,0,3,1
48951,1,2,171440,171442,171444,2,4,0
48952,1,1,171441,171444,171445,3,4,0
48953,4,3,171445,171445,171448,0,3,0
48954,5,3,171450,171450,171453,0,3,2
48955,3,3,171453,171453,171456,0,3,0
48956,1,1,171454,171456,171457,2,3,0
48957,2,2,171456,171457,171459,1,3,0
48958,6,1,171462,171462,171463,0,1,3
48959,2,2,171464,171464,171466,0,2,1
48960,5,2,171469,171469,171471,0,2,3
48961,1,3,171470,171471,171474,1,4,0
48962,6,2,171476,171476,171478,0,2,2
48963,1,1,171477,171478,171479,1,2,0
48964,4,1,171481,171481,171482,0,1,2
48965,5,3,171486,171486,171489,0,3,4
48966,3,2,171489,171489,171491,0,2,0
48967,4,1,171493,171493,171494,0,1,2
48968,3,3,171496,171496,171499,0,3,2
48969,4,1,171500,171500,171501,0,1,1
48970,5,3,171505,171505,171508,0,3,4
48971,5,1,171510,171510,171511,0,1,2
48972,4,3,171514,171514,171517,0,3,3
48973,5,1,171519,171519,171520,0,1,2
48974,6,1,171525,171525,171526,0,1,5
48975,6,3,171531,171531,171534,0,3,5
48976,2,3,171533,171534,171537,1,4,0
48977,1,2,171534,171537,171539,3,5,0
48978,4,2,171538,171539,171541,1,3,0
48979,4,3,171542,171542,171545,0,3,1
48980,2,2,171544,171545,171547,1,3,0
48981,2,1,171546,171547,171548,1,2,0
48982,3,2,171549,171549,171551,0,2,1
48983,3,1,171552,171552,171553,0,1,1
48984,1,1,171553,171553,171554,0,1,0
48985,1,1,171554,171554,171555,0,1,0
48986,4,1,171558,171558,171559,0,1,3
48987,5,2,171563,171563,171565,0,2,4
48988,6,1,171569,171569,171570,0,1,4
48989,5,3,171574,171574,171577,0,3,4
48990,6,1,171580,171580,171581,0,1,3
48991,1,1,171581,171581,171582,0,1,0
48992,2,3,171583,171583,171586,0,3,1
48993,4,3,171587,171587,171590,0,3,1
48994,4,2,171591,171591,171593,0,2,1
48995,1,2,171592,171593,171595,1,3,0
48996,5,3,171597,171597,171600,0,3,2
48997,1,2,171598,171600,171602,2,4,0
48998,3,2,171601,171602,171604,1,3,0
48999,2,1,171603,171604,171605,1,2,0
49000,6,3,171609,171609,171612,0,3,4
49001,2,1,171611,171612,171613,1,2,0
49002,3,3,171614,171614,171617,0,3,1
49003,2,3,171616,171617,171620,1,4,0
49004,6,1,171622,171622,171623,0,1,2
49005,6,1,171628,171628,171629,0,1,5
49006,5,3,171633,171633,171636,0,3,4
49007,2,3,171635,171636,171639,1,4,0
49008,2,2,171637,171639,171641,2,4,0
49009,4,1,171641,171641,171642,0,1,0
49010,2,3,171643,171643,171646,0,3,1
49011,3,3,171646,171646,171649,0,3,0
49012,4,1,171650,171650,171651,0,1,1
49013,6,1,171656,171656,171657,0,1,5
49014,2,1,171658,171658,171659,0,1,1
49015,3,2,171661,171661,171663,0,2,2
49016,4,2,171665,171665,171667,0,2,2
49017,5,1,171670,171670,171671,0,1,3
49018,4,2,171674,171674,171676,0,2,3
49019,6,1,171680,171680,171681,0,1,4
49020,4,2,171684,171684,171686,0,2,3
49021,6,2,171690,171690,171692,0,2,4
49022,2,1,171692,171692,171693,0,1,0
49023,1,2,171693,171693,171695,0,2,0
49024,2,1,171695,171695,171696,0,1,0
49025,2,1,171697,171697,171698,0,1,1
49026,6,1,171703,171703,171704,0,1,5
49027,3,3,171706,171706,171709,0,3,2
49028,4,2,171710,171710,171712,0,2,1
49029,5,1,171715,171715,171716,0,1,3
49030,1,2,171716,171716,171718,0,2,0
49031,5,3,171721,171721,171724,0,3,3
49032,5,3,171726,171726,171729,0,3,2
49033,5,2,171731,171731,171733,0,2,2
49034,3,3,171734,171734,171737,0,3,1
49035,4,3,171738,171738,171741,0,3,1
49036,4,3,171742,171742,171745,0,3,1
49037,3,2,171745,171745,171747,0,2,0
49038,6,2,171751,171751,171753,0,2,4
49039,5,1,171756,171756,171757,0,1,3
49040,2,3,171758,171758,171761,0,3,1
49041,1,3,171759,171761,171764,2,5,0
49042,1,3,171760,171764,171767,4,7,0
49043,3,2,171763,171767,171769,4,6,0
49044,3,2,171766,171769,171771,3,5,0
49045,1,1,171767,171771,171772,4,5,0
49046,6,2,171773,171773,171775,0,2,1
49047,5,3,171778,171778,171781,0,3,3
49048,1,2,171779,171781,171783,2,4,0
49049,1,2,171780,171783,171785,3,5,0
49050,3,3,171783,171785,171788,2,5,0
49051,5,1,171788,171788,171789,0,1,0
49052,6,3,171794,171794,171797,0,3,5
49053,3,3,171797,171797,171800,0,3,0
49054,6,2,171803,171803,171805,0,2,3
49055,3,2,171806,171806,171808,0,2,1
49056,1,2,171807,171808,171810,1,3,0
49057,6,2,171813,171813,171815,0,2,3
49058,5,3,171818,171818,171821,0,3,3
49059,2,3,171820,171821,171824,1,4,0
49060,5,1,171825,171825,171826,0,1,1
49061,5,3,171830,171830,171833,0,3,4
49062,2,2,171832,171833,171835,1,3,0
49063,6,1,171838,171838,171839,0,1,3
49064,4,2,171842,171842,171844,0,2,3
49065,1,1,171843,171844,171845,1,2,0
49066,4,1,171847,171847,171848,0,1,2
49067,2,1,171849,171849,171850,0,1,1
49068,2,2,171851,171851,171853,0,2,1
49069,3,3,171854,171854,171857,0,3,1
49070,4,3,171858,171858,171861,0,3,1
49071,6,2,171864,171864,171866,0,2,3
49072,2,1,171866,171866,171867,0,1,0
49073,1,2,171867,171867,171869,0,2,0
49074,2,3,171869,171869,171872,0,3,0
49075,6,3,171875,171875,171878,0,3,3
49076,6,3,171881,171881,171884,0,3,3
49077,6,2,171887,171887,171889,0,2,3
49078,6,3,171893,171893,171896,0,3,4
49079,1,1,171894,171896,171897,2,3,0
49080,5,1,171899,171899,171900,0,1,2
49081,4,2,171903,171903,171905,0,2,3
49082,6,1,171909,171909,171910,0,1,4
49083,5,1,171914,171914,171915,0,1,4
49084,3,1,171917,171917,171918,0,1,2
49085,1,1,171918,171918,171919,0,1,0
49086,6,1,171924,171924,171925,0,1,5
49087,1,3,171925,171925,171928,0,3,0
49088,1,1,171926,171928,171929,2,3,0
49089,3,3,171929,171929,171932,0,3,0
49090,6,3,171935,171935,171938,0,3,3
49091,2,2,171937,171938,171940,1,3,0
49092,1,1,171938,171940,171941,2,3,0
49093,2,1,171940,171941,171942,1,2,0
49094,3,2,171943,171943,171945,0,2,1
49095,2,2,171945,171945,171947,0,2,0
49096,1,2,171946,171947,171949,1,3,0
49097,5,1,171951,171951,171952,0,1,2
49098,1,2,171952,171952,171954,0,2,0
49099,4,2,171956,171956,171958,0,2,2
49100,3,2,171959,171959,171961,0,2,1
49101,2,2,171961,171961,171963,0,2,0
49102,3,3,171964,171964,171967,0,3,1
49103,2,2,171966,171967,171969,1,3,0
49104,1,1,171967,171969,171970,2,3,0
49105,4,3,171971,171971,171974,0,3,1
49106,6,3,171977,171977,171980,0,3,3
49107,5,1,171982,171982,171983,0,1,2
49108,5,1,171987,171987,171988,0,1,4
49109,5,2,171992,171992,171994,0,2,4
49110,5,3,171997,171997,172000,0,3,3
49111,1,3,171998,172000,172003,2,5,0
49112,6,2,172004,172004,172006,0,2,1
49113,2,1,172006,172006,172007,0,1,0
49114,5,1,172011,172011,172012,0,1,4
49115,5,3,172016,172016,172019,0,3,4
49116,3,2,172019,172019,172021,0,2,0
49117,3,2,172022,172022,172024,0,2,1
49118,6,2,172028,172028,172030,0,2,4
49119,2,3,172030,172030,172033,0,3,0
49120,4,1,172034,172034,172035,0,1,1
49121,3,1,172037,172037,172038,0,1,2
49122,6,3,172043,172043,172046,0,3,5
49123,6,3,172049,172049,172052,0,3,3
49124,2,3,172051,172052,172055,1,4,0
49125,2,2,172053,172055,172057,2,4,0
49126,4,1,172057,172057,172058,0,1,0
49127,4,2,172061,172061,172063,0,2,3
49128,3,1,172064,172064,172065,0,1,1
49129,1,1,172065,172065,172066,0,1,0
49130,6,3,172071,172071,172074,0,3,5
49131,3,3,172074,172074,172077,0,3,0
49132,2,2,172076,172077,172079,1,3,0
49133,1,3,172077,172079,172082,2,5,0
49134,3,1,172080,172082,172083,2,3,0
49135,3,3,172083,172083,172086,0,3,0
49136,1,2,172084,172086,172088,2,4,0
49137,4,2,172088,172088,172090,0,2,0
49138,4,1,172092,172092,172093,0,1,2
49139,4,3,172096,172096,172099,0,3,3
49140,4,3,172100,172100,172103,0,3,1
49141,5,2,172105,172105,172107,0,2,2
49142,6,1,172111,172111,172112,0,1,4
49143,1,3,172112,172112,172115,0,3,0
49144,1,1,172113,172115,172116,2,3,0
49145,2,2,172115,172116,172118,1,3,0
49146,5,2,172120,172120,172122,0,2,2
49147,6,1,172126,172126,172127,0,1,4
49148,6,3,172132,172132,172135,0,3,5
49149,1,3,172133,172135,172138,2,5,0
49150,2,1,172135,172138,172139,3,4,0
49151,5,1,172140,172140,172141,0,1,1
49152,5,1,172145,172145,172146,0,1,4
49153,5,1,172150,172150,172151,0,1,4
49154,1,2,172151,172151,172153,0,2,0
49155,2,1,172153,172153,172154,0,1,0
49156,2,2,172155,172155,172157,0,2,1
49157,1,3,172156,172157,172160,1,4,0
49158,3,1,172159,172160,172161,1,2,0
49159,6,3,172165,172165,172168,0,3,4
49160,5,2,172170,172170,172172,0,2,2
49161,1,1,172171,172172,172173,1,2,0
49162,5,1,172176,172176,172177,0,1,3
49163,6,3,172182,172182,172185,0,3,5
49164,5,3,172187,172187,172190,0,3,2
49165,1,2,172188,172190,172192,2,4,0
49166,4,2,172192,172192,172194,0,2,0
49167,6,3,172198,172198,172201,0,3,4
49168,4,1,172202,172202,172203,0,1,1
49169,5,1,172207,172207,172208,0,1,4
49170,3,3,172210,172210,172213,0,3,2
49171,6,1,172216,172216,172217,0,1,3
49172,6,3,172222,172222,172225,0,3,5
49173,1,2,172223,172225,172227,2,4,0
49174,3,1,172226,172227,172228,1,2,0
49175,4,3,172230,172230,172233,0,3,2
49176,4,1,172234,172234,172235,0,1,1
49177,6,1,172240,172240,172241,0,1,5
49178,1,2,172241,172241,172243,0,2,0
49179,1,2,172242,172243,172245,1,3,0
49180,3,2,172245,172245,172247,0,2,0
49181,3,3,172248,172248,172251,0,3,1
49182,1,3,172249,172251,172254,2,5,0
49183,1,3,172250,172254,172257,4,7,0
49184,1,2,172251,172257,172259,6,8,0
49185,5,3,172256,172259,172262,3,6,0
49186,6,2,172262,172262,172264,0,2,0
49187,4,2,172266,172266,172268,0,2,2
49188,1,1,172267,172268,172269,1,2,0
49189,1,2,172268,172269,172271,1,3,0
49190,4,3,172272,172272,172275,0,3,1
49191,5,2,172277,172277,172279,0,2,2
49192,3,1,172280,172280,172281,0,1,1
49193,5,3,172285,172285,172288,0,3,4
49194,4,1,172289,172289,172290,0,1,1
49195,5,1,172294,172294,172295,0,1,4
49196,4,2,172298,172298,172300,0,2,3
49197,1,2,172299,172300,172302,1,3,0
49198,1,2,172300,172302,172304,2,4,0
49199,3,2,172303,172304,172306,1,3,0
49200,2,3,172305,172306,172309,1,4,0
49201,1,2,172306,172309,172311,3,5,0
49202,2,1,172308,172311,172312,3,4,0
49203,3,2,172311,172312,172314,1,3,0
49204,4,1,172315,172315,172316,0,1,1
49205,5,2,172320,172320,172322,0,2,4
49206,1,2,172321,172322,172324,1,3,0
49207,5,2,172326,172326,172328,0,2,2
49208,3,2,172329,172329,172331,0,2,1
49209,6,2,172335,172335,172337,0,2,4
49210,5,3,172340,172340,172343,0,3,3
49211,2,1,172342,172343,172344,1,2,0
49212,1,3,172343,172344,172347,1,4,0
49213,5,1,172348,172348,172349,0,1,1
49214,1,2,172349,172349,172351,0,2,0
49215,4,1,172353,172353,172354,0,1,2
49216,2,3,172355,172355,172358,0,3,1
49217,4,1,172359,172359,172360,0,1,1
49218,5,1,172364,172364,172365,0,1,4
49219,4,1,172368,172368,172369,0,1,3
49220,4,3,172372,172372,172375,0,3,3
49221,3,1,172375,172375,172376,0,1,0
49222,6,3,172381,172381,172384,0,3,5
49223,1,3,172382,172384,172387,2,5,0
49224,4,1,172386,172387,172388,1,2,0
49225,2,3,172388,172388,172391,0,3,0
49226,2,2,172390,172391,172393,1,3,0
49227,3,2,172393,172393,172395,0,2,0
49228,4,3,172397,172397,172400,0,3,2
49229,5,1,172402,172402,172403,0,1,2
49230,1,3,172403,172403,172406,0,3,0
49231,6,2,172409,172409,172411,0,2,3
49232,1,1,172410,172411,172412,1,2,0
49233,5,2,172415,172415,172417,0,2,3
49234,5,3,172420,172420,172423,0,3,3
49235,1,3,172421,172423,172426,2,5,0
49236,4,3,172425,172426,172429,1,4,0
49237,3,1,172428,172429,172430,1,2,0
49238,2,3,172430,172430,172433,0,3,0
49239,4,3,172434,172434,172437,0,3,1
49240,4,3,172438,172438,172441,0,3,1
49241,4,1,172442,172442,172443,0,1,1
49242,6,3,172448,172448,172451,0,3,5
49243,6,2,172454,172454,172456,0,2,3
49244,5,2,172459,172459,172461,0,2,3
49245,4,3,172463,172463,172466,0,3,2
49246,4,3,172467,172467,172470,0,3,1
49247,2,2,172469,172470,172472,1,3,0
49248,1,2,172470,172472,172474,2,4,0
49249,3,3,172473,172474,172477,1,4,0
49250,2,3,172475,172477,172480,2,5,0
49251,1,3,172476,172480,172483,4,7,0
49252,2,3,172478,172483,172486,5,8,0
49253,6,1,172484,172486,172487,2,3,0
49254,6,2,172490,172490,172492,0,2,3
49255,3,3,172493,172493,172496,0,3,1
49256,6,2,172499,172499,172501,0,2,3
49257,1,1,172500,172501,172502,1,2,0
49258,1,3,172501,172502,172505,1,4,0
49259,6,2,172507,172507,172509,0,2,2
49260,2,3,172509,172509,172512,0,3,0
49261,4,1,172513,172513,172514,0,1,1
49262,5,2,172518,172518,172520,0,2,4
49263,4,2,172522,172522,172524,0,2,2
49264,6,3,172528,172528,172531,0,3,4
49265,3,3,172531,172531,172534,0,3,0
49266,3,1,172534,172534,172535,0,1,0
49267,5,2,172539,172539,172541,0,2,4
49268,4,2,172543,172543,172545,0,2,2
49269,1,1,172544,172545,172546,1,2,0
49270,3,1,172547,172547,172548,0,1,1
49271,5,3,172552,172552,172555,0,3,4
49272,2,3,172554,172555,172558,1,4,0
49273,6,1,172560,172560,172561,0,1,2
49274,5,3,172565,172565,172568,0,3,4
49275,4,3,172569,172569,172572,0,3,1
49276,6,3,172575,172575,172578,0,3,3
49277,2,1,172577,172578,172579,1,2,0
49278,3,1,172580,172580,172581,0,1,1
49279,1,3,172581,172581,172584,0,3,0
49280,5,1,172586,172586,172587,0,1,2
49281,5,3,172591,172591,172594,0,3,4
49282,3,1,172594,172594,172595,0,1,0
49283,6,1,172600,172600,172601,0,1,5
49284,5,2,172605,172605,172607,0,2,4
49285,3,1,172608,172608,172609,0,1,1
49286,5,3,172613,172613,172616,0,3,4
49287,1,1,172614,172616,172617,2,3,0
49288,2,1,172616,172617,172618,1,2,0
49289,4,3,172620,172620,172623,0,3,2
49290,2,2,172622,172623,172625,1,3,0
49291,3,2,172625,172625,172627,0,2,0
49292,1,3,172626,172627,172630,1,4,0
49293,6,1,172632,172632,172633,0,1,2
49294,1,3,172633,172633,172636,0,3,0
49295,6,1,172639,172639,172640,0,1,3
49296,1,3,172640,172640,172643,0,3,0
49297,3,1,172643,172643,172644,0,1,0
49298,4,2,172647,172647,172649,0,2,3
49299,2,1,172649,172649,172650,0,1,0
49300,2,3,172651,172651,172654,0,3,1
49301,5,1,172656,172656,172657,0,1,2
49302,1,3,172657,172657,172660,0,3,0
49303,6,3,172663,172663,172666,0,3,3
49304,5,3,172668,172668,172671,0,3,2
49305,5,2,172673,172673,172675,0,2,2
49306,6,2,172679,172679,172681,0,2,4
49307,2,1,172681,172681,172682,0,1,0
49308,1,3,172682,172682,172685,0,3,0
49309,3,3,172685,172685,172688,0,3,0
49310,5,1,172690,172690,172691,0,1,2
49311,3,1,172693,172693,172694,0,1,2
49312,2,1,172695,172695,172696,0,1,1
49313,5,3,172700,172700,172703,0,3,4
49314,6,1,172706,172706,172707,0,1,3
49315,3,1,172709,172709,172710,0,1,2
49316,4,1,172713,172713,172714,0,1,3
49317,5,3,172718,172718,172721,0,3,4
49318,4,2,172722,172722,172724,0,2,1
49319,3,2,172725,172725,172727,0,2,1
49320,4,1,172729,172729,172730,0,1,2
49321,5,3,172734,172734,172737,0,3,4
49322,3,1,172737,172737,172738,0,1,0
49323,2,3,172739,172739,172742,0,3,1
49324,2,2,172741,172742,172744,1,3,0
49325,2,3,172743,172744,172747,1,4,0
49326,5,3,172748,172748,172751,0,3,1
49327,3,1,172751,172751,172752,0,1,0
49328,1,2,172752,172752,172754,0,2,0
49329,3,3,172755,172755,172758,0,3,1
49330,3,2,172758,172758,172760,0,2,0
49331,6,1,172764,172764,172765,0,1,4
49332,1,3,172765,172765,172768,0,3,0
49333,3,1,172768,172768,172769,0,1,0
49334,6,1,172774,172774,172775,0,1,5
49335,6,2,172780,172780,172782,0,2,5
49336,6,1,172786,172786,172787,0,1,4
49337,4,1,172790,172790,172791,0,1,3
49338,2,2,172792,172792,172794,0,2,1
49339,2,1,172794,172794,172795,0,1,0
49340,6,3,172800,172800,172803,0,3,5
49341,2,1,172802,172803,172804,1,2,0
49342,3,2,172805,172805,172807,0,2,1
49343,1,2,172806,172807,172809,1,3,0
49344,2,3,172808,172809,172812,1,4,0
49345,2,2,172810,172812,172814,2,4,0
49346,4,1,172814,172814,172815,0,1,0
49347,5,1,172819,172819,172820,0,1,4
49348,3,3,172822,172822,172825,0,3,2
49349,2,3,172824,172825,172828,1,4,0
49350,5,3,172829,172829,172832,0,3,1
49351,5,3,172834,172834,172837,0,3,2
49352,4,2,172838,172838,172840,0,2,1
49353,3,1,172841,172841,172842,0,1,1
49354,5,1,172846,172846,172847,0,1,4
49355,5,2,172851,172851,172853,0,2,4
49356,3,1,172854,172854,172855,0,1,1
49357,4,3,172858,172858,172861,0,3,3
49358,1,3,172859,172861,172864,2,5,0
49359,4,1,172863,172864,172865,1,2,0
49360,6,3,172869,172869,172872,0,3,4
49361,4,1,172873,172873,172874,0,1,1
49362,4,2,172877,172877,172879,0,2,3
49363,1,3,172878,172879,172882,1,4,0
49364,5,2,172883,172883,172885,0,2,1
49365,3,3,172886,172886,172889,0,3,1
49366,2,2,172888,172889,172891,1,3,0
49367,3,3,172891,172891,172894,0,3,0
49368,6,2,172897,172897,172899,0,2,3
49369,4,3,172901,172901,172904,0,3,2
49370,1,2,172902,172904,172906,2,4,0
49371,6,2,172908,172908,172910,0,2,2
49372,1,1,172909,172910,172911,1,2,0
49373,6,1,172915,172915,172916,0,1,4
49374,1,2,172916,172916,172918,0,2,0
49375,5,2,172921,172921,172923,0,2,3
49376,3,3,172924,172924,172927,0,3,1
49377,2,3,172926,172927,172930,1,4,0
49378,3,3,172929,172930,172933,1,4,0
49379,5,2,172934,172934,172936,0,2,1
49380,1,3,172935,172936,172939,1,4,0
49381,5,1,172940,172940,172941,0,1,1
49382,4,2,172944,172944,172946,0,2,3
49383,6,2,172950,172950,172952,0,2,4
49384,2,1,172952,172952,172953,0,1,0
49385,4,1,172956,172956,172957,0,1,3
49386,2,1,172958,172958,172959,0,1,1
49387,1,1,172959,172959,172960,0,1,0
49388,6,3,172965,172965,172968,0,3,5
49389,5,2,172970,172970,172972,0,2,2
49390,1,3,172971,172972,172975,1,4,0
49391,3,1,172974,172975,172976,1,2,0
49392,1,2,172975,172976,172978,1,3,0
49393,6,2,172981,172981,172983,0,2,3
49394,3,1,172984,172984,172985,0,1,1
49395,2,2,172986,172986,172988,0,2,1
49396,6,2,172992,172992,172994,0,2,4
49397,3,3,172995,172995,172998,0,3,1
49398,1,1,172996,172998,172999,2,3,0
49399,4,3,173000,173000,173003,0,3,1
49400,4,3,173004,173004,173007,0,3,1
49401,6,3,173010,173010,173013,0,3,3
49402,5,2,173015,173015,173017,0,2,2
49403,2,2,173017,173017,173019,0,2,0
49404,1,1,173018,173019,173020,1,2,0
49405,2,2,173020,173020,173022,0,2,0
49406,3,1,173023,173023,173024,0,1,1
49407,5,2,173028,173028,173030,0,2,4
49408,6,3,173034,173034,173037,0,3,4
49409,4,2,173038,173038,173040,0,2,1
49410,5,3,173043,173043,173046,0,3,3
49411,6,1,173049,173049,173050,0,1,3
49412,6,2,173055,173055,173057,0,2,5
49413,5,2,173060,173060,173062,0,2,3
49414,6,1,173066,173066,173067,0,1,4
49415,4,2,173070,173070,173072,0,2,3
49416,4,3,173074,173074,173077,0,3,2
49417,4,2,173078,173078,173080,0,2,1
49418,1,2,173079,173080,173082,1,3,0
49419,1,3,173080,173082,173085,2,5,0
49420,5,3,173085,173085,173088,0,3,0
49421,1,3,173086,173088,173091,2,5,0
49422,1,3,173087,173091,173094,4,7,0
49423,5,1,173092,173094,173095,2,3,0
49424,5,3,173097,173097,173100,0,3,2
49425,3,3,173100,173100,173103,0,3,0
49426,4,3,173104,173104,173107,0,3,1
49427,2,2,173106,173107,173109,1,3,0
49428,2,3,173108,173109,173112,1,4,0
49429,3,2,173111,173112,173114,1,3,0
49430,4,2,173115,173115,173117,0,2,1
49431,1,1,173116,173117,173118,1,2,0
49432,5,1,173121,173121,173122,0,1,3
49433,1,3,173122,173122,173125,0,3,0
49434,2,3,173124,173125,173128,1,4,0
49435,5,1,173129,173129,173130,0,1,1
49436,2,3,173131,173131,173134,0,3,1
49437,1,2,173132,173134,173136,2,4,0
49438,4,2,173136,173136,173138,0,2,0
49439,3,1,173139,173139,173140,0,1,1
49440,4,2,173143,173143,173145,0,2,3
49441,5,2,173148,173148,173150,0,2,3
49442,5,1,173153,173153,173154,0,1,3
49443,2,3,173155,173155,173158,0,3,1
49444,5,3,173160,173160,173163,0,3,2
49445,6,1,173166,173166,173167,0,1,3
49446,1,2,173167,173167,173169,0,2,0
49447,1,1,173168,173169,173170,1,2,0
49448,4,3,173172,173172,173175,0,3,2
49449,1,2,173173,173175,173177,2,4,0
49450,4,2,173177,173177,173179,0,2,0
49451,3,2,173180,173180,173182,0,2,1
49452,2,1,173182,173182,173183,0,1,0
49453,3,2,173185,173185,173187,0,2,2
49454,1,2,173186,173187,173189,1,3,0
49455,1,3,173187,173189,173192,2,5,0
49456,2,3,173189,173192,173195,3,6,0
49457,5,2,173194,173195,173197,1,3,0
49458,4,1,173198,173198,173199,0,1,1
49459,4,3,173202,173202,173205,0,3,3
49460,1,2,173203,173205,173207,2,4,0
49461,5,2,173208,173208,173210,0,2,1
49462,6,2,173214,173214,173216,0,2,4
49463,5,3,173219,173219,173222,0,3,3
49464,6,3,173225,173225,173228,0,3,3
49465,5,2,173230,173230,173232,0,2,2
49466,3,3,173233,173233,173236,0,3,1
49467,4,3,173237,173237,173240,0,3,1
49468,2,3,173239,173240,173243,1,4,0
49469,2,2,173241,173243,173245,2,4,0
49470,4,1,173245,173245,173246,0,1,0
49471,6,3,173251,173251,173254,0,3,5
49472,3,1,173254,173254,173255,0,1,0
49473,1,3,173255,173255,173258,0,3,0
49474,1,1,173256,173258,173259,2,3,0
49475,5,2,173261,173261,173263,0,2,2
49476,3,1,173264,173264,173265,0,1,1
49477,5,3,173269,173269,173272,0,3,4
49478,6,2,173275,173275,173277,0,2,3
49479,3,1,173278,173278,173279,0,1,1
49480,6,2,173284,173284,173286,0,2,5
49481,6,3,173290,173290,173293,0,3,4
49482,4,2,173294,173294,173296,0,2,1
49483,5,1,173299,173299,173300,0,1,3
49484,1,3,173300,173300,173303,0,3,0
49485,1,3,173301,173303,173306,2,5,0
49486,6,2,173307,173307,173309,0,2,1
49487,1,1,173308,173309,173310,1,2,0
49488,4,1,173312,173312,173313,0,1,2
49489,5,2,173317,173317,173319,0,2,4
49490,6,3,173323,173323,173326,0,3,4
49491,6,2,173329,173329,173331,0,2,3
49492,4,2,173333,173333,173335,0,2,2
49493,6,3,173339,173339,173342,0,3,4
49494,5,3,173344,173344,173347,0,3,2
49495,3,1,173347,173347,173348,0,1,0
49496,5,3,173352,173352,173355,0,3,4
49497,6,2,173358,173358,173360,0,2,3
49498,2,2,173360,173360,173362,0,2,0
49499,3,2,173363,173363,173365,0,2,1
49500,6,3,173369,173369,173372,0,3,4
49501,5,3,173374,173374,173377,0,3,2
49502,5,2,173379,173379,173381,0,2,2
49503,5,2,173384,173384,173386,0,2,3
49504,3,2,173387,173387,173389,0,2,1
49505,3,3,173390,173390,173393,0,3,1
49506,2,3,173392,173393,173396,1,4,0
49507,2,2,173394,173396,173398,2,4,0
49508,3,3,173397,173398,173401,1,4,0
49509,6,3,173403,173403,173406,0,3,2
49510,1,3,173404,173406,173409,2,5,0
49511,3,2,173407,173409,173411,2,4,0
49512,3,1,173410,173411,173412,1,2,0
49513,6,1,173416,173416,173417,0,1,4
49514,5,2,173421,173421,173423,0,2,4
49515,4,3,173425,173425,173428,0,3,2
49516,5,3,173430,173430,173433,0,3,2
49517,2,2,173432,173433,173435,1,3,0
49518,3,1,173435,173435,173436,0,1,0
49519,2,1,173437,173437,173438,0,1,1
49520,4,1,173441,173441,173442,0,1,3
49521,4,3,173445,173445,173448,0,3,3
49522,1,1,173446,173448,173449,2,3,0
49523,1,3,173447,173449,173452,2,5,0
49524,6,3,173453,173453,173456,0,3,1
49525,2,3,173455,173456,173459,1,4,0
49526,3,1,173458,173459,173460,1,2,0
49527,3,3,173461,173461,173464,0,3,1
49528,1,2,173462,173464,173466,2,4,0
49529,6,1,173468,173468,173469,0,1,2
49530,2,1,173470,173470,173471,0,1,1
49531,4,1,173474,173474,173475,0,1,3
49532,3,3,173477,173477,173480,0,3,2
49533,6,2,173483,173483,173485,0,2,3
49534,4,3,173487,173487,173490,0,3,2
49535,1,1,173488,173490,173491,2,3,0
49536,5,2,173493,173493,173495,0,2,2
49537,6,3,173499,173499,173502,0,3,4
49538,4,3,173503,173503,173506,0,3,1
49539,1,2,173504,173506,173508,2,4,0
49540,2,2,173506,173508,173510,2,4,0
49541,5,1,173511,173511,173512,0,1,1
49542,1,2,173512,173512,173514,0,2,0
49543,6,3,173518,173518,173521,0,3,4
49544,2,2,173520,173521,173523,1,3,0
49545,3,1,173523,173523,173524,0,1,0
49546,6,2,173529,173529,173531,0,2,5
49547,1,3,173530,173531,173534,1,4,0
49548,2,2,173532,173534,173536,2,4,0
49549,2,1,173534,173536,173537,2,3,0
49550,5,2,173539,173539,173541,0,2,2
49551,6,3,173545,173545,173548,0,3,4
49552,3,2,173548,173548,173550,0,2,0
49553,4,1,173552,173552,173553,0,1,2
49554,3,1,173555,173555,173556,0,1,2
49555,3,2,173558,173558,173560,0,2,2
49556,1,1,173559,173560,173561,1,2,0
49557,5,3,173564,173564,173567,0,3,3
49558,6,3,173570,173570,173573,0,3,3
49559,3,1,173573,173573,173574,0,1,0
49560,2,3,173575,173575,173578,0,3,1
49561,2,2,173577,173578,173580,1,3,0
49562,3,3,173580,173580,173583,0,3,0
49563,1,2,173581,173583,173585,2,4,0
49564,2,3,173583,173585,173588,2,5,0
49565,3,2,173586,173588,173590,2,4,0
49566,4,1,173590,173590,173591,0,1,0
49567,3,2,173593,173593,173595,0,2,2
49568,2,2,173595,173595,173597,0,2,0
49569,6,2,173601,173601,173603,0,2,4
49570,2,2,173603,173603,173605,0,2,0
49571,5,3,173608,173608,173611,0,3,3
49572,3,3,173611,173611,173614,0,3,0
49573,4,2,173615,173615,173617,0,2,1
49574,2,2,173617,173617,173619,0,2,0
49575,6,3,173623,173623,173626,0,3,4
49576,6,3,173629,173629,173632,0,3,3
49577,2,1,173631,173632,173633,1,2,0
49578,4,1,173635,173635,173636,0,1,2
49579,1,1,173636,173636,173637,0,1,0
49580,2,2,173638,173638,173640,0,2,1
49581,2,2,173640,173640,173642,0,2,0
49582,2,3,173642,173642,173645,0,3,0
49583,5,1,173647,173647,173648,0,1,2
49584,3,2,173650,173650,173652,0,2,2
49585,1,2,173651,173652,173654,1,3,0
49586,6,1,173657,173657,173658,0,1,3
49587,5,3,173662,173662,173665,0,3,4
49588,3,1,173665,173665,173666,0,1,0
49589,3,2,173668,173668,173670,0,2,2
49590,6,3,173674,173674,173677,0,3,4
49591,6,3,173680,173680,173683,0,3,3
49592,1,1,173681,173683,173684,2,3,0
49593,6,3,173687,173687,173690,0,3,3
49594,5,2,173692,173692,173694,0,2,2
49595,5,1,173697,173697,173698,0,1,3
49596,6,2,173703,173703,173705,0,2,5
49597,3,3,173706,173706,173709,0,3,1
49598,2,3,173708,173709,173712,1,4,0
49599,2,2,173710,173712,173714,2,4,0
49600,5,3,173715,173715,173718,0,3,1
49601,5,3,173720,173720,173723,0,3,2
49602,1,3,173721,173723,173726,2,5,0
49603,2,1,173723,173726,173727,3,4,0
49604,2,3,173725,173727,173730,2,5,0
49605,5,1,173730,173730,173731,0,1,0
49606,4,2,173734,173734,173736,0,2,3
49607,1,1,173735,173736,173737,1,2,0
49608,4,2,173739,173739,173741,0,2,2
49609,1,1,173740,173741,173742,1,2,0
49610,4,3,173744,173744,173747,0,3,2
49611,3,2,173747,173747,173749,0,2,0
49612,5,1,173752,173752,173753,0,1,3
49613,1,3,173753,173753,173756,0,3,0
49614,2,2,173755,173756,173758,1,3,0
49615,2,3,173757,173758,173761,1,4,0
49616,1,3,173758,173761,173764,3,6,0
49617,2,1,173760,173764,173765,4,5,0
49618,6,2,173766,173766,173768,0,2,1
49619,5,1,173771,173771,173772,0,1,3
49620,6,2,173777,173777,173779,0,2,5
49621,2,2,173779,173779,173781,0,2,0
49622,4,1,173783,173783,173784,0,1,2
49623,5,3,173788,173788,173791,0,3,4
49624,5,1,173793,173793,173794,0,1,2
49625,1,3,173794,173794,173797,0,3,0
49626,6,2,173800,173800,173802,0,2,3
49627,3,1,173803,173803,173804,0,1,1
49628,1,1,173804,173804,173805,0,1,0
49629,5,3,173809,173809,173812,0,3,4
49630,3,2,173812,173812,173814,0,2,0
49631,1,3,173813,173814,173817,1,4,0
49632,1,3,173814,173817,173820,3,6,0
49633,4,1,173818,173820,173821,2,3,0
49634,1,3,173819,173821,173824,2,5,0
49635,2,3,173821,173824,173827,3,6,0
49636,6,2,173827,173827,173829,0,2,0
49637,1,1,173828,173829,173830,1,2,0
49638,4,2,173832,173832,173834,0,2,2
49639,1,3,173833,173834,173837,1,4,0
49640,6,3,173839,173839,173842,0,3,2
49641,5,1,173844,173844,173845,0,1,2
49642,4,2,173848,173848,173850,0,2,3
49643,2,3,173850,173850,173853,0,3,0
49644,6,1,173856,173856,173857,0,1,3
49645,5,2,173861,173861,173863,0,2,4
49646,3,3,173864,173864,173867,0,3,1
49647,5,1,173869,173869,173870,0,1,2
49648,1,2,173870,173870,173872,0,2,0
49649,6,2,173876,173876,173878,0,2,4
49650,6,2,173882,173882,173884,0,2,4
49651,2,1,173884,173884,173885,0,1,0
49652,2,2,173886,173886,173888,0,2,1
49653,1,1,173887,173888,173889,1,2,0
49654,5,1,173892,173892,173893,0,1,3
49655,4,3,173896,173896,173899,0,3,3
49656,4,2,173900,173900,173902,0,2,1
49657,6,1,173906,173906,173907,0,1,4
49658,1,1,173907,173907,173908,0,1,0
49659,3,2,173910,173910,173912,0,2,2
49660,1,1,173911,173912,173913,1,2,0
49661,5,1,173916,173916,173917,0,1,3
49662,3,1,173919,173919,173920,0,1,2
49663,4,3,173923,173923,173926,0,3,3
49664,3,1,173926,173926,173927,0,1,0
49665,5,3,173931,173931,173934,0,3,4
49666,4,3,173935,173935,173938,0,3,1
49667,1,2,173936,173938,173940,2,4,0
49668,3,2,173939,173940,173942,1,3,0
49669,2,3,173941,173942,173945,1,4,0
49670,5,3,173946,173946,173949,0,3,1
49671,5,1,173951,173951,173952,0,1,2
49672,1,1,173952,173952,173953,0,1,0
49673,2,1,173954,173954,173955,0,1,1
49674,1,1,173955,173955,173956,0,1,0
49675,5,2,173960,173960,173962,0,2,4
49676,6,2,173966,173966,173968,0,2,4
49677,1,1,173967,173968,173969,1,2,0
49678,6,3,173973,173973,173976,0,3,4
49679,2,3,173975,173976,173979,1,4,0
49680,3,2,173978,173979,173981,1,3,0
49681,4,3,173982,173982,173985,0,3,1
49682,1,2,173983,173985,173987,2,4,0
49683,4,1,173987,173987,173988,0,1,0
49684,6,1,173993,173993,173994,0,1,5
49685,5,3,173998,173998,174001,0,3,4
49686,3,3,174001,174001,174004,0,3,0
49687,3,2,174004,174004,174006,0,2,0
49688,3,1,174007,174007,174008,0,1,1
49689,2,1,174009,174009,174010,0,1,1
49690,6,3,174015,174015,174018,0,3,5
49691,5,2,174020,174020,174022,0,2,2
49692,2,2,174022,174022,174024,0,2,0
49693,2,2,174024,174024,174026,0,2,0
49694,3,3,174027,174027,174030,0,3,1
49695,6,1,174033,174033,174034,0,1,3
49696,5,1,174038,174038,174039,0,1,4
49697,4,1,174042,174042,174043,0,1,3
49698,6,2,174048,174048,174050,0,2,5
49699,1,1,174049,174050,174051,1,2,0
49700,1,1,174050,174051,174052,1,2,0
49701,2,2,174052,174052,174054,0,2,0
49702,4,3,174056,174056,174059,0,3,2
49703,4,2,174060,174060,174062,0,2,1
49704,5,1,174065,174065,174066,0,1,3
49705,5,1,174070,174070,174071,0,1,4
49706,6,3,174076,174076,174079,0,3,5
49707,3,1,174079,174079,174080,0,1,0
49708,6,3,174085,174085,174088,0,3,5
49709,4,2,174089,174089,174091,0,2,1
49710,3,3,174092,174092,174095,0,3,1
49711,3,1,174095,174095,174096,0,1,0
49712,6,3,174101,174101,174104,0,3,5
49713,3,3,174104,174104,174107,0,3,0
49714,4,2,174108,174108,174110,0,2,1
49715,2,3,174110,174110,174113,0,3,0
49716,3,3,174113,174113,174116,0,3,0
49717,1,1,174114,174116,174117,2,3,0
49718,3,2,174117,174117,174119,0,2,0
49719,1,1,174118,174119,174120,1,2,0
49720,2,1,174120,174120,174121,0,1,0
49721,5,3,174125,174125,174128,0,3,4
49722,6,1,174131,174131,174132,0,1,3
49723,4,3,174135,174135,174138,0,3,3
49724,6,1,174141,174141,174142,0,1,3
49725,4,1,174145,174145,174146,0,1,3
49726,3,3,174148,174148,174151,0,3,2
49727,6,1,174154,174154,174155,0,1,3
49728,2,2,174156,174156,174158,0,2,1
49729,4,1,174160,174160,174161,0,1,2
49730,5,1,174165,174165,174166,0,1,4
49731,4,1,174169,174169,174170,0,1,3
49732,2,2,174171,174171,174173,0,2,1
49733,4,2,174175,174175,174177,0,2,2
49734,2,1,174177,174177,174178,0,1,0
49735,4,3,174181,174181,174184,0,3,3
49736,3,2,174184,174184,174186,0,2,0
49737,2,2,174186,174186,174188,0,2,0
49738,5,3,174191,174191,174194,0,3,3
49739,1,3,174192,174194,174197,2,5,0
49740,5,3,174197,174197,174200,0,3,0
49741,5,3,174202,174202,174205,0,3,2
49742,1,2,174203,174205,174207,2,4,0
49743,1,3,174204,174207,174210,3,6,0
49744,5,2,174209,174210,174212,1,3,0
49745,5,2,174214,174214,174216,0,2,2
49746,2,2,174216,174216,174218,0,2,0
49747,6,2,174222,174222,174224,0,2,4
49748,5,1,174227,174227,174228,0,1,3
49749,1,1,174228,174228,174229,0,1,0
49750,5,2,174233,174233,174235,0,2,4
49751,6,1,174239,174239,174240,0,1,4
49752,2,2,174241,174241,174243,0,2,1
49753,2,1,174243,174243,174244,0,1,0
49754,2,3,174245,174245,174248,0,3,1
49755,2,2,174247,174248,174250,1,3,0
49756,3,1,174250,174250,174251,0,1,0
49757,1,3,174251,174251,174254,0,3,0
49758,5,2,174256,174256,174258,0,2,2
49759,1,3,174257,174258,174261,1,4,0
49760,5,3,174262,174262,174265,0,3,1
49761,1,3,174263,174265,174268,2,5,0
49762,2,2,174265,174268,174270,3,5,0
49763,2,1,174267,174270,174271,3,4,0
49764,6,1,174273,174273,174274,0,1,2
49765,4,2,174277,174277,174279,0,2,3
49766,5,2,174282,174282,174284,0,2,3
49767,4,3,174286,174286,174289,0,3,2
49768,5,3,174291,174291,174294,0,3,2
49769,6,2,174297,174297,174299,0,2,3
49770,6,3,174303,174303,174306,0,3,4
49771,6,3,174309,174309,174312,0,3,3
49772,4,2,174313,174313,174315,0,2,1
49773,3,2,174316,174316,174318,0,2,1
49774,5,2,174321,174321,174323,0,2,3
49775,1,2,174322,174323,174325,1,3,0
49776,6,2,174328,174328,174330,0,2,3
49777,5,1,174333,174333,174334,0,1,3
49778,6,1,174339,174339,174340,0,1,5
49779,6,1,174345,174345,174346,0,1,5
49780,6,2,174351,174351,174353,0,2,5
49781,2,2,174353,174353,174355,0,2,0
49782,3,1,174356,174356,174357,0,1,1
49783,6,3,174362,174362,174365,0,3,5
49784,6,1,174368,174368,174369,0,1,3
49785,4,3,174372,174372,174375,0,3,3
49786,4,3,174376,174376,174379,0,3,1
49787,2,3,174378,174379,174382,1,4,0
49788,3,1,174381,174382,174383,1,2,0
49789,6,3,174387,174387,174390,0,3,4
49790,1,2,174388,174390,174392,2,4,0
49791,6,1,174394,174394,174395,0,1,2
49792,6,3,174400,174400,174403,0,3,5
49793,5,2,174405,174405,174407,0,2,2
49794,2,2,174407,174407,174409,0,2,0
49795,4,2,174411,174411,174413,0,2,2
49796,4,3,174415,174415,174418,0,3,2
49797,2,1,174417,174418,174419,1,2,0
49798,5,1,174422,174422,174423,0,1,3
49799,1,2,174423,174423,174425,0,2,0
49800,6,1,174429,174429,174430,0,1,4
49801,4,1,174433,174433,174434,0,1,3
49802,4,2,174437,174437,174439,0,2,3
49803,4,2,174441,174441,174443,0,2,2
49804,2,2,174443,174443,174445,0,2,0
49805,5,2,174448,174448,174450,0,2,3
49806,6,1,174454,174454,174455,0,1,4
49807,2,2,174456,174456,174458,0,2,1
49808,3,2,174459,174459,174461,0,2,1
49809,6,2,174465,174465,174467,0,2,4
49810,2,3,174467,174467,174470,0,3,0
49811,3,2,174470,174470,174472,0,2,0
49812,5,3,174475,174475,174478,0,3,3
49813,6,3,174481,174481,174484,0,3,3
49814,2,3,174483,174484,174487,1,4,0
49815,4,2,174487,174487,174489,0,2,0
49816,6,1,174493,174493,174494,0,1,4
49817,1,3,174494,174494,174497,0,3,0
49818,6,3,174500,174500,174503,0,3,3
49819,1,2,174501,174503,174505,2,4,0
49820,6,1,174507,174507,174508,0,1,2
49821,2,3,174509,174509,174512,0,3,1
49822,3,3,174512,174512,174515,0,3,0
49823,1,1,174513,174515,174516,2,3,0
49824,6,1,174519,174519,174520,0,1,3
49825,5,3,174524,174524,174527,0,3,4
49826,5,3,174529,174529,174532,0,3,2
49827,5,1,174534,174534,174535,0,1,2
49828,6,1,174540,174540,174541,0,1,5
49829,4,2,174544,174544,174546,0,2,3
49830,5,1,174549,174549,174550,0,1,3
49831,1,3,174550,174550,174553,0,3,0
49832,3,3,174553,174553,174556,0,3,0
49833,5,2,174558,174558,174560,0,2,2
49834,3,2,174561,174561,174563,0,2,1
49835,3,2,174564,174564,174566,0,2,1
49836,3,1,174567,174567,174568,0,1,1
49837,1,3,174568,174568,174571,0,3,0
49838,1,1,174569,174571,174572,2,3,0
49839,4,3,174573,174573,174576,0,3,1
49840,5,2,174578,174578,174580,0,2,2
49841,5,1,174583,174583,174584,0,1,3
49842,1,3,174584,174584,174587,0,3,0
49843,3,3,174587,174587,174590,0,3,0
49844,6,2,174593,174593,174595,0,2,3
49845,3,1,174596,174596,174597,0,1,1
49846,2,3,174598,174598,174601,0,3,1
49847,1,1,174599,174601,174602,2,3,0
49848,6,3,174605,174605,174608,0,3,3
49849,1,3,174606,174608,174611,2,5,0
49850,1,1,174607,174611,174612,4,5,0
49851,5,1,174612,174612,174613,0,1,0
49852,1,1,174613,174613,174614,0,1,0
49853,6,1,174619,174619,174620,0,1,5
49854,5,1,174624,174624,174625,0,1,4
49855,4,2,174628,174628,174630,0,2,3
49856,3,1,174631,174631,174632,0,1,1
49857,3,1,174634,174634,174635,0,1,2
49858,4,2,174638,174638,174640,0,2,3
49859,5,2,174643,174643,174645,0,2,3
49860,3,2,174646,174646,174648,0,2,1
49861,4,1,174650,174650,174651,0,1,2
49862,4,1,174654,174654,174655,0,1,3
49863,2,1,174656,174656,174657,0,1,1
49864,6,1,174662,174662,174663,0,1,5
49865,2,3,174664,174664,174667,0,3,1
49866,2,1,174666,174667,174668,1,2,0
49867,1,1,174667,174668,174669,1,2,0
49868,3,3,174670,174670,174673,0,3,1
49869,6,2,174676,174676,174678,0,2,3
49870,5,3,174681,174681,174684,0,3,3
49871,2,2,174683,174684,174686,1,3,0
49872,5,2,174688,174688,174690,0,2,2
49873,6,3,174694,174694,174697,0,3,4
49874,6,1,174700,174700,174701,0,1,3
49875,2,1,174702,174702,174703,0,1,1
49876,4,3,174706,174706,174709,0,3,3
49877,3,2,174709,174709,174711,0,2,0
49878,5,1,174714,174714,174715,0,1,3
49879,3,2,174717,174717,174719,0,2,2
49880,1,2,174718,174719,174721,1,3,0
49881,3,3,174721,174721,174724,0,3,0
49882,1,3,174722,174724,174727,2,5,0
49883,1,1,174723,174727,174728,4,5,0
49884,1,1,174724,174728,174729,4,5,0
49885,4,1,174728,174729,174730,1,2,0
49886,2,3,174730,174730,174733,0,3,0
49887,5,3,174735,174735,174738,0,3,2
49888,6,1,174741,174741,174742,0,1,3
49889,5,2,174746,174746,174748,0,2,4
49890,2,2,174748,174748,174750,0,2,0
49891,6,2,174754,174754,174756,0,2,4
49892,6,3,174760,174760,174763,0,3,4
49893,2,2,174762,174763,174765,1,3,0
49894,1,2,174763,174765,174767,2,4,0
49895,2,3,174765,174767,174770,2,5,0
49896,1,3,174766,174770,174773,4,7,0
49897,6,1,174772,174773,174774,1,2,0
49898,2,3,174774,174774,174777,0,3,0
49899,6,1,174780,174780,174781,0,1,3
49900,6,1,174786,174786,174787,0,1,5
49901,1,1,174787,174787,174788,0,1,0
49902,6,3,174793,174793,174796,0,3,5
49903,3,1,174796,174796,174797,0,1,0
49904,4,3,174800,174800,174803,0,3,3
49905,3,1,174803,174803,174804,0,1,0
49906,1,2,174804,174804,174806,0,2,0
49907,3,3,174807,174807,174810,0,3,1
49908,2,3,174809,174810,174813,1,4,0
49909,6,3,174815,174815,174818,0,3,2
49910,4,2,174819,174819,174821,0,2,1
49911,6,3,174825,174825,174828,0,3,4
49912,4,3,174829,174829,174832,0,3,1
49913,4,1,174833,174833,174834,0,1,1
49914,4,1,174837,174837,174838,0,1,3
49915,4,3,174841,174841,174844,0,3,3
49916,4,2,174845,174845,174847,0,2,1
49917,6,3,174851,174851,174854,0,3,4
49918,4,3,174855,174855,174858,0,3,1
49919,1,3,174856,174858,174861,2,5,0
49920,2,3,174858,174861,174864,3,6,0
49921,3,2,174861,174864,174866,3,5,0
49922,6,2,174867,174867,174869,0,2,1
49923,5,2,174872,174872,174874,0,2,3
49924,6,3,174878,174878,174881,0,3,4
49925,6,1,174884,174884,174885,0,1,3
49926,6,2,174890,174890,174892,0,2,5
49927,3,2,174893,174893,174895,0,2,1
49928,4,1,174897,174897,174898,0,1,2
49929,4,1,174901,174901,174902,0,1,3
49930,6,3,174907,174907,174910,0,3,5
49931,1,2,174908,174910,174912,2,4,0
49932,6,2,174914,174914,174916,0,2,2
49933,1,1,174915,174916,174917,1,2,0
49934,6,3,174921,174921,174924,0,3,4
49935,2,2,174923,174924,174926,1,3,0
49936,5,1,174928,174928,174929,0,1,2
49937,5,1,174933,174933,174934,0,1,4
49938,4,3,174937,174937,174940,0,3,3
49939,2,1,174939,174940,174941,1,2,0
49940,1,3,174940,174941,174944,1,4,0
49941,3,1,174943,174944,174945,1,2,0
49942,3,3,174946,174946,174949,0,3,1
49943,6,2,174952,174952,174954,0,2,3
49944,4,3,174956,174956,174959,0,3,2
49945,4,2,174960,174960,174962,0,2,1
49946,1,1,174961,174962,174963,1,2,0
49947,1,1,174962,174963,174964,1,2,0
49948,4,1,174966,174966,174967,0,1,2
49949,2,2,174968,174968,174970,0,2,1
49950,4,2,174972,174972,174974,0,2,2
49951,6,1,174978,174978,174979,0,1,4
49952,2,1,174980,174980,174981,0,1,1
49953,4,2,174984,174984,174986,0,2,3
49954,3,3,174987,174987,174990,0,3,1
49955,6,2,174993,174993,174995,0,2,3
49956,1,3,174994,174995,174998,1,4,0
49957,5,1,174999,174999,175000,0,1,1
49958,3,2,175002,175002,175004,0,2,2
49959,3,3,175005,175005,175008,0,3,1
49960,2,3,175007,175008,175011,1,4,0
49961,3,1,175010,175011,175012,1,2,0
49962,1,2,175011,175012,175014,1,3,0
49963,4,3,175015,175015,175018,0,3,1
49964,2,1,175017,175018,175019,1,2,0
49965,1,2,175018,175019,175021,1,3,0
49966,2,3,175020,175021,175024,1,4,0
49967,4,3,175024,175024,175027,0,3,0
49968,1,3,175025,175027,175030,2,5,0
49969,6,2,175031,175031,175033,0,2,1
49970,5,2,175036,175036,175038,0,2,3
49971,5,2,175041,175041,175043,0,2,3
49972,3,2,175044,175044,175046,0,2,1
49973,1,3,175045,175046,175049,1,4,0
49974,1,2,175046,175049,175051,3,5,0
49975,6,3,175052,175052,175055,0,3,1
49976,6,3,175058,175058,175061,0,3,3
49977,6,3,175064,175064,175067,0,3,3
49978,2,3,175066,175067,175070,1,4,0
49979,5,1,175071,175071,175072,0,1,1
49980,6,3,175077,175077,175080,0,3,5
49981,6,3,175083,175083,175086,0,3,3
49982,2,2,175085,175086,175088,1,3,0
49983,5,2,175090,175090,175092,0,2,2
49984,6,3,175096,175096,175099,0,3,4
49985,2,2,175098,175099,175101,1,3,0
49986,6,2,175104,175104,175106,0,2,3
49987,4,3,175108,175108,175111,0,3,2
49988,5,3,175113,175113,175116,0,3,2
49989,5,1,175118,175118,175119,0,1,2
49990,5,1,175123,175123,175124,0,1,4
49991,1,1,175124,175124,175125,0,1,0
49992,4,2,175128,175128,175130,0,2,3
49993,2,1,175130,175130,175131,0,1,0
49994,6,2,175136,175136,175138,0,2,5
49995,1,2,175137,175138,175140,1,3,0
49996,2,3,175139,175140,175143,1,4,0
49997,1,3,175140,175143,175146,3,6,0
49998,3,3,175143,175146,175149,3,6,0
49999,5,1,175148,175149,175150,1,2,0
50000,3,3,175151,175151,175154,0,3,1
50001,1,2,175152,175154,175156,2,4,0
50002,5,1,175157,175157,175158,0,1,1
50003,5,1,175162,175162,175163,0,1,4
50004,2,2,175164,175164,175166,0,2,1
50005,2,1,175166,175166,175167,0,1,0
50006,6,2,175172,175172,175174,0,2,5
50007,5,2,175177,175177,175179,0,2,3
50008,2,3,175179,175179,175182,0,3,0
50009,3,2,175182,175182,175184,0,2,0
50010,1,2,175183,175184,175186,1,3,0
50011,2,3,175185,175186,175189,1,4,0
50012,6,1,175191,175191,175192,0,1,2
50013,1,1,175192,175192,175193,0,1,0
50014,2,2,175194,175194,175196,0,2,1
50015,1,3,175195,175196,175199,1,4,0
50016,1,3,175196,175199,175202,3,6,0
50017,1,3,175197,175202,175205,5,8,0
50018,2,3,175199,175205,175208,6,9,0
50019,2,1,175201,175208,175209,7,8,0
50020,5,2,175206,175209,175211,3,5,0
50021,5,1,175211,175211,175212,0,1,0
50022,1,2,175212,175212,175214,0,2,0
50023,4,3,175216,175216,175219,0,3,2
50024,3,2,175219,175219,175221,0,2,0
50025,3,3,175222,175222,175225,0,3,1
50026,5,1,175227,175227,175228,0,1,2
50027,5,2,175232,175232,175234,0,2,4
50028,1,1,175233,175234,175235,1,2,0
50029,3,2,175236,175236,175238,0,2,1
50030,2,2,175238,175238,175240,0,2,0
50031,4,3,175242,175242,175245,0,3,2
50032,6,2,175248,175248,175250,0,2,3
50033,5,1,175253,175253,175254,0,1,3
50034,4,2,175257,175257,175259,0,2,3
50035,4,2,175261,175261,175263,0,2,2
50036,1,3,175262,175263,175266,1,4,0
50037,4,2,175266,175266,175268,0,2,0
50038,5,3,175271,175271,175274,0,3,3
50039,1,3,175272,175274,175277,2,5,0
50040,6,2,175278,175278,175280,0,2,1
50041,5,1,175283,175283,175284,0,1,3
50042,5,3,175288,175288,175291,0,3,4
50043,6,3,175294,175294,175297,0,3,3
50044,2,1,175296,175297,175298,1,2,0
50045,6,1,175302,175302,175303,0,1,4
50046,1,2,175303,175303,175305,0,2,0
50047,5,2,175308,175308,175310,0,2,3
50048,3,2,175311,175311,175313,0,2,1
50049,6,2,175317,175317,175319,0,2,4
50050,3,3,175320,175320,175323,0,3,1
50051,6,1,175326,175326,175327,0,1,3
50052,6,3,175332,175332,175335,0,3,5
50053,6,2,175338,175338,175340,0,2,3
50054,3,3,175341,175341,175344,0,3,1
50055,5,1,175346,175346,175347,0,1,2
50056,5,3,175351,175351,175354,0,3,4
50057,2,2,175353,175354,175356,1,3,0
50058,4,1,175357,175357,175358,0,1,1
50059,2,2,175359,175359,175361,0,2,1
50060,5,2,175364,175364,175366,0,2,3
50061,1,2,175365,175366,175368,1,3,0
50062,5,1,175370,175370,175371,0,1,2
50063,6,1,175376,175376,175377,0,1,5
50064,4,1,175380,175380,175381,0,1,3
50065,2,2,175382,175382,175384,0,2,1
50066,2,2,175384,175384,175386,0,2,0
50067,2,3,175386,175386,175389,0,3,0
50068,3,1,175389,175389,175390,0,1,0
50069,6,2,175395,175395,175397,0,2,5
50070,2,2,175397,175397,175399,0,2,0
50071,6,1,175403,175403,175404,0,1,4
50072,2,3,175405,175405,175408,0,3,1
50073,2,2,175407,175408,175410,1,3,0
50074,2,3,175409,175410,175413,1,4,0
50075,4,1,175413,175413,175414,0,1,0
50076,1,2,175414,175414,175416,0,2,0
50077,6,2,175420,175420,175422,0,2,4
50078,3,3,175423,175423,175426,0,3,1
50079,1,3,175424,175426,175429,2,5,0
50080,2,3,175426,175429,175432,3,6,0
50081,5,1,175431,175432,175433,1,2,0
50082,4,3,175435,175435,175438,0,3,2
50083,1,3,175436,175438,175441,2,5,0
50084,6,2,175442,175442,175444,0,2,1
50085,2,2,175444,175444,175446,0,2,0
50086,1,3,175445,175446,175449,1,4,0
50087,4,1,175449,175449,175450,0,1,0
50088,5,2,175454,175454,175456,0,2,4
50089,2,1,175456,175456,175457,0,1,0
50090,5,3,175461,175461,175464,0,3,4
50091,3,3,175464,175464,175467,0,3,0
50092,5,2,175469,175469,175471,0,2,2
50093,4,1,175473,175473,175474,0,1,2
50094,2,1,175475,175475,175476,0,1,1
50095,6,1,175481,175481,175482,0,1,5
50096,3,1,175484,175484,175485,0,1,2
50097,3,2,175487,175487,175489,0,2,2
50098,4,2,175491,175491,175493,0,2,2
50099,1,3,175492,175493,175496,1,4,0
50100,3,1,175495,175496,175497,1,2,0
50101,4,3,175499,175499,175502,0,3,2
50102,6,1,175505,175505,175506,0,1,3
50103,4,1,175509,175509,175510,0,1,3
50104,6,3,175515,175515,175518,0,3,5
50105,3,3,175518,175518,175521,0,3,0
50106,3,1,175521,175521,175522,0,1,0
50107,4,1,175525,175525,175526,0,1,3
50108,3,2,175528,175528,175530,0,2,2
50109,6,3,175534,175534,175537,0,3,4
50110,1,2,175535,175537,175539,2,4,0
50111,4,1,175539,175539,175540,0,1,0
50112,6,2,175545,175545,175547,0,2,5
50113,5,3,175550,175550,175553,0,3,3
50114,6,2,175556,175556,175558,0,2,3
50115,5,2,175561,175561,175563,0,2,3
50116,3,3,175564,175564,175567,0,3,1
50117,6,2,175570,175570,175572,0,2,3
50118,2,3,175572,175572,175575,0,3,0
50119,5,2,175577,175577,175579,0,2,2
50120,5,3,175582,175582,175585,0,3,3
50121,3,2,175585,175585,175587,0,2,0
50122,2,2,175587,175587,175589,0,2,0
50123,3,1,175590,175590,175591,0,1,1
50124,6,1,175596,175596,175597,0,1,5
50125,6,2,175602,175602,175604,0,2,5
50126,3,3,175605,175605,175608,0,3,1
50127,2,2,175607,175608,175610,1,3,0
50128,3,1,175610,175610,175611,0,1,0
50129,2,1,175612,175612,175613,0,1,1
50130,6,1,175618,175618,175619,0,1,5
50131,6,3,175624,175624,175627,0,3,5
50132,3,2,175627,175627,175629,0,2,0
50133,5,2,175632,175632,175634,0,2,3
50134,3,1,175635,175635,175636,0,1,1
50135,3,1,175638,175638,175639,0,1,2
50136,5,1,175643,175643,175644,0,1,4
50137,1,2,175644,175644,175646,0,2,0
50138,2,3,175646,175646,175649,0,3,0
50139,3,1,175649,175649,175650,0,1,0
50140,3,2,175652,175652,175654,0,2,2
50141,3,1,175655,175655,175656,0,1,1
50142,3,3,175658,175658,175661,0,3,2
50143,4,3,175662,175662,175665,0,3,1
50144,3,1,175665,175665,175666,0,1,0
50145,1,1,175666,175666,175667,0,1,0
50146,2,1,175668,175668,175669,0,1,1
50147,3,1,175671,175671,175672,0,1,2
50148,2,3,175673,175673,175676,0,3,1
50149,5,1,175678,175678,175679,0,1,2
50150,6,2,175684,175684,175686,0,2,5
50151,3,2,175687,175687,175689,0,2,1
50152,1,3,175688,175689,175692,1,4,0
50153,4,2,175692,175692,175694,0,2,0
50154,2,1,175694,175694,175695,0,1,0
50155,1,3,175695,175695,175698,0,3,0
50156,3,3,175698,175698,175701,0,3,0
50157,1,2,175699,175701,175703,2,4,0
50158,1,1,175700,175703,175704,3,4,0
50159,6,2,175706,175706,175708,0,2,2
50160,5,1,175711,175711,175712,0,1,3
50161,4,2,175715,175715,175717,0,2,3
50162,6,3,175721,175721,175724,0,3,4
50163,5,2,175726,175726,175728,0,2,2
50164,1,1,175727,175728,175729,1,2,0
50165,4,3,175731,175731,175734,0,3,2
50166,6,2,175737,175737,175739,0,2,3
50167,5,3,175742,175742,175745,0,3,3
50168,1,2,175743,175745,175747,2,4,0
50169,6,2,175749,175749,175751,0,2,2
50170,3,1,175752,175752,175753,0,1,1
50171,6,1,175758,175758,175759,0,1,5
50172,2,1,175760,175760,175761,0,1,1
50173,1,1,175761,175761,175762,0,1,0
50174,1,2,175762,175762,175764,0,2,0
50175,2,3,175764,175764,175767,0,3,0
50176,1,1,175765,175767,175768,2,3,0
50177,2,3,175767,175768,175771,1,4,0
50178,5,3,175772,175772,175775,0,3,1
50179,6,1,175778,175778,175779,0,1,3
50180,6,3,175784,175784,175787,0,3,5
50181,6,3,175790,175790,175793,0,3,3
50182,6,1,175796,175796,175797,0,1,3
50183,4,3,175800,175800,175803,0,3,3
50184,1,2,175801,175803,175805,2,4,0
50185,5,1,175806,175806,175807,0,1,1
50186,6,2,175812,175812,175814,0,2,5
50187,1,2,175813,175814,175816,1,3,0
50188,1,3,175814,175816,175819,2,5,0
50189,5,2,175819,175819,175821,0,2,0
50190,1,2,175820,175821,175823,1,3,0
50191,3,3,175823,175823,175826,0,3,0
50192,2,2,175825,175826,175828,1,3,0
50193,3,1,175828,175828,175829,0,1,0
50194,3,2,175831,175831,175833,0,2,2
50195,2,3,175833,175833,175836,0,3,0
50196,6,2,175839,175839,175841,0,2,3
50197,5,2,175844,175844,175846,0,2,3
50198,5,2,175849,175849,175851,0,2,3
50199,6,2,175855,175855,175857,0,2,4
50200,4,2,175859,175859,175861,0,2,2
50201,3,3,175862,175862,175865,0,3,1
50202,6,2,175868,175868,175870,0,2,3
50203,3,1,175871,175871,175872,0,1,1
50204,6,2,175877,175877,175879,0,2,5
50205,2,3,175879,175879,175882,0,3,0
50206,5,2,175884,175884,175886,0,2,2
50207,5,1,175889,175889,175890,0,1,3
50208,6,1,175895,175895,175896,0,1,5
50209,6,2,175901,175901,175903,0,2,5
50210,1,1,175902,175903,175904,1,2,0
50211,6,2,175908,175908,175910,0,2,4
50212,4,1,175912,175912,175913,0,1,2
50213,3,2,175915,175915,175917,0,2,2
50214,4,3,175919,175919,175922,0,3,2
50215,3,1,175922,175922,175923,0,1,0
50216,2,3,175924,175924,175927,0,3,1
50217,3,1,175927,175927,175928,0,1,0
50218,5,3,175932,175932,175935,0,3,4
50219,2,1,175934,175935,175936,1,2,0
50220,2,2,175936,175936,175938,0,2,0
50221,1,2,175937,175938,175940,1,3,0
50222,5,1,175942,175942,175943,0,1,2
50223,3,1,175945,175945,175946,0,1,2
50224,5,2,175950,175950,175952,0,2,4
50225,5,1,175955,175955,175956,0,1,3
50226,3,1,175958,175958,175959,0,1,2
50227,1,3,175959,175959,175962,0,3,0
50228,5,1,175964,175964,175965,0,1,2
50229,2,2,175966,175966,175968,0,2,1
50230,4,3,175970,175970,175973,0,3,2
50231,1,2,175971,175973,175975,2,4,0
50232,4,3,175975,175975,175978,0,3,0
50233,6,2,175981,175981,175983,0,2,3
50234,4,3,175985,175985,175988,0,3,2
50235,6,1,175991,175991,175992,0,1,3
50236,3,1,175994,175994,175995,0,1,2
50237,3,2,175997,175997,175999,0,2,2
50238,1,3,175998,175999,176002,1,4,0
50239,2,2,176000,176002,176004,2,4,0
50240,3,1,176003,176004,176005,1,2,0
50241,3,3,176006,176006,176009,0,3,1
50242,4,1,176010,176010,176011,0,1,1
50243,1,3,176011,176011,176014,0,3,0
50244,2,2,176013,176014,176016,1,3,0
50245,2,3,176015,176016,176019,1,4,0
50246,2,1,176017,176019,176020,2,3,0
50247,2,2,176019,176020,176022,1,3,0
50248,1,1,176020,176022,176023,2,3,0
50249,4,2,176024,176024,176026,0,2,1
50250,4,3,176028,176028,176031,0,3,2
50251,4,2,176032,176032,176034,0,2,1
50252,5,1,176037,176037,176038,0,1,3
50253,3,3,176040,176040,176043,0,3,2
50254,4,2,176044,176044,176046,0,2,1
50255,4,3,176048,176048,176051,0,3,2
50256,5,3,176053,176053,176056,0,3,2
50257,4,1,176057,176057,176058,0,1,1
50258,4,3,176061,176061,176064,0,3,3
50259,3,2,176064,176064,176066,0,2,0
50260,4,2,176068,176068,176070,0,2,2
50261,2,3,176070,176070,176073,0,3,0
50262,5,3,176075,176075,176078,0,3,2
50263,3,3,176078,176078,176081,0,3,0
50264,5,3,176083,176083,176086,0,3,2
50265,2,2,176085,176086,176088,1,3,0
50266,2,1,176087,176088,176089,1,2,0
50267,2,1,176089,176089,176090,0,1,0
50268,4,3,176093,176093,176096,0,3,3
50269,2,1,176095,176096,176097,1,2,0
50270,4,2,176099,176099,176101,0,2,2
50271,2,2,176101,176101,176103,0,2,0
50272,5,3,176106,176106,176109,0,3,3
50273,4,1,176110,176110,176111,0,1,1
50274,2,3,176112,176112,176115,0,3,1
50275,2,1,176114,176115,176116,1,2,0
50276,3,1,176117,176117,176118,0,1,1
50277,5,2,176122,176122,176124,0,2,4
50278,5,1,176127,176127,176128,0,1,3
50279,1,2,176128,176128,176130,0,2,0
50280,5,2,176133,176133,176135,0,2,3
50281,2,3,176135,176135,176138,0,3,0
50282,1,3,176136,176138,176141,2,5,0
50283,6,2,176142,176142,176144,0,2,1
50284,6,1,176148,176148,176149,0,1,4
50285,4,3,176152,176152,176155,0,3,3
50286,2,2,176154,176155,176157,1,3,0
50287,3,1,176157,176157,176158,0,1,0
50288,3,3,176160,176160,176163,0,3,2
50289,3,2,176163,176163,176165,0,2,0
50290,1,3,176164,176165,176168,1,4,0
50291,5,2,176169,176169,176171,0,2,1
50292,6,1,176175,176175,176176,0,1,4
50293,2,3,176177,176177,176180,0,3,1
50294,6,3,176183,176183,176186,0,3,3
50295,1,2,176184,176186,176188,2,4,0
50296,2,3,176186,176188,176191,2,5,0
50297,5,3,176191,176191,176194,0,3,0
50298,3,3,176194,176194,176197,0,3,0
50299,6,1,176200,176200,176201,0,1,3
50300,3,2,176203,176203,176205,0,2,2
50301,2,3,176205,176205,176208,0,3,0
50302,5,3,176210,176210,176213,0,3,2
50303,3,1,176213,176213,176214,0,1,0
50304,3,1,176216,176216,176217,0,1,2
50305,5,2,176221,176221,176223,0,2,4
50306,1,2,176222,176223,176225,1,3,0
50307,3,2,176225,176225,176227,0,2,0
50308,3,2,176228,176228,176230,0,2,1
50309,4,1,176232,176232,176233,0,1,2
50310,1,1,176233,176233,176234,0,1,0
50311,2,3,176235,176235,176238,0,3,1
50312,5,1,176240,176240,176241,0,1,2
50313,2,1,176242,176242,176243,0,1,1
50314,1,1,176243,176243,176244,0,1,0
50315,6,1,176249,176249,176250,0,1,5
50316,5,3,176254,176254,176257,0,3,4
50317,6,1,176260,176260,176261,0,1,3
50318,6,1,176266,176266,176267,0,1,5
50319,2,1,176268,176268,176269,0,1,1
50320,2,2,176270,176270,176272,0,2,1
50321,5,2,176275,176275,176277,0,2,3
50322,4,3,176279,176279,176282,0,3,2
50323,4,2,176283,176283,176285,0,2,1
50324,5,2,176288,176288,176290,0,2,3
50325,4,2,176292,176292,176294,0,2,2
50326,5,1,176297,176297,176298,0,1,3
50327,5,1,176302,176302,176303,0,1,4
50328,4,2,176306,176306,176308,0,2,3
50329,6,1,176312,176312,176313,0,1,4
50330,3,2,176315,176315,176317,0,2,2
50331,4,2,176319,176319,176321,0,2,2
50332,5,3,176324,176324,176327,0,3,3
50333,6,1,176330,176330,176331,0,1,3
50334,3,3,176333,176333,176336,0,3,2
50335,3,3,176336,176336,176339,0,3,0
50336,5,3,176341,176341,176344,0,3,2
50337,2,3,176343,176344,176347,1,4,0
50338,3,1,176346,176347,176348,1,2,0
50339,2,1,176348,176348,176349,0,1,0
50340,5,2,176353,176353,176355,0,2,4
50341,2,1,176355,176355,176356,0,1,0
50342,2,2,176357,176357,176359,0,2,1
50343,5,2,176362,176362,176364,0,2,3
50344,4,1,176366,176366,176367,0,1,2
50345,1,3,176367,176367,176370,0,3,0
50346,1,2,176368,176370,176372,2,4,0
50347,5,2,176373,176373,176375,0,2,1
50348,3,2,176376,176376,176378,0,2,1
50349,4,1,176380,176380,176381,0,1,2
50350,1,1,176381,176381,176382,0,1,0
50351,3,2,176384,176384,176386,0,2,2
50352,6,2,176390,176390,176392,0,2,4
50353,5,3,176395,176395,176398,0,3,3
50354,5,1,176400,176400,176401,0,1,2
50355,3,3,176403,176403,176406,0,3,2
50356,2,2,176405,176406,176408,1,3,0
50357,4,2,176409,176409,176411,0,2,1
50358,2,1,176411,176411,176412,0,1,0
50359,3,3,176414,176414,176417,0,3,2
50360,3,1,176417,176417,176418,0,1,0
50361,6,2,176423,176423,176425,0,2,5
50362,6,3,176429,176429,176432,0,3,4
50363,1,2,176430,176432,176434,2,4,0
50364,3,2,176433,176434,176436,1,3,0
50365,6,2,176439,176439,176441,0,2,3
50366,4,2,176443,176443,176445,0,2,2
50367,3,1,176446,176446,176447,0,1,1
50368,4,2,176450,176450,176452,0,2,3
50369,3,2,176453,176453,176455,0,2,1
50370,6,2,176459,176459,176461,0,2,4
50371,5,2,176464,176464,176466,0,2,3
50372,1,1,176465,176466,176467,1,2,0
50373,6,2,176471,176471,176473,0,2,4
50374,3,1,176474,176474,176475,0,1,1
50375,1,3,176475,176475,176478,0,3,0
50376,5,3,176480,176480,176483,0,3,2
50377,6,2,176486,176486,176488,0,2,3
50378,2,2,176488,176488,176490,0,2,0
50379,2,1,176490,176490,176491,0,1,0
50380,6,1,176496,176496,176497,0,1,5
50381,5,1,176501,176501,176502,0,1,4
50382,6,2,176507,176507,176509,0,2,5
50383,5,2,176512,176512,176514,0,2,3
50384,5,3,176517,176517,176520,0,3,3
50385,4,2,176521,176521,176523,0,2,1
50386,3,2,176524,176524,176526,0,2,1
50387,6,2,176530,176530,176532,0,2,4
50388,1,3,176531,176532,176535,1,4,0
50389,5,2,176536,176536,176538,0,2,1
50390,6,2,176542,176542,176544,0,2,4
50391,2,2,176544,176544,176546,0,2,0
50392,4,2,176548,176548,176550,0,2,2
50393,3,3,176551,176551,176554,0,3,1
50394,3,2,176554,176554,176556,0,2,0
50395,1,3,176555,176556,176559,1,4,0
50396,3,2,176558,176559,176561,1,3,0
50397,1,1,176559,176561,176562,2,3,0
50398,3,2,176562,176562,176564,0,2,0
50399,3,1,176565,176565,176566,0,1,1
50400,1,2,176566,176566,176568,0,2,0
50401,3,2,176569,176569,176571,0,2,1
50402,1,3,176570,176571,176574,1,4,0
50403,3,2,176573,176574,176576,1,3,0
50404,1,3,176574,176576,176579,2,5,0
50405,3,3,176577,176579,176582,2,5,0
50406,3,3,176580,176582,176585,2,5,0
50407,6,3,176586,176586,176589,0,3,1
50408,6,1,176592,176592,176593,0,1,3
50409,5,3,176597,176597,176600,0,3,4
50410,6,3,176603,176603,176606,0,3,3
50411,2,3,176605,176606,176609,1,4,0
50412,6,2,176611,176611,176613,0,2,2
50413,1,3,176612,176613,176616,1,4,0
50414,4,3,176616,176616,176619,0,3,0
50415,3,1,176619,176619,176620,0,1,0
50416,4,1,176623,176623,176624,0,1,3
50417,5,1,176628,176628,176629,0,1,4
50418,3,2,176631,176631,176633,0,2,2
50419,1,1,176632,176633,176634,1,2,0
50420,1,1,176633,176634,176635,1,2,0
50421,2,3,176635,176635,176638,0,3,0
50422,3,3,176638,176638,176641,0,3,0
50423,1,1,176639,176641,176642,2,3,0
50424,4,3,176643,176643,176646,0,3,1
50425,4,1,176647,176647,176648,0,1,1
50426,6,1,176653,176653,176654,0,1,5
50427,5,2,176658,176658,176660,0,2,4
50428,5,2,176663,176663,176665,0,2,3
50429,3,1,176666,176666,176667,0,1,1
50430,6,2,176672,176672,176674,0,2,5
50431,3,2,176675,176675,176677,0,2,1
50432,2,3,176677,176677,176680,0,3,0
50433,4,1,176681,176681,176682,0,1,1
50434,5,2,176686,176686,176688,0,2,4
50435,6,3,176692,176692,176695,0,3,4
50436,1,2,176693,176695,176697,2,4,0
50437,1,1,176694,176697,176698,3,4,0
50438,1,1,176695,176698,176699,3,4,0
50439,5,1,176700,176700,176701,0,1,1
50440,4,2,176704,176704,176706,0,2,3
50441,2,2,176706,176706,176708,0,2,0
50442,6,1,176712,176712,176713,0,1,4
50443,2,3,176714,176714,176717,0,3,1
50444,3,2,176717,176717,176719,0,2,0
50445,5,1,176722,176722,176723,0,1,3
50446,3,1,176725,176725,176726,0,1,2
50447,3,1,176728,176728,176729,0,1,2
50448,3,3,176731,176731,176734,0,3,2
50449,6,3,176737,176737,176740,0,3,3
50450,3,3,176740,176740,176743,0,3,0
50451,4,2,176744,176744,176746,0,2,1
50452,6,1,176750,176750,176751,0,1,4
50453,1,3,176751,176751,176754,0,3,0
50454,3,2,176754,176754,176756,0,2,0
50455,4,2,176758,176758,176760,0,2,2
50456,6,2,176764,176764,176766,0,2,4
50457,3,3,176767,176767,176770,0,3,1
50458,2,3,176769,176770,176773,1,4,0
50459,2,1,176771,176773,176774,2,3,0
50460,1,2,176772,176774,176776,2,4,0
50461,1,1,176773,176776,176777,3,4,0
50462,1,3,176774,176777,176780,3,6,0
50463,4,1,176778,176780,176781,2,3,0
50464,6,3,176784,176784,176787,0,3,3
50465,4,2,176788,176788,176790,0,2,1
50466,5,2,176793,176793,176795,0,2,3
50467,6,3,176799,176799,176802,0,3,4
50468,4,1,176803,176803,176804,0,1,1
50469,2,3,176805,176805,176808,0,3,1
50470,3,2,176808,176808,176810,0,2,0
50471,6,3,176814,176814,176817,0,3,4
50472,3,3,176817,176817,176820,0,3,0
50473,4,3,176821,176821,176824,0,3,1
50474,4,2,176825,176825,176827,0,2,1
50475,6,2,176831,176831,176833,0,2,4
50476,1,3,176832,176833,176836,1,4,0
50477,6,1,176838,176838,176839,0,1,2
50478,3,1,176841,176841,176842,0,1,2
50479,6,2,176847,176847,176849,0,2,5
50480,6,1,176853,176853,176854,0,1,4
50481,3,1,176856,176856,176857,0,1,2
50482,2,2,176858,176858,176860,0,2,1
50483,2,1,176860,176860,176861,0,1,0
50484,4,3,176864,176864,176867,0,3,3
50485,2,2,176866,176867,176869,1,3,0
50486,2,2,176868,176869,176871,1,3,0
50487,5,2,176873,176873,176875,0,2,2
50488,1,3,176874,176875,176878,1,4,0
50489,1,1,176875,176878,176879,3,4,0
50490,1,3,176876,176879,176882,3,6,0
50491,5,3,176881,176882,176885,1,4,0
50492,3,3,176884,176885,176888,1,4,0
50493,6,1,176890,176890,176891,0,1,2
50494,6,1,176896,176896,176897,0,1,5
50495,2,1,176898,176898,176899,0,1,1
50496,1,1,176899,176899,176900,0,1,0
50497,4,1,176903,176903,176904,0,1,3
50498,2,2,176905,176905,176907,0,2,1
50499,4,3,176909,176909,176912,0,3,2
50500,3,2,176912,176912,176914,0,2,0
50501,6,3,176918,176918,176921,0,3,4
50502,4,1,176922,176922,176923,0,1,1
50503,6,2,176928,176928,176930,0,2,5
50504,4,3,176932,176932,176935,0,3,2
50505,3,3,176935,176935,176938,0,3,0
50506,1,2,176936,176938,176940,2,4,0
50507,2,1,176938,176940,176941,2,3,0
50508,5,3,176943,176943,176946,0,3,2
50509,3,3,176946,176946,176949,0,3,0
50510,6,1,176952,176952,176953,0,1,3
50511,3,3,176955,176955,176958,0,3,2
50512,2,1,176957,176958,176959,1,2,0
50513,2,2,176959,176959,176961,0,2,0
50514,4,1,176963,176963,176964,0,1,2
50515,5,1,176968,176968,176969,0,1,4
50516,3,2,176971,176971,176973,0,2,2
50517,1,1,176972,176973,176974,1,2,0
50518,2,3,176974,176974,176977,0,3,0
50519,1,1,176975,176977,176978,2,3,0
50520,5,2,176980,176980,176982,0,2,2
50521,6,3,176986,176986,176989,0,3,4
50522,4,1,176990,176990,176991,0,1,1
50523,3,3,176993,176993,176996,0,3,2
50524,5,3,176998,176998,177001,0,3,2
50525,1,3,176999,177001,177004,2,5,0
50526,2,1,177001,177004,177005,3,4,0
50527,5,1,177006,177006,177007,0,1,1
50528,2,3,177008,177008,177011,0,3,1
50529,6,3,177014,177014,177017,0,3,3
50530,3,2,177017,177017,177019,0,2,0
50531,6,1,177023,177023,177024,0,1,4
50532,5,3,177028,177028,177031,0,3,4
50533,4,1,177032,177032,177033,0,1,1
50534,3,2,177035,177035,177037,0,2,2
50535,6,2,177041,177041,177043,0,2,4
50536,4,3,177045,177045,177048,0,3,2
50537,5,1,177050,177050,177051,0,1,2
50538,1,1,177051,177051,177052,0,1,0
50539,2,3,177053,177053,177056,0,3,1
50540,5,2,177058,177058,177060,0,2,2
50541,2,1,177060,177060,177061,0,1,0
50542,5,2,177065,177065,177067,0,2,4
50543,5,1,177070,177070,177071,0,1,3
50544,5,3,177075,177075,177078,0,3,4
50545,6,1,177081,177081,177082,0,1,3
50546,3,1,177084,177084,177085,0,1,2
50547,2,3,177086,177086,177089,0,3,1
50548,2,3,177088,177089,177092,1,4,0
50549,2,1,177090,177092,177093,2,3,0
50550,5,1,177095,177095,177096,0,1,2
50551,1,2,177096,177096,177098,0,2,0
50552,3,1,177099,177099,177100,0,1,1
50553,1,3,177100,177100,177103,0,3,0
50554,6,2,177106,177106,177108,0,2,3
50555,4,2,177110,177110,177112,0,2,2
50556,5,1,177115,177115,177116,0,1,3
50557,3,1,177118,177118,177119,0,1,2
50558,4,1,177122,177122,177123,0,1,3
50559,2,2,177124,177124,177126,0,2,1
50560,3,2,177127,177127,177129,0,2,1
50561,6,3,177133,177133,177136,0,3,4
50562,5,3,177138,177138,177141,0,3,2
50563,1,2,177139,177141,177143,2,4,0
50564,6,1,177145,177145,177146,0,1,2
50565,3,3,177148,177148,177151,0,3,2
50566,6,2,177154,177154,177156,0,2,3
50567,6,2,177160,177160,177162,0,2,4
50568,5,2,177165,177165,177167,0,2,3
50569,3,2,177168,177168,177170,0,2,1
50570,3,1,177171,177171,177172,0,1,1
50571,1,3,177172,177172,177175,0,3,0
50572,4,3,177176,177176,177179,0,3,1
50573,1,1,177177,177179,177180,2,3,0
50574,6,1,177183,177183,177184,0,1,3
50575,1,2,177184,177184,177186,0,2,0
50576,6,3,177190,177190,177193,0,3,4
50577,1,3,177191,177193,177196,2,5,0
50578,4,3,177195,177196,177199,1,4,0
50579,3,2,177198,177199,177201,1,3,0
50580,5,2,177203,177203,177205,0,2,2
50581,5,1,177208,177208,177209,0,1,3
50582,2,2,177210,177210,177212,0,2,1
50583,2,1,177212,177212,177213,0,1,0
50584,5,1,177217,177217,177218,0,1,4
50585,4,2,177221,177221,177223,0,2,3
50586,2,1,177223,177223,177224,0,1,0
50587,5,1,177228,177228,177229,0,1,4
50588,1,1,177229,177229,177230,0,1,0
50589,4,1,177233,177233,177234,0,1,3
50590,3,1,177236,177236,177237,0,1,2
50591,5,1,177241,177241,177242,0,1,4
50592,3,1,177244,177244,177245,0,1,2
50593,6,1,177250,177250,177251,0,1,5
50594,1,1,177251,177251,177252,0,1,0
50595,6,3,177257,177257,177260,0,3,5
50596,4,3,177261,177261,177264,0,3,1
50597,1,3,177262,177264,177267,2,5,0
50598,1,1,177263,177267,177268,4,5,0
50599,1,2,177264,177268,177270,4,6,0
50600,1,3,177265,177270,177273,5,8,0
50601,3,1,177268,177273,177274,5,6,0
50602,2,3,177270,177274,177277,4,7,0
50603,1,2,177271,177277,177279,6,8,0
50604,1,2,177272,177279,177281,7,9,0
50605,2,1,177274,177281,177282,7,8,0
50606,6,2,177280,177282,177284,2,4,0
50607,6,3,177286,177286,177289,0,3,2
50608,4,1,177290,177290,177291,0,1,1
50609,3,2,177293,177293,177295,0,2,2
50610,1,3,177294,177295,177298,1,4,0
50611,5,2,177299,177299,177301,0,2,1
50612,1,1,177300,177301,177302,1,2,0
50613,2,2,177302,177302,177304,0,2,0
50614,5,2,177307,177307,177309,0,2,3
50615,5,2,177312,177312,177314,0,2,3
50616,5,2,177317,177317,177319,0,2,3
50617,4,2,177321,177321,177323,0,2,2
50618,3,1,177324,177324,177325,0,1,1
50619,2,2,177326,177326,177328,0,2,1
50620,5,2,177331,177331,177333,0,2,3
50621,5,1,177336,177336,177337,0,1,3
50622,6,3,177342,177342,177345,0,3,5
50623,3,2,177345,177345,177347,0,2,0
50624,5,3,177350,177350,177353,0,3,3
50625,1,1,177351,177353,177354,2,3,0
50626,6,1,177357,177357,177358,0,1,3
50627,3,2,177360,177360,177362,0,2,2
50628,5,2,177365,177365,177367,0,2,3
50629,3,1,177368,177368,177369,0,1,1
50630,5,1,177373,177373,177374,0,1,4
50631,5,3,177378,177378,177381,0,3,4
50632,5,2,177383,177383,177385,0,2,2
50633,1,3,177384,177385,177388,1,4,0
50634,6,1,177390,177390,177391,0,1,2
50635,5,3,177395,177395,177398,0,3,4
50636,5,3,177400,177400,177403,0,3,2
50637,2,1,177402,177403,177404,1,2,0
50638,1,3,177403,177404,177407,1,4,0
50639,5,3,177408,177408,177411,0,3,1
50640,3,3,177411,177411,177414,0,3,0
50641,1,1,177412,177414,177415,2,3,0
50642,1,2,177413,177415,177417,2,4,0
50643,5,1,177418,177418,177419,0,1,1
50644,6,2,177424,177424,177426,0,2,5
50645,6,3,177430,177430,177433,0,3,4
50646,5,3,177435,177435,177438,0,3,2
50647,6,3,177441,177441,177444,0,3,3
50648,5,3,177446,177446,177449,0,3,2
50649,5,1,177451,177451,177452,0,1,2
50650,3,1,177454,177454,177455,0,1,2
50651,1,2,177455,177455,177457,0,2,0
50652,1,2,177456,177457,177459,1,3,0
50653,3,3,177459,177459,177462,0,3,0
50654,2,3,177461,177462,177465,1,4,0
50655,3,2,177464,177465,177467,1,3,0
50656,5,2,177469,177469,177471,0,2,2
50657,3,3,177472,177472,177475,0,3,1
50658,6,1,177478,177478,177479,0,1,3
50659,5,1,177483,177483,177484,0,1,4
50660,6,2,177489,177489,177491,0,2,5
50661,1,2,177490,177491,177493,1,3,0
50662,1,2,177491,177493,177495,2,4,0
50663,2,3,177493,177495,177498,2,5,0
50664,5,1,177498,177498,177499,0,1,0
50665,4,2,177502,177502,177504,0,2,3
50666,2,1,177504,177504,177505,0,1,0
50667,3,1,177507,177507,177508,0,1,2
50668,1,1,177508,177508,177509,0,1,0
50669,5,1,177513,177513,177514,0,1,4
50670,2,3,177515,177515,177518,0,3,1
50671,5,3,177520,177520,177523,0,3,2
50672,1,3,177521,177523,177526,2,5,0
50673,1,1,177522,177526,177527,4,5,0
50674,3,3,177525,177527,177530,2,5,0
50675,5,2,177530,177530,177532,0,2,0
50676,1,1,177531,177532,177533,1,2,0
50677,2,3,177533,177533,177536,0,3,0
50678,4,1,177537,177537,177538,0,1,1
50679,5,3,177542,177542,177545,0,3,4
50680,1,2,177543,177545,177547,2,4,0
50681,3,2,177546,177547,177549,1,3,0
50682,4,3,177550,177550,177553,0,3,1
50683,6,2,177556,177556,177558,0,2,3
50684,2,3,177558,177558,177561,0,3,0
50685,5,2,177563,177563,177565,0,2,2
50686,5,3,177568,177568,177571,0,3,3
50687,2,2,177570,177571,177573,1,3,0
50688,6,2,177576,177576,177578,0,2,3
50689,4,1,177580,177580,177581,0,1,2
50690,4,1,177584,177584,177585,0,1,3
50691,3,3,177587,177587,177590,0,3,2
50692,1,1,177588,177590,177591,2,3,0
50693,4,2,177592,177592,177594,0,2,1
50694,6,3,177598,177598,177601,0,3,4
50695,2,3,177600,177601,177604,1,4,0
50696,1,1,177601,177604,177605,3,4,0
50697,5,1,177606,177606,177607,0,1,1
50698,1,3,177607,177607,177610,0,3,0
50699,5,2,177612,177612,177614,0,2,2
50700,1,3,177613,177614,177617,1,4,0
50701,5,1,177618,177618,177619,0,1,1
50702,6,1,177624,177624,177625,0,1,5
50703,5,2,177629,177629,177631,0,2,4
50704,4,2,177633,177633,177635,0,2,2
50705,6,3,177639,177639,177642,0,3,4
50706,4,1,177643,177643,177644,0,1,1
50707,1,3,177644,177644,177647,0,3,0
50708,3,1,177647,177647,177648,0,1,0
50709,3,1,177650,177650,177651,0,1,2
50710,6,2,177656,177656,177658,0,2,5
50711,5,3,177661,177661,177664,0,3,3
50712,6,3,177667,177667,177670,0,3,3
50713,3,2,177670,177670,177672,0,2,0
50714,4,1,177674,177674,177675,0,1,2
50715,4,3,177678,177678,177681,0,3,3
50716,2,3,177680,177681,177684,1,4,0
50717,5,2,177685,177685,177687,0,2,1
50718,6,3,177691,177691,177694,0,3,4
50719,3,2,177694,177694,177696,0,2,0
50720,4,3,177698,177698,177701,0,3,2
50721,3,1,177701,177701,177702,0,1,0
50722,1,2,177702,177702,177704,0,2,0
50723,3,2,177705,177705,177707,0,2,1
50724,2,3,177707,177707,177710,0,3,0
50725,2,3,177709,177710,177713,1,4,0
50726,6,1,177715,177715,177716,0,1,2
50727,2,2,177717,177717,177719,0,2,1
50728,3,2,177720,177720,177722,0,2,1
50729,5,1,177725,177725,177726,0,1,3
50730,6,3,177731,177731,177734,0,3,5
50731,2,2,177733,177734,177736,1,3,0
50732,2,1,177735,177736,177737,1,2,0
50733,4,1,177739,177739,177740,0,1,2
50734,6,2,177745,177745,177747,0,2,5
50735,4,2,177749,177749,177751,0,2,2
50736,1,1,177750,177751,177752,1,2,0
50737,6,2,177756,177756,177758,0,2,4
50738,2,1,177758,177758,177759,0,1,0
50739,3,1,177761,177761,177762,0,1,2
50740,1,1,177762,177762,177763,0,1,0
50741,5,3,177767,177767,177770,0,3,4
50742,3,2,177770,177770,177772,0,2,0
50743,5,1,177775,177775,177776,0,1,3
50744,1,3,177776,177776,177779,0,3,0
50745,5,3,177781,177781,177784,0,3,2
50746,1,3,177782,177784,177787,2,5,0
50747,4,1,177786,177787,177788,1,2,0
50748,3,3,177789,177789,177792,0,3,1
50749,6,1,177795,177795,177796,0,1,3
50750,4,3,177799,177799,177802,0,3,3
50751,2,3,177801,177802,177805,1,4,0
50752,1,2,177802,177805,177807,3,5,0
50753,3,3,177805,177807,177810,2,5,0
50754,6,3,177811,177811,177814,0,3,1
50755,6,3,177817,177817,177820,0,3,3
50756,2,2,177819,177820,177822,1,3,0
50757,1,1,177820,177822,177823,2,3,0
50758,3,2,177823,177823,177825,0,2,0
50759,3,2,177826,177826,177828,0,2,1
50760,2,2,177828,177828,177830,0,2,0
50761,2,1,177830,177830,177831,0,1,0
50762,3,3,177833,177833,177836,0,3,2
50763,1,1,177834,177836,177837,2,3,0
50764,6,3,177840,177840,177843,0,3,3
50765,1,1,177841,177843,177844,2,3,0
50766,1,2,177842,177844,177846,2,4,0
50767,4,2,177846,177846,177848,0,2,0
50768,3,1,177849,177849,177850,0,1,1
50769,3,1,177852,177852,177853,0,1,2
50770,3,2,177855,177855,177857,0,2,2
50771,4,3,177859,177859,177862,0,3,2
50772,2,1,177861,177862,177863,1,2,0
50773,1,1,177862,177863,177864,1,2,0
50774,6,3,177868,177868,177871,0,3,4
50775,6,3,177874,177874,177877,0,3,3
50776,4,1,177878,177878,177879,0,1,1
50777,1,1,177879,177879,177880,0,1,0
50778,6,2,177885,177885,177887,0,2,5
50779,3,3,177888,177888,177891,0,3,1
50780,5,1,177893,177893,177894,0,1,2
50781,3,2,177896,177896,177898,0,2,2
50782,3,3,177899,177899,177902,0,3,1
50783,5,1,177904,177904,177905,0,1,2
50784,3,1,177907,177907,177908,0,1,2
50785,5,2,177912,177912,177914,0,2,4
50786,6,1,177918,177918,177919,0,1,4
50787,4,3,177922,177922,177925,0,3,3
50788,3,1,177925,177925,177926,0,1,0
50789,5,3,177930,177930,177933,0,3,4
50790,1,1,177931,177933,177934,2,3,0
50791,6,1,177937,177937,177938,0,1,3
50792,5,3,177942,177942,177945,0,3,4
50793,6,3,177948,177948,177951,0,3,3
50794,1,3,177949,177951,177954,2,5,0
50795,3,1,177952,177954,177955,2,3,0
50796,5,3,177957,177957,177960,0,3,2
50797,4,3,177961,177961,177964,0,3,1
50798,6,1,177967,177967,177968,0,1,3
50799,3,2,177970,177970,177972,0,2,2
50800,2,3,177972,177972,177975,0,3,0
50801,4,3,177976,177976,177979,0,3,1
50802,5,3,177981,177981,177984,0,3,2
50803,5,1,177986,177986,177987,0,1,2
50804,2,1,177988,177988,177989,0,1,1
50805,3,1,177991,177991,177992,0,1,2
50806,2,2,177993,177993,177995,0,2,1
50807,3,2,177996,177996,177998,0,2,1
50808,2,2,177998,177998,178000,0,2,0
50809,4,2,178002,178002,178004,0,2,2
50810,4,2,178006,178006,178008,0,2,2
50811,4,3,178010,178010,178013,0,3,2
50812,3,2,178013,178013,178015,0,2,0
50813,1,3,178014,178015,178018,1,4,0
50814,3,1,178017,178018,178019,1,2,0
50815,5,3,178022,178022,178025,0,3,3
50816,6,2,178028,178028,178030,0,2,3
50817,1,2,178029,178030,178032,1,3,0
50818,6,1,178035,178035,178036,0,1,3
50819,2,3,178037,178037,178040,0,3,1
50820,3,2,178040,178040,178042,0,2,0
50821,3,2,178043,178043,178045,0,2,1
50822,6,3,178049,178049,178052,0,3,4
50823,5,2,178054,178054,178056,0,2,2
50824,6,2,178060,178060,178062,0,2,4
50825,5,1,178065,178065,178066,0,1,3
50826,3,1,178068,178068,178069,0,1,2
50827,4,2,178072,178072,178074,0,2,3
50828,1,2,178073,178074,178076,1,3,0
50829,4,3,178077,178077,178080,0,3,1
50830,5,3,178082,178082,178085,0,3,2
50831,3,3,178085,178085,178088,0,3,0
50832,4,1,178089,178089,178090,0,1,1
50833,4,1,178093,178093,178094,0,1,3
50834,6,3,178099,178099,178102,0,3,5
50835,4,3,178103,178103,178106,0,3,1
50836,1,1,178104,178106,178107,2,3,0
50837,6,2,178110,178110,178112,0,2,3
50838,2,3,178112,178112,178115,0,3,0
50839,2,1,178114,178115,178116,1,2,0
50840,1,2,178115,178116,178118,1,3,0
50841,5,2,178120,178120,178122,0,2,2
50842,6,1,178126,178126,178127,0,1,4
50843,1,3,178127,178127,178130,0,3,0
50844,1,2,178128,178130,178132,2,4,0
50845,4,1,178132,178132,178133,0,1,0
50846,1,3,178133,178133,178136,0,3,0
50847,3,1,178136,178136,178137,0,1,0
50848,3,2,178139,178139,178141,0,2,2
50849,1,1,178140,178141,178142,1,2,0
50850,6,2,178146,178146,178148,0,2,4
50851,3,1,178149,178149,178150,0,1,1
50852,5,1,178154,178154,178155,0,1,4
50853,2,3,178156,178156,178159,0,3,1
50854,1,1,178157,178159,178160,2,3,0
50855,2,3,178159,178160,178163,1,4,0
50856,3,3,178162,178163,178166,1,4,0
50857,2,3,178164,178166,178169,2,5,0
50858,3,3,178167,178169,178172,2,5,0
50859,2,3,178169,178172,178175,3,6,0
50860,1,2,178170,178175,178177,5,7,0
50861,6,1,178176,178177,178178,1,2,0
50862,6,1,178182,178182,178183,0,1,4
50863,6,3,178188,178188,178191,0,3,5
50864,2,1,178190,178191,178192,1,2,0
50865,3,1,178193,178193,178194,0,1,1
50866,4,3,178197,178197,178200,0,3,3
50867,5,2,178202,178202,178204,0,2,2
50868,1,2,178203,178204,178206,1,3,0
50869,1,2,178204,178206,178208,2,4,0
50870,5,1,178209,178209,178210,0,1,1
50871,6,1,178215,178215,178216,0,1,5
50872,5,1,178220,178220,178221,0,1,4
50873,6,3,178226,178226,178229,0,3,5
50874,3,2,178229,178229,178231,0,2,0
50875,3,1,178232,178232,178233,0,1,1
50876,3,1,178235,178235,178236,0,1,2
50877,3,3,178238,178238,178241,0,3,2
50878,5,2,178243,178243,178245,0,2,2
50879,1,3,178244,178245,178248,1,4,0
50880,6,1,178250,178250,178251,0,1,2
50881,5,2,178255,178255,178257,0,2,4
50882,1,3,178256,178257,178260,1,4,0
50883,5,2,178261,178261,178263,0,2,1
50884,4,2,178265,178265,178267,0,2,2
50885,5,2,178270,178270,178272,0,2,3
50886,6,2,178276,178276,178278,0,2,4
50887,5,3,178281,178281,178284,0,3,3
50888,5,2,178286,178286,178288,0,2,2
50889,4,1,178290,178290,178291,0,1,2
50890,1,3,178291,178291,178294,0,3,0
50891,4,3,178295,178295,178298,0,3,1
50892,2,3,178297,178298,178301,1,4,0
50893,1,1,178298,178301,178302,3,4,0
50894,6,2,178304,178304,178306,0,2,2
50895,3,2,178307,178307,178309,0,2,1
50896,3,1,178310,178310,178311,0,1,1
50897,1,1,178311,178311,178312,0,1,0
50898,4,2,178315,178315,178317,0,2,3
50899,2,3,178317,178317,178320,0,3,0
50900,2,2,178319,178320,178322,1,3,0
50901,3,1,178322,178322,178323,0,1,0
50902,2,3,178324,178324,178327,0,3,1
50903,6,1,178330,178330,178331,0,1,3
50904,6,2,178336,178336,178338,0,2,5
50905,5,1,178341,178341,178342,0,1,3
50906,1,1,178342,178342,178343,0,1,0
50907,4,2,178346,178346,178348,0,2,3
50908,6,3,178352,178352,178355,0,3,4
50909,3,3,178355,178355,178358,0,3,0
50910,1,3,178356,178358,178361,2,5,0
50911,1,1,178357,178361,178362,4,5,0
50912,1,1,178358,178362,178363,4,5,0
50913,6,1,178364,178364,178365,0,1,1
50914,3,1,178367,178367,178368,0,1,2
50915,3,1,178370,178370,178371,0,1,2
50916,5,1,178375,178375,178376,0,1,4
50917,1,3,178376,178376,178379,0,3,0
50918,5,2,178381,178381,178383,0,2,2
50919,1,1,178382,178383,178384,1,2,0
50920,3,2,178385,178385,178387,0,2,1
50921,1,2,178386,178387,178389,1,3,0
50922,2,3,178388,178389,178392,1,4,0
50923,6,3,178394,178394,178397,0,3,2
50924,4,2,178398,178398,178400,0,2,1
50925,6,2,178404,178404,178406,0,2,4
50926,5,3,178409,178409,178412,0,3,3
50927,5,3,178414,178414,178417,0,3,2
50928,2,1,178416,178417,178418,1,2,0
50929,5,1,178421,178421,178422,0,1,3
50930,6,2,178427,178427,178429,0,2,5
50931,4,2,178431,178431,178433,0,2,2
50932,1,3,178432,178433,178436,1,4,0
50933,4,2,178436,178436,178438,0,2,0
50934,3,3,178439,178439,178442,0,3,1
50935,6,3,178445,178445,178448,0,3,3
50936,5,1,178450,178450,178451,0,1,2
50937,2,3,178452,178452,178455,0,3,1
50938,5,2,178457,178457,178459,0,2,2
50939,3,1,178460,178460,178461,0,1,1
50940,3,2,178463,178463,178465,0,2,2
50941,6,2,178469,178469,178471,0,2,4
50942,2,3,178471,178471,178474,0,3,0
50943,6,1,178477,178477,178478,0,1,3
50944,4,3,178481,178481,178484,0,3,3
50945,1,3,178482,178484,178487,2,5,0
50946,6,1,178488,178488,178489,0,1,1
50947,1,2,178489,178489,178491,0,2,0
50948,3,2,178492,178492,178494,0,2,1
50949,6,3,178498,178498,178501,0,3,4
50950,1,3,178499,178501,178504,2,5,0
50951,2,1,178501,178504,178505,3,4,0
50952,2,3,178503,178505,178508,2,5,0
50953,1,2,178504,178508,178510,4,6,0
50954,5,2,178509,178510,178512,1,3,0
50955,4,3,178513,178513,178516,0,3,1
50956,3,1,178516,178516,178517,0,1,0
50957,3,2,178519,178519,178521,0,2,2
50958,4,1,178523,178523,178524,0,1,2
50959,3,1,178526,178526,178527,0,1,2
50960,1,1,178527,178527,178528,0,1,0
50961,3,1,178530,178530,178531,0,1,2
50962,3,3,178533,178533,178536,0,3,2
50963,5,3,178538,178538,178541,0,3,2
50964,5,3,178543,178543,178546,0,3,2
50965,5,1,178548,178548,178549,0,1,2
50966,4,2,178552,178552,178554,0,2,3
50967,1,1,178553,178554,178555,1,2,0
50968,3,3,178556,178556,178559,0,3,1
50969,6,3,178562,178562,178565,0,3,3
50970,1,3,178563,178565,178568,2,5,0
50971,4,2,178567,178568,178570,1,3,0
50972,4,3,178571,178571,178574,0,3,1
50973,3,3,178574,178574,178577,0,3,0
50974,5,3,178579,178579,178582,0,3,2
50975,1,1,178580,178582,178583,2,3,0
50976,1,2,178581,178583,178585,2,4,0
50977,5,1,178586,178586,178587,0,1,1
50978,5,3,178591,178591,178594,0,3,4
50979,2,2,178593,178594,178596,1,3,0
50980,4,1,178597,178597,178598,0,1,1
50981,6,3,178603,178603,178606,0,3,5
50982,4,2,178607,178607,178609,0,2,1
50983,6,3,178613,178613,178616,0,3,4
50984,3,2,178616,178616,178618,0,2,0
50985,3,3,178619,178619,178622,0,3,1
50986,6,2,178625,178625,178627,0,2,3
50987,5,3,178630,178630,178633,0,3,3
50988,6,3,178636,178636,178639,0,3,3
50989,3,3,178639,178639,178642,0,3,0
50990,3,3,178642,178642,178645,0,3,0
50991,6,2,178648,178648,178650,0,2,3
50992,1,2,178649,178650,178652,1,3,0
50993,5,2,178654,178654,178656,0,2,2
50994,6,2,178660,178660,178662,0,2,4
50995,4,2,178664,178664,178666,0,2,2
50996,3,1,178667,178667,178668,0,1,1
50997,3,1,178670,178670,178671,0,1,2
50998,5,2,178675,178675,178677,0,2,4
50999,3,3,178678,178678,178681,0,3,1
51000,1,3,178679,178681,178684,2,5,0
51001,2,2,178681,178684,178686,3,5,0
51002,4,3,178685,178686,178689,1,4,0
51003,3,2,178688,178689,178691,1,3,0
51004,6,1,178694,178694,178695,0,1,3
51005,1,3,178695,178695,178698,0,3,0
51006,5,2,178700,178700,178702,0,2,2
51007,5,2,178705,178705,178707,0,2,3
51008,3,1,178708,178708,178709,0,1,1
51009,6,1,178714,178714,178715,0,1,5
51010,2,2,178716,178716,178718,0,2,1
51011,3,1,178719,178719,178720,0,1,1
51012,3,1,178722,178722,178723,0,1,2
51013,4,2,178726,178726,178728,0,2,3
51014,4,3,178730,178730,178733,0,3,2
51015,3,1,178733,178733,178734,0,1,0
51016,4,1,178737,178737,178738,0,1,3
51017,3,1,178740,178740,178741,0,1,2
51018,5,2,178745,178745,178747,0,2,4
51019,4,2,178749,178749,178751,0,2,2
51020,2,3,178751,178751,178754,0,3,0
51021,1,3,178752,178754,178757,2,5,0
51022,1,3,178753,178757,178760,4,7,0
51023,3,1,178756,178760,178761,4,5,0
51024,5,1,178761,178761,178762,0,1,0
51025,4,1,178765,178765,178766,0,1,3
51026,6,1,178771,178771,178772,0,1,5
51027,6,2,178777,178777,178779,0,2,5
51028,5,1,178782,178782,178783,0,1,3
51029,6,2,178788,178788,178790,0,2,5
51030,4,3,178792,178792,178795,0,3,2
51031,6,2,178798,178798,178800,0,2,3
51032,2,3,178800,178800,178803,0,3,0
51033,4,1,178804,178804,178805,0,1,1
51034,2,1,178806,178806,178807,0,1,1
51035,2,1,178808,178808,178809,0,1,1
51036,4,2,178812,178812,178814,0,2,3
51037,2,3,178814,178814,178817,0,3,0
51038,1,2,178815,178817,178819,2,4,0
51039,5,3,178820,178820,178823,0,3,1
51040,5,2,178825,178825,178827,0,2,2
51041,4,3,178829,178829,178832,0,3,2
51042,3,2,178832,178832,178834,0,2,0
51043,5,1,178837,178837,178838,0,1,3
51044,1,2,178838,178838,178840,0,2,0
51045,5,2,178843,178843,178845,0,2,3
51046,1,2,178844,178845,178847,1,3,0
51047,1,3,178845,178847,178850,2,5,0
51048,1,2,178846,178850,178852,4,6,0
51049,2,3,178848,178852,178855,4,7,0
51050,6,3,178854,178855,178858,1,4,0
51051,4,3,178858,178858,178861,0,3,0
51052,1,2,178859,178861,178863,2,4,0
51053,2,3,178861,178863,178866,2,5,0
51054,4,3,178865,178866,178869,1,4,0
51055,6,1,178871,178871,178872,0,1,2
51056,2,3,178873,178873,178876,0,3,1
51057,1,1,178874,178876,178877,2,3,0
51058,5,1,178879,178879,178880,0,1,2
51059,1,1,178880,178880,178881,0,1,0
51060,4,3,178884,178884,178887,0,3,3
51061,3,3,178887,178887,178890,0,3,0
51062,5,1,178892,178892,178893,0,1,2
51063,4,3,178896,178896,178899,0,3,3
51064,6,1,178902,178902,178903,0,1,3
51065,2,2,178904,178904,178906,0,2,1
51066,3,3,178907,178907,178910,0,3,1
51067,1,3,178908,178910,178913,2,5,0
51068,1,2,178909,178913,178915,4,6,0
51069,1,2,178910,178915,178917,5,7,0
51070,2,3,178912,178917,178920,5,8,0
51071,5,3,178917,178920,178923,3,6,0
51072,4,3,178921,178923,178926,2,5,0
51073,6,1,178927,178927,178928,0,1,1
51074,3,1,178930,178930,178931,0,1,2
51075,5,1,178935,178935,178936,0,1,4
51076,1,2,178936,178936,178938,0,2,0
51077,3,1,178939,178939,178940,0,1,1
51078,3,3,178942,178942,178945,0,3,2
51079,5,2,178947,178947,178949,0,2,2
51080,4,2,178951,178951,178953,0,2,2
51081,6,1,178957,178957,178958,0,1,4
51082,4,3,178961,178961,178964,0,3,3
51083,2,1,178963,178964,178965,1,2,0
51084,6,3,178969,178969,178972,0,3,4
51085,5,3,178974,178974,178977,0,3,2
51086,5,1,178979,178979,178980,0,1,2
51087,1,2,178980,178980,178982,0,2,0
51088,2,1,178982,178982,178983,0,1,0
51089,6,1,178988,178988,178989,0,1,5
51090,2,3,178990,178990,178993,0,3,1
51091,5,2,178995,178995,178997,0,2,2
51092,2,3,178997,178997,179000,0,3,0
51093,2,1,178999,179000,179001,1,2,0
51094,1,3,179000,179001,179004,1,4,0
51095,3,1,179003,179004,179005,1,2,0
51096,6,2,179009,179009,179011,0,2,4
51097,3,3,179012,179012,179015,0,3,1
51098,1,2,179013,179015,179017,2,4,0
51099,2,3,179015,179017,179020,2,5,0
51100,3,2,179018,179020,179022,2,4,0
51101,3,3,179021,179022,179025,1,4,0
51102,4,1,179025,179025,179026,0,1,0
51103,1,1,179026,179026,179027,0,1,0
51104,3,3,179029,179029,179032,0,3,2
51105,1,3,179030,179032,179035,2,5,0
51106,1,3,179031,179035,179038,4,7,0
51107,6,2,179037,179038,179040,1,3,0
51108,1,1,179038,179040,179041,2,3,0
51109,6,1,179044,179044,179045,0,1,3
51110,6,2,179050,179050,179052,0,2,5
51111,6,3,179056,179056,179059,0,3,4
51112,5,1,179061,179061,179062,0,1,2
51113,1,2,179062,179062,179064,0,2,0
51114,4,1,179066,179066,179067,0,1,2
51115,1,1,179067,179067,179068,0,1,0
51116,1,3,179068,179068,179071,0,3,0
51117,1,2,179069,179071,179073,2,4,0
51118,5,1,179074,179074,179075,0,1,1
51119,2,2,179076,179076,179078,0,2,1
51120,5,2,179081,179081,179083,0,2,3
51121,5,3,179086,179086,179089,0,3,3
51122,5,3,179091,179091,179094,0,3,2
51123,1,3,179092,179094,179097,2,5,0
51124,2,2,179094,179097,179099,3,5,0
51125,5,3,179099,179099,179102,0,3,0
51126,4,1,179103,179103,179104,0,1,1
51127,3,2,179106,179106,179108,0,2,2
51128,2,3,179108,179108,179111,0,3,0
51129,2,2,179110,179111,179113,1,3,0
51130,1,2,179111,179113,179115,2,4,0
51131,1,3,179112,179115,179118,3,6,0
51132,5,3,179117,179118,179121,1,4,0
51133,3,3,179120,179121,179124,1,4,0
51134,4,2,179124,179124,179126,0,2,0
51135,1,2,179125,179126,179128,1,3,0
51136,5,1,179130,179130,179131,0,1,2
51137,2,1,179132,179132,179133,0,1,1
51138,6,1,179138,179138,179139,0,1,5
51139,5,1,179143,179143,179144,0,1,4
51140,1,3,179144,179144,179147,0,3,0
51141,6,2,179150,179150,179152,0,2,3
51142,4,3,179154,179154,179157,0,3,2
51143,5,3,179159,179159,179162,0,3,2
51144,4,1,179163,179163,179164,0,1,1
51145,2,2,179165,179165,179167,0,2,1
51146,4,2,179169,179169,179171,0,2,2
51147,3,3,179172,179172,179175,0,3,1
51148,6,2,179178,179178,179180,0,2,3
51149,1,1,179179,179180,179181,1,2,0
51150,2,3,179181,179181,179184,0,3,0
51151,3,3,179184,179184,179187,0,3,0
51152,6,1,179190,179190,179191,0,1,3
51153,4,2,179194,179194,179196,0,2,3
51154,6,1,179200,179200,179201,0,1,4
51155,4,2,179204,179204,179206,0,2,3
51156,3,3,179207,179207,179210,0,3,1
51157,2,2,179209,179210,179212,1,3,0
51158,5,3,179214,179214,179217,0,3,2
51159,3,2,179217,179217,179219,0,2,0
51160,3,3,179220,179220,179223,0,3,1
51161,4,3,179224,179224,179227,0,3,1
51162,6,2,179230,179230,179232,0,2,3
51163,2,2,179232,179232,179234,0,2,0
51164,6,2,179238,179238,179240,0,2,4
51165,1,3,179239,179240,179243,1,4,0
51166,2,2,179241,179243,179245,2,4,0
51167,4,2,179245,179245,179247,0,2,0
51168,4,1,179249,179249,179250,0,1,2
51169,5,3,179254,179254,179257,0,3,4
51170,6,3,179260,179260,179263,0,3,3
51171,2,3,179262,179263,179266,1,4,0
51172,4,1,179266,179266,179267,0,1,0
51173,1,3,179267,179267,179270,0,3,0
51174,2,1,179269,179270,179271,1,2,0
51175,2,1,179271,179271,179272,0,1,0
51176,3,3,179274,179274,179277,0,3,2
51177,5,1,179279,179279,179280,0,1,2
51178,3,1,179282,179282,179283,0,1,2
51179,3,1,179285,179285,179286,0,1,2
51180,4,3,179289,179289,179292,0,3,3
51181,3,3,179292,179292,179295,0,3,0
51182,1,1,179293,179295,179296,2,3,0
51183,6,3,179299,179299,179302,0,3,3
51184,6,2,179305,179305,179307,0,2,3
51185,1,3,179306,179307,179310,1,4,0
51186,3,2,179309,179310,179312,1,3,0
51187,5,2,179314,179314,179316,0,2,2
51188,1,2,179315,179316,179318,1,3,0
51189,4,3,179319,179319,179322,0,3,1
51190,3,3,179322,179322,179325,0,3,0
51191,3,1,179325,179325,179326,0,1,0
51192,4,1,179329,179329,179330,0,1,3
51193,1,1,179330,179330,179331,0,1,0
51194,2,3,179332,179332,179335,0,3,1
51195,2,3,179334,179335,179338,1,4,0
51196,1,2,179335,179338,179340,3,5,0
51197,4,2,179339,179340,179342,1,3,0
51198,4,2,179343,179343,179345,0,2,1
51199,3,2,179346,179346,179348,0,2,1
51200,4,1,179350,179350,179351,0,1,2
51201,1,1,179351,179351,179352,0,1,0
51202,2,1,179353,179353,179354,0,1,1
51203,1,1,179354,179354,179355,0,1,0
51204,4,2,179358,179358,179360,0,2,3
51205,6,3,179364,179364,179367,0,3,4
51206,4,2,179368,179368,179370,0,2,1
51207,4,3,179372,179372,179375,0,3,2
51208,1,2,179373,179375,179377,2,4,0
51209,4,2,179377,179377,179379,0,2,0
51210,3,1,179380,179380,179381,0,1,1
51211,6,2,179386,179386,179388,0,2,5
51212,1,3,179387,179388,179391,1,4,0
51213,6,3,179393,179393,179396,0,3,2
51214,6,1,179399,179399,179400,0,1,3
51215,5,2,179404,179404,179406,0,2,4
51216,4,3,179408,179408,179411,0,3,2
51217,5,3,179413,179413,179416,0,3,2
51218,4,3,179417,179417,179420,0,3,1
51219,5,2,179422,179422,179424,0,2,2
51220,1,1,179423,179424,179425,1,2,0
51221,1,2,179424,179425,179427,1,3,0
51222,1,2,179425,179427,179429,2,4,0
51223,6,3,179431,179431,179434,0,3,2
51224,4,1,179435,179435,179436,0,1,1
51225,1,1,179436,179436,179437,0,1,0
51226,3,2,179439,179439,179441,0,2,2
51227,2,2,179441,179441,179443,0,2,0
51228,6,2,179447,179447,179449,0,2,4
51229,4,3,179451,179451,179454,0,3,2
51230,4,1,179455,179455,179456,0,1,1
51231,4,2,179459,179459,179461,0,2,3
51232,6,2,179465,179465,179467,0,2,4
51233,1,3,179466,179467,179470,1,4,0
51234,2,1,179468,179470,179471,2,3,0
51235,6,1,179474,179474,179475,0,1,3
51236,4,1,179478,179478,179479,0,1,3
51237,1,1,179479,179479,179480,0,1,0
51238,1,3,179480,179480,179483,0,3,0
51239,1,2,179481,179483,179485,2,4,0
51240,2,3,179483,179485,179488,2,5,0
51241,3,1,179486,179488,179489,2,3,0
51242,3,3,179489,179489,179492,0,3,0
51243,4,3,179493,179493,179496,0,3,1
51244,6,1,179499,179499,179500,0,1,3
51245,1,3,179500,179500,179503,0,3,0
51246,4,2,179504,179504,179506,0,2,1
51247,5,1,179509,179509,179510,0,1,3
51248,3,3,179512,179512,179515,0,3,2
51249,2,3,179514,179515,179518,1,4,0
51250,5,1,179519,179519,179520,0,1,1
51251,2,1,179521,179521,179522,0,1,1
51252,5,1,179526,179526,179527,0,1,4
51253,4,1,179530,179530,179531,0,1,3
51254,2,3,179532,179532,179535,0,3,1
51255,5,2,179537,179537,179539,0,2,2
51256,3,3,179540,179540,179543,0,3,1
51257,5,3,179545,179545,179548,0,3,2
51258,3,2,179548,179548,179550,0,2,0
51259,1,1,179549,179550,179551,1,2,0
51260,6,3,179555,179555,179558,0,3,4
51261,2,3,179557,179558,179561,1,4,0
51262,6,1,179563,179563,179564,0,1,2
51263,3,1,179566,179566,179567,0,1,2
51264,2,1,179568,179568,179569,0,1,1
51265,5,2,179573,179573,179575,0,2,4
51266,4,3,179577,179577,179580,0,3,2
51267,1,1,179578,179580,179581,2,3,0
51268,6,2,179584,179584,179586,0,2,3
51269,2,1,179586,179586,179587,0,1,0
51270,1,1,179587,179587,179588,0,1,0
51271,2,3,179589,179589,179592,0,3,1
51272,1,1,179590,179592,179593,2,3,0
51273,3,2,179593,179593,179595,0,2,0
51274,6,3,179599,179599,179602,0,3,4
51275,4,3,179603,179603,179606,0,3,1
51276,5,1,179608,179608,179609,0,1,2
51277,1,3,179609,179609,179612,0,3,0
51278,1,3,179610,179612,179615,2,5,0
51279,5,3,179615,179615,179618,0,3,0
51280,2,2,179617,179618,179620,1,3,0
51281,5,2,179622,179622,179624,0,2,2
51282,5,2,179627,179627,179629,0,2,3
51283,6,3,179633,179633,179636,0,3,4
51284,6,1,179639,179639,179640,0,1,3
51285,1,3,179640,179640,179643,0,3,0
51286,1,3,179641,179643,179646,2,5,0
51287,3,3,179644,179646,179649,2,5,0
51288,4,2,179648,179649,179651,1,3,0
51289,2,2,179650,179651,179653,1,3,0
51290,1,1,179651,179653,179654,2,3,0
51291,5,2,179656,179656,179658,0,2,2
51292,4,3,179660,179660,179663,0,3,2
51293,6,1,179666,179666,179667,0,1,3
51294,1,1,179667,179667,179668,0,1,0
51295,1,2,179668,179668,179670,0,2,0
51296,2,3,179670,179670,179673,0,3,0
51297,5,2,179675,179675,179677,0,2,2
51298,3,2,179678,179678,179680,0,2,1
51299,3,1,179681,179681,179682,0,1,1
51300,3,2,179684,179684,179686,0,2,2
51301,3,3,179687,179687,179690,0,3,1
51302,6,2,179693,179693,179695,0,2,3
51303,3,1,179696,179696,179697,0,1,1
51304,4,1,179700,179700,179701,0,1,3
51305,2,1,179702,179702,179703,0,1,1
51306,5,1,179707,179707,179708,0,1,4
51307,5,1,179712,179712,179713,0,1,4
51308,1,1,179713,179713,179714,0,1,0
51309,4,1,179717,179717,179718,0,1,3
51310,4,3,179721,179721,179724,0,3,3
51311,4,1,179725,179725,179726,0,1,1
51312,2,3,179727,179727,179730,0,3,1
51313,2,1,179729,179730,179731,1,2,0
51314,4,3,179733,179733,179736,0,3,2
51315,6,1,179739,179739,179740,0,1,3
51316,6,3,179745,179745,179748,0,3,5
51317,3,2,179748,179748,179750,0,2,0
51318,1,3,179749,179750,179753,1,4,0
51319,1,2,179750,179753,179755,3,5,0
51320,2,1,179752,179755,179756,3,4,0
51321,2,2,179754,179756,179758,2,4,0
51322,6,1,179760,179760,179761,0,1,2
51323,4,3,179764,179764,179767,0,3,3
51324,2,2,179766,179767,179769,1,3,0
51325,5,1,179771,179771,179772,0,1,2
51326,6,2,179777,179777,179779,0,2,5
51327,3,1,179780,179780,179781,0,1,1
51328,3,3,179783,179783,179786,0,3,2
51329,6,3,179789,179789,179792,0,3,3
51330,2,1,179791,179792,179793,1,2,0
51331,3,1,179794,179794,179795,0,1,1
51332,2,2,179796,179796,179798,0,2,1
51333,5,2,179801,179801,179803,0,2,3
51334,2,2,179803,179803,179805,0,2,0
51335,2,2,179805,179805,179807,0,2,0
51336,4,1,179809,179809,179810,0,1,2
51337,3,1,179812,179812,179813,0,1,2
51338,4,3,179816,179816,179819,0,3,3
51339,4,2,179820,179820,179822,0,2,1
51340,5,1,179825,179825,179826,0,1,3
51341,3,3,179828,179828,179831,0,3,2
51342,2,3,179830,179831,179834,1,4,0
51343,6,3,179836,179836,179839,0,3,2
51344,2,2,179838,179839,179841,1,3,0
51345,1,2,179839,179841,179843,2,4,0
51346,3,3,179842,179843,179846,1,4,0
51347,4,2,179846,179846,179848,0,2,0
51348,5,2,179851,179851,179853,0,2,3
51349,4,1,179855,179855,179856,0,1,2
51350,2,3,179857,179857,179860,0,3,1
51351,2,1,179859,179860,179861,1,2,0
51352,3,1,179862,179862,179863,0,1,1
51353,6,1,179868,179868,179869,0,1,5
51354,1,1,179869,179869,179870,0,1,0
51355,6,2,179875,179875,179877,0,2,5
51356,1,2,179876,179877,179879,1,3,0
51357,5,1,179881,179881,179882,0,1,2
51358,2,3,179883,179883,179886,0,3,1
51359,1,2,179884,179886,179888,2,4,0
51360,1,3,179885,179888,179891,3,6,0
51361,5,3,179890,179891,179894,1,4,0
51362,2,2,179892,179894,179896,2,4,0
51363,4,1,179896,179896,179897,0,1,0
51364,1,2,179897,179897,179899,0,2,0
51365,5,3,179902,179902,179905,0,3,3
51366,3,2,179905,179905,179907,0,2,0
51367,1,2,179906,179907,179909,1,3,0
51368,6,3,179912,179912,179915,0,3,3
51369,4,3,179916,179916,179919,0,3,1
51370,5,2,179921,179921,179923,0,2,2
51371,3,1,179924,179924,179925,0,1,1
51372,1,3,179925,179925,179928,0,3,0
51373,2,1,179927,179928,179929,1,2,0
51374,3,2,179930,179930,179932,0,2,1
51375,6,1,179936,179936,179937,0,1,4
51376,1,2,179937,179937,179939,0,2,0
51377,1,3,179938,179939,179942,1,4,0
51378,2,2,179940,179942,179944,2,4,0
51379,6,3,179946,179946,179949,0,3,2
51380,1,2,179947,179949,179951,2,4,0
51381,4,3,179951,179951,179954,0,3,0
51382,5,3,179956,179956,179959,0,3,2
51383,3,3,179959,179959,179962,0,3,0
51384,2,2,179961,179962,179964,1,3,0
51385,4,2,179965,179965,179967,0,2,1
51386,5,1,179970,179970,179971,0,1,3
51387,1,3,179971,179971,179974,0,3,0
51388,1,3,179972,179974,179977,2,5,0
51389,1,2,179973,179977,179979,4,6,0
51390,2,2,179975,179979,179981,4,6,0
51391,6,3,179981,179981,179984,0,3,0
51392,6,2,179987,179987,179989,0,2,3
51393,4,1,179991,179991,179992,0,1,2
51394,4,2,179995,179995,179997,0,2,3
51395,4,2,179999,179999,180001,0,2,2
51396,6,1,180005,180005,180006,0,1,4
51397,1,1,180006,180006,180007,0,1,0
51398,4,1,180010,180010,180011,0,1,3
51399,1,2,180011,180011,180013,0,2,0
51400,4,2,180015,180015,180017,0,2,2
51401,6,3,180021,180021,180024,0,3,4
51402,5,1,180026,180026,180027,0,1,2
51403,6,1,180032,180032,180033,0,1,5
51404,1,3,180033,180033,180036,0,3,0
51405,1,2,180034,180036,180038,2,4,0
51406,1,2,180035,180038,180040,3,5,0
51407,4,3,180039,180040,180043,1,4,0
51408,4,1,180043,180043,180044,0,1,0
51409,1,3,180044,180044,180047,0,3,0
51410,5,3,180049,180049,180052,0,3,2
51411,1,2,180050,180052,180054,2,4,0
51412,1,3,180051,180054,180057,3,6,0
51413,3,3,180054,180057,180060,3,6,0
51414,2,2,180056,180060,180062,4,6,0
51415,3,2,180059,180062,180064,3,5,0
51416,6,2,180065,180065,180067,0,2,1
51417,2,3,180067,180067,180070,0,3,0
51418,4,1,180071,180071,180072,0,1,1
51419,3,1,180074,180074,180075,0,1,2
51420,1,3,180075,180075,180078,0,3,0
51421,1,2,180076,180078,180080,2,4,0
51422,4,3,180080,180080,180083,0,3,0
51423,6,3,180086,180086,180089,0,3,3
51424,5,2,180091,180091,180093,0,2,2
51425,5,3,180096,180096,180099,0,3,3
51426,5,2,180101,180101,180103,0,2,2
51427,5,2,180106,180106,180108,0,2,3
51428,4,1,180110,180110,180111,0,1,2
51429,6,1,180116,180116,180117,0,1,5
51430,2,1,180118,180118,180119,0,1,1
51431,4,2,180122,180122,180124,0,2,3
51432,6,2,180128,180128,180130,0,2,4
51433,2,2,180130,180130,180132,0,2,0
51434,4,3,180134,180134,180137,0,3,2
51435,2,2,180136,180137,180139,1,3,0
51436,4,3,180140,180140,180143,0,3,1
51437,6,3,180146,180146,180149,0,3,3
51438,1,1,180147,180149,180150,2,3,0
51439,5,2,180152,180152,180154,0,2,2
51440,1,2,180153,180154,180156,1,3,0
51441,4,3,180157,180157,180160,0,3,1
51442,5,3,180162,180162,180165,0,3,2
51443,1,2,180163,180165,180167,2,4,0
51444,3,3,180166,180167,180170,1,4,0
51445,6,3,180172,180172,180175,0,3,2
51446,5,3,180177,180177,180180,0,3,2
51447,1,1,180178,180180,180181,2,3,0
51448,5,2,180183,180183,180185,0,2,2
51449,3,1,180186,180186,180187,0,1,1
51450,2,3,180188,180188,180191,0,3,1
51451,1,1,180189,180191,180192,2,3,0
51452,2,1,180191,180192,180193,1,2,0
51453,2,2,180193,180193,180195,0,2,0
51454,3,3,180196,180196,180199,0,3,1
51455,3,3,180199,180199,180202,0,3,0
51456,6,1,180205,180205,180206,0,1,3
51457,1,2,180206,180206,180208,0,2,0
51458,6,1,180212,180212,180213,0,1,4
51459,1,3,180213,180213,180216,0,3,0
51460,6,3,180219,180219,180222,0,3,3
51461,4,2,180223,180223,180225,0,2,1
51462,1,3,180224,180225,180228,1,4,0
51463,4,1,180228,180228,180229,0,1,0
51464,2,1,180230,180230,180231,0,1,1
51465,5,1,180235,180235,180236,0,1,4
51466,2,1,180237,180237,180238,0,1,1
51467,1,1,180238,180238,180239,0,1,0
51468,1,3,180239,180239,180242,0,3,0
51469,4,3,180243,180243,180246,0,3,1
51470,4,3,180247,180247,180250,0,3,1
51471,1,3,180248,180250,180253,2,5,0
51472,5,3,180253,180253,180256,0,3,0
51473,6,2,180259,180259,180261,0,2,3
51474,5,1,180264,180264,180265,0,1,3
51475,5,2,180269,180269,180271,0,2,4
51476,5,2,180274,180274,180276,0,2,3
51477,1,1,180275,180276,180277,1,2,0
51478,1,2,180276,180277,180279,1,3,0
51479,4,3,180280,180280,180283,0,3,1
51480,2,1,180282,180283,180284,1,2,0
51481,3,3,180285,180285,180288,0,3,1
51482,3,3,180288,180288,180291,0,3,0
51483,4,2,180292,180292,180294,0,2,1
51484,5,3,180297,180297,180300,0,3,3
51485,1,1,180298,180300,180301,2,3,0
51486,1,3,180299,180301,180304,2,5,0
51487,5,3,180304,180304,180307,0,3,0
51488,2,2,180306,180307,180309,1,3,0
51489,6,1,180312,180312,180313,0,1,3
51490,1,3,180313,180313,180316,0,3,0
51491,4,1,180317,180317,180318,0,1,1
51492,1,3,180318,180318,180321,0,3,0
51493,5,2,180323,180323,180325,0,2,2
51494,6,3,180329,180329,180332,0,3,4
51495,1,2,180330,180332,180334,2,4,0
51496,2,2,180332,180334,180336,2,4,0
51497,2,3,180334,180336,180339,2,5,0
51498,6,1,180340,180340,180341,0,1,1
51499,2,3,180342,180342,180345,0,3,1
51500,5,3,180347,180347,180350,0,3,2
51501,2,1,180349,180350,180351,1,2,0
51502,5,2,180354,180354,180356,0,2,3
51503,2,1,180356,180356,180357,0,1,0
51504,2,1,180358,180358,180359,0,1,1
51505,6,2,180364,180364,180366,0,2,5
51506,2,1,180366,180366,180367,0,1,0
51507,1,1,180367,180367,180368,0,1,0
51508,3,1,180370,180370,180371,0,1,2
51509,2,3,180372,180372,180375,0,3,1
51510,3,2,180375,180375,180377,0,2,0
51511,3,1,180378,180378,180379,0,1,1
51512,6,2,180384,180384,180386,0,2,5
51513,1,2,180385,180386,180388,1,3,0
51514,1,2,180386,180388,180390,2,4,0
51515,1,3,180387,180390,180393,3,6,0
51516,3,1,180390,180393,180394,3,4,0
51517,5,1,180395,180395,180396,0,1,1
51518,1,1,180396,180396,180397,0,1,0
51519,2,3,180398,180398,180401,0,3,1
51520,2,2,180400,180401,180403,1,3,0
51521,6,3,180406,180406,180409,0,3,3
51522,2,3,180408,180409,180412,1,4,0
51523,5,1,180413,180413,180414,0,1,1
51524,1,2,180414,180414,180416,0,2,0
51525,3,1,180417,180417,180418,0,1,1
51526,4,3,180421,180421,180424,0,3,3
51527,3,1,180424,180424,180425,0,1,0
51528,3,2,180427,180427,180429,0,2,2
51529,5,2,180432,180432,180434,0,2,3
51530,3,2,180435,180435,180437,0,2,1
51531,6,3,180441,180441,180444,0,3,4
51532,2,1,180443,180444,180445,1,2,0
51533,4,2,180447,180447,180449,0,2,2
51534,1,1,180448,180449,180450,1,2,0
51535,3,2,180451,180451,180453,0,2,1
51536,1,1,180452,180453,180454,1,2,0
51537,1,3,180453,180454,180457,1,4,0
51538,6,2,180459,180459,180461,0,2,2
51539,2,3,180461,180461,180464,0,3,0
51540,5,3,180466,180466,180469,0,3,2
51541,5,1,180471,180471,180472,0,1,2
51542,6,3,180477,180477,180480,0,3,5
51543,5,1,180482,180482,180483,0,1,2
51544,3,2,180485,180485,180487,0,2,2
51545,5,3,180490,180490,180493,0,3,3
51546,6,3,180496,180496,180499,0,3,3
51547,2,1,180498,180499,180500,1,2,0
51548,3,2,180501,180501,180503,0,2,1
51549,3,2,180504,180504,180506,0,2,1
51550,1,2,180505,180506,180508,1,3,0
51551,6,1,180511,180511,180512,0,1,3
51552,3,3,180514,180514,180517,0,3,2
51553,4,2,180518,180518,180520,0,2,1
51554,6,3,180524,180524,180527,0,3,4
51555,3,1,180527,180527,180528,0,1,0
51556,6,1,180533,180533,180534,0,1,5
51557,2,3,180535,180535,180538,0,3,1
51558,1,1,180536,180538,180539,2,3,0
51559,2,1,180538,180539,180540,1,2,0
51560,2,1,180540,180540,180541,0,1,0
51561,1,3,180541,180541,180544,0,3,0
51562,1,1,180542,180544,180545,2,3,0
51563,3,1,180545,180545,180546,0,1,0
51564,5,2,180550,180550,180552,0,2,4
51565,6,3,180556,180556,180559,0,3,4
51566,6,1,180562,180562,180563,0,1,3
51567,5,1,180567,180567,180568,0,1,4
51568,4,3,180571,180571,180574,0,3,3
51569,5,3,180576,180576,180579,0,3,2
51570,1,1,180577,180579,180580,2,3,0
51571,6,1,180583,180583,180584,0,1,3
51572,1,2,180584,180584,180586,0,2,0
51573,3,1,180587,180587,180588,0,1,1
51574,1,1,180588,180588,180589,0,1,0
51575,2,3,180590,180590,180593,0,3,1
51576,1,2,180591,180593,180595,2,4,0
51577,1,1,180592,180595,180596,3,4,0
51578,2,3,180594,180596,180599,2,5,0
51579,1,3,180595,180599,180602,4,7,0
51580,5,3,180600,180602,180605,2,5,0
51581,5,2,180605,180605,180607,0,2,0
51582,2,3,180607,180607,180610,0,3,0
51583,2,1,180609,180610,180611,1,2,0
51584,2,1,180611,180611,180612,0,1,0
51585,2,3,180613,180613,180616,0,3,1
51586,1,3,180614,180616,180619,2,5,0
51587,5,3,180619,180619,180622,0,3,0
51588,2,1,180621,180622,180623,1,2,0
51589,3,1,180624,180624,180625,0,1,1
51590,5,3,180629,180629,180632,0,3,4
51591,4,3,180633,180633,180636,0,3,1
51592,2,2,180635,180636,180638,1,3,0
51593,4,3,180639,180639,180642,0,3,1
51594,2,1,180641,180642,180643,1,2,0
51595,5,1,180646,180646,180647,0,1,3
51596,2,1,180648,180648,180649,0,1,1
51597,4,2,180652,180652,180654,0,2,3
51598,3,2,180655,180655,180657,0,2,1
51599,6,2,180661,180661,180663,0,2,4
51600,4,1,180665,180665,180666,0,1,2
51601,1,3,180666,180666,180669,0,3,0
51602,2,1,180668,180669,180670,1,2,0
51603,2,3,180670,180670,180673,0,3,0
51604,3,1,180673,180673,180674,0,1,0
51605,2,3,180675,180675,180678,0,3,1
51606,6,2,180681,180681,180683,0,2,3
51607,3,2,180684,180684,180686,0,2,1
51608,5,2,180689,180689,180691,0,2,3
51609,3,3,180692,180692,180695,0,3,1
51610,3,3,180695,180695,180698,0,3,0
51611,6,3,180701,180701,180704,0,3,3
51612,1,3,180702,180704,180707,2,5,0
51613,6,3,180708,180708,180711,0,3,1
51614,3,2,180711,180711,180713,0,2,0
51615,4,2,180715,180715,180717,0,2,2
51616,1,2,180716,180717,180719,1,3,0
51617,6,3,180722,180722,180725,0,3,3
51618,4,3,180726,180726,180729,0,3,1
51619,6,3,180732,180732,180735,0,3,3
51620,5,1,180737,180737,180738,0,1,2
51621,5,3,180742,180742,180745,0,3,4
51622,1,2,180743,180745,180747,2,4,0
51623,1,3,180744,180747,180750,3,6,0
51624,6,1,180750,180750,180751,0,1,0
51625,1,3,180751,180751,180754,0,3,0
51626,1,2,180752,180754,180756,2,4,0
51627,6,2,180758,180758,180760,0,2,2
51628,1,3,180759,180760,180763,1,4,0
51629,1,2,180760,180763,180765,3,5,0
51630,5,3,180765,180765,180768,0,3,0
51631,3,3,180768,180768,180771,0,3,0
51632,4,3,180772,180772,180775,0,3,1
51633,4,2,180776,180776,180778,0,2,1
51634,3,1,180779,180779,180780,0,1,1
51635,3,1,180782,180782,180783,0,1,2
51636,2,3,180784,180784,180787,0,3,1
51637,3,1,180787,180787,180788,0,1,0
51638,3,1,180790,180790,180791,0,1,2
51639,3,3,180793,180793,180796,0,3,2
51640,6,3,180799,180799,180802,0,3,3
51641,1,3,180800,180802,180805,2,5,0
51642,4,3,180804,180805,180808,1,4,0
51643,3,2,180807,180808,180810,1,3,0
51644,3,1,180810,180810,180811,0,1,0
51645,6,1,180816,180816,180817,0,1,5
51646,3,2,180819,180819,180821,0,2,2
51647,4,3,180823,180823,180826,0,3,2
51648,6,3,180829,180829,180832,0,3,3
51649,5,3,180834,180834,180837,0,3,2
51650,2,1,180836,180837,180838,1,2,0
51651,4,2,180840,180840,180842,0,2,2
51652,3,2,180843,180843,180845,0,2,1
51653,3,1,180846,180846,180847,0,1,1
51654,5,2,180851,180851,180853,0,2,4
51655,3,2,180854,180854,180856,0,2,1
51656,5,1,180859,180859,180860,0,1,3
51657,5,3,180864,180864,180867,0,3,4
51658,4,3,180868,180868,180871,0,3,1
51659,4,3,180872,180872,180875,0,3,1
51660,3,3,180875,180875,180878,0,3,0
51661,5,1,180880,180880,180881,0,1,2
51662,3,2,180883,180883,180885,0,2,2
51663,6,1,180889,180889,180890,0,1,4
51664,4,2,180893,180893,180895,0,2,3
51665,2,2,180895,180895,180897,0,2,0
51666,2,3,180897,180897,180900,0,3,0
51667,6,2,180903,180903,180905,0,2,3
51668,5,3,180908,180908,180911,0,3,3
51669,3,3,180911,180911,180914,0,3,0
51670,4,1,180915,180915,180916,0,1,1
51671,4,3,180919,180919,180922,0,3,3
51672,2,2,180921,180922,180924,1,3,0
51673,1,3,180922,180924,180927,2,5,0
51674,4,2,180926,180927,180929,1,3,0
51675,5,3,180931,180931,180934,0,3,2
51676,4,3,180935,180935,180938,0,3,1
51677,2,2,180937,180938,180940,1,3,0
51678,2,1,180939,180940,180941,1,2,0
51679,3,3,180942,180942,180945,0,3,1
51680,4,1,180946,180946,180947,0,1,1
51681,3,2,180949,180949,180951,0,2,2
51682,2,2,180951,180951,180953,0,2,0
51683,6,1,180957,180957,180958,0,1,4
51684,6,3,180963,180963,180966,0,3,5
51685,2,3,180965,180966,180969,1,4,0
51686,4,1,180969,180969,180970,0,1,0
51687,6,1,180975,180975,180976,0,1,5
51688,6,2,180981,180981,180983,0,2,5
51689,2,2,180983,180983,180985,0,2,0
51690,4,3,180987,180987,180990,0,3,2
51691,2,3,180989,180990,180993,1,4,0
51692,6,3,180995,180995,180998,0,3,2
51693,3,3,180998,180998,181001,0,3,0
51694,6,3,181004,181004,181007,0,3,3
51695,6,2,181010,181010,181012,0,2,3
51696,6,2,181016,181016,181018,0,2,4
51697,5,1,181021,181021,181022,0,1,3
51698,1,2,181022,181022,181024,0,2,0
51699,6,1,181028,181028,181029,0,1,4
51700,1,2,181029,181029,181031,0,2,0
51701,2,3,181031,181031,181034,0,3,0
51702,4,1,181035,181035,181036,0,1,1
51703,4,2,181039,181039,181041,0,2,3
51704,1,1,181040,181041,181042,1,2,0
51705,3,1,181043,181043,181044,0,1,1
51706,3,2,181046,181046,181048,0,2,2
51707,2,3,181048,181048,181051,0,3,0
51708,3,1,181051,181051,181052,0,1,0
51709,2,3,181053,181053,181056,0,3,1
51710,4,1,181057,181057,181058,0,1,1
51711,4,3,181061,181061,181064,0,3,3
51712,1,2,181062,181064,181066,2,4,0
51713,6,1,181068,181068,181069,0,1,2
51714,1,1,181069,181069,181070,0,1,0
51715,5,2,181074,181074,181076,0,2,4
51716,1,3,181075,181076,181079,1,4,0
51717,3,3,181078,181079,181082,1,4,0
51718,1,2,181079,181082,181084,3,5,0
51719,2,3,181081,181084,181087,3,6,0
51720,4,1,181085,181087,181088,2,3,0
51721,3,3,181088,181088,181091,0,3,0
51722,5,3,181093,181093,181096,0,3,2
51723,5,3,181098,181098,181101,0,3,2
51724,5,3,181103,181103,181106,0,3,2
51725,5,2,181108,181108,181110,0,2,2
51726,2,2,181110,181110,181112,0,2,0
51727,2,2,181112,181112,181114,0,2,0
51728,3,2,181115,181115,181117,0,2,1
51729,5,1,181120,181120,181121,0,1,3
51730,5,3,181125,181125,181128,0,3,4
51731,5,1,181130,181130,181131,0,1,2
51732,2,2,181132,181132,181134,0,2,1
51733,4,1,181136,181136,181137,0,1,2
51734,5,2,181141,181141,181143,0,2,4
51735,2,1,181143,181143,181144,0,1,0
51736,4,2,181147,181147,181149,0,2,3
51737,2,3,181149,181149,181152,0,3,0
51738,4,3,181153,181153,181156,0,3,1
51739,5,2,181158,181158,181160,0,2,2
51740,6,2,181164,181164,181166,0,2,4
51741,6,3,181170,181170,181173,0,3,4
51742,1,1,181171,181173,181174,2,3,0
51743,5,2,181176,181176,181178,0,2,2
51744,2,3,181178,181178,181181,0,3,0
51745,4,3,181182,181182,181185,0,3,1
51746,3,3,181185,181185,181188,0,3,0
51747,1,3,181186,181188,181191,2,5,0
51748,5,1,181191,181191,181192,0,1,0
51749,3,2,181194,181194,181196,0,2,2
51750,6,3,181200,181200,181203,0,3,4
51751,5,1,181205,181205,181206,0,1,2
51752,6,3,181211,181211,181214,0,3,5
51753,3,2,181214,181214,181216,0,2,0
51754,4,3,181218,181218,181221,0,3,2
51755,3,3,181221,181221,181224,0,3,0
51756,1,2,181222,181224,181226,2,4,0
51757,4,2,181226,181226,181228,0,2,0
51758,2,3,181228,181228,181231,0,3,0
51759,5,3,181233,181233,181236,0,3,2
51760,2,3,181235,181236,181239,1,4,0
51761,5,1,181240,181240,181241,0,1,1
51762,4,1,181244,181244,181245,0,1,3
51763,6,1,181250,181250,181251,0,1,5
51764,4,2,181254,181254,181256,0,2,3
51765,1,1,181255,181256,181257,1,2,0
51766,6,1,181261,181261,181262,0,1,4
51767,3,1,181264,181264,181265,0,1,2
51768,5,3,181269,181269,181272,0,3,4
51769,6,1,181275,181275,181276,0,1,3
51770,2,2,181277,181277,181279,0,2,1
51771,1,3,181278,181279,181282,1,4,0
51772,2,3,181280,181282,181285,2,5,0
51773,1,3,181281,181285,181288,4,7,0
51774,3,2,181284,181288,181290,4,6,0
51775,2,1,181286,181290,181291,4,5,0
51776,2,1,181288,181291,181292,3,4,0
51777,6,3,181294,181294,181297,0,3,2
51778,6,2,181300,181300,181302,0,2,3
51779,1,1,181301,181302,181303,1,2,0
51780,2,2,181303,181303,181305,0,2,0
51781,1,3,181304,181305,181308,1,4,0
51782,2,1,181306,181308,181309,2,3,0
51783,5,2,181311,181311,181313,0,2,2
51784,1,1,181312,181313,181314,1,2,0
51785,4,2,181316,181316,181318,0,2,2
51786,2,1,181318,181318,181319,0,1,0
51787,6,1,181324,181324,181325,0,1,5
51788,2,2,181326,181326,181328,0,2,1
51789,1,2,181327,181328,181330,1,3,0
51790,4,1,181331,181331,181332,0,1,1
51791,5,2,181336,181336,181338,0,2,4
51792,5,3,181341,181341,181344,0,3,3
51793,6,2,181347,181347,181349,0,2,3
51794,3,3,181350,181350,181353,0,3,1
51795,3,2,181353,181353,181355,0,2,0
51796,2,1,181355,181355,181356,0,1,0
51797,1,2,181356,181356,181358,0,2,0
51798,2,2,181358,181358,181360,0,2,0
51799,1,3,181359,181360,181363,1,4,0
51800,3,3,181362,181363,181366,1,4,0
51801,3,1,181365,181366,181367,1,2,0
51802,6,3,181371,181371,181374,0,3,4
51803,3,2,181374,181374,181376,0,2,0
51804,3,2,181377,181377,181379,0,2,1
51805,5,3,181382,181382,181385,0,3,3
51806,2,1,181384,181385,181386,1,2,0
51807,4,2,181388,181388,181390,0,2,2
51808,5,2,181393,181393,181395,0,2,3
51809,1,3,181394,181395,181398,1,4,0
51810,1,3,181395,181398,181401,3,6,0
51811,3,1,181398,181401,181402,3,4,0
51812,3,2,181401,181402,181404,1,3,0
51813,4,1,181405,181405,181406,0,1,1
51814,6,2,181411,181411,181413,0,2,5
51815,6,3,181417,181417,181420,0,3,4
51816,2,1,181419,181420,181421,1,2,0
51817,4,2,181423,181423,181425,0,2,2
51818,3,1,181426,181426,181427,0,1,1
51819,1,2,181427,181427,181429,0,2,0
51820,2,3,181429,181429,181432,0,3,0
51821,2,1,181431,181432,181433,1,2,0
51822,5,3,181436,181436,181439,0,3,3
51823,6,3,181442,181442,181445,0,3,3
51824,1,2,181443,181445,181447,2,4,0
51825,5,1,181448,181448,181449,0,1,1
51826,1,1,181449,181449,181450,0,1,0
51827,1,1,181450,181450,181451,0,1,0
51828,6,2,181456,181456,181458,0,2,5
51829,2,2,181458,181458,181460,0,2,0
51830,5,1,181463,181463,181464,0,1,3
51831,3,1,181466,181466,181467,0,1,2
51832,6,2,181472,181472,181474,0,2,5
51833,5,1,181477,181477,181478,0,1,3
51834,4,2,181481,181481,181483,0,2,3
51835,2,2,181483,181483,181485,0,2,0
51836,4,3,181487,181487,181490,0,3,2
51837,5,3,181492,181492,181495,0,3,2
51838,1,3,181493,181495,181498,2,5,0
51839,1,1,181494,181498,181499,4,5,0
51840,2,3,181496,181499,181502,3,6,0
51841,1,3,181497,181502,181505,5,8,0
51842,4,3,181501,181505,181508,4,7,0
51843,1,1,181502,181508,181509,6,7,0
51844,4,3,181506,181509,181512,3,6,0
51845,2,2,181508,181512,181514,4,6,0
51846,3,2,181511,181514,181516,3,5,0
51847,1,2,181512,181516,181518,4,6,0
51848,4,3,181516,181518,181521,2,5,0
51849,5,3,181521,181521,181524,0,3,0
51850,1,2,181522,181524,181526,2,4,0
51851,1,2,181523,181526,181528,3,5,0
51852,2,1,181525,181528,181529,3,4,0
51853,5,2,181530,181530,181532,0,2,1
51854,5,3,181535,181535,181538,0,3,3
51855,2,1,181537,181538,181539,1,2,0
51856,4,2,181541,181541,181543,0,2,2
51857,2,2,181543,181543,181545,0,2,0
51858,3,1,181546,181546,181547,0,1,1
51859,6,1,181552,181552,181553,0,1,5
51860,6,2,181558,181558,181560,0,2,5
51861,6,3,181564,181564,181567,0,3,4
51862,4,3,181568,181568,181571,0,3,1
51863,2,2,181570,181571,181573,1,3,0
51864,1,3,181571,181573,181576,2,5,0
51865,6,1,181577,181577,181578,0,1,1
51866,4,2,181581,181581,181583,0,2,3
51867,6,1,181587,181587,181588,0,1,4
51868,6,1,181593,181593,181594,0,1,5
51869,1,3,181594,181594,181597,0,3,0
51870,1,2,181595,181597,181599,2,4,0
51871,4,2,181599,181599,181601,0,2,0
51872,1,1,181600,181601,181602,1,2,0
51873,2,1,181602,181602,181603,0,1,0
51874,1,1,181603,181603,181604,0,1,0
51875,3,3,181606,181606,181609,0,3,2
51876,6,3,181612,181612,181615,0,3,3
51877,4,3,181616,181616,181619,0,3,1
51878,3,3,181619,181619,181622,0,3,0
51879,4,1,181623,181623,181624,0,1,1
51880,5,3,181628,181628,181631,0,3,4
51881,3,2,181631,181631,181633,0,2,0
51882,2,3,181633,181633,181636,0,3,0
51883,1,1,181634,181636,181637,2,3,0
51884,3,1,181637,181637,181638,0,1,0
51885,3,1,181640,181640,181641,0,1,2
51886,2,2,181642,181642,181644,0,2,1
51887,2,1,181644,181644,181645,0,1,0
51888,4,1,181648,181648,181649,0,1,3
51889,4,1,181652,181652,181653,0,1,3
51890,2,3,181654,181654,181657,0,3,1
51891,5,2,181659,181659,181661,0,2,2
51892,2,3,181661,181661,181664,0,3,0
51893,3,1,181664,181664,181665,0,1,0
51894,5,3,181669,181669,181672,0,3,4
51895,3,1,181672,181672,181673,0,1,0
51896,5,3,181677,181677,181680,0,3,4
51897,3,3,181680,181680,181683,0,3,0
51898,6,1,181686,181686,181687,0,1,3
51899,5,2,181691,181691,181693,0,2,4
51900,4,1,181695,181695,181696,0,1,2
51901,2,1,181697,181697,181698,0,1,1
51902,2,2,181699,181699,181701,0,2,1
51903,2,1,181701,181701,181702,0,1,0
51904,1,1,181702,181702,181703,0,1,0
51905,3,1,181705,181705,181706,0,1,2
51906,3,2,181708,181708,181710,0,2,2
51907,1,1,181709,181710,181711,1,2,0
51908,5,3,181714,181714,181717,0,3,3
51909,6,2,181720,181720,181722,0,2,3
51910,2,3,181722,181722,181725,0,3,0
51911,5,2,181727,181727,181729,0,2,2
51912,1,1,181728,181729,181730,1,2,0
51913,4,1,181732,181732,181733,0,1,2
51914,4,2,181736,181736,181738,0,2,3
51915,4,3,181740,181740,181743,0,3,2
51916,6,2,181746,181746,181748,0,2,3
51917,5,2,181751,181751,181753,0,2,3
51918,4,1,181755,181755,181756,0,1,2
51919,3,2,181758,181758,181760,0,2,2
51920,2,1,181760,181760,181761,0,1,0
51921,4,1,181764,181764,181765,0,1,3
51922,2,1,181766,181766,181767,0,1,1
51923,4,2,181770,181770,181772,0,2,3
51924,3,3,181773,181773,181776,0,3,1
51925,5,3,181778,181778,181781,0,3,2
51926,5,3,181783,181783,181786,0,3,2
51927,1,3,181784,181786,181789,2,5,0
51928,2,2,181786,181789,181791,3,5,0
51929,6,1,181792,181792,181793,0,1,1
51930,2,2,181794,181794,181796,0,2,1
51931,5,3,181799,181799,181802,0,3,3
51932,2,1,181801,181802,181803,1,2,0
51933,1,1,181802,181803,181804,1,2,0
51934,4,2,181806,181806,181808,0,2,2
51935,3,3,181809,181809,181812,0,3,1
51936,3,1,181812,181812,181813,0,1,0
51937,2,3,181814,181814,181817,0,3,1
51938,4,1,181818,181818,181819,0,1,1
51939,5,2,181823,181823,181825,0,2,4
51940,1,2,181824,181825,181827,1,3,0
51941,1,1,181825,181827,181828,2,3,0
51942,4,3,181829,181829,181832,0,3,1
51943,1,1,181830,181832,181833,2,3,0
51944,2,3,181832,181833,181836,1,4,0
51945,2,3,181834,181836,181839,2,5,0
51946,5,3,181839,181839,181842,0,3,0
51947,1,3,181840,181842,181845,2,5,0
51948,3,2,181843,181845,181847,2,4,0
51949,4,2,181847,181847,181849,0,2,0
51950,6,3,181853,181853,181856,0,3,4
51951,2,3,181855,181856,181859,1,4,0
51952,6,1,181861,181861,181862,0,1,2
51953,2,1,181863,181863,181864,0,1,1
51954,6,1,181869,181869,181870,0,1,5
51955,6,1,181875,181875,181876,0,1,5
51956,1,1,181876,181876,181877,0,1,0
51957,4,2,181880,181880,181882,0,2,3
51958,2,3,181882,181882,181885,0,3,0
51959,6,2,181888,181888,181890,0,2,3
51960,1,3,181889,181890,181893,1,4,0
51961,2,1,181891,181893,181894,2,3,0
51962,1,1,181892,181894,181895,2,3,0
51963,6,3,181898,181898,181901,0,3,3
51964,1,1,181899,181901,181902,2,3,0
51965,5,3,181904,181904,181907,0,3,2
51966,1,1,181905,181907,181908,2,3,0
51967,5,3,181910,181910,181913,0,3,2
51968,6,2,181916,181916,181918,0,2,3
51969,1,2,181917,181918,181920,1,3,0
51970,5,1,181922,181922,181923,0,1,2
51971,5,3,181927,181927,181930,0,3,4
51972,5,1,181932,181932,181933,0,1,2
51973,3,3,181935,181935,181938,0,3,2
51974,5,1,181940,181940,181941,0,1,2
51975,1,1,181941,181941,181942,0,1,0
51976,3,2,181944,181944,181946,0,2,2
51977,1,3,181945,181946,181949,1,4,0
51978,3,3,181948,181949,181952,1,4,0
51979,2,2,181950,181952,181954,2,4,0
51980,5,1,181955,181955,181956,0,1,1
51981,5,2,181960,181960,181962,0,2,4
51982,6,1,181966,181966,181967,0,1,4
51983,4,1,181970,181970,181971,0,1,3
51984,6,3,181976,181976,181979,0,3,5
51985,4,2,181980,181980,181982,0,2,1
51986,4,2,181984,181984,181986,0,2,2
51987,2,2,181986,181986,181988,0,2,0
51988,1,1,181987,181988,181989,1,2,0
51989,6,2,181993,181993,181995,0,2,4
51990,4,2,181997,181997,181999,0,2,2
51991,1,3,181998,181999,182002,1,4,0
51992,4,3,182002,182002,182005,0,3,0
51993,6,3,182008,182008,182011,0,3,3
51994,5,1,182013,182013,182014,0,1,2
51995,4,2,182017,182017,182019,0,2,3
51996,5,2,182022,182022,182024,0,2,3
51997,2,3,182024,182024,182027,0,3,0
51998,5,3,182029,182029,182032,0,3,2
51999,1,1,182030,182032,182033,2,3,0
52000,5,2,182035,182035,182037,0,2,2
52001,1,3,182036,182037,182040,1,4,0
52002,5,1,182041,182041,182042,0,1,1
52003,4,2,182045,182045,182047,0,2,3
52004,2,1,182047,182047,182048,0,1,0
52005,5,2,182052,182052,182054,0,2,4
52006,4,2,182056,182056,182058,0,2,2
52007,6,1,182062,182062,182063,0,1,4
52008,5,3,182067,182067,182070,0,3,4
52009,5,2,182072,182072,182074,0,2,2
52010,2,1,182074,182074,182075,0,1,0
52011,2,2,182076,182076,182078,0,2,1
52012,1,3,182077,182078,182081,1,4,0
52013,4,1,182081,182081,182082,0,1,0
52014,6,1,182087,182087,182088,0,1,5
52015,6,2,182093,182093,182095,0,2,5
52016,6,2,182099,182099,182101,0,2,4
52017,4,1,182103,182103,182104,0,1,2
52018,2,2,182105,182105,182107,0,2,1
52019,5,1,182110,182110,182111,0,1,3
52020,5,1,182115,182115,182116,0,1,4
52021,3,1,182118,182118,182119,0,1,2
52022,3,3,182121,182121,182124,0,3,2
52023,6,3,182127,182127,182130,0,3,3
52024,5,3,182132,182132,182135,0,3,2
52025,3,1,182135,182135,182136,0,1,0
52026,6,2,182141,182141,182143,0,2,5
52027,2,1,182143,182143,182144,0,1,0
52028,5,1,182148,182148,182149,0,1,4
52029,2,2,182150,182150,182152,0,2,1
52030,4,2,182154,182154,182156,0,2,2
52031,5,3,182159,182159,182162,0,3,3
52032,4,2,182163,182163,182165,0,2,1
52033,1,2,182164,182165,182167,1,3,0
52034,3,1,182167,182167,182168,0,1,0
52035,1,3,182168,182168,182171,0,3,0
52036,3,3,182171,182171,182174,0,3,0
52037,5,1,182176,182176,182177,0,1,2
52038,4,2,182180,182180,182182,0,2,3
52039,2,1,182182,182182,182183,0,1,0
52040,6,2,182188,182188,182190,0,2,5
52041,4,1,182192,182192,182193,0,1,2
52042,3,1,182195,182195,182196,0,1,2
52043,1,3,182196,182196,182199,0,3,0
52044,3,2,182199,182199,182201,0,2,0
52045,6,2,182205,182205,182207,0,2,4
52046,2,3,182207,182207,182210,0,3,0
52047,1,1,182208,182210,182211,2,3,0
52048,1,3,182209,182211,182214,2,5,0
52049,3,2,182212,182214,182216,2,4,0
52050,6,2,182218,182218,182220,0,2,2
52051,2,2,182220,182220,182222,0,2,0
52052,4,3,182224,182224,182227,0,3,2
52053,3,2,182227,182227,182229,0,2,0
52054,3,2,182230,182230,182232,0,2,1
52055,5,3,182235,182235,182238,0,3,3
52056,1,3,182236,182238,182241,2,5,0
52057,6,3,182242,182242,182245,0,3,1
52058,6,2,182248,182248,182250,0,2,3
52059,1,1,182249,182250,182251,1,2,0
52060,6,1,182255,182255,182256,0,1,4
52061,5,3,182260,182260,182263,0,3,4
52062,1,2,182261,182263,182265,2,4,0
52063,2,2,182263,182265,182267,2,4,0
52064,2,3,182265,182267,182270,2,5,0
52065,5,3,182270,182270,182273,0,3,0
52066,2,2,182272,182273,182275,1,3,0
52067,4,3,182276,182276,182279,0,3,1
52068,2,2,182278,182279,182281,1,3,0
52069,1,2,182279,182281,182283,2,4,0
52070,2,2,182281,182283,182285,2,4,0
52071,2,2,182283,182285,182287,2,4,0
52072,2,2,182285,182287,182289,2,4,0
52073,5,1,182290,182290,182291,0,1,1
52074,2,1,182292,182292,182293,0,1,1
52075,3,2,182295,182295,182297,0,2,2
52076,5,2,182300,182300,182302,0,2,3
52077,1,2,182301,182302,182304,1,3,0
52078,4,2,182305,182305,182307,0,2,1
52079,6,3,182311,182311,182314,0,3,4
52080,1,1,182312,182314,182315,2,3,0
52081,4,2,182316,182316,182318,0,2,1
52082,1,2,182317,182318,182320,1,3,0
52083,3,2,182320,182320,182322,0,2,0
52084,1,1,182321,182322,182323,1,2,0
52085,5,3,182326,182326,182329,0,3,3
52086,6,2,182332,182332,182334,0,2,3
52087,4,2,182336,182336,182338,0,2,2
52088,4,1,182340,182340,182341,0,1,2
52089,3,1,182343,182343,182344,0,1,2
52090,1,1,182344,182344,182345,0,1,0
52091,2,2,182346,182346,182348,0,2,1
52092,4,3,182350,182350,182353,0,3,2
52093,4,2,182354,182354,182356,0,2,1
52094,6,3,182360,182360,182363,0,3,4
52095,6,1,182366,182366,182367,0,1,3
52096,5,1,182371,182371,182372,0,1,4
52097,4,3,182375,182375,182378,0,3,3
52098,5,3,182380,182380,182383,0,3,2
52099,1,1,182381,182383,182384,2,3,0
52100,2,2,182383,182384,182386,1,3,0
52101,5,2,182388,182388,182390,0,2,2
52102,4,2,182392,182392,182394,0,2,2
52103,6,3,182398,182398,182401,0,3,4
52104,1,2,182399,182401,182403,2,4,0
52105,2,2,182401,182403,182405,2,4,0
52106,6,2,182407,182407,182409,0,2,2
52107,4,3,182411,182411,182414,0,3,2
52108,2,2,182413,182414,182416,1,3,0
52109,4,3,182417,182417,182420,0,3,1
52110,1,2,182418,182420,182422,2,4,0
52111,1,1,182419,182422,182423,3,4,0
52112,3,2,182422,182423,182425,1,3,0
52113,1,2,182423,182425,182427,2,4,0
52114,4,3,182427,182427,182430,0,3,0
52115,5,3,182432,182432,182435,0,3,2
52116,4,2,182436,182436,182438,0,2,1
52117,5,2,182441,182441,182443,0,2,3
52118,2,2,182443,182443,182445,0,2,0
52119,2,2,182445,182445,182447,0,2,0
52120,6,2,182451,182451,182453,0,2,4
52121,5,3,182456,182456,182459,0,3,3
52122,2,2,182458,182459,182461,1,3,0
52123,1,2,182459,182461,182463,2,4,0
52124,3,3,182462,182463,182466,1,4,0
52125,6,2,182468,182468,182470,0,2,2
52126,1,3,182469,182470,182473,1,4,0
52127,1,3,182470,182473,182476,3,6,0
52128,3,3,182473,182476,182479,3,6,0
52129,2,3,182475,182479,182482,4,7,0
52130,5,1,182480,182482,182483,2,3,0
52131,5,1,182485,182485,182486,0,1,2
52132,2,2,182487,182487,182489,0,2,1
52133,2,3,182489,182489,182492,0,3,0
52134,3,2,182492,182492,182494,0,2,0
52135,4,1,182496,182496,182497,0,1,2
52136,3,2,182499,182499,182501,0,2,2
52137,1,1,182500,182501,182502,1,2,0
52138,6,3,182506,182506,182509,0,3,4
52139,5,2,182511,182511,182513,0,2,2
52140,1,3,182512,182513,182516,1,4,0
52141,3,1,182515,182516,182517,1,2,0
52142,2,2,182517,182517,182519,0,2,0
52143,6,2,182523,182523,182525,0,2,4
52144,6,1,182529,182529,182530,0,1,4
52145,4,1,182533,182533,182534,0,1,3
52146,3,1,182536,182536,182537,0,1,2
52147,4,3,182540,182540,182543,0,3,3
52148,4,3,182544,182544,182547,0,3,1
52149,4,2,182548,182548,182550,0,2,1
52150,3,3,182551,182551,182554,0,3,1
52151,2,1,182553,182554,182555,1,2,0
52152,6,2,182559,182559,182561,0,2,4
52153,4,2,182563,182563,182565,0,2,2
52154,4,3,182567,182567,182570,0,3,2
52155,1,2,182568,182570,182572,2,4,0
52156,2,3,182570,182572,182575,2,5,0
52157,4,3,182574,182575,182578,1,4,0
52158,2,1,182576,182578,182579,2,3,0
52159,6,1,182582,182582,182583,0,1,3
52160,5,2,182587,182587,182589,0,2,4
52161,5,1,182592,182592,182593,0,1,3
52162,4,2,182596,182596,182598,0,2,3
52163,1,2,182597,182598,182600,1,3,0
52164,2,3,182599,182600,182603,1,4,0
52165,1,1,182600,182603,182604,3,4,0
52166,5,2,182605,182605,182607,0,2,1
52167,1,2,182606,182607,182609,1,3,0
52168,5,3,182611,182611,182614,0,3,2
52169,5,2,182616,182616,182618,0,2,2
52170,4,1,182620,182620,182621,0,1,2
52171,3,1,182623,182623,182624,0,1,2
52172,2,1,182625,182625,182626,0,1,1
52173,2,1,182627,182627,182628,0,1,1
52174,3,2,182630,182630,182632,0,2,2
52175,5,2,182635,182635,182637,0,2,3
52176,3,3,182638,182638,182641,0,3,1
52177,5,1,182643,182643,182644,0,1,2
52178,2,1,182645,182645,182646,0,1,1
52179,4,3,182649,182649,182652,0,3,3
52180,4,1,182653,182653,182654,0,1,1
52181,3,1,182656,182656,182657,0,1,2
52182,2,3,182658,182658,182661,0,3,1
52183,6,1,182664,182664,182665,0,1,3
52184,3,1,182667,182667,182668,0,1,2
52185,5,1,182672,182672,182673,0,1,4
52186,1,1,182673,182673,182674,0,1,0
52187,3,2,182676,182676,182678,0,2,2
52188,6,2,182682,182682,182684,0,2,4
52189,1,3,182683,182684,182687,1,4,0
52190,4,2,182687,182687,182689,0,2,0
52191,3,1,182690,182690,182691,0,1,1
52192,5,3,182695,182695,182698,0,3,4
52193,4,1,182699,182699,182700,0,1,1
52194,4,3,182703,182703,182706,0,3,3
52195,1,3,182704,182706,182709,2,5,0
52196,2,3,182706,182709,182712,3,6,0
52197,2,1,182708,182712,182713,4,5,0
52198,1,3,182709,182713,182716,4,7,0
52199,3,1,182712,182716,182717,4,5,0
52200,4,3,182716,182717,182720,1,4,0
52201,3,2,182719,182720,182722,1,3,0
52202,5,1,182724,182724,182725,0,1,2
52203,6,3,182730,182730,182733,0,3,5
52204,3,2,182733,182733,182735,0,2,0
52205,1,2,182734,182735,182737,1,3,0
52206,1,1,182735,182737,182738,2,3,0
52207,4,3,182739,182739,182742,0,3,1
52208,2,2,182741,182742,182744,1,3,0
52209,3,2,182744,182744,182746,0,2,0
52210,3,2,182747,182747,182749,0,2,1
52211,2,3,182749,182749,182752,0,3,0
52212,4,2,182753,182753,182755,0,2,1
52213,1,1,182754,182755,182756,1,2,0
52214,6,3,182760,182760,182763,0,3,4
52215,3,1,182763,182763,182764,0,1,0
52216,2,1,182765,182765,182766,0,1,1
52217,2,1,182767,182767,182768,0,1,1
52218,5,2,182772,182772,182774,0,2,4
52219,5,3,182777,182777,182780,0,3,3
52220,4,2,182781,182781,182783,0,2,1
52221,6,3,182787,182787,182790,0,3,4
52222,3,1,182790,182790,182791,0,1,0
52223,4,1,182794,182794,182795,0,1,3
52224,4,1,182798,182798,182799,0,1,3
52225,6,1,182804,182804,182805,0,1,5
52226,5,1,182809,182809,182810,0,1,4
52227,6,2,182815,182815,182817,0,2,5
52228,3,2,182818,182818,182820,0,2,1
52229,6,2,182824,182824,182826,0,2,4
52230,3,2,182827,182827,182829,0,2,1
52231,4,1,182831,182831,182832,0,1,2
52232,3,3,182834,182834,182837,0,3,2
52233,6,2,182840,182840,182842,0,2,3
52234,3,2,182843,182843,182845,0,2,1
52235,5,1,182848,182848,182849,0,1,3
52236,3,3,182851,182851,182854,0,3,2
52237,3,3,182854,182854,182857,0,3,0
52238,3,3,182857,182857,182860,0,3,0
52239,5,3,182862,182862,182865,0,3,2
52240,4,3,182866,182866,182869,0,3,1
52241,1,2,182867,182869,182871,2,4,0
52242,2,3,182869,182871,182874,2,5,0
52243,1,3,182870,182874,182877,4,7,0
52244,6,3,182876,182877,182880,1,4,0
52245,6,2,182882,182882,182884,0,2,2
52246,5,2,182887,182887,182889,0,2,3
52247,1,1,182888,182889,182890,1,2,0
52248,6,3,182894,182894,182897,0,3,4
52249,1,2,182895,182897,182899,2,4,0
52250,5,1,182900,182900,182901,0,1,1
52251,4,1,182904,182904,182905,0,1,3
52252,3,3,182907,182907,182910,0,3,2
52253,3,1,182910,182910,182911,0,1,0
52254,4,3,182914,182914,182917,0,3,3
52255,1,1,182915,182917,182918,2,3,0
52256,6,2,182921,182921,182923,0,2,3
52257,4,3,182925,182925,182928,0,3,2
52258,1,1,182926,182928,182929,2,3,0
52259,1,1,182927,182929,182930,2,3,0
52260,2,3,182929,182930,182933,1,4,0
52261,3,3,182932,182933,182936,1,4,0
52262,6,3,182938,182938,182941,0,3,2
52263,2,3,182940,182941,182944,1,4,0
52264,1,1,182941,182944,182945,3,4,0
52265,3,3,182944,182945,182948,1,4,0
52266,5,2,182949,182949,182951,0,2,1
52267,3,2,182952,182952,182954,0,2,1
52268,6,3,182958,182958,182961,0,3,4
52269,3,2,182961,182961,182963,0,2,0
52270,5,2,182966,182966,182968,0,2,3
52271,1,1,182967,182968,182969,1,2,0
52272,2,2,182969,182969,182971,0,2,0
52273,3,2,182972,182972,182974,0,2,1
52274,3,2,182975,182975,182977,0,2,1
52275,5,2,182980,182980,182982,0,2,3
52276,5,1,182985,182985,182986,0,1,3
52277,2,1,182987,182987,182988,0,1,1
52278,1,3,182988,182988,182991,0,3,0
52279,4,3,182992,182992,182995,0,3,1
52280,2,1,182994,182995,182996,1,2,0
52281,6,2,183000,183000,183002,0,2,4
52282,1,2,183001,183002,183004,1,3,0
52283,2,1,183003,183004,183005,1,2,0
52284,5,1,183008,183008,183009,0,1,3
52285,3,2,183011,183011,183013,0,2,2
52286,1,1,183012,183013,183014,1,2,0
52287,2,1,183014,183014,183015,0,1,0
52288,2,1,183016,183016,183017,0,1,1
52289,6,3,183022,183022,183025,0,3,5
52290,5,2,183027,183027,183029,0,2,2
52291,5,1,183032,183032,183033,0,1,3
52292,5,3,183037,183037,183040,0,3,4
52293,3,3,183040,183040,183043,0,3,0
52294,6,2,183046,183046,183048,0,2,3
52295,2,3,183048,183048,183051,0,3,0
52296,5,2,183053,183053,183055,0,2,2
52297,2,2,183055,183055,183057,0,2,0
52298,2,3,183057,183057,183060,0,3,0
52299,5,1,183062,183062,183063,0,1,2
52300,1,1,183063,183063,183064,0,1,0
52301,6,1,183069,183069,183070,0,1,5
52302,1,3,183070,183070,183073,0,3,0
52303,4,3,183074,183074,183077,0,3,1
52304,6,3,183080,183080,183083,0,3,3
52305,6,2,183086,183086,183088,0,2,3
52306,3,2,183089,183089,183091,0,2,1
52307,5,2,183094,183094,183096,0,2,3
52308,4,3,183098,183098,183101,0,3,2
52309,3,2,183101,183101,183103,0,2,0
52310,4,3,183105,183105,183108,0,3,2
52311,3,3,183108,183108,183111,0,3,0
52312,3,3,183111,183111,183114,0,3,0
52313,4,2,183115,183115,183117,0,2,1
52314,4,1,183119,183119,183120,0,1,2
52315,6,2,183125,183125,183127,0,2,5
52316,2,1,183127,183127,183128,0,1,0
52317,5,3,183132,183132,183135,0,3,4
52318,6,1,183138,183138,183139,0,1,3
52319,3,3,183141,183141,183144,0,3,2
52320,6,1,183147,183147,183148,0,1,3
52321,3,1,183150,183150,183151,0,1,2
52322,5,1,183155,183155,183156,0,1,4
52323,3,3,183158,183158,183161,0,3,2
52324,6,3,183164,183164,183167,0,3,3
52325,4,1,183168,183168,183169,0,1,1
52326,6,2,183174,183174,183176,0,2,5
52327,3,1,183177,183177,183178,0,1,1
52328,3,1,183180,183180,183181,0,1,2
52329,4,1,183184,183184,183185,0,1,3
52330,2,1,183186,183186,183187,0,1,1
52331,3,1,183189,183189,183190,0,1,2
52332,4,3,183193,183193,183196,0,3,3
52333,1,3,183194,183196,183199,2,5,0
52334,4,2,183198,183199,183201,1,3,0
52335,5,3,183203,183203,183206,0,3,2
52336,3,3,183206,183206,183209,0,3,0
52337,2,1,183208,183209,183210,1,2,0
52338,5,1,183213,183213,183214,0,1,3
52339,2,1,183215,183215,183216,0,1,1
52340,6,2,183221,183221,183223,0,2,5
52341,3,2,183224,183224,183226,0,2,1
52342,3,1,183227,183227,183228,0,1,1
52343,6,2,183233,183233,183235,0,2,5
52344,2,3,183235,183235,183238,0,3,0
52345,6,3,183241,183241,183244,0,3,3
52346,3,2,183244,183244,183246,0,2,0
52347,6,3,183250,183250,183253,0,3,4
52348,1,1,183251,183253,183254,2,3,0
52349,1,1,183252,183254,183255,2,3,0
52350,2,1,183254,183255,183256,1,2,0
52351,6,2,183260,183260,183262,0,2,4
52352,4,2,183264,183264,183266,0,2,2
52353,2,3,183266,183266,183269,0,3,0
52354,4,1,183270,183270,183271,0,1,1
52355,4,3,183274,183274,183277,0,3,3
52356,1,2,183275,183277,183279,2,4,0
52357,5,3,183280,183280,183283,0,3,1
52358,2,1,183282,183283,183284,1,2,0
52359,3,1,183285,183285,183286,0,1,1
52360,3,1,183288,183288,183289,0,1,2
52361,5,1,183293,183293,183294,0,1,4
52362,5,2,183298,183298,183300,0,2,4
52363,5,1,183303,183303,183304,0,1,3
52364,1,2,183304,183304,183306,0,2,0
52365,6,2,183310,183310,183312,0,2,4
52366,6,3,183316,183316,183319,0,3,4
52367,4,1,183320,183320,183321,0,1,1
52368,2,3,183322,183322,183325,0,3,1
52369,1,3,183323,183325,183328,2,5,0
52370,5,2,183328,183328,183330,0,2,0
52371,5,1,183333,183333,183334,0,1,3
52372,3,3,183336,183336,183339,0,3,2
52373,1,2,183337,183339,183341,2,4,0
52374,1,1,183338,183341,183342,3,4,0
52375,5,2,183343,183343,183345,0,2,1
52376,4,2,183347,183347,183349,0,2,2
52377,3,2,183350,183350,183352,0,2,1
52378,2,1,183352,183352,183353,0,1,0
52379,2,3,183354,183354,183357,0,3,1
52380,5,3,183359,183359,183362,0,3,2
52381,3,2,183362,183362,183364,0,2,0
52382,5,2,183367,183367,183369,0,2,3
52383,5,3,183372,183372,183375,0,3,3
52384,5,3,183377,183377,183380,0,3,2
52385,2,3,183379,183380,183383,1,4,0
52386,6,1,183385,183385,183386,0,1,2
52387,1,1,183386,183386,183387,0,1,0
52388,6,1,183392,183392,183393,0,1,5
52389,5,3,183397,183397,183400,0,3,4
52390,6,3,183403,183403,183406,0,3,3
52391,3,2,183406,183406,183408,0,2,0
52392,4,2,183410,183410,183412,0,2,2
52393,3,3,183413,183413,183416,0,3,1
52394,2,1,183415,183416,183417,1,2,0
52395,6,2,183421,183421,183423,0,2,4
52396,2,1,183423,183423,183424,0,1,0
52397,4,2,183427,183427,183429,0,2,3
52398,4,1,183431,183431,183432,0,1,2
52399,3,2,183434,183434,183436,0,2,2
52400,4,1,183438,183438,183439,0,1,2
52401,4,2,183442,183442,183444,0,2,3
52402,4,2,183446,183446,183448,0,2,2
52403,4,1,183450,183450,183451,0,1,2
52404,2,1,183452,183452,183453,0,1,1
52405,6,2,183458,183458,183460,0,2,5
52406,5,3,183463,183463,183466,0,3,3
52407,1,2,183464,183466,183468,2,4,0
52408,2,1,183466,183468,183469,2,3,0
52409,2,1,183468,183469,183470,1,2,0
52410,3,3,183471,183471,183474,0,3,1
52411,4,1,183475,183475,183476,0,1,1
52412,6,1,183481,183481,183482,0,1,5
52413,3,2,183484,183484,183486,0,2,2
52414,4,2,183488,183488,183490,0,2,2
52415,3,2,183491,183491,183493,0,2,1
52416,2,3,183493,183493,183496,0,3,0
52417,1,2,183494,183496,183498,2,4,0
52418,6,2,183500,183500,183502,0,2,2
52419,3,3,183503,183503,183506,0,3,1
52420,2,2,183505,183506,183508,1,3,0
52421,1,1,183506,183508,183509,2,3,0
52422,4,2,183510,183510,183512,0,2,1
52423,5,2,183515,183515,183517,0,2,3
52424,3,2,183518,183518,183520,0,2,1
52425,6,1,183524,183524,183525,0,1,4
52426,5,2,183529,183529,183531,0,2,4
52427,1,2,183530,183531,183533,1,3,0
52428,4,2,183534,183534,183536,0,2,1
52429,3,2,183537,183537,183539,0,2,1
52430,2,2,183539,183539,183541,0,2,0
52431,1,3,183540,183541,183544,1,4,0
52432,3,1,183543,183544,183545,1,2,0
52433,6,1,183549,183549,183550,0,1,4
52434,4,1,183553,183553,183554,0,1,3
52435,2,3,183555,183555,183558,0,3,1
52436,6,1,183561,183561,183562,0,1,3
52437,6,1,183567,183567,183568,0,1,5
52438,6,1,183573,183573,183574,0,1,5
52439,6,2,183579,183579,183581,0,2,5
52440,4,2,183583,183583,183585,0,2,2
52441,3,3,183586,183586,183589,0,3,1
52442,3,2,183589,183589,183591,0,2,0
52443,6,3,183595,183595,183598,0,3,4
52444,3,3,183598,183598,183601,0,3,0
52445,2,2,183600,183601,183603,1,3,0
52446,5,1,183605,183605,183606,0,1,2
52447,1,1,183606,183606,183607,0,1,0
52448,2,3,183608,183608,183611,0,3,1
52449,6,2,183614,183614,183616,0,2,3
52450,2,2,183616,183616,183618,0,2,0
52451,3,3,183619,183619,183622,0,3,1
52452,4,2,183623,183623,183625,0,2,1
52453,5,3,183628,183628,183631,0,3,3
52454,3,1,183631,183631,183632,0,1,0
52455,4,1,183635,183635,183636,0,1,3
52456,2,3,183637,183637,183640,0,3,1
52457,5,3,183642,183642,183645,0,3,2
52458,2,1,183644,183645,183646,1,2,0
52459,1,2,183645,183646,183648,1,3,0
52460,2,3,183647,183648,183651,1,4,0
52461,2,1,183649,183651,183652,2,3,0
52462,3,2,183652,183652,183654,0,2,0
52463,3,2,183655,183655,183657,0,2,1
52464,1,3,183656,183657,183660,1,4,0
52465,2,1,183658,183660,183661,2,3,0
52466,6,1,183664,183664,183665,0,1,3
52467,3,1,183667,183667,183668,0,1,2
52468,5,1,183672,183672,183673,0,1,4
52469,6,3,183678,183678,183681,0,3,5
52470,3,2,183681,183681,183683,0,2,0
52471,2,3,183683,183683,183686,0,3,0
52472,3,1,183686,183686,183687,0,1,0
52473,3,1,183689,183689,183690,0,1,2
52474,1,3,183690,183690,183693,0,3,0
52475,5,2,183695,183695,183697,0,2,2
52476,3,3,183698,183698,183701,0,3,1
52477,4,1,183702,183702,183703,0,1,1
52478,6,1,183708,183708,183709,0,1,5
52479,6,3,183714,183714,183717,0,3,5
52480,1,1,183715,183717,183718,2,3,0
52481,5,3,183720,183720,183723,0,3,2
52482,1,3,183721,183723,183726,2,5,0
52483,3,3,183724,183726,183729,2,5,0
52484,4,3,183728,183729,183732,1,4,0
52485,3,3,183731,183732,183735,1,4,0
52486,2,2,183733,183735,183737,2,4,0
52487,3,2,183736,183737,183739,1,3,0
52488,3,1,183739,183739,183740,0,1,0
52489,6,2,183745,183745,183747,0,2,5
52490,6,1,183751,183751,183752,0,1,4
52491,1,1,183752,183752,183753,0,1,0
52492,6,2,183758,183758,183760,0,2,5
52493,2,1,183760,183760,183761,0,1,0
52494,6,3,183766,183766,183769,0,3,5
52495,6,1,183772,183772,183773,0,1,3
52496,2,2,183774,183774,183776,0,2,1
52497,5,3,183779,183779,183782,0,3,3
52498,4,2,183783,183783,183785,0,2,1
52499,6,3,183789,183789,183792,0,3,4
52500,5,1,183794,183794,183795,0,1,2
52501,6,1,183800,183800,183801,0,1,5
52502,1,1,183801,183801,183802,0,1,0
52503,6,3,183807,183807,183810,0,3,5
52504,2,3,183809,183810,183813,1,4,0
52505,4,3,183813,183813,183816,0,3,0
52506,6,3,183819,183819,183822,0,3,3
52507,5,1,183824,183824,183825,0,1,2
52508,1,2,183825,183825,183827,0,2,0
52509,1,2,183826,183827,183829,1,3,0
52510,6,3,183832,183832,183835,0,3,3
52511,5,1,183837,183837,183838,0,1,2
52512,6,1,183843,183843,183844,0,1,5
52513,3,2,183846,183846,183848,0,2,2
52514,4,2,183850,183850,183852,0,2,2
52515,6,1,183856,183856,183857,0,1,4
52516,1,3,183857,183857,183860,0,3,0
52517,3,3,183860,183860,183863,0,3,0
52518,2,1,183862,183863,183864,1,2,0
52519,5,3,183867,183867,183870,0,3,3
52520,2,3,183869,183870,183873,1,4,0
52521,4,1,183873,183873,183874,0,1,0
52522,2,3,183875,183875,183878,0,3,1
52523,2,1,183877,183878,183879,1,2,0
52524,3,2,183880,183880,183882,0,2,1
52525,4,2,183884,183884,183886,0,2,2
52526,6,3,183890,183890,183893,0,3,4
52527,4,3,183894,183894,183897,0,3,1
52528,4,1,183898,183898,183899,0,1,1
52529,6,1,183904,183904,183905,0,1,5
52530,3,1,183907,183907,183908,0,1,2
52531,1,2,183908,183908,183910,0,2,0
52532,3,2,183911,183911,183913,0,2,1
52533,6,3,183917,183917,183920,0,3,4
52534,2,2,183919,183920,183922,1,3,0
52535,6,3,183925,183925,183928,0,3,3
52536,1,2,183926,183928,183930,2,4,0
52537,2,2,183928,183930,183932,2,4,0
52538,4,2,183932,183932,183934,0,2,0
52539,5,3,183937,183937,183940,0,3,3
52540,5,3,183942,183942,183945,0,3,2
52541,5,1,183947,183947,183948,0,1,2
52542,1,1,183948,183948,183949,0,1,0
52543,4,3,183952,183952,183955,0,3,3
52544,1,2,183953,183955,183957,2,4,0
52545,2,3,183955,183957,183960,2,5,0
52546,2,2,183957,183960,183962,3,5,0
52547,1,2,183958,183962,183964,4,6,0
52548,4,1,183962,183964,183965,2,3,0
52549,3,3,183965,183965,183968,0,3,0
52550,1,1,183966,183968,183969,2,3,0
52551,2,2,183968,183969,183971,1,3,0
52552,2,3,183970,183971,183974,1,4,0
52553,5,1,183975,183975,183976,0,1,1
52554,2,3,183977,183977,183980,0,3,1
52555,5,3,183982,183982,183985,0,3,2
52556,6,3,183988,183988,183991,0,3,3
52557,5,2,183993,183993,183995,0,2,2
52558,3,1,183996,183996,183997,0,1,1
52559,5,2,184001,184001,184003,0,2,4
52560,3,3,184004,184004,184007,0,3,1
52561,5,3,184009,184009,184012,0,3,2
52562,2,3,184011,184012,184015,1,4,0
52563,6,1,184017,184017,184018,0,1,2
52564,6,1,184023,184023,184024,0,1,5
52565,2,2,184025,184025,184027,0,2,1
52566,1,3,184026,184027,184030,1,4,0
52567,4,3,184030,184030,184033,0,3,0
52568,5,2,184035,184035,184037,0,2,2
52569,2,3,184037,184037,184040,0,3,0
52570,2,2,184039,184040,184042,1,3,0
52571,2,2,184041,184042,184044,1,3,0
52572,1,2,184042,184044,184046,2,4,0
52573,2,1,184044,184046,184047,2,3,0
52574,5,1,184049,184049,184050,0,1,2
52575,4,1,184053,184053,184054,0,1,3
52576,2,3,184055,184055,184058,0,3,1
52577,2,2,184057,184058,184060,1,3,0
52578,5,2,184062,184062,184064,0,2,2
52579,5,3,184067,184067,184070,0,3,3
52580,2,3,184069,184070,184073,1,4,0
52581,4,1,184073,184073,184074,0,1,0
52582,3,1,184076,184076,184077,0,1,2
52583,6,1,184082,184082,184083,0,1,5
52584,6,3,184088,184088,184091,0,3,5
52585,1,1,184089,184091,184092,2,3,0
52586,4,2,184093,184093,184095,0,2,1
52587,6,2,184099,184099,184101,0,2,4
52588,4,1,184103,184103,184104,0,1,2
52589,3,3,184106,184106,184109,0,3,2
52590,1,3,184107,184109,184112,2,5,0
52591,5,3,184112,184112,184115,0,3,0
52592,2,2,184114,184115,184117,1,3,0
52593,1,2,184115,184117,184119,2,4,0
52594,3,1,184118,184119,184120,1,2,0
52595,2,2,184120,184120,184122,0,2,0
52596,4,1,184124,184124,184125,0,1,2
52597,6,2,184130,184130,184132,0,2,5
52598,4,1,184134,184134,184135,0,1,2
52599,6,1,184140,184140,184141,0,1,5
52600,2,2,184142,184142,184144,0,2,1
52601,2,2,184144,184144,184146,0,2,0
52602,1,3,184145,184146,184149,1,4,0
52603,2,2,184147,184149,184151,2,4,0
52604,2,3,184149,184151,184154,2,5,0
52605,3,2,184152,184154,184156,2,4,0
52606,4,3,184156,184156,184159,0,3,0
52607,6,2,184162,184162,184164,0,2,3
52608,5,1,184167,184167,184168,0,1,3
52609,5,2,184172,184172,184174,0,2,4
52610,5,1,184177,184177,184178,0,1,3
52611,6,2,184183,184183,184185,0,2,5
52612,6,2,184189,184189,184191,0,2,4
52613,3,1,184192,184192,184193,0,1,1
52614,1,3,184193,184193,184196,0,3,0
52615,2,2,184195,184196,184198,1,3,0
52616,6,3,184201,184201,184204,0,3,3
52617,5,3,184206,184206,184209,0,3,2
52618,5,1,184211,184211,184212,0,1,2
52619,1,1,184212,184212,184213,0,1,0
52620,6,3,184218,184218,184221,0,3,5
52621,3,2,184221,184221,184223,0,2,0
52622,6,2,184227,184227,184229,0,2,4
52623,2,2,184229,184229,184231,0,2,0
52624,1,3,184230,184231,184234,1,4,0
52625,6,1,184236,184236,184237,0,1,2
52626,5,3,184241,184241,184244,0,3,4
52627,6,1,184247,184247,184248,0,1,3
52628,2,3,184249,184249,184252,0,3,1
52629,1,1,184250,184252,184253,2,3,0
52630,1,2,184251,184253,184255,2,4,0
52631,5,3,184256,184256,184259,0,3,1
52632,5,2,184261,184261,184263,0,2,2
52633,6,2,184267,184267,184269,0,2,4
52634,3,3,184270,184270,184273,0,3,1
52635,5,1,184275,184275,184276,0,1,2
52636,5,2,184280,184280,184282,0,2,4
52637,5,2,184285,184285,184287,0,2,3
52638,4,1,184289,184289,184290,0,1,2
52639,6,1,184295,184295,184296,0,1,5
52640,1,2,184296,184296,184298,0,2,0
52641,6,1,184302,184302,184303,0,1,4
52642,2,2,184304,184304,184306,0,2,1
52643,1,2,184305,184306,184308,1,3,0
52644,4,1,184309,184309,184310,0,1,1
52645,5,3,184314,184314,184317,0,3,4
52646,4,1,184318,184318,184319,0,1,1
52647,2,3,184320,184320,184323,0,3,1
52648,4,1,184324,184324,184325,0,1,1
52649,2,2,184326,184326,184328,0,2,1
52650,4,2,184330,184330,184332,0,2,2
52651,3,3,184333,184333,184336,0,3,1
52652,4,3,184337,184337,184340,0,3,1
52653,5,2,184342,184342,184344,0,2,2
52654,5,3,184347,184347,184350,0,3,3
52655,1,2,184348,184350,184352,2,4,0
52656,6,3,184354,184354,184357,0,3,2
52657,3,2,184357,184357,184359,0,2,0
52658,1,3,184358,184359,184362,1,4,0
52659,4,2,184362,184362,184364,0,2,0
52660,5,3,184367,184367,184370,0,3,3
52661,2,1,184369,184370,184371,1,2,0
52662,2,1,184371,184371,184372,0,1,0
52663,5,2,184376,184376,184378,0,2,4
52664,2,2,184378,184378,184380,0,2,0
52665,6,1,184384,184384,184385,0,1,4
52666,5,2,184389,184389,184391,0,2,4
52667,6,3,184395,184395,184398,0,3,4
52668,6,2,184401,184401,184403,0,2,3
52669,1,2,184402,184403,184405,1,3,0
52670,6,1,184408,184408,184409,0,1,3
52671,2,2,184410,184410,184412,0,2,1
52672,6,3,184416,184416,184419,0,3,4
52673,2,1,184418,184419,184420,1,2,0
52674,5,1,184423,184423,184424,0,1,3
52675,4,3,184427,184427,184430,0,3,3
52676,6,1,184433,184433,184434,0,1,3
52677,3,2,184436,184436,184438,0,2,2
52678,6,3,184442,184442,184445,0,3,4
52679,1,2,184443,184445,184447,2,4,0
52680,6,3,184449,184449,184452,0,3,2
52681,3,1,184452,184452,184453,0,1,0
52682,3,2,184455,184455,184457,0,2,2
52683,1,3,184456,184457,184460,1,4,0
52684,6,3,184462,184462,184465,0,3,2
52685,1,1,184463,184465,184466,2,3,0
52686,1,2,184464,184466,184468,2,4,0
52687,1,2,184465,184468,184470,3,5,0
52688,4,2,184469,184470,184472,1,3,0
52689,2,3,184471,184472,184475,1,4,0
52690,6,1,184477,184477,184478,0,1,2
52691,2,3,184479,184479,184482,0,3,1
52692,4,3,184483,184483,184486,0,3,1
52693,1,1,184484,184486,184487,2,3,0
52694,4,2,184488,184488,184490,0,2,1
52695,1,3,184489,184490,184493,1,4,0
52696,4,3,184493,184493,184496,0,3,0
52697,1,1,184494,184496,184497,2,3,0
52698,4,2,184498,184498,184500,0,2,1
52699,3,3,184501,184501,184504,0,3,1
52700,3,2,184504,184504,184506,0,2,0
52701,6,3,184510,184510,184513,0,3,4
52702,6,2,184516,184516,184518,0,2,3
52703,6,1,184522,184522,184523,0,1,4
52704,4,2,184526,184526,184528,0,2,3
52705,2,3,184528,184528,184531,0,3,0
52706,6,2,184534,184534,184536,0,2,3
52707,6,1,184540,184540,184541,0,1,4
52708,1,3,184541,184541,184544,0,3,0
52709,4,1,184545,184545,184546,0,1,1
52710,1,3,184546,184546,184549,0,3,0
52711,2,1,184548,184549,184550,1,2,0
52712,4,3,184552,184552,184555,0,3,2
52713,4,1,184556,184556,184557,0,1,1
52714,4,1,184560,184560,184561,0,1,3
52715,1,3,184561,184561,184564,0,3,0
52716,1,2,184562,184564,184566,2,4,0
52717,4,3,184566,184566,184569,0,3,0
52718,5,2,184571,184571,184573,0,2,2
52719,5,3,184576,184576,184579,0,3,3
52720,1,2,184577,184579,184581,2,4,0
52721,2,2,184579,184581,184583,2,4,0
52722,4,3,184583,184583,184586,0,3,0
52723,5,3,184588,184588,184591,0,3,2
52724,5,3,184593,184593,184596,0,3,2
52725,1,2,184594,184596,184598,2,4,0
52726,5,2,184599,184599,184601,0,2,1
52727,1,1,184600,184601,184602,1,2,0
52728,4,2,184604,184604,184606,0,2,2
52729,4,2,184608,184608,184610,0,2,2
52730,2,1,184610,184610,184611,0,1,0
52731,5,1,184615,184615,184616,0,1,4
52732,6,2,184621,184621,184623,0,2,5
52733,5,2,184626,184626,184628,0,2,3
52734,6,3,184632,184632,184635,0,3,4
52735,6,1,184638,184638,184639,0,1,3
52736,3,3,184641,184641,184644,0,3,2
52737,1,2,184642,184644,184646,2,4,0
52738,4,2,184646,184646,184648,0,2,0
52739,3,1,184649,184649,184650,0,1,1
52740,3,3,184652,184652,184655,0,3,2
52741,1,3,184653,184655,184658,2,5,0
52742,3,1,184656,184658,184659,2,3,0
52743,5,2,184661,184661,184663,0,2,2
52744,1,1,184662,184663,184664,1,2,0
52745,5,1,184667,184667,184668,0,1,3
52746,2,3,184669,184669,184672,0,3,1
52747,5,3,184674,184674,184677,0,3,2
52748,2,1,184676,184677,184678,1,2,0
52749,5,3,184681,184681,184684,0,3,3
52750,3,2,184684,184684,184686,0,2,0
52751,1,3,184685,184686,184689,1,4,0
52752,5,3,184690,184690,184693,0,3,1
52753,5,1,184695,184695,184696,0,1,2
52754,5,3,184700,184700,184703,0,3,4
52755,6,3,184706,184706,184709,0,3,3
52756,5,3,184711,184711,184714,0,3,2
52757,5,1,184716,184716,184717,0,1,2
52758,2,3,184718,184718,184721,0,3,1
52759,3,2,184721,184721,184723,0,2,0
52760,3,3,184724,184724,184727,0,3,1
52761,4,2,184728,184728,184730,0,2,1
52762,4,2,184732,184732,184734,0,2,2
52763,4,3,184736,184736,184739,0,3,2
52764,6,1,184742,184742,184743,0,1,3
52765,1,3,184743,184743,184746,0,3,0
52766,4,2,184747,184747,184749,0,2,1
52767,6,1,184753,184753,184754,0,1,4
52768,4,2,184757,184757,184759,0,2,3
52769,6,1,184763,184763,184764,0,1,4
52770,2,1,184765,184765,184766,0,1,1
52771,5,2,184770,184770,184772,0,2,4
52772,2,2,184772,184772,184774,0,2,0
52773,5,2,184777,184777,184779,0,2,3
52774,5,3,184782,184782,184785,0,3,3
52775,4,1,184786,184786,184787,0,1,1
52776,5,3,184791,184791,184794,0,3,4
52777,3,1,184794,184794,184795,0,1,0
52778,2,3,184796,184796,184799,0,3,1
52779,2,3,184798,184799,184802,1,4,0
52780,5,3,184803,184803,184806,0,3,1
52781,2,3,184805,184806,184809,1,4,0
52782,3,3,184808,184809,184812,1,4,0
52783,2,3,184810,184812,184815,2,5,0
52784,3,1,184813,184815,184816,2,3,0
52785,5,3,184818,184818,184821,0,3,2
52786,6,1,184824,184824,184825,0,1,3
52787,6,3,184830,184830,184833,0,3,5
52788,2,1,184832,184833,184834,1,2,0
52789,6,1,184838,184838,184839,0,1,4
52790,4,3,184842,184842,184845,0,3,3
52791,6,3,184848,184848,184851,0,3,3
52792,3,2,184851,184851,184853,0,2,0
52793,2,2,184853,184853,184855,0,2,0
52794,2,1,184855,184855,184856,0,1,0
52795,5,3,184860,184860,184863,0,3,4
52796,1,1,184861,184863,184864,2,3,0
52797,1,2,184862,184864,184866,2,4,0
52798,3,2,184865,184866,184868,1,3,0
52799,3,3,184868,184868,184871,0,3,0
52800,5,2,184873,184873,184875,0,2,2
52801,1,1,184874,184875,184876,1,2,0
52802,2,1,184876,184876,184877,0,1,0
52803,3,1,184879,184879,184880,0,1,2
52804,1,3,184880,184880,184883,0,3,0
52805,4,2,184884,184884,184886,0,2,1
52806,3,3,184887,184887,184890,0,3,1
52807,6,1,184893,184893,184894,0,1,3
52808,3,1,184896,184896,184897,0,1,2
52809,4,2,184900,184900,184902,0,2,3
52810,4,2,184904,184904,184906,0,2,2
52811,1,2,184905,184906,184908,1,3,0
52812,5,1,184910,184910,184911,0,1,2
52813,3,3,184913,184913,184916,0,3,2
52814,3,2,184916,184916,184918,0,2,0
52815,2,1,184918,184918,184919,0,1,0
52816,3,1,184921,184921,184922,0,1,2
52817,6,3,184927,184927,184930,0,3,5
52818,5,1,184932,184932,184933,0,1,2
52819,1,3,184933,184933,184936,0,3,0
52820,4,1,184937,184937,184938,0,1,1
52821,5,3,184942,184942,184945,0,3,4
52822,3,2,184945,184945,184947,0,2,0
52823,4,1,184949,184949,184950,0,1,2
52824,6,1,184955,184955,184956,0,1,5
52825,1,3,184956,184956,184959,0,3,0
52826,4,3,184960,184960,184963,0,3,1
52827,1,3,184961,184963,184966,2,5,0
52828,6,1,184967,184967,184968,0,1,1
52829,5,2,184972,184972,184974,0,2,4
52830,2,3,184974,184974,184977,0,3,0
52831,1,2,184975,184977,184979,2,4,0
52832,2,2,184977,184979,184981,2,4,0
52833,5,1,184982,184982,184983,0,1,1
52834,5,1,184987,184987,184988,0,1,4
52835,1,1,184988,184988,184989,0,1,0
52836,2,3,184990,184990,184993,0,3,1
52837,1,3,184991,184993,184996,2,5,0
52838,6,3,184997,184997,185000,0,3,1
52839,4,1,185001,185001,185002,0,1,1
52840,2,2,185003,185003,185005,0,2,1
52841,5,2,185008,185008,185010,0,2,3
52842,2,3,185010,185010,185013,0,3,0
52843,4,3,185014,185014,185017,0,3,1
52844,4,2,185018,185018,185020,0,2,1
52845,4,2,185022,185022,185024,0,2,2
52846,6,1,185028,185028,185029,0,1,4
52847,6,2,185034,185034,185036,0,2,5
52848,3,1,185037,185037,185038,0,1,1
52849,2,2,185039,185039,185041,0,2,1
52850,4,1,185043,185043,185044,0,1,2
52851,4,2,185047,185047,185049,0,2,3
52852,3,2,185050,185050,185052,0,2,1
52853,1,1,185051,185052,185053,1,2,0
52854,3,1,185054,185054,185055,0,1,1
52855,3,3,185057,185057,185060,0,3,2
52856,1,1,185058,185060,185061,2,3,0
52857,2,3,185060,185061,185064,1,4,0
52858,2,1,185062,185064,185065,2,3,0
52859,2,2,185064,185065,185067,1,3,0
52860,3,2,185067,185067,185069,0,2,0
52861,5,3,185072,185072,185075,0,3,3
52862,5,3,185077,185077,185080,0,3,2
52863,2,2,185079,185080,185082,1,3,0
52864,4,3,185083,185083,185086,0,3,1
52865,2,2,185085,185086,185088,1,3,0
52866,4,1,185089,185089,185090,0,1,1
52867,4,2,185093,185093,185095,0,2,3
52868,6,1,185099,185099,185100,0,1,4
52869,5,1,185104,185104,185105,0,1,4
52870,6,3,185110,185110,185113,0,3,5
52871,6,2,185116,185116,185118,0,2,3
52872,1,3,185117,185118,185121,1,4,0
52873,6,1,185123,185123,185124,0,1,2
52874,2,3,185125,185125,185128,0,3,1
52875,6,2,185131,185131,185133,0,2,3
52876,3,3,185134,185134,185137,0,3,1
52877,2,3,185136,185137,185140,1,4,0
52878,6,2,185142,185142,185144,0,2,2
52879,6,1,185148,185148,185149,0,1,4
52880,6,1,185154,185154,185155,0,1,5
52881,2,2,185156,185156,185158,0,2,1
52882,1,1,185157,185158,185159,1,2,0
52883,1,2,185158,185159,185161,1,3,0
52884,1,1,185159,185161,185162,2,3,0
52885,6,1,185165,185165,185166,0,1,3
52886,5,2,185170,185170,185172,0,2,4
52887,1,1,185171,185172,185173,1,2,0
52888,6,3,185177,185177,185180,0,3,4
52889,2,2,185179,185180,185182,1,3,0
52890,1,1,185180,185182,185183,2,3,0
52891,2,2,185182,185183,185185,1,3,0
52892,3,3,185185,185185,185188,0,3,0
52893,5,2,185190,185190,185192,0,2,2
52894,4,1,185194,185194,185195,0,1,2
52895,6,3,185200,185200,185203,0,3,5
52896,3,1,185203,185203,185204,0,1,0
52897,3,1,185206,185206,185207,0,1,2
52898,4,2,185210,185210,185212,0,2,3
52899,5,2,185215,185215,185217,0,2,3
52900,6,1,185221,185221,185222,0,1,4
52901,6,2,185227,185227,185229,0,2,5
52902,2,2,185229,185229,185231,0,2,0
52903,4,1,185233,185233,185234,0,1,2
52904,1,2,185234,185234,185236,0,2,0
52905,2,3,185236,185236,185239,0,3,0
52906,5,1,185241,185241,185242,0,1,2
52907,4,2,185245,185245,185247,0,2,3
52908,1,1,185246,185247,185248,1,2,0
52909,4,2,185250,185250,185252,0,2,2
52910,6,1,185256,185256,185257,0,1,4
52911,1,1,185257,185257,185258,0,1,0
52912,5,1,185262,185262,185263,0,1,4
52913,3,3,185265,185265,185268,0,3,2
52914,6,1,185271,185271,185272,0,1,3
52915,5,2,185276,185276,185278,0,2,4
52916,5,1,185281,185281,185282,0,1,3
52917,4,1,185285,185285,185286,0,1,3
52918,4,1,185289,185289,185290,0,1,3
52919,1,3,185290,185290,185293,0,3,0
52920,5,3,185295,185295,185298,0,3,2
52921,5,3,185300,185300,185303,0,3,2
52922,6,1,185306,185306,185307,0,1,3
52923,2,1,185308,185308,185309,0,1,1
52924,2,3,185310,185310,185313,0,3,1
52925,2,2,185312,185313,185315,1,3,0
52926,1,3,185313,185315,185318,2,5,0
52927,4,2,185317,185318,185320,1,3,0
52928,1,3,185318,185320,185323,2,5,0
52929,5,3,185323,185323,185326,0,3,0
52930,3,1,185326,185326,185327,0,1,0
52931,6,1,185332,185332,185333,0,1,5
52932,3,1,185335,185335,185336,0,1,2
52933,1,2,185336,185336,185338,0,2,0
52934,5,1,185341,185341,185342,0,1,3
52935,5,2,185346,185346,185348,0,2,4
52936,2,3,185348,185348,185351,0,3,0
52937,4,2,185352,185352,185354,0,2,1
52938,3,2,185355,185355,185357,0,2,1
52939,1,1,185356,185357,185358,1,2,0
52940,1,3,185357,185358,185361,1,4,0
52941,5,1,185362,185362,185363,0,1,1
52942,6,1,185368,185368,185369,0,1,5
52943,3,1,185371,185371,185372,0,1,2
52944,5,1,185376,185376,185377,0,1,4
52945,6,2,185382,185382,185384,0,2,5
52946,6,2,185388,185388,185390,0,2,4
52947,3,2,185391,185391,185393,0,2,1
52948,6,3,185397,185397,185400,0,3,4
52949,4,2,185401,185401,185403,0,2,1
52950,3,2,185404,185404,185406,0,2,1
52951,5,3,185409,185409,185412,0,3,3
52952,5,2,185414,185414,185416,0,2,2
52953,2,1,185416,185416,185417,0,1,0
52954,3,3,185419,185419,185422,0,3,2
52955,5,1,185424,185424,185425,0,1,2
52956,5,3,185429,185429,185432,0,3,4
52957,3,1,185432,185432,185433,0,1,0
52958,1,2,185433,185433,185435,0,2,0
52959,2,1,185435,185435,185436,0,1,0
52960,2,1,185437,185437,185438,0,1,1
52961,6,3,185443,185443,185446,0,3,5
52962,1,2,185444,185446,185448,2,4,0
52963,6,2,185450,185450,185452,0,2,2
52964,1,3,185451,185452,185455,1,4,0
52965,2,1,185453,185455,185456,2,3,0
52966,2,1,185455,185456,185457,1,2,0
52967,3,3,185458,185458,185461,0,3,1
52968,6,2,185464,185464,185466,0,2,3
52969,3,1,185467,185467,185468,0,1,1
52970,4,2,185471,185471,185473,0,2,3
52971,2,2,185473,185473,185475,0,2,0
52972,4,2,185477,185477,185479,0,2,2
52973,5,3,185482,185482,185485,0,3,3
52974,6,1,185488,185488,185489,0,1,3
52975,6,3,185494,185494,185497,0,3,5
52976,2,3,185496,185497,185500,1,4,0
52977,2,2,185498,185500,185502,2,4,0
52978,6,3,185504,185504,185507,0,3,2
52979,4,1,185508,185508,185509,0,1,1
52980,4,2,185512,185512,185514,0,2,3
52981,5,1,185517,185517,185518,0,1,3
52982,4,2,185521,185521,185523,0,2,3
52983,5,2,185526,185526,185528,0,2,3
52984,6,2,185532,185532,185534,0,2,4
52985,4,1,185536,185536,185537,0,1,2
52986,5,1,185541,185541,185542,0,1,4
52987,1,3,185542,185542,185545,0,3,0
52988,1,3,185543,185545,185548,2,5,0
52989,4,3,185547,185548,185551,1,4,0
52990,4,2,185551,185551,185553,0,2,0
52991,3,1,185554,185554,185555,0,1,1
52992,2,2,185556,185556,185558,0,2,1
52993,2,1,185558,185558,185559,0,1,0
52994,6,1,185564,185564,185565,0,1,5
52995,6,2,185570,185570,185572,0,2,5
52996,3,3,185573,185573,185576,0,3,1
52997,5,3,185578,185578,185581,0,3,2
52998,5,2,185583,185583,185585,0,2,2
52999,1,3,185584,185585,185588,1,4,0
53000,4,2,185588,185588,185590,0,2,0
53001,2,1,185590,185590,185591,0,1,0
53002,6,3,185596,185596,185599,0,3,5
53003,1,3,185597,185599,185602,2,5,0
53004,2,2,185599,185602,185604,3,5,0
53005,5,2,185604,185604,185606,0,2,0
53006,2,1,185606,185606,185607,0,1,0
53007,1,3,185607,185607,185610,0,3,0
53008,5,3,185612,185612,185615,0,3,2
53009,3,3,185615,185615,185618,0,3,0
53010,5,3,185620,185620,185623,0,3,2
53011,3,2,185623,185623,185625,0,2,0
53012,3,1,185626,185626,185627,0,1,1
53013,2,1,185628,185628,185629,0,1,1
53014,5,1,185633,185633,185634,0,1,4
53015,6,2,185639,185639,185641,0,2,5
53016,1,3,185640,185641,185644,1,4,0
53017,4,3,185644,185644,185647,0,3,0
53018,3,3,185647,185647,185650,0,3,0
53019,1,1,185648,185650,185651,2,3,0
53020,3,3,185651,185651,185654,0,3,0
53021,1,1,185652,185654,185655,2,3,0
53022,1,3,185653,185655,185658,2,5,0
53023,2,3,185655,185658,185661,3,6,0
53024,2,1,185657,185661,185662,4,5,0
53025,4,3,185661,185662,185665,1,4,0
53026,3,1,185664,185665,185666,1,2,0
53027,5,3,185669,185669,185672,0,3,3
53028,5,1,185674,185674,185675,0,1,2
53029,1,3,185675,185675,185678,0,3,0
53030,2,3,185677,185678,185681,1,4,0
53031,4,2,185681,185681,185683,0,2,0
53032,4,2,185685,185685,185687,0,2,2
53033,1,3,185686,185687,185690,1,4,0
53034,6,2,185692,185692,185694,0,2,2
53035,6,2,185698,185698,185700,0,2,4
53036,4,2,185702,185702,185704,0,2,2
53037,4,2,185706,185706,185708,0,2,2
53038,4,2,185710,185710,185712,0,2,2
53039,2,3,185712,185712,185715,0,3,0
53040,6,3,185718,185718,185721,0,3,3
53041,1,1,185719,185721,185722,2,3,0
53042,3,2,185722,185722,185724,0,2,0
53043,4,1,185726,185726,185727,0,1,2
53044,3,1,185729,185729,185730,0,1,2
53045,2,3,185731,185731,185734,0,3,1
53046,5,3,185736,185736,185739,0,3,2
53047,6,1,185742,185742,185743,0,1,3
53048,1,2,185743,185743,185745,0,2,0
53049,4,2,185747,185747,185749,0,2,2
53050,1,3,185748,185749,185752,1,4,0
53051,2,3,185750,185752,185755,2,5,0
53052,6,1,185756,185756,185757,0,1,1
53053,6,1,185762,185762,185763,0,1,5
53054,5,1,185767,185767,185768,0,1,4
53055,3,1,185770,185770,185771,0,1,2
53056,2,2,185772,185772,185774,0,2,1
53057,5,1,185777,185777,185778,0,1,3
53058,6,1,185783,185783,185784,0,1,5
53059,2,3,185785,185785,185788,0,3,1
53060,6,1,185791,185791,185792,0,1,3
53061,1,1,185792,185792,185793,0,1,0
53062,3,3,185795,185795,185798,0,3,2
53063,6,3,185801,185801,185804,0,3,3
53064,3,2,185804,185804,185806,0,2,0
53065,6,2,185810,185810,185812,0,2,4
53066,5,2,185815,185815,185817,0,2,3
53067,2,3,185817,185817,185820,0,3,0
53068,3,1,185820,185820,185821,0,1,0
53069,5,2,185825,185825,185827,0,2,4
53070,2,3,185827,185827,185830,0,3,0
53071,3,2,185830,185830,185832,0,2,0
53072,1,2,185831,185832,185834,1,3,0
53073,5,2,185836,185836,185838,0,2,2
53074,5,3,185841,185841,185844,0,3,3
53075,5,1,185846,185846,185847,0,1,2
53076,1,1,185847,185847,185848,0,1,0
53077,1,1,185848,185848,185849,0,1,0
53078,6,3,185854,185854,185857,0,3,5
53079,3,2,185857,185857,185859,0,2,0
53080,2,3,185859,185859,185862,0,3,0
53081,1,3,185860,185862,185865,2,5,0
53082,5,2,185865,185865,185867,0,2,0
53083,2,1,185867,185867,185868,0,1,0
53084,3,1,185870,185870,185871,0,1,2
53085,2,1,185872,185872,185873,0,1,1
53086,4,3,185876,185876,185879,0,3,3
53087,5,1,185881,185881,185882,0,1,2
53088,2,2,185883,185883,185885,0,2,1
53089,2,3,185885,185885,185888,0,3,0
53090,1,1,185886,185888,185889,2,3,0
53091,4,1,185890,185890,185891,0,1,1
53092,5,1,185895,185895,185896,0,1,4
53093,5,2,185900,185900,185902,0,2,4
53094,5,2,185905,185905,185907,0,2,3
53095,4,3,185909,185909,185912,0,3,2
53096,3,1,185912,185912,185913,0,1,0
53097,2,3,185914,185914,185917,0,3,1
53098,1,3,185915,185917,185920,2,5,0
53099,3,3,185918,185920,185923,2,5,0
53100,1,1,185919,185923,185924,4,5,0
53101,6,1,185925,185925,185926,0,1,1
53102,4,1,185929,185929,185930,0,1,3
53103,5,3,185934,185934,185937,0,3,4
53104,4,1,185938,185938,185939,0,1,1
53105,4,3,185942,185942,185945,0,3,3
53106,6,1,185948,185948,185949,0,1,3
53107,4,1,185952,185952,185953,0,1,3
53108,2,2,185954,185954,185956,0,2,1
53109,3,2,185957,185957,185959,0,2,1
53110,4,1,185961,185961,185962,0,1,2
53111,5,3,185966,185966,185969,0,3,4
53112,4,3,185970,185970,185973,0,3,1
53113,3,2,185973,185973,185975,0,2,0
53114,3,3,185976,185976,185979,0,3,1
53115,2,1,185978,185979,185980,1,2,0
53116,1,1,185979,185980,185981,1,2,0
53117,2,1,185981,185981,185982,0,1,0
53118,2,1,185983,185983,185984,0,1,1
53119,3,1,185986,185986,185987,0,1,2
53120,1,2,185987,185987,185989,0,2,0
53121,1,2,185988,185989,185991,1,3,0
53122,1,2,185989,185991,185993,2,4,0
53123,2,3,185991,185993,185996,2,5,0
53124,2,2,185993,185996,185998,3,5,0
53125,3,2,185996,185998,186000,2,4,0
53126,2,2,185998,186000,186002,2,4,0
53127,1,2,185999,186002,186004,3,5,0
53128,2,2,186001,186004,186006,3,5,0
53129,5,3,186006,186006,186009,0,3,0
53130,3,2,186009,186009,186011,0,2,0
53131,2,3,186011,186011,186014,0,3,0
53132,5,3,186016,186016,186019,0,3,2
53133,2,1,186018,186019,186020,1,2,0
53134,3,3,186021,186021,186024,0,3,1
53135,1,2,186022,186024,186026,2,4,0
53136,2,3,186024,186026,186029,2,5,0
53137,2,2,186026,186029,186031,3,5,0
53138,4,1,186030,186031,186032,1,2,0
53139,1,2,186031,186032,186034,1,3,0
53140,6,3,186037,186037,186040,0,3,3
53141,1,2,186038,186040,186042,2,4,0
53142,4,3,186042,186042,186045,0,3,0
53143,1,2,186043,186045,186047,2,4,0
53144,2,2,186045,186047,186049,2,4,0
53145,1,2,186046,186049,186051,3,5,0
53146,6,1,186052,186052,186053,0,1,1
53147,4,1,186056,186056,186057,0,1,3
53148,3,2,186059,186059,186061,0,2,2
53149,2,3,186061,186061,186064,0,3,0
53150,6,1,186067,186067,186068,0,1,3
53151,5,1,186072,186072,186073,0,1,4
53152,2,1,186074,186074,186075,0,1,1
53153,5,1,186079,186079,186080,0,1,4
53154,6,2,186085,186085,186087,0,2,5
53155,2,3,186087,186087,186090,0,3,0
53156,4,2,186091,186091,186093,0,2,1
53157,6,1,186097,186097,186098,0,1,4
53158,1,2,186098,186098,186100,0,2,0
53159,2,2,186100,186100,186102,0,2,0
53160,6,2,186106,186106,186108,0,2,4
53161,6,2,186112,186112,186114,0,2,4
53162,3,3,186115,186115,186118,0,3,1
53163,2,3,186117,186118,186121,1,4,0
53164,4,1,186121,186121,186122,0,1,0
53165,1,2,186122,186122,186124,0,2,0
53166,1,2,186123,186124,186126,1,3,0
53167,3,2,186126,186126,186128,0,2,0
53168,6,3,186132,186132,186135,0,3,4
53169,2,3,186134,186135,186138,1,4,0
53170,5,2,186139,186139,186141,0,2,1
53171,5,3,186144,186144,186147,0,3,3
53172,3,1,186147,186147,186148,0,1,0
53173,1,3,186148,186148,186151,0,3,0
53174,2,1,186150,186151,186152,1,2,0
53175,6,2,186156,186156,186158,0,2,4
53176,1,3,186157,186158,186161,1,4,0
53177,5,1,186162,186162,186163,0,1,1
53178,5,3,186167,186167,186170,0,3,4
53179,4,1,186171,186171,186172,0,1,1
53180,4,1,186175,186175,186176,0,1,3
53181,6,1,186181,186181,186182,0,1,5
53182,5,1,186186,186186,186187,0,1,4
53183,4,3,186190,186190,186193,0,3,3
53184,6,1,186196,186196,186197,0,1,3
53185,3,2,186199,186199,186201,0,2,2
53186,2,3,186201,186201,186204,0,3,0
53187,5,1,186206,186206,186207,0,1,2
53188,5,2,186211,186211,186213,0,2,4
53189,5,2,186216,186216,186218,0,2,3
53190,4,2,186220,186220,186222,0,2,2
53191,1,3,186221,186222,186225,1,4,0
53192,3,2,186224,186225,186227,1,3,0
53193,6,2,186230,186230,186232,0,2,3
53194,2,1,186232,186232,186233,0,1,0
53195,4,1,186236,186236,186237,0,1,3
53196,2,3,186238,186238,186241,0,3,1
53197,4,3,186242,186242,186245,0,3,1
53198,4,1,186246,186246,186247,0,1,1
53199,6,3,186252,186252,186255,0,3,5
53200,6,2,186258,186258,186260,0,2,3
53201,5,3,186263,186263,186266,0,3,3
53202,2,2,186265,186266,186268,1,3,0
53203,3,3,186268,186268,186271,0,3,0
53204,2,3,186270,186271,186274,1,4,0
53205,5,2,186275,186275,186277,0,2,1
53206,6,2,186281,186281,186283,0,2,4
53207,1,2,186282,186283,186285,1,3,0
53208,1,2,186283,186285,186287,2,4,0
53209,5,3,186288,186288,186291,0,3,1
53210,1,1,186289,186291,186292,2,3,0
53211,1,2,186290,186292,186294,2,4,0
53212,4,1,186294,186294,186295,0,1,0
53213,4,2,186298,186298,186300,0,2,3
53214,5,3,186303,186303,186306,0,3,3
53215,5,1,186308,186308,186309,0,1,2
53216,1,3,186309,186309,186312,0,3,0
53217,3,1,186312,186312,186313,0,1,0
53218,3,1,186315,186315,186316,0,1,2
53219,4,3,186319,186319,186322,0,3,3
53220,1,1,186320,186322,186323,2,3,0
53221,5,3,186325,186325,186328,0,3,2
53222,3,2,186328,186328,186330,0,2,0
53223,1,1,186329,186330,186331,1,2,0
53224,4,2,186333,186333,186335,0,2,2
53225,3,3,186336,186336,186339,0,3,1
53226,5,3,186341,186341,186344,0,3,2
53227,2,1,186343,186344,186345,1,2,0
53228,5,1,186348,186348,186349,0,1,3
53229,6,3,186354,186354,186357,0,3,5
53230,3,2,186357,186357,186359,0,2,0
53231,1,2,186358,186359,186361,1,3,0
53232,4,3,186362,186362,186365,0,3,1
53233,1,3,186363,186365,186368,2,5,0
53234,3,3,186366,186368,186371,2,5,0
53235,3,1,186369,186371,186372,2,3,0
53236,2,3,186371,186372,186375,1,4,0
53237,4,2,186375,186375,186377,0,2,0
53238,5,1,186380,186380,186381,0,1,3
53239,3,2,186383,186383,186385,0,2,2
53240,3,3,186386,186386,186389,0,3,1
53241,2,2,186388,186389,186391,1,3,0
53242,3,2,186391,186391,186393,0,2,0
53243,3,2,186394,186394,186396,0,2,1
53244,5,2,186399,186399,186401,0,2,3
53245,1,3,186400,186401,186404,1,4,0
53246,2,1,186402,186404,186405,2,3,0
53247,5,2,186407,186407,186409,0,2,2
53248,2,1,186409,186409,186410,0,1,0
53249,4,2,186413,186413,186415,0,2,3
53250,5,2,186418,186418,186420,0,2,3
53251,3,2,186421,186421,186423,0,2,1
53252,1,3,186422,186423,186426,1,4,0
53253,2,2,186424,186426,186428,2,4,0
53254,6,3,186430,186430,186433,0,3,2
53255,4,3,186434,186434,186437,0,3,1
53256,5,2,186439,186439,186441,0,2,2
53257,2,1,186441,186441,186442,0,1,0
53258,6,1,186447,186447,186448,0,1,5
53259,6,1,186453,186453,186454,0,1,5
53260,5,1,186458,186458,186459,0,1,4
53261,5,1,186463,186463,186464,0,1,4
53262,4,1,186467,186467,186468,0,1,3
53263,5,2,186472,186472,186474,0,2,4
53264,6,1,186478,186478,186479,0,1,4
53265,1,2,186479,186479,186481,0,2,0
53266,5,1,186484,186484,186485,0,1,3
53267,5,1,186489,186489,186490,0,1,4
53268,2,3,186491,186491,186494,0,3,1
53269,6,1,186497,186497,186498,0,1,3
53270,6,2,186503,186503,186505,0,2,5
53271,6,2,186509,186509,186511,0,2,4
53272,6,2,186515,186515,186517,0,2,4
53273,1,3,186516,186517,186520,1,4,0
53274,2,1,186518,186520,186521,2,3,0
53275,5,1,186523,186523,186524,0,1,2
53276,2,1,186525,186525,186526,0,1,1
53277,1,2,186526,186526,186528,0,2,0
53278,4,3,186530,186530,186533,0,3,2
53279,4,2,186534,186534,186536,0,2,1
53280,1,1,186535,186536,186537,1,2,0
53281,4,1,186539,186539,186540,0,1,2
53282,1,2,186540,186540,186542,0,2,0
53283,4,1,186544,186544,186545,0,1,2
53284,2,1,186546,186546,186547,0,1,1
53285,6,1,186552,186552,186553,0,1,5
53286,1,3,186553,186553,186556,0,3,0
53287,3,1,186556,186556,186557,0,1,0
53288,1,1,186557,186557,186558,0,1,0
53289,4,3,186561,186561,186564,0,3,3
53290,2,3,186563,186564,186567,1,4,0
53291,4,3,186567,186567,186570,0,3,0
53292,6,3,186573,186573,186576,0,3,3
53293,3,2,186576,186576,186578,0,2,0
53294,1,1,186577,186578,186579,1,2,0
53295,5,1,186582,186582,186583,0,1,3
53296,1,1,186583,186583,186584,0,1,0
53297,5,3,186588,186588,186591,0,3,4
53298,1,2,186589,186591,186593,2,4,0
53299,6,3,186595,186595,186598,0,3,2
53300,3,3,186598,186598,186601,0,3,0
53301,2,3,186600,186601,186604,1,4,0
53302,4,1,186604,186604,186605,0,1,0
53303,3,1,186607,186607,186608,0,1,2
53304,5,3,186612,186612,186615,0,3,4
53305,6,1,186618,186618,186619,0,1,3
53306,1,2,186619,186619,186621,0,2,0
53307,1,1,186620,186621,186622,1,2,0
53308,2,1,186622,186622,186623,0,1,0
53309,4,1,186626,186626,186627,0,1,3
53310,2,1,186628,186628,186629,0,1,1
53311,4,2,186632,186632,186634,0,2,3
53312,5,1,186637,186637,186638,0,1,3
53313,2,3,186639,186639,186642,0,3,1
53314,4,3,186643,186643,186646,0,3,1
53315,1,1,186644,186646,186647,2,3,0
53316,2,3,186646,186647,186650,1,4,0
53317,4,2,186650,186650,186652,0,2,0
53318,4,1,186654,186654,186655,0,1,2
53319,1,2,186655,186655,186657,0,2,0
53320,3,3,186658,186658,186661,0,3,1
53321,5,2,186663,186663,186665,0,2,2
53322,3,1,186666,186666,186667,0,1,1
53323,4,1,186670,186670,186671,0,1,3
53324,1,2,186671,186671,186673,0,2,0
53325,6,3,186677,186677,186680,0,3,4
53326,2,2,186679,186680,186682,1,3,0
53327,6,3,186685,186685,186688,0,3,3
53328,3,1,186688,186688,186689,0,1,0
53329,2,1,186690,186690,186691,0,1,1
53330,5,2,186695,186695,186697,0,2,4
53331,2,3,186697,186697,186700,0,3,0
53332,2,3,186699,186700,186703,1,4,0
53333,4,1,186703,186703,186704,0,1,0
53334,1,2,186704,186704,186706,0,2,0
53335,1,1,186705,186706,186707,1,2,0
53336,4,3,186709,186709,186712,0,3,2
53337,4,2,186713,186713,186715,0,2,1
53338,2,3,186715,186715,186718,0,3,0
53339,1,1,186716,186718,186719,2,3,0
53340,6,2,186722,186722,186724,0,2,3
53341,5,2,186727,186727,186729,0,2,3
53342,2,1,186729,186729,186730,0,1,0
53343,6,3,186735,186735,186738,0,3,5
53344,6,2,186741,186741,186743,0,2,3
53345,4,1,186745,186745,186746,0,1,2
53346,6,2,186751,186751,186753,0,2,5
53347,3,1,186754,186754,186755,0,1,1
53348,1,2,186755,186755,186757,0,2,0
53349,1,3,186756,186757,186760,1,4,0
53350,1,1,186757,186760,186761,3,4,0
53351,1,1,186758,186761,186762,3,4,0
53352,6,2,186764,186764,186766,0,2,2
53353,6,3,186770,186770,186773,0,3,4
53354,5,1,186775,186775,186776,0,1,2
53355,3,3,186778,186778,186781,0,3,2
53356,5,1,186783,186783,186784,0,1,2
53357,3,3,186786,186786,186789,0,3,2
53358,6,2,186792,186792,186794,0,2,3
53359,2,1,186794,186794,186795,0,1,0
53360,4,3,186798,186798,186801,0,3,3
53361,2,3,186800,186801,186804,1,4,0
53362,4,3,186804,186804,186807,0,3,0
53363,6,1,186810,186810,186811,0,1,3
53364,4,3,186814,186814,186817,0,3,3
53365,2,3,186816,186817,186820,1,4,0
53366,3,1,186819,186820,186821,1,2,0
53367,6,1,186825,186825,186826,0,1,4
53368,1,1,186826,186826,186827,0,1,0
53369,6,3,186832,186832,186835,0,3,5
53370,2,2,186834,186835,186837,1,3,0
53371,4,3,186838,186838,186841,0,3,1
53372,5,1,186843,186843,186844,0,1,2
53373,3,1,186846,186846,186847,0,1,2
53374,3,1,186849,186849,186850,0,1,2
53375,4,1,186853,186853,186854,0,1,3
53376,4,2,186857,186857,186859,0,2,3
53377,1,3,186858,186859,186862,1,4,0
53378,3,3,186861,186862,186865,1,4,0
53379,5,1,186866,186866,186867,0,1,1
53380,4,2,186870,186870,186872,0,2,3
53381,2,1,186872,186872,186873,0,1,0
53382,4,1,186876,186876,186877,0,1,3
53383,1,3,186877,186877,186880,0,3,0
53384,5,1,186882,186882,186883,0,1,2
53385,2,3,186884,186884,186887,0,3,1
53386,5,1,186889,186889,186890,0,1,2
53387,6,2,186895,186895,186897,0,2,5
53388,3,3,186898,186898,186901,0,3,1
53389,2,1,186900,186901,186902,1,2,0
53390,1,1,186901,186902,186903,1,2,0
53391,6,1,186907,186907,186908,0,1,4
53392,6,2,186913,186913,186915,0,2,5
53393,1,2,186914,186915,186917,1,3,0
53394,2,2,186916,186917,186919,1,3,0
53395,4,1,186920,186920,186921,0,1,1
53396,1,2,186921,186921,186923,0,2,0
53397,6,2,186927,186927,186929,0,2,4
53398,1,3,186928,186929,186932,1,4,0
53399,1,3,186929,186932,186935,3,6,0
53400,5,2,186934,186935,186937,1,3,0
53401,3,1,186937,186937,186938,0,1,0
53402,6,2,186943,186943,186945,0,2,5
53403,4,3,186947,186947,186950,0,3,2
53404,5,3,186952,186952,186955,0,3,2
53405,5,2,186957,186957,186959,0,2,2
53406,5,1,186962,186962,186963,0,1,3
53407,5,1,186967,186967,186968,0,1,4
53408,5,2,186972,186972,186974,0,2,4
53409,1,1,186973,186974,186975,1,2,0
53410,4,1,186977,186977,186978,0,1,2
53411,2,1,186979,186979,186980,0,1,1
53412,5,1,186984,186984,186985,0,1,4
53413,6,3,186990,186990,186993,0,3,5
53414,2,3,186992,186993,186996,1,4,0
53415,1,1,186993,186996,186997,3,4,0
53416,2,1,186995,186997,186998,2,3,0
53417,1,3,186996,186998,187001,2,5,0
53418,2,1,186998,187001,187002,3,4,0
53419,1,3,186999,187002,187005,3,6,0
53420,5,2,187004,187005,187007,1,3,0
53421,3,1,187007,187007,187008,0,1,0
53422,2,1,187009,187009,187010,0,1,1
53423,3,3,187012,187012,187015,0,3,2
53424,6,3,187018,187018,187021,0,3,3
53425,3,3,187021,187021,187024,0,3,0
53426,4,3,187025,187025,187028,0,3,1
53427,5,1,187030,187030,187031,0,1,2
53428,6,2,187036,187036,187038,0,2,5
53429,5,3,187041,187041,187044,0,3,3
53430,2,1,187043,187044,187045,1,2,0
53431,3,2,187046,187046,187048,0,2,1
53432,4,2,187050,187050,187052,0,2,2
53433,3,2,187053,187053,187055,0,2,1
53434,6,2,187059,187059,187061,0,2,4
53435,6,3,187065,187065,187068,0,3,4
53436,6,2,187071,187071,187073,0,2,3
53437,4,3,187075,187075,187078,0,3,2
53438,4,3,187079,187079,187082,0,3,1
53439,2,1,187081,187082,187083,1,2,0
53440,3,2,187084,187084,187086,0,2,1
53441,2,2,187086,187086,187088,0,2,0
53442,4,1,187090,187090,187091,0,1,2
53443,5,2,187095,187095,187097,0,2,4
53444,1,3,187096,187097,187100,1,4,0
53445,1,2,187097,187100,187102,3,5,0
53446,4,1,187101,187102,187103,1,2,0
53447,3,3,187104,187104,187107,0,3,1
53448,2,3,187106,187107,187110,1,4,0
53449,2,1,187108,187110,187111,2,3,0
53450,1,2,187109,187111,187113,2,4,0
53451,6,1,187115,187115,187116,0,1,2
53452,5,1,187120,187120,187121,0,1,4
53453,6,2,187126,187126,187128,0,2,5
53454,3,3,187129,187129,187132,0,3,1
53455,6,2,187135,187135,187137,0,2,3
53456,2,1,187137,187137,187138,0,1,0
53457,6,3,187143,187143,187146,0,3,5
53458,1,3,187144,187146,187149,2,5,0
53459,1,3,187145,187149,187152,4,7,0
53460,2,3,187147,187152,187155,5,8,0
53461,5,2,187152,187155,187157,3,5,0
53462,6,3,187158,187158,187161,0,3,1
53463,6,1,187164,187164,187165,0,1,3
53464,1,3,187165,187165,187168,0,3,0
53465,5,3,187170,187170,187173,0,3,2
53466,6,3,187176,187176,187179,0,3,3
53467,1,3,187177,187179,187182,2,5,0
53468,4,1,187181,187182,187183,1,2,0
53469,6,2,187187,187187,187189,0,2,4
53470,5,1,187192,187192,187193,0,1,3
53471,5,1,187197,187197,187198,0,1,4
53472,3,2,187200,187200,187202,0,2,2
53473,5,3,187205,187205,187208,0,3,3
53474,4,3,187209,187209,187212,0,3,1
53475,6,3,187215,187215,187218,0,3,3
53476,4,2,187219,187219,187221,0,2,1
53477,2,3,187221,187221,187224,0,3,0
53478,4,1,187225,187225,187226,0,1,1
53479,3,1,187228,187228,187229,0,1,2
53480,1,1,187229,187229,187230,0,1,0
53481,3,1,187232,187232,187233,0,1,2
53482,5,1,187237,187237,187238,0,1,4
53483,2,3,187239,187239,187242,0,3,1
53484,5,3,187244,187244,187247,0,3,2
53485,5,2,187249,187249,187251,0,2,2
53486,3,3,187252,187252,187255,0,3,1
53487,5,1,187257,187257,187258,0,1,2
53488,1,1,187258,187258,187259,0,1,0
53489,3,1,187261,187261,187262,0,1,2
53490,4,1,187265,187265,187266,0,1,3
53491,2,2,187267,187267,187269,0,2,1
53492,1,2,187268,187269,187271,1,3,0
53493,6,2,187274,187274,187276,0,2,3
53494,2,2,187276,187276,187278,0,2,0
53495,4,3,187280,187280,187283,0,3,2
53496,1,2,187281,187283,187285,2,4,0
53497,1,2,187282,187285,187287,3,5,0
53498,6,1,187288,187288,187289,0,1,1
53499,1,1,187289,187289,187290,0,1,0
53500,3,1,187292,187292,187293,0,1,2
53501,2,2,187294,187294,187296,0,2,1
53502,3,1,187297,187297,187298,0,1,1
53503,2,2,187299,187299,187301,0,2,1
53504,5,2,187304,187304,187306,0,2,3
53505,6,2,187310,187310,187312,0,2,4
53506,3,3,187313,187313,187316,0,3,1
53507,2,2,187315,187316,187318,1,3,0
53508,3,1,187318,187318,187319,0,1,0
53509,6,3,187324,187324,187327,0,3,5
53510,2,1,187326,187327,187328,1,2,0
53511,4,2,187330,187330,187332,0,2,2
53512,2,1,187332,187332,187333,0,1,0
53513,1,3,187333,187333,187336,0,3,0
53514,3,3,187336,187336,187339,0,3,0
53515,6,1,187342,187342,187343,0,1,3
53516,5,3,187347,187347,187350,0,3,4
53517,1,1,187348,187350,187351,2,3,0
53518,1,2,187349,187351,187353,2,4,0
53519,3,2,187352,187353,187355,1,3,0
53520,1,2,187353,187355,187357,2,4,0
53521,5,1,187358,187358,187359,0,1,1
53522,4,1,187362,187362,187363,0,1,3
53523,2,3,187364,187364,187367,0,3,1
53524,5,1,187369,187369,187370,0,1,2
53525,6,3,187375,187375,187378,0,3,5
53526,4,3,187379,187379,187382,0,3,1
53527,3,3,187382,187382,187385,0,3,0
53528,2,2,187384,187385,187387,1,3,0
53529,5,1,187389,187389,187390,0,1,2
53530,3,1,187392,187392,187393,0,1,2
53531,4,1,187396,187396,187397,0,1,3
53532,2,1,187398,187398,187399,0,1,1
53533,4,1,187402,187402,187403,0,1,3
53534,5,1,187407,187407,187408,0,1,4
53535,6,1,187413,187413,187414,0,1,5
53536,4,2,187417,187417,187419,0,2,3
53537,1,2,187418,187419,187421,1,3,0
53538,5,3,187423,187423,187426,0,3,2
53539,4,2,187427,187427,187429,0,2,1
53540,3,1,187430,187430,187431,0,1,1
53541,6,1,187436,187436,187437,0,1,5
53542,6,1,187442,187442,187443,0,1,5
53543,1,1,187443,187443,187444,0,1,0
53544,2,1,187445,187445,187446,0,1,1
53545,3,2,187448,187448,187450,0,2,2
53546,2,2,187450,187450,187452,0,2,0
53547,6,2,187456,187456,187458,0,2,4
53548,1,1,187457,187458,187459,1,2,0
53549,2,1,187459,187459,187460,0,1,0
53550,5,1,187464,187464,187465,0,1,4
53551,3,2,187467,187467,187469,0,2,2
53552,5,1,187472,187472,187473,0,1,3
53553,1,3,187473,187473,187476,0,3,0
53554,3,3,187476,187476,187479,0,3,0
53555,6,1,187482,187482,187483,0,1,3
53556,3,2,187485,187485,187487,0,2,2
53557,4,1,187489,187489,187490,0,1,2
53558,5,3,187494,187494,187497,0,3,4
53559,3,1,187497,187497,187498,0,1,0
53560,2,3,187499,187499,187502,0,3,1
53561,5,3,187504,187504,187507,0,3,2
53562,2,1,187506,187507,187508,1,2,0
53563,2,1,187508,187508,187509,0,1,0
53564,6,3,187514,187514,187517,0,3,5
53565,4,2,187518,187518,187520,0,2,1
53566,6,1,187524,187524,187525,0,1,4
53567,3,1,187527,187527,187528,0,1,2
53568,1,2,187528,187528,187530,0,2,0
53569,4,2,187532,187532,187534,0,2,2
53570,1,1,187533,187534,187535,1,2,0
53571,1,2,187534,187535,187537,1,3,0
53572,5,1,187539,187539,187540,0,1,2
53573,1,2,187540,187540,187542,0,2,0
53574,1,2,187541,187542,187544,1,3,0
53575,3,2,187544,187544,187546,0,2,0
53576,1,2,187545,187546,187548,1,3,0
53577,2,2,187547,187548,187550,1,3,0
53578,1,3,187548,187550,187553,2,5,0
53579,5,2,187553,187553,187555,0,2,0
53580,6,3,187559,187559,187562,0,3,4
53581,5,1,187564,187564,187565,0,1,2
53582,4,3,187568,187568,187571,0,3,3
53583,2,2,187570,187571,187573,1,3,0
53584,1,2,187571,187573,187575,2,4,0
53585,6,3,187577,187577,187580,0,3,2
53586,2,1,187579,187580,187581,1,2,0
53587,4,1,187583,187583,187584,0,1,2
53588,3,1,187586,187586,187587,0,1,2
53589,1,2,187587,187587,187589,0,2,0
53590,5,2,187592,187592,187594,0,2,3
53591,1,2,187593,187594,187596,1,3,0
53592,5,2,187598,187598,187600,0,2,2
53593,2,3,187600,187600,187603,0,3,0
53594,6,1,187606,187606,187607,0,1,3
53595,3,1,187609,187609,187610,0,1,2
53596,4,3,187613,187613,187616,0,3,3
53597,1,1,187614,187616,187617,2,3,0
53598,6,3,187620,187620,187623,0,3,3
53599,1,3,187621,187623,187626,2,5,0
53600,4,2,187625,187626,187628,1,3,0
53601,6,1,187631,187631,187632,0,1,3
53602,1,1,187632,187632,187633,0,1,0
53603,4,3,187636,187636,187639,0,3,3
53604,4,3,187640,187640,187643,0,3,1
53605,4,1,187644,187644,187645,0,1,1
53606,3,3,187647,187647,187650,0,3,2
53607,4,2,187651,187651,187653,0,2,1
53608,6,3,187657,187657,187660,0,3,4
53609,2,1,187659,187660,187661,1,2,0
53610,6,2,187665,187665,187667,0,2,4
53611,3,1,187668,187668,187669,0,1,1
53612,6,2,187674,187674,187676,0,2,5
53613,5,3,187679,187679,187682,0,3,3
53614,2,1,187681,187682,187683,1,2,0
53615,5,1,187686,187686,187687,0,1,3
53616,2,2,187688,187688,187690,0,2,1
53617,6,2,187694,187694,187696,0,2,4
53618,2,1,187696,187696,187697,0,1,0
53619,4,3,187700,187700,187703,0,3,3
53620,5,2,187705,187705,187707,0,2,2
53621,3,3,187708,187708,187711,0,3,1
53622,6,3,187714,187714,187717,0,3,3
53623,5,3,187719,187719,187722,0,3,2
53624,1,3,187720,187722,187725,2,5,0
53625,4,2,187724,187725,187727,1,3,0
53626,3,2,187727,187727,187729,0,2,0
53627,1,1,187728,187729,187730,1,2,0
53628,6,3,187734,187734,187737,0,3,4
53629,5,1,187739,187739,187740,0,1,2
53630,5,1,187744,187744,187745,0,1,4
53631,2,3,187746,187746,187749,0,3,1
53632,6,3,187752,187752,187755,0,3,3
53633,6,3,187758,187758,187761,0,3,3
53634,4,1,187762,187762,187763,0,1,1
53635,5,1,187767,187767,187768,0,1,4
53636,2,3,187769,187769,187772,0,3,1
53637,6,3,187775,187775,187778,0,3,3
53638,2,2,187777,187778,187780,1,3,0
53639,6,3,187783,187783,187786,0,3,3
53640,5,1,187788,187788,187789,0,1,2
53641,3,1,187791,187791,187792,0,1,2
53642,1,1,187792,187792,187793,0,1,0
53643,3,3,187795,187795,187798,0,3,2
53644,3,3,187798,187798,187801,0,3,0
53645,6,1,187804,187804,187805,0,1,3
53646,6,3,187810,187810,187813,0,3,5
53647,4,3,187814,187814,187817,0,3,1
53648,2,2,187816,187817,187819,1,3,0
53649,3,1,187819,187819,187820,0,1,0
53650,6,3,187825,187825,187828,0,3,5
53651,5,3,187830,187830,187833,0,3,2
53652,2,3,187832,187833,187836,1,4,0
53653,6,3,187838,187838,187841,0,3,2
53654,2,1,187840,187841,187842,1,2,0
53655,2,1,187842,187842,187843,0,1,0
53656,3,2,187845,187845,187847,0,2,2
53657,1,1,187846,187847,187848,1,2,0
53658,4,1,187850,187850,187851,0,1,2
53659,1,1,187851,187851,187852,0,1,0
53660,1,1,187852,187852,187853,0,1,0
53661,4,2,187856,187856,187858,0,2,3
53662,2,3,187858,187858,187861,0,3,0
53663,4,3,187862,187862,187865,0,3,1
53664,5,3,187867,187867,187870,0,3,2
53665,6,1,187873,187873,187874,0,1,3
53666,5,2,187878,187878,187880,0,2,4
53667,6,1,187884,187884,187885,0,1,4
53668,2,1,187886,187886,187887,0,1,1
53669,2,3,187888,187888,187891,0,3,1
53670,4,2,187892,187892,187894,0,2,1
53671,5,2,187897,187897,187899,0,2,3
53672,6,2,187903,187903,187905,0,2,4
53673,1,2,187904,187905,187907,1,3,0
53674,2,2,187906,187907,187909,1,3,0
53675,4,2,187910,187910,187912,0,2,1
53676,5,2,187915,187915,187917,0,2,3
53677,1,1,187916,187917,187918,1,2,0
53678,2,1,187918,187918,187919,0,1,0
53679,2,2,187920,187920,187922,0,2,1
53680,6,3,187926,187926,187929,0,3,4
53681,4,1,187930,187930,187931,0,1,1
53682,6,3,187936,187936,187939,0,3,5
53683,2,3,187938,187939,187942,1,4,0
53684,1,1,187939,187942,187943,3,4,0
53685,4,2,187943,187943,187945,0,2,0
53686,3,2,187946,187946,187948,0,2,1
53687,3,3,187949,187949,187952,0,3,1
53688,1,1,187950,187952,187953,2,3,0
53689,6,3,187956,187956,187959,0,3,3
53690,6,3,187962,187962,187965,0,3,3
53691,6,1,187968,187968,187969,0,1,3
53692,2,1,187970,187970,187971,0,1,1
53693,5,3,187975,187975,187978,0,3,4
53694,5,3,187980,187980,187983,0,3,2
53695,5,1,187985,187985,187986,0,1,2
53696,6,3,187991,187991,187994,0,3,5
53697,3,1,187994,187994,187995,0,1,0
53698,4,1,187998,187998,187999,0,1,3
53699,2,3,188000,188000,188003,0,3,1
53700,2,1,188002,188003,188004,1,2,0
53701,6,3,188008,188008,188011,0,3,4
53702,4,2,188012,188012,188014,0,2,1
53703,4,1,188016,188016,188017,0,1,2
53704,1,1,188017,188017,188018,0,1,0
53705,2,1,188019,188019,188020,0,1,1
53706,4,1,188023,188023,188024,0,1,3
53707,3,3,188026,188026,188029,0,3,2
53708,2,3,188028,188029,188032,1,4,0
53709,1,2,188029,188032,188034,3,5,0
53710,5,1,188034,188034,188035,0,1,0
53711,6,2,188040,188040,188042,0,2,5
53712,6,1,188046,188046,188047,0,1,4
53713,6,3,188052,188052,188055,0,3,5
53714,3,3,188055,188055,188058,0,3,0
53715,3,2,188058,188058,188060,0,2,0
53716,6,3,188064,188064,188067,0,3,4
53717,4,2,188068,188068,188070,0,2,1
53718,6,1,188074,188074,188075,0,1,4
53719,4,3,188078,188078,188081,0,3,3
53720,6,3,188084,188084,188087,0,3,3
53721,4,1,188088,188088,188089,0,1,1
53722,4,1,188092,188092,188093,0,1,3
53723,1,3,188093,188093,188096,0,3,0
53724,5,2,188098,188098,188100,0,2,2
53725,4,1,188102,188102,188103,0,1,2
53726,6,1,188108,188108,188109,0,1,5
53727,2,1,188110,188110,188111,0,1,1
53728,4,1,188114,188114,188115,0,1,3
53729,6,1,188120,188120,188121,0,1,5
53730,3,1,188123,188123,188124,0,1,2
53731,2,3,188125,188125,188128,0,3,1
53732,6,1,188131,188131,188132,0,1,3
53733,6,2,188137,188137,188139,0,2,5
53734,1,1,188138,188139,188140,1,2,0
53735,2,2,188140,188140,188142,0,2,0
53736,1,1,188141,188142,188143,1,2,0
53737,2,3,188143,188143,188146,0,3,0
53738,1,3,188144,188146,188149,2,5,0
53739,4,2,188148,188149,188151,1,3,0
53740,5,1,188153,188153,188154,0,1,2
53741,6,3,188159,188159,188162,0,3,5
53742,6,1,188165,188165,188166,0,1,3
53743,5,3,188170,188170,188173,0,3,4
53744,6,3,188176,188176,188179,0,3,3
53745,6,1,188182,188182,188183,0,1,3
53746,6,1,188188,188188,188189,0,1,5
53747,4,2,188192,188192,188194,0,2,3
53748,1,2,188193,188194,188196,1,3,0
53749,5,1,188198,188198,188199,0,1,2
53750,3,3,188201,188201,188204,0,3,2
53751,6,2,188207,188207,188209,0,2,3
53752,1,2,188208,188209,188211,1,3,0
53753,2,3,188210,188211,188214,1,4,0
53754,1,2,188211,188214,188216,3,5,0
53755,6,1,188217,188217,188218,0,1,1
53756,6,2,188223,188223,188225,0,2,5
53757,5,1,188228,188228,188229,0,1,3
53758,5,3,188233,188233,188236,0,3,4
53759,4,1,188237,188237,188238,0,1,1
53760,5,1,188242,188242,188243,0,1,4
53761,1,1,188243,188243,188244,0,1,0
53762,4,3,188247,188247,188250,0,3,3
53763,2,3,188249,188250,188253,1,4,0
53764,6,3,188255,188255,188258,0,3,2
53765,3,3,188258,188258,188261,0,3,0
53766,6,3,188264,188264,188267,0,3,3
53767,6,1,188270,188270,188271,0,1,3
53768,1,1,188271,188271,188272,0,1,0
53769,5,2,188276,188276,188278,0,2,4
53770,5,2,188281,188281,188283,0,2,3
53771,3,1,188284,188284,188285,0,1,1
53772,4,2,188288,188288,188290,0,2,3
53773,5,3,188293,188293,188296,0,3,3
53774,6,1,188299,188299,188300,0,1,3
53775,1,2,188300,188300,188302,0,2,0
53776,6,3,188306,188306,188309,0,3,4
53777,3,2,188309,188309,188311,0,2,0
53778,2,3,188311,188311,188314,0,3,0
53779,5,3,188316,188316,188319,0,3,2
53780,3,2,188319,188319,188321,0,2,0
53781,3,2,188322,188322,188324,0,2,1
53782,1,2,188323,188324,188326,1,3,0
53783,6,3,188329,188329,188332,0,3,3
53784,2,2,188331,188332,188334,1,3,0
53785,2,3,188333,188334,188337,1,4,0
53786,3,3,188336,188337,188340,1,4,0
53787,4,2,188340,188340,188342,0,2,0
53788,5,1,188345,188345,188346,0,1,3
53789,5,1,188350,188350,188351,0,1,4
53790,2,2,188352,188352,188354,0,2,1
53791,2,2,188354,188354,188356,0,2,0
53792,3,2,188357,188357,188359,0,2,1
53793,1,1,188358,188359,188360,1,2,0
53794,2,2,188360,188360,188362,0,2,0
53795,2,1,188362,188362,188363,0,1,0
53796,2,2,188364,188364,188366,0,2,1
53797,2,1,188366,188366,188367,0,1,0
53798,4,2,188370,188370,188372,0,2,3
53799,4,2,188374,188374,188376,0,2,2
53800,3,2,188377,188377,188379,0,2,1
53801,6,3,188383,188383,188386,0,3,4
53802,5,1,188388,188388,188389,0,1,2
53803,4,2,188392,188392,188394,0,2,3
53804,1,3,188393,188394,188397,1,4,0
53805,1,2,188394,188397,188399,3,5,0
53806,1,1,188395,188399,188400,4,5,0
53807,4,3,188399,188400,188403,1,4,0
53808,6,3,188405,188405,188408,0,3,2
53809,4,1,188409,188409,188410,0,1,1
53810,5,2,188414,188414,188416,0,2,4
53811,1,3,188415,188416,188419,1,4,0
53812,4,3,188419,188419,188422,0,3,0
53813,1,2,188420,188422,188424,2,4,0
53814,4,2,188424,188424,188426,0,2,0
53815,2,2,188426,188426,188428,0,2,0
53816,1,2,188427,188428,188430,1,3,0
53817,4,2,188431,188431,188433,0,2,1
53818,3,2,188434,188434,188436,0,2,1
53819,2,1,188436,188436,188437,0,1,0
53820,2,1,188438,188438,188439,0,1,1
53821,6,2,188444,188444,188446,0,2,5
53822,3,3,188447,188447,188450,0,3,1
53823,3,1,188450,188450,188451,0,1,0
53824,3,2,188453,188453,188455,0,2,2
53825,5,1,188458,188458,188459,0,1,3
53826,3,1,188461,188461,188462,0,1,2
53827,1,1,188462,188462,188463,0,1,0
53828,4,3,188466,188466,188469,0,3,3
53829,5,1,188471,188471,188472,0,1,2
53830,3,3,188474,188474,188477,0,3,2
53831,4,2,188478,188478,188480,0,2,1
53832,3,2,188481,188481,188483,0,2,1
53833,3,3,188484,188484,188487,0,3,1
53834,2,2,188486,188487,188489,1,3,0
53835,5,2,188491,188491,188493,0,2,2
53836,6,3,188497,188497,188500,0,3,4
53837,3,2,188500,188500,188502,0,2,0
53838,4,3,188504,188504,188507,0,3,2
53839,2,3,188506,188507,188510,1,4,0
53840,5,1,188511,188511,188512,0,1,1
53841,2,3,188513,188513,188516,0,3,1
53842,1,2,188514,188516,188518,2,4,0
53843,6,2,188520,188520,188522,0,2,2
53844,1,1,188521,188522,188523,1,2,0
53845,6,2,188527,188527,188529,0,2,4
53846,3,3,188530,188530,188533,0,3,1
53847,5,1,188535,188535,188536,0,1,2
53848,1,2,188536,188536,188538,0,2,0
53849,1,2,188537,188538,188540,1,3,0
53850,6,1,188543,188543,188544,0,1,3
53851,4,3,188547,188547,188550,0,3,3
53852,1,2,188548,188550,188552,2,4,0
53853,5,2,188553,188553,188555,0,2,1
53854,5,1,188558,188558,188559,0,1,3
53855,5,2,188563,188563,188565,0,2,4
53856,1,2,188564,188565,188567,1,3,0
53857,2,1,188566,188567,188568,1,2,0
53858,6,1,188572,188572,188573,0,1,4
53859,3,1,188575,188575,188576,0,1,2
53860,2,3,188577,188577,188580,0,3,1
53861,5,2,188582,188582,188584,0,2,2
53862,1,1,188583,188584,188585,1,2,0
53863,4,3,188587,188587,188590,0,3,2
53864,6,3,188593,188593,188596,0,3,3
53865,1,1,188594,188596,188597,2,3,0
53866,1,2,188595,188597,188599,2,4,0
53867,6,1,188601,188601,188602,0,1,2
53868,6,1,188607,188607,188608,0,1,5
53869,5,1,188612,188612,188613,0,1,4
53870,3,3,188615,188615,188618,0,3,2
53871,2,3,188617,188618,188621,1,4,0
53872,3,3,188620,188621,188624,1,4,0
53873,6,3,188626,188626,188629,0,3,2
53874,2,1,188628,188629,188630,1,2,0
53875,4,2,188632,188632,188634,0,2,2
53876,3,2,188635,188635,188637,0,2,1
53877,2,3,188637,188637,188640,0,3,0
53878,4,3,188641,188641,188644,0,3,1
53879,5,2,188646,188646,188648,0,2,2
53880,6,3,188652,188652,188655,0,3,4
53881,1,3,188653,188655,188658,2,5,0
53882,6,1,188659,188659,188660,0,1,1
53883,1,2,188660,188660,188662,0,2,0
53884,2,2,188662,188662,188664,0,2,0
53885,5,3,188667,188667,188670,0,3,3
53886,6,3,188673,188673,188676,0,3,3
53887,2,1,188675,188676,188677,1,2,0
53888,1,3,188676,188677,188680,1,4,0
53889,3,1,188679,188680,188681,1,2,0
53890,4,3,188683,188683,188686,0,3,2
53891,5,3,188688,188688,188691,0,3,2
53892,5,2,188693,188693,188695,0,2,2
53893,6,3,188699,188699,188702,0,3,4
53894,4,1,188703,188703,188704,0,1,1
53895,5,1,188708,188708,188709,0,1,4
53896,5,3,188713,188713,188716,0,3,4
53897,2,3,188715,188716,188719,1,4,0
53898,1,2,188716,188719,188721,3,5,0
53899,4,1,188720,188721,188722,1,2,0
53900,2,2,188722,188722,188724,0,2,0
53901,2,3,188724,188724,188727,0,3,0
53902,6,1,188730,188730,188731,0,1,3
53903,3,3,188733,188733,188736,0,3,2
53904,5,1,188738,188738,188739,0,1,2
53905,2,3,188740,188740,188743,0,3,1
53906,5,2,188745,188745,188747,0,2,2
53907,4,2,188749,188749,188751,0,2,2
53908,1,3,188750,188751,188754,1,4,0
53909,2,1,188752,188754,188755,2,3,0
53910,3,3,188755,188755,188758,0,3,0
53911,1,3,188756,188758,188761,2,5,0
53912,3,3,188759,188761,188764,2,5,0
53913,2,2,188761,188764,188766,3,5,0
53914,4,3,188765,188766,188769,1,4,0
53915,5,2,188770,188770,188772,0,2,1
53916,1,3,188771,188772,188775,1,4,0
53917,3,1,188774,188775,188776,1,2,0
53918,2,3,188776,188776,188779,0,3,0
53919,2,2,188778,188779,188781,1,3,0
53920,6,1,188784,188784,188785,0,1,3
53921,1,1,188785,188785,188786,0,1,0
53922,4,2,188789,188789,188791,0,2,3
53923,2,2,188791,188791,188793,0,2,0
53924,5,2,188796,188796,188798,0,2,3
53925,1,2,188797,188798,188800,1,3,0
53926,1,1,188798,188800,188801,2,3,0
53927,3,1,188801,188801,188802,0,1,0
53928,4,3,188805,188805,188808,0,3,3
53929,4,3,188809,188809,188812,0,3,1
53930,2,3,188811,188812,188815,1,4,0
53931,6,3,188817,188817,188820,0,3,2
53932,3,3,188820,188820,188823,0,3,0
53933,5,3,188825,188825,188828,0,3,2
53934,2,2,188827,188828,188830,1,3,0
53935,4,3,188831,188831,188834,0,3,1
53936,1,1,188832,188834,188835,2,3,0
53937,3,3,188835,188835,188838,0,3,0
53938,1,1,188836,188838,188839,2,3,0
53939,1,3,188837,188839,188842,2,5,0
53940,2,1,188839,188842,188843,3,4,0
53941,4,1,188843,188843,188844,0,1,0
53942,6,2,188849,188849,188851,0,2,5
53943,5,1,188854,188854,188855,0,1,3
53944,6,1,188860,188860,188861,0,1,5
53945,6,2,188866,188866,188868,0,2,5
53946,3,1,188869,188869,188870,0,1,1
53947,3,3,188872,188872,188875,0,3,2
53948,1,2,188873,188875,188877,2,4,0
53949,1,2,188874,188877,188879,3,5,0
53950,5,1,188879,188879,188880,0,1,0
53951,6,1,188885,188885,188886,0,1,5
53952,1,2,188886,188886,188888,0,2,0
53953,6,1,188892,188892,188893,0,1,4
53954,3,1,188895,188895,188896,0,1,2
53955,3,1,188898,188898,188899,0,1,2
53956,3,3,188901,188901,188904,0,3,2
53957,6,1,188907,188907,188908,0,1,3
53958,3,1,188910,188910,188911,0,1,2
53959,5,2,188915,188915,188917,0,2,4
53960,4,2,188919,188919,188921,0,2,2
53961,2,1,188921,188921,188922,0,1,0
53962,6,2,188927,188927,188929,0,2,5
53963,1,1,188928,188929,188930,1,2,0
53964,6,3,188934,188934,188937,0,3,4
53965,3,2,188937,188937,188939,0,2,0
53966,1,1,188938,188939,188940,1,2,0
53967,4,2,188942,188942,188944,0,2,2
53968,5,1,188947,188947,188948,0,1,3
53969,6,2,188953,188953,188955,0,2,5
53970,3,1,188956,188956,188957,0,1,1
53971,4,1,188960,188960,188961,0,1,3
53972,2,3,188962,188962,188965,0,3,1
53973,2,3,188964,188965,188968,1,4,0
53974,1,2,188965,188968,188970,3,5,0
53975,6,3,188971,188971,188974,0,3,1
53976,5,2,188976,188976,188978,0,2,2
53977,6,3,188982,188982,188985,0,3,4
53978,6,1,188988,188988,188989,0,1,3
53979,6,3,188994,188994,188997,0,3,5
53980,2,1,188996,188997,188998,1,2,0
53981,2,3,188998,188998,189001,0,3,0
53982,3,3,189001,189001,189004,0,3,0
53983,2,2,189003,189004,189006,1,3,0
53984,1,2,189004,189006,189008,2,4,0
53985,2,1,189006,189008,189009,2,3,0
53986,6,3,189012,189012,189015,0,3,3
53987,5,2,189017,189017,189019,0,2,2
53988,3,1,189020,189020,189021,0,1,1
53989,5,1,189025,189025,189026,0,1,4
53990,1,3,189026,189026,189029,0,3,0
53991,2,2,189028,189029,189031,1,3,0
53992,3,1,189031,189031,189032,0,1,0
53993,4,2,189035,189035,189037,0,2,3
53994,5,2,189040,189040,189042,0,2,3
53995,4,1,189044,189044,189045,0,1,2
53996,6,1,189050,189050,189051,0,1,5
53997,6,1,189056,189056,189057,0,1,5
53998,5,1,189061,189061,189062,0,1,4
53999,6,2,189067,189067,189069,0,2,5
54000,1,2,189068,189069,189071,1,3,0
54001,5,2,189073,189073,189075,0,2,2
54002,3,1,189076,189076,189077,0,1,1
54003,3,3,189079,189079,189082,0,3,2
54004,4,1,189083,189083,189084,0,1,1
54005,3,3,189086,189086,189089,0,3,2
54006,6,3,189092,189092,189095,0,3,3
54007,5,3,189097,189097,189100,0,3,2
54008,4,3,189101,189101,189104,0,3,1
54009,3,2,189104,189104,189106,0,2,0
54010,4,3,189108,189108,189111,0,3,2
54011,5,3,189113,189113,189116,0,3,2
54012,4,1,189117,189117,189118,0,1,1
54013,4,3,189121,189121,189124,0,3,3
54014,6,2,189127,189127,189129,0,2,3
54015,3,1,189130,189130,189131,0,1,1
54016,6,3,189136,189136,189139,0,3,5
54017,4,1,189140,189140,189141,0,1,1
54018,6,1,189146,189146,189147,0,1,5
54019,1,2,189147,189147,189149,0,2,0
54020,6,1,189153,189153,189154,0,1,4
54021,4,2,189157,189157,189159,0,2,3
54022,6,2,189163,189163,189165,0,2,4
54023,3,3,189166,189166,189169,0,3,1
54024,3,3,189169,189169,189172,0,3,0
54025,5,3,189174,189174,189177,0,3,2
54026,5,3,189179,189179,189182,0,3,2
54027,6,1,189185,189185,189186,0,1,3
54028,2,1,189187,189187,189188,0,1,1
54029,3,1,189190,189190,189191,0,1,2
54030,5,3,189195,189195,189198,0,3,4
54031,3,2,189198,189198,189200,0,2,0
54032,5,2,189203,189203,189205,0,2,3
54033,2,3,189205,189205,189208,0,3,0
54034,2,3,189207,189208,189211,1,4,0
54035,6,2,189213,189213,189215,0,2,2
54036,4,2,189217,189217,189219,0,2,2
54037,5,1,189222,189222,189223,0,1,3
54038,6,3,189228,189228,189231,0,3,5
54039,2,1,189230,189231,189232,1,2,0
54040,1,1,189231,189232,189233,1,2,0
54041,4,1,189235,189235,189236,0,1,2
54042,2,2,189237,189237,189239,0,2,1
54043,1,2,189238,189239,189241,1,3,0
54044,5,3,189243,189243,189246,0,3,2
54045,6,1,189249,189249,189250,0,1,3
54046,3,3,189252,189252,189255,0,3,2
54047,6,1,189258,189258,189259,0,1,3
54048,1,3,189259,189259,189262,0,3,0
54049,2,3,189261,189262,189265,1,4,0
54050,1,1,189262,189265,189266,3,4,0
54051,3,2,189265,189266,189268,1,3,0
54052,6,3,189271,189271,189274,0,3,3
54053,6,1,189277,189277,189278,0,1,3
54054,3,2,189280,189280,189282,0,2,2
54055,5,1,189285,189285,189286,0,1,3
54056,1,2,189286,189286,189288,0,2,0
54057,6,2,189292,189292,189294,0,2,4
54058,3,1,189295,189295,189296,0,1,1
54059,1,3,189296,189296,189299,0,3,0
54060,2,3,189298,189299,189302,1,4,0
54061,6,1,189304,189304,189305,0,1,2
54062,1,2,189305,189305,189307,0,2,0
54063,4,2,189309,189309,189311,0,2,2
54064,1,1,189310,189311,189312,1,2,0
54065,4,1,189314,189314,189315,0,1,2
54066,6,3,189320,189320,189323,0,3,5
54067,4,1,189324,189324,189325,0,1,1
54068,2,2,189326,189326,189328,0,2,1
54069,5,3,189331,189331,189334,0,3,3
54070,2,2,189333,189334,189336,1,3,0
54071,6,3,189339,189339,189342,0,3,3
54072,3,1,189342,189342,189343,0,1,0
54073,2,1,189344,189344,189345,0,1,1
54074,1,1,189345,189345,189346,0,1,0
54075,3,3,189348,189348,189351,0,3,2
54076,1,2,189349,189351,189353,2,4,0
54077,2,2,189351,189353,189355,2,4,0
54078,2,2,189353,189355,189357,2,4,0
54079,1,3,189354,189357,189360,3,6,0
54080,1,3,189355,189360,189363,5,8,0
54081,2,3,189357,189363,189366,6,9,0
54082,2,3,189359,189366,189369,7,10,0
54083,6,3,189365,189369,189372,4,7,0
54084,3,1,189368,189372,189373,4,5,0
54085,4,3,189372,189373,189376,1,4,0
54086,3,1,189375,189376,189377,1,2,0
54087,3,1,189378,189378,189379,0,1,1
54088,3,3,189381,189381,189384,0,3,2
54089,1,2,189382,189384,189386,2,4,0
54090,5,2,189387,189387,189389,0,2,1
54091,4,2,189391,189391,189393,0,2,2
54092,5,1,189396,189396,189397,0,1,3
54093,4,3,189400,189400,189403,0,3,3
54094,5,3,189405,189405,189408,0,3,2
54095,6,1,189411,189411,189412,0,1,3
54096,6,3,189417,189417,189420,0,3,5
54097,3,2,189420,189420,189422,0,2,0
54098,1,3,189421,189422,189425,1,4,0
54099,5,3,189426,189426,189429,0,3,1
54100,6,2,189432,189432,189434,0,2,3
54101,4,1,189436,189436,189437,0,1,2
54102,5,1,189441,189441,189442,0,1,4
54103,6,1,189447,189447,189448,0,1,5
54104,3,1,189450,189450,189451,0,1,2
54105,2,1,189452,189452,189453,0,1,1
54106,1,2,189453,189453,189455,0,2,0
54107,4,3,189457,189457,189460,0,3,2
54108,2,1,189459,189460,189461,1,2,0
54109,3,1,189462,189462,189463,0,1,1
54110,3,1,189465,189465,189466,0,1,2
54111,6,1,189471,189471,189472,0,1,5
54112,4,2,189475,189475,189477,0,2,3
54113,5,3,189480,189480,189483,0,3,3
54114,4,3,189484,189484,189487,0,3,1
54115,6,3,189490,189490,189493,0,3,3
54116,3,2,189493,189493,189495,0,2,0
54117,4,2,189497,189497,189499,0,2,2
54118,3,1,189500,189500,189501,0,1,1
54119,5,1,189505,189505,189506,0,1,4
54120,3,1,189508,189508,189509,0,1,2
54121,2,3,189510,189510,189513,0,3,1
54122,5,1,189515,189515,189516,0,1,2
54123,2,3,189517,189517,189520,0,3,1
54124,3,3,189520,189520,189523,0,3,0
54125,5,1,189525,189525,189526,0,1,2
54126,3,2,189528,189528,189530,0,2,2
54127,5,1,189533,189533,189534,0,1,3
54128,2,3,189535,189535,189538,0,3,1
54129,1,1,189536,189538,189539,2,3,0
54130,4,1,189540,189540,189541,0,1,1
54131,4,1,189544,189544,189545,0,1,3
54132,1,2,189545,189545,189547,0,2,0
54133,1,2,189546,189547,189549,1,3,0
54134,4,2,189550,189550,189552,0,2,1
54135,2,3,189552,189552,189555,0,3,0
54136,5,1,189557,189557,189558,0,1,2
54137,1,1,189558,189558,189559,0,1,0
54138,2,1,189560,189560,189561,0,1,1
54139,5,3,189565,189565,189568,0,3,4
54140,3,3,189568,189568,189571,0,3,0
54141,2,1,189570,189571,189572,1,2,0
54142,6,1,189576,189576,189577,0,1,4
54143,1,2,189577,189577,189579,0,2,0
54144,5,2,189582,189582,189584,0,2,3
54145,5,3,189587,189587,189590,0,3,3
54146,4,1,189591,189591,189592,0,1,1
54147,3,1,189594,189594,189595,0,1,2
54148,3,2,189597,189597,189599,0,2,2
54149,4,2,189601,189601,189603,0,2,2
54150,5,1,189606,189606,189607,0,1,3
54151,3,2,189609,189609,189611,0,2,2
54152,6,1,189615,189615,189616,0,1,4
54153,6,3,189621,189621,189624,0,3,5
54154,2,2,189623,189624,189626,1,3,0
54155,2,3,189625,189626,189629,1,4,0
54156,4,1,189629,189629,189630,0,1,0
54157,6,1,189635,189635,189636,0,1,5
54158,4,1,189639,189639,189640,0,1,3
54159,5,2,189644,189644,189646,0,2,4
54160,3,2,189647,189647,189649,0,2,1
54161,4,1,189651,189651,189652,0,1,2
54162,4,1,189655,189655,189656,0,1,3
54163,2,2,189657,189657,189659,0,2,1
54164,6,1,189663,189663,189664,0,1,4
54165,1,1,189664,189664,189665,0,1,0
54166,6,2,189670,189670,189672,0,2,5
54167,5,1,189675,189675,189676,0,1,3
54168,6,1,189681,189681,189682,0,1,5
54169,3,1,189684,189684,189685,0,1,2
54170,1,3,189685,189685,189688,0,3,0
54171,1,1,189686,189688,189689,2,3,0
54172,6,3,189692,189692,189695,0,3,3
54173,4,3,189696,189696,189699,0,3,1
54174,3,1,189699,189699,189700,0,1,0
54175,3,3,189702,189702,189705,0,3,2
54176,3,1,189705,189705,189706,0,1,0
54177,3,1,189708,189708,189709,0,1,2
54178,2,3,189710,189710,189713,0,3,1
54179,6,2,189716,189716,189718,0,2,3
54180,1,3,189717,189718,189721,1,4,0
54181,6,1,189723,189723,189724,0,1,2
54182,2,1,189725,189725,189726,0,1,1
54183,1,2,189726,189726,189728,0,2,0
54184,4,1,189730,189730,189731,0,1,2
54185,1,2,189731,189731,189733,0,2,0
54186,5,2,189736,189736,189738,0,2,3
54187,5,1,189741,189741,189742,0,1,3
54188,3,1,189744,189744,189745,0,1,2
54189,2,1,189746,189746,189747,0,1,1
54190,6,3,189752,189752,189755,0,3,5
54191,2,1,189754,189755,189756,1,2,0
54192,6,2,189760,189760,189762,0,2,4
54193,2,1,189762,189762,189763,0,1,0
54194,3,1,189765,189765,189766,0,1,2
54195,5,2,189770,189770,189772,0,2,4
54196,5,1,189775,189775,189776,0,1,3
54197,1,2,189776,189776,189778,0,2,0
54198,6,1,189782,189782,189783,0,1,4
54199,6,2,189788,189788,189790,0,2,5
54200,2,2,189790,189790,189792,0,2,0
54201,6,3,189796,189796,189799,0,3,4
54202,5,1,189801,189801,189802,0,1,2
54203,1,2,189802,189802,189804,0,2,0
54204,4,2,189806,189806,189808,0,2,2
54205,2,1,189808,189808,189809,0,1,0
54206,4,2,189812,189812,189814,0,2,3
54207,4,3,189816,189816,189819,0,3,2
54208,6,3,189822,189822,189825,0,3,3
54209,5,3,189827,189827,189830,0,3,2
54210,3,1,189830,189830,189831,0,1,0
54211,1,3,189831,189831,189834,0,3,0
54212,6,3,189837,189837,189840,0,3,3
54213,5,1,189842,189842,189843,0,1,2
54214,5,1,189847,189847,189848,0,1,4
54215,5,1,189852,189852,189853,0,1,4
54216,6,1,189858,189858,189859,0,1,5
54217,1,2,189859,189859,189861,0,2,0
54218,5,1,189864,189864,189865,0,1,3
54219,6,1,189870,189870,189871,0,1,5
54220,4,3,189874,189874,189877,0,3,3
54221,2,2,189876,189877,189879,1,3,0
54222,6,3,189882,189882,189885,0,3,3
54223,5,2,189887,189887,189889,0,2,2
54224,4,3,189891,189891,189894,0,3,2
54225,6,2,189897,189897,189899,0,2,3
54226,4,2,189901,189901,189903,0,2,2
54227,1,1,189902,189903,189904,1,2,0
54228,3,2,189905,189905,189907,0,2,1
54229,1,1,189906,189907,189908,1,2,0
54230,6,1,189912,189912,189913,0,1,4
54231,5,2,189917,189917,189919,0,2,4
54232,6,1,189923,189923,189924,0,1,4
54233,6,1,189929,189929,189930,0,1,5
54234,4,3,189933,189933,189936,0,3,3
54235,2,3,189935,189936,189939,1,4,0
54236,1,3,189936,189939,189942,3,6,0
54237,2,3,189938,189942,189945,4,7,0
54238,2,3,189940,189945,189948,5,8,0
54239,5,3,189945,189948,189951,3,6,0
54240,2,1,189947,189951,189952,4,5,0
54241,1,2,189948,189952,189954,4,6,0
54242,3,1,189951,189954,189955,3,4,0
54243,2,3,189953,189955,189958,2,5,0
54244,2,1,189955,189958,189959,3,4,0
54245,2,3,189957,189959,189962,2,5,0
54246,3,2,189960,189962,189964,2,4,0
54247,3,2,189963,189964,189966,1,3,0
54248,6,2,189969,189969,189971,0,2,3
54249,4,2,189973,189973,189975,0,2,2
54250,2,1,189975,189975,189976,0,1,0
54251,3,1,189978,189978,189979,0,1,2
54252,2,2,189980,189980,189982,0,2,1
54253,4,2,189984,189984,189986,0,2,2
54254,1,3,189985,189986,189989,1,4,0
54255,1,1,189986,189989,189990,3,4,0
54256,1,1,189987,189990,189991,3,4,0
54257,2,1,189989,189991,189992,2,3,0
54258,2,2,189991,189992,189994,1,3,0
54259,3,1,189994,189994,189995,0,1,0
54260,2,3,189996,189996,189999,0,3,1
54261,4,1,190000,190000,190001,0,1,1
54262,2,3,190002,190002,190005,0,3,1
54263,2,1,190004,190005,190006,1,2,0
54264,2,3,190006,190006,190009,0,3,0
54265,2,1,190008,190009,190010,1,2,0
54266,5,1,190013,190013,190014,0,1,3
54267,2,3,190015,190015,190018,0,3,1
54268,1,3,190016,190018,190021,2,5,0
54269,5,3,190021,190021,190024,0,3,0
54270,6,2,190027,190027,190029,0,2,3
54271,5,2,190032,190032,190034,0,2,3
54272,3,3,190035,190035,190038,0,3,1
54273,6,2,190041,190041,190043,0,2,3
54274,6,3,190047,190047,190050,0,3,4
54275,4,2,190051,190051,190053,0,2,1
54276,5,3,190056,190056,190059,0,3,3
54277,6,2,190062,190062,190064,0,2,3
54278,3,3,190065,190065,190068,0,3,1
54279,6,2,190071,190071,190073,0,2,3
54280,4,1,190075,190075,190076,0,1,2
54281,6,3,190081,190081,190084,0,3,5
54282,6,3,190087,190087,190090,0,3,3
54283,1,2,190088,190090,190092,2,4,0
54284,2,3,190090,190092,190095,2,5,0
54285,4,2,190094,190095,190097,1,3,0
54286,1,1,190095,190097,190098,2,3,0
54287,5,3,190100,190100,190103,0,3,2
54288,5,1,190105,190105,190106,0,1,2
54289,5,2,190110,190110,190112,0,2,4
54290,6,3,190116,190116,190119,0,3,4
54291,6,2,190122,190122,190124,0,2,3
54292,1,2,190123,190124,190126,1,3,0
54293,3,2,190126,190126,190128,0,2,0
54294,3,2,190129,190129,190131,0,2,1
54295,1,1,190130,190131,190132,1,2,0
54296,5,1,190135,190135,190136,0,1,3
54297,6,3,190141,190141,190144,0,3,5
54298,6,3,190147,190147,190150,0,3,3
54299,3,3,190150,190150,190153,0,3,0
54300,3,1,190153,190153,190154,0,1,0
54301,1,1,190154,190154,190155,0,1,0
54302,1,3,190155,190155,190158,0,3,0
54303,6,1,190161,190161,190162,0,1,3
54304,6,3,190167,190167,190170,0,3,5
54305,6,1,190173,190173,190174,0,1,3
54306,3,1,190176,190176,190177,0,1,2
54307,5,2,190181,190181,190183,0,2,4
54308,4,3,190185,190185,190188,0,3,2
54309,2,1,190187,190188,190189,1,2,0
54310,4,2,190191,190191,190193,0,2,2
54311,1,1,190192,190193,190194,1,2,0
54312,5,3,190197,190197,190200,0,3,3
54313,4,2,190201,190201,190203,0,2,1
54314,1,3,190202,190203,190206,1,4,0
54315,4,2,190206,190206,190208,0,2,0
54316,3,3,190209,190209,190212,0,3,1
54317,6,2,190215,190215,190217,0,2,3
54318,4,1,190219,190219,190220,0,1,2
54319,5,3,190224,190224,190227,0,3,4
54320,6,2,190230,190230,190232,0,2,3
54321,6,2,190236,190236,190238,0,2,4
54322,6,3,190242,190242,190245,0,3,4
54323,5,1,190247,190247,190248,0,1,2
54324,2,2,190249,190249,190251,0,2,1
54325,2,1,190251,190251,190252,0,1,0
54326,6,2,190257,190257,190259,0,2,5
54327,5,2,190262,190262,190264,0,2,3
54328,5,1,190267,190267,190268,0,1,3
54329,5,2,190272,190272,190274,0,2,4
54330,4,1,190276,190276,190277,0,1,2
54331,6,2,190282,190282,190284,0,2,5
54332,3,2,190285,190285,190287,0,2,1
54333,4,3,190289,190289,190292,0,3,2
54334,5,1,190294,190294,190295,0,1,2
54335,2,2,190296,190296,190298,0,2,1
54336,6,1,190302,190302,190303,0,1,4
54337,1,2,190303,190303,190305,0,2,0
54338,3,2,190306,190306,190308,0,2,1
54339,3,3,190309,190309,190312,0,3,1
54340,6,2,190315,190315,190317,0,2,3
54341,3,3,190318,190318,190321,0,3,1
54342,3,1,190321,190321,190322,0,1,0
54343,2,2,190323,190323,190325,0,2,1
54344,2,3,190325,190325,190328,0,3,0
54345,5,1,190330,190330,190331,0,1,2
54346,4,3,190334,190334,190337,0,3,3
54347,3,2,190337,190337,190339,0,2,0
54348,3,2,190340,190340,190342,0,2,1
54349,3,2,190343,190343,190345,0,2,1
54350,3,2,190346,190346,190348,0,2,1
54351,3,3,190349,190349,190352,0,3,1
54352,3,1,190352,190352,190353,0,1,0
54353,4,2,190356,190356,190358,0,2,3
54354,6,2,190362,190362,190364,0,2,4
54355,2,3,190364,190364,190367,0,3,0
54356,3,1,190367,190367,190368,0,1,0
54357,2,2,190369,190369,190371,0,2,1
54358,3,2,190372,190372,190374,0,2,1
54359,4,1,190376,190376,190377,0,1,2
54360,6,3,190382,190382,190385,0,3,5
54361,3,1,190385,190385,190386,0,1,0
54362,5,2,190390,190390,190392,0,2,4
54363,4,1,190394,190394,190395,0,1,2
54364,3,3,190397,190397,190400,0,3,2
54365,6,3,190403,190403,190406,0,3,3
54366,1,2,190404,190406,190408,2,4,0
54367,6,2,190410,190410,190412,0,2,2
54368,6,2,190416,190416,190418,0,2,4
54369,4,2,190420,190420,190422,0,2,2
54370,1,3,190421,190422,190425,1,4,0
54371,4,2,190425,190425,190427,0,2,0
54372,5,2,190430,190430,190432,0,2,3
54373,6,1,190436,190436,190437,0,1,4
54374,1,3,190437,190437,190440,0,3,0
54375,1,1,190438,190440,190441,2,3,0
54376,6,3,190444,190444,190447,0,3,3
54377,1,3,190445,190447,190450,2,5,0
54378,2,1,190447,190450,190451,3,4,0
54379,3,3,190450,190451,190454,1,4,0
54380,5,3,190455,190455,190458,0,3,1
54381,2,2,190457,190458,190460,1,3,0
54382,2,3,190459,190460,190463,1,4,0
54383,1,2,190460,190463,190465,3,5,0
54384,5,1,190465,190465,190466,0,1,0
54385,5,3,190470,190470,190473,0,3,4
54386,1,1,190471,190473,190474,2,3,0
54387,5,3,190476,190476,190479,0,3,2
54388,6,1,190482,190482,190483,0,1,3
54389,5,1,190487,190487,190488,0,1,4
54390,2,1,190489,190489,190490,0,1,1
54391,5,3,190494,190494,190497,0,3,4
54392,2,3,190496,190497,190500,1,4,0
54393,4,2,190500,190500,190502,0,2,0
54394,1,3,190501,190502,190505,1,4,0
54395,6,2,190507,190507,190509,0,2,2
54396,4,2,190511,190511,190513,0,2,2
54397,5,1,190516,190516,190517,0,1,3
54398,5,1,190521,190521,190522,0,1,4
54399,1,3,190522,190522,190525,0,3,0
54400,6,1,190528,190528,190529,0,1,3
54401,3,1,190531,190531,190532,0,1,2
54402,2,2,190533,190533,190535,0,2,1
54403,2,3,190535,190535,190538,0,3,0
54404,5,3,190540,190540,190543,0,3,2
54405,2,1,190542,190543,190544,1,2,0
54406,5,1,190547,190547,190548,0,1,3
54407,4,3,190551,190551,190554,0,3,3
54408,1,2,190552,190554,190556,2,4,0
54409,2,3,190554,190556,190559,2,5,0
54410,5,1,190559,190559,190560,0,1,0
54411,4,3,190563,190563,190566,0,3,3
54412,2,1,190565,190566,190567,1,2,0
54413,6,1,190571,190571,190572,0,1,4
54414,1,1,190572,190572,190573,0,1,0
54415,3,1,190575,190575,190576,0,1,2
54416,4,3,190579,190579,190582,0,3,3
54417,1,3,190580,190582,190585,2,5,0
54418,1,1,190581,190585,190586,4,5,0
54419,1,3,190582,190586,190589,4,7,0
54420,3,1,190585,190589,190590,4,5,0
54421,1,2,190586,190590,190592,4,6,0
54422,3,1,190589,190592,190593,3,4,0
54423,5,3,190594,190594,190597,0,3,1
54424,6,3,190600,190600,190603,0,3,3
54425,6,3,190606,190606,190609,0,3,3
54426,1,1,190607,190609,190610,2,3,0
54427,4,3,190611,190611,190614,0,3,1
54428,2,3,190613,190614,190617,1,4,0
54429,5,1,190618,190618,190619,0,1,1
54430,1,3,190619,190619,190622,0,3,0
54431,2,1,190621,190622,190623,1,2,0
54432,4,1,190625,190625,190626,0,1,2
54433,2,2,190627,190627,190629,0,2,1
54434,3,1,190630,190630,190631,0,1,1
54435,6,3,190636,190636,190639,0,3,5
54436,4,1,190640,190640,190641,0,1,1
54437,6,3,190646,190646,190649,0,3,5
54438,4,2,190650,190650,190652,0,2,1
54439,3,1,190653,190653,190654,0,1,1
54440,4,1,190657,190657,190658,0,1,3
54441,4,1,190661,190661,190662,0,1,3
54442,2,2,190663,190663,190665,0,2,1
54443,2,1,190665,190665,190666,0,1,0
54444,5,1,190670,190670,190671,0,1,4
54445,5,3,190675,190675,190678,0,3,4
54446,5,2,190680,190680,190682,0,2,2
54447,6,2,190686,190686,190688,0,2,4
54448,4,1,190690,190690,190691,0,1,2
54449,4,1,190694,190694,190695,0,1,3
54450,4,1,190698,190698,190699,0,1,3
54451,6,1,190704,190704,190705,0,1,5
54452,5,1,190709,190709,190710,0,1,4
54453,2,3,190711,190711,190714,0,3,1
54454,1,1,190712,190714,190715,2,3,0
54455,4,2,190716,190716,190718,0,2,1
54456,3,1,190719,190719,190720,0,1,1
54457,6,3,190725,190725,190728,0,3,5
54458,2,2,190727,190728,190730,1,3,0
54459,6,1,190733,190733,190734,0,1,3
54460,5,2,190738,190738,190740,0,2,4
54461,6,1,190744,190744,190745,0,1,4
54462,4,3,190748,190748,190751,0,3,3
54463,1,2,190749,190751,190753,2,4,0
54464,6,2,190755,190755,190757,0,2,2
54465,2,2,190757,190757,190759,0,2,0
54466,3,3,190760,190760,190763,0,3,1
54467,5,3,190765,190765,190768,0,3,2
54468,1,1,190766,190768,190769,2,3,0
54469,5,2,190771,190771,190773,0,2,2
54470,3,2,190774,190774,190776,0,2,1
54471,1,1,190775,190776,190777,1,2,0
54472,4,1,190779,190779,190780,0,1,2
54473,2,2,190781,190781,190783,0,2,1
54474,2,3,190783,190783,190786,0,3,0
54475,1,1,190784,190786,190787,2,3,0
54476,1,2,190785,190787,190789,2,4,0
54477,2,1,190787,190789,190790,2,3,0
54478,4,2,190791,190791,190793,0,2,1
54479,3,2,190794,190794,190796,0,2,1
54480,5,2,190799,190799,190801,0,2,3
54481,3,2,190802,190802,190804,0,2,1
54482,4,3,190806,190806,190809,0,3,2
54483,2,2,190808,190809,190811,1,3,0
54484,5,2,190813,190813,190815,0,2,2
54485,2,1,190815,190815,190816,0,1,0
54486,6,3,190821,190821,190824,0,3,5
54487,5,2,190826,190826,190828,0,2,2
54488,1,2,190827,190828,190830,1,3,0
54489,3,2,190830,190830,190832,0,2,0
54490,5,3,190835,190835,190838,0,3,3
54491,5,3,190840,190840,190843,0,3,2
54492,5,1,190845,190845,190846,0,1,2
54493,1,3,190846,190846,190849,0,3,0
54494,6,2,190852,190852,190854,0,2,3
54495,2,3,190854,190854,190857,0,3,0
54496,4,3,190858,190858,190861,0,3,1
54497,3,1,190861,190861,190862,0,1,0
54498,6,3,190867,190867,190870,0,3,5
54499,2,1,190869,190870,190871,1,2,0
54500,5,3,190874,190874,190877,0,3,3
54501,1,2,190875,190877,190879,2,4,0
54502,2,1,190877,190879,190880,2,3,0
54503,1,1,190878,190880,190881,2,3,0
54504,2,1,190880,190881,190882,1,2,0
54505,4,1,190884,190884,190885,0,1,2
54506,4,2,190888,190888,190890,0,2,3
54507,5,2,190893,190893,190895,0,2,3
54508,3,1,190896,190896,190897,0,1,1
54509,3,1,190899,190899,190900,0,1,2
54510,4,2,190903,190903,190905,0,2,3
54511,1,2,190904,190905,190907,1,3,0
54512,3,2,190907,190907,190909,0,2,0
54513,5,2,190912,190912,190914,0,2,3
54514,4,3,190916,190916,190919,0,3,2
54515,3,3,190919,190919,190922,0,3,0
54516,2,2,190921,190922,190924,1,3,0
54517,4,3,190925,190925,190928,0,3,1
54518,2,1,190927,190928,190929,1,2,0
54519,4,1,190931,190931,190932,0,1,2
54520,6,1,190937,190937,190938,0,1,5
54521,1,1,190938,190938,190939,0,1,0
54522,2,3,190940,190940,190943,0,3,1
54523,1,3,190941,190943,190946,2,5,0
54524,6,3,190947,190947,190950,0,3,1
54525,3,2,190950,190950,190952,0,2,0
54526,5,2,190955,190955,190957,0,2,3
54527,3,3,190958,190958,190961,0,3,1
54528,1,2,190959,190961,190963,2,4,0
54529,1,3,190960,190963,190966,3,6,0
54530,3,2,190963,190966,190968,3,5,0
54531,1,2,190964,190968,190970,4,6,0
54532,4,2,190968,190970,190972,2,4,0
54533,1,2,190969,190972,190974,3,5,0
54534,6,1,190975,190975,190976,0,1,1
54535,2,2,190977,190977,190979,0,2,1
54536,2,1,190979,190979,190980,0,1,0
54537,6,3,190985,190985,190988,0,3,5
54538,1,1,190986,190988,190989,2,3,0
54539,6,1,190992,190992,190993,0,1,3
54540,3,1,190995,190995,190996,0,1,2
54541,2,3,190997,190997,191000,0,3,1
54542,4,2,191001,191001,191003,0,2,1
54543,5,1,191006,191006,191007,0,1,3
54544,6,1,191012,191012,191013,0,1,5
54545,1,1,191013,191013,191014,0,1,0
54546,5,1,191018,191018,191019,0,1,4
54547,3,3,191021,191021,191024,0,3,2
54548,2,2,191023,191024,191026,1,3,0
54549,3,1,191026,191026,191027,0,1,0
54550,6,1,191032,191032,191033,0,1,5
54551,1,1,191033,191033,191034,0,1,0
54552,6,3,191039,191039,191042,0,3,5
54553,6,2,191045,191045,191047,0,2,3
54554,3,3,191048,191048,191051,0,3,1
54555,5,3,191053,191053,191056,0,3,2
54556,2,3,191055,191056,191059,1,4,0
54557,5,3,191060,191060,191063,0,3,1
54558,2,3,191062,191063,191066,1,4,0
54559,4,1,191066,191066,191067,0,1,0
54560,6,2,191072,191072,191074,0,2,5
54561,1,1,191073,191074,191075,1,2,0
54562,3,3,191076,191076,191079,0,3,1
54563,2,1,191078,191079,191080,1,2,0
54564,1,1,191079,191080,191081,1,2,0
54565,5,1,191084,191084,191085,0,1,3
54566,3,2,191087,191087,191089,0,2,2
54567,3,2,191090,191090,191092,0,2,1
54568,4,3,191094,191094,191097,0,3,2
54569,3,3,191097,191097,191100,0,3,0
54570,3,1,191100,191100,191101,0,1,0
54571,1,2,191101,191101,191103,0,2,0
54572,6,3,191107,191107,191110,0,3,4
54573,3,1,191110,191110,191111,0,1,0
54574,4,3,191114,191114,191117,0,3,3
54575,6,2,191120,191120,191122,0,2,3
54576,1,2,191121,191122,191124,1,3,0
54577,4,2,191125,191125,191127,0,2,1
54578,6,3,191131,191131,191134,0,3,4
54579,3,3,191134,191134,191137,0,3,0
54580,2,2,191136,191137,191139,1,3,0
54581,5,1,191141,191141,191142,0,1,2
54582,2,2,191143,191143,191145,0,2,1
54583,3,1,191146,191146,191147,0,1,1
54584,5,2,191151,191151,191153,0,2,4
54585,3,3,191154,191154,191157,0,3,1
54586,5,3,191159,191159,191162,0,3,2
54587,1,2,191160,191162,191164,2,4,0
54588,2,3,191162,191164,191167,2,5,0
54589,5,1,191167,191167,191168,0,1,0
54590,4,1,191171,191171,191172,0,1,3
54591,2,1,191173,191173,191174,0,1,1
54592,3,1,191176,191176,191177,0,1,2
54593,2,1,191178,191178,191179,0,1,1
54594,5,2,191183,191183,191185,0,2,4
54595,4,1,191187,191187,191188,0,1,2
54596,1,3,191188,191188,191191,0,3,0
54597,4,2,191192,191192,191194,0,2,1
54598,3,3,191195,191195,191198,0,3,1
54599,1,1,191196,191198,191199,2,3,0
54600,1,1,191197,191199,191200,2,3,0
54601,2,3,191199,191200,191203,1,4,0
54602,2,1,191201,191203,191204,2,3,0
54603,4,2,191205,191205,191207,0,2,1
54604,1,3,191206,191207,191210,1,4,0
54605,6,3,191212,191212,191215,0,3,2
54606,6,1,191218,191218,191219,0,1,3
54607,6,1,191224,191224,191225,0,1,5
54608,6,3,191230,191230,191233,0,3,5
54609,2,1,191232,191233,191234,1,2,0
54610,5,3,191237,191237,191240,0,3,3
54611,4,3,191241,191241,191244,0,3,1
54612,5,3,191246,191246,191249,0,3,2
54613,3,3,191249,191249,191252,0,3,0
54614,6,2,191255,191255,191257,0,2,3
54615,3,2,191258,191258,191260,0,2,1
54616,2,3,191260,191260,191263,0,3,0
54617,2,1,191262,191263,191264,1,2,0
54618,6,2,191268,191268,191270,0,2,4
54619,3,3,191271,191271,191274,0,3,1
54620,3,2,191274,191274,191276,0,2,0
54621,3,2,191277,191277,191279,0,2,1
54622,2,1,191279,191279,191280,0,1,0
54623,6,2,191285,191285,191287,0,2,5
54624,2,1,191287,191287,191288,0,1,0
54625,3,3,191290,191290,191293,0,3,2
54626,5,2,191295,191295,191297,0,2,2
54627,2,1,191297,191297,191298,0,1,0
54628,5,2,191302,191302,191304,0,2,4
54629,6,1,191308,191308,191309,0,1,4
54630,1,2,191309,191309,191311,0,2,0
54631,5,2,191314,191314,191316,0,2,3
54632,1,3,191315,191316,191319,1,4,0
54633,3,3,191318,191319,191322,1,4,0
54634,1,2,191319,191322,191324,3,5,0
54635,5,1,191324,191324,191325,0,1,0
54636,2,2,191326,191326,191328,0,2,1
54637,6,1,191332,191332,191333,0,1,4
54638,5,1,191337,191337,191338,0,1,4
54639,1,3,191338,191338,191341,0,3,0
54640,4,2,191342,191342,191344,0,2,1
54641,3,1,191345,191345,191346,0,1,1
54642,6,3,191351,191351,191354,0,3,5
54643,5,2,191356,191356,191358,0,2,2
54644,3,2,191359,191359,191361,0,2,1
54645,6,2,191365,191365,191367,0,2,4
54646,5,3,191370,191370,191373,0,3,3
54647,1,3,191371,191373,191376,2,5,0
54648,6,3,191377,191377,191380,0,3,1
54649,6,1,191383,191383,191384,0,1,3
54650,5,2,191388,191388,191390,0,2,4
54651,6,3,191394,191394,191397,0,3,4
54652,1,2,191395,191397,191399,2,4,0
54653,6,2,191401,191401,191403,0,2,2
54654,5,2,191406,191406,191408,0,2,3
54655,4,1,191410,191410,191411,0,1,2
54656,1,1,191411,191411,191412,0,1,0
54657,1,1,191412,191412,191413,0,1,0
54658,6,3,191418,191418,191421,0,3,5
54659,6,1,191424,191424,191425,0,1,3
54660,5,1,191429,191429,191430,0,1,4
54661,2,1,191431,191431,191432,0,1,1
54662,6,2,191437,191437,191439,0,2,5
54663,6,3,191443,191443,191446,0,3,4
54664,1,3,191444,191446,191449,2,5,0
54665,3,2,191447,191449,191451,2,4,0
54666,2,3,191449,191451,191454,2,5,0
54667,4,2,191453,191454,191456,1,3,0
54668,4,3,191457,191457,191460,0,3,1
54669,4,2,191461,191461,191463,0,2,1
54670,2,3,191463,191463,191466,0,3,0
54671,5,1,191468,191468,191469,0,1,2
54672,6,3,191474,191474,191477,0,3,5
54673,3,3,191477,191477,191480,0,3,0
54674,3,2,191480,191480,191482,0,2,0
54675,2,1,191482,191482,191483,0,1,0
54676,3,2,191485,191485,191487,0,2,2
54677,3,1,191488,191488,191489,0,1,1
54678,6,3,191494,191494,191497,0,3,5
54679,1,2,191495,191497,191499,2,4,0
54680,6,3,191501,191501,191504,0,3,2
54681,2,1,191503,191504,191505,1,2,0
54682,1,3,191504,191505,191508,1,4,0
54683,4,3,191508,191508,191511,0,3,0
54684,5,1,191513,191513,191514,0,1,2
54685,3,3,191516,191516,191519,0,3,2
54686,2,3,191518,191519,191522,1,4,0
54687,6,1,191524,191524,191525,0,1,2
54688,6,1,191530,191530,191531,0,1,5
54689,3,3,191533,191533,191536,0,3,2
54690,4,1,191537,191537,191538,0,1,1
54691,4,1,191541,191541,191542,0,1,3
54692,2,1,191543,191543,191544,0,1,1
54693,4,3,191547,191547,191550,0,3,3
54694,2,3,191549,191550,191553,1,4,0
54695,6,2,191555,191555,191557,0,2,2
54696,1,2,191556,191557,191559,1,3,0
54697,4,1,191560,191560,191561,0,1,1
54698,3,1,191563,191563,191564,0,1,2
54699,3,1,191566,191566,191567,0,1,2
54700,2,1,191568,191568,191569,0,1,1
54701,3,2,191571,191571,191573,0,2,2
54702,5,1,191576,191576,191577,0,1,3
54703,6,2,191582,191582,191584,0,2,5
54704,4,3,191586,191586,191589,0,3,2
54705,3,3,191589,191589,191592,0,3,0
54706,2,3,191591,191592,191595,1,4,0
54707,4,2,191595,191595,191597,0,2,0
54708,1,1,191596,191597,191598,1,2,0
54709,4,2,191600,191600,191602,0,2,2
54710,6,2,191606,191606,191608,0,2,4
54711,3,1,191609,191609,191610,0,1,1
54712,5,1,191614,191614,191615,0,1,4
54713,6,3,191620,191620,191623,0,3,5
54714,6,1,191626,191626,191627,0,1,3
54715,4,2,191630,191630,191632,0,2,3
54716,3,1,191633,191633,191634,0,1,1
54717,5,1,191638,191638,191639,0,1,4
54718,4,1,191642,191642,191643,0,1,3
54719,1,3,191643,191643,191646,0,3,0
54720,1,2,191644,191646,191648,2,4,0
54721,2,3,191646,191648,191651,2,5,0
54722,1,2,191647,191651,191653,4,6,0
54723,4,2,191651,191653,191655,2,4,0
54724,3,2,191654,191655,191657,1,3,0
54725,3,1,191657,191657,191658,0,1,0
54726,1,2,191658,191658,191660,0,2,0
54727,2,1,191660,191660,191661,0,1,0
54728,6,1,191666,191666,191667,0,1,5
54729,1,1,191667,191667,191668,0,1,0
54730,2,3,191669,191669,191672,0,3,1
54731,1,1,191670,191672,191673,2,3,0
54732,5,3,191675,191675,191678,0,3,2
54733,1,2,191676,191678,191680,2,4,0
54734,6,2,191682,191682,191684,0,2,2
54735,6,1,191688,191688,191689,0,1,4
54736,6,2,191694,191694,191696,0,2,5
54737,5,2,191699,191699,191701,0,2,3
54738,3,1,191702,191702,191703,0,1,1
54739,3,3,191705,191705,191708,0,3,2
54740,4,1,191709,191709,191710,0,1,1
54741,4,3,191713,191713,191716,0,3,3
54742,2,1,191715,191716,191717,1,2,0
54743,4,3,191719,191719,191722,0,3,2
54744,6,3,191725,191725,191728,0,3,3
54745,3,2,191728,191728,191730,0,2,0
54746,5,2,191733,191733,191735,0,2,3
54747,5,1,191738,191738,191739,0,1,3
54748,4,1,191742,191742,191743,0,1,3
54749,2,2,191744,191744,191746,0,2,1
54750,1,1,191745,191746,191747,1,2,0
54751,1,3,191746,191747,191750,1,4,0
54752,5,1,191751,191751,191752,0,1,1
54753,3,3,191754,191754,191757,0,3,2
54754,3,1,191757,191757,191758,0,1,0
54755,4,1,191761,191761,191762,0,1,3
54756,3,1,191764,191764,191765,0,1,2
54757,2,1,191766,191766,191767,0,1,1
54758,3,2,191769,191769,191771,0,2,2
54759,2,2,191771,191771,191773,0,2,0
54760,2,1,191773,191773,191774,0,1,0
54761,2,2,191775,191775,191777,0,2,1
54762,3,1,191778,191778,191779,0,1,1
54763,5,1,191783,191783,191784,0,1,4
54764,4,3,191787,191787,191790,0,3,3
54765,4,2,191791,191791,191793,0,2,1
54766,3,1,191794,191794,191795,0,1,1
54767,6,2,191800,191800,191802,0,2,5
54768,3,3,191803,191803,191806,0,3,1
54769,1,3,191804,191806,191809,2,5,0
54770,4,3,191808,191809,191812,1,4,0
54771,3,3,191811,191812,191815,1,4,0
54772,2,3,191813,191815,191818,2,5,0
54773,2,3,191815,191818,191821,3,6,0
54774,6,1,191821,191821,191822,0,1,0
54775,1,1,191822,191822,191823,0,1,0
54776,4,2,191826,191826,191828,0,2,3
54777,3,1,191829,191829,191830,0,1,1
54778,4,3,191833,191833,191836,0,3,3
54779,4,2,191837,191837,191839,0,2,1
54780,4,2,191841,191841,191843,0,2,2
54781,2,2,191843,191843,191845,0,2,0
54782,4,1,191847,191847,191848,0,1,2
54783,5,1,191852,191852,191853,0,1,4
54784,1,1,191853,191853,191854,0,1,0
54785,6,2,191859,191859,191861,0,2,5
54786,2,3,191861,191861,191864,0,3,0
54787,3,1,191864,191864,191865,0,1,0
54788,5,3,191869,191869,191872,0,3,4
54789,3,1,191872,191872,191873,0,1,0
54790,1,2,191873,191873,191875,0,2,0
54791,1,2,191874,191875,191877,1,3,0
54792,3,1,191877,191877,191878,0,1,0
54793,4,3,191881,191881,191884,0,3,3
54794,1,2,191882,191884,191886,2,4,0
54795,3,2,191885,191886,191888,1,3,0
54796,1,2,191886,191888,191890,2,4,0
54797,1,2,191887,191890,191892,3,5,0
54798,3,3,191890,191892,191895,2,5,0
54799,3,3,191893,191895,191898,2,5,0
54800,6,2,191899,191899,191901,0,2,1
54801,1,3,191900,191901,191904,1,4,0
54802,4,3,191904,191904,191907,0,3,0
54803,4,1,191908,191908,191909,0,1,1
54804,6,3,191914,191914,191917,0,3,5
54805,2,2,191916,191917,191919,1,3,0
54806,2,1,191918,191919,191920,1,2,0
54807,1,3,191919,191920,191923,1,4,0
54808,1,2,191920,191923,191925,3,5,0
54809,1,3,191921,191925,191928,4,7,0
54810,4,2,191925,191928,191930,3,5,0
54811,6,2,191931,191931,191933,0,2,1
54812,4,1,191935,191935,191936,0,1,2
54813,5,1,191940,191940,191941,0,1,4
54814,4,2,191944,191944,191946,0,2,3
54815,2,3,191946,191946,191949,0,3,0
54816,5,1,191951,191951,191952,0,1,2
54817,4,2,191955,191955,191957,0,2,3
54818,1,2,191956,191957,191959,1,3,0
54819,4,3,191960,191960,191963,0,3,1
54820,4,2,191964,191964,191966,0,2,1
54821,6,3,191970,191970,191973,0,3,4
54822,3,2,191973,191973,191975,0,2,0
54823,4,3,191977,191977,191980,0,3,2
54824,2,2,191979,191980,191982,1,3,0
54825,2,2,191981,191982,191984,1,3,0
54826,5,3,191986,191986,191989,0,3,2
54827,1,1,191987,191989,191990,2,3,0
54828,4,2,191991,191991,191993,0,2,1
54829,3,1,191994,191994,191995,0,1,1
54830,5,2,191999,191999,192001,0,2,4
54831,6,1,192005,192005,192006,0,1,4
54832,5,3,192010,192010,192013,0,3,4
54833,3,1,192013,192013,192014,0,1,0
54834,3,2,192016,192016,192018,0,2,2
54835,1,2,192017,192018,192020,1,3,0
54836,1,3,192018,192020,192023,2,5,0
54837,4,1,192022,192023,192024,1,2,0
54838,4,1,192026,192026,192027,0,1,2
54839,2,2,192028,192028,192030,0,2,1
54840,3,1,192031,192031,192032,0,1,1
54841,1,2,192032,192032,192034,0,2,0
54842,3,3,192035,192035,192038,0,3,1
54843,5,2,192040,192040,192042,0,2,2
54844,4,3,192044,192044,192047,0,3,2
54845,1,3,192045,192047,192050,2,5,0
54846,5,2,192050,192050,192052,0,2,0
54847,2,3,192052,192052,192055,0,3,0
54848,4,1,192056,192056,192057,0,1,1
54849,2,3,192058,192058,192061,0,3,1
54850,6,2,192064,192064,192066,0,2,3
54851,5,2,192069,192069,192071,0,2,3
54852,1,2,192070,192071,192073,1,3,0
54853,4,1,192074,192074,192075,0,1,1
54854,4,3,192078,192078,192081,0,3,3
54855,4,3,192082,192082,192085,0,3,1
54856,6,1,192088,192088,192089,0,1,3
54857,6,2,192094,192094,192096,0,2,5
54858,4,3,192098,192098,192101,0,3,2
54859,5,3,192103,192103,192106,0,3,2
54860,6,1,192109,192109,192110,0,1,3
54861,6,2,192115,192115,192117,0,2,5
54862,2,2,192117,192117,192119,0,2,0
54863,2,1,192119,192119,192120,0,1,0
54864,4,1,192123,192123,192124,0,1,3
54865,4,3,192127,192127,192130,0,3,3
54866,1,3,192128,192130,192133,2,5,0
54867,5,3,192133,192133,192136,0,3,0
54868,3,2,192136,192136,192138,0,2,0
54869,1,1,192137,192138,192139,1,2,0
54870,2,1,192139,192139,192140,0,1,0
54871,1,1,192140,192140,192141,0,1,0
54872,3,1,192143,192143,192144,0,1,2
54873,4,1,192147,192147,192148,0,1,3
54874,6,2,192153,192153,192155,0,2,5
54875,6,3,192159,192159,192162,0,3,4
54876,5,3,192164,192164,192167,0,3,2
54877,4,2,192168,192168,192170,0,2,1
54878,3,1,192171,192171,192172,0,1,1
54879,3,1,192174,192174,192175,0,1,2
54880,3,3,192177,192177,192180,0,3,2
54881,3,3,192180,192180,192183,0,3,0
54882,5,3,192185,192185,192188,0,3,2
54883,3,2,192188,192188,192190,0,2,0
54884,1,3,192189,192190,192193,1,4,0
54885,2,2,192191,192193,192195,2,4,0
54886,1,2,192192,192195,192197,3,5,0
54887,5,1,192197,192197,192198,0,1,0
54888,5,1,192202,192202,192203,0,1,4
54889,4,3,192206,192206,192209,0,3,3
54890,1,2,192207,192209,192211,2,4,0
54891,6,2,192213,192213,192215,0,2,2
54892,4,2,192217,192217,192219,0,2,2
54893,6,1,192223,192223,192224,0,1,4
54894,3,3,192226,192226,192229,0,3,2
54895,2,2,192228,192229,192231,1,3,0
54896,3,1,192231,192231,192232,0,1,0
54897,1,1,192232,192232,192233,0,1,0
54898,6,1,192238,192238,192239,0,1,5
54899,4,2,192242,192242,192244,0,2,3
54900,5,1,192247,192247,192248,0,1,3
54901,5,2,192252,192252,192254,0,2,4
54902,2,3,192254,192254,192257,0,3,0
54903,5,2,192259,192259,192261,0,2,2
54904,3,3,192262,192262,192265,0,3,1
54905,6,1,192268,192268,192269,0,1,3
54906,2,1,192270,192270,192271,0,1,1
54907,1,3,192271,192271,192274,0,3,0
54908,6,2,192277,192277,192279,0,2,3
54909,6,3,192283,192283,192286,0,3,4
54910,1,3,192284,192286,192289,2,5,0
54911,5,1,192289,192289,192290,0,1,0
54912,2,3,192291,192291,192294,0,3,1
54913,6,1,192297,192297,192298,0,1,3
54914,3,2,192300,192300,192302,0,2,2
54915,5,3,192305,192305,192308,0,3,3
54916,4,2,192309,192309,192311,0,2,1
54917,3,1,192312,192312,192313,0,1,1
54918,4,1,192316,192316,192317,0,1,3
54919,1,2,192317,192317,192319,0,2,0
54920,1,1,192318,192319,192320,1,2,0
54921,3,1,192321,192321,192322,0,1,1
54922,6,3,192327,192327,192330,0,3,5
54923,5,2,192332,192332,192334,0,2,2
54924,1,2,192333,192334,192336,1,3,0
54925,3,3,192336,192336,192339,0,3,0
54926,6,2,192342,192342,192344,0,2,3
54927,2,2,192344,192344,192346,0,2,0
54928,1,3,192345,192346,192349,1,4,0
54929,4,3,192349,192349,192352,0,3,0
54930,6,2,192355,192355,192357,0,2,3
54931,6,2,192361,192361,192363,0,2,4
54932,2,1,192363,192363,192364,0,1,0
54933,3,1,192366,192366,192367,0,1,2
54934,5,2,192371,192371,192373,0,2,4
54935,5,3,192376,192376,192379,0,3,3
54936,4,1,192380,192380,192381,0,1,1
54937,3,2,192383,192383,192385,0,2,2
54938,4,3,192387,192387,192390,0,3,2
54939,1,2,192388,192390,192392,2,4,0
54940,1,3,192389,192392,192395,3,6,0
54941,2,2,192391,192395,192397,4,6,0
54942,3,1,192394,192397,192398,3,4,0
54943,3,3,192397,192398,192401,1,4,0
54944,3,3,192400,192401,192404,1,4,0
54945,6,1,192406,192406,192407,0,1,2
54946,2,3,192408,192408,192411,0,3,1
54947,4,1,192412,192412,192413,0,1,1
54948,2,1,192414,192414,192415,0,1,1
54949,3,2,192417,192417,192419,0,2,2
54950,1,3,192418,192419,192422,1,4,0
54951,3,1,192421,192422,192423,1,2,0
54952,1,3,192422,192423,192426,1,4,0
54953,4,3,192426,192426,192429,0,3,0
54954,2,3,192428,192429,192432,1,4,0
54955,2,3,192430,192432,192435,2,5,0
54956,4,3,192434,192435,192438,1,4,0
54957,4,3,192438,192438,192441,0,3,0
54958,4,1,192442,192442,192443,0,1,1
54959,3,3,192445,192445,192448,0,3,2
54960,2,1,192447,192448,192449,1,2,0
54961,3,1,192450,192450,192451,0,1,1
54962,1,2,192451,192451,192453,0,2,0
54963,5,3,192456,192456,192459,0,3,3
54964,3,1,192459,192459,192460,0,1,0
54965,4,2,192463,192463,192465,0,2,3
54966,1,3,192464,192465,192468,1,4,0
54967,2,1,192466,192468,192469,2,3,0
54968,2,3,192468,192469,192472,1,4,0
54969,1,2,192469,192472,192474,3,5,0
54970,6,3,192475,192475,192478,0,3,1
54971,5,3,192480,192480,192483,0,3,2
54972,6,3,192486,192486,192489,0,3,3
54973,3,1,192489,192489,192490,0,1,0
54974,4,3,192493,192493,192496,0,3,3
54975,1,3,192494,192496,192499,2,5,0
54976,5,2,192499,192499,192501,0,2,0
54977,1,2,192500,192501,192503,1,3,0
54978,4,1,192504,192504,192505,0,1,1
54979,4,3,192508,192508,192511,0,3,3
54980,2,1,192510,192511,192512,1,2,0
54981,5,1,192515,192515,192516,0,1,3
54982,4,2,192519,192519,192521,0,2,3
54983,3,3,192522,192522,192525,0,3,1
54984,1,3,192523,192525,192528,2,5,0
54985,6,3,192529,192529,192532,0,3,1
54986,4,1,192533,192533,192534,0,1,1
54987,5,1,192538,192538,192539,0,1,4
54988,6,2,192544,192544,192546,0,2,5
54989,6,1,192550,192550,192551,0,1,4
54990,4,2,192554,192554,192556,0,2,3
54991,4,1,192558,192558,192559,0,1,2
54992,4,3,192562,192562,192565,0,3,3
54993,4,1,192566,192566,192567,0,1,1
54994,4,1,192570,192570,192571,0,1,3
54995,2,3,192572,192572,192575,0,3,1
54996,3,1,192575,192575,192576,0,1,0
54997,3,3,192578,192578,192581,0,3,2
54998,2,3,192580,192581,192584,1,4,0
54999,6,3,192586,192586,192589,0,3,2
55000,3,2,192589,192589,192591,0,2,0
55001,6,2,192595,192595,192597,0,2,4
55002,1,1,192596,192597,192598,1,2,0
55003,5,2,192601,192601,192603,0,2,3
55004,4,1,192605,192605,192606,0,1,2
55005,2,2,192607,192607,192609,0,2,1
55006,6,3,192613,192613,192616,0,3,4
55007,3,1,192616,192616,192617,0,1,0
55008,3,2,192619,192619,192621,0,2,2
55009,2,2,192621,192621,192623,0,2,0
55010,2,3,192623,192623,192626,0,3,0
55011,1,3,192624,192626,192629,2,5,0
55012,2,3,192626,192629,192632,3,6,0
55013,5,1,192631,192632,192633,1,2,0
55014,3,3,192634,192634,192637,0,3,1
55015,3,2,192637,192637,192639,0,2,0
55016,6,3,192643,192643,192646,0,3,4
55017,4,2,192647,192647,192649,0,2,1
55018,2,1,192649,192649,192650,0,1,0
55019,3,3,192652,192652,192655,0,3,2
55020,6,3,192658,192658,192661,0,3,3
55021,3,2,192661,192661,192663,0,2,0
55022,3,1,192664,192664,192665,0,1,1
55023,4,1,192668,192668,192669,0,1,3
55024,5,3,192673,192673,192676,0,3,4
55025,6,2,192679,192679,192681,0,2,3
55026,1,1,192680,192681,192682,1,2,0
55027,1,2,192681,192682,192684,1,3,0
55028,4,3,192685,192685,192688,0,3,1
55029,6,1,192691,192691,192692,0,1,3
55030,5,3,192696,192696,192699,0,3,4
55031,6,2,192702,192702,192704,0,2,3
55032,5,2,192707,192707,192709,0,2,3
55033,3,2,192710,192710,192712,0,2,1
55034,5,3,192715,192715,192718,0,3,3
55035,3,1,192718,192718,192719,0,1,0
55036,3,2,192721,192721,192723,0,2,2
55037,2,3,192723,192723,192726,0,3,0
55038,2,1,192725,192726,192727,1,2,0
55039,3,2,192728,192728,192730,0,2,1
55040,4,3,192732,192732,192735,0,3,2
55041,4,3,192736,192736,192739,0,3,1
55042,4,3,192740,192740,192743,0,3,1
55043,5,1,192745,192745,192746,0,1,2
55044,2,3,192747,192747,192750,0,3,1
55045,4,2,192751,192751,192753,0,2,1
55046,2,2,192753,192753,192755,0,2,0
55047,4,2,192757,192757,192759,0,2,2
55048,5,3,192762,192762,192765,0,3,3
55049,5,2,192767,192767,192769,0,2,2
55050,4,3,192771,192771,192774,0,3,2
55051,4,1,192775,192775,192776,0,1,1
55052,3,1,192778,192778,192779,0,1,2
55053,5,2,192783,192783,192785,0,2,4
55054,4,3,192787,192787,192790,0,3,2
55055,2,1,192789,192790,192791,1,2,0
55056,4,1,192793,192793,192794,0,1,2
55057,5,1,192798,192798,192799,0,1,4
55058,6,1,192804,192804,192805,0,1,5
55059,2,2,192806,192806,192808,0,2,1
55060,3,2,192809,192809,192811,0,2,1
55061,4,2,192813,192813,192815,0,2,2
55062,2,1,192815,192815,192816,0,1,0
55063,3,3,192818,192818,192821,0,3,2
55064,6,3,192824,192824,192827,0,3,3
55065,2,1,192826,192827,192828,1,2,0
55066,3,1,192829,192829,192830,0,1,1
55067,2,2,192831,192831,192833,0,2,1
55068,4,1,192835,192835,192836,0,1,2
55069,4,2,192839,192839,192841,0,2,3
55070,3,1,192842,192842,192843,0,1,1
55071,1,3,192843,192843,192846,0,3,0
55072,4,3,192847,192847,192850,0,3,1
55073,2,2,192849,192850,192852,1,3,0
55074,3,1,192852,192852,192853,0,1,0
55075,2,1,192854,192854,192855,0,1,1
55076,5,1,192859,192859,192860,0,1,4
55077,5,2,192864,192864,192866,0,2,4
55078,5,2,192869,192869,192871,0,2,3
55079,3,2,192872,192872,192874,0,2,1
55080,1,2,192873,192874,192876,1,3,0
55081,5,1,192878,192878,192879,0,1,2
55082,1,2,192879,192879,192881,0,2,0
55083,5,2,192884,192884,192886,0,2,3
55084,6,1,192890,192890,192891,0,1,4
55085,2,2,192892,192892,192894,0,2,1
55086,6,1,192898,192898,192899,0,1,4
55087,4,3,192902,192902,192905,0,3,3
55088,6,1,192908,192908,192909,0,1,3
55089,2,3,192910,192910,192913,0,3,1
55090,3,1,192913,192913,192914,0,1,0
55091,3,3,192916,192916,192919,0,3,2
55092,4,1,192920,192920,192921,0,1,1
55093,1,1,192921,192921,192922,0,1,0
55094,6,2,192927,192927,192929,0,2,5
55095,2,3,192929,192929,192932,0,3,0
55096,2,2,192931,192932,192934,1,3,0
55097,4,1,192935,192935,192936,0,1,1
55098,2,1,192937,192937,192938,0,1,1
55099,3,1,192940,192940,192941,0,1,2
55100,2,2,192942,192942,192944,0,2,1
55101,5,3,192947,192947,192950,0,3,3
55102,6,1,192953,192953,192954,0,1,3
55103,1,3,192954,192954,192957,0,3,0
55104,3,3,192957,192957,192960,0,3,0
55105,6,2,192963,192963,192965,0,2,3
55106,5,3,192968,192968,192971,0,3,3
55107,3,2,192971,192971,192973,0,2,0
55108,3,2,192974,192974,192976,0,2,1
55109,1,1,192975,192976,192977,1,2,0
55110,5,3,192980,192980,192983,0,3,3
55111,1,3,192981,192983,192986,2,5,0
55112,3,1,192984,192986,192987,2,3,0
55113,6,2,192990,192990,192992,0,2,3
55114,1,3,192991,192992,192995,1,4,0
55115,3,3,192994,192995,192998,1,4,0
55116,4,3,192998,192998,193001,0,3,0
55117,3,2,193001,193001,193003,0,2,0
55118,5,1,193006,193006,193007,0,1,3
55119,2,2,193008,193008,193010,0,2,1
55120,6,1,193014,193014,193015,0,1,4
55121,2,1,193016,193016,193017,0,1,1
55122,4,2,193020,193020,193022,0,2,3
55123,3,1,193023,193023,193024,0,1,1
55124,2,2,193025,193025,193027,0,2,1
55125,1,1,193026,193027,193028,1,2,0
55126,5,3,193031,193031,193034,0,3,3
55127,6,2,193037,193037,193039,0,2,3
55128,3,2,193040,193040,193042,0,2,1
55129,4,1,193044,193044,193045,0,1,2
55130,5,1,193049,193049,193050,0,1,4
55131,2,3,193051,193051,193054,0,3,1
55132,6,1,193057,193057,193058,0,1,3
55133,4,1,193061,193061,193062,0,1,3
55134,3,1,193064,193064,193065,0,1,2
55135,4,3,193068,193068,193071,0,3,3
55136,5,1,193073,193073,193074,0,1,2
55137,2,1,193075,193075,193076,0,1,1
55138,3,2,193078,193078,193080,0,2,2
55139,6,3,193084,193084,193087,0,3,4
55140,5,2,193089,193089,193091,0,2,2
55141,6,2,193095,193095,193097,0,2,4
55142,2,1,193097,193097,193098,0,1,0
55143,5,3,193102,193102,193105,0,3,4
55144,3,1,193105,193105,193106,0,1,0
55145,6,2,193111,193111,193113,0,2,5
55146,5,2,193116,193116,193118,0,2,3
55147,4,2,193120,193120,193122,0,2,2
55148,1,1,193121,193122,193123,1,2,0
55149,6,3,193127,193127,193130,0,3,4
55150,1,2,193128,193130,193132,2,4,0
55151,3,2,193131,193132,193134,1,3,0
55152,3,2,193134,193134,193136,0,2,0
55153,5,1,193139,193139,193140,0,1,3
55154,3,1,193142,193142,193143,0,1,2
55155,4,2,193146,193146,193148,0,2,3
55156,4,1,193150,193150,193151,0,1,2
55157,2,3,193152,193152,193155,0,3,1
55158,2,2,193154,193155,193157,1,3,0
55159,6,1,193160,193160,193161,0,1,3
55160,5,2,193165,193165,193167,0,2,4
55161,6,1,193171,193171,193172,0,1,4
55162,2,2,193173,193173,193175,0,2,1
55163,6,2,193179,193179,193181,0,2,4
55164,2,2,193181,193181,193183,0,2,0
55165,2,2,193183,193183,193185,0,2,0
55166,1,1,193184,193185,193186,1,2,0
55167,4,1,193188,193188,193189,0,1,2
55168,6,2,193194,193194,193196,0,2,5
55169,3,1,193197,193197,193198,0,1,1
55170,4,1,193201,193201,193202,0,1,3
55171,1,3,193202,193202,193205,0,3,0
55172,4,3,193206,193206,193209,0,3,1
55173,4,1,193210,193210,193211,0,1,1
55174,4,2,193214,193214,193216,0,2,3
55175,6,3,193220,193220,193223,0,3,4
55176,4,2,193224,193224,193226,0,2,1
55177,1,2,193225,193226,193228,1,3,0
55178,1,2,193226,193228,193230,2,4,0
55179,4,3,193230,193230,193233,0,3,0
55180,2,3,193232,193233,193236,1,4,0
55181,1,2,193233,193236,193238,3,5,0
55182,1,2,193234,193238,193240,4,6,0
55183,2,2,193236,193240,193242,4,6,0
55184,4,2,193240,193242,193244,2,4,0
55185,3,1,193243,193244,193245,1,2,0
55186,2,2,193245,193245,193247,0,2,0
55187,3,3,193248,193248,193251,0,3,1
55188,5,1,193253,193253,193254,0,1,2
55189,1,3,193254,193254,193257,0,3,0
55190,5,2,193259,193259,193261,0,2,2
55191,1,1,193260,193261,193262,1,2,0
55192,1,2,193261,193262,193264,1,3,0
55193,5,1,193266,193266,193267,0,1,2
55194,6,1,193272,193272,193273,0,1,5
55195,6,2,193278,193278,193280,0,2,5
55196,1,3,193279,193280,193283,1,4,0
55197,1,1,193280,193283,193284,3,4,0
55198,2,2,193282,193284,193286,2,4,0
55199,3,1,193285,193286,193287,1,2,0
55200,6,3,193291,193291,193294,0,3,4
55201,6,2,193297,193297,193299,0,2,3
55202,1,2,193298,193299,193301,1,3,0
55203,3,2,193301,193301,193303,0,2,0
55204,2,1,193303,193303,193304,0,1,0
55205,1,2,193304,193304,193306,0,2,0
55206,3,1,193307,193307,193308,0,1,1
55207,4,2,193311,193311,193313,0,2,3
55208,6,2,193317,193317,193319,0,2,4
55209,4,2,193321,193321,193323,0,2,2
55210,1,2,193322,193323,193325,1,3,0
55211,3,3,193325,193325,193328,0,3,0
55212,2,2,193327,193328,193330,1,3,0
55213,4,1,193331,193331,193332,0,1,1
55214,6,3,193337,193337,193340,0,3,5
55215,5,3,193342,193342,193345,0,3,2
55216,5,3,193347,193347,193350,0,3,2
55217,4,1,193351,193351,193352,0,1,1
55218,4,2,193355,193355,193357,0,2,3
55219,1,1,193356,193357,193358,1,2,0
55220,3,3,193359,193359,193362,0,3,1
55221,2,3,193361,193362,193365,1,4,0
55222,2,1,193363,193365,193366,2,3,0
55223,2,1,193365,193366,193367,1,2,0
55224,5,1,193370,193370,193371,0,1,3
55225,5,3,193375,193375,193378,0,3,4
55226,3,1,193378,193378,193379,0,1,0
55227,1,1,193379,193379,193380,0,1,0
55228,5,2,193384,193384,193386,0,2,4
55229,1,1,193385,193386,193387,1,2,0
55230,5,3,193390,193390,193393,0,3,3
55231,5,3,193395,193395,193398,0,3,2
55232,3,2,193398,193398,193400,0,2,0
55233,2,1,193400,193400,193401,0,1,0
55234,5,2,193405,193405,193407,0,2,4
55235,4,3,193409,193409,193412,0,3,2
55236,1,1,193410,193412,193413,2,3,0
55237,5,2,193415,193415,193417,0,2,2
55238,5,1,193420,193420,193421,0,1,3
55239,3,3,193423,193423,193426,0,3,2
55240,2,1,193425,193426,193427,1,2,0
55241,1,2,193426,193427,193429,1,3,0
55242,3,3,193429,193429,193432,0,3,0
55243,2,2,193431,193432,193434,1,3,0
55244,1,3,193432,193434,193437,2,5,0
55245,6,2,193438,193438,193440,0,2,1
55246,2,2,193440,193440,193442,0,2,0
55247,1,1,193441,193442,193443,1,2,0
55248,3,1,193444,193444,193445,0,1,1
55249,6,1,193450,193450,193451,0,1,5
55250,6,1,193456,193456,193457,0,1,5
55251,6,2,193462,193462,193464,0,2,5
55252,5,3,193467,193467,193470,0,3,3
55253,3,1,193470,193470,193471,0,1,0
55254,4,2,193474,193474,193476,0,2,3
55255,6,2,193480,193480,193482,0,2,4
55256,5,1,193485,193485,193486,0,1,3
55257,6,3,193491,193491,193494,0,3,5
55258,2,1,193493,193494,193495,1,2,0
55259,1,3,193494,193495,193498,1,4,0
55260,4,1,193498,193498,193499,0,1,0
55261,4,3,193502,193502,193505,0,3,3
55262,5,1,193507,193507,193508,0,1,2
55263,6,2,193513,193513,193515,0,2,5
55264,6,3,193519,193519,193522,0,3,4
55265,4,3,193523,193523,193526,0,3,1
55266,3,3,193526,193526,193529,0,3,0
55267,3,3,193529,193529,193532,0,3,0
55268,3,2,193532,193532,193534,0,2,0
55269,2,3,193534,193534,193537,0,3,0
55270,1,1,193535,193537,193538,2,3,0
55271,6,2,193541,193541,193543,0,2,3
55272,2,1,193543,193543,193544,0,1,0
55273,5,3,193548,193548,193551,0,3,4
55274,5,1,193553,193553,193554,0,1,2
55275,1,3,193554,193554,193557,0,3,0
55276,1,2,193555,193557,193559,2,4,0
55277,2,1,193557,193559,193560,2,3,0
55278,3,3,193560,193560,193563,0,3,0
55279,1,1,193561,193563,193564,2,3,0
55280,3,1,193564,193564,193565,0,1,0
55281,4,1,193568,193568,193569,0,1,3
55282,1,1,193569,193569,193570,0,1,0
55283,5,3,193574,193574,193577,0,3,4
55284,1,1,193575,193577,193578,2,3,0
55285,3,3,193578,193578,193581,0,3,0
55286,1,2,193579,193581,193583,2,4,0
55287,4,1,193583,193583,193584,0,1,0
55288,6,1,193589,193589,193590,0,1,5
55289,5,3,193594,193594,193597,0,3,4
55290,6,3,193600,193600,193603,0,3,3
55291,6,3,193606,193606,193609,0,3,3
55292,3,1,193609,193609,193610,0,1,0
55293,6,3,193615,193615,193618,0,3,5
55294,5,1,193620,193620,193621,0,1,2
55295,4,2,193624,193624,193626,0,2,3
55296,3,2,193627,193627,193629,0,2,1
55297,3,2,193630,193630,193632,0,2,1
55298,1,2,193631,193632,193634,1,3,0
55299,3,1,193634,193634,193635,0,1,0
55300,4,3,193638,193638,193641,0,3,3
55301,6,2,193644,193644,193646,0,2,3
55302,5,3,193649,193649,193652,0,3,3
55303,2,2,193651,193652,193654,1,3,0
55304,5,3,193656,193656,193659,0,3,2
55305,6,2,193662,193662,193664,0,2,3
55306,3,2,193665,193665,193667,0,2,1
55307,4,3,193669,193669,193672,0,3,2
55308,5,3,193674,193674,193677,0,3,2
55309,6,3,193680,193680,193683,0,3,3
55310,3,1,193683,193683,193684,0,1,0
55311,1,1,193684,193684,193685,0,1,0
55312,5,1,193689,193689,193690,0,1,4
55313,3,3,193692,193692,193695,0,3,2
55314,5,1,193697,193697,193698,0,1,2
55315,1,1,193698,193698,193699,0,1,0
55316,6,2,193704,193704,193706,0,2,5
55317,4,2,193708,193708,193710,0,2,2
55318,3,3,193711,193711,193714,0,3,1
55319,3,1,193714,193714,193715,0,1,0
55320,4,2,193718,193718,193720,0,2,3
55321,6,3,193724,193724,193727,0,3,4
55322,2,3,193726,193727,193730,1,4,0
55323,2,2,193728,193730,193732,2,4,0
55324,1,1,193729,193732,193733,3,4,0
55325,2,1,193731,193733,193734,2,3,0
55326,3,3,193734,193734,193737,0,3,0
55327,2,1,193736,193737,193738,1,2,0
55328,4,3,193740,193740,193743,0,3,2
55329,5,2,193745,193745,193747,0,2,2
55330,6,3,193751,193751,193754,0,3,4
55331,5,1,193756,193756,193757,0,1,2
55332,6,2,193762,193762,193764,0,2,5
55333,3,1,193765,193765,193766,0,1,1
55334,3,2,193768,193768,193770,0,2,2
55335,3,3,193771,193771,193774,0,3,1
55336,5,3,193776,193776,193779,0,3,2
55337,1,2,193777,193779,193781,2,4,0
55338,5,1,193782,193782,193783,0,1,1
55339,2,1,193784,193784,193785,0,1,1
55340,6,3,193790,193790,193793,0,3,5
55341,2,2,193792,193793,193795,1,3,0
55342,2,1,193794,193795,193796,1,2,0
55343,3,1,193797,193797,193798,0,1,1
55344,1,1,193798,193798,193799,0,1,0
55345,1,3,193799,193799,193802,0,3,0
55346,5,1,193804,193804,193805,0,1,2
55347,1,1,193805,193805,193806,0,1,0
55348,1,3,193806,193806,193809,0,3,0
55349,5,3,193811,193811,193814,0,3,2
55350,4,2,193815,193815,193817,0,2,1
55351,2,2,193817,193817,193819,0,2,0
55352,6,3,193823,193823,193826,0,3,4
55353,3,2,193826,193826,193828,0,2,0
55354,2,1,193828,193828,193829,0,1,0
55355,2,2,193830,193830,193832,0,2,1
55356,4,3,193834,193834,193837,0,3,2
55357,3,2,193837,193837,193839,0,2,0
55358,4,1,193841,193841,193842,0,1,2
55359,2,2,193843,193843,193845,0,2,1
55360,4,3,193847,193847,193850,0,3,2
55361,5,1,193852,193852,193853,0,1,2
55362,1,2,193853,193853,193855,0,2,0
55363,5,1,193858,193858,193859,0,1,3
55364,4,2,193862,193862,193864,0,2,3
55365,5,2,193867,193867,193869,0,2,3
55366,4,2,193871,193871,193873,0,2,2
55367,2,2,193873,193873,193875,0,2,0
55368,3,1,193876,193876,193877,0,1,1
55369,2,2,193878,193878,193880,0,2,1
55370,4,1,193882,193882,193883,0,1,2
55371,5,1,193887,193887,193888,0,1,4
55372,2,1,193889,193889,193890,0,1,1
55373,1,2,193890,193890,193892,0,2,0
55374,1,3,193891,193892,193895,1,4,0
55375,3,1,193894,193895,193896,1,2,0
55376,5,2,193899,193899,193901,0,2,3
55377,2,2,193901,193901,193903,0,2,0
55378,3,3,193904,193904,193907,0,3,1
55379,3,1,193907,193907,193908,0,1,0
55380,3,2,193910,193910,193912,0,2,2
55381,2,2,193912,193912,193914,0,2,0
55382,3,2,193915,193915,193917,0,2,1
55383,5,2,193920,193920,193922,0,2,3
55384,3,2,193923,193923,193925,0,2,1
55385,5,1,193928,193928,193929,0,1,3
55386,4,1,193932,193932,193933,0,1,3
55387,1,3,193933,193933,193936,0,3,0
55388,1,3,193934,193936,193939,2,5,0
55389,6,3,193940,193940,193943,0,3,1
55390,6,2,193946,193946,193948,0,2,3
55391,5,2,193951,193951,193953,0,2,3
55392,5,1,193956,193956,193957,0,1,3
55393,6,3,193962,193962,193965,0,3,5
55394,4,3,193966,193966,193969,0,3,1
55395,3,3,193969,193969,193972,0,3,0
55396,1,3,193970,193972,193975,2,5,0
55397,6,2,193976,193976,193978,0,2,1
55398,5,1,193981,193981,193982,0,1,3
55399,1,3,193982,193982,193985,0,3,0
55400,2,2,193984,193985,193987,1,3,0
55401,1,2,193985,193987,193989,2,4,0
55402,4,1,193989,193989,193990,0,1,0
55403,6,1,193995,193995,193996,0,1,5
55404,2,1,193997,193997,193998,0,1,1
55405,4,3,194001,194001,194004,0,3,3
55406,4,2,194005,194005,194007,0,2,1
55407,4,1,194009,194009,194010,0,1,2
55408,2,3,194011,194011,194014,0,3,1
55409,4,2,194015,194015,194017,0,2,1
55410,5,1,194020,194020,194021,0,1,3
55411,5,2,194025,194025,194027,0,2,4
55412,6,2,194031,194031,194033,0,2,4
55413,6,2,194037,194037,194039,0,2,4
55414,5,2,194042,194042,194044,0,2,3
55415,5,2,194047,194047,194049,0,2,3
55416,4,2,194051,194051,194053,0,2,2
55417,5,1,194056,194056,194057,0,1,3
55418,6,1,194062,194062,194063,0,1,5
55419,2,2,194064,194064,194066,0,2,1
55420,4,3,194068,194068,194071,0,3,2
55421,3,2,194071,194071,194073,0,2,0
55422,5,3,194076,194076,194079,0,3,3
55423,5,1,194081,194081,194082,0,1,2
55424,2,1,194083,194083,194084,0,1,1
55425,5,3,194088,194088,194091,0,3,4
55426,1,3,194089,194091,194094,2,5,0
55427,3,1,194092,194094,194095,2,3,0
55428,3,3,194095,194095,194098,0,3,0
55429,2,3,194097,194098,194101,1,4,0
55430,4,2,194101,194101,194103,0,2,0
55431,5,3,194106,194106,194109,0,3,3
55432,5,2,194111,194111,194113,0,2,2
55433,2,1,194113,194113,194114,0,1,0
55434,3,1,194116,194116,194117,0,1,2
55435,4,3,194120,194120,194123,0,3,3
55436,1,1,194121,194123,194124,2,3,0
55437,5,1,194126,194126,194127,0,1,2
55438,5,2,194131,194131,194133,0,2,4
55439,4,3,194135,194135,194138,0,3,2
55440,6,1,194141,194141,194142,0,1,3
55441,5,2,194146,194146,194148,0,2,4
55442,2,2,194148,194148,194150,0,2,0
55443,6,3,194154,194154,194157,0,3,4
55444,6,3,194160,194160,194163,0,3,3
55445,4,1,194164,194164,194165,0,1,1
55446,3,2,194167,194167,194169,0,2,2
55447,1,2,194168,194169,194171,1,3,0
55448,1,2,194169,194171,194173,2,4,0
55449,1,1,194170,194173,194174,3,4,0
55450,5,3,194175,194175,194178,0,3,1
55451,6,2,194181,194181,194183,0,2,3
55452,4,2,194185,194185,194187,0,2,2
55453,4,2,194189,194189,194191,0,2,2
55454,6,3,194195,194195,194198,0,3,4
55455,3,1,194198,194198,194199,0,1,0
55456,1,3,194199,194199,194202,0,3,0
55457,6,1,194205,194205,194206,0,1,3
55458,4,2,194209,194209,194211,0,2,3
55459,4,2,194213,194213,194215,0,2,2
55460,5,1,194218,194218,194219,0,1,3
55461,5,3,194223,194223,194226,0,3,4
55462,5,1,194228,194228,194229,0,1,2
55463,3,1,194231,194231,194232,0,1,2
55464,5,2,194236,194236,194238,0,2,4
55465,2,2,194238,194238,194240,0,2,0
55466,6,2,194244,194244,194246,0,2,4
55467,5,3,194249,194249,194252,0,3,3
55468,6,2,194255,194255,194257,0,2,3
55469,5,1,194260,194260,194261,0,1,3
55470,1,2,194261,194261,194263,0,2,0
55471,4,1,194265,194265,194266,0,1,2
55472,1,1,194266,194266,194267,0,1,0
55473,6,1,194272,194272,194273,0,1,5
55474,4,3,194276,194276,194279,0,3,3
55475,5,2,194281,194281,194283,0,2,2
55476,6,1,194287,194287,194288,0,1,4
55477,2,3,194289,194289,194292,0,3,1
55478,6,1,194295,194295,194296,0,1,3
55479,4,1,194299,194299,194300,0,1,3
55480,1,3,194300,194300,194303,0,3,0
55481,2,2,194302,194303,194305,1,3,0
55482,6,2,194308,194308,194310,0,2,3
55483,2,3,194310,194310,194313,0,3,0
55484,4,2,194314,194314,194316,0,2,1
55485,5,1,194319,194319,194320,0,1,3
55486,4,1,194323,194323,194324,0,1,3
55487,4,3,194327,194327,194330,0,3,3
55488,4,3,194331,194331,194334,0,3,1
55489,4,2,194335,194335,194337,0,2,1
55490,4,3,194339,194339,194342,0,3,2
55491,2,1,194341,194342,194343,1,2,0
55492,2,1,194343,194343,194344,0,1,0
55493,1,1,194344,194344,194345,0,1,0
55494,1,1,194345,194345,194346,0,1,0
55495,1,1,194346,194346,194347,0,1,0
55496,3,3,194349,194349,194352,0,3,2
55497,4,1,194353,194353,194354,0,1,1
55498,4,1,194357,194357,194358,0,1,3
55499,1,3,194358,194358,194361,0,3,0
55500,6,1,194364,194364,194365,0,1,3
55501,5,1,194369,194369,194370,0,1,4
55502,6,2,194375,194375,194377,0,2,5
55503,1,2,194376,194377,194379,1,3,0
55504,1,1,194377,194379,194380,2,3,0
55505,5,1,194382,194382,194383,0,1,2
55506,5,1,194387,194387,194388,0,1,4
55507,3,1,194390,194390,194391,0,1,2
55508,4,1,194394,194394,194395,0,1,3
55509,2,1,194396,194396,194397,0,1,1
55510,1,1,194397,194397,194398,0,1,0
55511,2,1,194399,194399,194400,0,1,1
55512,1,1,194400,194400,194401,0,1,0
55513,6,1,194406,194406,194407,0,1,5
55514,1,3,194407,194407,194410,0,3,0
55515,2,1,194409,194410,194411,1,2,0
55516,2,2,194411,194411,194413,0,2,0
55517,3,2,194414,194414,194416,0,2,1
55518,4,1,194418,194418,194419,0,1,2
55519,1,3,194419,194419,194422,0,3,0
55520,2,3,194421,194422,194425,1,4,0
55521,2,1,194423,194425,194426,2,3,0
55522,4,2,194427,194427,194429,0,2,1
55523,4,1,194431,194431,194432,0,1,2
55524,3,1,194434,194434,194435,0,1,2
55525,5,3,194439,194439,194442,0,3,4
55526,1,1,194440,194442,194443,2,3,0
55527,4,1,194444,194444,194445,0,1,1
55528,6,1,194450,194450,194451,0,1,5
55529,5,1,194455,194455,194456,0,1,4
55530,6,1,194461,194461,194462,0,1,5
55531,1,3,194462,194462,194465,0,3,0
55532,3,1,194465,194465,194466,0,1,0
55533,3,1,194468,194468,194469,0,1,2
55534,1,1,194469,194469,194470,0,1,0
55535,4,3,194473,194473,194476,0,3,3
55536,6,3,194479,194479,194482,0,3,3
55537,5,1,194484,194484,194485,0,1,2
55538,5,2,194489,194489,194491,0,2,4
55539,5,1,194494,194494,194495,0,1,3
55540,6,3,194500,194500,194503,0,3,5
55541,5,1,194505,194505,194506,0,1,2
55542,1,3,194506,194506,194509,0,3,0
55543,2,1,194508,194509,194510,1,2,0
55544,2,2,194510,194510,194512,0,2,0
55545,2,1,194512,194512,194513,0,1,0
55546,6,2,194518,194518,194520,0,2,5
55547,5,2,194523,194523,194525,0,2,3
55548,5,2,194528,194528,194530,0,2,3
55549,4,2,194532,194532,194534,0,2,2
55550,3,1,194535,194535,194536,0,1,1
55551,4,3,194539,194539,194542,0,3,3
55552,6,2,194545,194545,194547,0,2,3
55553,1,2,194546,194547,194549,1,3,0
55554,2,3,194548,194549,194552,1,4,0
55555,1,2,194549,194552,194554,3,5,0
55556,4,2,194553,194554,194556,1,3,0
55557,4,1,194557,194557,194558,0,1,1
55558,6,2,194563,194563,194565,0,2,5
55559,4,1,194567,194567,194568,0,1,2
55560,4,2,194571,194571,194573,0,2,3
55561,3,1,194574,194574,194575,0,1,1
55562,2,1,194576,194576,194577,0,1,1
55563,3,2,194579,194579,194581,0,2,2
55564,6,2,194585,194585,194587,0,2,4
55565,6,2,194591,194591,194593,0,2,4
55566,5,1,194596,194596,194597,0,1,3
55567,6,1,194602,194602,194603,0,1,5
55568,3,3,194605,194605,194608,0,3,2
55569,6,1,194611,194611,194612,0,1,3
55570,5,1,194616,194616,194617,0,1,4
55571,4,3,194620,194620,194623,0,3,3
55572,3,3,194623,194623,194626,0,3,0
55573,4,1,194627,194627,194628,0,1,1
55574,5,3,194632,194632,194635,0,3,4
55575,4,3,194636,194636,194639,0,3,1
55576,6,1,194642,194642,194643,0,1,3
55577,1,1,194643,194643,194644,0,1,0
55578,5,2,194648,194648,194650,0,2,4
55579,5,3,194653,194653,194656,0,3,3
55580,2,1,194655,194656,194657,1,2,0
55581,5,2,194660,194660,194662,0,2,3
55582,2,2,194662,194662,194664,0,2,0
55583,4,3,194666,194666,194669,0,3,2
55584,6,3,194672,194672,194675,0,3,3
55585,5,1,194677,194677,194678,0,1,2
55586,3,2,194680,194680,194682,0,2,2
55587,4,3,194684,194684,194687,0,3,2
55588,6,2,194690,194690,194692,0,2,3
55589,1,3,194691,194692,194695,1,4,0
55590,5,1,194696,194696,194697,0,1,1
55591,5,2,194701,194701,194703,0,2,4
55592,4,3,194705,194705,194708,0,3,2
55593,3,1,194708,194708,194709,0,1,0
55594,6,2,194714,194714,194716,0,2,5
55595,1,2,194715,194716,194718,1,3,0
55596,4,3,194719,194719,194722,0,3,1
55597,6,1,194725,194725,194726,0,1,3
55598,5,1,194730,194730,194731,0,1,4
55599,3,2,194733,194733,194735,0,2,2
55600,3,3,194736,194736,194739,0,3,1
55601,1,1,194737,194739,194740,2,3,0
55602,5,2,194742,194742,194744,0,2,2
55603,3,2,194745,194745,194747,0,2,1
55604,1,3,194746,194747,194750,1,4,0
55605,4,3,194750,194750,194753,0,3,0
55606,6,1,194756,194756,194757,0,1,3
55607,6,2,194762,194762,194764,0,2,5
55608,6,2,194768,194768,194770,0,2,4
55609,6,2,194774,194774,194776,0,2,4
55610,3,2,194777,194777,194779,0,2,1
55611,3,1,194780,194780,194781,0,1,1
55612,2,1,194782,194782,194783,0,1,1
55613,5,1,194787,194787,194788,0,1,4
55614,4,2,194791,194791,194793,0,2,3
55615,6,2,194797,194797,194799,0,2,4
55616,3,2,194800,194800,194802,0,2,1
55617,1,3,194801,194802,194805,1,4,0
55618,5,2,194806,194806,194808,0,2,1
55619,3,2,194809,194809,194811,0,2,1
55620,3,2,194812,194812,194814,0,2,1
55621,1,1,194813,194814,194815,1,2,0
55622,6,1,194819,194819,194820,0,1,4
55623,6,3,194825,194825,194828,0,3,5
55624,1,2,194826,194828,194830,2,4,0
55625,3,2,194829,194830,194832,1,3,0
55626,1,1,194830,194832,194833,2,3,0
55627,4,2,194834,194834,194836,0,2,1
55628,4,2,194838,194838,194840,0,2,2
55629,4,1,194842,194842,194843,0,1,2
55630,2,1,194844,194844,194845,0,1,1
55631,3,3,194847,194847,194850,0,3,2
55632,3,1,194850,194850,194851,0,1,0
55633,1,2,194851,194851,194853,0,2,0
55634,1,1,194852,194853,194854,1,2,0
55635,6,1,194858,194858,194859,0,1,4
55636,3,1,194861,194861,194862,0,1,2
55637,2,3,194863,194863,194866,0,3,1
55638,2,1,194865,194866,194867,1,2,0
55639,1,1,194866,194867,194868,1,2,0
55640,1,3,194867,194868,194871,1,4,0
55641,1,2,194868,194871,194873,3,5,0
55642,3,3,194871,194873,194876,2,5,0
55643,4,3,194875,194876,194879,1,4,0
55644,4,2,194879,194879,194881,0,2,0
55645,1,2,194880,194881,194883,1,3,0
55646,2,2,194882,194883,194885,1,3,0
55647,3,2,194885,194885,194887,0,2,0
55648,4,1,194889,194889,194890,0,1,2
55649,4,3,194893,194893,194896,0,3,3
55650,5,1,194898,194898,194899,0,1,2
55651,2,3,194900,194900,194903,0,3,1
55652,1,1,194901,194903,194904,2,3,0
55653,1,1,194902,194904,194905,2,3,0
55654,1,1,194903,194905,194906,2,3,0
55655,5,3,194908,194908,194911,0,3,2
55656,2,2,194910,194911,194913,1,3,0
55657,3,2,194913,194913,194915,0,2,0
55658,5,1,194918,194918,194919,0,1,3
55659,5,3,194923,194923,194926,0,3,4
55660,1,2,194924,194926,194928,2,4,0
55661,4,2,194928,194928,194930,0,2,0
55662,3,1,194931,194931,194932,0,1,1
55663,4,1,194935,194935,194936,0,1,3
55664,1,3,194936,194936,194939,0,3,0
55665,6,1,194942,194942,194943,0,1,3
55666,2,1,194944,194944,194945,0,1,1
55667,4,1,194948,194948,194949,0,1,3
55668,1,2,194949,194949,194951,0,2,0
55669,3,1,194952,194952,194953,0,1,1
55670,3,2,194955,194955,194957,0,2,2
55671,5,2,194960,194960,194962,0,2,3
55672,3,1,194963,194963,194964,0,1,1
55673,2,2,194965,194965,194967,0,2,1
55674,5,1,194970,194970,194971,0,1,3
55675,2,3,194972,194972,194975,0,3,1
55676,2,3,194974,194975,194978,1,4,0
55677,5,2,194979,194979,194981,0,2,1
55678,6,2,194985,194985,194987,0,2,4
55679,4,1,194989,194989,194990,0,1,2
55680,4,3,194993,194993,194996,0,3,3
55681,4,2,194997,194997,194999,0,2,1
55682,2,2,194999,194999,195001,0,2,0
55683,4,2,195003,195003,195005,0,2,2
55684,1,2,195004,195005,195007,1,3,0
55685,1,2,195005,195007,195009,2,4,0
55686,6,3,195011,195011,195014,0,3,2
55687,4,2,195015,195015,195017,0,2,1
55688,1,2,195016,195017,195019,1,3,0
55689,5,1,195021,195021,195022,0,1,2
55690,4,3,195025,195025,195028,0,3,3
55691,1,2,195026,195028,195030,2,4,0
55692,2,1,195028,195030,195031,2,3,0
55693,5,2,195033,195033,195035,0,2,2
55694,4,3,195037,195037,195040,0,3,2
55695,6,3,195043,195043,195046,0,3,3
55696,6,3,195049,195049,195052,0,3,3
55697,3,2,195052,195052,195054,0,2,0
55698,6,1,195058,195058,195059,0,1,4
55699,5,2,195063,195063,195065,0,2,4
55700,1,2,195064,195065,195067,1,3,0
55701,1,1,195065,195067,195068,2,3,0
55702,5,3,195070,195070,195073,0,3,2
55703,5,3,195075,195075,195078,0,3,2
55704,6,3,195081,195081,195084,0,3,3
55705,1,3,195082,195084,195087,2,5,0
55706,3,2,195085,195087,195089,2,4,0
55707,1,1,195086,195089,195090,3,4,0
55708,6,2,195092,195092,195094,0,2,2
55709,5,2,195097,195097,195099,0,2,3
55710,5,1,195102,195102,195103,0,1,3
55711,4,1,195106,195106,195107,0,1,3
55712,1,2,195107,195107,195109,0,2,0
55713,2,3,195109,195109,195112,0,3,0
55714,1,1,195110,195112,195113,2,3,0
55715,6,3,195116,195116,195119,0,3,3
55716,5,3,195121,195121,195124,0,3,2
55717,4,1,195125,195125,195126,0,1,1
55718,4,3,195129,195129,195132,0,3,3
55719,5,3,195134,195134,195137,0,3,2
55720,5,2,195139,195139,195141,0,2,2
55721,2,3,195141,195141,195144,0,3,0
55722,5,3,195146,195146,195149,0,3,2
55723,1,2,195147,195149,195151,2,4,0
55724,2,2,195149,195151,195153,2,4,0
55725,2,3,195151,195153,195156,2,5,0
55726,4,3,195155,195156,195159,1,4,0
55727,1,3,195156,195159,195162,3,6,0
55728,5,2,195161,195162,195164,1,3,0
55729,2,3,195163,195164,195167,1,4,0
55730,1,3,195164,195167,195170,3,6,0
55731,5,2,195169,195170,195172,1,3,0
55732,2,1,195171,195172,195173,1,2,0
55733,1,2,195172,195173,195175,1,3,0
55734,5,3,195177,195177,195180,0,3,2
55735,1,1,195178,195180,195181,2,3,0
55736,2,2,195180,195181,195183,1,3,0
55737,3,2,195183,195183,195185,0,2,0
55738,2,3,195185,195185,195188,0,3,0
55739,5,3,195190,195190,195193,0,3,2
55740,1,2,195191,195193,195195,2,4,0
55741,1,2,195192,195195,195197,3,5,0
55742,4,2,195196,195197,195199,1,3,0
55743,2,1,195198,195199,195200,1,2,0
55744,3,2,195201,195201,195203,0,2,1
55745,1,3,195202,195203,195206,1,4,0
55746,2,2,195204,195206,195208,2,4,0
55747,6,2,195210,195210,195212,0,2,2
55748,3,2,195213,195213,195215,0,2,1
55749,2,2,195215,195215,195217,0,2,0
55750,5,3,195220,195220,195223,0,3,3
55751,6,1,195226,195226,195227,0,1,3
55752,1,1,195227,195227,195228,0,1,0
55753,3,1,195230,195230,195231,0,1,2
55754,6,3,195236,195236,195239,0,3,5
55755,2,2,195238,195239,195241,1,3,0
55756,1,2,195239,195241,195243,2,4,0
55757,2,2,195241,195243,195245,2,4,0
55758,2,1,195243,195245,195246,2,3,0
55759,2,1,195245,195246,195247,1,2,0
55760,2,1,195247,195247,195248,0,1,0
55761,2,2,195249,195249,195251,0,2,1
55762,6,1,195255,195255,195256,0,1,4
55763,2,1,195257,195257,195258,0,1,1
55764,6,3,195263,195263,195266,0,3,5
55765,4,2,195267,195267,195269,0,2,1
55766,3,3,195270,195270,195273,0,3,1
55767,4,3,195274,195274,195277,0,3,1
55768,5,1,195279,195279,195280,0,1,2
55769,5,2,195284,195284,195286,0,2,4
55770,6,2,195290,195290,195292,0,2,4
55771,1,2,195291,195292,195294,1,3,0
55772,1,3,195292,195294,195297,2,5,0
55773,6,2,195298,195298,195300,0,2,1
55774,5,3,195303,195303,195306,0,3,3
55775,2,1,195305,195306,195307,1,2,0
55776,6,3,195311,195311,195314,0,3,4
55777,2,1,195313,195314,195315,1,2,0
55778,5,1,195318,195318,195319,0,1,3
55779,2,1,195320,195320,195321,0,1,1
55780,5,1,195325,195325,195326,0,1,4
55781,6,1,195331,195331,195332,0,1,5
55782,2,1,195333,195333,195334,0,1,1
55783,4,1,195337,195337,195338,0,1,3
55784,4,1,195341,195341,195342,0,1,3
55785,2,1,195343,195343,195344,0,1,1
55786,3,2,195346,195346,195348,0,2,2
55787,2,2,195348,195348,195350,0,2,0
55788,6,2,195354,195354,195356,0,2,4
55789,2,3,195356,195356,195359,0,3,0
55790,4,1,195360,195360,195361,0,1,1
55791,6,3,195366,195366,195369,0,3,5
55792,6,3,195372,195372,195375,0,3,3
55793,5,3,195377,195377,195380,0,3,2
55794,3,2,195380,195380,195382,0,2,0
55795,2,2,195382,195382,195384,0,2,0
55796,1,1,195383,195384,195385,1,2,0
55797,4,3,195387,195387,195390,0,3,2
55798,4,2,195391,195391,195393,0,2,1
55799,4,1,195395,195395,195396,0,1,2
55800,4,2,195399,195399,195401,0,2,3
55801,2,2,195401,195401,195403,0,2,0
55802,5,2,195406,195406,195408,0,2,3
55803,2,3,195408,195408,195411,0,3,0
55804,1,1,195409,195411,195412,2,3,0
55805,3,1,195412,195412,195413,0,1,0
55806,3,2,195415,195415,195417,0,2,2
55807,3,3,195418,195418,195421,0,3,1
55808,6,3,195424,195424,195427,0,3,3
55809,3,3,195427,195427,195430,0,3,0
55810,6,2,195433,195433,195435,0,2,3
55811,6,3,195439,195439,195442,0,3,4
55812,6,1,195445,195445,195446,0,1,3
55813,5,2,195450,195450,195452,0,2,4
55814,2,1,195452,195452,195453,0,1,0
55815,5,3,195457,195457,195460,0,3,4
55816,6,2,195463,195463,195465,0,2,3
55817,2,2,195465,195465,195467,0,2,0
55818,5,2,195470,195470,195472,0,2,3
55819,3,2,195473,195473,195475,0,2,1
55820,4,3,195477,195477,195480,0,3,2
55821,4,3,195481,195481,195484,0,3,1
55822,1,2,195482,195484,195486,2,4,0
55823,4,2,195486,195486,195488,0,2,0
55824,1,1,195487,195488,195489,1,2,0
55825,2,1,195489,195489,195490,0,1,0
55826,2,1,195491,195491,195492,0,1,1
55827,6,1,195497,195497,195498,0,1,5
55828,5,3,195502,195502,195505,0,3,4
55829,4,3,195506,195506,195509,0,3,1
55830,1,1,195507,195509,195510,2,3,0
55831,1,3,195508,195510,195513,2,5,0
55832,5,2,195513,195513,195515,0,2,0
55833,4,2,195517,195517,195519,0,2,2
55834,3,1,195520,195520,195521,0,1,1
55835,5,1,195525,195525,195526,0,1,4
55836,1,2,195526,195526,195528,0,2,0
55837,4,2,195530,195530,195532,0,2,2
55838,6,3,195536,195536,195539,0,3,4
55839,4,3,195540,195540,195543,0,3,1
55840,6,3,195546,195546,195549,0,3,3
55841,1,2,195547,195549,195551,2,4,0
55842,3,1,195550,195551,195552,1,2,0
55843,1,3,195551,195552,195555,1,4,0
55844,4,1,195555,195555,195556,0,1,0
55845,4,2,195559,195559,195561,0,2,3
55846,5,3,195564,195564,195567,0,3,3
55847,5,3,195569,195569,195572,0,3,2
55848,3,3,195572,195572,195575,0,3,0
55849,1,1,195573,195575,195576,2,3,0
55850,2,1,195575,195576,195577,1,2,0
55851,4,3,195579,195579,195582,0,3,2
55852,1,3,195580,195582,195585,2,5,0
55853,6,3,195586,195586,195589,0,3,1
55854,1,2,195587,195589,195591,2,4,0
55855,3,3,195590,195591,195594,1,4,0
55856,4,1,195594,195594,195595,0,1,0
55857,5,1,195599,195599,195600,0,1,4
55858,5,3,195604,195604,195607,0,3,4
55859,3,3,195607,195607,195610,0,3,0
55860,5,3,195612,195612,195615,0,3,2
55861,5,2,195617,195617,195619,0,2,2
55862,1,2,195618,195619,195621,1,3,0
55863,2,1,195620,195621,195622,1,2,0
55864,1,3,195621,195622,195625,1,4,0
55865,6,2,195627,195627,195629,0,2,2
55866,6,2,195633,195633,195635,0,2,4
55867,1,3,195634,195635,195638,1,4,0
55868,1,2,195635,195638,195640,3,5,0
55869,2,2,195637,195640,195642,3,5,0
55870,3,1,195640,195642,195643,2,3,0
55871,3,3,195643,195643,195646,0,3,0
55872,6,2,195649,195649,195651,0,2,3
55873,3,1,195652,195652,195653,0,1,1
55874,2,1,195654,195654,195655,0,1,1
55875,5,1,195659,195659,195660,0,1,4
55876,2,2,195661,195661,195663,0,2,1
55877,3,3,195664,195664,195667,0,3,1
55878,4,1,195668,195668,195669,0,1,1
55879,6,3,195674,195674,195677,0,3,5
55880,5,3,195679,195679,195682,0,3,2
55881,4,1,195683,195683,195684,0,1,1
55882,5,2,195688,195688,195690,0,2,4
55883,6,1,195694,195694,195695,0,1,4
55884,5,2,195699,195699,195701,0,2,4
55885,4,2,195703,195703,195705,0,2,2
55886,1,1,195704,195705,195706,1,2,0
55887,2,3,195706,195706,195709,0,3,0
55888,3,2,195709,195709,195711,0,2,0
55889,3,1,195712,195712,195713,0,1,1
55890,2,3,195714,195714,195717,0,3,1
55891,2,2,195716,195717,195719,1,3,0
55892,3,2,195719,195719,195721,0,2,0
55893,6,2,195725,195725,195727,0,2,4
55894,3,2,195728,195728,195730,0,2,1
55895,5,2,195733,195733,195735,0,2,3
55896,1,2,195734,195735,195737,1,3,0
55897,4,1,195738,195738,195739,0,1,1
55898,3,2,195741,195741,195743,0,2,2
55899,3,3,195744,195744,195747,0,3,1
55900,5,2,195749,195749,195751,0,2,2
55901,1,2,195750,195751,195753,1,3,0
55902,1,3,195751,195753,195756,2,5,0
55903,6,2,195757,195757,195759,0,2,1
55904,2,1,195759,195759,195760,0,1,0
55905,6,1,195765,195765,195766,0,1,5
55906,6,2,195771,195771,195773,0,2,5
55907,5,3,195776,195776,195779,0,3,3
55908,4,2,195780,195780,195782,0,2,1
55909,4,2,195784,195784,195786,0,2,2
55910,6,1,195790,195790,195791,0,1,4
55911,6,2,195796,195796,195798,0,2,5
55912,5,3,195801,195801,195804,0,3,3
55913,5,2,195806,195806,195808,0,2,2
55914,1,2,195807,195808,195810,1,3,0
55915,3,3,195810,195810,195813,0,3,0
55916,4,1,195814,195814,195815,0,1,1
55917,2,2,195816,195816,195818,0,2,1
55918,3,2,195819,195819,195821,0,2,1
55919,1,2,195820,195821,195823,1,3,0
55920,6,3,195826,195826,195829,0,3,3
55921,5,3,195831,195831,195834,0,3,2
55922,4,1,195835,195835,195836,0,1,1
55923,6,3,195841,195841,195844,0,3,5
55924,6,3,195847,195847,195850,0,3,3
55925,1,3,195848,195850,195853,2,5,0
55926,6,1,195854,195854,195855,0,1,1
55927,1,2,195855,195855,195857,0,2,0
55928,3,1,195858,195858,195859,0,1,1
55929,4,3,195862,195862,195865,0,3,3
55930,4,3,195866,195866,195869,0,3,1
55931,4,2,195870,195870,195872,0,2,1
55932,4,3,195874,195874,195877,0,3,2
55933,3,2,195877,195877,195879,0,2,0
55934,4,3,195881,195881,195884,0,3,2
55935,6,1,195887,195887,195888,0,1,3
55936,5,1,195892,195892,195893,0,1,4
55937,5,3,195897,195897,195900,0,3,4
55938,6,1,195903,195903,195904,0,1,3
55939,4,1,195907,195907,195908,0,1,3
55940,3,2,195910,195910,195912,0,2,2
55941,1,1,195911,195912,195913,1,2,0
55942,2,1,195913,195913,195914,0,1,0
55943,1,3,195914,195914,195917,0,3,0
55944,2,1,195916,195917,195918,1,2,0
55945,1,3,195917,195918,195921,1,4,0
55946,2,3,195919,195921,195924,2,5,0
55947,1,2,195920,195924,195926,4,6,0
55948,4,1,195924,195926,195927,2,3,0
55949,5,2,195929,195929,195931,0,2,2
55950,6,2,195935,195935,195937,0,2,4
55951,4,1,195939,195939,195940,0,1,2
55952,3,2,195942,195942,195944,0,2,2
55953,1,1,195943,195944,195945,1,2,0
55954,6,1,195949,195949,195950,0,1,4
55955,1,1,195950,195950,195951,0,1,0
55956,5,1,195955,195955,195956,0,1,4
55957,3,2,195958,195958,195960,0,2,2
55958,1,3,195959,195960,195963,1,4,0
55959,3,1,195962,195963,195964,1,2,0
55960,4,2,195966,195966,195968,0,2,2
55961,5,2,195971,195971,195973,0,2,3
55962,3,3,195974,195974,195977,0,3,1
55963,6,1,195980,195980,195981,0,1,3
55964,4,2,195984,195984,195986,0,2,3
55965,4,2,195988,195988,195990,0,2,2
55966,1,1,195989,195990,195991,1,2,0
55967,2,1,195991,195991,195992,0,1,0
55968,4,2,195995,195995,195997,0,2,3
55969,2,3,195997,195997,196000,0,3,0
55970,1,1,195998,196000,196001,2,3,0
55971,4,2,196002,196002,196004,0,2,1
55972,1,1,196003,196004,196005,1,2,0
55973,4,2,196007,196007,196009,0,2,2
55974,6,1,196013,196013,196014,0,1,4
55975,1,2,196014,196014,196016,0,2,0
55976,5,2,196019,196019,196021,0,2,3
55977,3,2,196022,196022,196024,0,2,1
55978,2,2,196024,196024,196026,0,2,0
55979,5,3,196029,196029,196032,0,3,3
55980,2,2,196031,196032,196034,1,3,0
55981,5,2,196036,196036,196038,0,2,2
55982,1,1,196037,196038,196039,1,2,0
55983,6,1,196043,196043,196044,0,1,4
55984,3,1,196046,196046,196047,0,1,2
55985,4,3,196050,196050,196053,0,3,3
55986,1,1,196051,196053,196054,2,3,0
55987,1,2,196052,196054,196056,2,4,0
55988,4,1,196056,196056,196057,0,1,0
55989,4,2,196060,196060,196062,0,2,3
55990,5,1,196065,196065,196066,0,1,3
55991,6,2,196071,196071,196073,0,2,5
55992,5,2,196076,196076,196078,0,2,3
55993,1,3,196077,196078,196081,1,4,0
55994,4,2,196081,196081,196083,0,2,0
55995,5,1,196086,196086,196087,0,1,3
55996,2,3,196088,196088,196091,0,3,1
55997,1,3,196089,196091,196094,2,5,0
55998,4,1,196093,196094,196095,1,2,0
55999,3,1,196096,196096,196097,0,1,1
56000,4,2,196100,196100,196102,0,2,3
56001,1,2,196101,196102,196104,1,3,0
56002,1,2,196102,196104,196106,2,4,0
56003,5,2,196107,196107,196109,0,2,1
56004,6,1,196113,196113,196114,0,1,4
56005,5,1,196118,196118,196119,0,1,4
56006,1,1,196119,196119,196120,0,1,0
56007,3,1,196122,196122,196123,0,1,2
56008,3,3,196125,196125,196128,0,3,2
56009,2,2,196127,196128,196130,1,3,0
56010,4,1,196131,196131,196132,0,1,1
56011,3,2,196134,196134,196136,0,2,2
56012,5,3,196139,196139,196142,0,3,3
56013,5,1,196144,196144,196145,0,1,2
56014,2,1,196146,196146,196147,0,1,1
56015,2,3,196148,196148,196151,0,3,1
56016,5,1,196153,196153,196154,0,1,2
56017,1,3,196154,196154,196157,0,3,0
56018,4,3,196158,196158,196161,0,3,1
56019,4,1,196162,196162,196163,0,1,1
56020,2,1,196164,196164,196165,0,1,1
56021,4,3,196168,196168,196171,0,3,3
56022,4,1,196172,196172,196173,0,1,1
56023,6,2,196178,196178,196180,0,2,5
56024,3,3,196181,196181,196184,0,3,1
56025,2,1,196183,196184,196185,1,2,0
56026,5,1,196188,196188,196189,0,1,3
56027,6,1,196194,196194,196195,0,1,5
56028,5,3,196199,196199,196202,0,3,4
56029,6,2,196205,196205,196207,0,2,3
56030,2,1,196207,196207,196208,0,1,0
56031,6,1,196213,196213,196214,0,1,5
56032,2,2,196215,196215,196217,0,2,1
56033,1,2,196216,196217,196219,1,3,0
56034,2,1,196218,196219,196220,1,2,0
56035,1,3,196219,196220,196223,1,4,0
56036,6,1,196225,196225,196226,0,1,2
56037,6,2,196231,196231,196233,0,2,5
56038,5,1,196236,196236,196237,0,1,3
56039,5,1,196241,196241,196242,0,1,4
56040,1,2,196242,196242,196244,0,2,0
56041,2,1,196244,196244,196245,0,1,0
56042,3,3,196247,196247,196250,0,3,2
56043,6,1,196253,196253,196254,0,1,3
56044,4,1,196257,196257,196258,0,1,3
56045,3,2,196260,196260,196262,0,2,2
56046,2,3,196262,196262,196265,0,3,0
56047,6,2,196268,196268,196270,0,2,3
56048,6,2,196274,196274,196276,0,2,4
56049,1,2,196275,196276,196278,1,3,0
56050,3,2,196278,196278,196280,0,2,0
56051,2,1,196280,196280,196281,0,1,0
56052,6,2,196286,196286,196288,0,2,5
56053,3,3,196289,196289,196292,0,3,1
56054,4,1,196293,196293,196294,0,1,1
56055,1,2,196294,196294,196296,0,2,0
56056,5,2,196299,196299,196301,0,2,3
56057,1,1,196300,196301,196302,1,2,0
56058,1,1,196301,196302,196303,1,2,0
56059,2,3,196303,196303,196306,0,3,0
56060,1,3,196304,196306,196309,2,5,0
56061,1,2,196305,196309,196311,4,6,0
56062,6,3,196311,196311,196314,0,3,0
56063,4,1,196315,196315,196316,0,1,1
56064,4,2,196319,196319,196321,0,2,3
56065,1,2,196320,196321,196323,1,3,0
56066,4,2,196324,196324,196326,0,2,1
56067,4,3,196328,196328,196331,0,3,2
56068,1,1,196329,196331,196332,2,3,0
56069,5,3,196334,196334,196337,0,3,2
56070,5,3,196339,196339,196342,0,3,2
56071,3,3,196342,196342,196345,0,3,0
56072,1,1,196343,196345,196346,2,3,0
56073,4,1,196347,196347,196348,0,1,1
56074,5,3,196352,196352,196355,0,3,4
56075,5,2,196357,196357,196359,0,2,2
56076,4,3,196361,196361,196364,0,3,2
56077,4,3,196365,196365,196368,0,3,1
56078,5,1,196370,196370,196371,0,1,2
56079,4,3,196374,196374,196377,0,3,3
56080,3,3,196377,196377,196380,0,3,0
56081,5,3,196382,196382,196385,0,3,2
56082,2,1,196384,196385,196386,1,2,0
56083,1,1,196385,196386,196387,1,2,0
56084,5,1,196390,196390,196391,0,1,3
56085,4,2,196394,196394,196396,0,2,3
56086,5,3,196399,196399,196402,0,3,3
56087,6,3,196405,196405,196408,0,3,3
56088,6,2,196411,196411,196413,0,2,3
56089,6,2,196417,196417,196419,0,2,4
56090,6,3,196423,196423,196426,0,3,4
56091,2,2,196425,196426,196428,1,3,0
56092,2,2,196427,196428,196430,1,3,0
56093,2,3,196429,196430,196433,1,4,0
56094,2,2,196431,196433,196435,2,4,0
56095,1,3,196432,196435,196438,3,6,0
56096,4,1,196436,196438,196439,2,3,0
56097,2,3,196438,196439,196442,1,4,0
56098,3,3,196441,196442,196445,1,4,0
56099,5,1,196446,196446,196447,0,1,1
56100,4,1,196450,196450,196451,0,1,3
56101,3,2,196453,196453,196455,0,2,2
56102,4,2,196457,196457,196459,0,2,2
56103,6,2,196463,196463,196465,0,2,4
56104,4,1,196467,196467,196468,0,1,2
56105,2,1,196469,196469,196470,0,1,1
56106,1,3,196470,196470,196473,0,3,0
56107,3,1,196473,196473,196474,0,1,0
56108,6,3,196479,196479,196482,0,3,5
56109,2,3,196481,196482,196485,1,4,0
56110,3,1,196484,196485,196486,1,2,0
56111,4,1,196488,196488,196489,0,1,2
56112,4,3,196492,196492,196495,0,3,3
56113,4,1,196496,196496,196497,0,1,1
56114,1,2,196497,196497,196499,0,2,0
56115,1,3,196498,196499,196502,1,4,0
56116,2,3,196500,196502,196505,2,5,0
56117,5,3,196505,196505,196508,0,3,0
56118,2,1,196507,196508,196509,1,2,0
56119,6,3,196513,196513,196516,0,3,4
56120,5,3,196518,196518,196521,0,3,2
56121,6,2,196524,196524,196526,0,2,3
56122,5,3,196529,196529,196532,0,3,3
56123,6,3,196535,196535,196538,0,3,3
56124,2,2,196537,196538,196540,1,3,0
56125,1,3,196538,196540,196543,2,5,0
56126,3,1,196541,196543,196544,2,3,0
56127,5,1,196546,196546,196547,0,1,2
56128,5,1,196551,196551,196552,0,1,4
56129,3,2,196554,196554,196556,0,2,2
56130,5,2,196559,196559,196561,0,2,3
56131,5,3,196564,196564,196567,0,3,3
56132,2,1,196566,196567,196568,1,2,0
56133,3,1,196569,196569,196570,0,1,1
56134,2,2,196571,196571,196573,0,2,1
56135,6,2,196577,196577,196579,0,2,4
56136,5,1,196582,196582,196583,0,1,3
56137,5,3,196587,196587,196590,0,3,4
56138,1,1,196588,196590,196591,2,3,0
56139,5,1,196593,196593,196594,0,1,2
56140,1,3,196594,196594,196597,0,3,0
56141,5,3,196599,196599,196602,0,3,2
56142,5,2,196604,196604,196606,0,2,2
56143,5,2,196609,196609,196611,0,2,3
56144,4,2,196613,196613,196615,0,2,2
56145,2,3,196615,196615,196618,0,3,0
56146,2,2,196617,196618,196620,1,3,0
56147,1,3,196618,196620,196623,2,5,0
56148,4,1,196622,196623,196624,1,2,0
56149,4,1,196626,196626,196627,0,1,2
56150,5,1,196631,196631,196632,0,1,4
56151,3,3,196634,196634,196637,0,3,2
56152,3,3,196637,196637,196640,0,3,0
56153,2,3,196639,196640,196643,1,4,0
56154,6,3,196645,196645,196648,0,3,2
56155,1,3,196646,196648,196651,2,5,0
56156,2,2,196648,196651,196653,3,5,0
56157,6,2,196654,196654,196656,0,2,1
56158,1,1,196655,196656,196657,1,2,0
56159,4,1,196659,196659,196660,0,1,2
56160,6,3,196665,196665,196668,0,3,5
56161,3,1,196668,196668,196669,0,1,0
56162,5,1,196673,196673,196674,0,1,4
56163,4,3,196677,196677,196680,0,3,3
56164,4,1,196681,196681,196682,0,1,1
56165,6,3,196687,196687,196690,0,3,5
56166,2,2,196689,196690,196692,1,3,0
56167,4,2,196693,196693,196695,0,2,1
56168,1,1,196694,196695,196696,1,2,0
56169,3,1,196697,196697,196698,0,1,1
56170,5,2,196702,196702,196704,0,2,4
56171,5,1,196707,196707,196708,0,1,3
56172,2,3,196709,196709,196712,0,3,1
56173,2,2,196711,196712,196714,1,3,0
56174,2,3,196713,196714,196717,1,4,0
56175,2,1,196715,196717,196718,2,3,0
56176,1,1,196716,196718,196719,2,3,0
56177,2,3,196718,196719,196722,1,4,0
56178,6,2,196724,196724,196726,0,2,2
56179,2,2,196726,196726,196728,0,2,0
56180,6,2,196732,196732,196734,0,2,4
56181,5,3,196737,196737,196740,0,3,3
56182,5,2,196742,196742,196744,0,2,2
56183,5,3,196747,196747,196750,0,3,3
56184,5,2,196752,196752,196754,0,2,2
56185,2,3,196754,196754,196757,0,3,0
56186,2,1,196756,196757,196758,1,2,0
56187,5,3,196761,196761,196764,0,3,3
56188,3,1,196764,196764,196765,0,1,0
56189,1,3,196765,196765,196768,0,3,0
56190,3,2,196768,196768,196770,0,2,0
56191,5,1,196773,196773,196774,0,1,3
56192,6,1,196779,196779,196780,0,1,5
56193,4,1,196783,196783,196784,0,1,3
56194,6,2,196789,196789,196791,0,2,5
56195,4,2,196793,196793,196795,0,2,2
56196,6,2,196799,196799,196801,0,2,4
56197,4,2,196803,196803,196805,0,2,2
56198,3,1,196806,196806,196807,0,1,1
56199,2,1,196808,196808,196809,0,1,1
56200,6,1,196814,196814,196815,0,1,5
56201,4,1,196818,196818,196819,0,1,3
56202,5,2,196823,196823,196825,0,2,4
56203,5,1,196828,196828,196829,0,1,3
56204,2,2,196830,196830,196832,0,2,1
56205,3,2,196833,196833,196835,0,2,1
56206,5,2,196838,196838,196840,0,2,3
56207,2,2,196840,196840,196842,0,2,0
56208,1,3,196841,196842,196845,1,4,0
56209,4,2,196845,196845,196847,0,2,0
56210,3,1,196848,196848,196849,0,1,1
56211,5,3,196853,196853,196856,0,3,4
56212,4,1,196857,196857,196858,0,1,1
56213,1,3,196858,196858,196861,0,3,0
56214,6,3,196864,196864,196867,0,3,3
56215,4,2,196868,196868,196870,0,2,1
56216,4,3,196872,196872,196875,0,3,2
56217,3,1,196875,196875,196876,0,1,0
56218,1,3,196876,196876,196879,0,3,0
56219,5,2,196881,196881,196883,0,2,2
56220,4,2,196885,196885,196887,0,2,2
56221,2,1,196887,196887,196888,0,1,0
56222,4,2,196891,196891,196893,0,2,3
56223,4,3,196895,196895,196898,0,3,2
56224,6,2,196901,196901,196903,0,2,3
56225,1,1,196902,196903,196904,1,2,0
56226,4,1,196906,196906,196907,0,1,2
56227,2,3,196908,196908,196911,0,3,1
56228,4,1,196912,196912,196913,0,1,1
56229,2,3,196914,196914,196917,0,3,1
56230,1,3,196915,196917,196920,2,5,0
56231,2,1,196917,196920,196921,3,4,0
56232,2,2,196919,196921,196923,2,4,0
56233,6,1,196925,196925,196926,0,1,2
56234,3,1,196928,196928,196929,0,1,2
56235,1,1,196929,196929,196930,0,1,0
56236,2,3,196931,196931,196934,0,3,1
56237,5,2,196936,196936,196938,0,2,2
56238,5,3,196941,196941,196944,0,3,3
56239,5,1,196946,196946,196947,0,1,2
56240,3,3,196949,196949,196952,0,3,2
56241,6,3,196955,196955,196958,0,3,3
56242,6,1,196961,196961,196962,0,1,3
56243,6,2,196967,196967,196969,0,2,5
56244,5,3,196972,196972,196975,0,3,3
56245,3,1,196975,196975,196976,0,1,0
56246,2,2,196977,196977,196979,0,2,1
56247,6,2,196983,196983,196985,0,2,4
56248,3,1,196986,196986,196987,0,1,1
56249,6,2,196992,196992,196994,0,2,5
56250,4,2,196996,196996,196998,0,2,2
56251,5,1,197001,197001,197002,0,1,3
56252,5,3,197006,197006,197009,0,3,4
56253,2,2,197008,197009,197011,1,3,0
56254,3,1,197011,197011,197012,0,1,0
56255,2,3,197013,197013,197016,0,3,1
56256,3,3,197016,197016,197019,0,3,0
56257,5,1,197021,197021,197022,0,1,2
56258,4,2,197025,197025,197027,0,2,3
56259,4,1,197029,197029,197030,0,1,2
56260,4,2,197033,197033,197035,0,2,3
56261,1,2,197034,197035,197037,1,3,0
56262,4,1,197038,197038,197039,0,1,1
56263,5,1,197043,197043,197044,0,1,4
56264,4,3,197047,197047,197050,0,3,3
56265,1,3,197048,197050,197053,2,5,0
56266,3,1,197051,197053,197054,2,3,0
56267,2,3,197053,197054,197057,1,4,0
56268,2,3,197055,197057,197060,2,5,0
56269,4,2,197059,197060,197062,1,3,0
56270,1,3,197060,197062,197065,2,5,0
56271,1,2,197061,197065,197067,4,6,0
56272,1,1,197062,197067,197068,5,6,0
56273,4,3,197066,197068,197071,2,5,0
56274,1,3,197067,197071,197074,4,7,0
56275,6,1,197073,197074,197075,1,2,0
56276,2,3,197075,197075,197078,0,3,0
56277,6,1,197081,197081,197082,0,1,3
56278,4,1,197085,197085,197086,0,1,3
56279,3,1,197088,197088,197089,0,1,2
56280,1,2,197089,197089,197091,0,2,0
56281,2,1,197091,197091,197092,0,1,0
56282,3,1,197094,197094,197095,0,1,2
56283,3,2,197097,197097,197099,0,2,2
56284,5,1,197102,197102,197103,0,1,3
56285,6,2,197108,197108,197110,0,2,5
56286,6,1,197114,197114,197115,0,1,4
56287,3,3,197117,197117,197120,0,3,2
56288,3,1,197120,197120,197121,0,1,0
56289,6,3,197126,197126,197129,0,3,5
56290,3,2,197129,197129,197131,0,2,0
56291,4,1,197133,197133,197134,0,1,2
56292,6,2,197139,197139,197141,0,2,5
56293,4,1,197143,197143,197144,0,1,2
56294,6,1,197149,197149,197150,0,1,5
56295,6,1,197155,197155,197156,0,1,5
56296,6,3,197161,197161,197164,0,3,5
56297,1,2,197162,197164,197166,2,4,0
56298,5,2,197167,197167,197169,0,2,1
56299,6,2,197173,197173,197175,0,2,4
56300,6,1,197179,197179,197180,0,1,4
56301,3,3,197182,197182,197185,0,3,2
56302,6,2,197188,197188,197190,0,2,3
56303,6,2,197194,197194,197196,0,2,4
56304,3,3,197197,197197,197200,0,3,1
56305,1,3,197198,197200,197203,2,5,0
56306,6,3,197204,197204,197207,0,3,1
56307,1,2,197205,197207,197209,2,4,0
56308,4,3,197209,197209,197212,0,3,0
56309,1,1,197210,197212,197213,2,3,0
56310,5,3,197215,197215,197218,0,3,2
56311,1,1,197216,197218,197219,2,3,0
56312,1,1,197217,197219,197220,2,3,0
56313,5,3,197222,197222,197225,0,3,2
56314,4,3,197226,197226,197229,0,3,1
56315,2,1,197228,197229,197230,1,2,0
56316,5,1,197233,197233,197234,0,1,3
56317,1,2,197234,197234,197236,0,2,0
56318,4,3,197238,197238,197241,0,3,2
56319,4,1,197242,197242,197243,0,1,1
56320,6,2,197248,197248,197250,0,2,5
56321,3,2,197251,197251,197253,0,2,1
56322,5,2,197256,197256,197258,0,2,3
56323,1,1,197257,197258,197259,1,2,0
56324,4,3,197261,197261,197264,0,3,2
56325,4,3,197265,197265,197268,0,3,1
56326,6,2,197271,197271,197273,0,2,3
56327,2,3,197273,197273,197276,0,3,0
56328,3,2,197276,197276,197278,0,2,0
56329,6,1,197282,197282,197283,0,1,4
56330,3,1,197285,197285,197286,0,1,2
56331,5,3,197290,197290,197293,0,3,4
56332,2,1,197292,197293,197294,1,2,0
56333,5,2,197297,197297,197299,0,2,3
56334,4,1,197301,197301,197302,0,1,2
56335,1,1,197302,197302,197303,0,1,0
56336,2,1,197304,197304,197305,0,1,1
56337,3,1,197307,197307,197308,0,1,2
56338,5,1,197312,197312,197313,0,1,4
56339,3,1,197315,197315,197316,0,1,2
56340,2,3,197317,197317,197320,0,3,1
56341,6,3,197323,197323,197326,0,3,3
56342,1,3,197324,197326,197329,2,5,0
56343,6,3,197330,197330,197333,0,3,1
56344,3,2,197333,197333,197335,0,2,0
56345,1,2,197334,197335,197337,1,3,0
56346,1,2,197335,197337,197339,2,4,0
56347,3,2,197338,197339,197341,1,3,0
56348,1,2,197339,197341,197343,2,4,0
56349,3,3,197342,197343,197346,1,4,0
56350,6,2,197348,197348,197350,0,2,2
56351,1,2,197349,197350,197352,1,3,0
56352,6,1,197355,197355,197356,0,1,3
56353,3,1,197358,197358,197359,0,1,2
56354,2,2,197360,197360,197362,0,2,1
56355,4,1,197364,197364,197365,0,1,2
56356,2,1,197366,197366,197367,0,1,1
56357,3,3,197369,197369,197372,0,3,2
56358,6,2,197375,197375,197377,0,2,3
56359,3,3,197378,197378,197381,0,3,1
56360,3,1,197381,197381,197382,0,1,0
56361,1,2,197382,197382,197384,0,2,0
56362,4,2,197386,197386,197388,0,2,2
56363,3,3,197389,197389,197392,0,3,1
56364,2,3,197391,197392,197395,1,4,0
56365,4,1,197395,197395,197396,0,1,0
56366,3,1,197398,197398,197399,0,1,2
56367,5,3,197403,197403,197406,0,3,4
56368,6,1,197409,197409,197410,0,1,3
56369,4,2,197413,197413,197415,0,2,3
56370,2,3,197415,197415,197418,0,3,0
56371,5,3,197420,197420,197423,0,3,2
56372,4,1,197424,197424,197425,0,1,1
56373,2,2,197426,197426,197428,0,2,1
56374,4,2,197430,197430,197432,0,2,2
56375,1,1,197431,197432,197433,1,2,0
56376,5,3,197436,197436,197439,0,3,3
56377,5,1,197441,197441,197442,0,1,2
56378,1,2,197442,197442,197444,0,2,0
56379,3,1,197445,197445,197446,0,1,1
56380,4,1,197449,197449,197450,0,1,3
56381,3,1,197452,197452,197453,0,1,2
56382,3,1,197455,197455,197456,0,1,2
56383,5,2,197460,197460,197462,0,2,4
56384,4,2,197464,197464,197466,0,2,2
56385,5,2,197469,197469,197471,0,2,3
56386,6,1,197475,197475,197476,0,1,4
56387,5,3,197480,197480,197483,0,3,4
56388,2,2,197482,197483,197485,1,3,0
56389,2,3,197484,197485,197488,1,4,0
56390,6,1,197490,197490,197491,0,1,2
56391,6,3,197496,197496,197499,0,3,5
56392,6,2,197502,197502,197504,0,2,3
56393,6,1,197508,197508,197509,0,1,4
56394,1,1,197509,197509,197510,0,1,0
56395,5,2,197514,197514,197516,0,2,4
56396,5,3,197519,197519,197522,0,3,3
56397,6,3,197525,197525,197528,0,3,3
56398,1,1,197526,197528,197529,2,3,0
56399,3,3,197529,197529,197532,0,3,0
56400,6,1,197535,197535,197536,0,1,3
56401,1,2,197536,197536,197538,0,2,0
56402,2,3,197538,197538,197541,0,3,0
56403,2,2,197540,197541,197543,1,3,0
56404,6,1,197546,197546,197547,0,1,3
56405,2,2,197548,197548,197550,0,2,1
56406,4,3,197552,197552,197555,0,3,2
56407,5,3,197557,197557,197560,0,3,2
56408,3,2,197560,197560,197562,0,2,0
56409,6,3,197566,197566,197569,0,3,4
56410,6,3,197572,197572,197575,0,3,3
56411,2,3,197574,197575,197578,1,4,0
56412,6,2,197580,197580,197582,0,2,2
56413,3,3,197583,197583,197586,0,3,1
56414,2,2,197585,197586,197588,1,3,0
56415,5,1,197590,197590,197591,0,1,2
56416,4,3,197594,197594,197597,0,3,3
56417,5,1,197599,197599,197600,0,1,2
56418,3,2,197602,197602,197604,0,2,2
56419,6,3,197608,197608,197611,0,3,4
56420,1,1,197609,197611,197612,2,3,0
56421,1,2,197610,197612,197614,2,4,0
56422,5,3,197615,197615,197618,0,3,1
56423,4,2,197619,197619,197621,0,2,1
56424,5,1,197624,197624,197625,0,1,3
56425,1,3,197625,197625,197628,0,3,0
56426,1,2,197626,197628,197630,2,4,0
56427,6,1,197632,197632,197633,0,1,2
56428,2,1,197634,197634,197635,0,1,1
56429,4,2,197638,197638,197640,0,2,3
56430,4,3,197642,197642,197645,0,3,2
56431,5,1,197647,197647,197648,0,1,2
56432,2,3,197649,197649,197652,0,3,1
56433,6,1,197655,197655,197656,0,1,3
56434,3,3,197658,197658,197661,0,3,2
56435,5,3,197663,197663,197666,0,3,2
56436,3,2,197666,197666,197668,0,2,0
56437,6,2,197672,197672,197674,0,2,4
56438,6,2,197678,197678,197680,0,2,4
56439,4,3,197682,197682,197685,0,3,2
56440,5,2,197687,197687,197689,0,2,2
56441,2,3,197689,197689,197692,0,3,0
56442,6,3,197695,197695,197698,0,3,3
56443,2,2,197697,197698,197700,1,3,0
56444,4,3,197701,197701,197704,0,3,1
56445,4,1,197705,197705,197706,0,1,1
56446,6,2,197711,197711,197713,0,2,5
56447,6,1,197717,197717,197718,0,1,4
56448,4,1,197721,197721,197722,0,1,3
56449,4,2,197725,197725,197727,0,2,3
56450,5,2,197730,197730,197732,0,2,3
56451,2,2,197732,197732,197734,0,2,0
56452,2,3,197734,197734,197737,0,3,0
56453,1,2,197735,197737,197739,2,4,0
56454,4,3,197739,197739,197742,0,3,0
56455,4,1,197743,197743,197744,0,1,1
56456,6,2,197749,197749,197751,0,2,5
56457,4,3,197753,197753,197756,0,3,2
56458,3,1,197756,197756,197757,0,1,0
56459,1,2,197757,197757,197759,0,2,0
56460,6,3,197763,197763,197766,0,3,4
56461,3,2,197766,197766,197768,0,2,0
56462,1,1,197767,197768,197769,1,2,0
56463,2,2,197769,197769,197771,0,2,0
56464,5,1,197774,197774,197775,0,1,3
56465,3,3,197777,197777,197780,0,3,2
56466,5,1,197782,197782,197783,0,1,2
56467,1,2,197783,197783,197785,0,2,0
56468,1,2,197784,197785,197787,1,3,0
56469,4,3,197788,197788,197791,0,3,1
56470,5,3,197793,197793,197796,0,3,2
56471,4,3,197797,197797,197800,0,3,1
56472,3,1,197800,197800,197801,0,1,0
56473,2,2,197802,197802,197804,0,2,1
56474,4,2,197806,197806,197808,0,2,2
56475,5,3,197811,197811,197814,0,3,3
56476,2,2,197813,197814,197816,1,3,0
56477,5,2,197818,197818,197820,0,2,2
56478,5,1,197823,197823,197824,0,1,3
56479,4,1,197827,197827,197828,0,1,3
56480,3,2,197830,197830,197832,0,2,2
56481,3,3,197833,197833,197836,0,3,1
56482,2,2,197835,197836,197838,1,3,0
56483,4,2,197839,197839,197841,0,2,1
56484,3,3,197842,197842,197845,0,3,1
56485,5,3,197847,197847,197850,0,3,2
56486,4,3,197851,197851,197854,0,3,1
56487,4,2,197855,197855,197857,0,2,1
56488,2,3,197857,197857,197860,0,3,0
56489,4,2,197861,197861,197863,0,2,1
56490,4,1,197865,197865,197866,0,1,2
56491,6,1,197871,197871,197872,0,1,5
56492,6,2,197877,197877,197879,0,2,5
56493,4,2,197881,197881,197883,0,2,2
56494,6,1,197887,197887,197888,0,1,4
56495,1,3,197888,197888,197891,0,3,0
56496,2,3,197890,197891,197894,1,4,0
56497,6,3,197896,197896,197899,0,3,2
56498,5,2,197901,197901,197903,0,2,2
56499,2,2,197903,197903,197905,0,2,0
56500,5,3,197908,197908,197911,0,3,3
56501,4,2,197912,197912,197914,0,2,1
56502,2,3,197914,197914,197917,0,3,0
56503,4,1,197918,197918,197919,0,1,1
56504,2,1,197920,197920,197921,0,1,1
56505,3,1,197923,197923,197924,0,1,2
56506,6,2,197929,197929,197931,0,2,5
56507,3,2,197932,197932,197934,0,2,1
56508,5,3,197937,197937,197940,0,3,3
56509,5,3,197942,197942,197945,0,3,2
56510,5,1,197947,197947,197948,0,1,2
56511,2,2,197949,197949,197951,0,2,1
56512,4,3,197953,197953,197956,0,3,2
56513,5,1,197958,197958,197959,0,1,2
56514,4,3,197962,197962,197965,0,3,3
56515,1,3,197963,197965,197968,2,5,0
56516,4,1,197967,197968,197969,1,2,0
56517,6,1,197973,197973,197974,0,1,4
56518,2,1,197975,197975,197976,0,1,1
56519,5,3,197980,197980,197983,0,3,4
56520,6,2,197986,197986,197988,0,2,3
56521,5,3,197991,197991,197994,0,3,3
56522,5,3,197996,197996,197999,0,3,2
56523,2,1,197998,197999,198000,1,2,0
56524,5,2,198003,198003,198005,0,2,3
56525,4,1,198007,198007,198008,0,1,2
56526,6,3,198013,198013,198016,0,3,5
56527,2,2,198015,198016,198018,1,3,0
56528,1,2,198016,198018,198020,2,4,0
56529,2,2,198018,198020,198022,2,4,0
56530,1,3,198019,198022,198025,3,6,0
56531,3,3,198022,198025,198028,3,6,0
56532,6,2,198028,198028,198030,0,2,0
56533,5,3,198033,198033,198036,0,3,3
56534,3,1,198036,198036,198037,0,1,0
56535,2,2,198038,198038,198040,0,2,1
56536,4,3,198042,198042,198045,0,3,2
56537,2,3,198044,198045,198048,1,4,0
56538,3,2,198047,198048,198050,1,3,0
56539,2,3,198049,198050,198053,1,4,0
56540,6,1,198055,198055,198056,0,1,2
56541,3,2,198058,198058,198060,0,2,2
56542,5,1,198063,198063,198064,0,1,3
56543,5,1,198068,198068,198069,0,1,4
56544,1,1,198069,198069,198070,0,1,0
56545,5,2,198074,198074,198076,0,2,4
56546,2,3,198076,198076,198079,0,3,0
56547,3,1,198079,198079,198080,0,1,0
56548,3,2,198082,198082,198084,0,2,2
56549,6,3,198088,198088,198091,0,3,4
56550,2,1,198090,198091,198092,1,2,0
56551,4,3,198094,198094,198097,0,3,2
56552,3,2,198097,198097,198099,0,2,0
56553,2,1,198099,198099,198100,0,1,0
56554,6,3,198105,198105,198108,0,3,5
56555,4,3,198109,198109,198112,0,3,1
56556,5,2,198114,198114,198116,0,2,2
56557,6,3,198120,198120,198123,0,3,4
56558,3,3,198123,198123,198126,0,3,0
56559,5,1,198128,198128,198129,0,1,2
56560,5,1,198133,198133,198134,0,1,4
56561,6,3,198139,198139,198142,0,3,5
56562,3,2,198142,198142,198144,0,2,0
56563,6,2,198148,198148,198150,0,2,4
56564,3,2,198151,198151,198153,0,2,1
56565,6,1,198157,198157,198158,0,1,4
56566,1,3,198158,198158,198161,0,3,0
56567,1,2,198159,198161,198163,2,4,0
56568,2,2,198161,198163,198165,2,4,0
56569,1,2,198162,198165,198167,3,5,0
56570,2,3,198164,198167,198170,3,6,0
56571,1,1,198165,198170,198171,5,6,0
56572,3,1,198168,198171,198172,3,4,0
56573,3,2,198171,198172,198174,1,3,0
56574,4,1,198175,198175,198176,0,1,1
56575,5,2,198180,198180,198182,0,2,4
56576,1,2,198181,198182,198184,1,3,0
56577,1,2,198182,198184,198186,2,4,0
56578,3,1,198185,198186,198187,1,2,0
56579,2,2,198187,198187,198189,0,2,0
56580,2,3,198189,198189,198192,0,3,0
56581,3,3,198192,198192,198195,0,3,0
56582,6,3,198198,198198,198201,0,3,3
56583,4,3,198202,198202,198205,0,3,1
56584,1,2,198203,198205,198207,2,4,0
56585,2,3,198205,198207,198210,2,5,0
56586,4,1,198209,198210,198211,1,2,0
56587,6,2,198215,198215,198217,0,2,4
56588,3,3,198218,198218,198221,0,3,1
56589,5,1,198223,198223,198224,0,1,2
56590,4,2,198227,198227,198229,0,2,3
56591,4,3,198231,198231,198234,0,3,2
56592,4,1,198235,198235,198236,0,1,1
56593,1,1,198236,198236,198237,0,1,0
56594,1,1,198237,198237,198238,0,1,0
56595,1,2,198238,198238,198240,0,2,0
56596,3,1,198241,198241,198242,0,1,1
56597,6,1,198247,198247,198248,0,1,5
56598,2,3,198249,198249,198252,0,3,1
56599,3,3,198252,198252,198255,0,3,0
56600,1,3,198253,198255,198258,2,5,0
56601,3,3,198256,198258,198261,2,5,0
56602,5,2,198261,198261,198263,0,2,0
56603,3,1,198264,198264,198265,0,1,1
56604,5,3,198269,198269,198272,0,3,4
56605,5,1,198274,198274,198275,0,1,2
56606,3,1,198277,198277,198278,0,1,2
56607,2,1,198279,198279,198280,0,1,1
56608,6,3,198285,198285,198288,0,3,5
56609,6,1,198291,198291,198292,0,1,3
56610,2,1,198293,198293,198294,0,1,1
56611,5,3,198298,198298,198301,0,3,4
56612,4,3,198302,198302,198305,0,3,1
56613,6,3,198308,198308,198311,0,3,3
56614,6,2,198314,198314,198316,0,2,3
56615,3,3,198317,198317,198320,0,3,1
56616,1,3,198318,198320,198323,2,5,0
56617,2,1,198320,198323,198324,3,4,0
56618,2,1,198322,198324,198325,2,3,0
56619,5,1,198327,198327,198328,0,1,2
56620,2,1,198329,198329,198330,0,1,1
56621,1,1,198330,198330,198331,0,1,0
56622,3,1,198333,198333,198334,0,1,2
56623,2,3,198335,198335,198338,0,3,1
56624,5,2,198340,198340,198342,0,2,2
56625,6,2,198346,198346,198348,0,2,4
56626,2,2,198348,198348,198350,0,2,0
56627,6,3,198354,198354,198357,0,3,4
56628,3,2,198357,198357,198359,0,2,0
56629,4,2,198361,198361,198363,0,2,2
56630,6,1,198367,198367,198368,0,1,4
56631,6,3,198373,198373,198376,0,3,5
56632,2,3,198375,198376,198379,1,4,0
56633,2,2,198377,198379,198381,2,4,0
56634,2,1,198379,198381,198382,2,3,0
56635,5,2,198384,198384,198386,0,2,2
56636,1,1,198385,198386,198387,1,2,0
56637,4,1,198389,198389,198390,0,1,2
56638,6,2,198395,198395,198397,0,2,5
56639,1,3,198396,198397,198400,1,4,0
56640,4,1,198400,198400,198401,0,1,0
56641,1,1,198401,198401,198402,0,1,0
56642,3,1,198404,198404,198405,0,1,2
56643,1,2,198405,198405,198407,0,2,0
56644,4,2,198409,198409,198411,0,2,2
56645,1,1,198410,198411,198412,1,2,0
56646,6,3,198416,198416,198419,0,3,4
56647,2,3,198418,198419,198422,1,4,0
56648,5,1,198423,198423,198424,0,1,1
56649,4,1,198427,198427,198428,0,1,3
56650,4,1,198431,198431,198432,0,1,3
56651,5,3,198436,198436,198439,0,3,4
56652,3,3,198439,198439,198442,0,3,0
56653,4,2,198443,198443,198445,0,2,1
56654,1,3,198444,198445,198448,1,4,0
56655,5,2,198449,198449,198451,0,2,1
56656,3,3,198452,198452,198455,0,3,1
56657,3,2,198455,198455,198457,0,2,0
56658,4,3,198459,198459,198462,0,3,2
56659,3,3,198462,198462,198465,0,3,0
56660,1,3,198463,198465,198468,2,5,0
56661,1,1,198464,198468,198469,4,5,0
56662,5,3,198469,198469,198472,0,3,0
56663,1,3,198470,198472,198475,2,5,0
56664,3,2,198473,198475,198477,2,4,0
56665,6,1,198479,198479,198480,0,1,2
56666,3,3,198482,198482,198485,0,3,2
56667,2,1,198484,198485,198486,1,2,0
56668,5,1,198489,198489,198490,0,1,3
56669,5,1,198494,198494,198495,0,1,4
56670,3,2,198497,198497,198499,0,2,2
56671,3,3,198500,198500,198503,0,3,1
56672,5,2,198505,198505,198507,0,2,2
56673,5,1,198510,198510,198511,0,1,3
56674,6,3,198516,198516,198519,0,3,5
56675,5,2,198521,198521,198523,0,2,2
56676,1,3,198522,198523,198526,1,4,0
56677,6,3,198528,198528,198531,0,3,2
56678,6,3,198534,198534,198537,0,3,3
56679,2,1,198536,198537,198538,1,2,0
56680,6,2,198542,198542,198544,0,2,4
56681,3,3,198545,198545,198548,0,3,1
56682,5,1,198550,198550,198551,0,1,2
56683,1,3,198551,198551,198554,0,3,0
56684,3,2,198554,198554,198556,0,2,0
56685,4,3,198558,198558,198561,0,3,2
56686,2,3,198560,198561,198564,1,4,0
56687,1,3,198561,198564,198567,3,6,0
56688,1,2,198562,198567,198569,5,7,0
56689,5,3,198567,198569,198572,2,5,0
56690,3,2,198570,198572,198574,2,4,0
56691,5,1,198575,198575,198576,0,1,1
56692,3,1,198578,198578,198579,0,1,2
56693,6,3,198584,198584,198587,0,3,5
56694,1,2,198585,198587,198589,2,4,0
56695,5,3,198590,198590,198593,0,3,1
56696,5,2,198595,198595,198597,0,2,2
56697,5,3,198600,198600,198603,0,3,3
56698,5,3,198605,198605,198608,0,3,2
56699,6,3,198611,198611,198614,0,3,3
56700,5,3,198616,198616,198619,0,3,2
56701,2,1,198618,198619,198620,1,2,0
56702,6,1,198624,198624,198625,0,1,4
56703,4,2,198628,198628,198630,0,2,3
56704,1,3,198629,198630,198633,1,4,0
56705,5,2,198634,198634,198636,0,2,1
56706,2,2,198636,198636,198638,0,2,0
56707,5,2,198641,198641,198643,0,2,3
56708,2,1,198643,198643,198644,0,1,0
56709,4,3,198647,198647,198650,0,3,3
56710,1,2,198648,198650,198652,2,4,0
56711,1,3,198649,198652,198655,3,6,0
56712,2,1,198651,198655,198656,4,5,0
56713,1,3,198652,198656,198659,4,7,0
56714,2,1,198654,198659,198660,5,6,0
56715,3,2,198657,198660,198662,3,5,0
56716,2,2,198659,198662,198664,3,5,0
56717,6,2,198665,198665,198667,0,2,1
56718,1,2,198666,198667,198669,1,3,0
56719,1,1,198667,198669,198670,2,3,0
56720,6,3,198673,198673,198676,0,3,3
56721,5,2,198678,198678,198680,0,2,2
56722,2,3,198680,198680,198683,0,3,0
56723,3,2,198683,198683,198685,0,2,0
56724,2,3,198685,198685,198688,0,3,0
56725,6,1,198691,198691,198692,0,1,3
56726,2,1,198693,198693,198694,0,1,1
56727,1,1,198694,198694,198695,0,1,0
56728,2,2,198696,198696,198698,0,2,1
56729,3,2,198699,198699,198701,0,2,1
56730,4,3,198703,198703,198706,0,3,2
56731,1,1,198704,198706,198707,2,3,0
56732,1,3,198705,198707,198710,2,5,0
56733,1,2,198706,198710,198712,4,6,0
56734,6,2,198712,198712,198714,0,2,0
56735,1,1,198713,198714,198715,1,2,0
56736,2,2,198715,198715,198717,0,2,0
56737,4,1,198719,198719,198720,0,1,2
56738,1,2,198720,198720,198722,0,2,0
56739,5,2,198725,198725,198727,0,2,3
56740,6,3,198731,198731,198734,0,3,4
56741,4,3,198735,198735,198738,0,3,1
56742,2,2,198737,198738,198740,1,3,0
56743,6,1,198743,198743,198744,0,1,3
56744,2,2,198745,198745,198747,0,2,1
56745,5,1,198750,198750,198751,0,1,3
56746,2,2,198752,198752,198754,0,2,1
56747,6,3,198758,198758,198761,0,3,4
56748,3,1,198761,198761,198762,0,1,0
56749,3,1,198764,198764,198765,0,1,2
56750,3,1,198767,198767,198768,0,1,2
56751,2,1,198769,198769,198770,0,1,1
56752,3,1,198772,198772,198773,0,1,2
56753,6,1,198778,198778,198779,0,1,5
56754,6,2,198784,198784,198786,0,2,5
56755,6,2,198790,198790,198792,0,2,4
56756,2,3,198792,198792,198795,0,3,0
56757,5,1,198797,198797,198798,0,1,2
56758,6,1,198803,198803,198804,0,1,5
56759,5,2,198808,198808,198810,0,2,4
56760,6,1,198814,198814,198815,0,1,4
56761,4,3,198818,198818,198821,0,3,3
56762,3,2,198821,198821,198823,0,2,0
56763,2,1,198823,198823,198824,0,1,0
56764,2,3,198825,198825,198828,0,3,1
56765,3,2,198828,198828,198830,0,2,0
56766,2,3,198830,198830,198833,0,3,0
56767,3,1,198833,198833,198834,0,1,0
56768,2,3,198835,198835,198838,0,3,1
56769,4,1,198839,198839,198840,0,1,1
56770,1,3,198840,198840,198843,0,3,0
56771,6,2,198846,198846,198848,0,2,3
56772,5,1,198851,198851,198852,0,1,3
56773,1,3,198852,198852,198855,0,3,0
56774,6,1,198858,198858,198859,0,1,3
56775,6,3,198864,198864,198867,0,3,5
56776,1,1,198865,198867,198868,2,3,0
56777,6,1,198871,198871,198872,0,1,3
56778,5,2,198876,198876,198878,0,2,4
56779,2,3,198878,198878,198881,0,3,0
56780,4,3,198882,198882,198885,0,3,1
56781,4,2,198886,198886,198888,0,2,1
56782,6,2,198892,198892,198894,0,2,4
56783,5,1,198897,198897,198898,0,1,3
56784,5,1,198902,198902,198903,0,1,4
56785,5,2,198907,198907,198909,0,2,4
56786,5,3,198912,198912,198915,0,3,3
56787,2,3,198914,198915,198918,1,4,0
56788,1,2,198915,198918,198920,3,5,0
56789,4,2,198919,198920,198922,1,3,0
56790,5,1,198924,198924,198925,0,1,2
56791,5,1,198929,198929,198930,0,1,4
56792,1,1,198930,198930,198931,0,1,0
56793,4,1,198934,198934,198935,0,1,3
56794,2,1,198936,198936,198937,0,1,1
56795,5,1,198941,198941,198942,0,1,4
56796,5,2,198946,198946,198948,0,2,4
56797,4,3,198950,198950,198953,0,3,2
56798,3,3,198953,198953,198956,0,3,0
56799,5,2,198958,198958,198960,0,2,2
56800,2,3,198960,198960,198963,0,3,0
56801,3,1,198963,198963,198964,0,1,0
56802,4,3,198967,198967,198970,0,3,3
56803,1,2,198968,198970,198972,2,4,0
56804,5,1,198973,198973,198974,0,1,1
56805,3,2,198976,198976,198978,0,2,2
56806,1,2,198977,198978,198980,1,3,0
56807,6,3,198983,198983,198986,0,3,3
56808,2,1,198985,198986,198987,1,2,0
56809,1,2,198986,198987,198989,1,3,0
56810,5,1,198991,198991,198992,0,1,2
56811,4,2,198995,198995,198997,0,2,3
56812,3,1,198998,198998,198999,0,1,1
56813,1,1,198999,198999,199000,0,1,0
56814,1,2,199000,199000,199002,0,2,0
56815,5,3,199005,199005,199008,0,3,3
56816,6,2,199011,199011,199013,0,2,3
56817,4,1,199015,199015,199016,0,1,2
56818,3,3,199018,199018,199021,0,3,2
56819,5,3,199023,199023,199026,0,3,2
56820,5,2,199028,199028,199030,0,2,2
56821,5,3,199033,199033,199036,0,3,3
56822,5,1,199038,199038,199039,0,1,2
56823,6,3,199044,199044,199047,0,3,5
56824,6,2,199050,199050,199052,0,2,3
56825,3,2,199053,199053,199055,0,2,1
56826,5,3,199058,199058,199061,0,3,3
56827,2,3,199060,199061,199064,1,4,0
56828,3,1,199063,199064,199065,1,2,0
56829,2,1,199065,199065,199066,0,1,0
56830,6,3,199071,199071,199074,0,3,5
56831,5,2,199076,199076,199078,0,2,2
56832,6,3,199082,199082,199085,0,3,4
56833,3,2,199085,199085,199087,0,2,0
56834,1,1,199086,199087,199088,1,2,0
56835,4,1,199090,199090,199091,0,1,2
56836,5,3,199095,199095,199098,0,3,4
56837,4,2,199099,199099,199101,0,2,1
56838,1,1,199100,199101,199102,1,2,0
56839,6,2,199106,199106,199108,0,2,4
56840,6,1,199112,199112,199113,0,1,4
56841,1,1,199113,199113,199114,0,1,0
56842,5,2,199118,199118,199120,0,2,4
56843,4,3,199122,199122,199125,0,3,2
56844,1,2,199123,199125,199127,2,4,0
56845,3,3,199126,199127,199130,1,4,0
56846,2,2,199128,199130,199132,2,4,0
56847,1,2,199129,199132,199134,3,5,0
56848,2,2,199131,199134,199136,3,5,0
56849,2,1,199133,199136,199137,3,4,0
56850,3,2,199136,199137,199139,1,3,0
56851,2,1,199138,199139,199140,1,2,0
56852,4,2,199142,199142,199144,0,2,2
56853,4,3,199146,199146,199149,0,3,2
56854,6,2,199152,199152,199154,0,2,3
56855,5,2,199157,199157,199159,0,2,3
56856,5,1,199162,199162,199163,0,1,3
56857,6,1,199168,199168,199169,0,1,5
56858,6,3,199174,199174,199177,0,3,5
56859,1,3,199175,199177,199180,2,5,0
56860,4,1,199179,199180,199181,1,2,0
56861,5,3,199184,199184,199187,0,3,3
56862,4,1,199188,199188,199189,0,1,1
56863,2,1,199190,199190,199191,0,1,1
56864,5,3,199195,199195,199198,0,3,4
56865,3,2,199198,199198,199200,0,2,0
56866,4,1,199202,199202,199203,0,1,2
56867,5,3,199207,199207,199210,0,3,4
56868,5,3,199212,199212,199215,0,3,2
56869,3,3,199215,199215,199218,0,3,0
56870,6,1,199221,199221,199222,0,1,3
56871,6,3,199227,199227,199230,0,3,5
56872,2,3,199229,199230,199233,1,4,0
56873,3,1,199232,199233,199234,1,2,0
56874,2,3,199234,199234,199237,0,3,0
56875,5,1,199239,199239,199240,0,1,2
56876,6,3,199245,199245,199248,0,3,5
56877,2,1,199247,199248,199249,1,2,0
56878,5,2,199252,199252,199254,0,2,3
56879,6,3,199258,199258,199261,0,3,4
56880,2,1,199260,199261,199262,1,2,0
56881,5,3,199265,199265,199268,0,3,3
56882,6,3,199271,199271,199274,0,3,3
56883,1,2,199272,199274,199276,2,4,0
56884,1,1,199273,199276,199277,3,4,0
56885,2,3,199275,199277,199280,2,5,0
56886,4,2,199279,199280,199282,1,3,0
56887,4,1,199283,199283,199284,0,1,1
56888,4,3,199287,199287,199290,0,3,3
56889,6,1,199293,199293,199294,0,1,3
56890,2,2,199295,199295,199297,0,2,1
56891,6,3,199301,199301,199304,0,3,4
56892,4,2,199305,199305,199307,0,2,1
56893,4,3,199309,199309,199312,0,3,2
56894,1,1,199310,199312,199313,2,3,0
56895,4,1,199314,199314,199315,0,1,1
56896,6,1,199320,199320,199321,0,1,5
56897,6,1,199326,199326,199327,0,1,5
56898,2,2,199328,199328,199330,0,2,1
56899,6,3,199334,199334,199337,0,3,4
56900,4,3,199338,199338,199341,0,3,1
56901,3,3,199341,199341,199344,0,3,0
56902,6,1,199347,199347,199348,0,1,3
56903,4,3,199351,199351,199354,0,3,3
56904,2,3,199353,199354,199357,1,4,0
56905,2,1,199355,199357,199358,2,3,0
56906,3,3,199358,199358,199361,0,3,0
56907,4,3,199362,199362,199365,0,3,1
56908,5,1,199367,199367,199368,0,1,2
56909,1,1,199368,199368,199369,0,1,0
56910,1,1,199369,199369,199370,0,1,0
56911,5,1,199374,199374,199375,0,1,4
56912,6,1,199380,199380,199381,0,1,5
56913,3,1,199383,199383,199384,0,1,2
56914,2,2,199385,199385,199387,0,2,1
56915,5,2,199390,199390,199392,0,2,3
56916,3,2,199393,199393,199395,0,2,1
56917,3,1,199396,199396,199397,0,1,1
56918,4,3,199400,199400,199403,0,3,3
56919,4,2,199404,199404,199406,0,2,1
56920,3,2,199407,199407,199409,0,2,1
56921,6,1,199413,199413,199414,0,1,4
56922,4,3,199417,199417,199420,0,3,3
56923,1,1,199418,199420,199421,2,3,0
56924,4,3,199422,199422,199425,0,3,1
56925,5,1,199427,199427,199428,0,1,2
56926,1,3,199428,199428,199431,0,3,0
56927,1,3,199429,199431,199434,2,5,0
56928,1,2,199430,199434,199436,4,6,0
56929,2,2,199432,199436,199438,4,6,0
56930,2,1,199434,199438,199439,4,5,0
56931,1,2,199435,199439,199441,4,6,0
56932,1,3,199436,199441,199444,5,8,0
56933,3,2,199439,199444,199446,5,7,0
56934,3,1,199442,199446,199447,4,5,0
56935,3,1,199445,199447,199448,2,3,0
56936,2,1,199447,199448,199449,1,2,0
56937,2,1,199449,199449,199450,0,1,0
56938,6,2,199455,199455,199457,0,2,5
56939,2,1,199457,199457,199458,0,1,0
56940,2,1,199459,199459,199460,0,1,1
56941,3,2,199462,199462,199464,0,2,2
56942,5,3,199467,199467,199470,0,3,3
56943,2,1,199469,199470,199471,1,2,0
56944,1,2,199470,199471,199473,1,3,0
56945,3,2,199473,199473,199475,0,2,0
56946,4,2,199477,199477,199479,0,2,2
56947,4,3,199481,199481,199484,0,3,2
56948,6,3,199487,199487,199490,0,3,3
56949,6,2,199493,199493,199495,0,2,3
56950,6,3,199499,199499,199502,0,3,4
56951,5,1,199504,199504,199505,0,1,2
56952,2,3,199506,199506,199509,0,3,1
56953,3,1,199509,199509,199510,0,1,0
56954,2,3,199511,199511,199514,0,3,1
56955,6,2,199517,199517,199519,0,2,3
56956,3,2,199520,199520,199522,0,2,1
56957,4,2,199524,199524,199526,0,2,2
56958,5,1,199529,199529,199530,0,1,3
56959,6,2,199535,199535,199537,0,2,5
56960,4,1,199539,199539,199540,0,1,2
56961,6,2,199545,199545,199547,0,2,5
56962,3,1,199548,199548,199549,0,1,1
56963,5,2,199553,199553,199555,0,2,4
56964,3,1,199556,199556,199557,0,1,1
56965,3,1,199559,199559,199560,0,1,2
56966,3,1,199562,199562,199563,0,1,2
56967,5,1,199567,199567,199568,0,1,4
56968,4,2,199571,199571,199573,0,2,3
56969,3,2,199574,199574,199576,0,2,1
56970,1,1,199575,199576,199577,1,2,0
56971,5,1,199580,199580,199581,0,1,3
56972,2,2,199582,199582,199584,0,2,1
56973,3,1,199585,199585,199586,0,1,1
56974,5,1,199590,199590,199591,0,1,4
56975,1,1,199591,199591,199592,0,1,0
56976,3,1,199594,199594,199595,0,1,2
56977,3,3,199597,199597,199600,0,3,2
56978,1,2,199598,199600,199602,2,4,0
56979,6,2,199604,199604,199606,0,2,2
56980,5,3,199609,199609,199612,0,3,3
56981,6,3,199615,199615,199618,0,3,3
56982,6,3,199621,199621,199624,0,3,3
56983,4,3,199625,199625,199628,0,3,1
56984,2,2,199627,199628,199630,1,3,0
56985,4,3,199631,199631,199634,0,3,1
56986,1,3,199632,199634,199637,2,5,0
56987,1,2,199633,199637,199639,4,6,0
56988,6,2,199639,199639,199641,0,2,0
56989,3,1,199642,199642,199643,0,1,1
56990,6,1,199648,199648,199649,0,1,5
56991,6,2,199654,199654,199656,0,2,5
56992,1,1,199655,199656,199657,1,2,0
56993,3,2,199658,199658,199660,0,2,1
56994,1,2,199659,199660,199662,1,3,0
56995,3,1,199662,199662,199663,0,1,0
56996,6,1,199668,199668,199669,0,1,5
56997,1,1,199669,199669,199670,0,1,0
56998,4,2,199673,199673,199675,0,2,3
56999,3,2,199676,199676,199678,0,2,1
57000,6,3,199682,199682,199685,0,3,4
57001,3,3,199685,199685,199688,0,3,0
57002,6,1,199691,199691,199692,0,1,3
57003,3,2,199694,199694,199696,0,2,2
57004,4,3,199698,199698,199701,0,3,2
57005,5,1,199703,199703,199704,0,1,2
57006,4,1,199707,199707,199708,0,1,3
57007,1,3,199708,199708,199711,0,3,0
57008,5,1,199713,199713,199714,0,1,2
57009,2,2,199715,199715,199717,0,2,1
57010,4,3,199719,199719,199722,0,3,2
57011,2,1,199721,199722,199723,1,2,0
57012,5,3,199726,199726,199729,0,3,3
57013,1,1,199727,199729,199730,2,3,0
57014,4,2,199731,199731,199733,0,2,1
57015,5,1,199736,199736,199737,0,1,3
57016,2,3,199738,199738,199741,0,3,1
57017,1,1,199739,199741,199742,2,3,0
57018,6,1,199745,199745,199746,0,1,3
57019,2,3,199747,199747,199750,0,3,1
57020,2,2,199749,199750,199752,1,3,0
57021,3,2,199752,199752,199754,0,2,0
57022,3,2,199755,199755,199757,0,2,1
57023,2,1,199757,199757,199758,0,1,0
57024,1,1,199758,199758,199759,0,1,0
57025,3,3,199761,199761,199764,0,3,2
57026,3,1,199764,199764,199765,0,1,0
57027,1,3,199765,199765,199768,0,3,0
57028,5,1,199770,199770,199771,0,1,2
57029,2,2,199772,199772,199774,0,2,1
57030,6,2,199778,199778,199780,0,2,4
57031,4,2,199782,199782,199784,0,2,2
57032,4,3,199786,199786,199789,0,3,2
57033,1,2,199787,199789,199791,2,4,0
57034,3,1,199790,199791,199792,1,2,0
57035,6,3,199796,199796,199799,0,3,4
57036,5,2,199801,199801,199803,0,2,2
57037,6,2,199807,199807,199809,0,2,4
57038,4,3,199811,199811,199814,0,3,2
57039,4,1,199815,199815,199816,0,1,1
57040,3,3,199818,199818,199821,0,3,2
57041,5,3,199823,199823,199826,0,3,2
57042,1,1,199824,199826,199827,2,3,0
57043,1,2,199825,199827,199829,2,4,0
57044,1,1,199826,199829,199830,3,4,0
57045,3,1,199829,199830,199831,1,2,0
57046,2,1,199831,199831,199832,0,1,0
57047,1,3,199832,199832,199835,0,3,0
57048,3,2,199835,199835,199837,0,2,0
57049,4,1,199839,199839,199840,0,1,2
57050,4,1,199843,199843,199844,0,1,3
57051,5,3,199848,199848,199851,0,3,4
57052,3,2,199851,199851,199853,0,2,0
57053,3,3,199854,199854,199857,0,3,1
57054,2,3,199856,199857,199860,1,4,0
57055,4,1,199860,199860,199861,0,1,0
57056,5,3,199865,199865,199868,0,3,4
57057,1,2,199866,199868,199870,2,4,0
57058,4,2,199870,199870,199872,0,2,0
57059,1,1,199871,199872,199873,1,2,0
57060,6,2,199877,199877,199879,0,2,4
57061,6,3,199883,199883,199886,0,3,4
57062,6,1,199889,199889,199890,0,1,3
57063,1,3,199890,199890,199893,0,3,0
57064,1,3,199891,199893,199896,2,5,0
57065,3,1,199894,199896,199897,2,3,0
57066,6,1,199900,199900,199901,0,1,3
57067,3,2,199903,199903,199905,0,2,2
57068,4,2,199907,199907,199909,0,2,2
57069,2,2,199909,199909,199911,0,2,0
57070,1,3,199910,199911,199914,1,4,0
57071,6,2,199916,199916,199918,0,2,2
57072,6,2,199922,199922,199924,0,2,4
57073,6,1,199928,199928,199929,0,1,4
57074,6,2,199934,199934,199936,0,2,5
57075,3,2,199937,199937,199939,0,2,1
57076,4,2,199941,199941,199943,0,2,2
57077,3,1,199944,199944,199945,0,1,1
57078,3,2,199947,199947,199949,0,2,2
57079,6,3,199953,199953,199956,0,3,4
57080,1,1,199954,199956,199957,2,3,0
57081,2,1,199956,199957,199958,1,2,0
57082,3,1,199959,199959,199960,0,1,1
57083,3,2,199962,199962,199964,0,2,2
57084,4,1,199966,199966,199967,0,1,2
57085,4,1,199970,199970,199971,0,1,3
57086,1,2,199971,199971,199973,0,2,0
57087,5,1,199976,199976,199977,0,1,3
57088,3,2,199979,199979,199981,0,2,2
57089,2,2,199981,199981,199983,0,2,0
57090,1,3,199982,199983,199986,1,4,0
57091,6,3,199988,199988,199991,0,3,2
57092,6,2,199994,199994,199996,0,2,3
57093,4,2,199998,199998,200000,0,2,2
57094,6,2,200004,200004,200006,0,2,4
57095,2,3,200006,200006,200009,0,3,0
57096,2,1,200008,200009,200010,1,2,0
57097,5,3,200013,200013,200016,0,3,3
57098,2,2,200015,200016,200018,1,3,0
57099,2,3,200017,200018,200021,1,4,0
57100,5,2,200022,200022,200024,0,2,1
57101,2,1,200024,200024,200025,0,1,0
57102,4,3,200028,200028,200031,0,3,3
57103,5,1,200033,200033,200034,0,1,2
57104,1,2,200034,200034,200036,0,2,0
57105,4,2,200038,200038,200040,0,2,2
57106,1,3,200039,200040,200043,1,4,0
57107,3,1,200042,200043,200044,1,2,0
57108,4,1,200046,200046,200047,0,1,2
57109,4,2,200050,200050,200052,0,2,3
57110,3,1,200053,200053,200054,0,1,1
57111,3,3,200056,200056,200059,0,3,2
57112,5,1,200061,200061,200062,0,1,2
57113,4,3,200065,200065,200068,0,3,3
57114,6,2,200071,200071,200073,0,2,3
57115,2,2,200073,200073,200075,0,2,0
57116,4,1,200077,200077,200078,0,1,2
57117,4,3,200081,200081,200084,0,3,3
57118,3,3,200084,200084,200087,0,3,0
57119,2,1,200086,200087,200088,1,2,0
57120,2,3,200088,200088,200091,0,3,0
57121,3,3,200091,200091,200094,0,3,0
57122,6,1,200097,200097,200098,0,1,3
57123,3,1,200100,200100,200101,0,1,2
57124,4,1,200104,200104,200105,0,1,3
57125,1,3,200105,200105,200108,0,3,0
57126,4,3,200109,200109,200112,0,3,1
57127,5,1,200114,200114,200115,0,1,2
57128,2,2,200116,200116,200118,0,2,1
57129,3,1,200119,200119,200120,0,1,1
57130,6,2,200125,200125,200127,0,2,5
57131,4,3,200129,200129,200132,0,3,2
57132,4,2,200133,200133,200135,0,2,1
57133,2,1,200135,200135,200136,0,1,0
57134,5,2,200140,200140,200142,0,2,4
57135,1,1,200141,200142,200143,1,2,0
57136,3,3,200144,200144,200147,0,3,1
57137,2,2,200146,200147,200149,1,3,0
57138,5,2,200151,200151,200153,0,2,2
57139,1,3,200152,200153,200156,1,4,0
57140,4,1,200156,200156,200157,0,1,0
57141,2,3,200158,200158,200161,0,3,1
57142,2,1,200160,200161,200162,1,2,0
57143,2,3,200162,200162,200165,0,3,0
57144,1,2,200163,200165,200167,2,4,0
57145,6,1,200169,200169,200170,0,1,2
57146,4,3,200173,200173,200176,0,3,3
57147,3,1,200176,200176,200177,0,1,0
57148,6,2,200182,200182,200184,0,2,5
57149,4,2,200186,200186,200188,0,2,2
57150,1,2,200187,200188,200190,1,3,0
57151,6,3,200193,200193,200196,0,3,3
57152,4,2,200197,200197,200199,0,2,1
57153,2,2,200199,200199,200201,0,2,0
57154,1,2,200200,200201,200203,1,3,0
57155,5,3,200205,200205,200208,0,3,2
57156,3,3,200208,200208,200211,0,3,0
57157,2,2,200210,200211,200213,1,3,0
57158,3,2,200213,200213,200215,0,2,0
57159,2,2,200215,200215,200217,0,2,0
57160,1,1,200216,200217,200218,1,2,0
57161,1,2,200217,200218,200220,1,3,0
57162,2,1,200219,200220,200221,1,2,0
57163,6,1,200225,200225,200226,0,1,4
57164,4,1,200229,200229,200230,0,1,3
57165,6,2,200235,200235,200237,0,2,5
57166,1,2,200236,200237,200239,1,3,0
57167,5,3,200241,200241,200244,0,3,2
57168,1,1,200242,200244,200245,2,3,0
57169,1,1,200243,200245,200246,2,3,0
57170,6,2,200249,200249,200251,0,2,3
57171,3,1,200252,200252,200253,0,1,1
57172,1,3,200253,200253,200256,0,3,0
57173,6,2,200259,200259,200261,0,2,3
57174,5,1,200264,200264,200265,0,1,3
57175,2,2,200266,200266,200268,0,2,1
57176,4,2,200270,200270,200272,0,2,2
57177,2,3,200272,200272,200275,0,3,0
57178,3,2,200275,200275,200277,0,2,0
57179,1,3,200276,200277,200280,1,4,0
57180,2,1,200278,200280,200281,2,3,0
57181,5,2,200283,200283,200285,0,2,2
57182,1,1,200284,200285,200286,1,2,0
57183,3,2,200287,200287,200289,0,2,1
57184,6,3,200293,200293,200296,0,3,4
57185,3,2,200296,200296,200298,0,2,0
57186,3,2,200299,200299,200301,0,2,1
57187,6,2,200305,200305,200307,0,2,4
57188,5,1,200310,200310,200311,0,1,3
57189,2,2,200312,200312,200314,0,2,1
57190,6,1,200318,200318,200319,0,1,4
57191,6,2,200324,200324,200326,0,2,5
57192,3,1,200327,200327,200328,0,1,1
57193,4,3,200331,200331,200334,0,3,3
57194,1,1,200332,200334,200335,2,3,0
57195,5,1,200337,200337,200338,0,1,2
57196,2,2,200339,200339,200341,0,2,1
57197,5,2,200344,200344,200346,0,2,3
57198,3,2,200347,200347,200349,0,2,1
57199,5,3,200352,200352,200355,0,3,3
57200,1,2,200353,200355,200357,2,4,0
57201,1,2,200354,200357,200359,3,5,0
57202,5,3,200359,200359,200362,0,3,0
57203,2,1,200361,200362,200363,1,2,0
57204,3,2,200364,200364,200366,0,2,1
57205,2,2,200366,200366,200368,0,2,0
57206,5,2,200371,200371,200373,0,2,3
57207,4,3,200375,200375,200378,0,3,2
57208,4,1,200379,200379,200380,0,1,1
57209,4,2,200383,200383,200385,0,2,3
57210,1,1,200384,200385,200386,1,2,0
57211,1,2,200385,200386,200388,1,3,0
57212,2,2,200387,200388,200390,1,3,0
57213,4,2,200391,200391,200393,0,2,1
57214,1,2,200392,200393,200395,1,3,0
57215,3,3,200395,200395,200398,0,3,0
57216,4,2,200399,200399,200401,0,2,1
57217,3,3,200402,200402,200405,0,3,1
57218,1,2,200403,200405,200407,2,4,0
57219,3,3,200406,200407,200410,1,4,0
57220,6,2,200412,200412,200414,0,2,2
57221,4,3,200416,200416,200419,0,3,2
57222,1,3,200417,200419,200422,2,5,0
57223,1,1,200418,200422,200423,4,5,0
57224,6,3,200424,200424,200427,0,3,1
57225,3,2,200427,200427,200429,0,2,0
57226,6,2,200433,200433,200435,0,2,4
57227,5,1,200438,200438,200439,0,1,3
57228,2,3,200440,200440,200443,0,3,1
57229,1,3,200441,200443,200446,2,5,0
57230,3,3,200444,200446,200449,2,5,0
57231,6,3,200450,200450,200453,0,3,1
57232,4,1,200454,200454,200455,0,1,1
57233,3,3,200457,200457,200460,0,3,2
57234,4,3,200461,200461,200464,0,3,1
57235,2,2,200463,200464,200466,1,3,0
57236,5,1,200468,200468,200469,0,1,2
57237,3,3,200471,200471,200474,0,3,2
57238,2,1,200473,200474,200475,1,2,0
57239,2,3,200475,200475,200478,0,3,0
57240,5,2,200480,200480,200482,0,2,2
57241,6,3,200486,200486,200489,0,3,4
57242,1,3,200487,200489,200492,2,5,0
57243,5,2,200492,200492,200494,0,2,0
57244,4,3,200496,200496,200499,0,3,2
57245,6,2,200502,200502,200504,0,2,3
57246,6,1,200508,200508,200509,0,1,4
57247,6,3,200514,200514,200517,0,3,5
57248,6,1,200520,200520,200521,0,1,3
57249,3,1,200523,200523,200524,0,1,2
57250,3,3,200526,200526,200529,0,3,2
57251,6,2,200532,200532,200534,0,2,3
57252,1,1,200533,200534,200535,1,2,0
57253,1,3,200534,200535,200538,1,4,0
57254,2,1,200536,200538,200539,2,3,0
57255,2,1,200538,200539,200540,1,2,0
57256,1,2,200539,200540,200542,1,3,0
57257,1,1,200540,200542,200543,2,3,0
57258,3,3,200543,200543,200546,0,3,0
57259,6,3,200549,200549,200552,0,3,3
57260,1,3,200550,200552,200555,2,5,0
57261,1,1,200551,200555,200556,4,5,0
57262,2,2,200553,200556,200558,3,5,0
57263,2,3,200555,200558,200561,3,6,0
57264,6,1,200561,200561,200562,0,1,0
57265,4,2,200565,200565,200567,0,2,3
57266,4,1,200569,200569,200570,0,1,2
57267,1,3,200570,200570,200573,0,3,0
57268,6,2,200576,200576,200578,0,2,3
57269,1,1,200577,200578,200579,1,2,0
57270,3,3,200580,200580,200583,0,3,1
57271,2,1,200582,200583,200584,1,2,0
57272,3,2,200585,200585,200587,0,2,1
57273,2,2,200587,200587,200589,0,2,0
57274,6,3,200593,200593,200596,0,3,4
57275,4,2,200597,200597,200599,0,2,1
57276,6,2,200603,200603,200605,0,2,4
57277,1,3,200604,200605,200608,1,4,0
57278,3,3,200607,200608,200611,1,4,0
57279,6,2,200613,200613,200615,0,2,2
57280,2,2,200615,200615,200617,0,2,0
57281,4,1,200619,200619,200620,0,1,2
57282,5,3,200624,200624,200627,0,3,4
57283,5,2,200629,200629,200631,0,2,2
57284,3,3,200632,200632,200635,0,3,1
57285,4,3,200636,200636,200639,0,3,1
57286,2,3,200638,200639,200642,1,4,0
57287,2,2,200640,200642,200644,2,4,0
57288,4,1,200644,200644,200645,0,1,0
57289,4,1,200648,200648,200649,0,1,3
57290,6,3,200654,200654,200657,0,3,5
57291,3,1,200657,200657,200658,0,1,0
57292,1,2,200658,200658,200660,0,2,0
57293,5,3,200663,200663,200666,0,3,3
57294,5,1,200668,200668,200669,0,1,2
57295,1,2,200669,200669,200671,0,2,0
57296,2,3,200671,200671,200674,0,3,0
57297,1,1,200672,200674,200675,2,3,0
57298,2,1,200674,200675,200676,1,2,0
57299,5,2,200679,200679,200681,0,2,3
57300,1,1,200680,200681,200682,1,2,0
57301,4,2,200684,200684,200686,0,2,2
57302,2,2,200686,200686,200688,0,2,0
57303,2,1,200688,200688,200689,0,1,0
57304,6,2,200694,200694,200696,0,2,5
57305,1,2,200695,200696,200698,1,3,0
57306,4,2,200699,200699,200701,0,2,1
57307,5,3,200704,200704,200707,0,3,3
57308,1,2,200705,200707,200709,2,4,0
57309,1,2,200706,200709,200711,3,5,0
57310,3,1,200709,200711,200712,2,3,0
57311,1,3,200710,200712,200715,2,5,0
57312,5,2,200715,200715,200717,0,2,0
57313,1,2,200716,200717,200719,1,3,0
57314,2,1,200718,200719,200720,1,2,0
57315,3,1,200721,200721,200722,0,1,1
57316,2,2,200723,200723,200725,0,2,1
57317,3,2,200726,200726,200728,0,2,1
57318,1,1,200727,200728,200729,1,2,0
57319,2,1,200729,200729,200730,0,1,0
57320,4,1,200733,200733,200734,0,1,3
57321,3,3,200736,200736,200739,0,3,2
57322,2,3,200738,200739,200742,1,4,0
57323,2,3,200740,200742,200745,2,5,0
57324,6,3,200746,200746,200749,0,3,1
57325,6,3,200752,200752,200755,0,3,3
57326,1,2,200753,200755,200757,2,4,0
57327,6,2,200759,200759,200761,0,2,2
57328,6,3,200765,200765,200768,0,3,4
57329,3,1,200768,200768,200769,0,1,0
57330,3,1,200771,200771,200772,0,1,2
57331,1,2,200772,200772,200774,0,2,0
57332,1,3,200773,200774,200777,1,4,0
57333,1,2,200774,200777,200779,3,5,0
57334,1,1,200775,200779,200780,4,5,0
57335,4,1,200779,200780,200781,1,2,0
57336,3,2,200782,200782,200784,0,2,1
57337,6,2,200788,200788,200790,0,2,4
57338,5,2,200793,200793,200795,0,2,3
57339,6,2,200799,200799,200801,0,2,4
57340,2,2,200801,200801,200803,0,2,0
57341,1,3,200802,200803,200806,1,4,0
57342,4,3,200806,200806,200809,0,3,0
57343,2,3,200808,200809,200812,1,4,0
57344,4,3,200812,200812,200815,0,3,0
57345,5,1,200817,200817,200818,0,1,2
57346,3,1,200820,200820,200821,0,1,2
57347,2,2,200822,200822,200824,0,2,1
57348,1,3,200823,200824,200827,1,4,0
57349,4,1,200827,200827,200828,0,1,0
57350,1,3,200828,200828,200831,0,3,0
57351,3,2,200831,200831,200833,0,2,0
57352,5,3,200836,200836,200839,0,3,3
57353,1,2,200837,200839,200841,2,4,0
57354,4,1,200841,200841,200842,0,1,0
57355,6,1,200847,200847,200848,0,1,5
57356,2,1,200849,200849,200850,0,1,1
57357,4,3,200853,200853,200856,0,3,3
57358,6,1,200859,200859,200860,0,1,3
57359,5,2,200864,200864,200866,0,2,4
57360,5,1,200869,200869,200870,0,1,3
57361,5,1,200874,200874,200875,0,1,4
57362,6,1,200880,200880,200881,0,1,5
57363,4,1,200884,200884,200885,0,1,3
57364,4,2,200888,200888,200890,0,2,3
57365,4,3,200892,200892,200895,0,3,2
57366,5,2,200897,200897,200899,0,2,2
57367,6,1,200903,200903,200904,0,1,4
57368,4,2,200907,200907,200909,0,2,3
57369,3,1,200910,200910,200911,0,1,1
57370,6,3,200916,200916,200919,0,3,5
57371,1,1,200917,200919,200920,2,3,0
57372,5,2,200922,200922,200924,0,2,2
57373,4,2,200926,200926,200928,0,2,2
57374,6,1,200932,200932,200933,0,1,4
57375,4,1,200936,200936,200937,0,1,3
57376,4,1,200940,200940,200941,0,1,3
57377,3,1,200943,200943,200944,0,1,2
57378,5,3,200948,200948,200951,0,3,4
57379,6,2,200954,200954,200956,0,2,3
57380,4,1,200958,200958,200959,0,1,2
57381,6,1,200964,200964,200965,0,1,5
57382,2,2,200966,200966,200968,0,2,1
57383,2,3,200968,200968,200971,0,3,0
57384,5,3,200973,200973,200976,0,3,2
57385,2,1,200975,200976,200977,1,2,0
57386,4,3,200979,200979,200982,0,3,2
57387,1,2,200980,200982,200984,2,4,0
57388,1,2,200981,200984,200986,3,5,0
57389,6,3,200987,200987,200990,0,3,1
57390,6,3,200993,200993,200996,0,3,3
57391,5,2,200998,200998,201000,0,2,2
57392,4,3,201002,201002,201005,0,3,2
57393,3,3,201005,201005,201008,0,3,0
57394,3,2,201008,201008,201010,0,2,0
57395,1,1,201009,201010,201011,1,2,0
57396,5,3,201014,201014,201017,0,3,3
57397,6,2,201020,201020,201022,0,2,3
57398,5,2,201025,201025,201027,0,2,3
57399,4,2,201029,201029,201031,0,2,2
57400,4,2,201033,201033,201035,0,2,2
57401,2,1,201035,201035,201036,0,1,0
57402,4,1,201039,201039,201040,0,1,3
57403,5,3,201044,201044,201047,0,3,4
57404,1,3,201045,201047,201050,2,5,0
57405,3,1,201048,201050,201051,2,3,0
57406,2,1,201050,201051,201052,1,2,0
57407,4,3,201054,201054,201057,0,3,2
57408,2,3,201056,201057,201060,1,4,0
57409,2,1,201058,201060,201061,2,3,0
57410,2,2,201060,201061,201063,1,3,0
57411,3,3,201063,201063,201066,0,3,0
57412,3,3,201066,201066,201069,0,3,0
57413,6,3,201072,201072,201075,0,3,3
57414,2,1,201074,201075,201076,1,2,0
57415,1,2,201075,201076,201078,1,3,0
57416,2,2,201077,201078,201080,1,3,0
57417,6,2,201083,201083,201085,0,2,3
57418,5,2,201088,201088,201090,0,2,3
57419,4,1,201092,201092,201093,0,1,2
57420,2,2,201094,201094,201096,0,2,1
57421,6,2,201100,201100,201102,0,2,4
57422,2,3,201102,201102,201105,0,3,0
57423,4,2,201106,201106,201108,0,2,1
57424,3,1,201109,201109,201110,0,1,1
57425,6,3,201115,201115,201118,0,3,5
57426,1,3,201116,201118,201121,2,5,0
57427,2,2,201118,201121,201123,3,5,0
57428,3,1,201121,201123,201124,2,3,0
57429,5,1,201126,201126,201127,0,1,2
57430,4,3,201130,201130,201133,0,3,3
57431,1,2,201131,201133,201135,2,4,0
57432,5,1,201136,201136,201137,0,1,1
57433,2,2,201138,201138,201140,0,2,1
57434,4,2,201142,201142,201144,0,2,2
57435,6,3,201148,201148,201151,0,3,4
57436,4,1,201152,201152,201153,0,1,1
57437,1,3,201153,201153,201156,0,3,0
57438,2,3,201155,201156,201159,1,4,0
57439,3,1,201158,201159,201160,1,2,0
57440,5,2,201163,201163,201165,0,2,3
57441,5,1,201168,201168,201169,0,1,3
57442,6,3,201174,201174,201177,0,3,5
57443,4,2,201178,201178,201180,0,2,1
57444,3,1,201181,201181,201182,0,1,1
57445,3,3,201184,201184,201187,0,3,2
57446,3,3,201187,201187,201190,0,3,0
57447,2,2,201189,201190,201192,1,3,0
57448,5,3,201194,201194,201197,0,3,2
57449,1,3,201195,201197,201200,2,5,0
57450,1,3,201196,201200,201203,4,7,0
57451,5,2,201201,201203,201205,2,4,0
57452,1,2,201202,201205,201207,3,5,0
57453,3,2,201205,201207,201209,2,4,0
57454,4,2,201209,201209,201211,0,2,0
57455,1,3,201210,201211,201214,1,4,0
57456,4,2,201214,201214,201216,0,2,0
57457,1,3,201215,201216,201219,1,4,0
57458,3,2,201218,201219,201221,1,3,0
57459,5,3,201223,201223,201226,0,3,2
57460,5,1,201228,201228,201229,0,1,2
57461,2,1,201230,201230,201231,0,1,1
57462,2,3,201232,201232,201235,0,3,1
57463,1,2,201233,201235,201237,2,4,0
57464,2,3,201235,201237,201240,2,5,0
57465,5,1,201240,201240,201241,0,1,0
57466,4,1,201244,201244,201245,0,1,3
57467,3,3,201247,201247,201250,0,3,2
57468,2,3,201249,201250,201253,1,4,0
57469,5,2,201254,201254,201256,0,2,1
57470,2,2,201256,201256,201258,0,2,0
57471,4,2,201260,201260,201262,0,2,2
57472,2,2,201262,201262,201264,0,2,0
57473,2,3,201264,201264,201267,0,3,0
57474,2,1,201266,201267,201268,1,2,0
57475,2,1,201268,201268,201269,0,1,0
57476,6,2,201274,201274,201276,0,2,5
57477,5,1,201279,201279,201280,0,1,3
57478,2,3,201281,201281,201284,0,3,1
57479,6,2,201287,201287,201289,0,2,3
57480,1,2,201288,201289,201291,1,3,0
57481,6,2,201294,201294,201296,0,2,3
57482,3,3,201297,201297,201300,0,3,1
57483,2,3,201299,201300,201303,1,4,0
57484,6,1,201305,201305,201306,0,1,2
57485,2,3,201307,201307,201310,0,3,1
57486,4,1,201311,201311,201312,0,1,1
57487,3,1,201314,201314,201315,0,1,2
57488,2,2,201316,201316,201318,0,2,1
57489,5,1,201321,201321,201322,0,1,3
57490,4,1,201325,201325,201326,0,1,3
57491,1,1,201326,201326,201327,0,1,0
57492,3,3,201329,201329,201332,0,3,2
57493,5,2,201334,201334,201336,0,2,2
57494,4,1,201338,201338,201339,0,1,2
57495,5,2,201343,201343,201345,0,2,4
57496,6,3,201349,201349,201352,0,3,4
57497,3,2,201352,201352,201354,0,2,0
57498,6,1,201358,201358,201359,0,1,4
57499,4,3,201362,201362,201365,0,3,3
57500,4,2,201366,201366,201368,0,2,1
57501,5,3,201371,201371,201374,0,3,3
57502,6,3,201377,201377,201380,0,3,3
57503,1,3,201378,201380,201383,2,5,0
57504,4,1,201382,201383,201384,1,2,0
57505,3,2,201385,201385,201387,0,2,1
57506,5,1,201390,201390,201391,0,1,3
57507,1,2,201391,201391,201393,0,2,0
57508,3,2,201394,201394,201396,0,2,1
57509,5,1,201399,201399,201400,0,1,3
57510,4,1,201403,201403,201404,0,1,3
57511,4,1,201407,201407,201408,0,1,3
57512,6,3,201413,201413,201416,0,3,5
57513,4,2,201417,201417,201419,0,2,1
57514,5,3,201422,201422,201425,0,3,3
57515,2,2,201424,201425,201427,1,3,0
57516,5,1,201429,201429,201430,0,1,2
57517,1,2,201430,201430,201432,0,2,0
57518,1,3,201431,201432,201435,1,4,0
57519,4,3,201435,201435,201438,0,3,0
57520,3,2,201438,201438,201440,0,2,0
57521,1,3,201439,201440,201443,1,4,0
57522,1,3,201440,201443,201446,3,6,0
57523,1,3,201441,201446,201449,5,8,0
57524,6,1,201447,201449,201450,2,3,0
57525,5,3,201452,201452,201455,0,3,2
57526,1,2,201453,201455,201457,2,4,0
57527,3,1,201456,201457,201458,1,2,0
57528,6,3,201462,201462,201465,0,3,4
57529,3,3,201465,201465,201468,0,3,0
57530,1,3,201466,201468,201471,2,5,0
57531,5,3,201471,201471,201474,0,3,0
57532,4,3,201475,201475,201478,0,3,1
57533,3,1,201478,201478,201479,0,1,0
57534,2,3,201480,201480,201483,0,3,1
57535,2,2,201482,201483,201485,1,3,0
57536,6,1,201488,201488,201489,0,1,3
57537,4,1,201492,201492,201493,0,1,3
57538,3,2,201495,201495,201497,0,2,2
57539,5,1,201500,201500,201501,0,1,3
57540,4,1,201504,201504,201505,0,1,3
57541,6,3,201510,201510,201513,0,3,5
57542,1,2,201511,201513,201515,2,4,0
57543,1,1,201512,201515,201516,3,4,0
57544,5,2,201517,201517,201519,0,2,1
57545,2,1,201519,201519,201520,0,1,0
57546,4,3,201523,201523,201526,0,3,3
57547,5,2,201528,201528,201530,0,2,2
57548,2,3,201530,201530,201533,0,3,0
57549,6,3,201536,201536,201539,0,3,3
57550,2,2,201538,201539,201541,1,3,0
57551,4,1,201542,201542,201543,0,1,1
57552,1,1,201543,201543,201544,0,1,0
57553,5,1,201548,201548,201549,0,1,4
57554,6,2,201554,201554,201556,0,2,5
57555,6,2,201560,201560,201562,0,2,4
57556,1,1,201561,201562,201563,1,2,0
57557,6,3,201567,201567,201570,0,3,4
57558,3,3,201570,201570,201573,0,3,0
57559,5,2,201575,201575,201577,0,2,2
57560,2,2,201577,201577,201579,0,2,0
57561,6,2,201583,201583,201585,0,2,4
57562,6,1,201589,201589,201590,0,1,4
57563,4,2,201593,201593,201595,0,2,3
57564,4,1,201597,201597,201598,0,1,2
57565,2,3,201599,201599,201602,0,3,1
57566,6,2,201605,201605,201607,0,2,3
57567,6,2,201611,201611,201613,0,2,4
57568,6,3,201617,201617,201620,0,3,4
57569,4,2,201621,201621,201623,0,2,1
57570,2,3,201623,201623,201626,0,3,0
57571,4,3,201627,201627,201630,0,3,1
57572,2,3,201629,201630,201633,1,4,0
57573,4,2,201633,201633,201635,0,2,0
57574,4,1,201637,201637,201638,0,1,2
57575,5,1,201642,201642,201643,0,1,4
57576,4,1,201646,201646,201647,0,1,3
57577,4,3,201650,201650,201653,0,3,3
57578,3,2,201653,201653,201655,0,2,0
57579,5,3,201658,201658,201661,0,3,3
57580,1,2,201659,201661,201663,2,4,0
57581,6,3,201665,201665,201668,0,3,2
57582,5,2,201670,201670,201672,0,2,2
57583,5,3,201675,201675,201678,0,3,3
57584,4,3,201679,201679,201682,0,3,1
57585,5,2,201684,201684,201686,0,2,2
57586,3,3,201687,201687,201690,0,3,1
57587,5,2,201692,201692,201694,0,2,2
57588,6,1,201698,201698,201699,0,1,4
57589,5,3,201703,201703,201706,0,3,4
57590,2,2,201705,201706,201708,1,3,0
57591,5,3,201710,201710,201713,0,3,2
57592,6,2,201716,201716,201718,0,2,3
57593,6,3,201722,201722,201725,0,3,4
57594,4,3,201726,201726,201729,0,3,1
57595,1,3,201727,201729,201732,2,5,0
57596,6,3,201733,201733,201736,0,3,1
57597,4,2,201737,201737,201739,0,2,1
57598,6,1,201743,201743,201744,0,1,4
57599,5,2,201748,201748,201750,0,2,4
57600,1,3,201749,201750,201753,1,4,0
57601,4,2,201753,201753,201755,0,2,0
57602,6,1,201759,201759,201760,0,1,4
57603,2,2,201761,201761,201763,0,2,1
57604,5,2,201766,201766,201768,0,2,3
57605,5,2,201771,201771,201773,0,2,3
57606,1,2,201772,201773,201775,1,3,0
57607,1,3,201773,201775,201778,2,5,0
57608,3,2,201776,201778,201780,2,4,0
57609,5,1,201781,201781,201782,0,1,1
57610,4,3,201785,201785,201788,0,3,3
57611,3,2,201788,201788,201790,0,2,0
57612,5,1,201793,201793,201794,0,1,3
57613,4,1,201797,201797,201798,0,1,3
57614,2,1,201799,201799,201800,0,1,1
57615,6,2,201805,201805,201807,0,2,5
57616,4,2,201809,201809,201811,0,2,2
57617,1,1,201810,201811,201812,1,2,0
57618,6,2,201816,201816,201818,0,2,4
57619,1,2,201817,201818,201820,1,3,0
57620,5,1,201822,201822,201823,0,1,2
57621,4,2,201826,201826,201828,0,2,3
57622,1,3,201827,201828,201831,1,4,0
57623,2,2,201829,201831,201833,2,4,0
57624,5,1,201834,201834,201835,0,1,1
57625,1,1,201835,201835,201836,0,1,0
57626,4,3,201839,201839,201842,0,3,3
57627,4,2,201843,201843,201845,0,2,1
57628,1,3,201844,201845,201848,1,4,0
57629,2,2,201846,201848,201850,2,4,0
57630,6,2,201852,201852,201854,0,2,2
57631,3,3,201855,201855,201858,0,3,1
57632,3,2,201858,201858,201860,0,2,0
57633,3,3,201861,201861,201864,0,3,1
57634,5,1,201866,201866,201867,0,1,2
57635,1,3,201867,201867,201870,0,3,0
57636,3,2,201870,201870,201872,0,2,0
57637,6,3,201876,201876,201879,0,3,4
57638,5,2,201881,201881,201883,0,2,2
57639,2,3,201883,201883,201886,0,3,0
57640,3,3,201886,201886,201889,0,3,0
57641,4,1,201890,201890,201891,0,1,1
57642,4,1,201894,201894,201895,0,1,3
57643,2,2,201896,201896,201898,0,2,1
57644,1,2,201897,201898,201900,1,3,0
57645,4,2,201901,201901,201903,0,2,1
57646,2,2,201903,201903,201905,0,2,0
57647,3,2,201906,201906,201908,0,2,1
57648,1,1,201907,201908,201909,1,2,0
57649,3,2,201910,201910,201912,0,2,1
57650,1,2,201911,201912,201914,1,3,0
57651,4,2,201915,201915,201917,0,2,1
57652,3,3,201918,201918,201921,0,3,1
57653,1,2,201919,201921,201923,2,4,0
57654,1,2,201920,201923,201925,3,5,0
57655,1,2,201921,201925,201927,4,6,0
57656,6,2,201927,201927,201929,0,2,0
57657,5,2,201932,201932,201934,0,2,3
57658,4,3,201936,201936,201939,0,3,2
57659,3,1,201939,201939,201940,0,1,0
57660,2,3,201941,201941,201944,0,3,1
57661,3,1,201944,201944,201945,0,1,0
57662,2,2,201946,201946,201948,0,2,1
57663,4,3,201950,201950,201953,0,3,2
57664,5,2,201955,201955,201957,0,2,2
57665,4,2,201959,201959,201961,0,2,2
57666,6,1,201965,201965,201966,0,1,4
57667,1,3,201966,201966,201969,0,3,0
57668,3,2,201969,201969,201971,0,2,0
57669,3,2,201972,201972,201974,0,2,1
57670,3,2,201975,201975,201977,0,2,1
57671,3,3,201978,201978,201981,0,3,1
57672,3,2,201981,201981,201983,0,2,0
57673,1,3,201982,201983,201986,1,4,0
57674,2,2,201984,201986,201988,2,4,0
57675,5,3,201989,201989,201992,0,3,1
57676,2,2,201991,201992,201994,1,3,0
57677,5,1,201996,201996,201997,0,1,2
57678,1,3,201997,201997,202000,0,3,0
57679,4,2,202001,202001,202003,0,2,1
57680,6,3,202007,202007,202010,0,3,4
57681,5,3,202012,202012,202015,0,3,2
57682,2,3,202014,202015,202018,1,4,0
57683,6,3,202020,202020,202023,0,3,2
57684,5,1,202025,202025,202026,0,1,2
57685,4,1,202029,202029,202030,0,1,3
57686,6,2,202035,202035,202037,0,2,5
57687,5,1,202040,202040,202041,0,1,3
57688,1,3,202041,202041,202044,0,3,0
57689,2,3,202043,202044,202047,1,4,0
57690,3,3,202046,202047,202050,1,4,0
57691,2,2,202048,202050,202052,2,4,0
57692,3,1,202051,202052,202053,1,2,0
57693,2,2,202053,202053,202055,0,2,0
57694,4,2,202057,202057,202059,0,2,2
57695,2,3,202059,202059,202062,0,3,0
57696,5,1,202064,202064,202065,0,1,2
57697,3,3,202067,202067,202070,0,3,2
57698,1,1,202068,202070,202071,2,3,0
57699,4,2,202072,202072,202074,0,2,1
57700,4,3,202076,202076,202079,0,3,2
57701,3,3,202079,202079,202082,0,3,0
57702,4,1,202083,202083,202084,0,1,1
57703,4,2,202087,202087,202089,0,2,3
57704,2,2,202089,202089,202091,0,2,0
57705,6,3,202095,202095,202098,0,3,4
57706,4,1,202099,202099,202100,0,1,1
57707,5,2,202104,202104,202106,0,2,4
57708,3,1,202107,202107,202108,0,1,1
57709,6,1,202113,202113,202114,0,1,5
57710,5,2,202118,202118,202120,0,2,4
57711,1,3,202119,202120,202123,1,4,0
57712,1,3,202120,202123,202126,3,6,0
57713,1,2,202121,202126,202128,5,7,0
57714,5,2,202126,202128,202130,2,4,0
57715,4,3,202130,202130,202133,0,3,0
57716,2,1,202132,202133,202134,1,2,0
57717,2,3,202134,202134,202137,0,3,0
57718,5,3,202139,202139,202142,0,3,2
57719,6,3,202145,202145,202148,0,3,3
57720,2,3,202147,202148,202151,1,4,0
57721,5,3,202152,202152,202155,0,3,1
57722,4,1,202156,202156,202157,0,1,1
57723,4,2,202160,202160,202162,0,2,3
57724,6,3,202166,202166,202169,0,3,4
57725,3,1,202169,202169,202170,0,1,0
57726,1,2,202170,202170,202172,0,2,0
57727,6,1,202176,202176,202177,0,1,4
57728,3,2,202179,202179,202181,0,2,2
57729,5,2,202184,202184,202186,0,2,3
57730,5,1,202189,202189,202190,0,1,3
57731,4,1,202193,202193,202194,0,1,3
57732,1,1,202194,202194,202195,0,1,0
57733,6,1,202200,202200,202201,0,1,5
57734,5,3,202205,202205,202208,0,3,4
57735,6,2,202211,202211,202213,0,2,3
57736,2,1,202213,202213,202214,0,1,0
57737,2,2,202215,202215,202217,0,2,1
57738,1,2,202216,202217,202219,1,3,0
57739,3,3,202219,202219,202222,0,3,0
57740,5,3,202224,202224,202227,0,3,2
57741,6,3,202230,202230,202233,0,3,3
57742,2,1,202232,202233,202234,1,2,0
57743,3,1,202235,202235,202236,0,1,1
57744,4,3,202239,202239,202242,0,3,3
57745,1,3,202240,202242,202245,2,5,0
57746,4,3,202244,202245,202248,1,4,0
57747,4,3,202248,202248,202251,0,3,0
57748,4,1,202252,202252,202253,0,1,1
57749,1,3,202253,202253,202256,0,3,0
57750,1,2,202254,202256,202258,2,4,0
57751,1,3,202255,202258,202261,3,6,0
57752,3,3,202258,202261,202264,3,6,0
57753,1,2,202259,202264,202266,5,7,0
57754,5,1,202264,202266,202267,2,3,0
57755,1,3,202265,202267,202270,2,5,0
57756,5,2,202270,202270,202272,0,2,0
57757,3,3,202273,202273,202276,0,3,1
57758,6,2,202279,202279,202281,0,2,3
57759,2,2,202281,202281,202283,0,2,0
57760,4,2,202285,202285,202287,0,2,2
57761,3,2,202288,202288,202290,0,2,1
57762,5,1,202293,202293,202294,0,1,3
57763,6,2,202299,202299,202301,0,2,5
57764,4,2,202303,202303,202305,0,2,2
57765,3,2,202306,202306,202308,0,2,1
57766,2,2,202308,202308,202310,0,2,0
57767,5,2,202313,202313,202315,0,2,3
57768,2,3,202315,202315,202318,0,3,0
57769,3,3,202318,202318,202321,0,3,0
57770,1,3,202319,202321,202324,2,5,0
57771,1,3,202320,202324,202327,4,7,0
57772,3,2,202323,202327,202329,4,6,0
57773,2,3,202325,202329,202332,4,7,0
57774,4,2,202329,202332,202334,3,5,0
57775,2,2,202331,202334,202336,3,5,0
57776,5,3,202336,202336,202339,0,3,0
57777,6,3,202342,202342,202345,0,3,3
57778,6,1,202348,202348,202349,0,1,3
57779,6,1,202354,202354,202355,0,1,5
57780,6,1,202360,202360,202361,0,1,5
57781,6,1,202366,202366,202367,0,1,5
57782,4,3,202370,202370,202373,0,3,3
57783,6,2,202376,202376,202378,0,2,3
57784,1,3,202377,202378,202381,1,4,0
57785,2,1,202379,202381,202382,2,3,0
57786,4,2,202383,202383,202385,0,2,1
57787,2,1,202385,202385,202386,0,1,0
57788,5,3,202390,202390,202393,0,3,4
57789,1,3,202391,202393,202396,2,5,0
57790,5,3,202396,202396,202399,0,3,0
57791,6,3,202402,202402,202405,0,3,3
57792,1,3,202403,202405,202408,2,5,0
57793,2,2,202405,202408,202410,3,5,0
57794,6,2,202411,202411,202413,0,2,1
57795,4,2,202415,202415,202417,0,2,2
57796,1,1,202416,202417,202418,1,2,0
57797,4,3,202420,202420,202423,0,3,2
57798,3,3,202423,202423,202426,0,3,0
57799,6,1,202429,202429,202430,0,1,3
57800,5,3,202434,202434,202437,0,3,4
57801,2,2,202436,202437,202439,1,3,0
57802,6,2,202442,202442,202444,0,2,3
57803,4,1,202446,202446,202447,0,1,2
57804,6,2,202452,202452,202454,0,2,5
57805,5,1,202457,202457,202458,0,1,3
57806,6,3,202463,202463,202466,0,3,5
57807,4,1,202467,202467,202468,0,1,1
57808,4,2,202471,202471,202473,0,2,3
57809,1,3,202472,202473,202476,1,4,0
57810,2,1,202474,202476,202477,2,3,0
57811,5,3,202479,202479,202482,0,3,2
57812,5,1,202484,202484,202485,0,1,2
57813,4,2,202488,202488,202490,0,2,3
57814,4,2,202492,202492,202494,0,2,2
57815,1,3,202493,202494,202497,1,4,0
57816,6,1,202499,202499,202500,0,1,2
57817,5,2,202504,202504,202506,0,2,4
57818,2,3,202506,202506,202509,0,3,0
57819,5,2,202511,202511,202513,0,2,2
57820,6,1,202517,202517,202518,0,1,4
57821,1,2,202518,202518,202520,0,2,0
57822,6,1,202524,202524,202525,0,1,4
57823,1,2,202525,202525,202527,0,2,0
57824,4,2,202529,202529,202531,0,2,2
57825,2,3,202531,202531,202534,0,3,0
57826,2,3,202533,202534,202537,1,4,0
57827,2,2,202535,202537,202539,2,4,0
57828,1,2,202536,202539,202541,3,5,0
57829,6,3,202542,202542,202545,0,3,1
57830,2,1,202544,202545,202546,1,2,0
57831,3,1,202547,202547,202548,0,1,1
57832,4,1,202551,202551,202552,0,1,3
57833,3,2,202554,202554,202556,0,2,2
57834,2,1,202556,202556,202557,0,1,0
57835,4,1,202560,202560,202561,0,1,3
57836,2,1,202562,202562,202563,0,1,1
57837,1,3,202563,202563,202566,0,3,0
57838,6,1,202569,202569,202570,0,1,3
57839,2,2,202571,202571,202573,0,2,1
57840,6,1,202577,202577,202578,0,1,4
57841,5,1,202582,202582,202583,0,1,4
57842,2,1,202584,202584,202585,0,1,1
57843,2,2,202586,202586,202588,0,2,1
57844,3,3,202589,202589,202592,0,3,1
57845,1,1,202590,202592,202593,2,3,0
57846,2,2,202592,202593,202595,1,3,0
57847,5,2,202597,202597,202599,0,2,2
57848,2,1,202599,202599,202600,0,1,0
57849,2,2,202601,202601,202603,0,2,1
57850,6,1,202607,202607,202608,0,1,4
57851,1,2,202608,202608,202610,0,2,0
57852,2,2,202610,202610,202612,0,2,0
57853,3,2,202613,202613,202615,0,2,1
57854,1,2,202614,202615,202617,1,3,0
57855,4,1,202618,202618,202619,0,1,1
57856,4,1,202622,202622,202623,0,1,3
57857,5,3,202627,202627,202630,0,3,4
57858,2,3,202629,202630,202633,1,4,0
57859,2,3,202631,202633,202636,2,5,0
57860,2,2,202633,202636,202638,3,5,0
57861,3,1,202636,202638,202639,2,3,0
57862,2,1,202638,202639,202640,1,2,0
57863,3,2,202641,202641,202643,0,2,1
57864,2,1,202643,202643,202644,0,1,0
57865,1,3,202644,202644,202647,0,3,0
57866,5,3,202649,202649,202652,0,3,2
57867,6,3,202655,202655,202658,0,3,3
57868,2,2,202657,202658,202660,1,3,0
57869,1,2,202658,202660,202662,2,4,0
57870,1,1,202659,202662,202663,3,4,0
57871,2,1,202661,202663,202664,2,3,0
57872,1,1,202662,202664,202665,2,3,0
57873,1,2,202663,202665,202667,2,4,0
57874,4,3,202667,202667,202670,0,3,0
57875,2,1,202669,202670,202671,1,2,0
57876,4,3,202673,202673,202676,0,3,2
57877,4,3,202677,202677,202680,0,3,1
57878,2,2,202679,202680,202682,1,3,0
57879,3,1,202682,202682,202683,0,1,0
57880,2,2,202684,202684,202686,0,2,1
57881,5,1,202689,202689,202690,0,1,3
57882,4,3,202693,202693,202696,0,3,3
57883,1,3,202694,202696,202699,2,5,0
57884,3,1,202697,202699,202700,2,3,0
57885,5,3,202702,202702,202705,0,3,2
57886,4,3,202706,202706,202709,0,3,1
57887,1,2,202707,202709,202711,2,4,0
57888,6,3,202713,202713,202716,0,3,2
57889,4,3,202717,202717,202720,0,3,1
57890,4,2,202721,202721,202723,0,2,1
57891,5,1,202726,202726,202727,0,1,3
57892,6,1,202732,202732,202733,0,1,5
57893,3,1,202735,202735,202736,0,1,2
57894,1,1,202736,202736,202737,0,1,0
57895,5,2,202741,202741,202743,0,2,4
57896,5,3,202746,202746,202749,0,3,3
57897,1,2,202747,202749,202751,2,4,0
57898,3,1,202750,202751,202752,1,2,0
57899,4,1,202754,202754,202755,0,1,2
57900,4,2,202758,202758,202760,0,2,3
57901,3,1,202761,202761,202762,0,1,1
57902,2,2,202763,202763,202765,0,2,1
57903,3,1,202766,202766,202767,0,1,1
57904,3,2,202769,202769,202771,0,2,2
57905,4,1,202773,202773,202774,0,1,2
57906,5,3,202778,202778,202781,0,3,4
57907,6,2,202784,202784,202786,0,2,3
57908,3,1,202787,202787,202788,0,1,1
57909,1,2,202788,202788,202790,0,2,0
57910,5,1,202793,202793,202794,0,1,3
57911,5,1,202798,202798,202799,0,1,4
57912,1,3,202799,202799,202802,0,3,0
57913,3,2,202802,202802,202804,0,2,0
57914,1,2,202803,202804,202806,1,3,0
57915,4,2,202807,202807,202809,0,2,1
57916,2,1,202809,202809,202810,0,1,0
57917,1,3,202810,202810,202813,0,3,0
57918,3,1,202813,202813,202814,0,1,0
57919,2,1,202815,202815,202816,0,1,1
57920,5,3,202820,202820,202823,0,3,4
57921,5,3,202825,202825,202828,0,3,2
57922,2,3,202827,202828,202831,1,4,0
57923,1,3,202828,202831,202834,3,6,0
57924,5,2,202833,202834,202836,1,3,0
57925,2,2,202835,202836,202838,1,3,0
57926,1,1,202836,202838,202839,2,3,0
57927,5,1,202841,202841,202842,0,1,2
57928,6,3,202847,202847,202850,0,3,5
57929,4,1,202851,202851,202852,0,1,1
57930,3,3,202854,202854,202857,0,3,2
57931,2,1,202856,202857,202858,1,2,0
57932,4,2,202860,202860,202862,0,2,2
57933,6,1,202866,202866,202867,0,1,4
57934,3,3,202869,202869,202872,0,3,2
57935,2,2,202871,202872,202874,1,3,0
57936,6,3,202877,202877,202880,0,3,3
57937,1,3,202878,202880,202883,2,5,0
57938,2,2,202880,202883,202885,3,5,0
57939,6,3,202886,202886,202889,0,3,1
57940,1,2,202887,202889,202891,2,4,0
57941,2,2,202889,202891,202893,2,4,0
57942,3,3,202892,202893,202896,1,4,0
57943,4,1,202896,202896,202897,0,1,0
57944,5,1,202901,202901,202902,0,1,4
57945,3,1,202904,202904,202905,0,1,2
57946,2,1,202906,202906,202907,0,1,1
57947,5,2,202911,202911,202913,0,2,4
57948,5,2,202916,202916,202918,0,2,3
57949,3,1,202919,202919,202920,0,1,1
57950,5,3,202924,202924,202927,0,3,4
57951,5,3,202929,202929,202932,0,3,2
57952,5,2,202934,202934,202936,0,2,2
57953,2,3,202936,202936,202939,0,3,0
57954,5,2,202941,202941,202943,0,2,2
57955,2,2,202943,202943,202945,0,2,0
57956,4,2,202947,202947,202949,0,2,2
57957,5,2,202952,202952,202954,0,2,3
57958,6,1,202958,202958,202959,0,1,4
57959,4,2,202962,202962,202964,0,2,3
57960,1,3,202963,202964,202967,1,4,0
57961,4,3,202967,202967,202970,0,3,0
57962,1,2,202968,202970,202972,2,4,0
57963,5,3,202973,202973,202976,0,3,1
57964,5,1,202978,202978,202979,0,1,2
57965,4,2,202982,202982,202984,0,2,3
57966,6,2,202988,202988,202990,0,2,4
57967,3,3,202991,202991,202994,0,3,1
57968,6,1,202997,202997,202998,0,1,3
57969,5,3,203002,203002,203005,0,3,4
57970,5,2,203007,203007,203009,0,2,2
57971,4,2,203011,203011,203013,0,2,2
57972,2,1,203013,203013,203014,0,1,0
57973,2,2,203015,203015,203017,0,2,1
57974,1,3,203016,203017,203020,1,4,0
57975,3,1,203019,203020,203021,1,2,0
57976,3,3,203022,203022,203025,0,3,1
57977,3,1,203025,203025,203026,0,1,0
57978,4,1,203029,203029,203030,0,1,3
57979,5,2,203034,203034,203036,0,2,4
57980,5,3,203039,203039,203042,0,3,3
57981,2,1,203041,203042,203043,1,2,0
57982,1,3,203042,203043,203046,1,4,0
57983,4,3,203046,203046,203049,0,3,0
57984,4,1,203050,203050,203051,0,1,1
57985,6,1,203056,203056,203057,0,1,5
57986,6,1,203062,203062,203063,0,1,5
57987,4,1,203066,203066,203067,0,1,3
57988,3,3,203069,203069,203072,0,3,2
57989,3,2,203072,203072,203074,0,2,0
57990,5,3,203077,203077,203080,0,3,3
57991,3,2,203080,203080,203082,0,2,0
57992,4,3,203084,203084,203087,0,3,2
57993,5,2,203089,203089,203091,0,2,2
57994,4,3,203093,203093,203096,0,3,2
57995,3,1,203096,203096,203097,0,1,0
57996,5,2,203101,203101,203103,0,2,4
57997,5,1,203106,203106,203107,0,1,3
57998,4,1,203110,203110,203111,0,1,3
57999,5,3,203115,203115,203118,0,3,4
58000,5,2,203120,203120,203122,0,2,2
58001,1,1,203121,203122,203123,1,2,0
58002,4,2,203125,203125,203127,0,2,2
58003,5,3,203130,203130,203133,0,3,3
58004,6,1,203136,203136,203137,0,1,3
58005,4,1,203140,203140,203141,0,1,3
58006,6,2,203146,203146,203148,0,2,5
58007,6,3,203152,203152,203155,0,3,4
58008,2,3,203154,203155,203158,1,4,0
58009,3,2,203157,203158,203160,1,3,0
58010,5,3,203162,203162,203165,0,3,2
58011,3,1,203165,203165,203166,0,1,0
58012,4,1,203169,203169,203170,0,1,3
58013,5,1,203174,203174,203175,0,1,4
58014,2,1,203176,203176,203177,0,1,1
58015,5,1,203181,203181,203182,0,1,4
58016,3,2,203184,203184,203186,0,2,2
58017,2,2,203186,203186,203188,0,2,0
58018,5,3,203191,203191,203194,0,3,3
58019,3,1,203194,203194,203195,0,1,0
58020,4,1,203198,203198,203199,0,1,3
58021,3,3,203201,203201,203204,0,3,2
58022,1,2,203202,203204,203206,2,4,0
58023,1,2,203203,203206,203208,3,5,0
58024,2,3,203205,203208,203211,3,6,0
58025,5,3,203210,203211,203214,1,4,0
58026,2,3,203212,203214,203217,2,5,0
58027,1,3,203213,203217,203220,4,7,0
58028,5,2,203218,203220,203222,2,4,0
58029,2,3,203220,203222,203225,2,5,0
58030,2,1,203222,203225,203226,3,4,0
58031,3,1,203225,203226,203227,1,2,0
58032,6,3,203231,203231,203234,0,3,4
58033,2,2,203233,203234,203236,1,3,0
58034,6,2,203239,203239,203241,0,2,3
58035,4,3,203243,203243,203246,0,3,2
58036,4,3,203247,203247,203250,0,3,1
58037,1,3,203248,203250,203253,2,5,0
58038,4,2,203252,203253,203255,1,3,0
58039,2,1,203254,203255,203256,1,2,0
58040,2,3,203256,203256,203259,0,3,0
58041,6,3,203262,203262,203265,0,3,3
58042,6,2,203268,203268,203270,0,2,3
58043,3,2,203271,203271,203273,0,2,1
58044,6,1,203277,203277,203278,0,1,4
58045,3,3,203280,203280,203283,0,3,2
58046,4,1,203284,203284,203285,0,1,1
58047,2,3,203286,203286,203289,0,3,1
58048,3,3,203289,203289,203292,0,3,0
58049,1,3,203290,203292,203295,2,5,0
58050,4,1,203294,203295,203296,1,2,0
58051,4,2,203298,203298,203300,0,2,2
58052,1,1,203299,203300,203301,1,2,0
58053,6,3,203305,203305,203308,0,3,4
58054,4,3,203309,203309,203312,0,3,1
58055,2,1,203311,203312,203313,1,2,0
58056,6,3,203317,203317,203320,0,3,4
58057,5,3,203322,203322,203325,0,3,2
58058,6,1,203328,203328,203329,0,1,3
58059,4,2,203332,203332,203334,0,2,3
58060,2,2,203334,203334,203336,0,2,0
58061,6,3,203340,203340,203343,0,3,4
58062,3,2,203343,203343,203345,0,2,0
58063,3,1,203346,203346,203347,0,1,1
58064,6,1,203352,203352,203353,0,1,5
58065,4,3,203356,203356,203359,0,3,3
58066,3,2,203359,203359,203361,0,2,0
58067,2,3,203361,203361,203364,0,3,0
58068,1,1,203362,203364,203365,2,3,0
58069,3,3,203365,203365,203368,0,3,0
58070,1,3,203366,203368,203371,2,5,0
58071,6,2,203372,203372,203374,0,2,1
58072,4,1,203376,203376,203377,0,1,2
58073,4,1,203380,203380,203381,0,1,3
58074,5,2,203385,203385,203387,0,2,4
58075,2,1,203387,203387,203388,0,1,0
58076,4,3,203391,203391,203394,0,3,3
58077,6,2,203397,203397,203399,0,2,3
58078,1,1,203398,203399,203400,1,2,0
58079,2,3,203400,203400,203403,0,3,0
58080,5,3,203405,203405,203408,0,3,2
58081,2,1,203407,203408,203409,1,2,0
58082,6,1,203413,203413,203414,0,1,4
58083,5,1,203418,203418,203419,0,1,4
58084,1,1,203419,203419,203420,0,1,0
58085,6,1,203425,203425,203426,0,1,5
58086,3,3,203428,203428,203431,0,3,2
58087,6,2,203434,203434,203436,0,2,3
58088,6,3,203440,203440,203443,0,3,4
58089,2,2,203442,203443,203445,1,3,0
58090,2,2,203444,203445,203447,1,3,0
58091,4,2,203448,203448,203450,0,2,1
58092,3,3,203451,203451,203454,0,3,1
58093,3,2,203454,203454,203456,0,2,0
58094,3,2,203457,203457,203459,0,2,1
58095,5,3,203462,203462,203465,0,3,3
58096,5,3,203467,203467,203470,0,3,2
58097,1,2,203468,203470,203472,2,4,0
58098,2,3,203470,203472,203475,2,5,0
58099,4,3,203474,203475,203478,1,4,0
58100,4,1,203478,203478,203479,0,1,0
58101,2,3,203480,203480,203483,0,3,1
58102,2,2,203482,203483,203485,1,3,0
58103,5,1,203487,203487,203488,0,1,2
58104,1,3,203488,203488,203491,0,3,0
58105,4,2,203492,203492,203494,0,2,1
58106,2,1,203494,203494,203495,0,1,0
58107,1,1,203495,203495,203496,0,1,0
58108,5,1,203500,203500,203501,0,1,4
58109,6,2,203506,203506,203508,0,2,5
58110,5,3,203511,203511,203514,0,3,3
58111,3,3,203514,203514,203517,0,3,0
58112,4,3,203518,203518,203521,0,3,1
58113,1,3,203519,203521,203524,2,5,0
58114,6,3,203525,203525,203528,0,3,1
58115,6,1,203531,203531,203532,0,1,3
58116,3,1,203534,203534,203535,0,1,2
58117,3,3,203537,203537,203540,0,3,2
58118,1,3,203538,203540,203543,2,5,0
58119,2,3,203540,203543,203546,3,6,0
58120,1,2,203541,203546,203548,5,7,0
58121,4,2,203545,203548,203550,3,5,0
58122,5,1,203550,203550,203551,0,1,0
58123,3,3,203553,203553,203556,0,3,2
58124,2,3,203555,203556,203559,1,4,0
58125,4,3,203559,203559,203562,0,3,0
58126,3,2,203562,203562,203564,0,2,0
58127,5,1,203567,203567,203568,0,1,3
58128,4,2,203571,203571,203573,0,2,3
58129,5,2,203576,203576,203578,0,2,3
58130,4,3,203580,203580,203583,0,3,2
58131,1,2,203581,203583,203585,2,4,0
58132,1,2,203582,203585,203587,3,5,0
58133,2,2,203584,203587,203589,3,5,0
58134,6,2,203590,203590,203592,0,2,1
58135,2,2,203592,203592,203594,0,2,0
58136,5,3,203597,203597,203600,0,3,3
58137,6,2,203603,203603,203605,0,2,3
58138,6,2,203609,203609,203611,0,2,4
58139,6,1,203615,203615,203616,0,1,4
58140,6,1,203621,203621,203622,0,1,5
58141,1,1,203622,203622,203623,0,1,0
58142,6,3,203628,203628,203631,0,3,5
58143,2,1,203630,203631,203632,1,2,0
58144,5,1,203635,203635,203636,0,1,3
58145,3,1,203638,203638,203639,0,1,2
58146,3,3,203641,203641,203644,0,3,2
58147,1,2,203642,203644,203646,2,4,0
58148,4,1,203646,203646,203647,0,1,0
58149,6,2,203652,203652,203654,0,2,5
58150,3,3,203655,203655,203658,0,3,1
58151,6,3,203661,203661,203664,0,3,3
58152,2,1,203663,203664,203665,1,2,0
58153,2,1,203665,203665,203666,0,1,0
58154,6,1,203671,203671,203672,0,1,5
58155,6,1,203677,203677,203678,0,1,5
58156,1,2,203678,203678,203680,0,2,0
58157,1,1,203679,203680,203681,1,2,0
58158,1,2,203680,203681,203683,1,3,0
58159,6,2,203686,203686,203688,0,2,3
58160,1,1,203687,203688,203689,1,2,0
58161,3,1,203690,203690,203691,0,1,1
58162,4,2,203694,203694,203696,0,2,3
58163,6,1,203700,203700,203701,0,1,4
58164,6,2,203706,203706,203708,0,2,5
58165,3,1,203709,203709,203710,0,1,1
58166,2,3,203711,203711,203714,0,3,1
58167,2,1,203713,203714,203715,1,2,0
58168,2,2,203715,203715,203717,0,2,0
58169,3,3,203718,203718,203721,0,3,1
58170,6,3,203724,203724,203727,0,3,3
58171,2,3,203726,203727,203730,1,4,0
58172,6,3,203732,203732,203735,0,3,2
58173,2,3,203734,203735,203738,1,4,0
58174,5,2,203739,203739,203741,0,2,1
58175,5,1,203744,203744,203745,0,1,3
58176,4,1,203748,203748,203749,0,1,3
58177,2,2,203750,203750,203752,0,2,1
58178,1,3,203751,203752,203755,1,4,0
58179,6,2,203757,203757,203759,0,2,2
58180,6,3,203763,203763,203766,0,3,4
58181,3,2,203766,203766,203768,0,2,0
58182,4,2,203770,203770,203772,0,2,2
58183,5,3,203775,203775,203778,0,3,3
58184,1,2,203776,203778,203780,2,4,0
58185,4,2,203780,203780,203782,0,2,0
58186,3,3,203783,203783,203786,0,3,1
58187,1,1,203784,203786,203787,2,3,0
58188,5,2,203789,203789,203791,0,2,2
58189,3,2,203792,203792,203794,0,2,1
58190,2,2,203794,203794,203796,0,2,0
58191,2,3,203796,203796,203799,0,3,0
58192,3,3,203799,203799,203802,0,3,0
58193,2,3,203801,203802,203805,1,4,0
58194,6,1,203807,203807,203808,0,1,2
58195,4,1,203811,203811,203812,0,1,3
58196,5,3,203816,203816,203819,0,3,4
58197,4,1,203820,203820,203821,0,1,1
58198,3,2,203823,203823,203825,0,2,2
58199,6,2,203829,203829,203831,0,2,4
58200,2,1,203831,203831,203832,0,1,0
58201,4,1,203835,203835,203836,0,1,3
58202,5,2,203840,203840,203842,0,2,4
58203,5,1,203845,203845,203846,0,1,3
58204,1,3,203846,203846,203849,0,3,0
58205,4,1,203850,203850,203851,0,1,1
58206,6,1,203856,203856,203857,0,1,5
58207,4,1,203860,203860,203861,0,1,3
58208,6,3,203866,203866,203869,0,3,5
58209,2,3,203868,203869,203872,1,4,0
58210,4,1,203872,203872,203873,0,1,0
58211,5,1,203877,203877,203878,0,1,4
58212,4,3,203881,203881,203884,0,3,3
58213,3,3,203884,203884,203887,0,3,0
58214,1,1,203885,203887,203888,2,3,0
58215,1,2,203886,203888,203890,2,4,0
58216,1,3,203887,203890,203893,3,6,0
58217,3,2,203890,203893,203895,3,5,0
58218,4,3,203894,203895,203898,1,4,0
58219,2,3,203896,203898,203901,2,5,0
58220,1,2,203897,203901,203903,4,6,0
58221,1,2,203898,203903,203905,5,7,0
58222,6,3,203904,203905,203908,1,4,0
58223,5,1,203909,203909,203910,0,1,1
58224,4,2,203913,203913,203915,0,2,3
58225,4,1,203917,203917,203918,0,1,2
58226,3,3,203920,203920,203923,0,3,2
58227,4,2,203924,203924,203926,0,2,1
58228,6,3,203930,203930,203933,0,3,4
58229,3,3,203933,203933,203936,0,3,0
58230,2,2,203935,203936,203938,1,3,0
58231,3,1,203938,203938,203939,0,1,0
58232,5,2,203943,203943,203945,0,2,4
58233,6,2,203949,203949,203951,0,2,4
58234,3,1,203952,203952,203953,0,1,1
58235,1,2,203953,203953,203955,0,2,0
58236,6,2,203959,203959,203961,0,2,4
58237,3,2,203962,203962,203964,0,2,1
58238,5,3,203967,203967,203970,0,3,3
58239,2,3,203969,203970,203973,1,4,0
58240,5,3,203974,203974,203977,0,3,1
58241,1,3,203975,203977,203980,2,5,0
58242,5,2,203980,203980,203982,0,2,0
58243,6,1,203986,203986,203987,0,1,4
58244,4,1,203990,203990,203991,0,1,3
58245,2,2,203992,203992,203994,0,2,1
58246,4,1,203996,203996,203997,0,1,2
58247,4,2,204000,204000,204002,0,2,3
58248,5,1,204005,204005,204006,0,1,3
58249,4,1,204009,204009,204010,0,1,3
58250,3,3,204012,204012,204015,0,3,2
58251,1,3,204013,204015,204018,2,5,0
58252,5,1,204018,204018,204019,0,1,0
58253,3,3,204021,204021,204024,0,3,2
58254,3,2,204024,204024,204026,0,2,0
58255,1,3,204025,204026,204029,1,4,0
58256,2,2,204027,204029,204031,2,4,0
58257,1,1,204028,204031,204032,3,4,0
58258,2,2,204030,204032,204034,2,4,0
58259,5,2,204035,204035,204037,0,2,1
58260,3,2,204038,204038,204040,0,2,1
58261,5,3,204043,204043,204046,0,3,3
58262,2,3,204045,204046,204049,1,4,0
58263,2,1,204047,204049,204050,2,3,0
58264,6,3,204053,204053,204056,0,3,3
58265,3,2,204056,204056,204058,0,2,0
58266,1,3,204057,204058,204061,1,4,0
58267,2,3,204059,204061,204064,2,5,0
58268,2,3,204061,204064,204067,3,6,0
58269,5,2,204066,204067,204069,1,3,0
58270,4,2,204070,204070,204072,0,2,1
58271,3,2,204073,204073,204075,0,2,1
58272,1,1,204074,204075,204076,1,2,0
58273,3,3,204077,204077,204080,0,3,1
58274,1,3,204078,204080,204083,2,5,0
58275,2,1,204080,204083,204084,3,4,0
58276,2,1,204082,204084,204085,2,3,0
58277,4,2,204086,204086,204088,0,2,1
58278,5,3,204091,204091,204094,0,3,3
58279,4,2,204095,204095,204097,0,2,1
58280,3,3,204098,204098,204101,0,3,1
58281,6,2,204104,204104,204106,0,2,3
58282,3,3,204107,204107,204110,0,3,1
58283,5,2,204112,204112,204114,0,2,2
58284,6,2,204118,204118,204120,0,2,4
58285,4,3,204122,204122,204125,0,3,2
58286,4,2,204126,204126,204128,0,2,1
58287,3,3,204129,204129,204132,0,3,1
58288,4,3,204133,204133,204136,0,3,1
58289,5,2,204138,204138,204140,0,2,2
58290,5,2,204143,204143,204145,0,2,3
58291,4,1,204147,204147,204148,0,1,2
58292,2,2,204149,204149,204151,0,2,1
58293,6,3,204155,204155,204158,0,3,4
58294,3,1,204158,204158,204159,0,1,0
58295,1,3,204159,204159,204162,0,3,0
58296,2,1,204161,204162,204163,1,2,0
58297,6,2,204167,204167,204169,0,2,4
58298,2,1,204169,204169,204170,0,1,0
58299,4,1,204173,204173,204174,0,1,3
58300,6,1,204179,204179,204180,0,1,5
58301,5,2,204184,204184,204186,0,2,4
58302,5,2,204189,204189,204191,0,2,3
58303,5,2,204194,204194,204196,0,2,3
58304,2,3,204196,204196,204199,0,3,0
58305,6,3,204202,204202,204205,0,3,3
58306,5,3,204207,204207,204210,0,3,2
58307,1,1,204208,204210,204211,2,3,0
58308,5,1,204213,204213,204214,0,1,2
58309,1,2,204214,204214,204216,0,2,0
58310,6,2,204220,204220,204222,0,2,4
58311,5,1,204225,204225,204226,0,1,3
58312,3,1,204228,204228,204229,0,1,2
58313,2,2,204230,204230,204232,0,2,1
58314,1,2,204231,204232,204234,1,3,0
58315,5,3,204236,204236,204239,0,3,2
58316,2,1,204238,204239,204240,1,2,0
58317,2,2,204240,204240,204242,0,2,0
58318,3,2,204243,204243,204245,0,2,1
58319,3,1,204246,204246,204247,0,1,1
58320,3,3,204249,204249,204252,0,3,2
58321,2,3,204251,204252,204255,1,4,0
58322,5,3,204256,204256,204259,0,3,1
58323,6,2,204262,204262,204264,0,2,3
58324,5,3,204267,204267,204270,0,3,3
58325,3,3,204270,204270,204273,0,3,0
58326,6,3,204276,204276,204279,0,3,3
58327,2,2,204278,204279,204281,1,3,0
58328,3,2,204281,204281,204283,0,2,0
58329,6,2,204287,204287,204289,0,2,4
58330,2,1,204289,204289,204290,0,1,0
58331,4,3,204293,204293,204296,0,3,3
58332,2,2,204295,204296,204298,1,3,0
58333,6,2,204301,204301,204303,0,2,3
58334,3,1,204304,204304,204305,0,1,1
58335,5,2,204309,204309,204311,0,2,4
58336,6,3,204315,204315,204318,0,3,4
58337,1,1,204316,204318,204319,2,3,0
58338,1,1,204317,204319,204320,2,3,0
58339,1,3,204318,204320,204323,2,5,0
58340,3,1,204321,204323,204324,2,3,0
58341,6,2,204327,204327,204329,0,2,3
58342,5,2,204332,204332,204334,0,2,3
58343,2,2,204334,204334,204336,0,2,0
58344,6,1,204340,204340,204341,0,1,4
58345,6,1,204346,204346,204347,0,1,5
58346,2,3,204348,204348,204351,0,3,1
58347,1,1,204349,204351,204352,2,3,0
58348,2,1,204351,204352,204353,1,2,0
58349,4,3,204355,204355,204358,0,3,2
58350,4,1,204359,204359,204360,0,1,1
58351,1,2,204360,204360,204362,0,2,0
58352,4,1,204364,204364,204365,0,1,2
58353,3,2,204367,204367,204369,0,2,2
58354,3,1,204370,204370,204371,0,1,1
58355,1,1,204371,204371,204372,0,1,0
58356,6,3,204377,204377,204380,0,3,5
58357,1,3,204378,204380,204383,2,5,0
58358,5,3,204383,204383,204386,0,3,0
58359,5,1,204388,204388,204389,0,1,2
58360,1,3,204389,204389,204392,0,3,0
58361,1,3,204390,204392,204395,2,5,0
58362,3,3,204393,204395,204398,2,5,0
58363,5,2,204398,204398,204400,0,2,0
58364,1,1,204399,204400,204401,1,2,0
58365,2,2,204401,204401,204403,0,2,0
58366,4,3,204405,204405,204408,0,3,2
58367,2,1,204407,204408,204409,1,2,0
58368,4,3,204411,204411,204414,0,3,2
58369,5,1,204416,204416,204417,0,1,2
58370,2,3,204418,204418,204421,0,3,1
58371,4,1,204422,204422,204423,0,1,1
58372,2,3,204424,204424,204427,0,3,1
58373,1,3,204425,204427,204430,2,5,0
58374,2,3,204427,204430,204433,3,6,0
58375,2,2,204429,204433,204435,4,6,0
58376,3,2,204432,204435,204437,3,5,0
58377,4,1,204436,204437,204438,1,2,0
58378,6,3,204442,204442,204445,0,3,4
58379,3,3,204445,204445,204448,0,3,0
58380,6,3,204451,204451,204454,0,3,3
58381,1,3,204452,204454,204457,2,5,0
58382,2,1,204454,204457,204458,3,4,0
58383,1,1,204455,204458,204459,3,4,0
58384,1,3,204456,204459,204462,3,6,0
58385,1,3,204457,204462,204465,5,8,0
58386,4,1,204461,204465,204466,4,5,0
58387,3,3,204464,204466,204469,2,5,0
58388,5,1,204469,204469,204470,0,1,0
58389,5,1,204474,204474,204475,0,1,4
58390,6,2,204480,204480,204482,0,2,5
58391,3,1,204483,204483,204484,0,1,1
58392,1,3,204484,204484,204487,0,3,0
58393,6,2,204490,204490,204492,0,2,3
58394,1,2,204491,204492,204494,1,3,0
58395,6,1,204497,204497,204498,0,1,3
58396,5,2,204502,204502,204504,0,2,4
58397,4,1,204506,204506,204507,0,1,2
58398,1,2,204507,204507,204509,0,2,0
58399,1,3,204508,204509,204512,1,4,0
58400,1,2,204509,204512,204514,3,5,0
58401,2,2,204511,204514,204516,3,5,0
58402,4,1,204515,204516,204517,1,2,0
58403,3,1,204518,204518,204519,0,1,1
58404,4,3,204522,204522,204525,0,3,3
58405,2,3,204524,204525,204528,1,4,0
58406,3,3,204527,204528,204531,1,4,0
58407,1,3,204528,204531,204534,3,6,0
58408,6,1,204534,204534,204535,0,1,0
58409,6,2,204540,204540,204542,0,2,5
58410,3,2,204543,204543,204545,0,2,1
58411,3,3,204546,204546,204549,0,3,1
58412,6,2,204552,204552,204554,0,2,3
58413,4,2,204556,204556,204558,0,2,2
58414,3,2,204559,204559,204561,0,2,1
58415,3,1,204562,204562,204563,0,1,1
58416,6,1,204568,204568,204569,0,1,5
58417,1,2,204569,204569,204571,0,2,0
58418,1,1,204570,204571,204572,1,2,0
58419,1,3,204571,204572,204575,1,4,0
58420,2,3,204573,204575,204578,2,5,0
58421,2,2,204575,204578,204580,3,5,0
58422,3,3,204578,204580,204583,2,5,0
58423,3,3,204581,204583,204586,2,5,0
58424,2,2,204583,204586,204588,3,5,0
58425,2,1,204585,204588,204589,3,4,0
58426,4,3,204589,204589,204592,0,3,0
58427,6,2,204595,204595,204597,0,2,3
58428,2,2,204597,204597,204599,0,2,0
58429,5,3,204602,204602,204605,0,3,3
58430,5,1,204607,204607,204608,0,1,2
58431,5,1,204612,204612,204613,0,1,4
58432,6,3,204618,204618,204621,0,3,5
58433,3,1,204621,204621,204622,0,1,0
58434,2,2,204623,204623,204625,0,2,1
58435,5,2,204628,204628,204630,0,2,3
58436,2,2,204630,204630,204632,0,2,0
58437,4,2,204634,204634,204636,0,2,2
58438,2,2,204636,204636,204638,0,2,0
58439,3,1,204639,204639,204640,0,1,1
58440,5,1,204644,204644,204645,0,1,4
58441,2,2,204646,204646,204648,0,2,1
58442,2,3,204648,204648,204651,0,3,0
58443,2,1,204650,204651,204652,1,2,0
58444,3,2,204653,204653,204655,0,2,1
58445,6,1,204659,204659,204660,0,1,4
58446,5,2,204664,204664,204666,0,2,4
58447,6,3,204670,204670,204673,0,3,4
58448,5,1,204675,204675,204676,0,1,2
58449,3,1,204678,204678,204679,0,1,2
58450,5,3,204683,204683,204686,0,3,4
58451,3,3,204686,204686,204689,0,3,0
58452,1,3,204687,204689,204692,2,5,0
58453,5,3,204692,204692,204695,0,3,0
58454,6,1,204698,204698,204699,0,1,3
58455,4,3,204702,204702,204705,0,3,3
58456,4,1,204706,204706,204707,0,1,1
58457,5,2,204711,204711,204713,0,2,4
58458,4,3,204715,204715,204718,0,3,2
58459,5,3,204720,204720,204723,0,3,2
58460,6,1,204726,204726,204727,0,1,3
58461,1,1,204727,204727,204728,0,1,0
58462,5,3,204732,204732,204735,0,3,4
58463,6,3,204738,204738,204741,0,3,3
58464,3,3,204741,204741,204744,0,3,0
58465,2,1,204743,204744,204745,1,2,0
58466,2,1,204745,204745,204746,0,1,0
58467,6,1,204751,204751,204752,0,1,5
58468,5,1,204756,204756,204757,0,1,4
58469,6,3,204762,204762,204765,0,3,5
58470,2,3,204764,204765,204768,1,4,0
58471,1,2,204765,204768,204770,3,5,0
58472,6,3,204771,204771,204774,0,3,1
58473,4,3,204775,204775,204778,0,3,1
58474,5,1,204780,204780,204781,0,1,2
58475,5,1,204785,204785,204786,0,1,4
58476,1,2,204786,204786,204788,0,2,0
58477,3,3,204789,204789,204792,0,3,1
58478,5,3,204794,204794,204797,0,3,2
58479,3,2,204797,204797,204799,0,2,0
58480,1,2,204798,204799,204801,1,3,0
58481,1,2,204799,204801,204803,2,4,0
58482,5,2,204804,204804,204806,0,2,1
58483,5,2,204809,204809,204811,0,2,3
58484,3,2,204812,204812,204814,0,2,1
58485,1,2,204813,204814,204816,1,3,0
58486,6,1,204819,204819,204820,0,1,3
58487,4,1,204823,204823,204824,0,1,3
58488,6,1,204829,204829,204830,0,1,5
58489,6,2,204835,204835,204837,0,2,5
58490,4,2,204839,204839,204841,0,2,2
58491,1,2,204840,204841,204843,1,3,0
58492,2,3,204842,204843,204846,1,4,0
58493,1,3,204843,204846,204849,3,6,0
58494,2,2,204845,204849,204851,4,6,0
58495,1,2,204846,204851,204853,5,7,0
58496,3,2,204849,204853,204855,4,6,0
58497,3,2,204852,204855,204857,3,5,0
58498,4,2,204856,204857,204859,1,3,0
58499,4,1,204860,204860,204861,0,1,1
58500,4,1,204864,204864,204865,0,1,3
58501,6,1,204870,204870,204871,0,1,5
58502,1,3,204871,204871,204874,0,3,0
58503,4,1,204875,204875,204876,0,1,1
58504,5,2,204880,204880,204882,0,2,4
58505,2,2,204882,204882,204884,0,2,0
58506,4,2,204886,204886,204888,0,2,2
58507,3,3,204889,204889,204892,0,3,1
58508,1,1,204890,204892,204893,2,3,0
58509,4,3,204894,204894,204897,0,3,1
58510,3,1,204897,204897,204898,0,1,0
58511,2,1,204899,204899,204900,0,1,1
58512,3,1,204902,204902,204903,0,1,2
58513,6,2,204908,204908,204910,0,2,5
58514,5,1,204913,204913,204914,0,1,3
58515,4,1,204917,204917,204918,0,1,3
58516,6,1,204923,204923,204924,0,1,5
58517,6,2,204929,204929,204931,0,2,5
58518,2,2,204931,204931,204933,0,2,0
58519,1,1,204932,204933,204934,1,2,0
58520,5,1,204937,204937,204938,0,1,3
58521,6,2,204943,204943,204945,0,2,5
58522,5,3,204948,204948,204951,0,3,3
58523,4,1,204952,204952,204953,0,1,1
58524,1,3,204953,204953,204956,0,3,0
58525,2,1,204955,204956,204957,1,2,0
58526,1,1,204956,204957,204958,1,2,0
58527,6,3,204962,204962,204965,0,3,4
58528,3,1,204965,204965,204966,0,1,0
58529,5,1,204970,204970,204971,0,1,4
58530,5,3,204975,204975,204978,0,3,4
58531,6,1,204981,204981,204982,0,1,3
58532,3,1,204984,204984,204985,0,1,2
58533,1,1,204985,204985,204986,0,1,0
58534,3,1,204988,204988,204989,0,1,2
58535,3,2,204991,204991,204993,0,2,2
58536,2,2,204993,204993,204995,0,2,0
58537,6,3,204999,204999,205002,0,3,4
58538,6,1,205005,205005,205006,0,1,3
58539,2,2,205007,205007,205009,0,2,1
58540,5,2,205012,205012,205014,0,2,3
58541,5,3,205017,205017,205020,0,3,3
58542,6,2,205023,205023,205025,0,2,3
58543,1,2,205024,205025,205027,1,3,0
58544,4,2,205028,205028,205030,0,2,1
58545,4,2,205032,205032,205034,0,2,2
58546,5,3,205037,205037,205040,0,3,3
58547,2,3,205039,205040,205043,1,4,0
58548,1,3,205040,205043,205046,3,6,0
58549,5,2,205045,205046,205048,1,3,0
58550,3,3,205048,205048,205051,0,3,0
58551,3,3,205051,205051,205054,0,3,0
58552,2,2,205053,205054,205056,1,3,0
58553,3,3,205056,205056,205059,0,3,0
58554,5,1,205061,205061,205062,0,1,2
58555,3,2,205064,205064,205066,0,2,2
58556,5,1,205069,205069,205070,0,1,3
58557,4,1,205073,205073,205074,0,1,3
58558,5,1,205078,205078,205079,0,1,4
58559,1,1,205079,205079,205080,0,1,0
58560,6,3,205085,205085,205088,0,3,5
58561,3,3,205088,205088,205091,0,3,0
58562,3,3,205091,205091,205094,0,3,0
58563,4,1,205095,205095,205096,0,1,1
58564,2,3,205097,205097,205100,0,3,1
58565,5,1,205102,205102,205103,0,1,2
58566,5,1,205107,205107,205108,0,1,4
58567,4,2,205111,205111,205113,0,2,3
58568,2,3,205113,205113,205116,0,3,0
58569,4,3,205117,205117,205120,0,3,1
58570,3,3,205120,205120,205123,0,3,0
58571,3,2,205123,205123,205125,0,2,0
58572,5,1,205128,205128,205129,0,1,3
58573,5,2,205133,205133,205135,0,2,4
58574,5,2,205138,205138,205140,0,2,3
58575,4,3,205142,205142,205145,0,3,2
58576,2,3,205144,205145,205148,1,4,0
58577,2,3,205146,205148,205151,2,5,0
58578,1,2,205147,205151,205153,4,6,0
58579,1,3,205148,205153,205156,5,8,0
58580,3,2,205151,205156,205158,5,7,0
58581,3,1,205154,205158,205159,4,5,0
58582,4,3,205158,205159,205162,1,4,0
58583,3,1,205161,205162,205163,1,2,0
58584,5,2,205166,205166,205168,0,2,3
58585,6,3,205172,205172,205175,0,3,4
58586,6,3,205178,205178,205181,0,3,3
58587,4,3,205182,205182,205185,0,3,1
58588,6,2,205188,205188,205190,0,2,3
58589,4,3,205192,205192,205195,0,3,2
58590,3,1,205195,205195,205196,0,1,0
58591,2,2,205197,205197,205199,0,2,1
58592,6,2,205203,205203,205205,0,2,4
58593,1,3,205204,205205,205208,1,4,0
58594,5,1,205209,205209,205210,0,1,1
58595,4,2,205213,205213,205215,0,2,3
58596,4,1,205217,205217,205218,0,1,2
58597,3,2,205220,205220,205222,0,2,2
58598,3,2,205223,205223,205225,0,2,1
58599,6,2,205229,205229,205231,0,2,4
58600,6,1,205235,205235,205236,0,1,4
58601,2,2,205237,205237,205239,0,2,1
58602,1,2,205238,205239,205241,1,3,0
58603,1,1,205239,205241,205242,2,3,0
58604,2,2,205241,205242,205244,1,3,0
58605,1,1,205242,205244,205245,2,3,0
58606,2,1,205244,205245,205246,1,2,0
58607,1,3,205245,205246,205249,1,4,0
58608,2,2,205247,205249,205251,2,4,0
58609,3,3,205250,205251,205254,1,4,0
58610,3,3,205253,205254,205257,1,4,0
58611,3,2,205256,205257,205259,1,3,0
58612,6,2,205262,205262,205264,0,2,3
58613,5,1,205267,205267,205268,0,1,3
58614,5,1,205272,205272,205273,0,1,4
58615,3,2,205275,205275,205277,0,2,2
58616,3,1,205278,205278,205279,0,1,1
58617,3,2,205281,205281,205283,0,2,2
58618,5,1,205286,205286,205287,0,1,3
58619,4,3,205290,205290,205293,0,3,3
58620,5,3,205295,205295,205298,0,3,2
58621,3,2,205298,205298,205300,0,2,0
58622,3,3,205301,205301,205304,0,3,1
58623,1,3,205302,205304,205307,2,5,0
58624,3,3,205305,205307,205310,2,5,0
58625,2,2,205307,205310,205312,3,5,0
58626,1,3,205308,205312,205315,4,7,0
58627,5,1,205313,205315,205316,2,3,0
58628,1,2,205314,205316,205318,2,4,0
58629,4,1,205318,205318,205319,0,1,0
58630,6,3,205324,205324,205327,0,3,5
58631,2,3,205326,205327,205330,1,4,0
58632,6,3,205332,205332,205335,0,3,2
58633,1,2,205333,205335,205337,2,4,0
58634,6,3,205339,205339,205342,0,3,2
58635,1,1,205340,205342,205343,2,3,0
58636,3,1,205343,205343,205344,0,1,0
58637,5,1,205348,205348,205349,0,1,4
58638,5,3,205353,205353,205356,0,3,4
58639,4,2,205357,205357,205359,0,2,1
58640,1,2,205358,205359,205361,1,3,0
58641,5,2,205363,205363,205365,0,2,2
58642,5,2,205368,205368,205370,0,2,3
58643,3,1,205371,205371,205372,0,1,1
58644,4,1,205375,205375,205376,0,1,3
58645,1,1,205376,205376,205377,0,1,0
58646,3,1,205379,205379,205380,0,1,2
58647,2,2,205381,205381,205383,0,2,1
58648,6,2,205387,205387,205389,0,2,4
58649,4,3,205391,205391,205394,0,3,2
58650,2,1,205393,205394,205395,1,2,0
58651,5,2,205398,205398,205400,0,2,3
58652,4,3,205402,205402,205405,0,3,2
58653,1,1,205403,205405,205406,2,3,0
58654,4,1,205407,205407,205408,0,1,1
58655,6,2,205413,205413,205415,0,2,5
58656,3,3,205416,205416,205419,0,3,1
58657,5,2,205421,205421,205423,0,2,2
58658,3,3,205424,205424,205427,0,3,1
58659,4,1,205428,205428,205429,0,1,1
58660,3,3,205431,205431,205434,0,3,2
58661,3,2,205434,205434,205436,0,2,0
58662,6,3,205440,205440,205443,0,3,4
58663,3,2,205443,205443,205445,0,2,0
58664,2,2,205445,205445,205447,0,2,0
58665,4,1,205449,205449,205450,0,1,2
58666,2,1,205451,205451,205452,0,1,1
58667,6,2,205457,205457,205459,0,2,5
58668,2,2,205459,205459,205461,0,2,0
58669,6,2,205465,205465,205467,0,2,4
58670,6,1,205471,205471,205472,0,1,4
58671,4,2,205475,205475,205477,0,2,3
58672,4,2,205479,205479,205481,0,2,2
58673,5,2,205484,205484,205486,0,2,3
58674,6,1,205490,205490,205491,0,1,4
58675,2,3,205492,205492,205495,0,3,1
58676,2,3,205494,205495,205498,1,4,0
58677,3,2,205497,205498,205500,1,3,0
58678,2,2,205499,205500,205502,1,3,0
58679,6,2,205505,205505,205507,0,2,3
58680,2,1,205507,205507,205508,0,1,0
58681,2,2,205509,205509,205511,0,2,1
58682,3,2,205512,205512,205514,0,2,1
58683,2,3,205514,205514,205517,0,3,0
58684,6,3,205520,205520,205523,0,3,3
58685,5,2,205525,205525,205527,0,2,2
58686,3,1,205528,205528,205529,0,1,1
58687,5,1,205533,205533,205534,0,1,4
58688,6,1,205539,205539,205540,0,1,5
58689,4,3,205543,205543,205546,0,3,3
58690,1,1,205544,205546,205547,2,3,0
58691,5,2,205549,205549,205551,0,2,2
58692,5,2,205554,205554,205556,0,2,3
58693,4,3,205558,205558,205561,0,3,2
58694,1,1,205559,205561,205562,2,3,0
58695,6,3,205565,205565,205568,0,3,3
58696,4,2,205569,205569,205571,0,2,1
58697,3,2,205572,205572,205574,0,2,1
58698,5,2,205577,205577,205579,0,2,3
58699,5,1,205582,205582,205583,0,1,3
58700,3,3,205585,205585,205588,0,3,2
58701,2,1,205587,205588,205589,1,2,0
58702,2,3,205589,205589,205592,0,3,0
58703,1,2,205590,205592,205594,2,4,0
58704,6,3,205596,205596,205599,0,3,2
58705,5,2,205601,205601,205603,0,2,2
58706,5,2,205606,205606,205608,0,2,3
58707,2,3,205608,205608,205611,0,3,0
58708,2,1,205610,205611,205612,1,2,0
58709,1,3,205611,205612,205615,1,4,0
58710,2,3,205613,205615,205618,2,5,0
58711,3,2,205616,205618,205620,2,4,0
58712,6,3,205622,205622,205625,0,3,2
58713,6,1,205628,205628,205629,0,1,3
58714,3,2,205631,205631,205633,0,2,2
58715,1,2,205632,205633,205635,1,3,0
58716,5,2,205637,205637,205639,0,2,2
58717,3,2,205640,205640,205642,0,2,1
58718,2,2,205642,205642,205644,0,2,0
58719,3,2,205645,205645,205647,0,2,1
58720,6,3,205651,205651,205654,0,3,4
58721,5,3,205656,205656,205659,0,3,2
58722,5,3,205661,205661,205664,0,3,2
58723,4,2,205665,205665,205667,0,2,1
58724,6,3,205671,205671,205674,0,3,4
58725,3,1,205674,205674,205675,0,1,0
58726,2,3,205676,205676,205679,0,3,1
58727,2,2,205678,205679,205681,1,3,0
58728,3,1,205681,205681,205682,0,1,0
58729,4,1,205685,205685,205686,0,1,3
58730,3,2,205688,205688,205690,0,2,2
58731,1,3,205689,205690,205693,1,4,0
58732,1,2,205690,205693,205695,3,5,0
58733,5,2,205695,205695,205697,0,2,0
58734,1,3,205696,205697,205700,1,4,0
58735,6,2,205702,205702,205704,0,2,2
58736,4,1,205706,205706,205707,0,1,2
58737,2,2,205708,205708,205710,0,2,1
58738,4,1,205712,205712,205713,0,1,2
58739,4,2,205716,205716,205718,0,2,3
58740,5,1,205721,205721,205722,0,1,3
58741,5,2,205726,205726,205728,0,2,4
58742,4,1,205730,205730,205731,0,1,2
58743,6,3,205736,205736,205739,0,3,5
58744,6,2,205742,205742,205744,0,2,3
58745,3,3,205745,205745,205748,0,3,1
58746,1,3,205746,205748,205751,2,5,0
58747,4,2,205750,205751,205753,1,3,0
58748,3,1,205753,205753,205754,0,1,0
58749,1,1,205754,205754,205755,0,1,0
58750,3,1,205757,205757,205758,0,1,2
58751,3,3,205760,205760,205763,0,3,2
58752,1,3,205761,205763,205766,2,5,0
58753,4,2,205765,205766,205768,1,3,0
58754,2,3,205767,205768,205771,1,4,0
58755,1,2,205768,205771,205773,3,5,0
58756,6,1,205774,205774,205775,0,1,1
58757,1,2,205775,205775,205777,0,2,0
58758,1,1,205776,205777,205778,1,2,0
58759,1,3,205777,205778,205781,1,4,0
58760,4,1,205781,205781,205782,0,1,0
58761,6,2,205787,205787,205789,0,2,5
58762,4,2,205791,205791,205793,0,2,2
58763,3,1,205794,205794,205795,0,1,1
58764,2,2,205796,205796,205798,0,2,1
58765,2,3,205798,205798,205801,0,3,0
58766,5,3,205803,205803,205806,0,3,2
58767,1,3,205804,205806,205809,2,5,0
58768,5,1,205809,205809,205810,0,1,0
58769,1,1,205810,205810,205811,0,1,0
58770,6,2,205816,205816,205818,0,2,5
58771,3,3,205819,205819,205822,0,3,1
58772,4,2,205823,205823,205825,0,2,1
58773,1,1,205824,205825,205826,1,2,0
58774,3,2,205827,205827,205829,0,2,1
58775,2,3,205829,205829,205832,0,3,0
58776,4,3,205833,205833,205836,0,3,1
58777,2,3,205835,205836,205839,1,4,0
58778,3,1,205838,205839,205840,1,2,0
58779,2,1,205840,205840,205841,0,1,0
58780,3,3,205843,205843,205846,0,3,2
58781,2,3,205845,205846,205849,1,4,0
58782,5,3,205850,205850,205853,0,3,1
58783,4,2,205854,205854,205856,0,2,1
58784,4,2,205858,205858,205860,0,2,2
58785,5,2,205863,205863,205865,0,2,3
58786,4,1,205867,205867,205868,0,1,2
58787,2,3,205869,205869,205872,0,3,1
58788,2,1,205871,205872,205873,1,2,0
58789,4,1,205875,205875,205876,0,1,2
58790,4,2,205879,205879,205881,0,2,3
58791,3,2,205882,205882,205884,0,2,1
58792,2,2,205884,205884,205886,0,2,0
58793,5,2,205889,205889,205891,0,2,3
58794,3,1,205892,205892,205893,0,1,1
58795,4,2,205896,205896,205898,0,2,3
58796,4,1,205900,205900,205901,0,1,2
58797,4,2,205904,205904,205906,0,2,3
58798,5,3,205909,205909,205912,0,3,3
58799,1,3,205910,205912,205915,2,5,0
58800,2,1,205912,205915,205916,3,4,0
58801,6,3,205918,205918,205921,0,3,2
58802,4,2,205922,205922,205924,0,2,1
58803,3,3,205925,205925,205928,0,3,1
58804,6,1,205931,205931,205932,0,1,3
58805,4,1,205935,205935,205936,0,1,3
58806,3,3,205938,205938,205941,0,3,2
58807,2,1,205940,205941,205942,1,2,0
58808,3,1,205943,205943,205944,0,1,1
58809,1,2,205944,205944,205946,0,2,0
58810,5,3,205949,205949,205952,0,3,3
58811,4,3,205953,205953,205956,0,3,1
58812,1,2,205954,205956,205958,2,4,0
58813,3,2,205957,205958,205960,1,3,0
58814,2,1,205959,205960,205961,1,2,0
58815,2,2,205961,205961,205963,0,2,0
58816,2,2,205963,205963,205965,0,2,0
58817,2,1,205965,205965,205966,0,1,0
58818,3,2,205968,205968,205970,0,2,2
58819,5,2,205973,205973,205975,0,2,3
58820,5,2,205978,205978,205980,0,2,3
58821,3,3,205981,205981,205984,0,3,1
58822,1,1,205982,205984,205985,2,3,0
58823,1,1,205983,205985,205986,2,3,0
58824,2,1,205985,205986,205987,1,2,0
58825,6,1,205991,205991,205992,0,1,4
58826,4,3,205995,205995,205998,0,3,3
58827,2,2,205997,205998,206000,1,3,0
58828,2,1,205999,206000,206001,1,2,0
58829,4,3,206003,206003,206006,0,3,2
58830,3,3,206006,206006,206009,0,3,0
58831,1,3,206007,206009,206012,2,5,0
58832,6,3,206013,206013,206016,0,3,1
58833,2,2,206015,206016,206018,1,3,0
58834,6,3,206021,206021,206024,0,3,3
58835,4,1,206025,206025,206026,0,1,1
58836,2,1,206027,206027,206028,0,1,1
58837,3,1,206030,206030,206031,0,1,2
58838,3,2,206033,206033,206035,0,2,2
58839,5,3,206038,206038,206041,0,3,3
58840,2,1,206040,206041,206042,1,2,0
58841,3,1,206043,206043,206044,0,1,1
58842,1,2,206044,206044,206046,0,2,0
58843,5,2,206049,206049,206051,0,2,3
58844,2,2,206051,206051,206053,0,2,0
58845,1,1,206052,206053,206054,1,2,0
58846,1,2,206053,206054,206056,1,3,0
58847,4,2,206057,206057,206059,0,2,1
58848,2,1,206059,206059,206060,0,1,0
58849,5,2,206064,206064,206066,0,2,4
58850,6,3,206070,206070,206073,0,3,4
58851,6,1,206076,206076,206077,0,1,3
58852,4,2,206080,206080,206082,0,2,3
58853,1,3,206081,206082,206085,1,4,0
58854,6,2,206087,206087,206089,0,2,2
58855,2,1,206089,206089,206090,0,1,0
58856,6,3,206095,206095,206098,0,3,5
58857,1,3,206096,206098,206101,2,5,0
58858,6,2,206102,206102,206104,0,2,1
58859,3,1,206105,206105,206106,0,1,1
58860,6,3,206111,206111,206114,0,3,5
58861,1,2,206112,206114,206116,2,4,0
58862,5,1,206117,206117,206118,0,1,1
58863,2,1,206119,206119,206120,0,1,1
58864,6,3,206125,206125,206128,0,3,5
58865,4,3,206129,206129,206132,0,3,1
58866,5,3,206134,206134,206137,0,3,2
58867,5,1,206139,206139,206140,0,1,2
58868,6,2,206145,206145,206147,0,2,5
58869,2,3,206147,206147,206150,0,3,0
58870,1,3,206148,206150,206153,2,5,0
58871,6,3,206154,206154,206157,0,3,1
58872,6,1,206160,206160,206161,0,1,3
58873,2,3,206162,206162,206165,0,3,1
58874,4,1,206166,206166,206167,0,1,1
58875,6,3,206172,206172,206175,0,3,5
58876,1,1,206173,206175,206176,2,3,0
58877,5,3,206178,206178,206181,0,3,2
58878,5,3,206183,206183,206186,0,3,2
58879,1,3,206184,206186,206189,2,5,0
58880,4,2,206188,206189,206191,1,3,0
58881,2,3,206190,206191,206194,1,4,0
58882,6,1,206196,206196,206197,0,1,2
58883,5,2,206201,206201,206203,0,2,4
58884,4,2,206205,206205,206207,0,2,2
58885,3,1,206208,206208,206209,0,1,1
58886,4,1,206212,206212,206213,0,1,3
58887,6,3,206218,206218,206221,0,3,5
58888,4,3,206222,206222,206225,0,3,1
58889,4,2,206226,206226,206228,0,2,1
58890,1,1,206227,206228,206229,1,2,0
58891,4,3,206231,206231,206234,0,3,2
58892,1,3,206232,206234,206237,2,5,0
58893,2,3,206234,206237,206240,3,6,0
58894,5,3,206239,206240,206243,1,4,0
58895,1,3,206240,206243,206246,3,6,0
58896,6,2,206246,206246,206248,0,2,0
58897,5,1,206251,206251,206252,0,1,3
58898,5,3,206256,206256,206259,0,3,4
58899,2,2,206258,206259,206261,1,3,0
58900,3,3,206261,206261,206264,0,3,0
58901,1,3,206262,206264,206267,2,5,0
58902,2,1,206264,206267,206268,3,4,0
58903,6,2,206270,206270,206272,0,2,2
58904,6,1,206276,206276,206277,0,1,4
58905,5,1,206281,206281,206282,0,1,4
58906,5,2,206286,206286,206288,0,2,4
58907,2,1,206288,206288,206289,0,1,0
58908,2,3,206290,206290,206293,0,3,1
58909,4,2,206294,206294,206296,0,2,1
58910,5,2,206299,206299,206301,0,2,3
58911,3,3,206302,206302,206305,0,3,1
58912,4,1,206306,206306,206307,0,1,1
58913,3,3,206309,206309,206312,0,3,2
58914,5,1,206314,206314,206315,0,1,2
58915,6,2,206320,206320,206322,0,2,5
58916,1,3,206321,206322,206325,1,4,0
58917,2,2,206323,206325,206327,2,4,0
58918,2,1,206325,206327,206328,2,3,0
58919,5,3,206330,206330,206333,0,3,2
58920,1,3,206331,206333,206336,2,5,0
58921,5,3,206336,206336,206339,0,3,0
58922,4,1,206340,206340,206341,0,1,1
58923,1,3,206341,206341,206344,0,3,0
58924,1,2,206342,206344,206346,2,4,0
58925,2,1,206344,206346,206347,2,3,0
58926,2,3,206346,206347,206350,1,4,0
58927,2,2,206348,206350,206352,2,4,0
58928,6,2,206354,206354,206356,0,2,2
58929,1,2,206355,206356,206358,1,3,0
58930,4,2,206359,206359,206361,0,2,1
58931,2,2,206361,206361,206363,0,2,0
58932,1,1,206362,206363,206364,1,2,0
58933,2,2,206364,206364,206366,0,2,0
58934,6,3,206370,206370,206373,0,3,4
58935,2,1,206372,206373,206374,1,2,0
58936,4,3,206376,206376,206379,0,3,2
58937,4,3,206380,206380,206383,0,3,1
58938,5,3,206385,206385,206388,0,3,2
58939,6,2,206391,206391,206393,0,2,3
58940,2,1,206393,206393,206394,0,1,0
58941,5,1,206398,206398,206399,0,1,4
58942,5,3,206403,206403,206406,0,3,4
58943,3,2,206406,206406,206408,0,2,0
58944,2,1,206408,206408,206409,0,1,0
58945,3,1,206411,206411,206412,0,1,2
58946,4,2,206415,206415,206417,0,2,3
58947,6,3,206421,206421,206424,0,3,4
58948,4,1,206425,206425,206426,0,1,1
58949,3,3,206428,206428,206431,0,3,2
58950,4,1,206432,206432,206433,0,1,1
58951,6,3,206438,206438,206441,0,3,5
58952,3,3,206441,206441,206444,0,3,0
58953,3,1,206444,206444,206445,0,1,0
58954,3,2,206447,206447,206449,0,2,2
58955,3,1,206450,206450,206451,0,1,1
58956,4,1,206454,206454,206455,0,1,3
58957,3,2,206457,206457,206459,0,2,2
58958,1,3,206458,206459,206462,1,4,0
58959,2,2,206460,206462,206464,2,4,0
58960,2,1,206462,206464,206465,2,3,0
58961,3,3,206465,206465,206468,0,3,0
58962,5,3,206470,206470,206473,0,3,2
58963,6,1,206476,206476,206477,0,1,3
58964,5,3,206481,206481,206484,0,3,4
58965,5,1,206486,206486,206487,0,1,2
58966,6,1,206492,206492,206493,0,1,5
58967,1,3,206493,206493,206496,0,3,0
58968,2,1,206495,206496,206497,1,2,0
58969,6,2,206501,206501,206503,0,2,4
58970,2,3,206503,206503,206506,0,3,0
58971,2,2,206505,206506,206508,1,3,0
58972,5,2,206510,206510,206512,0,2,2
58973,5,3,206515,206515,206518,0,3,3
58974,1,1,206516,206518,206519,2,3,0
58975,6,2,206522,206522,206524,0,2,3
58976,5,3,206527,206527,206530,0,3,3
58977,2,1,206529,206530,206531,1,2,0
58978,5,2,206534,206534,206536,0,2,3
58979,3,1,206537,206537,206538,0,1,1
58980,4,1,206541,206541,206542,0,1,3
58981,4,3,206545,206545,206548,0,3,3
58982,6,3,206551,206551,206554,0,3,3
58983,3,2,206554,206554,206556,0,2,0
58984,1,1,206555,206556,206557,1,2,0
58985,5,1,206560,206560,206561,0,1,3
58986,5,2,206565,206565,206567,0,2,4
58987,4,3,206569,206569,206572,0,3,2
58988,3,2,206572,206572,206574,0,2,0
58989,2,3,206574,206574,206577,0,3,0
58990,3,2,206577,206577,206579,0,2,0
58991,4,1,206581,206581,206582,0,1,2
58992,6,3,206587,206587,206590,0,3,5
58993,3,3,206590,206590,206593,0,3,0
58994,2,3,206592,206593,206596,1,4,0
58995,1,1,206593,206596,206597,3,4,0
58996,5,3,206598,206598,206601,0,3,1
58997,6,2,206604,206604,206606,0,2,3
58998,4,1,206608,206608,206609,0,1,2
58999,4,1,206612,206612,206613,0,1,3
59000,4,2,206616,206616,206618,0,2,3
59001,2,2,206618,206618,206620,0,2,0
59002,1,2,206619,206620,206622,1,3,0
59003,3,1,206622,206622,206623,0,1,0
59004,6,3,206628,206628,206631,0,3,5
59005,1,2,206629,206631,206633,2,4,0
59006,4,3,206633,206633,206636,0,3,0
59007,2,3,206635,206636,206639,1,4,0
59008,5,2,206640,206640,206642,0,2,1
59009,1,1,206641,206642,206643,1,2,0
59010,5,1,206646,206646,206647,0,1,3
59011,4,3,206650,206650,206653,0,3,3
59012,4,2,206654,206654,206656,0,2,1
59013,5,2,206659,206659,206661,0,2,3
59014,1,3,206660,206661,206664,1,4,0
59015,5,1,206665,206665,206666,0,1,1
59016,6,2,206671,206671,206673,0,2,5
59017,6,2,206677,206677,206679,0,2,4
59018,3,2,206680,206680,206682,0,2,1
59019,2,3,206682,206682,206685,0,3,0
59020,2,2,206684,206685,206687,1,3,0
59021,6,3,206690,206690,206693,0,3,3
59022,1,1,206691,206693,206694,2,3,0
59023,1,1,206692,206694,206695,2,3,0
59024,5,1,206697,206697,206698,0,1,2
59025,5,2,206702,206702,206704,0,2,4
59026,5,1,206707,206707,206708,0,1,3
59027,1,2,206708,206708,206710,0,2,0
59028,5,2,206713,206713,206715,0,2,3
59029,3,2,206716,206716,206718,0,2,1
59030,1,2,206717,206718,206720,1,3,0
59031,3,1,206720,206720,206721,0,1,0
59032,2,1,206722,206722,206723,0,1,1
59033,5,1,206727,206727,206728,0,1,4
59034,2,1,206729,206729,206730,0,1,1
59035,4,3,206733,206733,206736,0,3,3
59036,5,2,206738,206738,206740,0,2,2
59037,1,1,206739,206740,206741,1,2,0
59038,4,3,206743,206743,206746,0,3,2
59039,2,2,206745,206746,206748,1,3,0
59040,5,1,206750,206750,206751,0,1,2
59041,6,2,206756,206756,206758,0,2,5
59042,5,2,206761,206761,206763,0,2,3
59043,4,1,206765,206765,206766,0,1,2
59044,2,1,206767,206767,206768,0,1,1
59045,6,2,206773,206773,206775,0,2,5
59046,5,2,206778,206778,206780,0,2,3
59047,2,3,206780,206780,206783,0,3,0
59048,6,3,206786,206786,206789,0,3,3
59049,2,1,206788,206789,206790,1,2,0
59050,1,2,206789,206790,206792,1,3,0
59051,3,3,206792,206792,206795,0,3,0
59052,2,1,206794,206795,206796,1,2,0
59053,6,2,206800,206800,206802,0,2,4
59054,4,1,206804,206804,206805,0,1,2
59055,2,1,206806,206806,206807,0,1,1
59056,6,1,206812,206812,206813,0,1,5
59057,4,2,206816,206816,206818,0,2,3
59058,5,3,206821,206821,206824,0,3,3
59059,2,2,206823,206824,206826,1,3,0
59060,6,2,206829,206829,206831,0,2,3
59061,1,2,206830,206831,206833,1,3,0
59062,2,1,206832,206833,206834,1,2,0
59063,2,3,206834,206834,206837,0,3,0
59064,3,1,206837,206837,206838,0,1,0
59065,2,3,206839,206839,206842,0,3,1
59066,1,2,206840,206842,206844,2,4,0
59067,1,1,206841,206844,206845,3,4,0
59068,3,1,206844,206845,206846,1,2,0
59069,5,1,206849,206849,206850,0,1,3
59070,5,1,206854,206854,206855,0,1,4
59071,3,3,206857,206857,206860,0,3,2
59072,3,3,206860,206860,206863,0,3,0
59073,6,1,206866,206866,206867,0,1,3
59074,6,2,206872,206872,206874,0,2,5
59075,6,2,206878,206878,206880,0,2,4
59076,1,3,206879,206880,206883,1,4,0
59077,2,2,206881,206883,206885,2,4,0
59078,3,1,206884,206885,206886,1,2,0
59079,6,1,206890,206890,206891,0,1,4
59080,6,2,206896,206896,206898,0,2,5
59081,4,3,206900,206900,206903,0,3,2
59082,6,2,206906,206906,206908,0,2,3
59083,1,2,206907,206908,206910,1,3,0
59084,5,1,206912,206912,206913,0,1,2
59085,3,1,206915,206915,206916,0,1,2
59086,5,3,206920,206920,206923,0,3,4
59087,3,2,206923,206923,206925,0,2,0
59088,5,2,206928,206928,206930,0,2,3
59089,4,1,206932,206932,206933,0,1,2
59090,2,3,206934,206934,206937,0,3,1
59091,4,2,206938,206938,206940,0,2,1
59092,6,1,206944,206944,206945,0,1,4
59093,6,3,206950,206950,206953,0,3,5
59094,5,2,206955,206955,206957,0,2,2
59095,2,3,206957,206957,206960,0,3,0
59096,1,1,206958,206960,206961,2,3,0
59097,2,3,206960,206961,206964,1,4,0
59098,5,3,206965,206965,206968,0,3,1
59099,1,2,206966,206968,206970,2,4,0
59100,6,2,206972,206972,206974,0,2,2
59101,5,1,206977,206977,206978,0,1,3
59102,6,2,206983,206983,206985,0,2,5
59103,1,2,206984,206985,206987,1,3,0
59104,6,1,206990,206990,206991,0,1,3
59105,6,2,206996,206996,206998,0,2,5
59106,1,3,206997,206998,207001,1,4,0
59107,5,3,207002,207002,207005,0,3,1
59108,5,3,207007,207007,207010,0,3,2
59109,2,2,207009,207010,207012,1,3,0
59110,6,3,207015,207015,207018,0,3,3
59111,4,2,207019,207019,207021,0,2,1
59112,2,1,207021,207021,207022,0,1,0
59113,3,3,207024,207024,207027,0,3,2
59114,3,3,207027,207027,207030,0,3,0
59115,3,3,207030,207030,207033,0,3,0
59116,4,3,207034,207034,207037,0,3,1
59117,3,1,207037,207037,207038,0,1,0
59118,6,3,207043,207043,207046,0,3,5
59119,4,2,207047,207047,207049,0,2,1
59120,6,1,207053,207053,207054,0,1,4
59121,3,3,207056,207056,207059,0,3,2
59122,2,2,207058,207059,207061,1,3,0
59123,1,2,207059,207061,207063,2,4,0
59124,3,2,207062,207063,207065,1,3,0
59125,2,2,207064,207065,207067,1,3,0
59126,1,1,207065,207067,207068,2,3,0
59127,5,2,207070,207070,207072,0,2,2
59128,2,2,207072,207072,207074,0,2,0
59129,3,3,207075,207075,207078,0,3,1
59130,5,1,207080,207080,207081,0,1,2
59131,6,1,207086,207086,207087,0,1,5
59132,4,3,207090,207090,207093,0,3,3
59133,1,1,207091,207093,207094,2,3,0
59134,6,2,207097,207097,207099,0,2,3
59135,5,3,207102,207102,207105,0,3,3
59136,2,2,207104,207105,207107,1,3,0
59137,5,1,207109,207109,207110,0,1,2
59138,3,3,207112,207112,207115,0,3,2
59139,6,2,207118,207118,207120,0,2,3
59140,2,1,207120,207120,207121,0,1,0
59141,6,1,207126,207126,207127,0,1,5
59142,5,1,207131,207131,207132,0,1,4
59143,3,2,207134,207134,207136,0,2,2
59144,6,3,207140,207140,207143,0,3,4
59145,1,1,207141,207143,207144,2,3,0
59146,4,1,207145,207145,207146,0,1,1
59147,2,3,207147,207147,207150,0,3,1
59148,4,3,207151,207151,207154,0,3,1
59149,6,1,207157,207157,207158,0,1,3
59150,2,1,207159,207159,207160,0,1,1
59151,3,2,207162,207162,207164,0,2,2
59152,1,1,207163,207164,207165,1,2,0
59153,6,2,207169,207169,207171,0,2,4
59154,5,3,207174,207174,207177,0,3,3
59155,5,2,207179,207179,207181,0,2,2
59156,6,2,207185,207185,207187,0,2,4
59157,2,1,207187,207187,207188,0,1,0
59158,1,2,207188,207188,207190,0,2,0
59159,5,1,207193,207193,207194,0,1,3
59160,1,1,207194,207194,207195,0,1,0
59161,2,2,207196,207196,207198,0,2,1
59162,1,1,207197,207198,207199,1,2,0
59163,6,2,207203,207203,207205,0,2,4
59164,5,2,207208,207208,207210,0,2,3
59165,5,1,207213,207213,207214,0,1,3
59166,2,3,207215,207215,207218,0,3,1
59167,1,2,207216,207218,207220,2,4,0
59168,2,2,207218,207220,207222,2,4,0
59169,3,1,207221,207222,207223,1,2,0
59170,1,3,207222,207223,207226,1,4,0
59171,2,1,207224,207226,207227,2,3,0
59172,1,2,207225,207227,207229,2,4,0
59173,2,3,207227,207229,207232,2,5,0
59174,6,3,207233,207233,207236,0,3,1
59175,2,2,207235,207236,207238,1,3,0
59176,3,3,207238,207238,207241,0,3,0
59177,2,2,207240,207241,207243,1,3,0
59178,1,2,207241,207243,207245,2,4,0
59179,3,3,207244,207245,207248,1,4,0
59180,4,2,207248,207248,207250,0,2,0
59181,6,1,207254,207254,207255,0,1,4
59182,5,1,207259,207259,207260,0,1,4
59183,5,2,207264,207264,207266,0,2,4
59184,2,3,207266,207266,207269,0,3,0
59185,4,1,207270,207270,207271,0,1,1
59186,1,2,207271,207271,207273,0,2,0
59187,4,1,207275,207275,207276,0,1,2
59188,5,2,207280,207280,207282,0,2,4
59189,1,3,207281,207282,207285,1,4,0
59190,2,1,207283,207285,207286,2,3,0
59191,1,3,207284,207286,207289,2,5,0
59192,1,1,207285,207289,207290,4,5,0
59193,4,1,207289,207290,207291,1,2,0
59194,4,3,207293,207293,207296,0,3,2
59195,5,2,207298,207298,207300,0,2,2
59196,5,1,207303,207303,207304,0,1,3
59197,2,3,207305,207305,207308,0,3,1
59198,1,2,207306,207308,207310,2,4,0
59199,4,3,207310,207310,207313,0,3,0
59200,6,1,207316,207316,207317,0,1,3
59201,5,2,207321,207321,207323,0,2,4
59202,4,3,207325,207325,207328,0,3,2
59203,6,2,207331,207331,207333,0,2,3
59204,2,3,207333,207333,207336,0,3,0
59205,4,3,207337,207337,207340,0,3,1
59206,6,1,207343,207343,207344,0,1,3
59207,2,2,207345,207345,207347,0,2,1
59208,3,2,207348,207348,207350,0,2,1
59209,2,1,207350,207350,207351,0,1,0
59210,2,1,207352,207352,207353,0,1,1
59211,5,2,207357,207357,207359,0,2,4
59212,1,1,207358,207359,207360,1,2,0
59213,6,2,207364,207364,207366,0,2,4
59214,3,3,207367,207367,207370,0,3,1
59215,1,2,207368,207370,207372,2,4,0
59216,4,1,207372,207372,207373,0,1,0
59217,3,1,207375,207375,207376,0,1,2
59218,4,2,207379,207379,207381,0,2,3
59219,4,3,207383,207383,207386,0,3,2
59220,3,3,207386,207386,207389,0,3,0
59221,3,2,207389,207389,207391,0,2,0
59222,3,1,207392,207392,207393,0,1,1
59223,3,1,207395,207395,207396,0,1,2
59224,3,1,207398,207398,207399,0,1,2
59225,2,1,207400,207400,207401,0,1,1
59226,2,3,207402,207402,207405,0,3,1
59227,5,2,207407,207407,207409,0,2,2
59228,4,2,207411,207411,207413,0,2,2
59229,3,1,207414,207414,207415,0,1,1
59230,2,3,207416,207416,207419,0,3,1
59231,4,3,207420,207420,207423,0,3,1
59232,2,1,207422,207423,207424,1,2,0
59233,6,2,207428,207428,207430,0,2,4
59234,2,1,207430,207430,207431,0,1,0
59235,4,1,207434,207434,207435,0,1,3
59236,2,3,207436,207436,207439,0,3,1
59237,3,1,207439,207439,207440,0,1,0
59238,6,2,207445,207445,207447,0,2,5
59239,4,1,207449,207449,207450,0,1,2
59240,4,1,207453,207453,207454,0,1,3
59241,4,2,207457,207457,207459,0,2,3
59242,2,3,207459,207459,207462,0,3,0
59243,6,3,207465,207465,207468,0,3,3
59244,3,1,207468,207468,207469,0,1,0
59245,1,2,207469,207469,207471,0,2,0
59246,6,1,207475,207475,207476,0,1,4
59247,4,2,207479,207479,207481,0,2,3
59248,1,1,207480,207481,207482,1,2,0
59249,3,2,207483,207483,207485,0,2,1
59250,3,1,207486,207486,207487,0,1,1
59251,4,2,207490,207490,207492,0,2,3
59252,6,2,207496,207496,207498,0,2,4
59253,3,1,207499,207499,207500,0,1,1
59254,5,1,207504,207504,207505,0,1,4
59255,2,1,207506,207506,207507,0,1,1
59256,4,1,207510,207510,207511,0,1,3
59257,1,2,207511,207511,207513,0,2,0
59258,6,3,207517,207517,207520,0,3,4
59259,6,1,207523,207523,207524,0,1,3
59260,6,3,207529,207529,207532,0,3,5
59261,2,1,207531,207532,207533,1,2,0
59262,3,3,207534,207534,207537,0,3,1
59263,1,2,207535,207537,207539,2,4,0
59264,4,2,207539,207539,207541,0,2,0
59265,4,2,207543,207543,207545,0,2,2
59266,2,3,207545,207545,207548,0,3,0
59267,4,2,207549,207549,207551,0,2,1
59268,6,1,207555,207555,207556,0,1,4
59269,6,2,207561,207561,207563,0,2,5
59270,6,3,207567,207567,207570,0,3,4
59271,3,1,207570,207570,207571,0,1,0
59272,6,3,207576,207576,207579,0,3,5
59273,2,1,207578,207579,207580,1,2,0
59274,6,3,207584,207584,207587,0,3,4
59275,4,3,207588,207588,207591,0,3,1
59276,5,3,207593,207593,207596,0,3,2
59277,2,2,207595,207596,207598,1,3,0
59278,1,3,207596,207598,207601,2,5,0
59279,3,2,207599,207601,207603,2,4,0
59280,4,2,207603,207603,207605,0,2,0
59281,5,2,207608,207608,207610,0,2,3
59282,2,2,207610,207610,207612,0,2,0
59283,2,3,207612,207612,207615,0,3,0
59284,5,2,207617,207617,207619,0,2,2
59285,5,2,207622,207622,207624,0,2,3
59286,5,2,207627,207627,207629,0,2,3
59287,6,1,207633,207633,207634,0,1,4
59288,3,3,207636,207636,207639,0,3,2
59289,2,1,207638,207639,207640,1,2,0
59290,4,3,207642,207642,207645,0,3,2
59291,2,1,207644,207645,207646,1,2,0
59292,5,1,207649,207649,207650,0,1,3
59293,5,2,207654,207654,207656,0,2,4
59294,4,2,207658,207658,207660,0,2,2
59295,6,2,207664,207664,207666,0,2,4
59296,2,1,207666,207666,207667,0,1,0
59297,6,2,207672,207672,207674,0,2,5
59298,2,3,207674,207674,207677,0,3,0
59299,5,3,207679,207679,207682,0,3,2
59300,6,2,207685,207685,207687,0,2,3
59301,1,1,207686,207687,207688,1,2,0
59302,5,3,207691,207691,207694,0,3,3
59303,4,3,207695,207695,207698,0,3,1
59304,5,1,207700,207700,207701,0,1,2
59305,2,3,207702,207702,207705,0,3,1
59306,4,1,207706,207706,207707,0,1,1
59307,3,1,207709,207709,207710,0,1,2
59308,1,2,207710,207710,207712,0,2,0
59309,1,3,207711,207712,207715,1,4,0
59310,6,3,207717,207717,207720,0,3,2
59311,2,1,207719,207720,207721,1,2,0
59312,3,1,207722,207722,207723,0,1,1
59313,4,3,207726,207726,207729,0,3,3
59314,4,1,207730,207730,207731,0,1,1
59315,3,3,207733,207733,207736,0,3,2
59316,3,3,207736,207736,207739,0,3,0
59317,4,2,207740,207740,207742,0,2,1
59318,5,1,207745,207745,207746,0,1,3
59319,4,3,207749,207749,207752,0,3,3
59320,6,3,207755,207755,207758,0,3,3
59321,1,1,207756,207758,207759,2,3,0
59322,3,2,207759,207759,207761,0,2,0
59323,3,1,207762,207762,207763,0,1,1
59324,1,1,207763,207763,207764,0,1,0
59325,4,3,207767,207767,207770,0,3,3
59326,1,3,207768,207770,207773,2,5,0
59327,2,1,207770,207773,207774,3,4,0
59328,5,2,207775,207775,207777,0,2,1
59329,1,2,207776,207777,207779,1,3,0
59330,5,1,207781,207781,207782,0,1,2
59331,1,3,207782,207782,207785,0,3,0
59332,1,2,207783,207785,207787,2,4,0
59333,3,1,207786,207787,207788,1,2,0
59334,3,1,207789,207789,207790,0,1,1
59335,1,3,207790,207790,207793,0,3,0
59336,2,1,207792,207793,207794,1,2,0
59337,2,2,207794,207794,207796,0,2,0
59338,5,3,207799,207799,207802,0,3,3
59339,1,3,207800,207802,207805,2,5,0
59340,1,2,207801,207805,207807,4,6,0
59341,1,1,207802,207807,207808,5,6,0
59342,5,3,207807,207808,207811,1,4,0
59343,1,1,207808,207811,207812,3,4,0
59344,3,3,207811,207812,207815,1,4,0
59345,4,1,207815,207815,207816,0,1,0
59346,1,2,207816,207816,207818,0,2,0
59347,4,1,207820,207820,207821,0,1,2
59348,2,1,207822,207822,207823,0,1,1
59349,5,1,207827,207827,207828,0,1,4
59350,6,1,207833,207833,207834,0,1,5
59351,5,1,207838,207838,207839,0,1,4
59352,5,2,207843,207843,207845,0,2,4
59353,1,1,207844,207845,207846,1,2,0
59354,2,2,207846,207846,207848,0,2,0
59355,2,3,207848,207848,207851,0,3,0
59356,2,2,207850,207851,207853,1,3,0
59357,4,2,207854,207854,207856,0,2,1
59358,2,2,207856,207856,207858,0,2,0
59359,6,3,207862,207862,207865,0,3,4
59360,6,2,207868,207868,207870,0,2,3
59361,1,1,207869,207870,207871,1,2,0
59362,2,1,207871,207871,207872,0,1,0
59363,4,2,207875,207875,207877,0,2,3
59364,4,1,207879,207879,207880,0,1,2
59365,3,1,207882,207882,207883,0,1,2
59366,1,2,207883,207883,207885,0,2,0
59367,5,2,207888,207888,207890,0,2,3
59368,4,2,207892,207892,207894,0,2,2
59369,1,3,207893,207894,207897,1,4,0
59370,4,3,207897,207897,207900,0,3,0
59371,2,1,207899,207900,207901,1,2,0
59372,4,2,207903,207903,207905,0,2,2
59373,1,3,207904,207905,207908,1,4,0
59374,2,2,207906,207908,207910,2,4,0
59375,6,1,207912,207912,207913,0,1,2
59376,2,2,207914,207914,207916,0,2,1
59377,6,2,207920,207920,207922,0,2,4
59378,1,1,207921,207922,207923,1,2,0
59379,4,2,207925,207925,207927,0,2,2
59380,3,2,207928,207928,207930,0,2,1
59381,4,2,207932,207932,207934,0,2,2
59382,2,3,207934,207934,207937,0,3,0
59383,5,2,207939,207939,207941,0,2,2
59384,3,3,207942,207942,207945,0,3,1
59385,2,3,207944,207945,207948,1,4,0
59386,4,2,207948,207948,207950,0,2,0
59387,4,3,207952,207952,207955,0,3,2
59388,4,3,207956,207956,207959,0,3,1
59389,5,3,207961,207961,207964,0,3,2
59390,2,3,207963,207964,207967,1,4,0
59391,3,2,207966,207967,207969,1,3,0
59392,4,3,207970,207970,207973,0,3,1
59393,4,2,207974,207974,207976,0,2,1
59394,2,1,207976,207976,207977,0,1,0
59395,3,2,207979,207979,207981,0,2,2
59396,6,3,207985,207985,207988,0,3,4
59397,5,1,207990,207990,207991,0,1,2
59398,5,3,207995,207995,207998,0,3,4
59399,5,1,208000,208000,208001,0,1,2
59400,3,3,208003,208003,208006,0,3,2
59401,4,3,208007,208007,208010,0,3,1
59402,5,3,208012,208012,208015,0,3,2
59403,5,3,208017,208017,208020,0,3,2
59404,1,3,208018,208020,208023,2,5,0
59405,3,2,208021,208023,208025,2,4,0
59406,1,1,208022,208025,208026,3,4,0
59407,5,2,208027,208027,208029,0,2,1
59408,1,1,208028,208029,208030,1,2,0
59409,5,2,208033,208033,208035,0,2,3
59410,5,2,208038,208038,208040,0,2,3
59411,6,3,208044,208044,208047,0,3,4
59412,3,1,208047,208047,208048,0,1,0
59413,4,2,208051,208051,208053,0,2,3
59414,1,2,208052,208053,208055,1,3,0
59415,4,1,208056,208056,208057,0,1,1
59416,3,3,208059,208059,208062,0,3,2
59417,6,1,208065,208065,208066,0,1,3
59418,3,2,208068,208068,208070,0,2,2
59419,5,3,208073,208073,208076,0,3,3
59420,2,1,208075,208076,208077,1,2,0
59421,5,1,208080,208080,208081,0,1,3
59422,5,1,208085,208085,208086,0,1,4
59423,2,1,208087,208087,208088,0,1,1
59424,5,3,208092,208092,208095,0,3,4
59425,5,1,208097,208097,208098,0,1,2
59426,3,2,208100,208100,208102,0,2,2
59427,1,1,208101,208102,208103,1,2,0
59428,5,1,208106,208106,208107,0,1,3
59429,1,2,208107,208107,208109,0,2,0
59430,2,3,208109,208109,208112,0,3,0
59431,1,3,208110,208112,208115,2,5,0
59432,4,1,208114,208115,208116,1,2,0
59433,1,1,208115,208116,208117,1,2,0
59434,1,3,208116,208117,208120,1,4,0
59435,3,3,208119,208120,208123,1,4,0
59436,4,1,208123,208123,208124,0,1,0
59437,1,1,208124,208124,208125,0,1,0
59438,6,1,208130,208130,208131,0,1,5
59439,1,1,208131,208131,208132,0,1,0
59440,2,1,208133,208133,208134,0,1,1
59441,1,2,208134,208134,208136,0,2,0
59442,5,2,208139,208139,208141,0,2,3
59443,3,2,208142,208142,208144,0,2,1
59444,4,3,208146,208146,208149,0,3,2
59445,1,3,208147,208149,208152,2,5,0
59446,6,2,208153,208153,208155,0,2,1
59447,5,1,208158,208158,208159,0,1,3
59448,2,3,208160,208160,208163,0,3,1
59449,6,2,208166,208166,208168,0,2,3
59450,3,1,208169,208169,208170,0,1,1
59451,1,1,208170,208170,208171,0,1,0
59452,4,3,208174,208174,208177,0,3,3
59453,3,1,208177,208177,208178,0,1,0
59454,6,1,208183,208183,208184,0,1,5
59455,3,1,208186,208186,208187,0,1,2
59456,5,3,208191,208191,208194,0,3,4
59457,2,1,208193,208194,208195,1,2,0
59458,5,2,208198,208198,208200,0,2,3
59459,3,3,208201,208201,208204,0,3,1
59460,5,2,208206,208206,208208,0,2,2
59461,5,2,208211,208211,208213,0,2,3
59462,4,2,208215,208215,208217,0,2,2
59463,1,1,208216,208217,208218,1,2,0
59464,2,2,208218,208218,208220,0,2,0
59465,5,2,208223,208223,208225,0,2,3
59466,6,2,208229,208229,208231,0,2,4
59467,2,2,208231,208231,208233,0,2,0
59468,4,1,208235,208235,208236,0,1,2
59469,2,1,208237,208237,208238,0,1,1
59470,3,3,208240,208240,208243,0,3,2
59471,2,2,208242,208243,208245,1,3,0
59472,2,1,208244,208245,208246,1,2,0
59473,4,2,208248,208248,208250,0,2,2
59474,5,2,208253,208253,208255,0,2,3
59475,2,2,208255,208255,208257,0,2,0
59476,4,2,208259,208259,208261,0,2,2
59477,2,1,208261,208261,208262,0,1,0
59478,5,3,208266,208266,208269,0,3,4
59479,4,2,208270,208270,208272,0,2,1
59480,3,1,208273,208273,208274,0,1,1
59481,3,1,208276,208276,208277,0,1,2
59482,4,2,208280,208280,208282,0,2,3
59483,3,3,208283,208283,208286,0,3,1
59484,5,1,208288,208288,208289,0,1,2
59485,5,1,208293,208293,208294,0,1,4
59486,5,2,208298,208298,208300,0,2,4
59487,4,3,208302,208302,208305,0,3,2
59488,6,3,208308,208308,208311,0,3,3
59489,5,1,208313,208313,208314,0,1,2
59490,3,1,208316,208316,208317,0,1,2
59491,4,2,208320,208320,208322,0,2,3
59492,5,2,208325,208325,208327,0,2,3
59493,4,3,208329,208329,208332,0,3,2
59494,6,3,208335,208335,208338,0,3,3
59495,1,3,208336,208338,208341,2,5,0
59496,3,3,208339,208341,208344,2,5,0
59497,4,2,208343,208344,208346,1,3,0
59498,3,2,208346,208346,208348,0,2,0
59499,3,3,208349,208349,208352,0,3,1
59500,1,3,208350,208352,208355,2,5,0
59501,4,2,208354,208355,208357,1,3,0
59502,1,2,208355,208357,208359,2,4,0
59503,1,2,208356,208359,208361,3,5,0
59504,3,2,208359,208361,208363,2,4,0
59505,1,3,208360,208363,208366,3,6,0
59506,3,1,208363,208366,208367,3,4,0
59507,1,2,208364,208367,208369,3,5,0
59508,4,1,208368,208369,208370,1,2,0
59509,1,1,208369,208370,208371,1,2,0
59510,3,3,208372,208372,208375,0,3,1
59511,5,3,208377,208377,208380,0,3,2
59512,1,1,208378,208380,208381,2,3,0
59513,3,1,208381,208381,208382,0,1,0
59514,5,2,208386,208386,208388,0,2,4
59515,3,3,208389,208389,208392,0,3,1
59516,3,1,208392,208392,208393,0,1,0
59517,4,2,208396,208396,208398,0,2,3
59518,4,3,208400,208400,208403,0,3,2
59519,1,2,208401,208403,208405,2,4,0
59520,4,3,208405,208405,208408,0,3,0
59521,3,3,208408,208408,208411,0,3,0
59522,4,3,208412,208412,208415,0,3,1
59523,1,1,208413,208415,208416,2,3,0
59524,5,3,208418,208418,208421,0,3,2
59525,3,1,208421,208421,208422,0,1,0
59526,6,3,208427,208427,208430,0,3,5
59527,4,2,208431,208431,208433,0,2,1
59528,1,2,208432,208433,208435,1,3,0
59529,3,2,208435,208435,208437,0,2,0
59530,5,3,208440,208440,208443,0,3,3
59531,4,1,208444,208444,208445,0,1,1
59532,3,1,208447,208447,208448,0,1,2
59533,2,2,208449,208449,208451,0,2,1
59534,3,3,208452,208452,208455,0,3,1
59535,2,3,208454,208455,208458,1,4,0
59536,6,1,208460,208460,208461,0,1,2
59537,3,3,208463,208463,208466,0,3,2
59538,6,1,208469,208469,208470,0,1,3
59539,6,3,208475,208475,208478,0,3,5
59540,2,2,208477,208478,208480,1,3,0
59541,6,3,208483,208483,208486,0,3,3
59542,2,1,208485,208486,208487,1,2,0
59543,5,1,208490,208490,208491,0,1,3
59544,3,3,208493,208493,208496,0,3,2
59545,4,1,208497,208497,208498,0,1,1
59546,3,3,208500,208500,208503,0,3,2
59547,1,3,208501,208503,208506,2,5,0
59548,1,3,208502,208506,208509,4,7,0
59549,1,3,208503,208509,208512,6,9,0
59550,5,2,208508,208512,208514,4,6,0
59551,1,3,208509,208514,208517,5,8,0
59552,1,2,208510,208517,208519,7,9,0
59553,3,3,208513,208519,208522,6,9,0
59554,1,2,208514,208522,208524,8,10,0
59555,2,3,208516,208524,208527,8,11,0
59556,3,2,208519,208527,208529,8,10,0
59557,1,1,208520,208529,208530,9,10,0
59558,5,1,208525,208530,208531,5,6,0
59559,2,2,208527,208531,208533,4,6,0
59560,1,2,208528,208533,208535,5,7,0
59561,2,1,208530,208535,208536,5,6,0
59562,3,3,208533,208536,208539,3,6,0
59563,5,2,208538,208539,208541,1,3,0
59564,5,1,208543,208543,208544,0,1,2
59565,6,2,208549,208549,208551,0,2,5
59566,4,1,208553,208553,208554,0,1,2
59567,2,3,208555,208555,208558,0,3,1
59568,3,1,208558,208558,208559,0,1,0
59569,4,1,208562,208562,208563,0,1,3
59570,4,3,208566,208566,208569,0,3,3
59571,3,1,208569,208569,208570,0,1,0
59572,5,3,208574,208574,208577,0,3,4
59573,2,1,208576,208577,208578,1,2,0
59574,3,1,208579,208579,208580,0,1,1
59575,1,1,208580,208580,208581,0,1,0
59576,4,2,208584,208584,208586,0,2,3
59577,2,2,208586,208586,208588,0,2,0
59578,5,2,208591,208591,208593,0,2,3
59579,6,1,208597,208597,208598,0,1,4
59580,4,1,208601,208601,208602,0,1,3
59581,4,2,208605,208605,208607,0,2,3
59582,6,3,208611,208611,208614,0,3,4
59583,2,1,208613,208614,208615,1,2,0
59584,5,2,208618,208618,208620,0,2,3
59585,3,3,208621,208621,208624,0,3,1
59586,1,1,208622,208624,208625,2,3,0
59587,5,3,208627,208627,208630,0,3,2
59588,2,3,208629,208630,208633,1,4,0
59589,2,1,208631,208633,208634,2,3,0
59590,5,2,208636,208636,208638,0,2,2
59591,1,1,208637,208638,208639,1,2,0
59592,4,1,208641,208641,208642,0,1,2
59593,1,1,208642,208642,208643,0,1,0
59594,2,3,208644,208644,208647,0,3,1
59595,3,1,208647,208647,208648,0,1,0
59596,6,2,208653,208653,208655,0,2,5
59597,1,2,208654,208655,208657,1,3,0
59598,1,3,208655,208657,208660,2,5,0
59599,4,1,208659,208660,208661,1,2,0
59600,3,3,208662,208662,208665,0,3,1
59601,6,3,208668,208668,208671,0,3,3
59602,4,2,208672,208672,208674,0,2,1
59603,4,2,208676,208676,208678,0,2,2
59604,6,1,208682,208682,208683,0,1,4
59605,5,1,208687,208687,208688,0,1,4
59606,2,1,208689,208689,208690,0,1,1
59607,3,2,208692,208692,208694,0,2,2
59608,1,1,208693,208694,208695,1,2,0
59609,2,1,208695,208695,208696,0,1,0
59610,1,3,208696,208696,208699,0,3,0
59611,3,3,208699,208699,208702,0,3,0
59612,4,1,208703,208703,208704,0,1,1
59613,2,2,208705,208705,208707,0,2,1
59614,3,2,208708,208708,208710,0,2,1
59615,2,3,208710,208710,208713,0,3,0
59616,5,1,208715,208715,208716,0,1,2
59617,6,3,208721,208721,208724,0,3,5
59618,1,3,208722,208724,208727,2,5,0
59619,3,3,208725,208727,208730,2,5,0
59620,2,2,208727,208730,208732,3,5,0
59621,1,3,208728,208732,208735,4,7,0
59622,4,3,208732,208735,208738,3,6,0
59623,6,3,208738,208738,208741,0,3,0
59624,4,3,208742,208742,208745,0,3,1
59625,2,3,208744,208745,208748,1,4,0
59626,6,1,208750,208750,208751,0,1,2
59627,1,1,208751,208751,208752,0,1,0
59628,4,3,208755,208755,208758,0,3,3
59629,6,1,208761,208761,208762,0,1,3
59630,5,2,208766,208766,208768,0,2,4
59631,5,1,208771,208771,208772,0,1,3
59632,2,1,208773,208773,208774,0,1,1
59633,5,3,208778,208778,208781,0,3,4
59634,4,1,208782,208782,208783,0,1,1
59635,3,1,208785,208785,208786,0,1,2
59636,6,2,208791,208791,208793,0,2,5
59637,5,3,208796,208796,208799,0,3,3
59638,4,2,208800,208800,208802,0,2,1
59639,6,2,208806,208806,208808,0,2,4
59640,4,2,208810,208810,208812,0,2,2
59641,5,1,208815,208815,208816,0,1,3
59642,6,2,208821,208821,208823,0,2,5
59643,3,3,208824,208824,208827,0,3,1
59644,2,3,208826,208827,208830,1,4,0
59645,6,1,208832,208832,208833,0,1,2
59646,3,2,208835,208835,208837,0,2,2
59647,6,2,208841,208841,208843,0,2,4
59648,3,1,208844,208844,208845,0,1,1
59649,2,3,208846,208846,208849,0,3,1
59650,3,2,208849,208849,208851,0,2,0
59651,1,3,208850,208851,208854,1,4,0
59652,1,3,208851,208854,208857,3,6,0
59653,1,3,208852,208857,208860,5,8,0
59654,6,2,208858,208860,208862,2,4,0
59655,3,1,208861,208862,208863,1,2,0
59656,6,2,208867,208867,208869,0,2,4
59657,5,1,208872,208872,208873,0,1,3
59658,3,3,208875,208875,208878,0,3,2
59659,3,1,208878,208878,208879,0,1,0
59660,4,2,208882,208882,208884,0,2,3
59661,3,3,208885,208885,208888,0,3,1
59662,2,1,208887,208888,208889,1,2,0
59663,1,2,208888,208889,208891,1,3,0
59664,4,1,208892,208892,208893,0,1,1
59665,1,2,208893,208893,208895,0,2,0
59666,5,1,208898,208898,208899,0,1,3
59667,1,1,208899,208899,208900,0,1,0
59668,1,2,208900,208900,208902,0,2,0
59669,2,2,208902,208902,208904,0,2,0
59670,1,2,208903,208904,208906,1,3,0
59671,5,1,208908,208908,208909,0,1,2
59672,2,1,208910,208910,208911,0,1,1
59673,3,2,208913,208913,208915,0,2,2
59674,2,1,208915,208915,208916,0,1,0
59675,4,1,208919,208919,208920,0,1,3
59676,6,2,208925,208925,208927,0,2,5
59677,4,1,208929,208929,208930,0,1,2
59678,2,1,208931,208931,208932,0,1,1
59679,2,3,208933,208933,208936,0,3,1
59680,1,1,208934,208936,208937,2,3,0
59681,6,3,208940,208940,208943,0,3,3
59682,3,2,208943,208943,208945,0,2,0
59683,6,3,208949,208949,208952,0,3,4
59684,5,2,208954,208954,208956,0,2,2
59685,2,3,208956,208956,208959,0,3,0
59686,5,1,208961,208961,208962,0,1,2
59687,5,2,208966,208966,208968,0,2,4
59688,3,2,208969,208969,208971,0,2,1
59689,4,2,208973,208973,208975,0,2,2
59690,1,3,208974,208975,208978,1,4,0
59691,6,2,208980,208980,208982,0,2,2
59692,2,3,208982,208982,208985,0,3,0
59693,5,3,208987,208987,208990,0,3,2
59694,3,1,208990,208990,208991,0,1,0
59695,2,3,208992,208992,208995,0,3,1
59696,2,1,208994,208995,208996,1,2,0
59697,5,2,208999,208999,209001,0,2,3
59698,6,1,209005,209005,209006,0,1,4
59699,5,1,209010,209010,209011,0,1,4
59700,6,3,209016,209016,209019,0,3,5
59701,5,3,209021,209021,209024,0,3,2
59702,5,2,209026,209026,209028,0,2,2
59703,6,1,209032,209032,209033,0,1,4
59704,3,2,209035,209035,209037,0,2,2
59705,4,3,209039,209039,209042,0,3,2
59706,4,1,209043,209043,209044,0,1,1
59707,4,2,209047,209047,209049,0,2,3
59708,1,1,209048,209049,209050,1,2,0
59709,2,2,209050,209050,209052,0,2,0
59710,6,2,209056,209056,209058,0,2,4
59711,1,2,209057,209058,209060,1,3,0
59712,5,3,209062,209062,209065,0,3,2
59713,6,3,209068,209068,209071,0,3,3
59714,6,1,209074,209074,209075,0,1,3
59715,2,1,209076,209076,209077,0,1,1
59716,1,2,209077,209077,209079,0,2,0
59717,3,3,209080,209080,209083,0,3,1
59718,5,3,209085,209085,209088,0,3,2
59719,5,3,209090,209090,209093,0,3,2
59720,6,3,209096,209096,209099,0,3,3
59721,3,1,209099,209099,209100,0,1,0
59722,2,1,209101,209101,209102,0,1,1
59723,4,3,209105,209105,209108,0,3,3
59724,1,3,209106,209108,209111,2,5,0
59725,6,1,209112,209112,209113,0,1,1
59726,5,1,209117,209117,209118,0,1,4
59727,4,3,209121,209121,209124,0,3,3
59728,6,3,209127,209127,209130,0,3,3
59729,3,1,209130,209130,209131,0,1,0
59730,3,2,209133,209133,209135,0,2,2
59731,6,1,209139,209139,209140,0,1,4
59732,5,2,209144,209144,209146,0,2,4
59733,4,1,209148,209148,209149,0,1,2
59734,3,1,209151,209151,209152,0,1,2
59735,3,1,209154,209154,209155,0,1,2
59736,3,3,209157,209157,209160,0,3,2
59737,1,1,209158,209160,209161,2,3,0
59738,1,2,209159,209161,209163,2,4,0
59739,3,3,209162,209163,209166,1,4,0
59740,1,3,209163,209166,209169,3,6,0
59741,5,1,209168,209169,209170,1,2,0
59742,1,1,209169,209170,209171,1,2,0
59743,6,1,209175,209175,209176,0,1,4
59744,6,2,209181,209181,209183,0,2,5
59745,4,3,209185,209185,209188,0,3,2
59746,4,3,209189,209189,209192,0,3,1
59747,4,1,209193,209193,209194,0,1,1
59748,6,1,209199,209199,209200,0,1,5
59749,2,1,209201,209201,209202,0,1,1
59750,3,3,209204,209204,209207,0,3,2
59751,5,2,209209,209209,209211,0,2,2
59752,1,3,209210,209211,209214,1,4,0
59753,3,3,209213,209214,209217,1,4,0
59754,1,2,209214,209217,209219,3,5,0
59755,2,3,209216,209219,209222,3,6,0
59756,4,3,209220,209222,209225,2,5,0
59757,2,3,209222,209225,209228,3,6,0
59758,3,3,209225,209228,209231,3,6,0
59759,6,2,209231,209231,209233,0,2,0
59760,2,1,209233,209233,209234,0,1,0
59761,4,2,209237,209237,209239,0,2,3
59762,6,1,209243,209243,209244,0,1,4
59763,1,1,209244,209244,209245,0,1,0
59764,4,3,209248,209248,209251,0,3,3
59765,1,1,209249,209251,209252,2,3,0
59766,1,1,209250,209252,209253,2,3,0
59767,2,1,209252,209253,209254,1,2,0
59768,5,1,209257,209257,209258,0,1,3
59769,5,1,209262,209262,209263,0,1,4
59770,4,3,209266,209266,209269,0,3,3
59771,4,2,209270,209270,209272,0,2,1
59772,6,3,209276,209276,209279,0,3,4
59773,2,3,209278,209279,209282,1,4,0
59774,1,1,209279,209282,209283,3,4,0
59775,2,3,209281,209283,209286,2,5,0
59776,6,1,209287,209287,209288,0,1,1
59777,2,2,209289,209289,209291,0,2,1
59778,4,1,209293,209293,209294,0,1,2
59779,1,2,209294,209294,209296,0,2,0
59780,2,2,209296,209296,209298,0,2,0
59781,3,3,209299,209299,209302,0,3,1
59782,3,1,209302,209302,209303,0,1,0
59783,6,3,209308,209308,209311,0,3,5
59784,5,1,209313,209313,209314,0,1,2
59785,2,2,209315,209315,209317,0,2,1
59786,4,1,209319,209319,209320,0,1,2
59787,5,2,209324,209324,209326,0,2,4
59788,1,3,209325,209326,209329,1,4,0
59789,3,3,209328,209329,209332,1,4,0
59790,2,1,209330,209332,209333,2,3,0
59791,3,3,209333,209333,209336,0,3,0
59792,1,3,209334,209336,209339,2,5,0
59793,3,1,209337,209339,209340,2,3,0
59794,2,2,209339,209340,209342,1,3,0
59795,6,3,209345,209345,209348,0,3,3
59796,1,1,209346,209348,209349,2,3,0
59797,6,1,209352,209352,209353,0,1,3
59798,5,2,209357,209357,209359,0,2,4
59799,3,2,209360,209360,209362,0,2,1
59800,5,3,209365,209365,209368,0,3,3
59801,6,3,209371,209371,209374,0,3,3
59802,4,2,209375,209375,209377,0,2,1
59803,4,2,209379,209379,209381,0,2,2
59804,4,3,209383,209383,209386,0,3,2
59805,4,3,209387,209387,209390,0,3,1
59806,1,2,209388,209390,209392,2,4,0
59807,1,3,209389,209392,209395,3,6,0
59808,6,1,209395,209395,209396,0,1,0
59809,5,3,209400,209400,209403,0,3,4
59810,4,2,209404,209404,209406,0,2,1
59811,2,2,209406,209406,209408,0,2,0
59812,4,2,209410,209410,209412,0,2,2
59813,3,1,209413,209413,209414,0,1,1
59814,3,2,209416,209416,209418,0,2,2
59815,6,3,209422,209422,209425,0,3,4
59816,1,2,209423,209425,209427,2,4,0
59817,6,1,209429,209429,209430,0,1,2
59818,4,3,209433,209433,209436,0,3,3
59819,1,2,209434,209436,209438,2,4,0
59820,1,1,209435,209438,209439,3,4,0
59821,5,2,209440,209440,209442,0,2,1
59822,4,3,209444,209444,209447,0,3,2
59823,3,3,209447,209447,209450,0,3,0
59824,6,1,209453,209453,209454,0,1,3
59825,5,2,209458,209458,209460,0,2,4
59826,1,1,209459,209460,209461,1,2,0
59827,6,2,209465,209465,209467,0,2,4
59828,2,1,209467,209467,209468,0,1,0
59829,3,3,209470,209470,209473,0,3,2
59830,5,3,209475,209475,209478,0,3,2
59831,2,1,209477,209478,209479,1,2,0
59832,4,2,209481,209481,209483,0,2,2
59833,6,3,209487,209487,209490,0,3,4
59834,6,2,209493,209493,209495,0,2,3
59835,5,1,209498,209498,209499,0,1,3
59836,5,1,209503,209503,209504,0,1,4
59837,4,3,209507,209507,209510,0,3,3
59838,1,2,209508,209510,209512,2,4,0
59839,3,2,209511,209512,209514,1,3,0
59840,1,2,209512,209514,209516,2,4,0
59841,2,3,209514,209516,209519,2,5,0
59842,5,3,209519,209519,209522,0,3,0
59843,6,2,209525,209525,209527,0,2,3
59844,2,3,209527,209527,209530,0,3,0
59845,1,1,209528,209530,209531,2,3,0
59846,2,1,209530,209531,209532,1,2,0
59847,3,3,209533,209533,209536,0,3,1
59848,2,1,209535,209536,209537,1,2,0
59849,6,3,209541,209541,209544,0,3,4
59850,6,1,209547,209547,209548,0,1,3
59851,4,2,209551,209551,209553,0,2,3
59852,3,1,209554,209554,209555,0,1,1
59853,4,1,209558,209558,209559,0,1,3
59854,1,2,209559,209559,209561,0,2,0
59855,1,1,209560,209561,209562,1,2,0
59856,2,2,209562,209562,209564,0,2,0
59857,6,2,209568,209568,209570,0,2,4
59858,2,1,209570,209570,209571,0,1,0
59859,4,2,209574,209574,209576,0,2,3
59860,4,1,209578,209578,209579,0,1,2
59861,1,1,209579,209579,209580,0,1,0
59862,5,3,209584,209584,209587,0,3,4
59863,2,1,209586,209587,209588,1,2,0
59864,1,1,209587,209588,209589,1,2,0
59865,6,2,209593,209593,209595,0,2,4
59866,3,2,209596,209596,209598,0,2,1
59867,3,1,209599,209599,209600,0,1,1
59868,4,1,209603,209603,209604,0,1,3
59869,4,3,209607,209607,209610,0,3,3
59870,1,1,209608,209610,209611,2,3,0
59871,4,3,209612,209612,209615,0,3,1
59872,6,2,209618,209618,209620,0,2,3
59873,4,2,209622,209622,209624,0,2,2
59874,3,2,209625,209625,209627,0,2,1
59875,3,2,209628,209628,209630,0,2,1
59876,1,3,209629,209630,209633,1,4,0
59877,2,3,209631,209633,209636,2,5,0
59878,5,2,209636,209636,209638,0,2,0
59879,5,1,209641,209641,209642,0,1,3
59880,6,3,209647,209647,209650,0,3,5
59881,5,2,209652,209652,209654,0,2,2
59882,2,2,209654,209654,209656,0,2,0
59883,2,1,209656,209656,209657,0,1,0
59884,6,3,209662,209662,209665,0,3,5
59885,1,3,209663,209665,209668,2,5,0
59886,2,2,209665,209668,209670,3,5,0
59887,4,1,209669,209670,209671,1,2,0
59888,1,3,209670,209671,209674,1,4,0
59889,5,3,209675,209675,209678,0,3,1
59890,5,2,209680,209680,209682,0,2,2
59891,4,3,209684,209684,209687,0,3,2
59892,4,3,209688,209688,209691,0,3,1
59893,3,3,209691,209691,209694,0,3,0
59894,4,1,209695,209695,209696,0,1,1
59895,5,3,209700,209700,209703,0,3,4
59896,4,2,209704,209704,209706,0,2,1
59897,5,3,209709,209709,209712,0,3,3
59898,2,1,209711,209712,209713,1,2,0
59899,4,3,209715,209715,209718,0,3,2
59900,1,1,209716,209718,209719,2,3,0
59901,3,1,209719,209719,209720,0,1,0
59902,2,2,209721,209721,209723,0,2,1
59903,6,2,209727,209727,209729,0,2,4
59904,6,1,209733,209733,209734,0,1,4
59905,4,2,209737,209737,209739,0,2,3
59906,6,1,209743,209743,209744,0,1,4
59907,2,3,209745,209745,209748,0,3,1
59908,4,2,209749,209749,209751,0,2,1
59909,4,2,209753,209753,209755,0,2,2
59910,1,1,209754,209755,209756,1,2,0
59911,4,1,209758,209758,209759,0,1,2
59912,2,2,209760,209760,209762,0,2,1
59913,2,1,209762,209762,209763,0,1,0
59914,4,2,209766,209766,209768,0,2,3
59915,5,1,209771,209771,209772,0,1,3
59916,4,1,209775,209775,209776,0,1,3
59917,2,1,209777,209777,209778,0,1,1
59918,2,3,209779,209779,209782,0,3,1
59919,6,1,209785,209785,209786,0,1,3
59920,6,2,209791,209791,209793,0,2,5
59921,6,1,209797,209797,209798,0,1,4
59922,3,2,209800,209800,209802,0,2,2
59923,4,1,209804,209804,209805,0,1,2
59924,1,3,209805,209805,209808,0,3,0
59925,2,1,209807,209808,209809,1,2,0
59926,3,1,209810,209810,209811,0,1,1
59927,3,1,209813,209813,209814,0,1,2
59928,6,1,209819,209819,209820,0,1,5
59929,5,1,209824,209824,209825,0,1,4
59930,3,1,209827,209827,209828,0,1,2
59931,1,2,209828,209828,209830,0,2,0
59932,5,1,209833,209833,209834,0,1,3
59933,4,1,209837,209837,209838,0,1,3
59934,4,2,209841,209841,209843,0,2,3
59935,3,1,209844,209844,209845,0,1,1
59936,3,2,209847,209847,209849,0,2,2
59937,6,1,209853,209853,209854,0,1,4
59938,4,3,209857,209857,209860,0,3,3
59939,3,1,209860,209860,209861,0,1,0
59940,6,2,209866,209866,209868,0,2,5
59941,3,1,209869,209869,209870,0,1,1
59942,6,1,209875,209875,209876,0,1,5
59943,6,1,209881,209881,209882,0,1,5
59944,2,3,209883,209883,209886,0,3,1
59945,6,1,209889,209889,209890,0,1,3
59946,2,2,209891,209891,209893,0,2,1
59947,6,1,209897,209897,209898,0,1,4
59948,6,3,209903,209903,209906,0,3,5
59949,6,3,209909,209909,209912,0,3,3
59950,2,2,209911,209912,209914,1,3,0
59951,6,2,209917,209917,209919,0,2,3
59952,5,1,209922,209922,209923,0,1,3
59953,5,3,209927,209927,209930,0,3,4
59954,5,3,209932,209932,209935,0,3,2
59955,5,1,209937,209937,209938,0,1,2
59956,1,1,209938,209938,209939,0,1,0
59957,6,2,209944,209944,209946,0,2,5
59958,6,1,209950,209950,209951,0,1,4
59959,4,1,209954,209954,209955,0,1,3
59960,4,2,209958,209958,209960,0,2,3
59961,2,3,209960,209960,209963,0,3,0
59962,1,1,209961,209963,209964,2,3,0
59963,3,3,209964,209964,209967,0,3,0
59964,4,2,209968,209968,209970,0,2,1
59965,2,1,209970,209970,209971,0,1,0
59966,2,1,209972,209972,209973,0,1,1
59967,6,1,209978,209978,209979,0,1,5
59968,6,2,209984,209984,209986,0,2,5
59969,1,1,209985,209986,209987,1,2,0
59970,1,3,209986,209987,209990,1,4,0
59971,1,1,209987,209990,209991,3,4,0
59972,3,1,209990,209991,209992,1,2,0
59973,1,3,209991,209992,209995,1,4,0
59974,1,2,209992,209995,209997,3,5,0
59975,3,3,209995,209997,210000,2,5,0
59976,5,3,210000,210000,210003,0,3,0
59977,3,1,210003,210003,210004,0,1,0
59978,6,3,210009,210009,210012,0,3,5
59979,3,3,210012,210012,210015,0,3,0
59980,3,2,210015,210015,210017,0,2,0
59981,2,3,210017,210017,210020,0,3,0
59982,2,2,210019,210020,210022,1,3,0
59983,6,3,210025,210025,210028,0,3,3
59984,3,1,210028,210028,210029,0,1,0
59985,1,2,210029,210029,210031,0,2,0
59986,4,3,210033,210033,210036,0,3,2
59987,6,2,210039,210039,210041,0,2,3
59988,3,1,210042,210042,210043,0,1,1
59989,1,1,210043,210043,210044,0,1,0
59990,3,1,210046,210046,210047,0,1,2
59991,3,1,210049,210049,210050,0,1,2
59992,4,1,210053,210053,210054,0,1,3
59993,2,3,210055,210055,210058,0,3,1
59994,3,3,210058,210058,210061,0,3,0
59995,4,1,210062,210062,210063,0,1,1
59996,1,3,210063,210063,210066,0,3,0
59997,5,1,210068,210068,210069,0,1,2
59998,6,3,210074,210074,210077,0,3,5
59999,6,3,210080,210080,210083,0,3,3
60000,2,2,210082,210083,210085,1,3,0
60001,6,1,210088,210088,210089,0,1,3
60002,5,3,210093,210093,210096,0,3,4
60003,5,2,210098,210098,210100,0,2,2
60004,4,2,210102,210102,210104,0,2,2
60005,4,1,210106,210106,210107,0,1,2
60006,6,2,210112,210112,210114,0,2,5
60007,3,3,210115,210115,210118,0,3,1
60008,3,2,210118,210118,210120,0,2,0
60009,1,2,210119,210120,210122,1,3,0
60010,1,2,210120,210122,210124,2,4,0
60011,3,2,210123,210124,210126,1,3,0
60012,1,1,210124,210126,210127,2,3,0
60013,5,2,210129,210129,210131,0,2,2
60014,1,3,210130,210131,210134,1,4,0
60015,3,2,210133,210134,210136,1,3,0
60016,3,1,210136,210136,210137,0,1,0
60017,2,3,210138,210138,210141,0,3,1
60018,4,1,210142,210142,210143,0,1,1
60019,3,1,210145,210145,210146,0,1,2
60020,1,3,210146,210146,210149,0,3,0
60021,5,1,210151,210151,210152,0,1,2
60022,2,3,210153,210153,210156,0,3,1
60023,5,3,210158,210158,210161,0,3,2
60024,3,3,210161,210161,210164,0,3,0
60025,6,2,210167,210167,210169,0,2,3
60026,3,3,210170,210170,210173,0,3,1
60027,2,1,210172,210173,210174,1,2,0
60028,5,3,210177,210177,210180,0,3,3
60029,6,3,210183,210183,210186,0,3,3
60030,6,2,210189,210189,210191,0,2,3
60031,3,1,210192,210192,210193,0,1,1
60032,6,3,210198,210198,210201,0,3,5
60033,4,1,210202,210202,210203,0,1,1
60034,2,3,210204,210204,210207,0,3,1
60035,2,1,210206,210207,210208,1,2,0
60036,6,1,210212,210212,210213,0,1,4
60037,4,3,210216,210216,210219,0,3,3
60038,5,2,210221,210221,210223,0,2,2
60039,1,1,210222,210223,210224,1,2,0
60040,5,1,210227,210227,210228,0,1,3
60041,4,1,210231,210231,210232,0,1,3
60042,2,2,210233,210233,210235,0,2,1
60043,1,2,210234,210235,210237,1,3,0
60044,1,1,210235,210237,210238,2,3,0
60045,6,2,210241,210241,210243,0,2,3
60046,4,2,210245,210245,210247,0,2,2
60047,3,1,210248,210248,210249,0,1,1
60048,5,2,210253,210253,210255,0,2,4
60049,1,1,210254,210255,210256,1,2,0
60050,5,1,210259,210259,210260,0,1,3
60051,2,3,210261,210261,210264,0,3,1
60052,2,2,210263,210264,210266,1,3,0
60053,3,1,210266,210266,210267,0,1,0
60054,2,2,210268,210268,210270,0,2,1
60055,2,1,210270,210270,210271,0,1,0
60056,3,2,210273,210273,210275,0,2,2
60057,4,2,210277,210277,210279,0,2,2
60058,6,3,210283,210283,210286,0,3,4
60059,3,1,210286,210286,210287,0,1,0
60060,5,1,210291,210291,210292,0,1,4
60061,3,2,210294,210294,210296,0,2,2
60062,1,1,210295,210296,210297,1,2,0
60063,4,2,210299,210299,210301,0,2,2
60064,1,3,210300,210301,210304,1,4,0
60065,4,1,210304,210304,210305,0,1,0
60066,2,2,210306,210306,210308,0,2,1
60067,4,1,210310,210310,210311,0,1,2
60068,2,1,210312,210312,210313,0,1,1
60069,4,3,210316,210316,210319,0,3,3
60070,3,1,210319,210319,210320,0,1,0
60071,6,1,210325,210325,210326,0,1,5
60072,6,2,210331,210331,210333,0,2,5
60073,6,2,210337,210337,210339,0,2,4
60074,6,2,210343,210343,210345,0,2,4
60075,3,3,210346,210346,210349,0,3,1
60076,5,1,210351,210351,210352,0,1,2
60077,1,3,210352,210352,210355,0,3,0
60078,5,1,210357,210357,210358,0,1,2
60079,3,3,210360,210360,210363,0,3,2
60080,1,2,210361,210363,210365,2,4,0
60081,6,2,210367,210367,210369,0,2,2
60082,1,1,210368,210369,210370,1,2,0
60083,4,3,210372,210372,210375,0,3,2
60084,1,3,210373,210375,210378,2,5,0
60085,3,1,210376,210378,210379,2,3,0
60086,3,1,210379,210379,210380,0,1,0
60087,3,3,210382,210382,210385,0,3,2
60088,2,1,210384,210385,210386,1,2,0
60089,5,1,210389,210389,210390,0,1,3
60090,2,3,210391,210391,210394,0,3,1
60091,4,1,210395,210395,210396,0,1,1
60092,3,2,210398,210398,210400,0,2,2
60093,2,1,210400,210400,210401,0,1,0
60094,3,2,210403,210403,210405,0,2,2
60095,3,3,210406,210406,210409,0,3,1
60096,5,3,210411,210411,210414,0,3,2
60097,2,2,210413,210414,210416,1,3,0
60098,1,2,210414,210416,210418,2,4,0
60099,5,2,210419,210419,210421,0,2,1
60100,1,2,210420,210421,210423,1,3,0
60101,5,2,210425,210425,210427,0,2,2
60102,5,3,210430,210430,210433,0,3,3
60103,5,3,210435,210435,210438,0,3,2
60104,3,1,210438,210438,210439,0,1,0
60105,1,1,210439,210439,210440,0,1,0
60106,2,2,210441,210441,210443,0,2,1
60107,1,2,210442,210443,210445,1,3,0
60108,1,3,210443,210445,210448,2,5,0
60109,4,2,210447,210448,210450,1,3,0
60110,3,1,210450,210450,210451,0,1,0
60111,4,3,210454,210454,210457,0,3,3
60112,3,1,210457,210457,210458,0,1,0
60113,3,2,210460,210460,210462,0,2,2
60114,4,2,210464,210464,210466,0,2,2
60115,3,3,210467,210467,210470,0,3,1
60116,6,2,210473,210473,210475,0,2,3
60117,3,1,210476,210476,210477,0,1,1
60118,6,2,210482,210482,210484,0,2,5
60119,4,2,210486,210486,210488,0,2,2
60120,4,3,210490,210490,210493,0,3,2
60121,1,1,210491,210493,210494,2,3,0
60122,2,2,210493,210494,210496,1,3,0
60123,2,1,210495,210496,210497,1,2,0
60124,2,3,210497,210497,210500,0,3,0
60125,1,2,210498,210500,210502,2,4,0
60126,4,2,210502,210502,210504,0,2,0
60127,2,2,210504,210504,210506,0,2,0
60128,6,3,210510,210510,210513,0,3,4
60129,2,2,210512,210513,210515,1,3,0
60130,5,1,210517,210517,210518,0,1,2
60131,4,2,210521,210521,210523,0,2,3
60132,4,1,210525,210525,210526,0,1,2
60133,1,2,210526,210526,210528,0,2,0
60134,6,3,210532,210532,210535,0,3,4
60135,1,2,210533,210535,210537,2,4,0
60136,3,2,210536,210537,210539,1,3,0
60137,1,2,210537,210539,210541,2,4,0
60138,6,3,210543,210543,210546,0,3,2
60139,3,1,210546,210546,210547,0,1,0
60140,5,3,210551,210551,210554,0,3,4
60141,2,3,210553,210554,210557,1,4,0
60142,3,1,210556,210557,210558,1,2,0
60143,4,1,210560,210560,210561,0,1,2
60144,2,3,210562,210562,210565,0,3,1
60145,3,1,210565,210565,210566,0,1,0
60146,3,3,210568,210568,210571,0,3,2
60147,3,1,210571,210571,210572,0,1,0
60148,1,3,210572,210572,210575,0,3,0
60149,2,2,210574,210575,210577,1,3,0
60150,2,1,210576,210577,210578,1,2,0
60151,1,3,210577,210578,210581,1,4,0
60152,2,1,210579,210581,210582,2,3,0
60153,6,3,210585,210585,210588,0,3,3
60154,2,3,210587,210588,210591,1,4,0
60155,4,2,210591,210591,210593,0,2,0
60156,4,1,210595,210595,210596,0,1,2
60157,6,3,210601,210601,210604,0,3,5
60158,1,3,210602,210604,210607,2,5,0
60159,5,3,210607,210607,210610,0,3,0
60160,6,1,210613,210613,210614,0,1,3
60161,5,1,210618,210618,210619,0,1,4
60162,3,3,210621,210621,210624,0,3,2
60163,4,1,210625,210625,210626,0,1,1
60164,5,2,210630,210630,210632,0,2,4
60165,4,1,210634,210634,210635,0,1,2
60166,5,1,210639,210639,210640,0,1,4
60167,4,2,210643,210643,210645,0,2,3
60168,2,1,210645,210645,210646,0,1,0
60169,5,1,210650,210650,210651,0,1,4
60170,1,3,210651,210651,210654,0,3,0
60171,1,1,210652,210654,210655,2,3,0
60172,4,2,210656,210656,210658,0,2,1
60173,3,2,210659,210659,210661,0,2,1
60174,1,2,210660,210661,210663,1,3,0
60175,3,2,210663,210663,210665,0,2,0
60176,1,3,210664,210665,210668,1,4,0
60177,2,3,210666,210668,210671,2,5,0
60178,6,1,210672,210672,210673,0,1,1
60179,6,2,210678,210678,210680,0,2,5
60180,2,3,210680,210680,210683,0,3,0
60181,2,1,210682,210683,210684,1,2,0
60182,6,1,210688,210688,210689,0,1,4
60183,6,2,210694,210694,210696,0,2,5
60184,1,2,210695,210696,210698,1,3,0
60185,4,3,210699,210699,210702,0,3,1
60186,2,2,210701,210702,210704,1,3,0
60187,4,3,210705,210705,210708,0,3,1
60188,5,2,210710,210710,210712,0,2,2
60189,1,3,210711,210712,210715,1,4,0
60190,4,1,210715,210715,210716,0,1,0
60191,6,3,210721,210721,210724,0,3,5
60192,4,3,210725,210725,210728,0,3,1
60193,3,3,210728,210728,210731,0,3,0
60194,1,2,210729,210731,210733,2,4,0
60195,5,3,210734,210734,210737,0,3,1
60196,5,1,210739,210739,210740,0,1,2
60197,1,3,210740,210740,210743,0,3,0
60198,6,2,210746,210746,210748,0,2,3
60199,2,2,210748,210748,210750,0,2,0
60200,5,1,210753,210753,210754,0,1,3
60201,1,2,210754,210754,210756,0,2,0
60202,5,1,210759,210759,210760,0,1,3
60203,3,3,210762,210762,210765,0,3,2
60204,3,2,210765,210765,210767,0,2,0
60205,5,2,210770,210770,210772,0,2,3
60206,5,3,210775,210775,210778,0,3,3
60207,4,1,210779,210779,210780,0,1,1
60208,1,3,210780,210780,210783,0,3,0
60209,3,2,210783,210783,210785,0,2,0
60210,5,2,210788,210788,210790,0,2,3
60211,4,2,210792,210792,210794,0,2,2
60212,1,3,210793,210794,210797,1,4,0
60213,5,1,210798,210798,210799,0,1,1
60214,3,2,210801,210801,210803,0,2,2
60215,2,1,210803,210803,210804,0,1,0
60216,6,1,210809,210809,210810,0,1,5
60217,6,1,210815,210815,210816,0,1,5
60218,6,1,210821,210821,210822,0,1,5
60219,6,2,210827,210827,210829,0,2,5
60220,4,2,210831,210831,210833,0,2,2
60221,5,1,210836,210836,210837,0,1,3
60222,1,2,210837,210837,210839,0,2,0
60223,2,3,210839,210839,210842,0,3,0
60224,6,1,210845,210845,210846,0,1,3
60225,3,3,210848,210848,210851,0,3,2
60226,6,2,210854,210854,210856,0,2,3
60227,4,2,210858,210858,210860,0,2,2
60228,2,3,210860,210860,210863,0,3,0
60229,1,2,210861,210863,210865,2,4,0
60230,3,2,210864,210865,210867,1,3,0
60231,2,2,210866,210867,210869,1,3,0
60232,2,2,210868,210869,210871,1,3,0
60233,6,1,210874,210874,210875,0,1,3
60234,4,1,210878,210878,210879,0,1,3
60235,4,1,210882,210882,210883,0,1,3
60236,4,2,210886,210886,210888,0,2,3
60237,3,1,210889,210889,210890,0,1,1
60238,1,3,210890,210890,210893,0,3,0
60239,2,2,210892,210893,210895,1,3,0
60240,1,3,210893,210895,210898,2,5,0
60241,2,2,210895,210898,210900,3,5,0
60242,4,2,210899,210900,210902,1,3,0
60243,4,3,210903,210903,210906,0,3,1
60244,6,2,210909,210909,210911,0,2,3
60245,1,2,210910,210911,210913,1,3,0
60246,4,1,210914,210914,210915,0,1,1
60247,4,2,210918,210918,210920,0,2,3
60248,6,2,210924,210924,210926,0,2,4
60249,6,2,210930,210930,210932,0,2,4
60250,6,3,210936,210936,210939,0,3,4
60251,4,2,210940,210940,210942,0,2,1
60252,6,1,210946,210946,210947,0,1,4
60253,2,1,210948,210948,210949,0,1,1
60254,4,1,210952,210952,210953,0,1,3
60255,4,1,210956,210956,210957,0,1,3
60256,5,3,210961,210961,210964,0,3,4
60257,2,2,210963,210964,210966,1,3,0
60258,3,1,210966,210966,210967,0,1,0
60259,3,1,210969,210969,210970,0,1,2
60260,5,1,210974,210974,210975,0,1,4
60261,6,3,210980,210980,210983,0,3,5
60262,4,3,210984,210984,210987,0,3,1
60263,3,3,210987,210987,210990,0,3,0
60264,1,1,210988,210990,210991,2,3,0
60265,6,2,210994,210994,210996,0,2,3
60266,6,3,211000,211000,211003,0,3,4
60267,4,1,211004,211004,211005,0,1,1
60268,2,1,211006,211006,211007,0,1,1
60269,5,2,211011,211011,211013,0,2,4
60270,3,3,211014,211014,211017,0,3,1
60271,5,1,211019,211019,211020,0,1,2
60272,2,1,211021,211021,211022,0,1,1
60273,6,2,211027,211027,211029,0,2,5
60274,3,3,211030,211030,211033,0,3,1
60275,5,2,211035,211035,211037,0,2,2
60276,4,2,211039,211039,211041,0,2,2
60277,2,3,211041,211041,211044,0,3,0
60278,4,3,211045,211045,211048,0,3,1
60279,2,1,211047,211048,211049,1,2,0
60280,1,1,211048,211049,211050,1,2,0
60281,4,1,211052,211052,211053,0,1,2
60282,4,1,211056,211056,211057,0,1,3
60283,6,1,211062,211062,211063,0,1,5
60284,2,3,211064,211064,211067,0,3,1
60285,6,1,211070,211070,211071,0,1,3
60286,1,2,211071,211071,211073,0,2,0
60287,1,3,211072,211073,211076,1,4,0
60288,3,2,211075,211076,211078,1,3,0
60289,2,3,211077,211078,211081,1,4,0
60290,3,1,211080,211081,211082,1,2,0
60291,3,2,211083,211083,211085,0,2,1
60292,4,2,211087,211087,211089,0,2,2
60293,4,3,211091,211091,211094,0,3,2
60294,1,3,211092,211094,211097,2,5,0
60295,4,2,211096,211097,211099,1,3,0
60296,3,1,211099,211099,211100,0,1,0
60297,5,3,211104,211104,211107,0,3,4
60298,5,3,211109,211109,211112,0,3,2
60299,4,3,211113,211113,211116,0,3,1
60300,5,3,211118,211118,211121,0,3,2
60301,6,2,211124,211124,211126,0,2,3
60302,6,1,211130,211130,211131,0,1,4
60303,3,1,211133,211133,211134,0,1,2
60304,2,1,211135,211135,211136,0,1,1
60305,5,2,211140,211140,211142,0,2,4
60306,3,2,211143,211143,211145,0,2,1
60307,3,3,211146,211146,211149,0,3,1
60308,4,2,211150,211150,211152,0,2,1
60309,5,3,211155,211155,211158,0,3,3
60310,4,3,211159,211159,211162,0,3,1
60311,2,3,211161,211162,211165,1,4,0
60312,1,3,211162,211165,211168,3,6,0
60313,2,3,211164,211168,211171,4,7,0
60314,4,2,211168,211171,211173,3,5,0
60315,4,2,211172,211173,211175,1,3,0
60316,4,3,211176,211176,211179,0,3,1
60317,1,2,211177,211179,211181,2,4,0
60318,6,2,211183,211183,211185,0,2,2
60319,2,1,211185,211185,211186,0,1,0
60320,4,2,211189,211189,211191,0,2,3
60321,6,1,211195,211195,211196,0,1,4
60322,4,3,211199,211199,211202,0,3,3
60323,5,1,211204,211204,211205,0,1,2
60324,4,1,211208,211208,211209,0,1,3
60325,6,3,211214,211214,211217,0,3,5
60326,6,1,211220,211220,211221,0,1,3
60327,3,2,211223,211223,211225,0,2,2
60328,6,1,211229,211229,211230,0,1,4
60329,5,2,211234,211234,211236,0,2,4
60330,5,3,211239,211239,211242,0,3,3
60331,4,3,211243,211243,211246,0,3,1
60332,3,2,211246,211246,211248,0,2,0
60333,2,1,211248,211248,211249,0,1,0
60334,6,3,211254,211254,211257,0,3,5
60335,1,3,211255,211257,211260,2,5,0
60336,5,2,211260,211260,211262,0,2,0
60337,4,3,211264,211264,211267,0,3,2
60338,6,2,211270,211270,211272,0,2,3
60339,1,3,211271,211272,211275,1,4,0
60340,5,1,211276,211276,211277,0,1,1
60341,1,1,211277,211277,211278,0,1,0
60342,1,3,211278,211278,211281,0,3,0
60343,2,3,211280,211281,211284,1,4,0
60344,3,3,211283,211284,211287,1,4,0
60345,2,1,211285,211287,211288,2,3,0
60346,6,1,211291,211291,211292,0,1,3
60347,3,3,211294,211294,211297,0,3,2
60348,1,1,211295,211297,211298,2,3,0
60349,6,2,211301,211301,211303,0,2,3
60350,6,3,211307,211307,211310,0,3,4
60351,1,3,211308,211310,211313,2,5,0
60352,2,1,211310,211313,211314,3,4,0
60353,5,3,211315,211315,211318,0,3,1
60354,1,2,211316,211318,211320,2,4,0
60355,4,3,211320,211320,211323,0,3,0
60356,1,3,211321,211323,211326,2,5,0
60357,5,2,211326,211326,211328,0,2,0
60358,2,2,211328,211328,211330,0,2,0
60359,4,2,211332,211332,211334,0,2,2
60360,3,2,211335,211335,211337,0,2,1
60361,2,2,211337,211337,211339,0,2,0
60362,5,2,211342,211342,211344,0,2,3
60363,5,2,211347,211347,211349,0,2,3
60364,1,3,211348,211349,211352,1,4,0
60365,2,2,211350,211352,211354,2,4,0
60366,5,3,211355,211355,211358,0,3,1
60367,1,3,211356,211358,211361,2,5,0
60368,5,2,211361,211361,211363,0,2,0
60369,4,2,211365,211365,211367,0,2,2
60370,2,1,211367,211367,211368,0,1,0
60371,4,1,211371,211371,211372,0,1,3
60372,1,2,211372,211372,211374,0,2,0
60373,2,3,211374,211374,211377,0,3,0
60374,4,1,211378,211378,211379,0,1,1
60375,6,2,211384,211384,211386,0,2,5
60376,6,2,211390,211390,211392,0,2,4
60377,3,3,211393,211393,211396,0,3,1
60378,1,2,211394,211396,211398,2,4,0
60379,3,1,211397,211398,211399,1,2,0
60380,4,2,211401,211401,211403,0,2,2
60381,5,1,211406,211406,211407,0,1,3
60382,5,2,211411,211411,211413,0,2,4
60383,2,2,211413,211413,211415,0,2,0
60384,2,2,211415,211415,211417,0,2,0
60385,6,3,211421,211421,211424,0,3,4
60386,6,2,211427,211427,211429,0,2,3
60387,5,1,211432,211432,211433,0,1,3
60388,3,2,211435,211435,211437,0,2,2
60389,2,2,211437,211437,211439,0,2,0
60390,2,3,211439,211439,211442,0,3,0
60391,6,1,211445,211445,211446,0,1,3
60392,1,2,211446,211446,211448,0,2,0
60393,6,1,211452,211452,211453,0,1,4
60394,5,1,211457,211457,211458,0,1,4
60395,6,1,211463,211463,211464,0,1,5
60396,3,1,211466,211466,211467,0,1,2
60397,1,2,211467,211467,211469,0,2,0
60398,5,3,211472,211472,211475,0,3,3
60399,5,1,211477,211477,211478,0,1,2
60400,4,1,211481,211481,211482,0,1,3
60401,5,3,211486,211486,211489,0,3,4
60402,1,1,211487,211489,211490,2,3,0
60403,6,1,211493,211493,211494,0,1,3
60404,3,2,211496,211496,211498,0,2,2
60405,4,1,211500,211500,211501,0,1,2
60406,1,2,211501,211501,211503,0,2,0
60407,2,1,211503,211503,211504,0,1,0
60408,6,3,211509,211509,211512,0,3,5
60409,5,2,211514,211514,211516,0,2,2
60410,1,2,211515,211516,211518,1,3,0
60411,1,3,211516,211518,211521,2,5,0
60412,1,3,211517,211521,211524,4,7,0
60413,4,2,211521,211524,211526,3,5,0
60414,4,1,211525,211526,211527,1,2,0
60415,6,2,211531,211531,211533,0,2,4
60416,4,1,211535,211535,211536,0,1,2
60417,6,1,211541,211541,211542,0,1,5
60418,3,1,211544,211544,211545,0,1,2
60419,5,2,211549,211549,211551,0,2,4
60420,2,1,211551,211551,211552,0,1,0
60421,3,1,211554,211554,211555,0,1,2
60422,4,3,211558,211558,211561,0,3,3
60423,5,2,211563,211563,211565,0,2,2
60424,3,2,211566,211566,211568,0,2,1
60425,5,2,211571,211571,211573,0,2,3
60426,2,3,211573,211573,211576,0,3,0
60427,2,2,211575,211576,211578,1,3,0
60428,6,1,211581,211581,211582,0,1,3
60429,6,1,211587,211587,211588,0,1,5
60430,2,3,211589,211589,211592,0,3,1
60431,2,1,211591,211592,211593,1,2,0
60432,5,2,211596,211596,211598,0,2,3
60433,5,3,211601,211601,211604,0,3,3
60434,2,2,211603,211604,211606,1,3,0
60435,5,2,211608,211608,211610,0,2,2
60436,6,3,211614,211614,211617,0,3,4
60437,3,3,211617,211617,211620,0,3,0
60438,5,2,211622,211622,211624,0,2,2
60439,4,3,211626,211626,211629,0,3,2
60440,3,1,211629,211629,211630,0,1,0
60441,3,2,211632,211632,211634,0,2,2
60442,3,1,211635,211635,211636,0,1,1
60443,2,3,211637,211637,211640,0,3,1
60444,4,2,211641,211641,211643,0,2,1
60445,6,1,211647,211647,211648,0,1,4
60446,5,2,211652,211652,211654,0,2,4
60447,6,3,211658,211658,211661,0,3,4
60448,5,2,211663,211663,211665,0,2,2
60449,1,1,211664,211665,211666,1,2,0
60450,2,3,211666,211666,211669,0,3,0
60451,2,1,211668,211669,211670,1,2,0
60452,4,1,211672,211672,211673,0,1,2
60453,5,1,211677,211677,211678,0,1,4
60454,3,1,211680,211680,211681,0,1,2
60455,6,3,211686,211686,211689,0,3,5
60456,1,3,211687,211689,211692,2,5,0
60457,1,1,211688,211692,211693,4,5,0
60458,1,3,211689,211693,211696,4,7,0
60459,1,1,211690,211696,211697,6,7,0
60460,5,3,211695,211697,211700,2,5,0
60461,2,1,211697,211700,211701,3,4,0
60462,5,3,211702,211702,211705,0,3,1
60463,2,3,211704,211705,211708,1,4,0
60464,4,3,211708,211708,211711,0,3,0
60465,1,1,211709,211711,211712,2,3,0
60466,2,2,211711,211712,211714,1,3,0
60467,3,1,211714,211714,211715,0,1,0
60468,1,1,211715,211715,211716,0,1,0
60469,2,3,211717,211717,211720,0,3,1
60470,1,2,211718,211720,211722,2,4,0
60471,2,1,211720,211722,211723,2,3,0
60472,1,1,211721,211723,211724,2,3,0
60473,3,2,211724,211724,211726,0,2,0
60474,2,3,211726,211726,211729,0,3,0
60475,5,3,211731,211731,211734,0,3,2
60476,4,1,211735,211735,211736,0,1,1
60477,3,2,211738,211738,211740,0,2,2
60478,6,1,211744,211744,211745,0,1,4
60479,3,2,211747,211747,211749,0,2,2
60480,1,1,211748,211749,211750,1,2,0
60481,4,2,211752,211752,211754,0,2,2
60482,2,3,211754,211754,211757,0,3,0
60483,4,1,211758,211758,211759,0,1,1
60484,5,1,211763,211763,211764,0,1,4
60485,6,2,211769,211769,211771,0,2,5
60486,5,3,211774,211774,211777,0,3,3
60487,5,3,211779,211779,211782,0,3,2
60488,6,1,211785,211785,211786,0,1,3
60489,1,3,211786,211786,211789,0,3,0
60490,6,3,211792,211792,211795,0,3,3
60491,3,2,211795,211795,211797,0,2,0
60492,4,2,211799,211799,211801,0,2,2
60493,2,1,211801,211801,211802,0,1,0
60494,5,3,211806,211806,211809,0,3,4
60495,4,2,211810,211810,211812,0,2,1
60496,4,1,211814,211814,211815,0,1,2
60497,6,2,211820,211820,211822,0,2,5
60498,5,2,211825,211825,211827,0,2,3
60499,5,2,211830,211830,211832,0,2,3
60500,6,3,211836,211836,211839,0,3,4
60501,3,2,211839,211839,211841,0,2,0
60502,2,3,211841,211841,211844,0,3,0
60503,5,1,211846,211846,211847,0,1,2
60504,5,1,211851,211851,211852,0,1,4
60505,3,2,211854,211854,211856,0,2,2
60506,2,3,211856,211856,211859,0,3,0
60507,5,2,211861,211861,211863,0,2,2
60508,2,2,211863,211863,211865,0,2,0
60509,1,3,211864,211865,211868,1,4,0
60510,1,2,211865,211868,211870,3,5,0
60511,1,3,211866,211870,211873,4,7,0
60512,5,3,211871,211873,211876,2,5,0
60513,4,3,211875,211876,211879,1,4,0
60514,6,3,211881,211881,211884,0,3,2
60515,1,3,211882,211884,211887,2,5,0
60516,6,3,211888,211888,211891,0,3,1
60517,3,2,211891,211891,211893,0,2,0
60518,1,2,211892,211893,211895,1,3,0
60519,6,2,211898,211898,211900,0,2,3
60520,1,1,211899,211900,211901,1,2,0
60521,3,1,211902,211902,211903,0,1,1
60522,1,3,211903,211903,211906,0,3,0
60523,4,1,211907,211907,211908,0,1,1
60524,3,3,211910,211910,211913,0,3,2
60525,2,2,211912,211913,211915,1,3,0
60526,4,1,211916,211916,211917,0,1,1
60527,3,1,211919,211919,211920,0,1,2
60528,5,1,211924,211924,211925,0,1,4
60529,2,1,211926,211926,211927,0,1,1
60530,4,2,211930,211930,211932,0,2,3
60531,1,2,211931,211932,211934,1,3,0
60532,5,3,211936,211936,211939,0,3,2
60533,6,2,211942,211942,211944,0,2,3
60534,6,1,211948,211948,211949,0,1,4
60535,2,1,211950,211950,211951,0,1,1
60536,1,1,211951,211951,211952,0,1,0
60537,2,1,211953,211953,211954,0,1,1
60538,5,2,211958,211958,211960,0,2,4
60539,5,2,211963,211963,211965,0,2,3
60540,2,3,211965,211965,211968,0,3,0
60541,2,1,211967,211968,211969,1,2,0
60542,2,1,211969,211969,211970,0,1,0
60543,5,3,211974,211974,211977,0,3,4
60544,3,3,211977,211977,211980,0,3,0
60545,2,1,211979,211980,211981,1,2,0
60546,1,1,211980,211981,211982,1,2,0
60547,6,1,211986,211986,211987,0,1,4
60548,6,1,211992,211992,211993,0,1,5
60549,3,2,211995,211995,211997,0,2,2
60550,1,3,211996,211997,212000,1,4,0
60551,4,3,212000,212000,212003,0,3,0
60552,1,2,212001,212003,212005,2,4,0
60553,4,1,212005,212005,212006,0,1,0
60554,6,3,212011,212011,212014,0,3,5
60555,2,1,212013,212014,212015,1,2,0
60556,1,3,212014,212015,212018,1,4,0
60557,5,1,212019,212019,212020,0,1,1
60558,4,1,212023,212023,212024,0,1,3
60559,6,2,212029,212029,212031,0,2,5
60560,2,3,212031,212031,212034,0,3,0
60561,3,3,212034,212034,212037,0,3,0
60562,1,3,212035,212037,212040,2,5,0
60563,4,1,212039,212040,212041,1,2,0
60564,2,1,212041,212041,212042,0,1,0
60565,2,2,212043,212043,212045,0,2,1
60566,5,2,212048,212048,212050,0,2,3
60567,1,1,212049,212050,212051,1,2,0
60568,6,2,212055,212055,212057,0,2,4
60569,1,2,212056,212057,212059,1,3,0
60570,3,3,212059,212059,212062,0,3,0
60571,5,2,212064,212064,212066,0,2,2
60572,3,1,212067,212067,212068,0,1,1
60573,1,3,212068,212068,212071,0,3,0
60574,6,1,212074,212074,212075,0,1,3
60575,6,2,212080,212080,212082,0,2,5
60576,4,2,212084,212084,212086,0,2,2
60577,2,1,212086,212086,212087,0,1,0
60578,6,1,212092,212092,212093,0,1,5
60579,5,3,212097,212097,212100,0,3,4
60580,2,2,212099,212100,212102,1,3,0
60581,5,2,212104,212104,212106,0,2,2
60582,5,1,212109,212109,212110,0,1,3
60583,2,2,212111,212111,212113,0,2,1
60584,1,3,212112,212113,212116,1,4,0
60585,4,2,212116,212116,212118,0,2,0
60586,1,2,212117,212118,212120,1,3,0
60587,6,1,212123,212123,212124,0,1,3
60588,4,1,212127,212127,212128,0,1,3
60589,3,1,212130,212130,212131,0,1,2
60590,2,3,212132,212132,212135,0,3,1
60591,6,1,212138,212138,212139,0,1,3
60592,4,2,212142,212142,212144,0,2,3
60593,2,3,212144,212144,212147,0,3,0
60594,3,1,212147,212147,212148,0,1,0
60595,6,1,212153,212153,212154,0,1,5
60596,2,2,212155,212155,212157,0,2,1
60597,2,3,212157,212157,212160,0,3,0
60598,4,1,212161,212161,212162,0,1,1
60599,6,1,212167,212167,212168,0,1,5
60600,4,1,212171,212171,212172,0,1,3
60601,4,2,212175,212175,212177,0,2,3
60602,4,2,212179,212179,212181,0,2,2
60603,2,3,212181,212181,212184,0,3,0
60604,2,2,212183,212184,212186,1,3,0
60605,4,3,212187,212187,212190,0,3,1
60606,3,1,212190,212190,212191,0,1,0
60607,2,1,212192,212192,212193,0,1,1
60608,4,1,212196,212196,212197,0,1,3
60609,2,2,212198,212198,212200,0,2,1
60610,6,3,212204,212204,212207,0,3,4
60611,6,1,212210,212210,212211,0,1,3
60612,6,1,212216,212216,212217,0,1,5
60613,1,1,212217,212217,212218,0,1,0
60614,6,3,212223,212223,212226,0,3,5
60615,3,2,212226,212226,212228,0,2,0
60616,3,2,212229,212229,212231,0,2,1
60617,5,1,212234,212234,212235,0,1,3
60618,2,3,212236,212236,212239,0,3,1
60619,3,3,212239,212239,212242,0,3,0
60620,2,1,212241,212242,212243,1,2,0
60621,2,2,212243,212243,212245,0,2,0
60622,4,3,212247,212247,212250,0,3,2
60623,3,3,212250,212250,212253,0,3,0
60624,6,3,212256,212256,212259,0,3,3
60625,3,2,212259,212259,212261,0,2,0
60626,1,3,212260,212261,212264,1,4,0
60627,2,1,212262,212264,212265,2,3,0
60628,5,1,212267,212267,212268,0,1,2
60629,4,3,212271,212271,212274,0,3,3
60630,3,3,212274,212274,212277,0,3,0
60631,3,3,212277,212277,212280,0,3,0
60632,1,2,212278,212280,212282,2,4,0
60633,6,1,212284,212284,212285,0,1,2
60634,2,2,212286,212286,212288,0,2,1
60635,2,3,212288,212288,212291,0,3,0
60636,2,2,212290,212291,212293,1,3,0
60637,1,1,212291,212293,212294,2,3,0
60638,2,1,212293,212294,212295,1,2,0
60639,1,1,212294,212295,212296,1,2,0
60640,6,2,212300,212300,212302,0,2,4
60641,4,3,212304,212304,212307,0,3,2
60642,1,3,212305,212307,212310,2,5,0
60643,6,3,212311,212311,212314,0,3,1
60644,1,1,212312,212314,212315,2,3,0
60645,1,2,212313,212315,212317,2,4,0
60646,1,3,212314,212317,212320,3,6,0
60647,1,3,212315,212320,212323,5,8,0
60648,3,3,212318,212323,212326,5,8,0
60649,6,1,212324,212326,212327,2,3,0
60650,2,1,212326,212327,212328,1,2,0
60651,4,2,212330,212330,212332,0,2,2
60652,3,1,212333,212333,212334,0,1,1
60653,1,2,212334,212334,212336,0,2,0
60654,3,1,212337,212337,212338,0,1,1
60655,4,3,212341,212341,212344,0,3,3
60656,6,3,212347,212347,212350,0,3,3
60657,2,1,212349,212350,212351,1,2,0
60658,1,2,212350,212351,212353,1,3,0
60659,2,1,212352,212353,212354,1,2,0
60660,3,1,212355,212355,212356,0,1,1
60661,2,1,212357,212357,212358,0,1,1
60662,2,2,212359,212359,212361,0,2,1
60663,6,2,212365,212365,212367,0,2,4
60664,5,2,212370,212370,212372,0,2,3
60665,1,1,212371,212372,212373,1,2,0
60666,4,2,212375,212375,212377,0,2,2
60667,2,1,212377,212377,212378,0,1,0
60668,5,1,212382,212382,212383,0,1,4
60669,6,2,212388,212388,212390,0,2,5
60670,5,3,212393,212393,212396,0,3,3
60671,2,2,212395,212396,212398,1,3,0
60672,3,1,212398,212398,212399,0,1,0
60673,5,2,212403,212403,212405,0,2,4
60674,1,3,212404,212405,212408,1,4,0
60675,4,1,212408,212408,212409,0,1,0
60676,3,2,212411,212411,212413,0,2,2
60677,1,2,212412,212413,212415,1,3,0
60678,2,1,212414,212415,212416,1,2,0
60679,2,2,212416,212416,212418,0,2,0
60680,5,3,212421,212421,212424,0,3,3
60681,6,2,212427,212427,212429,0,2,3
60682,1,3,212428,212429,212432,1,4,0
60683,4,3,212432,212432,212435,0,3,0
60684,1,2,212433,212435,212437,2,4,0
60685,4,1,212437,212437,212438,0,1,0
60686,6,1,212443,212443,212444,0,1,5
60687,5,1,212448,212448,212449,0,1,4
60688,5,1,212453,212453,212454,0,1,4
60689,3,1,212456,212456,212457,0,1,2
60690,1,1,212457,212457,212458,0,1,0
60691,4,2,212461,212461,212463,0,2,3
60692,2,2,212463,212463,212465,0,2,0
60693,5,1,212468,212468,212469,0,1,3
60694,2,1,212470,212470,212471,0,1,1
60695,1,1,212471,212471,212472,0,1,0
60696,2,1,212473,212473,212474,0,1,1
60697,1,3,212474,212474,212477,0,3,0
60698,5,2,212479,212479,212481,0,2,2
60699,1,1,212480,212481,212482,1,2,0
60700,4,1,212484,212484,212485,0,1,2
60701,1,1,212485,212485,212486,0,1,0
60702,5,1,212490,212490,212491,0,1,4
60703,4,2,212494,212494,212496,0,2,3
60704,4,2,212498,212498,212500,0,2,2
60705,1,1,212499,212500,212501,1,2,0
60706,1,3,212500,212501,212504,1,4,0
60707,4,2,212504,212504,212506,0,2,0
60708,4,1,212508,212508,212509,0,1,2
60709,1,3,212509,212509,212512,0,3,0
60710,5,3,212514,212514,212517,0,3,2
60711,3,2,212517,212517,212519,0,2,0
60712,6,3,212523,212523,212526,0,3,4
60713,2,2,212525,212526,212528,1,3,0
60714,6,2,212531,212531,212533,0,2,3
60715,6,2,212537,212537,212539,0,2,4
60716,5,3,212542,212542,212545,0,3,3
60717,5,2,212547,212547,212549,0,2,2
60718,3,1,212550,212550,212551,0,1,1
60719,5,2,212555,212555,212557,0,2,4
60720,4,1,212559,212559,212560,0,1,2
60721,3,1,212562,212562,212563,0,1,2
60722,5,2,212567,212567,212569,0,2,4
60723,5,2,212572,212572,212574,0,2,3
60724,4,1,212576,212576,212577,0,1,2
60725,5,3,212581,212581,212584,0,3,4
60726,2,2,212583,212584,212586,1,3,0
60727,3,3,212586,212586,212589,0,3,0
60728,3,3,212589,212589,212592,0,3,0
60729,5,3,212594,212594,212597,0,3,2
60730,5,2,212599,212599,212601,0,2,2
60731,4,2,212603,212603,212605,0,2,2
60732,1,1,212604,212605,212606,1,2,0
60733,5,1,212609,212609,212610,0,1,3
60734,2,2,212611,212611,212613,0,2,1
60735,5,3,212616,212616,212619,0,3,3
60736,3,3,212619,212619,212622,0,3,0
60737,3,3,212622,212622,212625,0,3,0
60738,6,1,212628,212628,212629,0,1,3
60739,2,1,212630,212630,212631,0,1,1
60740,1,2,212631,212631,212633,0,2,0
60741,1,3,212632,212633,212636,1,4,0
60742,1,1,212633,212636,212637,3,4,0
60743,2,1,212635,212637,212638,2,3,0
60744,2,1,212637,212638,212639,1,2,0
60745,3,1,212640,212640,212641,0,1,1
60746,5,2,212645,212645,212647,0,2,4
60747,5,2,212650,212650,212652,0,2,3
60748,4,2,212654,212654,212656,0,2,2
60749,4,2,212658,212658,212660,0,2,2
60750,2,2,212660,212660,212662,0,2,0
60751,3,2,212663,212663,212665,0,2,1
60752,4,1,212667,212667,212668,0,1,2
60753,4,1,212671,212671,212672,0,1,3
60754,5,1,212676,212676,212677,0,1,4
60755,4,3,212680,212680,212683,0,3,3
60756,4,3,212684,212684,212687,0,3,1
60757,4,1,212688,212688,212689,0,1,1
60758,3,1,212691,212691,212692,0,1,2
60759,6,2,212697,212697,212699,0,2,5
60760,6,1,212703,212703,212704,0,1,4
60761,2,1,212705,212705,212706,0,1,1
60762,6,1,212711,212711,212712,0,1,5
60763,5,2,212716,212716,212718,0,2,4
60764,2,3,212718,212718,212721,0,3,0
60765,3,1,212721,212721,212722,0,1,0
60766,3,2,212724,212724,212726,0,2,2
60767,3,1,212727,212727,212728,0,1,1
60768,6,1,212733,212733,212734,0,1,5
60769,4,3,212737,212737,212740,0,3,3
60770,5,1,212742,212742,212743,0,1,2
60771,2,1,212744,212744,212745,0,1,1
60772,5,2,212749,212749,212751,0,2,4
60773,3,2,212752,212752,212754,0,2,1
60774,4,2,212756,212756,212758,0,2,2
60775,1,1,212757,212758,212759,1,2,0
60776,4,2,212761,212761,212763,0,2,2
60777,4,2,212765,212765,212767,0,2,2
60778,3,2,212768,212768,212770,0,2,1
60779,2,3,212770,212770,212773,0,3,0
60780,4,3,212774,212774,212777,0,3,1
60781,5,2,212779,212779,212781,0,2,2
60782,5,2,212784,212784,212786,0,2,3
60783,3,1,212787,212787,212788,0,1,1
60784,5,2,212792,212792,212794,0,2,4
60785,4,2,212796,212796,212798,0,2,2
60786,2,1,212798,212798,212799,0,1,0
60787,5,3,212803,212803,212806,0,3,4
60788,5,3,212808,212808,212811,0,3,2
60789,2,1,212810,212811,212812,1,2,0
60790,6,1,212816,212816,212817,0,1,4
60791,4,1,212820,212820,212821,0,1,3
60792,5,1,212825,212825,212826,0,1,4
60793,5,1,212830,212830,212831,0,1,4
60794,4,2,212834,212834,212836,0,2,3
60795,6,2,212840,212840,212842,0,2,4
60796,6,3,212846,212846,212849,0,3,4
60797,5,3,212851,212851,212854,0,3,2
60798,2,2,212853,212854,212856,1,3,0
60799,5,1,212858,212858,212859,0,1,2
60800,4,2,212862,212862,212864,0,2,3
60801,4,1,212866,212866,212867,0,1,2
60802,2,3,212868,212868,212871,0,3,1
60803,5,3,212873,212873,212876,0,3,2
60804,1,1,212874,212876,212877,2,3,0
60805,3,2,212877,212877,212879,0,2,0
60806,6,2,212883,212883,212885,0,2,4
60807,2,3,212885,212885,212888,0,3,0
60808,5,3,212890,212890,212893,0,3,2
60809,4,3,212894,212894,212897,0,3,1
60810,2,3,212896,212897,212900,1,4,0
60811,6,3,212902,212902,212905,0,3,2
60812,6,2,212908,212908,212910,0,2,3
60813,5,3,212913,212913,212916,0,3,3
60814,2,3,212915,212916,212919,1,4,0
60815,2,1,212917,212919,212920,2,3,0
60816,2,2,212919,212920,212922,1,3,0
60817,3,3,212922,212922,212925,0,3,0
60818,3,3,212925,212925,212928,0,3,0
60819,3,3,212928,212928,212931,0,3,0
60820,4,2,212932,212932,212934,0,2,1
60821,5,2,212937,212937,212939,0,2,3
60822,3,3,212940,212940,212943,0,3,1
60823,6,1,212946,212946,212947,0,1,3
60824,1,3,212947,212947,212950,0,3,0
60825,3,1,212950,212950,212951,0,1,0
60826,5,1,212955,212955,212956,0,1,4
60827,1,1,212956,212956,212957,0,1,0
60828,2,2,212958,212958,212960,0,2,1
60829,1,3,212959,212960,212963,1,4,0
60830,6,3,212965,212965,212968,0,3,2
60831,1,3,212966,212968,212971,2,5,0
60832,1,1,212967,212971,212972,4,5,0
60833,3,3,212970,212972,212975,2,5,0
60834,4,3,212974,212975,212978,1,4,0
60835,3,2,212977,212978,212980,1,3,0
60836,6,2,212983,212983,212985,0,2,3
60837,3,2,212986,212986,212988,0,2,1
60838,6,2,212992,212992,212994,0,2,4
60839,1,2,212993,212994,212996,1,3,0
60840,1,1,212994,212996,212997,2,3,0
60841,2,3,212996,212997,213000,1,4,0
60842,3,1,212999,213000,213001,1,2,0
60843,6,2,213005,213005,213007,0,2,4
60844,6,3,213011,213011,213014,0,3,4
60845,5,1,213016,213016,213017,0,1,2
60846,6,2,213022,213022,213024,0,2,5
60847,6,3,213028,213028,213031,0,3,4
60848,5,3,213033,213033,213036,0,3,2
60849,4,1,213037,213037,213038,0,1,1
60850,6,2,213043,213043,213045,0,2,5
60851,6,3,213049,213049,213052,0,3,4
60852,5,1,213054,213054,213055,0,1,2
60853,2,2,213056,213056,213058,0,2,1
60854,1,2,213057,213058,213060,1,3,0
60855,3,3,213060,213060,213063,0,3,0
60856,4,3,213064,213064,213067,0,3,1
60857,3,1,213067,213067,213068,0,1,0
60858,2,3,213069,213069,213072,0,3,1
60859,4,1,213073,213073,213074,0,1,1
60860,6,3,213079,213079,213082,0,3,5
60861,1,3,213080,213082,213085,2,5,0
60862,5,3,213085,213085,213088,0,3,0
60863,4,3,213089,213089,213092,0,3,1
60864,2,1,213091,213092,213093,1,2,0
60865,1,3,213092,213093,213096,1,4,0
60866,1,3,213093,213096,213099,3,6,0
60867,1,1,213094,213099,213100,5,6,0
60868,4,1,213098,213100,213101,2,3,0
60869,2,2,213100,213101,213103,1,3,0
60870,2,1,213102,213103,213104,1,2,0
60871,6,2,213108,213108,213110,0,2,4
60872,3,2,213111,213111,213113,0,2,1
60873,3,2,213114,213114,213116,0,2,1
60874,2,3,213116,213116,213119,0,3,0
60875,6,3,213122,213122,213125,0,3,3
60876,5,3,213127,213127,213130,0,3,2
60877,3,2,213130,213130,213132,0,2,0
60878,3,1,213133,213133,213134,0,1,1
60879,6,3,213139,213139,213142,0,3,5
60880,6,3,213145,213145,213148,0,3,3
60881,1,1,213146,213148,213149,2,3,0
60882,2,1,213148,213149,213150,1,2,0
60883,4,3,213152,213152,213155,0,3,2
60884,1,3,213153,213155,213158,2,5,0
60885,6,2,213159,213159,213161,0,2,1
60886,3,2,213162,213162,213164,0,2,1
60887,6,1,213168,213168,213169,0,1,4
60888,5,1,213173,213173,213174,0,1,4
60889,2,3,213175,213175,213178,0,3,1
60890,6,2,213181,213181,213183,0,2,3
60891,6,3,213187,213187,213190,0,3,4
60892,4,2,213191,213191,213193,0,2,1
60893,5,3,213196,213196,213199,0,3,3
60894,1,2,213197,213199,213201,2,4,0
60895,2,1,213199,213201,213202,2,3,0
60896,6,1,213205,213205,213206,0,1,3
60897,3,1,213208,213208,213209,0,1,2
60898,3,1,213211,213211,213212,0,1,2
60899,2,2,213213,213213,213215,0,2,1
60900,5,1,213218,213218,213219,0,1,3
60901,5,3,213223,213223,213226,0,3,4
60902,5,2,213228,213228,213230,0,2,2
60903,6,2,213234,213234,213236,0,2,4
60904,2,3,213236,213236,213239,0,3,0
60905,1,1,213237,213239,213240,2,3,0
60906,3,3,213240,213240,213243,0,3,0
60907,6,3,213246,213246,213249,0,3,3
60908,1,2,213247,213249,213251,2,4,0
60909,3,2,213250,213251,213253,1,3,0
60910,3,2,213253,213253,213255,0,2,0
60911,1,3,213254,213255,213258,1,4,0
60912,6,2,213260,213260,213262,0,2,2
60913,1,1,213261,213262,213263,1,2,0
60914,5,1,213266,213266,213267,0,1,3
60915,5,2,213271,213271,213273,0,2,4
60916,3,2,213274,213274,213276,0,2,1
60917,2,3,213276,213276,213279,0,3,0
60918,2,1,213278,213279,213280,1,2,0
60919,5,3,213283,213283,213286,0,3,3
60920,3,1,213286,213286,213287,0,1,0
60921,4,1,213290,213290,213291,0,1,3
60922,1,3,213291,213291,213294,0,3,0
60923,2,2,213293,213294,213296,1,3,0
60924,5,2,213298,213298,213300,0,2,2
60925,2,1,213300,213300,213301,0,1,0
60926,4,3,213304,213304,213307,0,3,3
60927,1,2,213305,213307,213309,2,4,0
60928,6,3,213311,213311,213314,0,3,2
60929,1,1,213312,213314,213315,2,3,0
60930,6,1,213318,213318,213319,0,1,3
60931,2,1,213320,213320,213321,0,1,1
60932,2,3,213322,213322,213325,0,3,1
60933,2,3,213324,213325,213328,1,4,0
60934,1,2,213325,213328,213330,3,5,0
60935,6,3,213331,213331,213334,0,3,1
60936,1,2,213332,213334,213336,2,4,0
60937,3,2,213335,213336,213338,1,3,0
60938,1,3,213336,213338,213341,2,5,0
60939,4,2,213340,213341,213343,1,3,0
60940,3,2,213343,213343,213345,0,2,0
60941,3,2,213346,213346,213348,0,2,1
60942,2,2,213348,213348,213350,0,2,0
60943,6,1,213354,213354,213355,0,1,4
60944,4,1,213358,213358,213359,0,1,3
60945,1,3,213359,213359,213362,0,3,0
60946,5,1,213364,213364,213365,0,1,2
60947,6,1,213370,213370,213371,0,1,5
60948,6,1,213376,213376,213377,0,1,5
60949,6,2,213382,213382,213384,0,2,5
60950,2,1,213384,213384,213385,0,1,0
60951,5,2,213389,213389,213391,0,2,4
60952,2,2,213391,213391,213393,0,2,0
60953,6,2,213397,213397,213399,0,2,4
60954,4,3,213401,213401,213404,0,3,2
60955,6,3,213407,213407,213410,0,3,3
60956,5,2,213412,213412,213414,0,2,2
60957,5,3,213417,213417,213420,0,3,3
60958,5,2,213422,213422,213424,0,2,2
60959,3,3,213425,213425,213428,0,3,1
60960,3,1,213428,213428,213429,0,1,0
60961,2,1,213430,213430,213431,0,1,1
60962,4,2,213434,213434,213436,0,2,3
60963,5,2,213439,213439,213441,0,2,3
60964,4,1,213443,213443,213444,0,1,2
60965,3,3,213446,213446,213449,0,3,2
60966,6,2,213452,213452,213454,0,2,3
60967,3,1,213455,213455,213456,0,1,1
60968,4,3,213459,213459,213462,0,3,3
60969,2,2,213461,213462,213464,1,3,0
60970,5,3,213466,213466,213469,0,3,2
60971,1,2,213467,213469,213471,2,4,0
60972,6,2,213473,213473,213475,0,2,2
60973,6,1,213479,213479,213480,0,1,4
60974,2,2,213481,213481,213483,0,2,1
60975,6,3,213487,213487,213490,0,3,4
60976,4,1,213491,213491,213492,0,1,1
60977,1,2,213492,213492,213494,0,2,0
60978,6,3,213498,213498,213501,0,3,4
60979,1,3,213499,213501,213504,2,5,0
60980,4,3,213503,213504,213507,1,4,0
60981,1,1,213504,213507,213508,3,4,0
60982,5,1,213509,213509,213510,0,1,1
60983,2,3,213511,213511,213514,0,3,1
60984,2,3,213513,213514,213517,1,4,0
60985,2,2,213515,213517,213519,2,4,0
60986,2,2,213517,213519,213521,2,4,0
60987,2,3,213519,213521,213524,2,5,0
60988,1,2,213520,213524,213526,4,6,0
60989,1,1,213521,213526,213527,5,6,0
60990,1,1,213522,213527,213528,5,6,0
60991,3,3,213525,213528,213531,3,6,0
60992,2,3,213527,213531,213534,4,7,0
60993,1,1,213528,213534,213535,6,7,0
60994,3,3,213531,213535,213538,4,7,0
60995,5,2,213536,213538,213540,2,4,0
60996,6,3,213542,213542,213545,0,3,2
60997,3,3,213545,213545,213548,0,3,0
60998,5,2,213550,213550,213552,0,2,2
60999,3,3,213553,213553,213556,0,3,1
61000,1,2,213554,213556,213558,2,4,0
61001,1,1,213555,213558,213559,3,4,0
61002,2,1,213557,213559,213560,2,3,0
61003,3,1,213560,213560,213561,0,1,0
61004,4,2,213564,213564,213566,0,2,3
61005,1,2,213565,213566,213568,1,3,0
61006,1,1,213566,213568,213569,2,3,0
61007,4,1,213570,213570,213571,0,1,1
61008,5,2,213575,213575,213577,0,2,4
61009,1,2,213576,213577,213579,1,3,0
61010,3,3,213579,213579,213582,0,3,0
61011,3,2,213582,213582,213584,0,2,0
61012,4,3,213586,213586,213589,0,3,2
61013,1,2,213587,213589,213591,2,4,0
61014,5,2,213592,213592,213594,0,2,1
61015,5,3,213597,213597,213600,0,3,3
61016,2,3,213599,213600,213603,1,4,0
61017,4,2,213603,213603,213605,0,2,0
61018,2,2,213605,213605,213607,0,2,0
61019,4,3,213609,213609,213612,0,3,2
61020,3,2,213612,213612,213614,0,2,0
61021,5,3,213617,213617,213620,0,3,3
61022,6,3,213623,213623,213626,0,3,3
61023,3,3,213626,213626,213629,0,3,0
61024,1,3,213627,213629,213632,2,5,0
61025,5,2,213632,213632,213634,0,2,0
61026,2,1,213634,213634,213635,0,1,0
61027,4,2,213638,213638,213640,0,2,3
61028,5,3,213643,213643,213646,0,3,3
61029,5,3,213648,213648,213651,0,3,2
61030,2,3,213650,213651,213654,1,4,0
61031,1,2,213651,213654,213656,3,5,0
61032,5,1,213656,213656,213657,0,1,0
61033,2,3,213658,213658,213661,0,3,1
61034,5,3,213663,213663,213666,0,3,2
61035,1,3,213664,213666,213669,2,5,0
61036,5,2,213669,213669,213671,0,2,0
61037,3,3,213672,213672,213675,0,3,1
61038,1,2,213673,213675,213677,2,4,0
61039,5,1,213678,213678,213679,0,1,1
61040,2,2,213680,213680,213682,0,2,1
61041,1,1,213681,213682,213683,1,2,0
61042,1,3,213682,213683,213686,1,4,0
61043,6,3,213688,213688,213691,0,3,2
61044,1,3,213689,213691,213694,2,5,0
61045,1,3,213690,213694,213697,4,7,0
61046,1,3,213691,213697,213700,6,9,0
61047,2,2,213693,213700,213702,7,9,0
61048,2,3,213695,213702,213705,7,10,0
61049,5,1,213700,213705,213706,5,6,0
61050,5,3,213705,213706,213709,1,4,0
61051,3,1,213708,213709,213710,1,2,0
61052,5,2,213713,213713,213715,0,2,3
61053,2,1,213715,213715,213716,0,1,0
61054,2,1,213717,213717,213718,0,1,1
61055,1,3,213718,213718,213721,0,3,0
61056,3,1,213721,213721,213722,0,1,0
61057,4,2,213725,213725,213727,0,2,3
61058,3,1,213728,213728,213729,0,1,1
61059,3,3,213731,213731,213734,0,3,2
61060,6,3,213737,213737,213740,0,3,3
61061,2,1,213739,213740,213741,1,2,0
61062,4,1,213743,213743,213744,0,1,2
61063,1,1,213744,213744,213745,0,1,0
61064,4,2,213748,213748,213750,0,2,3
61065,3,3,213751,213751,213754,0,3,1
61066,5,1,213756,213756,213757,0,1,2
61067,1,1,213757,213757,213758,0,1,0
61068,1,2,213758,213758,213760,0,2,0
61069,2,3,213760,213760,213763,0,3,0
61070,1,3,213761,213763,213766,2,5,0
61071,4,2,213765,213766,213768,1,3,0
61072,4,3,213769,213769,213772,0,3,1
61073,1,2,213770,213772,213774,2,4,0
61074,2,2,213772,213774,213776,2,4,0
61075,5,3,213777,213777,213780,0,3,1
61076,3,2,213780,213780,213782,0,2,0
61077,3,2,213783,213783,213785,0,2,1
61078,4,1,213787,213787,213788,0,1,2
61079,6,2,213793,213793,213795,0,2,5
61080,1,2,213794,213795,213797,1,3,0
61081,6,2,213800,213800,213802,0,2,3
61082,6,2,213806,213806,213808,0,2,4
61083,1,3,213807,213808,213811,1,4,0
61084,3,3,213810,213811,213814,1,4,0
61085,3,1,213813,213814,213815,1,2,0
61086,6,3,213819,213819,213822,0,3,4
61087,1,1,213820,213822,213823,2,3,0
61088,6,3,213826,213826,213829,0,3,3
61089,6,3,213832,213832,213835,0,3,3
61090,2,3,213834,213835,213838,1,4,0
61091,6,1,213840,213840,213841,0,1,2
61092,5,1,213845,213845,213846,0,1,4
61093,5,1,213850,213850,213851,0,1,4
61094,6,3,213856,213856,213859,0,3,5
61095,1,1,213857,213859,213860,2,3,0
61096,3,2,213860,213860,213862,0,2,0
61097,2,1,213862,213862,213863,0,1,0
61098,1,1,213863,213863,213864,0,1,0
61099,3,1,213866,213866,213867,0,1,2
61100,6,3,213872,213872,213875,0,3,5
61101,1,2,213873,213875,213877,2,4,0
61102,5,3,213878,213878,213881,0,3,1
61103,4,2,213882,213882,213884,0,2,1
61104,2,2,213884,213884,213886,0,2,0
61105,1,1,213885,213886,213887,1,2,0
61106,3,3,213888,213888,213891,0,3,1
61107,3,2,213891,213891,213893,0,2,0
61108,1,2,213892,213893,213895,1,3,0
61109,5,3,213897,213897,213900,0,3,2
61110,1,1,213898,213900,213901,2,3,0
61111,2,1,213900,213901,213902,1,2,0
61112,1,2,213901,213902,213904,1,3,0
61113,1,2,213902,213904,213906,2,4,0
61114,2,1,213904,213906,213907,2,3,0
61115,6,1,213910,213910,213911,0,1,3
61116,6,3,213916,213916,213919,0,3,5
61117,1,3,213917,213919,213922,2,5,0
61118,2,1,213919,213922,213923,3,4,0
61119,1,1,213920,213923,213924,3,4,0
61120,6,2,213926,213926,213928,0,2,2
61121,4,3,213930,213930,213933,0,3,2
61122,2,2,213932,213933,213935,1,3,0
61123,5,3,213937,213937,213940,0,3,2
61124,2,1,213939,213940,213941,1,2,0
61125,3,1,213942,213942,213943,0,1,1
61126,2,2,213944,213944,213946,0,2,1
61127,4,2,213948,213948,213950,0,2,2
61128,2,2,213950,213950,213952,0,2,0
61129,4,3,213954,213954,213957,0,3,2
61130,5,1,213959,213959,213960,0,1,2
61131,2,1,213961,213961,213962,0,1,1
61132,4,1,213965,213965,213966,0,1,3
61133,3,1,213968,213968,213969,0,1,2
61134,6,1,213974,213974,213975,0,1,5
61135,5,2,213979,213979,213981,0,2,4
61136,6,2,213985,213985,213987,0,2,4
61137,6,3,213991,213991,213994,0,3,4
61138,3,2,213994,213994,213996,0,2,0
61139,2,3,213996,213996,213999,0,3,0
61140,5,3,214001,214001,214004,0,3,2
61141,2,3,214003,214004,214007,1,4,0
61142,6,1,214009,214009,214010,0,1,2
61143,3,2,214012,214012,214014,0,2,2
61144,3,3,214015,214015,214018,0,3,1
61145,4,3,214019,214019,214022,0,3,1
61146,6,2,214025,214025,214027,0,2,3
61147,5,2,214030,214030,214032,0,2,3
61148,6,2,214036,214036,214038,0,2,4
61149,6,1,214042,214042,214043,0,1,4
61150,3,1,214045,214045,214046,0,1,2
61151,3,2,214048,214048,214050,0,2,2
61152,4,2,214052,214052,214054,0,2,2
61153,4,1,214056,214056,214057,0,1,2
61154,1,2,214057,214057,214059,0,2,0
61155,4,2,214061,214061,214063,0,2,2
61156,6,1,214067,214067,214068,0,1,4
61157,6,2,214073,214073,214075,0,2,5
61158,6,2,214079,214079,214081,0,2,4
61159,1,3,214080,214081,214084,1,4,0
61160,4,3,214084,214084,214087,0,3,0
61161,6,3,214090,214090,214093,0,3,3
61162,4,2,214094,214094,214096,0,2,1
61163,1,2,214095,214096,214098,1,3,0
61164,2,1,214097,214098,214099,1,2,0
61165,6,3,214103,214103,214106,0,3,4
61166,2,1,214105,214106,214107,1,2,0
61167,6,2,214111,214111,214113,0,2,4
61168,1,3,214112,214113,214116,1,4,0
61169,3,3,214115,214116,214119,1,4,0
61170,3,3,214118,214119,214122,1,4,0
61171,4,1,214122,214122,214123,0,1,0
61172,2,2,214124,214124,214126,0,2,1
61173,3,2,214127,214127,214129,0,2,1
61174,6,1,214133,214133,214134,0,1,4
61175,1,1,214134,214134,214135,0,1,0
61176,2,1,214136,214136,214137,0,1,1
61177,1,3,214137,214137,214140,0,3,0
61178,4,3,214141,214141,214144,0,3,1
61179,4,2,214145,214145,214147,0,2,1
61180,4,3,214149,214149,214152,0,3,2
61181,5,3,214154,214154,214157,0,3,2
61182,6,1,214160,214160,214161,0,1,3
61183,4,3,214164,214164,214167,0,3,3
61184,5,2,214169,214169,214171,0,2,2
61185,5,3,214174,214174,214177,0,3,3
61186,4,1,214178,214178,214179,0,1,1
61187,4,2,214182,214182,214184,0,2,3
61188,1,2,214183,214184,214186,1,3,0
61189,4,3,214187,214187,214190,0,3,1
61190,5,2,214192,214192,214194,0,2,2
61191,5,1,214197,214197,214198,0,1,3
61192,5,3,214202,214202,214205,0,3,4
61193,6,1,214208,214208,214209,0,1,3
61194,1,1,214209,214209,214210,0,1,0
61195,6,3,214215,214215,214218,0,3,5
61196,6,3,214221,214221,214224,0,3,3
61197,6,1,214227,214227,214228,0,1,3
61198,4,3,214231,214231,214234,0,3,3
61199,6,2,214237,214237,214239,0,2,3
61200,4,2,214241,214241,214243,0,2,2
61201,3,1,214244,214244,214245,0,1,1
61202,1,3,214245,214245,214248,0,3,0
61203,2,3,214247,214248,214251,1,4,0
61204,6,1,214253,214253,214254,0,1,2
61205,6,2,214259,214259,214261,0,2,5
61206,2,3,214261,214261,214264,0,3,0
61207,2,3,214263,214264,214267,1,4,0
61208,2,2,214265,214267,214269,2,4,0
61209,1,2,214266,214269,214271,3,5,0
61210,6,1,214272,214272,214273,0,1,1
61211,6,1,214278,214278,214279,0,1,5
61212,6,2,214284,214284,214286,0,2,5
61213,4,2,214288,214288,214290,0,2,2
61214,3,1,214291,214291,214292,0,1,1
61215,4,1,214295,214295,214296,0,1,3
61216,6,3,214301,214301,214304,0,3,5
61217,6,1,214307,214307,214308,0,1,3
61218,1,2,214308,214308,214310,0,2,0
61219,4,1,214312,214312,214313,0,1,2
61220,6,2,214318,214318,214320,0,2,5
61221,1,2,214319,214320,214322,1,3,0
61222,2,1,214321,214322,214323,1,2,0
61223,2,3,214323,214323,214326,0,3,0
61224,2,2,214325,214326,214328,1,3,0
61225,5,1,214330,214330,214331,0,1,2
61226,4,3,214334,214334,214337,0,3,3
61227,1,2,214335,214337,214339,2,4,0
61228,2,2,214337,214339,214341,2,4,0
61229,2,3,214339,214341,214344,2,5,0
61230,2,3,214341,214344,214347,3,6,0
61231,5,1,214346,214347,214348,1,2,0
61232,3,2,214349,214349,214351,0,2,1
61233,5,2,214354,214354,214356,0,2,3
61234,6,2,214360,214360,214362,0,2,4
61235,3,2,214363,214363,214365,0,2,1
61236,6,3,214369,214369,214372,0,3,4
61237,3,3,214372,214372,214375,0,3,0
61238,1,1,214373,214375,214376,2,3,0
61239,6,3,214379,214379,214382,0,3,3
61240,2,1,214381,214382,214383,1,2,0
61241,3,1,214384,214384,214385,0,1,1
61242,1,3,214385,214385,214388,0,3,0
61243,2,2,214387,214388,214390,1,3,0
61244,6,2,214393,214393,214395,0,2,3
61245,6,3,214399,214399,214402,0,3,4
61246,3,3,214402,214402,214405,0,3,0
61247,1,3,214403,214405,214408,2,5,0
61248,3,1,214406,214408,214409,2,3,0
61249,2,1,214408,214409,214410,1,2,0
61250,5,2,214413,214413,214415,0,2,3
61251,4,2,214417,214417,214419,0,2,2
61252,1,1,214418,214419,214420,1,2,0
61253,1,1,214419,214420,214421,1,2,0
61254,3,2,214422,214422,214424,0,2,1
61255,4,1,214426,214426,214427,0,1,2
61256,4,2,214430,214430,214432,0,2,3
61257,3,1,214433,214433,214434,0,1,1
61258,5,3,214438,214438,214441,0,3,4
61259,6,1,214444,214444,214445,0,1,3
61260,1,2,214445,214445,214447,0,2,0
61261,1,2,214446,214447,214449,1,3,0
61262,4,2,214450,214450,214452,0,2,1
61263,3,2,214453,214453,214455,0,2,1
61264,2,3,214455,214455,214458,0,3,0
61265,5,2,214460,214460,214462,0,2,2
61266,4,1,214464,214464,214465,0,1,2
61267,3,3,214467,214467,214470,0,3,2
61268,4,2,214471,214471,214473,0,2,1
61269,6,3,214477,214477,214480,0,3,4
61270,2,2,214479,214480,214482,1,3,0
61271,5,1,214484,214484,214485,0,1,2
61272,1,3,214485,214485,214488,0,3,0
61273,5,3,214490,214490,214493,0,3,2
61274,5,3,214495,214495,214498,0,3,2
61275,6,1,214501,214501,214502,0,1,3
61276,3,2,214504,214504,214506,0,2,2
61277,5,2,214509,214509,214511,0,2,3
61278,1,2,214510,214511,214513,1,3,0
61279,5,2,214515,214515,214517,0,2,2
61280,5,3,214520,214520,214523,0,3,3
61281,1,2,214521,214523,214525,2,4,0
61282,1,2,214522,214525,214527,3,5,0
61283,3,1,214525,214527,214528,2,3,0
61284,6,1,214531,214531,214532,0,1,3
61285,5,1,214536,214536,214537,0,1,4
61286,5,2,214541,214541,214543,0,2,4
61287,1,2,214542,214543,214545,1,3,0
61288,5,3,214547,214547,214550,0,3,2
61289,4,3,214551,214551,214554,0,3,1
61290,6,1,214557,214557,214558,0,1,3
61291,5,1,214562,214562,214563,0,1,4
61292,4,3,214566,214566,214569,0,3,3
61293,5,1,214571,214571,214572,0,1,2
61294,4,2,214575,214575,214577,0,2,3
61295,6,1,214581,214581,214582,0,1,4
61296,1,2,214582,214582,214584,0,2,0
61297,4,2,214586,214586,214588,0,2,2
61298,3,2,214589,214589,214591,0,2,1
61299,1,3,214590,214591,214594,1,4,0
61300,3,2,214593,214594,214596,1,3,0
61301,3,2,214596,214596,214598,0,2,0
61302,3,2,214599,214599,214601,0,2,1
61303,1,2,214600,214601,214603,1,3,0
61304,4,1,214604,214604,214605,0,1,1
61305,5,1,214609,214609,214610,0,1,4
61306,3,3,214612,214612,214615,0,3,2
61307,6,2,214618,214618,214620,0,2,3
61308,4,3,214622,214622,214625,0,3,2
61309,3,1,214625,214625,214626,0,1,0
61310,4,2,214629,214629,214631,0,2,3
61311,4,1,214633,214633,214634,0,1,2
61312,2,2,214635,214635,214637,0,2,1
61313,5,2,214640,214640,214642,0,2,3
61314,1,3,214641,214642,214645,1,4,0
61315,3,3,214644,214645,214648,1,4,0
61316,2,1,214646,214648,214649,2,3,0
61317,5,2,214651,214651,214653,0,2,2
61318,2,2,214653,214653,214655,0,2,0
61319,5,3,214658,214658,214661,0,3,3
61320,6,1,214664,214664,214665,0,1,3
61321,6,3,214670,214670,214673,0,3,5
61322,3,2,214673,214673,214675,0,2,0
61323,1,3,214674,214675,214678,1,4,0
61324,5,3,214679,214679,214682,0,3,1
61325,2,2,214681,214682,214684,1,3,0
61326,2,3,214683,214684,214687,1,4,0
61327,1,1,214684,214687,214688,3,4,0
61328,2,1,214686,214688,214689,2,3,0
61329,1,1,214687,214689,214690,2,3,0
61330,6,3,214693,214693,214696,0,3,3
61331,1,1,214694,214696,214697,2,3,0
61332,2,1,214696,214697,214698,1,2,0
61333,2,3,214698,214698,214701,0,3,0
61334,3,2,214701,214701,214703,0,2,0
61335,4,1,214705,214705,214706,0,1,2
61336,4,2,214709,214709,214711,0,2,3
61337,6,3,214715,214715,214718,0,3,4
61338,3,2,214718,214718,214720,0,2,0
61339,4,1,214722,214722,214723,0,1,2
61340,6,2,214728,214728,214730,0,2,5
61341,1,3,214729,214730,214733,1,4,0
61342,6,1,214735,214735,214736,0,1,2
61343,4,2,214739,214739,214741,0,2,3
61344,3,2,214742,214742,214744,0,2,1
61345,2,1,214744,214744,214745,0,1,0
61346,4,1,214748,214748,214749,0,1,3
61347,2,1,214750,214750,214751,0,1,1
61348,6,3,214756,214756,214759,0,3,5
61349,2,3,214758,214759,214762,1,4,0
61350,3,1,214761,214762,214763,1,2,0
61351,1,2,214762,214763,214765,1,3,0
61352,1,3,214763,214765,214768,2,5,0
61353,4,2,214767,214768,214770,1,3,0
61354,4,2,214771,214771,214773,0,2,1
61355,2,1,214773,214773,214774,0,1,0
61356,6,2,214779,214779,214781,0,2,5
61357,1,2,214780,214781,214783,1,3,0
61358,1,2,214781,214783,214785,2,4,0
61359,3,2,214784,214785,214787,1,3,0
61360,6,1,214790,214790,214791,0,1,3
61361,5,2,214795,214795,214797,0,2,4
61362,1,2,214796,214797,214799,1,3,0
61363,3,2,214799,214799,214801,0,2,0
61364,4,3,214803,214803,214806,0,3,2
61365,2,1,214805,214806,214807,1,2,0
61366,6,1,214811,214811,214812,0,1,4
61367,1,3,214812,214812,214815,0,3,0
61368,6,1,214818,214818,214819,0,1,3
61369,4,1,214822,214822,214823,0,1,3
61370,4,1,214826,214826,214827,0,1,3
61371,3,1,214829,214829,214830,0,1,2
61372,3,2,214832,214832,214834,0,2,2
61373,2,2,214834,214834,214836,0,2,0
61374,6,3,214840,214840,214843,0,3,4
61375,1,3,214841,214843,214846,2,5,0
61376,1,1,214842,214846,214847,4,5,0
61377,1,2,214843,214847,214849,4,6,0
61378,1,3,214844,214849,214852,5,8,0
61379,2,3,214846,214852,214855,6,9,0
61380,5,3,214851,214855,214858,4,7,0
61381,2,3,214853,214858,214861,5,8,0
61382,1,1,214854,214861,214862,7,8,0
61383,6,3,214860,214862,214865,2,5,0
61384,1,2,214861,214865,214867,4,6,0
61385,5,1,214866,214867,214868,1,2,0
61386,6,1,214872,214872,214873,0,1,4
61387,2,3,214874,214874,214877,0,3,1
61388,4,3,214878,214878,214881,0,3,1
61389,1,2,214879,214881,214883,2,4,0
61390,2,3,214881,214883,214886,2,5,0
61391,5,2,214886,214886,214888,0,2,0
61392,1,1,214887,214888,214889,1,2,0
61393,3,3,214890,214890,214893,0,3,1
61394,2,1,214892,214893,214894,1,2,0
61395,2,1,214894,214894,214895,0,1,0
61396,5,2,214899,214899,214901,0,2,4
61397,1,3,214900,214901,214904,1,4,0
61398,3,2,214903,214904,214906,1,3,0
61399,5,2,214908,214908,214910,0,2,2
61400,6,3,214914,214914,214917,0,3,4
61401,4,1,214918,214918,214919,0,1,1
61402,1,1,214919,214919,214920,0,1,0
61403,4,3,214923,214923,214926,0,3,3
61404,2,3,214925,214926,214929,1,4,0
61405,2,3,214927,214929,214932,2,5,0
61406,2,2,214929,214932,214934,3,5,0
61407,1,3,214930,214934,214937,4,7,0
61408,3,2,214933,214937,214939,4,6,0
61409,6,3,214939,214939,214942,0,3,0
61410,5,3,214944,214944,214947,0,3,2
61411,1,3,214945,214947,214950,2,5,0
61412,4,3,214949,214950,214953,1,4,0
61413,5,1,214954,214954,214955,0,1,1
61414,2,2,214956,214956,214958,0,2,1
61415,3,3,214959,214959,214962,0,3,1
61416,3,2,214962,214962,214964,0,2,0
61417,1,3,214963,214964,214967,1,4,0
61418,5,1,214968,214968,214969,0,1,1
61419,4,1,214972,214972,214973,0,1,3
61420,1,2,214973,214973,214975,0,2,0
61421,4,1,214977,214977,214978,0,1,2
61422,3,3,214980,214980,214983,0,3,2
61423,5,2,214985,214985,214987,0,2,2
61424,2,3,214987,214987,214990,0,3,0
61425,6,2,214993,214993,214995,0,2,3
61426,4,1,214997,214997,214998,0,1,2
61427,2,2,214999,214999,215001,0,2,1
61428,6,3,215005,215005,215008,0,3,4
61429,1,2,215006,215008,215010,2,4,0
61430,5,1,215011,215011,215012,0,1,1
61431,5,2,215016,215016,215018,0,2,4
61432,2,3,215018,215018,215021,0,3,0
61433,2,1,215020,215021,215022,1,2,0
61434,5,2,215025,215025,215027,0,2,3
61435,6,1,215031,215031,215032,0,1,4
61436,5,1,215036,215036,215037,0,1,4
61437,1,1,215037,215037,215038,0,1,0
61438,1,2,215038,215038,215040,0,2,0
61439,5,1,215043,215043,215044,0,1,3
61440,2,3,215045,215045,215048,0,3,1
61441,5,1,215050,215050,215051,0,1,2
61442,3,2,215053,215053,215055,0,2,2
61443,1,2,215054,215055,215057,1,3,0
61444,5,2,215059,215059,215061,0,2,2
61445,5,1,215064,215064,215065,0,1,3
61446,1,2,215065,215065,215067,0,2,0
61447,2,1,215067,215067,215068,0,1,0
61448,3,1,215070,215070,215071,0,1,2
61449,2,1,215072,215072,215073,0,1,1
61450,5,1,215077,215077,215078,0,1,4
61451,1,2,215078,215078,215080,0,2,0
61452,2,3,215080,215080,215083,0,3,0
61453,2,2,215082,215083,215085,1,3,0
61454,4,2,215086,215086,215088,0,2,1
61455,6,2,215092,215092,215094,0,2,4
61456,6,1,215098,215098,215099,0,1,4
61457,5,2,215103,215103,215105,0,2,4
61458,5,3,215108,215108,215111,0,3,3
61459,1,1,215109,215111,215112,2,3,0
61460,5,1,215114,215114,215115,0,1,2
61461,4,3,215118,215118,215121,0,3,3
61462,1,1,215119,215121,215122,2,3,0
61463,2,1,215121,215122,215123,1,2,0
61464,5,3,215126,215126,215129,0,3,3
61465,1,3,215127,215129,215132,2,5,0
61466,6,1,215133,215133,215134,0,1,1
61467,3,2,215136,215136,215138,0,2,2
61468,1,2,215137,215138,215140,1,3,0
61469,1,3,215138,215140,215143,2,5,0
61470,6,1,215144,215144,215145,0,1,1
61471,3,2,215147,215147,215149,0,2,2
61472,1,3,215148,215149,215152,1,4,0
61473,2,1,215150,215152,215153,2,3,0
61474,1,2,215151,215153,215155,2,4,0
61475,5,3,215156,215156,215159,0,3,1
61476,4,1,215160,215160,215161,0,1,1
61477,1,3,215161,215161,215164,0,3,0
61478,1,1,215162,215164,215165,2,3,0
61479,3,3,215165,215165,215168,0,3,0
61480,1,3,215166,215168,215171,2,5,0
61481,3,3,215169,215171,215174,2,5,0
61482,3,1,215172,215174,215175,2,3,0
61483,2,3,215174,215175,215178,1,4,0
61484,6,1,215180,215180,215181,0,1,2
61485,6,2,215186,215186,215188,0,2,5
61486,6,1,215192,215192,215193,0,1,4
61487,5,1,215197,215197,215198,0,1,4
61488,6,2,215203,215203,215205,0,2,5
61489,2,2,215205,215205,215207,0,2,0
61490,1,3,215206,215207,215210,1,4,0
61491,4,1,215210,215210,215211,0,1,0
61492,2,3,215212,215212,215215,0,3,1
61493,6,1,215218,215218,215219,0,1,3
61494,1,1,215219,215219,215220,0,1,0
61495,6,2,215225,215225,215227,0,2,5
61496,5,2,215230,215230,215232,0,2,3
61497,6,3,215236,215236,215239,0,3,4
61498,2,3,215238,215239,215242,1,4,0
61499,2,1,215240,215242,215243,2,3,0
61500,4,3,215244,215244,215247,0,3,1
61501,3,2,215247,215247,215249,0,2,0
61502,1,3,215248,215249,215252,1,4,0
61503,1,2,215249,215252,215254,3,5,0
61504,2,3,215251,215254,215257,3,6,0
61505,1,2,215252,215257,215259,5,7,0
61506,4,1,215256,215259,215260,3,4,0
61507,6,1,215262,215262,215263,0,1,2
61508,1,1,215263,215263,215264,0,1,0
61509,6,3,215269,215269,215272,0,3,5
61510,4,1,215273,215273,215274,0,1,1
61511,5,1,215278,215278,215279,0,1,4
61512,4,2,215282,215282,215284,0,2,3
61513,3,2,215285,215285,215287,0,2,1
61514,6,2,215291,215291,215293,0,2,4
61515,2,1,215293,215293,215294,0,1,0
61516,1,2,215294,215294,215296,0,2,0
61517,4,3,215298,215298,215301,0,3,2
61518,6,1,215304,215304,215305,0,1,3
61519,6,2,215310,215310,215312,0,2,5
61520,2,1,215312,215312,215313,0,1,0
61521,6,1,215318,215318,215319,0,1,5
61522,2,2,215320,215320,215322,0,2,1
61523,6,1,215326,215326,215327,0,1,4
61524,2,1,215328,215328,215329,0,1,1
61525,3,1,215331,215331,215332,0,1,2
61526,6,1,215337,215337,215338,0,1,5
61527,6,3,215343,215343,215346,0,3,5
61528,6,2,215349,215349,215351,0,2,3
61529,3,2,215352,215352,215354,0,2,1
61530,6,2,215358,215358,215360,0,2,4
61531,3,1,215361,215361,215362,0,1,1
61532,2,3,215363,215363,215366,0,3,1
61533,1,2,215364,215366,215368,2,4,0
61534,2,2,215366,215368,215370,2,4,0
61535,3,3,215369,215370,215373,1,4,0
61536,5,2,215374,215374,215376,0,2,1
61537,6,2,215380,215380,215382,0,2,4
61538,1,2,215381,215382,215384,1,3,0
61539,6,2,215387,215387,215389,0,2,3
61540,5,3,215392,215392,215395,0,3,3
61541,2,1,215394,215395,215396,1,2,0
61542,1,3,215395,215396,215399,1,4,0
61543,1,3,215396,215399,215402,3,6,0
61544,6,1,215402,215402,215403,0,1,0
61545,5,1,215407,215407,215408,0,1,4
61546,4,1,215411,215411,215412,0,1,3
61547,6,2,215417,215417,215419,0,2,5
61548,1,1,215418,215419,215420,1,2,0
61549,3,2,215421,215421,215423,0,2,1
61550,4,2,215425,215425,215427,0,2,2
61551,6,2,215431,215431,215433,0,2,4
61552,6,1,215437,215437,215438,0,1,4
61553,6,3,215443,215443,215446,0,3,5
61554,2,2,215445,215446,215448,1,3,0
61555,1,1,215446,215448,215449,2,3,0
61556,5,3,215451,215451,215454,0,3,2
61557,1,1,215452,215454,215455,2,3,0
61558,4,1,215456,215456,215457,0,1,1
61559,3,3,215459,215459,215462,0,3,2
61560,3,1,215462,215462,215463,0,1,0
61561,3,1,215465,215465,215466,0,1,2
61562,6,1,215471,215471,215472,0,1,5
61563,1,1,215472,215472,215473,0,1,0
61564,6,1,215478,215478,215479,0,1,5
61565,4,1,215482,215482,215483,0,1,3
61566,5,2,215487,215487,215489,0,2,4
61567,3,1,215490,215490,215491,0,1,1
61568,5,2,215495,215495,215497,0,2,4
61569,2,1,215497,215497,215498,0,1,0
61570,5,3,215502,215502,215505,0,3,4
61571,5,1,215507,215507,215508,0,1,2
61572,1,2,215508,215508,215510,0,2,0
61573,5,1,215513,215513,215514,0,1,3
61574,1,3,215514,215514,215517,0,3,0
61575,4,1,215518,215518,215519,0,1,1
61576,6,3,215524,215524,215527,0,3,5
61577,4,3,215528,215528,215531,0,3,1
61578,6,3,215534,215534,215537,0,3,3
61579,6,2,215540,215540,215542,0,2,3
61580,5,3,215545,215545,215548,0,3,3
61581,4,1,215549,215549,215550,0,1,1
61582,1,2,215550,215550,215552,0,2,0
61583,3,2,215553,215553,215555,0,2,1
61584,6,2,215559,215559,215561,0,2,4
61585,2,3,215561,215561,215564,0,3,0
61586,5,1,215566,215566,215567,0,1,2
61587,3,2,215569,215569,215571,0,2,2
61588,5,2,215574,215574,215576,0,2,3
61589,4,1,215578,215578,215579,0,1,2
61590,2,2,215580,215580,215582,0,2,1
61591,1,2,215581,215582,215584,1,3,0
61592,2,1,215583,215584,215585,1,2,0
61593,6,3,215589,215589,215592,0,3,4
61594,5,2,215594,215594,215596,0,2,2
61595,5,3,215599,215599,215602,0,3,3
61596,6,1,215605,215605,215606,0,1,3
61597,1,2,215606,215606,215608,0,2,0
61598,3,1,215609,215609,215610,0,1,1
61599,3,2,215612,215612,215614,0,2,2
61600,1,2,215613,215614,215616,1,3,0
61601,2,3,215615,215616,215619,1,4,0
61602,6,3,215621,215621,215624,0,3,2
61603,2,1,215623,215624,215625,1,2,0
61604,1,2,215624,215625,215627,1,3,0
61605,4,3,215628,215628,215631,0,3,1
61606,4,1,215632,215632,215633,0,1,1
61607,1,3,215633,215633,215636,0,3,0
61608,2,2,215635,215636,215638,1,3,0
61609,4,2,215639,215639,215641,0,2,1
61610,6,2,215645,215645,215647,0,2,4
61611,3,2,215648,215648,215650,0,2,1
61612,2,2,215650,215650,215652,0,2,0
61613,1,3,215651,215652,215655,1,4,0
61614,4,1,215655,215655,215656,0,1,0
61615,5,3,215660,215660,215663,0,3,4
61616,1,3,215661,215663,215666,2,5,0
61617,4,1,215665,215666,215667,1,2,0
61618,6,1,215671,215671,215672,0,1,4
61619,6,2,215677,215677,215679,0,2,5
61620,1,1,215678,215679,215680,1,2,0
61621,4,3,215682,215682,215685,0,3,2
61622,4,2,215686,215686,215688,0,2,1
61623,3,2,215689,215689,215691,0,2,1
61624,2,3,215691,215691,215694,0,3,0
61625,4,2,215695,215695,215697,0,2,1
61626,5,2,215700,215700,215702,0,2,3
61627,3,3,215703,215703,215706,0,3,1
61628,5,1,215708,215708,215709,0,1,2
61629,2,3,215710,215710,215713,0,3,1
61630,2,2,215712,215713,215715,1,3,0
61631,6,2,215718,215718,215720,0,2,3
61632,5,3,215723,215723,215726,0,3,3
61633,5,2,215728,215728,215730,0,2,2
61634,2,3,215730,215730,215733,0,3,0
61635,1,2,215731,215733,215735,2,4,0
61636,6,3,215737,215737,215740,0,3,2
61637,4,2,215741,215741,215743,0,2,1
61638,3,1,215744,215744,215745,0,1,1
61639,6,2,215750,215750,215752,0,2,5
61640,2,1,215752,215752,215753,0,1,0
61641,4,1,215756,215756,215757,0,1,3
61642,1,1,215757,215757,215758,0,1,0
61643,4,3,215761,215761,215764,0,3,3
61644,2,2,215763,215764,215766,1,3,0
61645,1,1,215764,215766,215767,2,3,0
61646,3,3,215767,215767,215770,0,3,0
61647,1,1,215768,215770,215771,2,3,0
61648,5,2,215773,215773,215775,0,2,2
61649,5,3,215778,215778,215781,0,3,3
61650,3,1,215781,215781,215782,0,1,0
61651,5,1,215786,215786,215787,0,1,4
61652,5,1,215791,215791,215792,0,1,4
61653,2,1,215793,215793,215794,0,1,1
61654,3,1,215796,215796,215797,0,1,2
61655,2,1,215798,215798,215799,0,1,1
61656,2,1,215800,215800,215801,0,1,1
61657,6,2,215806,215806,215808,0,2,5
61658,5,3,215811,215811,215814,0,3,3
61659,1,2,215812,215814,215816,2,4,0
61660,1,3,215813,215816,215819,3,6,0
61661,2,3,215815,215819,215822,4,7,0
61662,5,2,215820,215822,215824,2,4,0
61663,6,2,215826,215826,215828,0,2,2
61664,2,1,215828,215828,215829,0,1,0
61665,5,1,215833,215833,215834,0,1,4
61666,5,2,215838,215838,215840,0,2,4
61667,3,1,215841,215841,215842,0,1,1
61668,3,3,215844,215844,215847,0,3,2
61669,3,3,215847,215847,215850,0,3,0
61670,3,2,215850,215850,215852,0,2,0
61671,2,2,215852,215852,215854,0,2,0
61672,1,1,215853,215854,215855,1,2,0
61673,3,1,215856,215856,215857,0,1,1
61674,1,2,215857,215857,215859,0,2,0
61675,5,1,215862,215862,215863,0,1,3
61676,2,1,215864,215864,215865,0,1,1
61677,4,1,215868,215868,215869,0,1,3
61678,5,2,215873,215873,215875,0,2,4
61679,1,3,215874,215875,215878,1,4,0
61680,1,1,215875,215878,215879,3,4,0
61681,6,3,215881,215881,215884,0,3,2
61682,4,2,215885,215885,215887,0,2,1
61683,4,3,215889,215889,215892,0,3,2
61684,1,1,215890,215892,215893,2,3,0
61685,5,3,215895,215895,215898,0,3,2
61686,6,2,215901,215901,215903,0,2,3
61687,1,2,215902,215903,215905,1,3,0
61688,5,1,215907,215907,215908,0,1,2
61689,1,2,215908,215908,215910,0,2,0
61690,1,1,215909,215910,215911,1,2,0
61691,5,1,215914,215914,215915,0,1,3
61692,5,2,215919,215919,215921,0,2,4
61693,4,2,215923,215923,215925,0,2,2
61694,2,2,215925,215925,215927,0,2,0
61695,6,3,215931,215931,215934,0,3,4
61696,3,2,215934,215934,215936,0,2,0
61697,3,2,215937,215937,215939,0,2,1
61698,4,1,215941,215941,215942,0,1,2
61699,6,2,215947,215947,215949,0,2,5
61700,2,2,215949,215949,215951,0,2,0
61701,1,1,215950,215951,215952,1,2,0
61702,3,1,215953,215953,215954,0,1,1
61703,5,1,215958,215958,215959,0,1,4
61704,5,3,215963,215963,215966,0,3,4
61705,4,2,215967,215967,215969,0,2,1
61706,6,2,215973,215973,215975,0,2,4
61707,1,2,215974,215975,215977,1,3,0
61708,3,3,215977,215977,215980,0,3,0
61709,5,3,215982,215982,215985,0,3,2
61710,2,1,215984,215985,215986,1,2,0
61711,1,3,215985,215986,215989,1,4,0
61712,3,1,215988,215989,215990,1,2,0
61713,3,2,215991,215991,215993,0,2,1
61714,4,2,215995,215995,215997,0,2,2
61715,1,3,215996,215997,216000,1,4,0
61716,6,3,216002,216002,216005,0,3,2
61717,1,1,216003,216005,216006,2,3,0
61718,1,2,216004,216006,216008,2,4,0
61719,4,3,216008,216008,216011,0,3,0
61720,1,1,216009,216011,216012,2,3,0
61721,5,2,216014,216014,216016,0,2,2
61722,6,3,216020,216020,216023,0,3,4
61723,4,2,216024,216024,216026,0,2,1
61724,5,1,216029,216029,216030,0,1,3
61725,1,2,216030,216030,216032,0,2,0
61726,1,1,216031,216032,216033,1,2,0
61727,4,3,216035,216035,216038,0,3,2
61728,2,2,216037,216038,216040,1,3,0
61729,6,1,216043,216043,216044,0,1,3
61730,2,1,216045,216045,216046,0,1,1
61731,4,1,216049,216049,216050,0,1,3
61732,4,3,216053,216053,216056,0,3,3
61733,6,2,216059,216059,216061,0,2,3
61734,6,1,216065,216065,216066,0,1,4
61735,1,2,216066,216066,216068,0,2,0
61736,6,2,216072,216072,216074,0,2,4
61737,1,2,216073,216074,216076,1,3,0
61738,1,3,216074,216076,216079,2,5,0
61739,5,2,216079,216079,216081,0,2,0
61740,3,3,216082,216082,216085,0,3,1
61741,2,2,216084,216085,216087,1,3,0
61742,3,2,216087,216087,216089,0,2,0
61743,5,2,216092,216092,216094,0,2,3
61744,3,3,216095,216095,216098,0,3,1
61745,4,3,216099,216099,216102,0,3,1
61746,6,1,216105,216105,216106,0,1,3
61747,6,2,216111,216111,216113,0,2,5
61748,6,2,216117,216117,216119,0,2,4
61749,3,1,216120,216120,216121,0,1,1
61750,1,3,216121,216121,216124,0,3,0
61751,2,3,216123,216124,216127,1,4,0
61752,3,3,216126,216127,216130,1,4,0
61753,6,1,216132,216132,216133,0,1,2
61754,3,2,216135,216135,216137,0,2,2
61755,3,2,216138,216138,216140,0,2,1
61756,3,3,216141,216141,216144,0,3,1
61757,2,3,216143,216144,216147,1,4,0
61758,1,3,216144,216147,216150,3,6,0
61759,1,2,216145,216150,216152,5,7,0
61760,5,3,216150,216152,216155,2,5,0
61761,5,1,216155,216155,216156,0,1,0
61762,2,2,216157,216157,216159,0,2,1
61763,6,2,216163,216163,216165,0,2,4
61764,3,3,216166,216166,216169,0,3,1
61765,4,2,216170,216170,216172,0,2,1
61766,3,2,216173,216173,216175,0,2,1
61767,3,3,216176,216176,216179,0,3,1
61768,3,2,216179,216179,216181,0,2,0
61769,1,3,216180,216181,216184,1,4,0
61770,4,1,216184,216184,216185,0,1,0
61771,2,1,216186,216186,216187,0,1,1
61772,1,3,216187,216187,216190,0,3,0
61773,2,3,216189,216190,216193,1,4,0
61774,3,3,216192,216193,216196,1,4,0
61775,4,1,216196,216196,216197,0,1,0
61776,5,3,216201,216201,216204,0,3,4
61777,5,3,216206,216206,216209,0,3,2
61778,2,3,216208,216209,216212,1,4,0
61779,2,3,216210,216212,216215,2,5,0
61780,5,2,216215,216215,216217,0,2,0
61781,4,3,216219,216219,216222,0,3,2
61782,4,1,216223,216223,216224,0,1,1
61783,5,1,216228,216228,216229,0,1,4
61784,4,2,216232,216232,216234,0,2,3
61785,1,2,216233,216234,216236,1,3,0
61786,3,1,216236,216236,216237,0,1,0
61787,3,3,216239,216239,216242,0,3,2
61788,3,3,216242,216242,216245,0,3,0
61789,3,3,216245,216245,216248,0,3,0
61790,6,1,216251,216251,216252,0,1,3
61791,3,2,216254,216254,216256,0,2,2
61792,4,1,216258,216258,216259,0,1,2
61793,6,2,216264,216264,216266,0,2,5
61794,2,1,216266,216266,216267,0,1,0
61795,5,2,216271,216271,216273,0,2,4
61796,2,3,216273,216273,216276,0,3,0
61797,3,1,216276,216276,216277,0,1,0
61798,4,2,216280,216280,216282,0,2,3
61799,4,1,216284,216284,216285,0,1,2
61800,5,1,216289,216289,216290,0,1,4
61801,6,2,216295,216295,216297,0,2,5
61802,3,3,216298,216298,216301,0,3,1
61803,1,2,216299,216301,216303,2,4,0
61804,3,2,216302,216303,216305,1,3,0
61805,5,2,216307,216307,216309,0,2,2
61806,1,2,216308,216309,216311,1,3,0
61807,2,1,216310,216311,216312,1,2,0
61808,2,2,216312,216312,216314,0,2,0
61809,2,2,216314,216314,216316,0,2,0
61810,5,1,216319,216319,216320,0,1,3
61811,4,3,216323,216323,216326,0,3,3
61812,6,2,216329,216329,216331,0,2,3
61813,4,2,216333,216333,216335,0,2,2
61814,2,3,216335,216335,216338,0,3,0
61815,4,2,216339,216339,216341,0,2,1
61816,4,2,216343,216343,216345,0,2,2
61817,6,3,216349,216349,216352,0,3,4
61818,3,2,216352,216352,216354,0,2,0
61819,1,3,216353,216354,216357,1,4,0
61820,5,2,216358,216358,216360,0,2,1
61821,4,2,216362,216362,216364,0,2,2
61822,5,2,216367,216367,216369,0,2,3
61823,5,1,216372,216372,216373,0,1,3
61824,6,3,216378,216378,216381,0,3,5
61825,4,2,216382,216382,216384,0,2,1
61826,4,2,216386,216386,216388,0,2,2
61827,4,2,216390,216390,216392,0,2,2
61828,2,3,216392,216392,216395,0,3,0
61829,6,3,216398,216398,216401,0,3,3
61830,3,3,216401,216401,216404,0,3,0
61831,6,1,216407,216407,216408,0,1,3
61832,3,3,216410,216410,216413,0,3,2
61833,6,1,216416,216416,216417,0,1,3
61834,2,2,216418,216418,216420,0,2,1
61835,3,2,216421,216421,216423,0,2,1
61836,1,1,216422,216423,216424,1,2,0
61837,6,3,216428,216428,216431,0,3,4
61838,3,3,216431,216431,216434,0,3,0
61839,3,2,216434,216434,216436,0,2,0
61840,5,1,216439,216439,216440,0,1,3
61841,5,3,216444,216444,216447,0,3,4
61842,3,3,216447,216447,216450,0,3,0
61843,5,2,216452,216452,216454,0,2,2
61844,4,3,216456,216456,216459,0,3,2
61845,6,2,216462,216462,216464,0,2,3
61846,4,1,216466,216466,216467,0,1,2
61847,3,1,216469,216469,216470,0,1,2
61848,5,2,216474,216474,216476,0,2,4
61849,2,2,216476,216476,216478,0,2,0
61850,3,2,216479,216479,216481,0,2,1
61851,1,3,216480,216481,216484,1,4,0
61852,5,3,216485,216485,216488,0,3,1
61853,4,3,216489,216489,216492,0,3,1
61854,6,1,216495,216495,216496,0,1,3
61855,3,3,216498,216498,216501,0,3,2
61856,4,2,216502,216502,216504,0,2,1
61857,6,1,216508,216508,216509,0,1,4
61858,6,3,216514,216514,216517,0,3,5
61859,5,1,216519,216519,216520,0,1,2
61860,3,1,216522,216522,216523,0,1,2
61861,3,2,216525,216525,216527,0,2,2
61862,2,3,216527,216527,216530,0,3,0
61863,5,2,216532,216532,216534,0,2,2
61864,6,1,216538,216538,216539,0,1,4
61865,2,2,216540,216540,216542,0,2,1
61866,3,3,216543,216543,216546,0,3,1
61867,3,1,216546,216546,216547,0,1,0
61868,2,2,216548,216548,216550,0,2,1
61869,3,2,216551,216551,216553,0,2,1
61870,4,1,216555,216555,216556,0,1,2
61871,4,3,216559,216559,216562,0,3,3
61872,5,1,216564,216564,216565,0,1,2
61873,6,2,216570,216570,216572,0,2,5
61874,4,2,216574,216574,216576,0,2,2
61875,4,2,216578,216578,216580,0,2,2
61876,5,1,216583,216583,216584,0,1,3
61877,6,2,216589,216589,216591,0,2,5
61878,4,2,216593,216593,216595,0,2,2
61879,3,1,216596,216596,216597,0,1,1
61880,6,2,216602,216602,216604,0,2,5
61881,6,3,216608,216608,216611,0,3,4
61882,2,2,216610,216611,216613,1,3,0
61883,5,2,216615,216615,216617,0,2,2
61884,5,1,216620,216620,216621,0,1,3
61885,5,2,216625,216625,216627,0,2,4
61886,3,2,216628,216628,216630,0,2,1
61887,2,3,216630,216630,216633,0,3,0
61888,2,3,216632,216633,216636,1,4,0
61889,1,3,216633,216636,216639,3,6,0
61890,5,3,216638,216639,216642,1,4,0
61891,3,1,216641,216642,216643,1,2,0
61892,1,3,216642,216643,216646,1,4,0
61893,3,2,216645,216646,216648,1,3,0
61894,6,2,216651,216651,216653,0,2,3
61895,3,2,216654,216654,216656,0,2,1
61896,6,3,216660,216660,216663,0,3,4
61897,3,1,216663,216663,216664,0,1,0
61898,6,1,216669,216669,216670,0,1,5
61899,1,2,216670,216670,216672,0,2,0
61900,4,2,216674,216674,216676,0,2,2
61901,1,3,216675,216676,216679,1,4,0
61902,4,2,216679,216679,216681,0,2,0
61903,6,3,216685,216685,216688,0,3,4
61904,1,3,216686,216688,216691,2,5,0
61905,2,3,216688,216691,216694,3,6,0
61906,3,2,216691,216694,216696,3,5,0
61907,6,1,216697,216697,216698,0,1,1
61908,3,3,216700,216700,216703,0,3,2
61909,2,2,216702,216703,216705,1,3,0
61910,1,3,216703,216705,216708,2,5,0
61911,3,1,216706,216708,216709,2,3,0
61912,5,3,216711,216711,216714,0,3,2
61913,5,1,216716,216716,216717,0,1,2
61914,1,1,216717,216717,216718,0,1,0
61915,4,2,216721,216721,216723,0,2,3
61916,1,2,216722,216723,216725,1,3,0
61917,4,1,216726,216726,216727,0,1,1
61918,5,1,216731,216731,216732,0,1,4
61919,4,1,216735,216735,216736,0,1,3
61920,4,2,216739,216739,216741,0,2,3
61921,3,2,216742,216742,216744,0,2,1
61922,2,3,216744,216744,216747,0,3,0
61923,5,3,216749,216749,216752,0,3,2
61924,6,3,216755,216755,216758,0,3,3
61925,4,1,216759,216759,216760,0,1,1
61926,2,3,216761,216761,216764,0,3,1
61927,5,1,216766,216766,216767,0,1,2
61928,4,1,216770,216770,216771,0,1,3
61929,1,1,216771,216771,216772,0,1,0
61930,5,3,216776,216776,216779,0,3,4
61931,4,2,216780,216780,216782,0,2,1
61932,1,1,216781,216782,216783,1,2,0
61933,5,3,216786,216786,216789,0,3,3
61934,5,1,216791,216791,216792,0,1,2
61935,1,3,216792,216792,216795,0,3,0
61936,3,1,216795,216795,216796,0,1,0
61937,6,1,216801,216801,216802,0,1,5
61938,3,2,216804,216804,216806,0,2,2
61939,3,3,216807,216807,216810,0,3,1
61940,1,1,216808,216810,216811,2,3,0
61941,3,3,216811,216811,216814,0,3,0
61942,6,3,216817,216817,216820,0,3,3
61943,1,2,216818,216820,216822,2,4,0
61944,2,3,216820,216822,216825,2,5,0
61945,4,3,216824,216825,216828,1,4,0
61946,6,2,216830,216830,216832,0,2,2
61947,6,1,216836,216836,216837,0,1,4
61948,6,2,216842,216842,216844,0,2,5
61949,2,1,216844,216844,216845,0,1,0
61950,3,3,216847,216847,216850,0,3,2
61951,6,2,216853,216853,216855,0,2,3
61952,4,3,216857,216857,216860,0,3,2
61953,1,3,216858,216860,216863,2,5,0
61954,4,3,216862,216863,216866,1,4,0
61955,4,3,216866,216866,216869,0,3,0
61956,5,1,216871,216871,216872,0,1,2
61957,2,1,216873,216873,216874,0,1,1
61958,2,3,216875,216875,216878,0,3,1
61959,4,3,216879,216879,216882,0,3,1
61960,4,2,216883,216883,216885,0,2,1
61961,1,2,216884,216885,216887,1,3,0
61962,3,3,216887,216887,216890,0,3,0
61963,1,3,216888,216890,216893,2,5,0
61964,6,2,216894,216894,216896,0,2,1
61965,3,3,216897,216897,216900,0,3,1
61966,2,1,216899,216900,216901,1,2,0
61967,1,2,216900,216901,216903,1,3,0
61968,6,3,216906,216906,216909,0,3,3
61969,2,1,216908,216909,216910,1,2,0
61970,3,2,216911,216911,216913,0,2,1
61971,5,3,216916,216916,216919,0,3,3
61972,4,1,216920,216920,216921,0,1,1
61973,4,2,216924,216924,216926,0,2,3
61974,5,3,216929,216929,216932,0,3,3
61975,3,2,216932,216932,216934,0,2,0
61976,4,2,216936,216936,216938,0,2,2
61977,3,3,216939,216939,216942,0,3,1
61978,2,3,216941,216942,216945,1,4,0
61979,2,1,216943,216945,216946,2,3,0
61980,2,1,216945,216946,216947,1,2,0
61981,1,2,216946,216947,216949,1,3,0
61982,1,3,216947,216949,216952,2,5,0
61983,2,3,216949,216952,216955,3,6,0
61984,6,3,216955,216955,216958,0,3,0
61985,3,3,216958,216958,216961,0,3,0
61986,5,1,216963,216963,216964,0,1,2
61987,3,3,216966,216966,216969,0,3,2
61988,1,2,216967,216969,216971,2,4,0
61989,5,1,216972,216972,216973,0,1,1
61990,5,1,216977,216977,216978,0,1,4
61991,1,1,216978,216978,216979,0,1,0
61992,4,2,216982,216982,216984,0,2,3
61993,1,2,216983,216984,216986,1,3,0
61994,5,2,216988,216988,216990,0,2,2
61995,6,1,216994,216994,216995,0,1,4
61996,1,3,216995,216995,216998,0,3,0
61997,6,1,217001,217001,217002,0,1,3
61998,4,1,217005,217005,217006,0,1,3
61999,3,1,217008,217008,217009,0,1,2
62000,2,2,217010,217010,217012,0,2,1
62001,2,1,217012,217012,217013,0,1,0
62002,2,3,217014,217014,217017,0,3,1
62003,1,1,217015,217017,217018,2,3,0
62004,5,2,217020,217020,217022,0,2,2
62005,5,1,217025,217025,217026,0,1,3
62006,3,1,217028,217028,217029,0,1,2
62007,6,2,217034,217034,217036,0,2,5
62008,1,2,217035,217036,217038,1,3,0
62009,3,1,217038,217038,217039,0,1,0
62010,5,3,217043,217043,217046,0,3,4
62011,2,2,217045,217046,217048,1,3,0
62012,2,3,217047,217048,217051,1,4,0
62013,5,2,217052,217052,217054,0,2,1
62014,3,3,217055,217055,217058,0,3,1
62015,1,1,217056,217058,217059,2,3,0
62016,5,2,217061,217061,217063,0,2,2
62017,6,1,217067,217067,217068,0,1,4
62018,5,3,217072,217072,217075,0,3,4
62019,6,1,217078,217078,217079,0,1,3
62020,3,3,217081,217081,217084,0,3,2
62021,4,3,217085,217085,217088,0,3,1
62022,1,3,217086,217088,217091,2,5,0
62023,2,2,217088,217091,217093,3,5,0
62024,5,2,217093,217093,217095,0,2,0
62025,1,2,217094,217095,217097,1,3,0
62026,3,3,217097,217097,217100,0,3,0
62027,3,3,217100,217100,217103,0,3,0
62028,3,2,217103,217103,217105,0,2,0
62029,2,2,217105,217105,217107,0,2,0
62030,6,1,217111,217111,217112,0,1,4
62031,6,3,217117,217117,217120,0,3,5
62032,1,2,217118,217120,217122,2,4,0
62033,4,3,217122,217122,217125,0,3,0
62034,2,1,217124,217125,217126,1,2,0
62035,1,3,217125,217126,217129,1,4,0
62036,5,1,217130,217130,217131,0,1,1
62037,2,1,217132,217132,217133,0,1,1
62038,1,1,217133,217133,217134,0,1,0
62039,6,2,217139,217139,217141,0,2,5
62040,4,3,217143,217143,217146,0,3,2
62041,2,1,217145,217146,217147,1,2,0
62042,6,2,217151,217151,217153,0,2,4
62043,1,2,217152,217153,217155,1,3,0
62044,6,3,217158,217158,217161,0,3,3
62045,5,3,217163,217163,217166,0,3,2
62046,1,1,217164,217166,217167,2,3,0
62047,5,1,217169,217169,217170,0,1,2
62048,5,1,217174,217174,217175,0,1,4
62049,5,3,217179,217179,217182,0,3,4
62050,4,3,217183,217183,217186,0,3,1
62051,6,1,217189,217189,217190,0,1,3
62052,5,2,217194,217194,217196,0,2,4
62053,4,3,217198,217198,217201,0,3,2
62054,2,1,217200,217201,217202,1,2,0
62055,3,1,217203,217203,217204,0,1,1
62056,2,1,217205,217205,217206,0,1,1
62057,6,3,217211,217211,217214,0,3,5
62058,3,1,217214,217214,217215,0,1,0
62059,3,2,217217,217217,217219,0,2,2
62060,2,1,217219,217219,217220,0,1,0
62061,3,2,217222,217222,217224,0,2,2
62062,3,3,217225,217225,217228,0,3,1
62063,5,2,217230,217230,217232,0,2,2
62064,5,2,217235,217235,217237,0,2,3
62065,6,1,217241,217241,217242,0,1,4
62066,2,1,217243,217243,217244,0,1,1
62067,5,1,217248,217248,217249,0,1,4
62068,5,1,217253,217253,217254,0,1,4
62069,4,2,217257,217257,217259,0,2,3
62070,6,3,217263,217263,217266,0,3,4
62071,4,2,217267,217267,217269,0,2,1
62072,1,1,217268,217269,217270,1,2,0
62073,1,1,217269,217270,217271,1,2,0
62074,3,3,217272,217272,217275,0,3,1
62075,1,2,217273,217275,217277,2,4,0
62076,5,2,217278,217278,217280,0,2,1
62077,3,1,217281,217281,217282,0,1,1
62078,5,2,217286,217286,217288,0,2,4
62079,3,2,217289,217289,217291,0,2,1
62080,5,1,217294,217294,217295,0,1,3
62081,5,3,217299,217299,217302,0,3,4
62082,6,1,217305,217305,217306,0,1,3
62083,6,2,217311,217311,217313,0,2,5
62084,4,2,217315,217315,217317,0,2,2
62085,3,2,217318,217318,217320,0,2,1
62086,5,3,217323,217323,217326,0,3,3
62087,2,2,217325,217326,217328,1,3,0
62088,6,1,217331,217331,217332,0,1,3
62089,3,1,217334,217334,217335,0,1,2
62090,1,3,217335,217335,217338,0,3,0
62091,6,3,217341,217341,217344,0,3,3
62092,6,2,217347,217347,217349,0,2,3
62093,3,1,217350,217350,217351,0,1,1
62094,1,3,217351,217351,217354,0,3,0
62095,2,2,217353,217354,217356,1,3,0
62096,5,3,217358,217358,217361,0,3,2
62097,5,1,217363,217363,217364,0,1,2
62098,3,3,217366,217366,217369,0,3,2
62099,4,3,217370,217370,217373,0,3,1
62100,3,2,217373,217373,217375,0,2,0
62101,5,3,217378,217378,217381,0,3,3
62102,5,1,217383,217383,217384,0,1,2
62103,6,1,217389,217389,217390,0,1,5
62104,3,1,217392,217392,217393,0,1,2
62105,2,3,217394,217394,217397,0,3,1
62106,1,2,217395,217397,217399,2,4,0
62107,4,3,217399,217399,217402,0,3,0
62108,3,1,217402,217402,217403,0,1,0
62109,3,1,217405,217405,217406,0,1,2
62110,3,2,217408,217408,217410,0,2,2
62111,4,2,217412,217412,217414,0,2,2
62112,4,3,217416,217416,217419,0,3,2
62113,6,2,217422,217422,217424,0,2,3
62114,5,1,217427,217427,217428,0,1,3
62115,5,3,217432,217432,217435,0,3,4
62116,6,1,217438,217438,217439,0,1,3
62117,4,2,217442,217442,217444,0,2,3
62118,1,2,217443,217444,217446,1,3,0
62119,1,1,217444,217446,217447,2,3,0
62120,5,1,217449,217449,217450,0,1,2
62121,1,3,217450,217450,217453,0,3,0
62122,3,2,217453,217453,217455,0,2,0
62123,1,2,217454,217455,217457,1,3,0
62124,2,2,217456,217457,217459,1,3,0
62125,6,2,217462,217462,217464,0,2,3
62126,2,2,217464,217464,217466,0,2,0
62127,5,1,217469,217469,217470,0,1,3
62128,6,2,217475,217475,217477,0,2,5
62129,2,3,217477,217477,217480,0,3,0
62130,2,1,217479,217480,217481,1,2,0
62131,5,3,217484,217484,217487,0,3,3
62132,2,3,217486,217487,217490,1,4,0
62133,2,3,217488,217490,217493,2,5,0
62134,6,3,217494,217494,217497,0,3,1
62135,1,2,217495,217497,217499,2,4,0
62136,6,1,217501,217501,217502,0,1,2
62137,4,2,217505,217505,217507,0,2,3
62138,5,1,217510,217510,217511,0,1,3
62139,6,2,217516,217516,217518,0,2,5
62140,5,1,217521,217521,217522,0,1,3
62141,6,1,217527,217527,217528,0,1,5
62142,6,2,217533,217533,217535,0,2,5
62143,6,1,217539,217539,217540,0,1,4
62144,2,1,217541,217541,217542,0,1,1
62145,4,2,217545,217545,217547,0,2,3
62146,2,1,217547,217547,217548,0,1,0
62147,2,2,217549,217549,217551,0,2,1
62148,2,2,217551,217551,217553,0,2,0
62149,6,1,217557,217557,217558,0,1,4
62150,3,2,217560,217560,217562,0,2,2
62151,2,2,217562,217562,217564,0,2,0
62152,5,3,217567,217567,217570,0,3,3
62153,4,1,217571,217571,217572,0,1,1
62154,6,1,217577,217577,217578,0,1,5
62155,2,2,217579,217579,217581,0,2,1
62156,5,1,217584,217584,217585,0,1,3
62157,6,1,217590,217590,217591,0,1,5
62158,2,2,217592,217592,217594,0,2,1
62159,6,2,217598,217598,217600,0,2,4
62160,4,1,217602,217602,217603,0,1,2
62161,5,3,217607,217607,217610,0,3,4
62162,2,3,217609,217610,217613,1,4,0
62163,6,1,217615,217615,217616,0,1,2
62164,6,2,217621,217621,217623,0,2,5
62165,5,2,217626,217626,217628,0,2,3
62166,2,2,217628,217628,217630,0,2,0
62167,1,3,217629,217630,217633,1,4,0
62168,1,3,217630,217633,217636,3,6,0
62169,2,1,217632,217636,217637,4,5,0
62170,2,3,217634,217637,217640,3,6,0
62171,4,1,217638,217640,217641,2,3,0
62172,2,1,217640,217641,217642,1,2,0
62173,4,3,217644,217644,217647,0,3,2
62174,5,3,217649,217649,217652,0,3,2
62175,3,2,217652,217652,217654,0,2,0
62176,3,2,217655,217655,217657,0,2,1
62177,3,3,217658,217658,217661,0,3,1
62178,4,2,217662,217662,217664,0,2,1
62179,4,3,217666,217666,217669,0,3,2
62180,6,3,217672,217672,217675,0,3,3
62181,5,3,217677,217677,217680,0,3,2
62182,5,1,217682,217682,217683,0,1,2
62183,6,2,217688,217688,217690,0,2,5
62184,1,2,217689,217690,217692,1,3,0
62185,3,3,217692,217692,217695,0,3,0
62186,6,2,217698,217698,217700,0,2,3
62187,1,2,217699,217700,217702,1,3,0
62188,5,2,217704,217704,217706,0,2,2
62189,5,1,217709,217709,217710,0,1,3
62190,1,1,217710,217710,217711,0,1,0
62191,6,2,217716,217716,217718,0,2,5
62192,5,2,217721,217721,217723,0,2,3
62193,2,2,217723,217723,217725,0,2,0
62194,2,3,217725,217725,217728,0,3,0
62195,1,2,217726,217728,217730,2,4,0
62196,6,2,217732,217732,217734,0,2,2
62197,2,3,217734,217734,217737,0,3,0
62198,5,2,217739,217739,217741,0,2,2
62199,3,2,217742,217742,217744,0,2,1
62200,3,2,217745,217745,217747,0,2,1
62201,2,1,217747,217747,217748,0,1,0
62202,5,1,217752,217752,217753,0,1,4
62203,4,1,217756,217756,217757,0,1,3
62204,4,2,217760,217760,217762,0,2,3
62205,1,3,217761,217762,217765,1,4,0
62206,5,3,217766,217766,217769,0,3,1
62207,5,1,217771,217771,217772,0,1,2
62208,1,1,217772,217772,217773,0,1,0
62209,6,2,217778,217778,217780,0,2,5
62210,2,2,217780,217780,217782,0,2,0
62211,3,3,217783,217783,217786,0,3,1
62212,1,3,217784,217786,217789,2,5,0
62213,6,2,217790,217790,217792,0,2,1
62214,5,3,217795,217795,217798,0,3,3
62215,3,3,217798,217798,217801,0,3,0
62216,2,1,217800,217801,217802,1,2,0
62217,5,1,217805,217805,217806,0,1,3
62218,4,2,217809,217809,217811,0,2,3
62219,6,2,217815,217815,217817,0,2,4
62220,3,2,217818,217818,217820,0,2,1
62221,2,1,217820,217820,217821,0,1,0
62222,2,2,217822,217822,217824,0,2,1
62223,2,1,217824,217824,217825,0,1,0
62224,2,3,217826,217826,217829,0,3,1
62225,2,2,217828,217829,217831,1,3,0
62226,4,3,217832,217832,217835,0,3,1
62227,6,1,217838,217838,217839,0,1,3
62228,2,1,217840,217840,217841,0,1,1
62229,2,2,217842,217842,217844,0,2,1
62230,2,1,217844,217844,217845,0,1,0
62231,6,2,217850,217850,217852,0,2,5
62232,2,2,217852,217852,217854,0,2,0
62233,1,3,217853,217854,217857,1,4,0
62234,1,2,217854,217857,217859,3,5,0
62235,2,1,217856,217859,217860,3,4,0
62236,4,3,217860,217860,217863,0,3,0
62237,1,1,217861,217863,217864,2,3,0
62238,3,3,217864,217864,217867,0,3,0
62239,2,2,217866,217867,217869,1,3,0
62240,5,3,217871,217871,217874,0,3,2
62241,3,2,217874,217874,217876,0,2,0
62242,1,3,217875,217876,217879,1,4,0
62243,1,3,217876,217879,217882,3,6,0
62244,1,2,217877,217882,217884,5,7,0
62245,3,3,217880,217884,217887,4,7,0
62246,3,1,217883,217887,217888,4,5,0
62247,6,1,217889,217889,217890,0,1,1
62248,3,3,217892,217892,217895,0,3,2
62249,2,3,217894,217895,217898,1,4,0
62250,2,2,217896,217898,217900,2,4,0
62251,1,3,217897,217900,217903,3,6,0
62252,6,1,217903,217903,217904,0,1,0
62253,4,2,217907,217907,217909,0,2,3
62254,1,1,217908,217909,217910,1,2,0
62255,3,3,217911,217911,217914,0,3,1
62256,5,3,217916,217916,217919,0,3,2
62257,2,1,217918,217919,217920,1,2,0
62258,3,3,217921,217921,217924,0,3,1
62259,4,2,217925,217925,217927,0,2,1
62260,2,2,217927,217927,217929,0,2,0
62261,1,1,217928,217929,217930,1,2,0
62262,1,2,217929,217930,217932,1,3,0
62263,5,2,217934,217934,217936,0,2,2
62264,5,1,217939,217939,217940,0,1,3
62265,2,2,217941,217941,217943,0,2,1
62266,1,3,217942,217943,217946,1,4,0
62267,2,1,217944,217946,217947,2,3,0
62268,6,3,217950,217950,217953,0,3,3
62269,1,2,217951,217953,217955,2,4,0
62270,6,1,217957,217957,217958,0,1,2
62271,3,3,217960,217960,217963,0,3,2
62272,6,1,217966,217966,217967,0,1,3
62273,5,1,217971,217971,217972,0,1,4
62274,4,1,217975,217975,217976,0,1,3
62275,5,1,217980,217980,217981,0,1,4
62276,4,3,217984,217984,217987,0,3,3
62277,2,3,217986,217987,217990,1,4,0
62278,2,2,217988,217990,217992,2,4,0
62279,1,3,217989,217992,217995,3,6,0
62280,5,2,217994,217995,217997,1,3,0
62281,4,1,217998,217998,217999,0,1,1
62282,5,2,218003,218003,218005,0,2,4
62283,2,3,218005,218005,218008,0,3,0
62284,6,3,218011,218011,218014,0,3,3
62285,6,1,218017,218017,218018,0,1,3
62286,6,3,218023,218023,218026,0,3,5
62287,1,3,218024,218026,218029,2,5,0
62288,4,3,218028,218029,218032,1,4,0
62289,3,2,218031,218032,218034,1,3,0
62290,1,2,218032,218034,218036,2,4,0
62291,1,2,218033,218036,218038,3,5,0
62292,3,1,218036,218038,218039,2,3,0
62293,4,1,218040,218040,218041,0,1,1
62294,5,3,218045,218045,218048,0,3,4
62295,6,3,218051,218051,218054,0,3,3
62296,6,1,218057,218057,218058,0,1,3
62297,6,2,218063,218063,218065,0,2,5
62298,1,2,218064,218065,218067,1,3,0
62299,3,2,218067,218067,218069,0,2,0
62300,2,2,218069,218069,218071,0,2,0
62301,1,1,218070,218071,218072,1,2,0
62302,6,1,218076,218076,218077,0,1,4
62303,3,3,218079,218079,218082,0,3,2
62304,6,1,218085,218085,218086,0,1,3
62305,1,1,218086,218086,218087,0,1,0
62306,3,3,218089,218089,218092,0,3,2
62307,3,3,218092,218092,218095,0,3,0
62308,6,2,218098,218098,218100,0,2,3
62309,4,2,218102,218102,218104,0,2,2
62310,6,2,218108,218108,218110,0,2,4
62311,1,2,218109,218110,218112,1,3,0
62312,3,3,218112,218112,218115,0,3,0
62313,6,1,218118,218118,218119,0,1,3
62314,2,1,218120,218120,218121,0,1,1
62315,5,3,218125,218125,218128,0,3,4
62316,5,2,218130,218130,218132,0,2,2
62317,4,1,218134,218134,218135,0,1,2
62318,2,1,218136,218136,218137,0,1,1
62319,2,3,218138,218138,218141,0,3,1
62320,4,3,218142,218142,218145,0,3,1
62321,3,3,218145,218145,218148,0,3,0
62322,3,1,218148,218148,218149,0,1,0
62323,5,2,218153,218153,218155,0,2,4
62324,6,3,218159,218159,218162,0,3,4
62325,3,2,218162,218162,218164,0,2,0
62326,6,2,218168,218168,218170,0,2,4
62327,4,1,218172,218172,218173,0,1,2
62328,4,3,218176,218176,218179,0,3,3
62329,3,2,218179,218179,218181,0,2,0
62330,6,3,218185,218185,218188,0,3,4
62331,2,3,218187,218188,218191,1,4,0
62332,4,3,218191,218191,218194,0,3,0
62333,4,2,218195,218195,218197,0,2,1
62334,4,3,218199,218199,218202,0,3,2
62335,3,3,218202,218202,218205,0,3,0
62336,5,2,218207,218207,218209,0,2,2
62337,2,3,218209,218209,218212,0,3,0
62338,5,3,218214,218214,218217,0,3,2
62339,3,1,218217,218217,218218,0,1,0
62340,5,1,218222,218222,218223,0,1,4
62341,4,2,218226,218226,218228,0,2,3
62342,5,3,218231,218231,218234,0,3,3
62343,3,3,218234,218234,218237,0,3,0
62344,1,1,218235,218237,218238,2,3,0
62345,1,3,218236,218238,218241,2,5,0
62346,4,3,218240,218241,218244,1,4,0
62347,3,3,218243,218244,218247,1,4,0
62348,3,1,218246,218247,218248,1,2,0
62349,4,3,218250,218250,218253,0,3,2
62350,3,1,218253,218253,218254,0,1,0
62351,2,2,218255,218255,218257,0,2,1
62352,4,1,218259,218259,218260,0,1,2
62353,4,2,218263,218263,218265,0,2,3
62354,1,1,218264,218265,218266,1,2,0
62355,1,2,218265,218266,218268,1,3,0
62356,2,1,218267,218268,218269,1,2,0
62357,3,3,218270,218270,218273,0,3,1
62358,1,2,218271,218273,218275,2,4,0
62359,2,2,218273,218275,218277,2,4,0
62360,5,3,218278,218278,218281,0,3,1
62361,2,2,218280,218281,218283,1,3,0
62362,5,3,218285,218285,218288,0,3,2
62363,2,1,218287,218288,218289,1,2,0
62364,6,2,218293,218293,218295,0,2,4
62365,1,2,218294,218295,218297,1,3,0
62366,1,1,218295,218297,218298,2,3,0
62367,1,3,218296,218298,218301,2,5,0
62368,6,3,218302,218302,218305,0,3,1
62369,6,1,218308,218308,218309,0,1,3
62370,6,1,218314,218314,218315,0,1,5
62371,4,3,218318,218318,218321,0,3,3
62372,2,1,218320,218321,218322,1,2,0
62373,3,2,218323,218323,218325,0,2,1
62374,1,2,218324,218325,218327,1,3,0
62375,5,1,218329,218329,218330,0,1,2
62376,4,2,218333,218333,218335,0,2,3
62377,1,1,218334,218335,218336,1,2,0
62378,6,2,218340,218340,218342,0,2,4
62379,5,3,218345,218345,218348,0,3,3
62380,1,3,218346,218348,218351,2,5,0
62381,1,3,218347,218351,218354,4,7,0
62382,2,1,218349,218354,218355,5,6,0
62383,4,3,218353,218355,218358,2,5,0
62384,1,3,218354,218358,218361,4,7,0
62385,4,2,218358,218361,218363,3,5,0
62386,5,2,218363,218363,218365,0,2,0
62387,4,2,218367,218367,218369,0,2,2
62388,6,1,218373,218373,218374,0,1,4
62389,3,2,218376,218376,218378,0,2,2
62390,2,3,218378,218378,218381,0,3,0
62391,2,1,218380,218381,218382,1,2,0
62392,5,1,218385,218385,218386,0,1,3
62393,2,1,218387,218387,218388,0,1,1
62394,4,1,218391,218391,218392,0,1,3
62395,5,2,218396,218396,218398,0,2,4
62396,2,2,218398,218398,218400,0,2,0
62397,4,3,218402,218402,218405,0,3,2
62398,1,1,218403,218405,218406,2,3,0
62399,5,2,218408,218408,218410,0,2,2
62400,5,3,218413,218413,218416,0,3,3
62401,3,1,218416,218416,218417,0,1,0
62402,1,3,218417,218417,218420,0,3,0
62403,3,1,218420,218420,218421,0,1,0
62404,5,3,218425,218425,218428,0,3,4
62405,3,3,218428,218428,218431,0,3,0
62406,5,3,218433,218433,218436,0,3,2
62407,5,3,218438,218438,218441,0,3,2
62408,2,3,218440,218441,218444,1,4,0
62409,4,2,218444,218444,218446,0,2,0
62410,1,1,218445,218446,218447,1,2,0
62411,3,2,218448,218448,218450,0,2,1
62412,5,3,218453,218453,218456,0,3,3
62413,4,1,218457,218457,218458,0,1,1
62414,1,3,218458,218458,218461,0,3,0
62415,1,3,218459,218461,218464,2,5,0
62416,6,1,218465,218465,218466,0,1,1
62417,4,2,218469,218469,218471,0,2,3
62418,6,2,218475,218475,218477,0,2,4
62419,4,1,218479,218479,218480,0,1,2
62420,1,1,218480,218480,218481,0,1,0
62421,6,3,218486,218486,218489,0,3,5
62422,3,2,218489,218489,218491,0,2,0
62423,4,3,218493,218493,218496,0,3,2
62424,5,3,218498,218498,218501,0,3,2
62425,4,3,218502,218502,218505,0,3,1
62426,2,2,218504,218505,218507,1,3,0
62427,4,2,218508,218508,218510,0,2,1
62428,2,2,218510,218510,218512,0,2,0
62429,6,2,218516,218516,218518,0,2,4
62430,4,1,218520,218520,218521,0,1,2
62431,4,2,218524,218524,218526,0,2,3
62432,6,3,218530,218530,218533,0,3,4
62433,6,3,218536,218536,218539,0,3,3
62434,4,3,218540,218540,218543,0,3,1
62435,6,1,218546,218546,218547,0,1,3
62436,6,3,218552,218552,218555,0,3,5
62437,6,2,218558,218558,218560,0,2,3
62438,3,3,218561,218561,218564,0,3,1
62439,1,2,218562,218564,218566,2,4,0
62440,6,1,218568,218568,218569,0,1,2
62441,1,1,218569,218569,218570,0,1,0
62442,3,1,218572,218572,218573,0,1,2
62443,6,1,218578,218578,218579,0,1,5
62444,4,3,218582,218582,218585,0,3,3
62445,2,2,218584,218585,218587,1,3,0
62446,2,3,218586,218587,218590,1,4,0
62447,1,3,218587,218590,218593,3,6,0
62448,1,3,218588,218593,218596,5,8,0
62449,3,1,218591,218596,218597,5,6,0
62450,4,1,218595,218597,218598,2,3,0
62451,5,2,218600,218600,218602,0,2,2
62452,3,3,218603,218603,218606,0,3,1
62453,4,1,218607,218607,218608,0,1,1
62454,3,1,218610,218610,218611,0,1,2
62455,5,2,218615,218615,218617,0,2,4
62456,5,3,218620,218620,218623,0,3,3
62457,6,1,218626,218626,218627,0,1,3
62458,5,3,218631,218631,218634,0,3,4
62459,4,1,218635,218635,218636,0,1,1
62460,1,2,218636,218636,218638,0,2,0
62461,4,1,218640,218640,218641,0,1,2
62462,1,2,218641,218641,218643,0,2,0
62463,5,3,218646,218646,218649,0,3,3
62464,5,3,218651,218651,218654,0,3,2
62465,4,2,218655,218655,218657,0,2,1
62466,4,1,218659,218659,218660,0,1,2
62467,4,2,218663,218663,218665,0,2,3
62468,2,3,218665,218665,218668,0,3,0
62469,2,3,218667,218668,218671,1,4,0
62470,1,3,218668,218671,218674,3,6,0
62471,2,1,218670,218674,218675,4,5,0
62472,5,3,218675,218675,218678,0,3,0
62473,5,2,218680,218680,218682,0,2,2
62474,4,3,218684,218684,218687,0,3,2
62475,4,2,218688,218688,218690,0,2,1
62476,1,2,218689,218690,218692,1,3,0
62477,5,1,218694,218694,218695,0,1,2
62478,4,2,218698,218698,218700,0,2,3
62479,2,1,218700,218700,218701,0,1,0
62480,6,2,218706,218706,218708,0,2,5
62481,6,3,218712,218712,218715,0,3,4
62482,3,2,218715,218715,218717,0,2,0
62483,1,1,218716,218717,218718,1,2,0
62484,2,2,218718,218718,218720,0,2,0
62485,5,1,218723,218723,218724,0,1,3
62486,4,1,218727,218727,218728,0,1,3
62487,4,2,218731,218731,218733,0,2,3
62488,6,3,218737,218737,218740,0,3,4
62489,1,1,218738,218740,218741,2,3,0
62490,2,1,218740,218741,218742,1,2,0
62491,1,3,218741,218742,218745,1,4,0
62492,1,2,218742,218745,218747,3,5,0
62493,1,1,218743,218747,218748,4,5,0
62494,4,1,218747,218748,218749,1,2,0
62495,1,3,218748,218749,218752,1,4,0
62496,6,2,218754,218754,218756,0,2,2
62497,5,3,218759,218759,218762,0,3,3
62498,3,2,218762,218762,218764,0,2,0
62499,1,3,218763,218764,218767,1,4,0
62500,1,3,218764,218767,218770,3,6,0
62501,1,1,218765,218770,218771,5,6,0
62502,5,2,218770,218771,218773,1,3,0
62503,3,2,218773,218773,218775,0,2,0
62504,5,3,218778,218778,218781,0,3,3
62505,4,3,218782,218782,218785,0,3,1
62506,6,1,218788,218788,218789,0,1,3
62507,6,2,218794,218794,218796,0,2,5
62508,1,1,218795,218796,218797,1,2,0
62509,1,1,218796,218797,218798,1,2,0
62510,4,2,218800,218800,218802,0,2,2
62511,2,2,218802,218802,218804,0,2,0
62512,4,2,218806,218806,218808,0,2,2
62513,3,3,218809,218809,218812,0,3,1
62514,5,1,218814,218814,218815,0,1,2
62515,3,1,218817,218817,218818,0,1,2
62516,1,1,218818,218818,218819,0,1,0
62517,4,2,218822,218822,218824,0,2,3
62518,5,1,218827,218827,218828,0,1,3
62519,4,3,218831,218831,218834,0,3,3
62520,5,3,218836,218836,218839,0,3,2
62521,6,2,218842,218842,218844,0,2,3
62522,1,2,218843,218844,218846,1,3,0
62523,3,3,218846,218846,218849,0,3,0
62524,2,3,218848,218849,218852,1,4,0
62525,1,1,218849,218852,218853,3,4,0
62526,1,3,218850,218853,218856,3,6,0
62527,6,1,218856,218856,218857,0,1,0
62528,3,3,218859,218859,218862,0,3,2
62529,5,3,218864,218864,218867,0,3,2
62530,1,3,218865,218867,218870,2,5,0
62531,2,3,218867,218870,218873,3,6,0
62532,4,1,218871,218873,218874,2,3,0
62533,6,3,218877,218877,218880,0,3,3
62534,1,1,218878,218880,218881,2,3,0
62535,4,3,218882,218882,218885,0,3,1
62536,6,1,218888,218888,218889,0,1,3
62537,3,1,218891,218891,218892,0,1,2
62538,3,1,218894,218894,218895,0,1,2
62539,4,2,218898,218898,218900,0,2,3
62540,1,3,218899,218900,218903,1,4,0
62541,3,2,218902,218903,218905,1,3,0
62542,5,1,218907,218907,218908,0,1,2
62543,6,1,218913,218913,218914,0,1,5
62544,1,2,218914,218914,218916,0,2,0
62545,4,3,218918,218918,218921,0,3,2
62546,4,3,218922,218922,218925,0,3,1
62547,5,1,218927,218927,218928,0,1,2
62548,2,2,218929,218929,218931,0,2,1
62549,1,3,218930,218931,218934,1,4,0
62550,2,2,218932,218934,218936,2,4,0
62551,2,3,218934,218936,218939,2,5,0
62552,3,2,218937,218939,218941,2,4,0
62553,4,1,218941,218941,218942,0,1,0
62554,5,2,218946,218946,218948,0,2,4
62555,4,3,218950,218950,218953,0,3,2
62556,5,3,218955,218955,218958,0,3,2
62557,4,3,218959,218959,218962,0,3,1
62558,5,2,218964,218964,218966,0,2,2
62559,3,1,218967,218967,218968,0,1,1
62560,5,3,218972,218972,218975,0,3,4
62561,2,2,218974,218975,218977,1,3,0
62562,4,2,218978,218978,218980,0,2,1
62563,3,1,218981,218981,218982,0,1,1
62564,2,1,218983,218983,218984,0,1,1
62565,3,3,218986,218986,218989,0,3,2
62566,3,1,218989,218989,218990,0,1,0
62567,1,3,218990,218990,218993,0,3,0
62568,4,1,218994,218994,218995,0,1,1
62569,6,1,219000,219000,219001,0,1,5
62570,3,2,219003,219003,219005,0,2,2
62571,1,2,219004,219005,219007,1,3,0
62572,5,1,219009,219009,219010,0,1,2
62573,3,1,219012,219012,219013,0,1,2
62574,3,1,219015,219015,219016,0,1,2
62575,3,2,219018,219018,219020,0,2,2
62576,5,2,219023,219023,219025,0,2,3
62577,1,2,219024,219025,219027,1,3,0
62578,1,1,219025,219027,219028,2,3,0
62579,3,1,219028,219028,219029,0,1,0
62580,1,3,219029,219029,219032,0,3,0
62581,1,2,219030,219032,219034,2,4,0
62582,1,2,219031,219034,219036,3,5,0
62583,4,1,219035,219036,219037,1,2,0
62584,2,3,219037,219037,219040,0,3,0
62585,1,3,219038,219040,219043,2,5,0
62586,5,3,219043,219043,219046,0,3,0
62587,6,2,219049,219049,219051,0,2,3
62588,4,1,219053,219053,219054,0,1,2
62589,2,3,219055,219055,219058,0,3,1
62590,1,1,219056,219058,219059,2,3,0
62591,2,2,219058,219059,219061,1,3,0
62592,3,2,219061,219061,219063,0,2,0
62593,4,1,219065,219065,219066,0,1,2
62594,5,1,219070,219070,219071,0,1,4
62595,6,2,219076,219076,219078,0,2,5
62596,5,1,219081,219081,219082,0,1,3
62597,3,3,219084,219084,219087,0,3,2
62598,3,3,219087,219087,219090,0,3,0
62599,3,1,219090,219090,219091,0,1,0
62600,1,2,219091,219091,219093,0,2,0
62601,5,2,219096,219096,219098,0,2,3
62602,1,3,219097,219098,219101,1,4,0
62603,1,2,219098,219101,219103,3,5,0
62604,6,2,219104,219104,219106,0,2,1
62605,1,1,219105,219106,219107,1,2,0
62606,5,1,219110,219110,219111,0,1,3
62607,4,2,219114,219114,219116,0,2,3
62608,5,1,219119,219119,219120,0,1,3
62609,3,2,219122,219122,219124,0,2,2
62610,6,1,219128,219128,219129,0,1,4
62611,2,1,219130,219130,219131,0,1,1
62612,5,3,219135,219135,219138,0,3,4
62613,4,3,219139,219139,219142,0,3,1
62614,1,1,219140,219142,219143,2,3,0
62615,1,1,219141,219143,219144,2,3,0
62616,1,3,219142,219144,219147,2,5,0
62617,3,2,219145,219147,219149,2,4,0
62618,5,2,219150,219150,219152,0,2,1
62619,2,2,219152,219152,219154,0,2,0
62620,3,2,219155,219155,219157,0,2,1
62621,6,1,219161,219161,219162,0,1,4
62622,5,3,219166,219166,219169,0,3,4
62623,6,1,219172,219172,219173,0,1,3
62624,2,2,219174,219174,219176,0,2,1
62625,4,3,219178,219178,219181,0,3,2
62626,4,2,219182,219182,219184,0,2,1
62627,6,3,219188,219188,219191,0,3,4
62628,1,3,219189,219191,219194,2,5,0
62629,6,3,219195,219195,219198,0,3,1
62630,3,2,219198,219198,219200,0,2,0
62631,5,2,219203,219203,219205,0,2,3
62632,5,3,219208,219208,219211,0,3,3
62633,1,2,219209,219211,219213,2,4,0
62634,4,1,219213,219213,219214,0,1,0
62635,4,2,219217,219217,219219,0,2,3
62636,5,3,219222,219222,219225,0,3,3
62637,6,2,219228,219228,219230,0,2,3
62638,2,3,219230,219230,219233,0,3,0
62639,6,3,219236,219236,219239,0,3,3
62640,1,2,219237,219239,219241,2,4,0
62641,5,3,219242,219242,219245,0,3,1
62642,4,1,219246,219246,219247,0,1,1
62643,1,3,219247,219247,219250,0,3,0
62644,2,1,219249,219250,219251,1,2,0
62645,6,3,219255,219255,219258,0,3,4
62646,4,1,219259,219259,219260,0,1,1
62647,1,2,219260,219260,219262,0,2,0
62648,3,2,219263,219263,219265,0,2,1
62649,2,2,219265,219265,219267,0,2,0
62650,6,2,219271,219271,219273,0,2,4
62651,2,2,219273,219273,219275,0,2,0
62652,2,2,219275,219275,219277,0,2,0
62653,4,2,219279,219279,219281,0,2,2
62654,2,1,219281,219281,219282,0,1,0
62655,2,3,219283,219283,219286,0,3,1
62656,2,3,219285,219286,219289,1,4,0
62657,6,3,219291,219291,219294,0,3,2
62658,2,1,219293,219294,219295,1,2,0
62659,4,3,219297,219297,219300,0,3,2
62660,5,3,219302,219302,219305,0,3,2
62661,2,1,219304,219305,219306,1,2,0
62662,5,1,219309,219309,219310,0,1,3
62663,4,2,219313,219313,219315,0,2,3
62664,3,1,219316,219316,219317,0,1,1
62665,4,1,219320,219320,219321,0,1,3
62666,3,2,219323,219323,219325,0,2,2
62667,1,1,219324,219325,219326,1,2,0
62668,5,2,219329,219329,219331,0,2,3
62669,5,1,219334,219334,219335,0,1,3
62670,2,1,219336,219336,219337,0,1,1
62671,5,2,219341,219341,219343,0,2,4
62672,6,1,219347,219347,219348,0,1,4
62673,6,1,219353,219353,219354,0,1,5
62674,3,2,219356,219356,219358,0,2,2
62675,6,3,219362,219362,219365,0,3,4
62676,6,3,219368,219368,219371,0,3,3
62677,3,2,219371,219371,219373,0,2,0
62678,3,3,219374,219374,219377,0,3,1
62679,5,1,219379,219379,219380,0,1,2
62680,6,3,219385,219385,219388,0,3,5
62681,1,1,219386,219388,219389,2,3,0
62682,5,1,219391,219391,219392,0,1,2
62683,2,1,219393,219393,219394,0,1,1
62684,2,3,219395,219395,219398,0,3,1
62685,5,3,219400,219400,219403,0,3,2
62686,5,2,219405,219405,219407,0,2,2
62687,1,2,219406,219407,219409,1,3,0
62688,4,1,219410,219410,219411,0,1,1
62689,5,1,219415,219415,219416,0,1,4
62690,2,2,219417,219417,219419,0,2,1
62691,1,2,219418,219419,219421,1,3,0
62692,4,2,219422,219422,219424,0,2,1
62693,3,3,219425,219425,219428,0,3,1
62694,6,1,219431,219431,219432,0,1,3
62695,1,1,219432,219432,219433,0,1,0
62696,4,3,219436,219436,219439,0,3,3
62697,5,3,219441,219441,219444,0,3,2
62698,5,1,219446,219446,219447,0,1,2
62699,4,3,219450,219450,219453,0,3,3
62700,3,2,219453,219453,219455,0,2,0
62701,3,3,219456,219456,219459,0,3,1
62702,4,3,219460,219460,219463,0,3,1
62703,5,2,219465,219465,219467,0,2,2
62704,5,1,219470,219470,219471,0,1,3
62705,4,2,219474,219474,219476,0,2,3
62706,1,1,219475,219476,219477,1,2,0
62707,6,2,219481,219481,219483,0,2,4
62708,5,2,219486,219486,219488,0,2,3
62709,6,2,219492,219492,219494,0,2,4
62710,5,2,219497,219497,219499,0,2,3
62711,3,3,219500,219500,219503,0,3,1
62712,5,2,219505,219505,219507,0,2,2
62713,3,2,219508,219508,219510,0,2,1
62714,6,2,219514,219514,219516,0,2,4
62715,3,2,219517,219517,219519,0,2,1
62716,3,3,219520,219520,219523,0,3,1
62717,4,2,219524,219524,219526,0,2,1
62718,5,2,219529,219529,219531,0,2,3
62719,2,2,219531,219531,219533,0,2,0
62720,4,2,219535,219535,219537,0,2,2
62721,5,3,219540,219540,219543,0,3,3
62722,1,3,219541,219543,219546,2,5,0
62723,3,1,219544,219546,219547,2,3,0
62724,4,3,219548,219548,219551,0,3,1
62725,5,3,219553,219553,219556,0,3,2
62726,4,2,219557,219557,219559,0,2,1
62727,3,3,219560,219560,219563,0,3,1
62728,2,1,219562,219563,219564,1,2,0
62729,4,3,219566,219566,219569,0,3,2
62730,1,2,219567,219569,219571,2,4,0
62731,4,3,219571,219571,219574,0,3,0
62732,1,3,219572,219574,219577,2,5,0
62733,2,2,219574,219577,219579,3,5,0
62734,2,1,219576,219579,219580,3,4,0
62735,5,2,219581,219581,219583,0,2,1
62736,6,3,219587,219587,219590,0,3,4
62737,3,1,219590,219590,219591,0,1,0
62738,1,1,219591,219591,219592,0,1,0
62739,4,3,219595,219595,219598,0,3,3
62740,1,1,219596,219598,219599,2,3,0
62741,1,2,219597,219599,219601,2,4,0
62742,6,2,219603,219603,219605,0,2,2
62743,6,1,219609,219609,219610,0,1,4
62744,6,3,219615,219615,219618,0,3,5
62745,6,2,219621,219621,219623,0,2,3
62746,1,1,219622,219623,219624,1,2,0
62747,4,3,219626,219626,219629,0,3,2
62748,2,2,219628,219629,219631,1,3,0
62749,3,1,219631,219631,219632,0,1,0
62750,6,3,219637,219637,219640,0,3,5
62751,3,3,219640,219640,219643,0,3,0
62752,5,2,219645,219645,219647,0,2,2
62753,3,3,219648,219648,219651,0,3,1
62754,6,3,219654,219654,219657,0,3,3
62755,5,1,219659,219659,219660,0,1,2
62756,1,2,219660,219660,219662,0,2,0
62757,4,1,219664,219664,219665,0,1,2
62758,2,1,219666,219666,219667,0,1,1
62759,1,1,219667,219667,219668,0,1,0
62760,1,3,219668,219668,219671,0,3,0
62761,1,3,219669,219671,219674,2,5,0
62762,3,3,219672,219674,219677,2,5,0
62763,5,3,219677,219677,219680,0,3,0
62764,4,1,219681,219681,219682,0,1,1
62765,2,1,219683,219683,219684,0,1,1
62766,6,2,219689,219689,219691,0,2,5
62767,3,1,219692,219692,219693,0,1,1
62768,5,3,219697,219697,219700,0,3,4
62769,5,3,219702,219702,219705,0,3,2
62770,3,1,219705,219705,219706,0,1,0
62771,1,1,219706,219706,219707,0,1,0
62772,5,2,219711,219711,219713,0,2,4
62773,2,1,219713,219713,219714,0,1,0
62774,2,3,219715,219715,219718,0,3,1
62775,5,3,219720,219720,219723,0,3,2
62776,2,2,219722,219723,219725,1,3,0
62777,1,3,219723,219725,219728,2,5,0
62778,5,2,219728,219728,219730,0,2,0
62779,5,3,219733,219733,219736,0,3,3
62780,2,1,219735,219736,219737,1,2,0
62781,2,2,219737,219737,219739,0,2,0
62782,6,2,219743,219743,219745,0,2,4
62783,1,3,219744,219745,219748,1,4,0
62784,1,1,219745,219748,219749,3,4,0
62785,4,3,219749,219749,219752,0,3,0
62786,4,2,219753,219753,219755,0,2,1
62787,1,2,219754,219755,219757,1,3,0
62788,3,3,219757,219757,219760,0,3,0
62789,4,2,219761,219761,219763,0,2,1
62790,1,2,219762,219763,219765,1,3,0
62791,3,2,219765,219765,219767,0,2,0
62792,1,1,219766,219767,219768,1,2,0
62793,1,1,219767,219768,219769,1,2,0
62794,4,2,219771,219771,219773,0,2,2
62795,2,3,219773,219773,219776,0,3,0
62796,5,1,219778,219778,219779,0,1,2
62797,1,1,219779,219779,219780,0,1,0
62798,5,3,219784,219784,219787,0,3,4
62799,6,2,219790,219790,219792,0,2,3
62800,3,1,219793,219793,219794,0,1,1
62801,5,1,219798,219798,219799,0,1,4
62802,1,3,219799,219799,219802,0,3,0
62803,2,2,219801,219802,219804,1,3,0
62804,1,3,219802,219804,219807,2,5,0
62805,1,2,219803,219807,219809,4,6,0
62806,5,2,219808,219809,219811,1,3,0
62807,3,2,219811,219811,219813,0,2,0
62808,3,3,219814,219814,219817,0,3,1
62809,4,1,219818,219818,219819,0,1,1
62810,5,2,219823,219823,219825,0,2,4
62811,3,1,219826,219826,219827,0,1,1
62812,6,2,219832,219832,219834,0,2,5
62813,2,2,219834,219834,219836,0,2,0
62814,6,3,219840,219840,219843,0,3,4
62815,4,1,219844,219844,219845,0,1,1
62816,3,3,219847,219847,219850,0,3,2
62817,1,3,219848,219850,219853,2,5,0
62818,4,3,219852,219853,219856,1,4,0
62819,2,2,219854,219856,219858,2,4,0
62820,4,3,219858,219858,219861,0,3,0
62821,3,1,219861,219861,219862,0,1,0
62822,3,3,219864,219864,219867,0,3,2
62823,3,1,219867,219867,219868,0,1,0
62824,4,2,219871,219871,219873,0,2,3
62825,4,3,219875,219875,219878,0,3,2
62826,3,1,219878,219878,219879,0,1,0
62827,4,1,219882,219882,219883,0,1,3
62828,5,2,219887,219887,219889,0,2,4
62829,4,1,219891,219891,219892,0,1,2
62830,4,3,219895,219895,219898,0,3,3
62831,6,3,219901,219901,219904,0,3,3
62832,5,3,219906,219906,219909,0,3,2
62833,5,1,219911,219911,219912,0,1,2
62834,6,2,219917,219917,219919,0,2,5
62835,1,3,219918,219919,219922,1,4,0
62836,1,1,219919,219922,219923,3,4,0
62837,3,1,219922,219923,219924,1,2,0
62838,2,1,219924,219924,219925,0,1,0
62839,6,1,219930,219930,219931,0,1,5
62840,3,3,219933,219933,219936,0,3,2
62841,4,2,219937,219937,219939,0,2,1
62842,6,3,219943,219943,219946,0,3,4
62843,5,1,219948,219948,219949,0,1,2
62844,4,3,219952,219952,219955,0,3,3
62845,4,3,219956,219956,219959,0,3,1
62846,5,1,219961,219961,219962,0,1,2
62847,3,1,219964,219964,219965,0,1,2
62848,3,3,219967,219967,219970,0,3,2
62849,3,1,219970,219970,219971,0,1,0
62850,5,1,219975,219975,219976,0,1,4
62851,6,1,219981,219981,219982,0,1,5
62852,3,3,219984,219984,219987,0,3,2
62853,2,3,219986,219987,219990,1,4,0
62854,3,1,219989,219990,219991,1,2,0
62855,4,3,219993,219993,219996,0,3,2
62856,1,3,219994,219996,219999,2,5,0
62857,5,1,219999,219999,220000,0,1,0
62858,1,1,220000,220000,220001,0,1,0
62859,4,1,220004,220004,220005,0,1,3
62860,3,2,220007,220007,220009,0,2,2
62861,6,1,220013,220013,220014,0,1,4
62862,5,2,220018,220018,220020,0,2,4
62863,4,1,220022,220022,220023,0,1,2
62864,2,1,220024,220024,220025,0,1,1
62865,6,2,220030,220030,220032,0,2,5
62866,3,1,220033,220033,220034,0,1,1
62867,5,3,220038,220038,220041,0,3,4
62868,5,1,220043,220043,220044,0,1,2
62869,2,1,220045,220045,220046,0,1,1
62870,2,1,220047,220047,220048,0,1,1
62871,5,3,220052,220052,220055,0,3,4
62872,1,2,220053,220055,220057,2,4,0
62873,6,2,220059,220059,220061,0,2,2
62874,5,1,220064,220064,220065,0,1,3
62875,4,1,220068,220068,220069,0,1,3
62876,5,1,220073,220073,220074,0,1,4
62877,6,3,220079,220079,220082,0,3,5
62878,6,3,220085,220085,220088,0,3,3
62879,6,3,220091,220091,220094,0,3,3
62880,1,3,220092,220094,220097,2,5,0
62881,1,3,220093,220097,220100,4,7,0
62882,1,2,220094,220100,220102,6,8,0
62883,5,2,220099,220102,220104,3,5,0
62884,1,3,220100,220104,220107,4,7,0
62885,3,3,220103,220107,220110,4,7,0
62886,4,2,220107,220110,220112,3,5,0
62887,4,2,220111,220112,220114,1,3,0
62888,4,1,220115,220115,220116,0,1,1
62889,5,3,220120,220120,220123,0,3,4
62890,1,3,220121,220123,220126,2,5,0
62891,5,2,220126,220126,220128,0,2,0
62892,1,1,220127,220128,220129,1,2,0
62893,2,1,220129,220129,220130,0,1,0
62894,6,1,220135,220135,220136,0,1,5
62895,1,1,220136,220136,220137,0,1,0
62896,2,2,220138,220138,220140,0,2,1
62897,4,2,220142,220142,220144,0,2,2
62898,1,1,220143,220144,220145,1,2,0
62899,3,2,220146,220146,220148,0,2,1
62900,2,3,220148,220148,220151,0,3,0
62901,1,3,220149,220151,220154,2,5,0
62902,3,3,220152,220154,220157,2,5,0
62903,3,1,220155,220157,220158,2,3,0
62904,1,2,220156,220158,220160,2,4,0
62905,6,3,220162,220162,220165,0,3,2
62906,5,1,220167,220167,220168,0,1,2
62907,2,2,220169,220169,220171,0,2,1
62908,5,3,220174,220174,220177,0,3,3
62909,6,1,220180,220180,220181,0,1,3
62910,2,1,220182,220182,220183,0,1,1
62911,3,1,220185,220185,220186,0,1,2
62912,2,3,220187,220187,220190,0,3,1
62913,3,2,220190,220190,220192,0,2,0
62914,4,1,220194,220194,220195,0,1,2
62915,3,1,220197,220197,220198,0,1,2
62916,1,1,220198,220198,220199,0,1,0
62917,4,3,220202,220202,220205,0,3,3
62918,6,3,220208,220208,220211,0,3,3
62919,6,3,220214,220214,220217,0,3,3
62920,6,2,220220,220220,220222,0,2,3
62921,3,1,220223,220223,220224,0,1,1
62922,1,3,220224,220224,220227,0,3,0
62923,2,1,220226,220227,220228,1,2,0
62924,6,3,220232,220232,220235,0,3,4
62925,1,1,220233,220235,220236,2,3,0
62926,2,2,220235,220236,220238,1,3,0
62927,3,3,220238,220238,220241,0,3,0
62928,4,2,220242,220242,220244,0,2,1
62929,2,3,220244,220244,220247,0,3,0
62930,5,1,220249,220249,220250,0,1,2
62931,5,1,220254,220254,220255,0,1,4
62932,5,1,220259,220259,220260,0,1,4
62933,6,1,220265,220265,220266,0,1,5
62934,4,3,220269,220269,220272,0,3,3
62935,1,3,220270,220272,220275,2,5,0
62936,2,3,220272,220275,220278,3,6,0
62937,6,3,220278,220278,220281,0,3,0
62938,1,1,220279,220281,220282,2,3,0
62939,1,3,220280,220282,220285,2,5,0
62940,6,2,220286,220286,220288,0,2,1
62941,6,1,220292,220292,220293,0,1,4
62942,6,3,220298,220298,220301,0,3,5
62943,6,1,220304,220304,220305,0,1,3
62944,3,3,220307,220307,220310,0,3,2
62945,2,3,220309,220310,220313,1,4,0
62946,1,3,220310,220313,220316,3,6,0
62947,2,1,220312,220316,220317,4,5,0
62948,2,1,220314,220317,220318,3,4,0
62949,1,1,220315,220318,220319,3,4,0
62950,3,2,220318,220319,220321,1,3,0
62951,1,3,220319,220321,220324,2,5,0
62952,4,1,220323,220324,220325,1,2,0
62953,2,2,220325,220325,220327,0,2,0
62954,1,2,220326,220327,220329,1,3,0
62955,4,3,220330,220330,220333,0,3,1
62956,5,1,220335,220335,220336,0,1,2
62957,1,3,220336,220336,220339,0,3,0
62958,1,2,220337,220339,220341,2,4,0
62959,2,3,220339,220341,220344,2,5,0
62960,5,1,220344,220344,220345,0,1,0
62961,2,1,220346,220346,220347,0,1,1
62962,4,1,220350,220350,220351,0,1,3
62963,2,3,220352,220352,220355,0,3,1
62964,2,2,220354,220355,220357,1,3,0
62965,1,3,220355,220357,220360,2,5,0
62966,1,3,220356,220360,220363,4,7,0
62967,3,1,220359,220363,220364,4,5,0
62968,2,3,220361,220364,220367,3,6,0
62969,4,1,220365,220367,220368,2,3,0
62970,1,3,220366,220368,220371,2,5,0
62971,4,2,220370,220371,220373,1,3,0
62972,3,2,220373,220373,220375,0,2,0
62973,3,1,220376,220376,220377,0,1,1
62974,6,3,220382,220382,220385,0,3,5
62975,1,1,220383,220385,220386,2,3,0
62976,5,3,220388,220388,220391,0,3,2
62977,6,3,220394,220394,220397,0,3,3
62978,3,1,220397,220397,220398,0,1,0
62979,4,1,220401,220401,220402,0,1,3
62980,2,1,220403,220403,220404,0,1,1
62981,4,1,220407,220407,220408,0,1,3
62982,6,2,220413,220413,220415,0,2,5
62983,6,3,220419,220419,220422,0,3,4
62984,6,1,220425,220425,220426,0,1,3
62985,3,2,220428,220428,220430,0,2,2
62986,2,2,220430,220430,220432,0,2,0
62987,3,1,220433,220433,220434,0,1,1
62988,6,3,220439,220439,220442,0,3,5
62989,6,1,220445,220445,220446,0,1,3
62990,6,2,220451,220451,220453,0,2,5
62991,5,3,220456,220456,220459,0,3,3
62992,6,2,220462,220462,220464,0,2,3
62993,5,3,220467,220467,220470,0,3,3
62994,3,1,220470,220470,220471,0,1,0
62995,1,3,220471,220471,220474,0,3,0
62996,6,3,220477,220477,220480,0,3,3
62997,3,3,220480,220480,220483,0,3,0
62998,5,3,220485,220485,220488,0,3,2
62999,5,1,220490,220490,220491,0,1,2
63000,1,1,220491,220491,220492,0,1,0
63001,3,1,220494,220494,220495,0,1,2
63002,4,2,220498,220498,220500,0,2,3
63003,3,3,220501,220501,220504,0,3,1
63004,3,1,220504,220504,220505,0,1,0
63005,2,3,220506,220506,220509,0,3,1
63006,4,2,220510,220510,220512,0,2,1
63007,6,3,220516,220516,220519,0,3,4
63008,3,3,220519,220519,220522,0,3,0
63009,1,1,220520,220522,220523,2,3,0
63010,6,2,220526,220526,220528,0,2,3
63011,3,1,220529,220529,220530,0,1,1
63012,6,2,220535,220535,220537,0,2,5
63013,4,1,220539,220539,220540,0,1,2
63014,3,1,220542,220542,220543,0,1,2
63015,4,3,220546,220546,220549,0,3,3
63016,2,1,220548,220549,220550,1,2,0
63017,1,2,220549,220550,220552,1,3,0
63018,5,2,220554,220554,220556,0,2,2
63019,4,2,220558,220558,220560,0,2,2
63020,2,2,220560,220560,220562,0,2,0
63021,4,3,220564,220564,220567,0,3,2
63022,1,2,220565,220567,220569,2,4,0
63023,2,3,220567,220569,220572,2,5,0
63024,5,1,220572,220572,220573,0,1,0
63025,1,2,220573,220573,220575,0,2,0
63026,3,1,220576,220576,220577,0,1,1
63027,1,2,220577,220577,220579,0,2,0
63028,1,1,220578,220579,220580,1,2,0
63029,5,2,220583,220583,220585,0,2,3
63030,1,1,220584,220585,220586,1,2,0
63031,5,3,220589,220589,220592,0,3,3
63032,5,2,220594,220594,220596,0,2,2
63033,6,2,220600,220600,220602,0,2,4
63034,2,2,220602,220602,220604,0,2,0
63035,1,3,220603,220604,220607,1,4,0
63036,2,3,220605,220607,220610,2,5,0
63037,2,2,220607,220610,220612,3,5,0
63038,5,2,220612,220612,220614,0,2,0
63039,6,2,220618,220618,220620,0,2,4
63040,6,3,220624,220624,220627,0,3,4
63041,5,3,220629,220629,220632,0,3,2
63042,5,3,220634,220634,220637,0,3,2
63043,6,1,220640,220640,220641,0,1,3
63044,6,3,220646,220646,220649,0,3,5
63045,6,1,220652,220652,220653,0,1,3
63046,5,1,220657,220657,220658,0,1,4
63047,2,2,220659,220659,220661,0,2,1
63048,1,1,220660,220661,220662,1,2,0
63049,5,2,220665,220665,220667,0,2,3
63050,3,3,220668,220668,220671,0,3,1
63051,2,1,220670,220671,220672,1,2,0
63052,4,3,220674,220674,220677,0,3,2
63053,1,3,220675,220677,220680,2,5,0
63054,2,2,220677,220680,220682,3,5,0
63055,1,3,220678,220682,220685,4,7,0
63056,2,1,220680,220685,220686,5,6,0
63057,1,3,220681,220686,220689,5,8,0
63058,5,3,220686,220689,220692,3,6,0
63059,6,1,220692,220692,220693,0,1,0
63060,6,2,220698,220698,220700,0,2,5
63061,2,2,220700,220700,220702,0,2,0
63062,4,3,220704,220704,220707,0,3,2
63063,6,2,220710,220710,220712,0,2,3
63064,2,3,220712,220712,220715,0,3,0
63065,1,2,220713,220715,220717,2,4,0
63066,5,1,220718,220718,220719,0,1,1
63067,2,3,220720,220720,220723,0,3,1
63068,4,3,220724,220724,220727,0,3,1
63069,6,2,220730,220730,220732,0,2,3
63070,3,2,220733,220733,220735,0,2,1
63071,5,1,220738,220738,220739,0,1,3
63072,6,3,220744,220744,220747,0,3,5
63073,2,3,220746,220747,220750,1,4,0
63074,3,2,220749,220750,220752,1,3,0
63075,6,1,220755,220755,220756,0,1,3
63076,1,1,220756,220756,220757,0,1,0
63077,3,1,220759,220759,220760,0,1,2
63078,5,3,220764,220764,220767,0,3,4
63079,3,2,220767,220767,220769,0,2,0
63080,5,3,220772,220772,220775,0,3,3
63081,5,3,220777,220777,220780,0,3,2
63082,1,3,220778,220780,220783,2,5,0
63083,1,2,220779,220783,220785,4,6,0
63084,4,3,220783,220785,220788,2,5,0
63085,6,1,220789,220789,220790,0,1,1
63086,2,1,220791,220791,220792,0,1,1
63087,3,2,220794,220794,220796,0,2,2
63088,1,3,220795,220796,220799,1,4,0
63089,3,2,220798,220799,220801,1,3,0
63090,4,3,220802,220802,220805,0,3,1
63091,5,3,220807,220807,220810,0,3,2
63092,3,1,220810,220810,220811,0,1,0
63093,1,1,220811,220811,220812,0,1,0
63094,4,3,220815,220815,220818,0,3,3
63095,1,1,220816,220818,220819,2,3,0
63096,5,2,220821,220821,220823,0,2,2
63097,4,1,220825,220825,220826,0,1,2
63098,1,2,220826,220826,220828,0,2,0
63099,5,2,220831,220831,220833,0,2,3
63100,3,1,220834,220834,220835,0,1,1
63101,5,2,220839,220839,220841,0,2,4
63102,4,1,220843,220843,220844,0,1,2
63103,5,3,220848,220848,220851,0,3,4
63104,3,1,220851,220851,220852,0,1,0
63105,2,2,220853,220853,220855,0,2,1
63106,2,3,220855,220855,220858,0,3,0
63107,6,2,220861,220861,220863,0,2,3
63108,2,3,220863,220863,220866,0,3,0
63109,4,2,220867,220867,220869,0,2,1
63110,3,1,220870,220870,220871,0,1,1
63111,5,2,220875,220875,220877,0,2,4
63112,5,2,220880,220880,220882,0,2,3
63113,6,3,220886,220886,220889,0,3,4
63114,3,3,220889,220889,220892,0,3,0
63115,5,3,220894,220894,220897,0,3,2
63116,2,2,220896,220897,220899,1,3,0
63117,3,2,220899,220899,220901,0,2,0
63118,5,1,220904,220904,220905,0,1,3
63119,4,2,220908,220908,220910,0,2,3
63120,1,3,220909,220910,220913,1,4,0
63121,2,1,220911,220913,220914,2,3,0
63122,1,1,220912,220914,220915,2,3,0
63123,2,1,220914,220915,220916,1,2,0
63124,5,2,220919,220919,220921,0,2,3
63125,3,2,220922,220922,220924,0,2,1
63126,6,2,220928,220928,220930,0,2,4
63127,1,2,220929,220930,220932,1,3,0
63128,2,1,220931,220932,220933,1,2,0
63129,1,3,220932,220933,220936,1,4,0
63130,5,2,220937,220937,220939,0,2,1
63131,5,2,220942,220942,220944,0,2,3
63132,2,2,220944,220944,220946,0,2,0
63133,5,1,220949,220949,220950,0,1,3
63134,1,1,220950,220950,220951,0,1,0
63135,5,2,220955,220955,220957,0,2,4
63136,4,3,220959,220959,220962,0,3,2
63137,1,1,220960,220962,220963,2,3,0
63138,4,2,220964,220964,220966,0,2,1
63139,5,1,220969,220969,220970,0,1,3
63140,3,1,220972,220972,220973,0,1,2
63141,6,3,220978,220978,220981,0,3,5
63142,3,2,220981,220981,220983,0,2,0
63143,2,3,220983,220983,220986,0,3,0
63144,1,3,220984,220986,220989,2,5,0
63145,6,3,220990,220990,220993,0,3,1
63146,2,3,220992,220993,220996,1,4,0
63147,1,2,220993,220996,220998,3,5,0
63148,6,1,220999,220999,221000,0,1,1
63149,6,1,221005,221005,221006,0,1,5
63150,2,1,221007,221007,221008,0,1,1
63151,5,1,221012,221012,221013,0,1,4
63152,5,2,221017,221017,221019,0,2,4
63153,4,3,221021,221021,221024,0,3,2
63154,5,3,221026,221026,221029,0,3,2
63155,1,3,221027,221029,221032,2,5,0
63156,4,3,221031,221032,221035,1,4,0
63157,1,2,221032,221035,221037,3,5,0
63158,3,1,221035,221037,221038,2,3,0
63159,6,1,221041,221041,221042,0,1,3
63160,2,1,221043,221043,221044,0,1,1
63161,4,3,221047,221047,221050,0,3,3
63162,5,2,221052,221052,221054,0,2,2
63163,3,3,221055,221055,221058,0,3,1
63164,5,3,221060,221060,221063,0,3,2
63165,4,1,221064,221064,221065,0,1,1
63166,6,3,221070,221070,221073,0,3,5
63167,6,1,221076,221076,221077,0,1,3
63168,5,2,221081,221081,221083,0,2,4
63169,3,3,221084,221084,221087,0,3,1
63170,6,3,221090,221090,221093,0,3,3
63171,1,2,221091,221093,221095,2,4,0
63172,5,1,221096,221096,221097,0,1,1
63173,6,1,221102,221102,221103,0,1,5
63174,1,3,221103,221103,221106,0,3,0
63175,4,1,221107,221107,221108,0,1,1
63176,3,2,221110,221110,221112,0,2,2
63177,2,1,221112,221112,221113,0,1,0
63178,4,2,221116,221116,221118,0,2,3
63179,5,2,221121,221121,221123,0,2,3
63180,3,2,221124,221124,221126,0,2,1
63181,1,3,221125,221126,221129,1,4,0
63182,3,2,221128,221129,221131,1,3,0
63183,4,1,221132,221132,221133,0,1,1
63184,2,3,221134,221134,221137,0,3,1
63185,4,3,221138,221138,221141,0,3,1
63186,6,1,221144,221144,221145,0,1,3
63187,4,2,221148,221148,221150,0,2,3
63188,4,1,221152,221152,221153,0,1,2
63189,3,3,221155,221155,221158,0,3,2
63190,5,3,221160,221160,221163,0,3,2
63191,3,1,221163,221163,221164,0,1,0
63192,4,2,221167,221167,221169,0,2,3
63193,6,2,221173,221173,221175,0,2,4
63194,6,1,221179,221179,221180,0,1,4
63195,2,2,221181,221181,221183,0,2,1
63196,2,2,221183,221183,221185,0,2,0
63197,4,1,221187,221187,221188,0,1,2
63198,6,3,221193,221193,221196,0,3,5
63199,6,3,221199,221199,221202,0,3,3
63200,5,2,221204,221204,221206,0,2,2
63201,5,3,221209,221209,221212,0,3,3
63202,2,3,221211,221212,221215,1,4,0
63203,4,2,221215,221215,221217,0,2,0
63204,4,3,221219,221219,221222,0,3,2
63205,1,2,221220,221222,221224,2,4,0
63206,5,2,221225,221225,221227,0,2,1
63207,2,3,221227,221227,221230,0,3,0
63208,3,1,221230,221230,221231,0,1,0
63209,3,3,221233,221233,221236,0,3,2
63210,4,2,221237,221237,221239,0,2,1
63211,6,3,221243,221243,221246,0,3,4
63212,6,3,221249,221249,221252,0,3,3
63213,6,2,221255,221255,221257,0,2,3
63214,4,2,221259,221259,221261,0,2,2
63215,5,3,221264,221264,221267,0,3,3
63216,4,3,221268,221268,221271,0,3,1
63217,4,3,221272,221272,221275,0,3,1
63218,1,3,221273,221275,221278,2,5,0
63219,3,1,221276,221278,221279,2,3,0
63220,1,1,221277,221279,221280,2,3,0
63221,1,2,221278,221280,221282,2,4,0
63222,3,3,221281,221282,221285,1,4,0
63223,4,1,221285,221285,221286,0,1,0
63224,6,2,221291,221291,221293,0,2,5
63225,2,3,221293,221293,221296,0,3,0
63226,1,1,221294,221296,221297,2,3,0
63227,5,2,221299,221299,221301,0,2,2
63228,1,3,221300,221301,221304,1,4,0
63229,2,2,221302,221304,221306,2,4,0
63230,6,1,221308,221308,221309,0,1,2
63231,5,3,221313,221313,221316,0,3,4
63232,6,1,221319,221319,221320,0,1,3
63233,5,2,221324,221324,221326,0,2,4
63234,3,1,221327,221327,221328,0,1,1
63235,3,1,221330,221330,221331,0,1,2
63236,1,3,221331,221331,221334,0,3,0
63237,2,2,221333,221334,221336,1,3,0
63238,2,1,221335,221336,221337,1,2,0
63239,2,3,221337,221337,221340,0,3,0
63240,4,3,221341,221341,221344,0,3,1
63241,4,3,221345,221345,221348,0,3,1
63242,3,2,221348,221348,221350,0,2,0
63243,1,1,221349,221350,221351,1,2,0
63244,1,1,221350,221351,221352,1,2,0
63245,3,3,221353,221353,221356,0,3,1
63246,5,3,221358,221358,221361,0,3,2
63247,1,2,221359,221361,221363,2,4,0
63248,5,2,221364,221364,221366,0,2,1
63249,2,3,221366,221366,221369,0,3,0
63250,2,1,221368,221369,221370,1,2,0
63251,3,2,221371,221371,221373,0,2,1
63252,4,1,221375,221375,221376,0,1,2
63253,6,1,221381,221381,221382,0,1,5
63254,2,2,221383,221383,221385,0,2,1
63255,3,3,221386,221386,221389,0,3,1
63256,6,1,221392,221392,221393,0,1,3
63257,4,1,221396,221396,221397,0,1,3
63258,3,1,221399,221399,221400,0,1,2
63259,5,1,221404,221404,221405,0,1,4
63260,3,2,221407,221407,221409,0,2,2
63261,1,2,221408,221409,221411,1,3,0
63262,4,1,221412,221412,221413,0,1,1
63263,6,1,221418,221418,221419,0,1,5
63264,4,2,221422,221422,221424,0,2,3
63265,3,2,221425,221425,221427,0,2,1
63266,1,2,221426,221427,221429,1,3,0
63267,4,1,221430,221430,221431,0,1,1
63268,5,3,221435,221435,221438,0,3,4
63269,3,3,221438,221438,221441,0,3,0
63270,4,2,221442,221442,221444,0,2,1
63271,2,2,221444,221444,221446,0,2,0
63272,6,3,221450,221450,221453,0,3,4
63273,6,2,221456,221456,221458,0,2,3
63274,5,3,221461,221461,221464,0,3,3
63275,1,1,221462,221464,221465,2,3,0
63276,6,3,221468,221468,221471,0,3,3
63277,6,1,221474,221474,221475,0,1,3
63278,3,1,221477,221477,221478,0,1,2
63279,5,1,221482,221482,221483,0,1,4
63280,6,3,221488,221488,221491,0,3,5
63281,3,2,221491,221491,221493,0,2,0
63282,4,2,221495,221495,221497,0,2,2
63283,5,3,221500,221500,221503,0,3,3
63284,5,1,221505,221505,221506,0,1,2
63285,6,3,221511,221511,221514,0,3,5
63286,1,1,221512,221514,221515,2,3,0
63287,6,3,221518,221518,221521,0,3,3
63288,5,1,221523,221523,221524,0,1,2
63289,1,2,221524,221524,221526,0,2,0
63290,5,2,221529,221529,221531,0,2,3
63291,2,3,221531,221531,221534,0,3,0
63292,6,1,221537,221537,221538,0,1,3
63293,1,3,221538,221538,221541,0,3,0
63294,2,2,221540,221541,221543,1,3,0
63295,2,1,221542,221543,221544,1,2,0
63296,6,3,221548,221548,221551,0,3,4
63297,1,1,221549,221551,221552,2,3,0
63298,5,1,221554,221554,221555,0,1,2
63299,2,1,221556,221556,221557,0,1,1
63300,3,1,221559,221559,221560,0,1,2
63301,3,3,221562,221562,221565,0,3,2
63302,6,2,221568,221568,221570,0,2,3
63303,2,3,221570,221570,221573,0,3,0
63304,3,1,221573,221573,221574,0,1,0
63305,6,3,221579,221579,221582,0,3,5
63306,2,2,221581,221582,221584,1,3,0
63307,4,3,221585,221585,221588,0,3,1
63308,3,2,221588,221588,221590,0,2,0
63309,1,2,221589,221590,221592,1,3,0
63310,1,3,221590,221592,221595,2,5,0
63311,5,3,221595,221595,221598,0,3,0
63312,4,2,221599,221599,221601,0,2,1
63313,3,1,221602,221602,221603,0,1,1
63314,1,1,221603,221603,221604,0,1,0
63315,6,3,221609,221609,221612,0,3,5
63316,4,2,221613,221613,221615,0,2,1
63317,5,3,221618,221618,221621,0,3,3
63318,4,2,221622,221622,221624,0,2,1
63319,2,1,221624,221624,221625,0,1,0
63320,4,2,221628,221628,221630,0,2,3
63321,6,3,221634,221634,221637,0,3,4
63322,2,2,221636,221637,221639,1,3,0
63323,2,3,221638,221639,221642,1,4,0
63324,6,2,221644,221644,221646,0,2,2
63325,6,2,221650,221650,221652,0,2,4
63326,2,1,221652,221652,221653,0,1,0
63327,5,1,221657,221657,221658,0,1,4
63328,1,2,221658,221658,221660,0,2,0
63329,4,3,221662,221662,221665,0,3,2
63330,2,2,221664,221665,221667,1,3,0
63331,4,2,221668,221668,221670,0,2,1
63332,3,1,221671,221671,221672,0,1,1
63333,5,3,221676,221676,221679,0,3,4
63334,4,3,221680,221680,221683,0,3,1
63335,5,3,221685,221685,221688,0,3,2
63336,3,1,221688,221688,221689,0,1,0
63337,1,3,221689,221689,221692,0,3,0
63338,2,2,221691,221692,221694,1,3,0
63339,4,1,221695,221695,221696,0,1,1
63340,1,1,221696,221696,221697,0,1,0
63341,2,1,221698,221698,221699,0,1,1
63342,6,1,221704,221704,221705,0,1,5
63343,2,1,221706,221706,221707,0,1,1
63344,1,2,221707,221707,221709,0,2,0
63345,5,3,221712,221712,221715,0,3,3
63346,4,3,221716,221716,221719,0,3,1
63347,6,3,221722,221722,221725,0,3,3
63348,5,1,221727,221727,221728,0,1,2
63349,4,1,221731,221731,221732,0,1,3
63350,6,3,221737,221737,221740,0,3,5
63351,2,2,221739,221740,221742,1,3,0
63352,6,1,221745,221745,221746,0,1,3
63353,5,3,221750,221750,221753,0,3,4
63354,5,2,221755,221755,221757,0,2,2
63355,1,2,221756,221757,221759,1,3,0
63356,6,1,221762,221762,221763,0,1,3
63357,6,1,221768,221768,221769,0,1,5
63358,5,2,221773,221773,221775,0,2,4
63359,5,2,221778,221778,221780,0,2,3
63360,3,2,221781,221781,221783,0,2,1
63361,2,1,221783,221783,221784,0,1,0
63362,5,3,221788,221788,221791,0,3,4
63363,2,2,221790,221791,221793,1,3,0
63364,4,3,221794,221794,221797,0,3,1
63365,5,2,221799,221799,221801,0,2,2
63366,3,3,221802,221802,221805,0,3,1
63367,3,2,221805,221805,221807,0,2,0
63368,2,3,221807,221807,221810,0,3,0
63369,4,1,221811,221811,221812,0,1,1
63370,4,1,221815,221815,221816,0,1,3
63371,5,1,221820,221820,221821,0,1,4
63372,2,3,221822,221822,221825,0,3,1
63373,2,3,221824,221825,221828,1,4,0
63374,1,1,221825,221828,221829,3,4,0
63375,1,1,221826,221829,221830,3,4,0
63376,1,1,221827,221830,221831,3,4,0
63377,3,2,221830,221831,221833,1,3,0
63378,5,1,221835,221835,221836,0,1,2
63379,5,3,221840,221840,221843,0,3,4
63380,5,2,221845,221845,221847,0,2,2
63381,5,1,221850,221850,221851,0,1,3
63382,3,2,221853,221853,221855,0,2,2
63383,4,3,221857,221857,221860,0,3,2
63384,4,1,221861,221861,221862,0,1,1
63385,1,1,221862,221862,221863,0,1,0
63386,4,2,221866,221866,221868,0,2,3
63387,6,2,221872,221872,221874,0,2,4
63388,3,2,221875,221875,221877,0,2,1
63389,1,3,221876,221877,221880,1,4,0
63390,2,3,221878,221880,221883,2,5,0
63391,2,2,221880,221883,221885,3,5,0
63392,6,2,221886,221886,221888,0,2,1
63393,4,2,221890,221890,221892,0,2,2
63394,2,3,221892,221892,221895,0,3,0
63395,5,3,221897,221897,221900,0,3,2
63396,4,2,221901,221901,221903,0,2,1
63397,4,2,221905,221905,221907,0,2,2
63398,6,2,221911,221911,221913,0,2,4
63399,6,2,221917,221917,221919,0,2,4
63400,2,1,221919,221919,221920,0,1,0
63401,2,1,221921,221921,221922,0,1,1
63402,5,2,221926,221926,221928,0,2,4
63403,4,2,221930,221930,221932,0,2,2
63404,3,3,221933,221933,221936,0,3,1
63405,6,1,221939,221939,221940,0,1,3
63406,4,1,221943,221943,221944,0,1,3
63407,6,3,221949,221949,221952,0,3,5
63408,2,2,221951,221952,221954,1,3,0
63409,4,3,221955,221955,221958,0,3,1
63410,6,3,221961,221961,221964,0,3,3
63411,4,1,221965,221965,221966,0,1,1
63412,2,1,221967,221967,221968,0,1,1
63413,2,2,221969,221969,221971,0,2,1
63414,5,2,221974,221974,221976,0,2,3
63415,5,1,221979,221979,221980,0,1,3
63416,3,3,221982,221982,221985,0,3,2
63417,5,1,221987,221987,221988,0,1,2
63418,4,2,221991,221991,221993,0,2,3
63419,1,2,221992,221993,221995,1,3,0
63420,6,3,221998,221998,222001,0,3,3
63421,2,3,222000,222001,222004,1,4,0
63422,6,3,222006,222006,222009,0,3,2
63423,1,2,222007,222009,222011,2,4,0
63424,5,2,222012,222012,222014,0,2,1
63425,2,2,222014,222014,222016,0,2,0
63426,3,1,222017,222017,222018,0,1,1
63427,6,1,222023,222023,222024,0,1,5
63428,2,2,222025,222025,222027,0,2,1
63429,6,2,222031,222031,222033,0,2,4
63430,4,3,222035,222035,222038,0,3,2
63431,1,1,222036,222038,222039,2,3,0
63432,3,2,222039,222039,222041,0,2,0
63433,6,1,222045,222045,222046,0,1,4
63434,4,3,222049,222049,222052,0,3,3
63435,3,1,222052,222052,222053,0,1,0
63436,6,1,222058,222058,222059,0,1,5
63437,3,2,222061,222061,222063,0,2,2
63438,3,1,222064,222064,222065,0,1,1
63439,2,2,222066,222066,222068,0,2,1
63440,4,1,222070,222070,222071,0,1,2
63441,6,2,222076,222076,222078,0,2,5
63442,5,1,222081,222081,222082,0,1,3
63443,4,3,222085,222085,222088,0,3,3
63444,2,3,222087,222088,222091,1,4,0
63445,1,1,222088,222091,222092,3,4,0
63446,5,3,222093,222093,222096,0,3,1
63447,4,1,222097,222097,222098,0,1,1
63448,3,3,222100,222100,222103,0,3,2
63449,5,3,222105,222105,222108,0,3,2
63450,4,2,222109,222109,222111,0,2,1
63451,5,1,222114,222114,222115,0,1,3
63452,3,1,222117,222117,222118,0,1,2
63453,1,3,222118,222118,222121,0,3,0
63454,3,1,222121,222121,222122,0,1,0
63455,1,3,222122,222122,222125,0,3,0
63456,2,3,222124,222125,222128,1,4,0
63457,2,3,222126,222128,222131,2,5,0
63458,2,2,222128,222131,222133,3,5,0
63459,6,3,222134,222134,222137,0,3,1
63460,6,2,222140,222140,222142,0,2,3
63461,2,1,222142,222142,222143,0,1,0
63462,4,3,222146,222146,222149,0,3,3
63463,3,2,222149,222149,222151,0,2,0
63464,5,3,222154,222154,222157,0,3,3
63465,5,1,222159,222159,222160,0,1,2
63466,2,1,222161,222161,222162,0,1,1
63467,4,3,222165,222165,222168,0,3,3
63468,5,2,222170,222170,222172,0,2,2
63469,5,2,222175,222175,222177,0,2,3
63470,4,2,222179,222179,222181,0,2,2
63471,4,1,222183,222183,222184,0,1,2
63472,6,2,222189,222189,222191,0,2,5
63473,6,1,222195,222195,222196,0,1,4
63474,2,3,222197,222197,222200,0,3,1
63475,4,1,222201,222201,222202,0,1,1
63476,2,3,222203,222203,222206,0,3,1
63477,1,3,222204,222206,222209,2,5,0
63478,1,1,222205,222209,222210,4,5,0
63479,3,1,222208,222210,222211,2,3,0
63480,4,2,222212,222212,222214,0,2,1
63481,4,1,222216,222216,222217,0,1,2
63482,1,2,222217,222217,222219,0,2,0
63483,5,1,222222,222222,222223,0,1,3
63484,6,3,222228,222228,222231,0,3,5
63485,3,1,222231,222231,222232,0,1,0
63486,5,3,222236,222236,222239,0,3,4
63487,4,2,222240,222240,222242,0,2,1
63488,2,1,222242,222242,222243,0,1,0
63489,2,1,222244,222244,222245,0,1,1
63490,6,1,222250,222250,222251,0,1,5
63491,2,3,222252,222252,222255,0,3,1
63492,5,1,222257,222257,222258,0,1,2
63493,6,3,222263,222263,222266,0,3,5
63494,3,1,222266,222266,222267,0,1,0
63495,6,1,222272,222272,222273,0,1,5
63496,5,3,222277,222277,222280,0,3,4
63497,3,1,222280,222280,222281,0,1,0
63498,2,2,222282,222282,222284,0,2,1
63499,5,2,222287,222287,222289,0,2,3
63500,2,3,222289,222289,222292,0,3,0
63501,6,1,222295,222295,222296,0,1,3
63502,1,1,222296,222296,222297,0,1,0
63503,5,3,222301,222301,222304,0,3,4
63504,4,1,222305,222305,222306,0,1,1
63505,6,1,222311,222311,222312,0,1,5
63506,6,1,222317,222317,222318,0,1,5
63507,3,2,222320,222320,222322,0,2,2
63508,6,3,222326,222326,222329,0,3,4
63509,4,2,222330,222330,222332,0,2,1
63510,3,3,222333,222333,222336,0,3,1
63511,5,3,222338,222338,222341,0,3,2
63512,5,1,222343,222343,222344,0,1,2
63513,6,2,222349,222349,222351,0,2,5
63514,4,3,222353,222353,222356,0,3,2
63515,2,3,222355,222356,222359,1,4,0
63516,1,2,222356,222359,222361,3,5,0
63517,2,2,222358,222361,222363,3,5,0
63518,3,3,222361,222363,222366,2,5,0
63519,5,1,222366,222366,222367,0,1,0
63520,6,2,222372,222372,222374,0,2,5
63521,3,3,222375,222375,222378,0,3,1
63522,4,2,222379,222379,222381,0,2,1
63523,2,1,222381,222381,222382,0,1,0
63524,1,3,222382,222382,222385,0,3,0
63525,5,2,222387,222387,222389,0,2,2
63526,5,2,222392,222392,222394,0,2,3
63527,2,2,222394,222394,222396,0,2,0
63528,4,2,222398,222398,222400,0,2,2
63529,5,3,222403,222403,222406,0,3,3
63530,3,2,222406,222406,222408,0,2,0
63531,5,1,222411,222411,222412,0,1,3
63532,5,1,222416,222416,222417,0,1,4
63533,1,2,222417,222417,222419,0,2,0
63534,4,3,222421,222421,222424,0,3,2
63535,5,3,222426,222426,222429,0,3,2
63536,2,3,222428,222429,222432,1,4,0
63537,6,2,222434,222434,222436,0,2,2
63538,6,3,222440,222440,222443,0,3,4
63539,4,3,222444,222444,222447,0,3,1
63540,2,1,222446,222447,222448,1,2,0
63541,4,1,222450,222450,222451,0,1,2
63542,5,2,222455,222455,222457,0,2,4
63543,5,3,222460,222460,222463,0,3,3
63544,5,1,222465,222465,222466,0,1,2
63545,4,3,222469,222469,222472,0,3,3
63546,5,1,222474,222474,222475,0,1,2
63547,5,1,222479,222479,222480,0,1,4
63548,3,1,222482,222482,222483,0,1,2
63549,2,1,222484,222484,222485,0,1,1
63550,5,3,222489,222489,222492,0,3,4
63551,1,1,222490,222492,222493,2,3,0
63552,4,3,222494,222494,222497,0,3,1
63553,1,3,222495,222497,222500,2,5,0
63554,2,2,222497,222500,222502,3,5,0
63555,1,2,222498,222502,222504,4,6,0
63556,6,2,222504,222504,222506,0,2,0
63557,6,3,222510,222510,222513,0,3,4
63558,3,3,222513,222513,222516,0,3,0
63559,6,2,222519,222519,222521,0,2,3
63560,1,1,222520,222521,222522,1,2,0
63561,5,2,222525,222525,222527,0,2,3
63562,1,3,222526,222527,222530,1,4,0
63563,6,1,222532,222532,222533,0,1,2
63564,1,2,222533,222533,222535,0,2,0
63565,5,2,222538,222538,222540,0,2,3
63566,4,3,222542,222542,222545,0,3,2
63567,5,3,222547,222547,222550,0,3,2
63568,4,3,222551,222551,222554,0,3,1
63569,2,2,222553,222554,222556,1,3,0
63570,1,2,222554,222556,222558,2,4,0
63571,5,3,222559,222559,222562,0,3,1
63572,1,2,222560,222562,222564,2,4,0
63573,4,2,222564,222564,222566,0,2,0
63574,6,3,222570,222570,222573,0,3,4
63575,6,1,222576,222576,222577,0,1,3
63576,4,3,222580,222580,222583,0,3,3
63577,3,2,222583,222583,222585,0,2,0
63578,3,2,222586,222586,222588,0,2,1
63579,3,1,222589,222589,222590,0,1,1
63580,1,1,222590,222590,222591,0,1,0
63581,2,1,222592,222592,222593,0,1,1
63582,6,3,222598,222598,222601,0,3,5
63583,6,3,222604,222604,222607,0,3,3
63584,6,3,222610,222610,222613,0,3,3
63585,3,1,222613,222613,222614,0,1,0
63586,2,3,222615,222615,222618,0,3,1
63587,3,3,222618,222618,222621,0,3,0
63588,5,1,222623,222623,222624,0,1,2
63589,1,3,222624,222624,222627,0,3,0
63590,1,3,222625,222627,222630,2,5,0
63591,3,2,222628,222630,222632,2,4,0
63592,1,3,222629,222632,222635,3,6,0
63593,3,1,222632,222635,222636,3,4,0
63594,6,3,222638,222638,222641,0,3,2
63595,2,1,222640,222641,222642,1,2,0
63596,3,3,222643,222643,222646,0,3,1
63597,1,3,222644,222646,222649,2,5,0
63598,5,1,222649,222649,222650,0,1,0
63599,5,2,222654,222654,222656,0,2,4
63600,3,1,222657,222657,222658,0,1,1
63601,6,3,222663,222663,222666,0,3,5
63602,4,1,222667,222667,222668,0,1,1
63603,3,1,222670,222670,222671,0,1,2
63604,6,2,222676,222676,222678,0,2,5
63605,5,2,222681,222681,222683,0,2,3
63606,5,1,222686,222686,222687,0,1,3
63607,6,1,222692,222692,222693,0,1,5
63608,6,2,222698,222698,222700,0,2,5
63609,5,1,222703,222703,222704,0,1,3
63610,2,1,222705,222705,222706,0,1,1
63611,5,1,222710,222710,222711,0,1,4
63612,4,2,222714,222714,222716,0,2,3
63613,6,1,222720,222720,222721,0,1,4
63614,1,1,222721,222721,222722,0,1,0
63615,2,1,222723,222723,222724,0,1,1
63616,3,3,222726,222726,222729,0,3,2
63617,1,1,222727,222729,222730,2,3,0
63618,2,2,222729,222730,222732,1,3,0
63619,2,3,222731,222732,222735,1,4,0
63620,1,1,222732,222735,222736,3,4,0
63621,5,2,222737,222737,222739,0,2,1
63622,2,1,222739,222739,222740,0,1,0
63623,6,2,222745,222745,222747,0,2,5
63624,1,2,222746,222747,222749,1,3,0
63625,6,2,222752,222752,222754,0,2,3
63626,4,1,222756,222756,222757,0,1,2
63627,4,3,222760,222760,222763,0,3,3
63628,6,1,222766,222766,222767,0,1,3
63629,2,1,222768,222768,222769,0,1,1
63630,3,3,222771,222771,222774,0,3,2
63631,3,3,222774,222774,222777,0,3,0
63632,5,3,222779,222779,222782,0,3,2
63633,2,3,222781,222782,222785,1,4,0
63634,3,2,222784,222785,222787,1,3,0
63635,2,3,222786,222787,222790,1,4,0
63636,6,2,222792,222792,222794,0,2,2
63637,4,3,222796,222796,222799,0,3,2
63638,3,1,222799,222799,222800,0,1,0
63639,3,2,222802,222802,222804,0,2,2
63640,2,2,222804,222804,222806,0,2,0
63641,3,1,222807,222807,222808,0,1,1
63642,1,1,222808,222808,222809,0,1,0
63643,5,1,222813,222813,222814,0,1,4
63644,6,2,222819,222819,222821,0,2,5
63645,4,1,222823,222823,222824,0,1,2
63646,4,1,222827,222827,222828,0,1,3
63647,2,3,222829,222829,222832,0,3,1
63648,5,1,222834,222834,222835,0,1,2
63649,5,1,222839,222839,222840,0,1,4
63650,3,3,222842,222842,222845,0,3,2
63651,2,2,222844,222845,222847,1,3,0
63652,1,1,222845,222847,222848,2,3,0
63653,4,1,222849,222849,222850,0,1,1
63654,5,3,222854,222854,222857,0,3,4
63655,2,1,222856,222857,222858,1,2,0
63656,3,3,222859,222859,222862,0,3,1
63657,1,2,222860,222862,222864,2,4,0
63658,4,2,222864,222864,222866,0,2,0
63659,1,2,222865,222866,222868,1,3,0
63660,3,2,222868,222868,222870,0,2,0
63661,2,1,222870,222870,222871,0,1,0
63662,3,1,222873,222873,222874,0,1,2
63663,2,3,222875,222875,222878,0,3,1
63664,3,1,222878,222878,222879,0,1,0
63665,6,2,222884,222884,222886,0,2,5
63666,3,1,222887,222887,222888,0,1,1
63667,4,2,222891,222891,222893,0,2,3
63668,5,1,222896,222896,222897,0,1,3
63669,5,2,222901,222901,222903,0,2,4
63670,1,3,222902,222903,222906,1,4,0
63671,2,3,222904,222906,222909,2,5,0
63672,6,1,222910,222910,222911,0,1,1
63673,1,2,222911,222911,222913,0,2,0
63674,2,2,222913,222913,222915,0,2,0
63675,5,1,222918,222918,222919,0,1,3
63676,6,1,222924,222924,222925,0,1,5
63677,5,3,222929,222929,222932,0,3,4
63678,3,3,222932,222932,222935,0,3,0
63679,5,3,222937,222937,222940,0,3,2
63680,5,1,222942,222942,222943,0,1,2
63681,1,3,222943,222943,222946,0,3,0
63682,1,3,222944,222946,222949,2,5,0
63683,5,2,222949,222949,222951,0,2,0
63684,5,2,222954,222954,222956,0,2,3
63685,4,2,222958,222958,222960,0,2,2
63686,2,3,222960,222960,222963,0,3,0
63687,1,2,222961,222963,222965,2,4,0
63688,6,3,222967,222967,222970,0,3,2
63689,1,1,222968,222970,222971,2,3,0
63690,3,1,222971,222971,222972,0,1,0
63691,1,1,222972,222972,222973,0,1,0
63692,3,3,222975,222975,222978,0,3,2
63693,6,1,222981,222981,222982,0,1,3
63694,4,1,222985,222985,222986,0,1,3
63695,5,1,222990,222990,222991,0,1,4
63696,6,3,222996,222996,222999,0,3,5
63697,5,1,223001,223001,223002,0,1,2
63698,2,1,223003,223003,223004,0,1,1
63699,4,3,223007,223007,223010,0,3,3
63700,2,3,223009,223010,223013,1,4,0
63701,3,3,223012,223013,223016,1,4,0
63702,1,3,223013,223016,223019,3,6,0
63703,3,1,223016,223019,223020,3,4,0
63704,4,3,223020,223020,223023,0,3,0
63705,3,3,223023,223023,223026,0,3,0
63706,6,2,223029,223029,223031,0,2,3
63707,2,1,223031,223031,223032,0,1,0
63708,6,3,223037,223037,223040,0,3,5
63709,4,3,223041,223041,223044,0,3,1
63710,3,2,223044,223044,223046,0,2,0
63711,3,1,223047,223047,223048,0,1,1
63712,1,3,223048,223048,223051,0,3,0
63713,2,1,223050,223051,223052,1,2,0
63714,1,3,223051,223052,223055,1,4,0
63715,4,3,223055,223055,223058,0,3,0
63716,4,1,223059,223059,223060,0,1,1
63717,2,2,223061,223061,223063,0,2,1
63718,3,1,223064,223064,223065,0,1,1
63719,5,1,223069,223069,223070,0,1,4
63720,4,3,223073,223073,223076,0,3,3
63721,2,2,223075,223076,223078,1,3,0
63722,4,1,223079,223079,223080,0,1,1
63723,3,2,223082,223082,223084,0,2,2
63724,1,2,223083,223084,223086,1,3,0
63725,2,2,223085,223086,223088,1,3,0
63726,5,3,223090,223090,223093,0,3,2
63727,4,3,223094,223094,223097,0,3,1
63728,4,2,223098,223098,223100,0,2,1
63729,2,2,223100,223100,223102,0,2,0
63730,6,2,223106,223106,223108,0,2,4
63731,1,3,223107,223108,223111,1,4,0
63732,2,2,223109,223111,223113,2,4,0
63733,1,3,223110,223113,223116,3,6,0
63734,2,2,223112,223116,223118,4,6,0
63735,6,3,223118,223118,223121,0,3,0
63736,2,1,223120,223121,223122,1,2,0
63737,2,1,223122,223122,223123,0,1,0
63738,3,2,223125,223125,223127,0,2,2
63739,1,2,223126,223127,223129,1,3,0
63740,6,2,223132,223132,223134,0,2,3
63741,3,2,223135,223135,223137,0,2,1
63742,2,1,223137,223137,223138,0,1,0
63743,6,3,223143,223143,223146,0,3,5
63744,5,2,223148,223148,223150,0,2,2
63745,1,2,223149,223150,223152,1,3,0
63746,4,3,223153,223153,223156,0,3,1
63747,6,1,223159,223159,223160,0,1,3
63748,5,2,223164,223164,223166,0,2,4
63749,1,2,223165,223166,223168,1,3,0
63750,6,1,223171,223171,223172,0,1,3
63751,5,3,223176,223176,223179,0,3,4
63752,6,1,223182,223182,223183,0,1,3
63753,3,2,223185,223185,223187,0,2,2
63754,3,1,223188,223188,223189,0,1,1
63755,2,1,223190,223190,223191,0,1,1
63756,6,3,223196,223196,223199,0,3,5
63757,6,2,223202,223202,223204,0,2,3
63758,5,1,223207,223207,223208,0,1,3
63759,1,2,223208,223208,223210,0,2,0
63760,1,1,223209,223210,223211,1,2,0
63761,6,2,223215,223215,223217,0,2,4
63762,4,1,223219,223219,223220,0,1,2
63763,1,3,223220,223220,223223,0,3,0
63764,5,3,223225,223225,223228,0,3,2
63765,1,1,223226,223228,223229,2,3,0
63766,4,3,223230,223230,223233,0,3,1
63767,4,3,223234,223234,223237,0,3,1
63768,4,2,223238,223238,223240,0,2,1
63769,3,2,223241,223241,223243,0,2,1
63770,4,1,223245,223245,223246,0,1,2
63771,5,3,223250,223250,223253,0,3,4
63772,3,2,223253,223253,223255,0,2,0
63773,5,3,223258,223258,223261,0,3,3
63774,6,2,223264,223264,223266,0,2,3
63775,2,3,223266,223266,223269,0,3,0
63776,3,2,223269,223269,223271,0,2,0
63777,3,2,223272,223272,223274,0,2,1
63778,1,1,223273,223274,223275,1,2,0
63779,4,3,223277,223277,223280,0,3,2
63780,6,3,223283,223283,223286,0,3,3
63781,6,3,223289,223289,223292,0,3,3
63782,2,1,223291,223292,223293,1,2,0
63783,1,2,223292,223293,223295,1,3,0
63784,5,2,223297,223297,223299,0,2,2
63785,5,3,223302,223302,223305,0,3,3
63786,1,2,223303,223305,223307,2,4,0
63787,6,1,223309,223309,223310,0,1,2
63788,3,3,223312,223312,223315,0,3,2
63789,5,1,223317,223317,223318,0,1,2
63790,3,2,223320,223320,223322,0,2,2
63791,3,3,223323,223323,223326,0,3,1
63792,6,1,223329,223329,223330,0,1,3
63793,6,2,223335,223335,223337,0,2,5
63794,4,2,223339,223339,223341,0,2,2
63795,2,1,223341,223341,223342,0,1,0
63796,4,2,223345,223345,223347,0,2,3
63797,4,3,223349,223349,223352,0,3,2
63798,1,3,223350,223352,223355,2,5,0
63799,3,2,223353,223355,223357,2,4,0
63800,3,2,223356,223357,223359,1,3,0
63801,6,1,223362,223362,223363,0,1,3
63802,5,3,223367,223367,223370,0,3,4
63803,2,2,223369,223370,223372,1,3,0
63804,6,1,223375,223375,223376,0,1,3
63805,1,2,223376,223376,223378,0,2,0
63806,4,2,223380,223380,223382,0,2,2
63807,2,1,223382,223382,223383,0,1,0
63808,6,1,223388,223388,223389,0,1,5
63809,4,3,223392,223392,223395,0,3,3
63810,4,2,223396,223396,223398,0,2,1
63811,6,1,223402,223402,223403,0,1,4
63812,5,1,223407,223407,223408,0,1,4
63813,5,1,223412,223412,223413,0,1,4
63814,4,2,223416,223416,223418,0,2,3
63815,6,3,223422,223422,223425,0,3,4
63816,4,2,223426,223426,223428,0,2,1
63817,2,3,223428,223428,223431,0,3,0
63818,3,2,223431,223431,223433,0,2,0
63819,1,1,223432,223433,223434,1,2,0
63820,2,2,223434,223434,223436,0,2,0
63821,6,1,223440,223440,223441,0,1,4
63822,2,2,223442,223442,223444,0,2,1
63823,2,1,223444,223444,223445,0,1,0
63824,2,1,223446,223446,223447,0,1,1
63825,3,2,223449,223449,223451,0,2,2
63826,2,1,223451,223451,223452,0,1,0
63827,6,2,223457,223457,223459,0,2,5
63828,6,3,223463,223463,223466,0,3,4
63829,4,3,223467,223467,223470,0,3,1
63830,3,2,223470,223470,223472,0,2,0
63831,6,3,223476,223476,223479,0,3,4
63832,2,2,223478,223479,223481,1,3,0
63833,1,1,223479,223481,223482,2,3,0
63834,4,2,223483,223483,223485,0,2,1
63835,3,1,223486,223486,223487,0,1,1
63836,4,1,223490,223490,223491,0,1,3
63837,5,1,223495,223495,223496,0,1,4
63838,2,1,223497,223497,223498,0,1,1
63839,4,3,223501,223501,223504,0,3,3
63840,4,2,223505,223505,223507,0,2,1
63841,2,2,223507,223507,223509,0,2,0
63842,2,1,223509,223509,223510,0,1,0
63843,2,1,223511,223511,223512,0,1,1
63844,1,1,223512,223512,223513,0,1,0
63845,6,2,223518,223518,223520,0,2,5
63846,3,2,223521,223521,223523,0,2,1
63847,6,2,223527,223527,223529,0,2,4
63848,3,1,223530,223530,223531,0,1,1
63849,5,1,223535,223535,223536,0,1,4
63850,3,3,223538,223538,223541,0,3,2
63851,2,3,223540,223541,223544,1,4,0
63852,5,3,223545,223545,223548,0,3,1
63853,5,2,223550,223550,223552,0,2,2
63854,3,2,223553,223553,223555,0,2,1
63855,1,2,223554,223555,223557,1,3,0
63856,6,3,223560,223560,223563,0,3,3
63857,1,1,223561,223563,223564,2,3,0
63858,3,1,223564,223564,223565,0,1,0
63859,4,2,223568,223568,223570,0,2,3
63860,3,3,223571,223571,223574,0,3,1
63861,3,2,223574,223574,223576,0,2,0
63862,1,1,223575,223576,223577,1,2,0
63863,6,3,223581,223581,223584,0,3,4
63864,1,1,223582,223584,223585,2,3,0
63865,3,2,223585,223585,223587,0,2,0
63866,2,1,223587,223587,223588,0,1,0
63867,4,3,223591,223591,223594,0,3,3
63868,5,3,223596,223596,223599,0,3,2
63869,1,3,223597,223599,223602,2,5,0
63870,6,1,223603,223603,223604,0,1,1
63871,6,2,223609,223609,223611,0,2,5
63872,1,2,223610,223611,223613,1,3,0
63873,5,1,223615,223615,223616,0,1,2
63874,4,1,223619,223619,223620,0,1,3
63875,6,2,223625,223625,223627,0,2,5
63876,2,1,223627,223627,223628,0,1,0
63877,4,3,223631,223631,223634,0,3,3
63878,2,1,223633,223634,223635,1,2,0
63879,3,3,223636,223636,223639,0,3,1
63880,5,2,223641,223641,223643,0,2,2
63881,5,2,223646,223646,223648,0,2,3
63882,4,1,223650,223650,223651,0,1,2
63883,6,3,223656,223656,223659,0,3,5
63884,5,3,223661,223661,223664,0,3,2
63885,1,2,223662,223664,223666,2,4,0
63886,4,2,223666,223666,223668,0,2,0
63887,1,1,223667,223668,223669,1,2,0
63888,3,3,223670,223670,223673,0,3,1
63889,1,3,223671,223673,223676,2,5,0
63890,3,2,223674,223676,223678,2,4,0
63891,5,3,223679,223679,223682,0,3,1
63892,5,1,223684,223684,223685,0,1,2
63893,3,1,223687,223687,223688,0,1,2
63894,1,1,223688,223688,223689,0,1,0
63895,5,2,223693,223693,223695,0,2,4
63896,4,3,223697,223697,223700,0,3,2
63897,2,1,223699,223700,223701,1,2,0
63898,4,3,223703,223703,223706,0,3,2
63899,6,1,223709,223709,223710,0,1,3
63900,3,2,223712,223712,223714,0,2,2
63901,3,2,223715,223715,223717,0,2,1
63902,1,2,223716,223717,223719,1,3,0
63903,4,1,223720,223720,223721,0,1,1
63904,6,2,223726,223726,223728,0,2,5
63905,5,2,223731,223731,223733,0,2,3
63906,1,1,223732,223733,223734,1,2,0
63907,3,2,223735,223735,223737,0,2,1
63908,5,1,223740,223740,223741,0,1,3
63909,4,1,223744,223744,223745,0,1,3
63910,1,2,223745,223745,223747,0,2,0
63911,5,2,223750,223750,223752,0,2,3
63912,6,2,223756,223756,223758,0,2,4
63913,4,2,223760,223760,223762,0,2,2
63914,4,1,223764,223764,223765,0,1,2
63915,3,3,223767,223767,223770,0,3,2
63916,4,1,223771,223771,223772,0,1,1
63917,2,2,223773,223773,223775,0,2,1
63918,2,1,223775,223775,223776,0,1,0
63919,1,2,223776,223776,223778,0,2,0
63920,6,1,223782,223782,223783,0,1,4
63921,4,1,223786,223786,223787,0,1,3
63922,4,1,223790,223790,223791,0,1,3
63923,1,2,223791,223791,223793,0,2,0
63924,5,1,223796,223796,223797,0,1,3
63925,1,2,223797,223797,223799,0,2,0
63926,3,1,223800,223800,223801,0,1,1
63927,6,3,223806,223806,223809,0,3,5
63928,3,1,223809,223809,223810,0,1,0
63929,5,3,223814,223814,223817,0,3,4
63930,6,3,223820,223820,223823,0,3,3
63931,2,2,223822,223823,223825,1,3,0
63932,4,2,223826,223826,223828,0,2,1
63933,1,3,223827,223828,223831,1,4,0
63934,6,2,223833,223833,223835,0,2,2
63935,3,2,223836,223836,223838,0,2,1
63936,5,2,223841,223841,223843,0,2,3
63937,1,3,223842,223843,223846,1,4,0
63938,2,3,223844,223846,223849,2,5,0
63939,4,1,223848,223849,223850,1,2,0
63940,5,3,223853,223853,223856,0,3,3
63941,3,1,223856,223856,223857,0,1,0
63942,6,3,223862,223862,223865,0,3,5
63943,5,2,223867,223867,223869,0,2,2
63944,6,3,223873,223873,223876,0,3,4
63945,1,1,223874,223876,223877,2,3,0
63946,1,1,223875,223877,223878,2,3,0
63947,1,2,223876,223878,223880,2,4,0
63948,2,1,223878,223880,223881,2,3,0
63949,4,1,223882,223882,223883,0,1,1
63950,2,2,223884,223884,223886,0,2,1
63951,6,3,223890,223890,223893,0,3,4
63952,2,3,223892,223893,223896,1,4,0
63953,5,2,223897,223897,223899,0,2,1
63954,4,2,223901,223901,223903,0,2,2
63955,5,1,223906,223906,223907,0,1,3
63956,3,3,223909,223909,223912,0,3,2
63957,2,2,223911,223912,223914,1,3,0
63958,3,1,223914,223914,223915,0,1,0
63959,4,1,223918,223918,223919,0,1,3
63960,3,3,223921,223921,223924,0,3,2
63961,5,3,223926,223926,223929,0,3,2
63962,2,3,223928,223929,223932,1,4,0
63963,4,2,223932,223932,223934,0,2,0
63964,1,1,223933,223934,223935,1,2,0
63965,5,3,223938,223938,223941,0,3,3
63966,2,1,223940,223941,223942,1,2,0
63967,4,3,223944,223944,223947,0,3,2
63968,1,3,223945,223947,223950,2,5,0
63969,2,3,223947,223950,223953,3,6,0
63970,2,2,223949,223953,223955,4,6,0
63971,4,3,223953,223955,223958,2,5,0
63972,3,2,223956,223958,223960,2,4,0
63973,4,3,223960,223960,223963,0,3,0
63974,4,2,223964,223964,223966,0,2,1
63975,2,1,223966,223966,223967,0,1,0
63976,4,3,223970,223970,223973,0,3,3
63977,1,2,223971,223973,223975,2,4,0
63978,2,3,223973,223975,223978,2,5,0
63979,3,3,223976,223978,223981,2,5,0
63980,4,3,223980,223981,223984,1,4,0
63981,1,1,223981,223984,223985,3,4,0
63982,4,1,223985,223985,223986,0,1,0
63983,1,2,223986,223986,223988,0,2,0
63984,4,3,223990,223990,223993,0,3,2
63985,1,2,223991,223993,223995,2,4,0
63986,4,2,223995,223995,223997,0,2,0
63987,3,2,223998,223998,224000,0,2,1
63988,5,2,224003,224003,224005,0,2,3
63989,2,3,224005,224005,224008,0,3,0
63990,5,3,224010,224010,224013,0,3,2
63991,3,2,224013,224013,224015,0,2,0
63992,2,3,224015,224015,224018,0,3,0
63993,4,2,224019,224019,224021,0,2,1
63994,3,2,224022,224022,224024,0,2,1
63995,1,1,224023,224024,224025,1,2,0
63996,6,2,224029,224029,224031,0,2,4
63997,6,1,224035,224035,224036,0,1,4
63998,2,3,224037,224037,224040,0,3,1
63999,4,3,224041,224041,224044,0,3,1
64000,4,1,224045,224045,224046,0,1,1
64001,6,2,224051,224051,224053,0,2,5
64002,2,3,224053,224053,224056,0,3,0
64003,1,2,224054,224056,224058,2,4,0
64004,3,2,224057,224058,224060,1,3,0
64005,4,3,224061,224061,224064,0,3,1
64006,6,3,224067,224067,224070,0,3,3
64007,2,2,224069,224070,224072,1,3,0
64008,4,3,224073,224073,224076,0,3,1
64009,6,2,224079,224079,224081,0,2,3
64010,2,3,224081,224081,224084,0,3,0
64011,4,1,224085,224085,224086,0,1,1
64012,4,1,224089,224089,224090,0,1,3
64013,3,1,224092,224092,224093,0,1,2
64014,5,1,224097,224097,224098,0,1,4
64015,4,1,224101,224101,224102,0,1,3
64016,5,3,224106,224106,224109,0,3,4
64017,2,3,224108,224109,224112,1,4,0
64018,1,2,224109,224112,224114,3,5,0
64019,4,2,224113,224114,224116,1,3,0
64020,2,2,224115,224116,224118,1,3,0
64021,6,3,224121,224121,224124,0,3,3
64022,3,1,224124,224124,224125,0,1,0
64023,1,2,224125,224125,224127,0,2,0
64024,4,2,224129,224129,224131,0,2,2
64025,5,3,224134,224134,224137,0,3,3
64026,2,3,224136,224137,224140,1,4,0
64027,5,2,224141,224141,224143,0,2,1
64028,5,2,224146,224146,224148,0,2,3
64029,5,1,224151,224151,224152,0,1,3
64030,4,3,224155,224155,224158,0,3,3
64031,3,2,224158,224158,224160,0,2,0
64032,6,2,224164,224164,224166,0,2,4
64033,4,1,224168,224168,224169,0,1,2
64034,5,1,224173,224173,224174,0,1,4
64035,2,3,224175,224175,224178,0,3,1
64036,1,2,224176,224178,224180,2,4,0
64037,1,1,224177,224180,224181,3,4,0
64038,1,2,224178,224181,224183,3,5,0
64039,3,1,224181,224183,224184,2,3,0
64040,3,3,224184,224184,224187,0,3,0
64041,6,3,224190,224190,224193,0,3,3
64042,1,2,224191,224193,224195,2,4,0
64043,4,3,224195,224195,224198,0,3,0
64044,6,3,224201,224201,224204,0,3,3
64045,4,2,224205,224205,224207,0,2,1
64046,4,2,224209,224209,224211,0,2,2
64047,3,3,224212,224212,224215,0,3,1
64048,3,3,224215,224215,224218,0,3,0
64049,3,3,224218,224218,224221,0,3,0
64050,5,3,224223,224223,224226,0,3,2
64051,5,3,224228,224228,224231,0,3,2
64052,3,2,224231,224231,224233,0,2,0
64053,1,3,224232,224233,224236,1,4,0
64054,4,1,224236,224236,224237,0,1,0
64055,3,2,224239,224239,224241,0,2,2
64056,6,2,224245,224245,224247,0,2,4
64057,3,2,224248,224248,224250,0,2,1
64058,2,3,224250,224250,224253,0,3,0
64059,6,2,224256,224256,224258,0,2,3
64060,4,1,224260,224260,224261,0,1,2
64061,4,3,224264,224264,224267,0,3,3
64062,1,3,224265,224267,224270,2,5,0
64063,3,2,224268,224270,224272,2,4,0
64064,4,1,224272,224272,224273,0,1,0
64065,1,1,224273,224273,224274,0,1,0
64066,1,2,224274,224274,224276,0,2,0
64067,6,1,224280,224280,224281,0,1,4
64068,5,1,224285,224285,224286,0,1,4
64069,3,1,224288,224288,224289,0,1,2
64070,3,2,224291,224291,224293,0,2,2
64071,2,3,224293,224293,224296,0,3,0
64072,4,1,224297,224297,224298,0,1,1
64073,3,1,224300,224300,224301,0,1,2
64074,2,2,224302,224302,224304,0,2,1
64075,3,1,224305,224305,224306,0,1,1
64076,5,2,224310,224310,224312,0,2,4
64077,5,3,224315,224315,224318,0,3,3
64078,2,1,224317,224318,224319,1,2,0
64079,1,2,224318,224319,224321,1,3,0
64080,6,3,224324,224324,224327,0,3,3
64081,6,3,224330,224330,224333,0,3,3
64082,4,1,224334,224334,224335,0,1,1
64083,4,3,224338,224338,224341,0,3,3
64084,4,2,224342,224342,224344,0,2,1
64085,4,3,224346,224346,224349,0,3,2
64086,2,2,224348,224349,224351,1,3,0
64087,2,3,224350,224351,224354,1,4,0
64088,3,2,224353,224354,224356,1,3,0
64089,4,1,224357,224357,224358,0,1,1
64090,3,2,224360,224360,224362,0,2,2
64091,6,3,224366,224366,224369,0,3,4
64092,6,3,224372,224372,224375,0,3,3
64093,4,1,224376,224376,224377,0,1,1
64094,4,1,224380,224380,224381,0,1,3
64095,2,2,224382,224382,224384,0,2,1
64096,4,2,224386,224386,224388,0,2,2
64097,5,1,224391,224391,224392,0,1,3
64098,6,2,224397,224397,224399,0,2,5
64099,6,1,224403,224403,224404,0,1,4
64100,1,1,224404,224404,224405,0,1,0
64101,5,1,224409,224409,224410,0,1,4
64102,6,3,224415,224415,224418,0,3,5
64103,4,2,224419,224419,224421,0,2,1
64104,4,1,224423,224423,224424,0,1,2
64105,1,2,224424,224424,224426,0,2,0
64106,6,1,224430,224430,224431,0,1,4
64107,2,1,224432,224432,224433,0,1,1
64108,3,3,224435,224435,224438,0,3,2
64109,5,2,224440,224440,224442,0,2,2
64110,3,2,224443,224443,224445,0,2,1
64111,1,1,224444,224445,224446,1,2,0
64112,2,2,224446,224446,224448,0,2,0
64113,3,3,224449,224449,224452,0,3,1
64114,6,3,224455,224455,224458,0,3,3
64115,3,2,224458,224458,224460,0,2,0
64116,6,3,224464,224464,224467,0,3,4
64117,6,2,224470,224470,224472,0,2,3
64118,6,1,224476,224476,224477,0,1,4
64119,1,1,224477,224477,224478,0,1,0
64120,3,2,224480,224480,224482,0,2,2
64121,1,3,224481,224482,224485,1,4,0
64122,5,3,224486,224486,224489,0,3,1
64123,6,1,224492,224492,224493,0,1,3
64124,3,2,224495,224495,224497,0,2,2
64125,1,3,224496,224497,224500,1,4,0
64126,3,1,224499,224500,224501,1,2,0
64127,4,3,224503,224503,224506,0,3,2
64128,2,3,224505,224506,224509,1,4,0
64129,6,3,224511,224511,224514,0,3,2
64130,6,1,224517,224517,224518,0,1,3
64131,1,1,224518,224518,224519,0,1,0
64132,5,1,224523,224523,224524,0,1,4
64133,2,3,224525,224525,224528,0,3,1
64134,1,3,224526,224528,224531,2,5,0
64135,6,3,224532,224532,224535,0,3,1
64136,1,1,224533,224535,224536,2,3,0
64137,6,3,224539,224539,224542,0,3,3
64138,6,3,224545,224545,224548,0,3,3
64139,3,3,224548,224548,224551,0,3,0
64140,2,1,224550,224551,224552,1,2,0
64141,6,3,224556,224556,224559,0,3,4
64142,4,3,224560,224560,224563,0,3,1
64143,1,1,224561,224563,224564,2,3,0
64144,4,2,224565,224565,224567,0,2,1
64145,3,1,224568,224568,224569,0,1,1
64146,6,1,224574,224574,224575,0,1,5
64147,6,1,224580,224580,224581,0,1,5
64148,4,1,224584,224584,224585,0,1,3
64149,4,3,224588,224588,224591,0,3,3
64150,1,1,224589,224591,224592,2,3,0
64151,6,2,224595,224595,224597,0,2,3
64152,4,3,224599,224599,224602,0,3,2
64153,4,3,224603,224603,224606,0,3,1
64154,2,2,224605,224606,224608,1,3,0
64155,3,2,224608,224608,224610,0,2,0
64156,4,2,224612,224612,224614,0,2,2
64157,4,1,224616,224616,224617,0,1,2
64158,6,2,224622,224622,224624,0,2,5
64159,3,3,224625,224625,224628,0,3,1
64160,5,1,224630,224630,224631,0,1,2
64161,6,3,224636,224636,224639,0,3,5
64162,5,3,224641,224641,224644,0,3,2
64163,5,1,224646,224646,224647,0,1,2
64164,5,1,224651,224651,224652,0,1,4
64165,5,1,224656,224656,224657,0,1,4
64166,5,1,224661,224661,224662,0,1,4
64167,6,2,224667,224667,224669,0,2,5
64168,5,2,224672,224672,224674,0,2,3
64169,4,2,224676,224676,224678,0,2,2
64170,3,1,224679,224679,224680,0,1,1
64171,6,3,224685,224685,224688,0,3,5
64172,3,3,224688,224688,224691,0,3,0
64173,4,1,224692,224692,224693,0,1,1
64174,5,1,224697,224697,224698,0,1,4
64175,6,1,224703,224703,224704,0,1,5
64176,6,1,224709,224709,224710,0,1,5
64177,6,1,224715,224715,224716,0,1,5
64178,3,3,224718,224718,224721,0,3,2
64179,1,3,224719,224721,224724,2,5,0
64180,4,2,224723,224724,224726,1,3,0
64181,3,3,224726,224726,224729,0,3,0
64182,4,1,224730,224730,224731,0,1,1
64183,6,1,224736,224736,224737,0,1,5
64184,6,1,224742,224742,224743,0,1,5
64185,1,1,224743,224743,224744,0,1,0
64186,1,1,224744,224744,224745,0,1,0
64187,6,2,224750,224750,224752,0,2,5
64188,3,2,224753,224753,224755,0,2,1
64189,6,1,224759,224759,224760,0,1,4
64190,4,2,224763,224763,224765,0,2,3
64191,4,3,224767,224767,224770,0,3,2
64192,3,1,224770,224770,224771,0,1,0
64193,6,1,224776,224776,224777,0,1,5
64194,4,1,224780,224780,224781,0,1,3
64195,2,3,224782,224782,224785,0,3,1
64196,1,2,224783,224785,224787,2,4,0
64197,1,1,224784,224787,224788,3,4,0
64198,1,2,224785,224788,224790,3,5,0
64199,1,1,224786,224790,224791,4,5,0
64200,3,3,224789,224791,224794,2,5,0
64201,5,1,224794,224794,224795,0,1,0
64202,6,3,224800,224800,224803,0,3,5
64203,3,2,224803,224803,224805,0,2,0
64204,2,2,224805,224805,224807,0,2,0
64205,5,3,224810,224810,224813,0,3,3
64206,4,1,224814,224814,224815,0,1,1
64207,3,1,224817,224817,224818,0,1,2
64208,2,1,224819,224819,224820,0,1,1
64209,3,3,224822,224822,224825,0,3,2
64210,1,2,224823,224825,224827,2,4,0
64211,4,3,224827,224827,224830,0,3,0
64212,4,2,224831,224831,224833,0,2,1
64213,1,3,224832,224833,224836,1,4,0
64214,4,3,224836,224836,224839,0,3,0
64215,1,1,224837,224839,224840,2,3,0
64216,3,2,224840,224840,224842,0,2,0
64217,4,3,224844,224844,224847,0,3,2
64218,1,3,224845,224847,224850,2,5,0
64219,1,3,224846,224850,224853,4,7,0
64220,6,2,224852,224853,224855,1,3,0
64221,2,2,224854,224855,224857,1,3,0
64222,5,3,224859,224859,224862,0,3,2
64223,2,1,224861,224862,224863,1,2,0
64224,2,2,224863,224863,224865,0,2,0
64225,2,2,224865,224865,224867,0,2,0
64226,5,2,224870,224870,224872,0,2,3
64227,2,1,224872,224872,224873,0,1,0
64228,4,3,224876,224876,224879,0,3,3
64229,2,3,224878,224879,224882,1,4,0
64230,4,1,224882,224882,224883,0,1,0
64231,1,3,224883,224883,224886,0,3,0
64232,1,2,224884,224886,224888,2,4,0
64233,3,3,224887,224888,224891,1,4,0
64234,5,2,224892,224892,224894,0,2,1
64235,2,2,224894,224894,224896,0,2,0
64236,6,1,224900,224900,224901,0,1,4
64237,6,3,224906,224906,224909,0,3,5
64238,1,1,224907,224909,224910,2,3,0
64239,4,3,224911,224911,224914,0,3,1
64240,1,1,224912,224914,224915,2,3,0
64241,6,1,224918,224918,224919,0,1,3
64242,2,1,224920,224920,224921,0,1,1
64243,5,1,224925,224925,224926,0,1,4
64244,1,2,224926,224926,224928,0,2,0
64245,5,1,224931,224931,224932,0,1,3
64246,1,2,224932,224932,224934,0,2,0
64247,2,3,224934,224934,224937,0,3,0
64248,6,2,224940,224940,224942,0,2,3
64249,5,1,224945,224945,224946,0,1,3
64250,5,3,224950,224950,224953,0,3,4
64251,6,1,224956,224956,224957,0,1,3
64252,2,2,224958,224958,224960,0,2,1
64253,5,3,224963,224963,224966,0,3,3
64254,4,1,224967,224967,224968,0,1,1
64255,1,2,224968,224968,224970,0,2,0
64256,4,2,224972,224972,224974,0,2,2
64257,6,1,224978,224978,224979,0,1,4
64258,3,2,224981,224981,224983,0,2,2
64259,2,3,224983,224983,224986,0,3,0
64260,4,2,224987,224987,224989,0,2,1
64261,3,2,224990,224990,224992,0,2,1
64262,6,1,224996,224996,224997,0,1,4
64263,2,2,224998,224998,225000,0,2,1
64264,4,3,225002,225002,225005,0,3,2
64265,5,2,225007,225007,225009,0,2,2
64266,6,2,225013,225013,225015,0,2,4
64267,3,2,225016,225016,225018,0,2,1
64268,5,2,225021,225021,225023,0,2,3
64269,2,1,225023,225023,225024,0,1,0
64270,5,3,225028,225028,225031,0,3,4
64271,4,1,225032,225032,225033,0,1,1
64272,5,3,225037,225037,225040,0,3,4
64273,1,3,225038,225040,225043,2,5,0
64274,6,1,225044,225044,225045,0,1,1
64275,2,3,225046,225046,225049,0,3,1
64276,1,1,225047,225049,225050,2,3,0
64277,6,2,225053,225053,225055,0,2,3
64278,4,2,225057,225057,225059,0,2,2
64279,2,3,225059,225059,225062,0,3,0
64280,5,1,225064,225064,225065,0,1,2
64281,4,2,225068,225068,225070,0,2,3
64282,6,2,225074,225074,225076,0,2,4
64283,4,3,225078,225078,225081,0,3,2
64284,5,2,225083,225083,225085,0,2,2
64285,5,3,225088,225088,225091,0,3,3
64286,2,1,225090,225091,225092,1,2,0
64287,4,2,225094,225094,225096,0,2,2
64288,4,1,225098,225098,225099,0,1,2
64289,5,2,225103,225103,225105,0,2,4
64290,4,3,225107,225107,225110,0,3,2
64291,3,1,225110,225110,225111,0,1,0
64292,1,3,225111,225111,225114,0,3,0
64293,6,2,225117,225117,225119,0,2,3
64294,4,2,225121,225121,225123,0,2,2
64295,3,2,225124,225124,225126,0,2,1
64296,3,2,225127,225127,225129,0,2,1
64297,1,3,225128,225129,225132,1,4,0
64298,1,2,225129,225132,225134,3,5,0
64299,4,2,225133,225134,225136,1,3,0
64300,5,2,225138,225138,225140,0,2,2
64301,2,2,225140,225140,225142,0,2,0
64302,1,3,225141,225142,225145,1,4,0
64303,6,2,225147,225147,225149,0,2,2
64304,6,2,225153,225153,225155,0,2,4
64305,5,2,225158,225158,225160,0,2,3
64306,3,3,225161,225161,225164,0,3,1
64307,3,3,225164,225164,225167,0,3,0
64308,6,2,225170,225170,225172,0,2,3
64309,6,3,225176,225176,225179,0,3,4
64310,5,3,225181,225181,225184,0,3,2
64311,1,3,225182,225184,225187,2,5,0
64312,4,3,225186,225187,225190,1,4,0
64313,5,1,225191,225191,225192,0,1,1
64314,4,3,225195,225195,225198,0,3,3
64315,3,1,225198,225198,225199,0,1,0
64316,5,1,225203,225203,225204,0,1,4
64317,3,2,225206,225206,225208,0,2,2
64318,3,2,225209,225209,225211,0,2,1
64319,4,1,225213,225213,225214,0,1,2
64320,5,3,225218,225218,225221,0,3,4
64321,4,2,225222,225222,225224,0,2,1
64322,2,1,225224,225224,225225,0,1,0
64323,3,2,225227,225227,225229,0,2,2
64324,3,2,225230,225230,225232,0,2,1
64325,2,1,225232,225232,225233,0,1,0
64326,2,2,225234,225234,225236,0,2,1
64327,3,3,225237,225237,225240,0,3,1
64328,6,3,225243,225243,225246,0,3,3
64329,5,3,225248,225248,225251,0,3,2
64330,3,1,225251,225251,225252,0,1,0
64331,4,1,225255,225255,225256,0,1,3
64332,1,1,225256,225256,225257,0,1,0
64333,5,2,225261,225261,225263,0,2,4
64334,3,2,225264,225264,225266,0,2,1
64335,3,3,225267,225267,225270,0,3,1
64336,4,3,225271,225271,225274,0,3,1
64337,5,2,225276,225276,225278,0,2,2
64338,3,3,225279,225279,225282,0,3,1
64339,2,1,225281,225282,225283,1,2,0
64340,1,2,225282,225283,225285,1,3,0
64341,1,2,225283,225285,225287,2,4,0
64342,1,3,225284,225287,225290,3,6,0
64343,6,1,225290,225290,225291,0,1,0
64344,2,3,225292,225292,225295,0,3,1
64345,1,2,225293,225295,225297,2,4,0
64346,4,1,225297,225297,225298,0,1,0
64347,1,3,225298,225298,225301,0,3,0
64348,1,1,225299,225301,225302,2,3,0
64349,2,3,225301,225302,225305,1,4,0
64350,2,2,225303,225305,225307,2,4,0
64351,4,1,225307,225307,225308,0,1,0
64352,1,1,225308,225308,225309,0,1,0
64353,4,1,225312,225312,225313,0,1,3
64354,3,2,225315,225315,225317,0,2,2
64355,4,2,225319,225319,225321,0,2,2
64356,4,1,225323,225323,225324,0,1,2
64357,2,3,225325,225325,225328,0,3,1
64358,5,1,225330,225330,225331,0,1,2
64359,3,2,225333,225333,225335,0,2,2
64360,2,1,225335,225335,225336,0,1,0
64361,6,2,225341,225341,225343,0,2,5
64362,2,3,225343,225343,225346,0,3,0
64363,5,3,225348,225348,225351,0,3,2
64364,5,1,225353,225353,225354,0,1,2
64365,3,3,225356,225356,225359,0,3,2
64366,5,2,225361,225361,225363,0,2,2
64367,2,2,225363,225363,225365,0,2,0
64368,1,3,225364,225365,225368,1,4,0
64369,5,1,225369,225369,225370,0,1,1
64370,6,2,225375,225375,225377,0,2,5
64371,4,1,225379,225379,225380,0,1,2
64372,6,3,225385,225385,225388,0,3,5
64373,3,3,225388,225388,225391,0,3,0
64374,3,3,225391,225391,225394,0,3,0
64375,5,3,225396,225396,225399,0,3,2
64376,4,1,225400,225400,225401,0,1,1
64377,4,3,225404,225404,225407,0,3,3
64378,2,2,225406,225407,225409,1,3,0
64379,4,1,225410,225410,225411,0,1,1
64380,4,1,225414,225414,225415,0,1,3
64381,4,1,225418,225418,225419,0,1,3
64382,4,1,225422,225422,225423,0,1,3
64383,1,1,225423,225423,225424,0,1,0
64384,5,2,225428,225428,225430,0,2,4
64385,1,1,225429,225430,225431,1,2,0
64386,4,2,225433,225433,225435,0,2,2
64387,6,2,225439,225439,225441,0,2,4
64388,1,2,225440,225441,225443,1,3,0
64389,4,2,225444,225444,225446,0,2,1
64390,1,2,225445,225446,225448,1,3,0
64391,5,2,225450,225450,225452,0,2,2
64392,2,2,225452,225452,225454,0,2,0
64393,1,1,225453,225454,225455,1,2,0
64394,2,2,225455,225455,225457,0,2,0
64395,3,3,225458,225458,225461,0,3,1
64396,4,1,225462,225462,225463,0,1,1
64397,2,3,225464,225464,225467,0,3,1
64398,6,2,225470,225470,225472,0,2,3
64399,4,2,225474,225474,225476,0,2,2
64400,6,1,225480,225480,225481,0,1,4
64401,2,2,225482,225482,225484,0,2,1
64402,3,3,225485,225485,225488,0,3,1
64403,3,2,225488,225488,225490,0,2,0
64404,3,1,225491,225491,225492,0,1,1
64405,4,2,225495,225495,225497,0,2,3
64406,3,2,225498,225498,225500,0,2,1
64407,6,3,225504,225504,225507,0,3,4
64408,1,2,225505,225507,225509,2,4,0
64409,1,3,225506,225509,225512,3,6,0
64410,3,3,225509,225512,225515,3,6,0
64411,4,1,225513,225515,225516,2,3,0
64412,4,2,225517,225517,225519,0,2,1
64413,5,2,225522,225522,225524,0,2,3
64414,3,3,225525,225525,225528,0,3,1
64415,2,1,225527,225528,225529,1,2,0
64416,6,2,225533,225533,225535,0,2,4
64417,1,2,225534,225535,225537,1,3,0
64418,1,3,225535,225537,225540,2,5,0
64419,5,2,225540,225540,225542,0,2,0
64420,6,3,225546,225546,225549,0,3,4
64421,2,1,225548,225549,225550,1,2,0
64422,3,1,225551,225551,225552,0,1,1
64423,5,1,225556,225556,225557,0,1,4
64424,6,1,225562,225562,225563,0,1,5
64425,4,1,225566,225566,225567,0,1,3
64426,4,2,225570,225570,225572,0,2,3
64427,4,1,225574,225574,225575,0,1,2
64428,1,2,225575,225575,225577,0,2,0
64429,4,3,225579,225579,225582,0,3,2
64430,1,2,225580,225582,225584,2,4,0
64431,6,2,225586,225586,225588,0,2,2
64432,6,3,225592,225592,225595,0,3,4
64433,1,3,225593,225595,225598,2,5,0
64434,1,3,225594,225598,225601,4,7,0
64435,4,2,225598,225601,225603,3,5,0
64436,3,1,225601,225603,225604,2,3,0
64437,3,2,225604,225604,225606,0,2,0
64438,1,2,225605,225606,225608,1,3,0
64439,5,1,225610,225610,225611,0,1,2
64440,4,2,225614,225614,225616,0,2,3
64441,5,2,225619,225619,225621,0,2,3
64442,3,3,225622,225622,225625,0,3,1
64443,6,2,225628,225628,225630,0,2,3
64444,3,1,225631,225631,225632,0,1,1
64445,5,2,225636,225636,225638,0,2,4
64446,2,2,225638,225638,225640,0,2,0
64447,5,2,225643,225643,225645,0,2,3
64448,6,2,225649,225649,225651,0,2,4
64449,4,1,225653,225653,225654,0,1,2
64450,6,1,225659,225659,225660,0,1,5
64451,5,3,225664,225664,225667,0,3,4
64452,4,3,225668,225668,225671,0,3,1
64453,1,2,225669,225671,225673,2,4,0
64454,6,1,225675,225675,225676,0,1,2
64455,2,2,225677,225677,225679,0,2,1
64456,3,2,225680,225680,225682,0,2,1
64457,2,1,225682,225682,225683,0,1,0
64458,3,1,225685,225685,225686,0,1,2
64459,3,1,225688,225688,225689,0,1,2
64460,5,3,225693,225693,225696,0,3,4
64461,1,2,225694,225696,225698,2,4,0
64462,3,1,225697,225698,225699,1,2,0
64463,4,1,225701,225701,225702,0,1,2
64464,3,2,225704,225704,225706,0,2,2
64465,4,2,225708,225708,225710,0,2,2
64466,6,1,225714,225714,225715,0,1,4
64467,1,1,225715,225715,225716,0,1,0
64468,2,1,225717,225717,225718,0,1,1
64469,6,3,225723,225723,225726,0,3,5
64470,1,1,225724,225726,225727,2,3,0
64471,5,1,225729,225729,225730,0,1,2
64472,3,1,225732,225732,225733,0,1,2
64473,2,1,225734,225734,225735,0,1,1
64474,3,3,225737,225737,225740,0,3,2
64475,6,2,225743,225743,225745,0,2,3
64476,3,3,225746,225746,225749,0,3,1
64477,6,1,225752,225752,225753,0,1,3
64478,5,2,225757,225757,225759,0,2,4
64479,6,1,225763,225763,225764,0,1,4
64480,4,3,225767,225767,225770,0,3,3
64481,2,1,225769,225770,225771,1,2,0
64482,3,1,225772,225772,225773,0,1,1
64483,4,3,225776,225776,225779,0,3,3
64484,5,2,225781,225781,225783,0,2,2
64485,5,2,225786,225786,225788,0,2,3
64486,2,1,225788,225788,225789,0,1,0
64487,1,2,225789,225789,225791,0,2,0
64488,3,2,225792,225792,225794,0,2,1
64489,5,1,225797,225797,225798,0,1,3
64490,4,1,225801,225801,225802,0,1,3
64491,3,3,225804,225804,225807,0,3,2
64492,2,1,225806,225807,225808,1,2,0
64493,2,2,225808,225808,225810,0,2,0
64494,5,2,225813,225813,225815,0,2,3
64495,5,2,225818,225818,225820,0,2,3
64496,6,2,225824,225824,225826,0,2,4
64497,6,1,225830,225830,225831,0,1,4
64498,6,3,225836,225836,225839,0,3,5
64499,3,2,225839,225839,225841,0,2,0
64500,3,1,225842,225842,225843,0,1,1
64501,2,3,225844,225844,225847,0,3,1
64502,6,2,225850,225850,225852,0,2,3
64503,6,2,225856,225856,225858,0,2,4
64504,2,3,225858,225858,225861,0,3,0
64505,5,3,225863,225863,225866,0,3,2
64506,2,2,225865,225866,225868,1,3,0
64507,1,3,225866,225868,225871,2,5,0
64508,4,1,225870,225871,225872,1,2,0
64509,5,3,225875,225875,225878,0,3,3
64510,2,1,225877,225878,225879,1,2,0
64511,3,3,225880,225880,225883,0,3,1
64512,1,1,225881,225883,225884,2,3,0
64513,2,1,225883,225884,225885,1,2,0
64514,5,3,225888,225888,225891,0,3,3
64515,1,1,225889,225891,225892,2,3,0
64516,5,1,225894,225894,225895,0,1,2
64517,2,1,225896,225896,225897,0,1,1
64518,3,1,225899,225899,225900,0,1,2
64519,3,3,225902,225902,225905,0,3,2
64520,2,1,225904,225905,225906,1,2,0
64521,6,2,225910,225910,225912,0,2,4
64522,5,3,225915,225915,225918,0,3,3
64523,5,3,225920,225920,225923,0,3,2
64524,1,3,225921,225923,225926,2,5,0
64525,3,3,225924,225926,225929,2,5,0
64526,4,3,225928,225929,225932,1,4,0
64527,4,3,225932,225932,225935,0,3,0
64528,3,2,225935,225935,225937,0,2,0
64529,3,3,225938,225938,225941,0,3,1
64530,1,3,225939,225941,225944,2,5,0
64531,1,1,225940,225944,225945,4,5,0
64532,6,3,225946,225946,225949,0,3,1
64533,5,3,225951,225951,225954,0,3,2
64534,2,1,225953,225954,225955,1,2,0
64535,1,1,225954,225955,225956,1,2,0
64536,3,3,225957,225957,225960,0,3,1
64537,4,2,225961,225961,225963,0,2,1
64538,4,1,225965,225965,225966,0,1,2
64539,4,1,225969,225969,225970,0,1,3
64540,5,1,225974,225974,225975,0,1,4
64541,4,3,225978,225978,225981,0,3,3
64542,4,1,225982,225982,225983,0,1,1
64543,4,3,225986,225986,225989,0,3,3
64544,3,2,225989,225989,225991,0,2,0
64545,3,2,225992,225992,225994,0,2,1
64546,3,3,225995,225995,225998,0,3,1
64547,1,1,225996,225998,225999,2,3,0
64548,6,3,226002,226002,226005,0,3,3
64549,3,2,226005,226005,226007,0,2,0
64550,4,2,226009,226009,226011,0,2,2
64551,6,1,226015,226015,226016,0,1,4
64552,5,3,226020,226020,226023,0,3,4
64553,4,3,226024,226024,226027,0,3,1
64554,4,2,226028,226028,226030,0,2,1
64555,2,2,226030,226030,226032,0,2,0
64556,3,1,226033,226033,226034,0,1,1
64557,6,3,226039,226039,226042,0,3,5
64558,1,2,226040,226042,226044,2,4,0
64559,2,3,226042,226044,226047,2,5,0
64560,5,1,226047,226047,226048,0,1,0
64561,4,1,226051,226051,226052,0,1,3
64562,1,3,226052,226052,226055,0,3,0
64563,5,3,226057,226057,226060,0,3,2
64564,2,3,226059,226060,226063,1,4,0
64565,6,3,226065,226065,226068,0,3,2
64566,1,2,226066,226068,226070,2,4,0
64567,4,3,226070,226070,226073,0,3,0
64568,5,3,226075,226075,226078,0,3,2
64569,6,2,226081,226081,226083,0,2,3
64570,4,1,226085,226085,226086,0,1,2
64571,5,2,226090,226090,226092,0,2,4
64572,1,1,226091,226092,226093,1,2,0
64573,2,1,226093,226093,226094,0,1,0
64574,1,1,226094,226094,226095,0,1,0
64575,6,1,226100,226100,226101,0,1,5
64576,3,3,226103,226103,226106,0,3,2
64577,5,1,226108,226108,226109,0,1,2
64578,1,1,226109,226109,226110,0,1,0
64579,1,3,226110,226110,226113,0,3,0
64580,5,2,226115,226115,226117,0,2,2
64581,6,3,226121,226121,226124,0,3,4
64582,1,3,226122,226124,226127,2,5,0
64583,1,3,226123,226127,226130,4,7,0
64584,1,2,226124,226130,226132,6,8,0
64585,3,2,226127,226132,226134,5,7,0
64586,6,1,226133,226134,226135,1,2,0
64587,5,1,226138,226138,226139,0,1,3
64588,4,2,226142,226142,226144,0,2,3
64589,6,1,226148,226148,226149,0,1,4
64590,3,2,226151,226151,226153,0,2,2
64591,6,3,226157,226157,226160,0,3,4
64592,1,3,226158,226160,226163,2,5,0
64593,6,3,226164,226164,226167,0,3,1
64594,2,1,226166,226167,226168,1,2,0
64595,2,1,226168,226168,226169,0,1,0
64596,2,2,226170,226170,226172,0,2,1
64597,6,3,226176,226176,226179,0,3,4
64598,5,3,226181,226181,226184,0,3,2
64599,2,2,226183,226184,226186,1,3,0
64600,1,1,226184,226186,226187,2,3,0
64601,2,1,226186,226187,226188,1,2,0
64602,6,1,226192,226192,226193,0,1,4
64603,6,3,226198,226198,226201,0,3,5
64604,6,2,226204,226204,226206,0,2,3
64605,6,1,226210,226210,226211,0,1,4
64606,2,2,226212,226212,226214,0,2,1
64607,5,2,226217,226217,226219,0,2,3
64608,3,3,226220,226220,226223,0,3,1
64609,1,2,226221,226223,226225,2,4,0
64610,1,1,226222,226225,226226,3,4,0
64611,2,3,226224,226226,226229,2,5,0
64612,2,2,226226,226229,226231,3,5,0
64613,6,2,226232,226232,226234,0,2,1
64614,1,2,226233,226234,226236,1,3,0
64615,6,1,226239,226239,226240,0,1,3
64616,4,3,226243,226243,226246,0,3,3
64617,5,1,226248,226248,226249,0,1,2
64618,5,1,226253,226253,226254,0,1,4
64619,2,2,226255,226255,226257,0,2,1
64620,6,1,226261,226261,226262,0,1,4
64621,5,3,226266,226266,226269,0,3,4
64622,1,3,226267,226269,226272,2,5,0
64623,3,1,226270,226272,226273,2,3,0
64624,3,2,226273,226273,226275,0,2,0
64625,4,3,226277,226277,226280,0,3,2
64626,4,2,226281,226281,226283,0,2,1
64627,5,2,226286,226286,226288,0,2,3
64628,2,1,226288,226288,226289,0,1,0
64629,3,1,226291,226291,226292,0,1,2
64630,3,2,226294,226294,226296,0,2,2
64631,4,3,226298,226298,226301,0,3,2
64632,3,2,226301,226301,226303,0,2,0
64633,2,1,226303,226303,226304,0,1,0
64634,1,3,226304,226304,226307,0,3,0
64635,3,3,226307,226307,226310,0,3,0
64636,1,1,226308,226310,226311,2,3,0
64637,1,3,226309,226311,226314,2,5,0
64638,4,1,226313,226314,226315,1,2,0
64639,1,1,226314,226315,226316,1,2,0
64640,3,1,226317,226317,226318,0,1,1
64641,1,1,226318,226318,226319,0,1,0
64642,5,1,226323,226323,226324,0,1,4
64643,3,2,226326,226326,226328,0,2,2
64644,2,3,226328,226328,226331,0,3,0
64645,1,1,226329,226331,226332,2,3,0
64646,5,2,226334,226334,226336,0,2,2
64647,6,3,226340,226340,226343,0,3,4
64648,2,1,226342,226343,226344,1,2,0
64649,2,3,226344,226344,226347,0,3,0
64650,1,3,226345,226347,226350,2,5,0
64651,2,1,226347,226350,226351,3,4,0
64652,1,3,226348,226351,226354,3,6,0
64653,2,1,226350,226354,226355,4,5,0
64654,4,1,226354,226355,226356,1,2,0
64655,6,2,226360,226360,226362,0,2,4
64656,2,3,226362,226362,226365,0,3,0
64657,1,1,226363,226365,226366,2,3,0
64658,1,2,226364,226366,226368,2,4,0
64659,1,3,226365,226368,226371,3,6,0
64660,5,2,226370,226371,226373,1,3,0
64661,3,3,226373,226373,226376,0,3,0
64662,3,1,226376,226376,226377,0,1,0
64663,2,2,226378,226378,226380,0,2,1
64664,6,2,226384,226384,226386,0,2,4
64665,5,3,226389,226389,226392,0,3,3
64666,2,1,226391,226392,226393,1,2,0
64667,2,3,226393,226393,226396,0,3,0
64668,6,2,226399,226399,226401,0,2,3
64669,5,2,226404,226404,226406,0,2,3
64670,5,1,226409,226409,226410,0,1,3
64671,2,2,226411,226411,226413,0,2,1
64672,1,3,226412,226413,226416,1,4,0
64673,4,2,226416,226416,226418,0,2,0
64674,2,3,226418,226418,226421,0,3,0
64675,1,2,226419,226421,226423,2,4,0
64676,4,3,226423,226423,226426,0,3,0
64677,1,3,226424,226426,226429,2,5,0
64678,1,3,226425,226429,226432,4,7,0
64679,5,3,226430,226432,226435,2,5,0
64680,4,1,226434,226435,226436,1,2,0
64681,3,3,226437,226437,226440,0,3,1
64682,4,3,226441,226441,226444,0,3,1
64683,5,3,226446,226446,226449,0,3,2
64684,6,1,226452,226452,226453,0,1,3
64685,5,1,226457,226457,226458,0,1,4
64686,4,3,226461,226461,226464,0,3,3
64687,4,2,226465,226465,226467,0,2,1
64688,6,1,226471,226471,226472,0,1,4
64689,5,1,226476,226476,226477,0,1,4
64690,4,2,226480,226480,226482,0,2,3
64691,1,3,226481,226482,226485,1,4,0
64692,1,2,226482,226485,226487,3,5,0
64693,4,1,226486,226487,226488,1,2,0
64694,6,1,226492,226492,226493,0,1,4
64695,5,3,226497,226497,226500,0,3,4
64696,6,1,226503,226503,226504,0,1,3
64697,2,1,226505,226505,226506,0,1,1
64698,2,1,226507,226507,226508,0,1,1
64699,6,3,226513,226513,226516,0,3,5
64700,4,2,226517,226517,226519,0,2,1
64701,1,1,226518,226519,226520,1,2,0
64702,2,3,226520,226520,226523,0,3,0
64703,2,2,226522,226523,226525,1,3,0
64704,1,1,226523,226525,226526,2,3,0
64705,4,3,226527,226527,226530,0,3,1
64706,2,2,226529,226530,226532,1,3,0
64707,1,1,226530,226532,226533,2,3,0
64708,2,3,226532,226533,226536,1,4,0
64709,6,1,226538,226538,226539,0,1,2
64710,4,1,226542,226542,226543,0,1,3
64711,4,3,226546,226546,226549,0,3,3
64712,1,2,226547,226549,226551,2,4,0
64713,5,1,226552,226552,226553,0,1,1
64714,1,3,226553,226553,226556,0,3,0
64715,2,1,226555,226556,226557,1,2,0
64716,1,3,226556,226557,226560,1,4,0
64717,6,2,226562,226562,226564,0,2,2
64718,3,1,226565,226565,226566,0,1,1
64719,4,3,226569,226569,226572,0,3,3
64720,6,2,226575,226575,226577,0,2,3
64721,2,3,226577,226577,226580,0,3,0
64722,4,3,226581,226581,226584,0,3,1
64723,6,1,226587,226587,226588,0,1,3
64724,5,3,226592,226592,226595,0,3,4
64725,4,3,226596,226596,226599,0,3,1
64726,2,1,226598,226599,226600,1,2,0
64727,4,3,226602,226602,226605,0,3,2
64728,1,3,226603,226605,226608,2,5,0
64729,4,2,226607,226608,226610,1,3,0
64730,3,2,226610,226610,226612,0,2,0
64731,1,3,226611,226612,226615,1,4,0
64732,6,2,226617,226617,226619,0,2,2
64733,2,3,226619,226619,226622,0,3,0
64734,3,2,226622,226622,226624,0,2,0
64735,1,2,226623,226624,226626,1,3,0
64736,1,1,226624,226626,226627,2,3,0
64737,1,2,226625,226627,226629,2,4,0
64738,5,1,226630,226630,226631,0,1,1
64739,1,3,226631,226631,226634,0,3,0
64740,3,3,226634,226634,226637,0,3,0
64741,3,2,226637,226637,226639,0,2,0
64742,5,1,226642,226642,226643,0,1,3
64743,3,3,226645,226645,226648,0,3,2
64744,5,1,226650,226650,226651,0,1,2
64745,6,2,226656,226656,226658,0,2,5
64746,4,3,226660,226660,226663,0,3,2
64747,3,2,226663,226663,226665,0,2,0
64748,4,3,226667,226667,226670,0,3,2
64749,5,3,226672,226672,226675,0,3,2
64750,2,3,226674,226675,226678,1,4,0
64751,6,1,226680,226680,226681,0,1,2
64752,2,1,226682,226682,226683,0,1,1
64753,5,1,226687,226687,226688,0,1,4
64754,3,3,226690,226690,226693,0,3,2
64755,2,2,226692,226693,226695,1,3,0
64756,1,1,226693,226695,226696,2,3,0
64757,4,2,226697,226697,226699,0,2,1
64758,3,3,226700,226700,226703,0,3,1
64759,5,3,226705,226705,226708,0,3,2
64760,3,1,226708,226708,226709,0,1,0
64761,2,2,226710,226710,226712,0,2,1
64762,5,1,226715,226715,226716,0,1,3
64763,6,1,226721,226721,226722,0,1,5
64764,5,1,226726,226726,226727,0,1,4
64765,1,1,226727,226727,226728,0,1,0
64766,6,3,226733,226733,226736,0,3,5
64767,6,2,226739,226739,226741,0,2,3
64768,5,1,226744,226744,226745,0,1,3
64769,3,2,226747,226747,226749,0,2,2
64770,5,3,226752,226752,226755,0,3,3
64771,5,1,226757,226757,226758,0,1,2
64772,1,1,226758,226758,226759,0,1,0
64773,1,2,226759,226759,226761,0,2,0
64774,5,3,226764,226764,226767,0,3,3
64775,4,2,226768,226768,226770,0,2,1
64776,3,3,226771,226771,226774,0,3,1
64777,2,1,226773,226774,226775,1,2,0
64778,4,1,226777,226777,226778,0,1,2
64779,2,3,226779,226779,226782,0,3,1
64780,5,2,226784,226784,226786,0,2,2
64781,3,2,226787,226787,226789,0,2,1
64782,6,3,226793,226793,226796,0,3,4
64783,2,2,226795,226796,226798,1,3,0
64784,6,2,226801,226801,226803,0,2,3
64785,1,1,226802,226803,226804,1,2,0
64786,4,3,226806,226806,226809,0,3,2
64787,1,3,226807,226809,226812,2,5,0
64788,1,3,226808,226812,226815,4,7,0
64789,6,2,226814,226815,226817,1,3,0
64790,3,1,226817,226817,226818,0,1,0
64791,5,2,226822,226822,226824,0,2,4
64792,4,3,226826,226826,226829,0,3,2
64793,3,1,226829,226829,226830,0,1,0
64794,3,2,226832,226832,226834,0,2,2
64795,5,1,226837,226837,226838,0,1,3
64796,5,1,226842,226842,226843,0,1,4
64797,3,3,226845,226845,226848,0,3,2
64798,1,1,226846,226848,226849,2,3,0
64799,1,2,226847,226849,226851,2,4,0
64800,5,1,226852,226852,226853,0,1,1
64801,6,2,226858,226858,226860,0,2,5
64802,1,2,226859,226860,226862,1,3,0
64803,5,1,226864,226864,226865,0,1,2
64804,2,2,226866,226866,226868,0,2,1
64805,2,2,226868,226868,226870,0,2,0
64806,3,2,226871,226871,226873,0,2,1
64807,3,2,226874,226874,226876,0,2,1
64808,2,3,226876,226876,226879,0,3,0
64809,3,1,226879,226879,226880,0,1,0
64810,1,2,226880,226880,226882,0,2,0
64811,3,3,226883,226883,226886,0,3,1
64812,4,1,226887,226887,226888,0,1,1
64813,6,2,226893,226893,226895,0,2,5
64814,1,3,226894,226895,226898,1,4,0
64815,4,1,226898,226898,226899,0,1,0
64816,2,3,226900,226900,226903,0,3,1
64817,2,2,226902,226903,226905,1,3,0
64818,6,1,226908,226908,226909,0,1,3
64819,4,1,226912,226912,226913,0,1,3
64820,6,3,226918,226918,226921,0,3,5
64821,1,2,226919,226921,226923,2,4,0
64822,4,1,226923,226923,226924,0,1,0
64823,3,1,226926,226926,226927,0,1,2
64824,6,3,226932,226932,226935,0,3,5
64825,3,1,226935,226935,226936,0,1,0
64826,3,3,226938,226938,226941,0,3,2
64827,1,2,226939,226941,226943,2,4,0
64828,1,2,226940,226943,226945,3,5,0
64829,3,2,226943,226945,226947,2,4,0
64830,1,3,226944,226947,226950,3,6,0
64831,6,1,226950,226950,226951,0,1,0
64832,2,1,226952,226952,226953,0,1,1
64833,4,2,226956,226956,226958,0,2,3
64834,4,2,226960,226960,226962,0,2,2
64835,2,1,226962,226962,226963,0,1,0
64836,5,2,226967,226967,226969,0,2,4
64837,3,2,226970,226970,226972,0,2,1
64838,4,3,226974,226974,226977,0,3,2
64839,6,3,226980,226980,226983,0,3,3
64840,4,1,226984,226984,226985,0,1,1
64841,2,3,226986,226986,226989,0,3,1
64842,2,3,226988,226989,226992,1,4,0
64843,2,3,226990,226992,226995,2,5,0
64844,1,1,226991,226995,226996,4,5,0
64845,6,3,226997,226997,227000,0,3,1
64846,5,1,227002,227002,227003,0,1,2
64847,3,1,227005,227005,227006,0,1,2
64848,1,1,227006,227006,227007,0,1,0
64849,2,3,227008,227008,227011,0,3,1
64850,2,2,227010,227011,227013,1,3,0
64851,5,1,227015,227015,227016,0,1,2
64852,5,3,227020,227020,227023,0,3,4
64853,2,3,227022,227023,227026,1,4,0
64854,4,2,227026,227026,227028,0,2,0
64855,4,1,227030,227030,227031,0,1,2
64856,4,2,227034,227034,227036,0,2,3
64857,6,1,227040,227040,227041,0,1,4
64858,2,3,227042,227042,227045,0,3,1
64859,4,1,227046,227046,227047,0,1,1
64860,3,1,227049,227049,227050,0,1,2
64861,6,2,227055,227055,227057,0,2,5
64862,1,2,227056,227057,227059,1,3,0
64863,4,3,227060,227060,227063,0,3,1
64864,1,2,227061,227063,227065,2,4,0
64865,5,2,227066,227066,227068,0,2,1
64866,4,1,227070,227070,227071,0,1,2
64867,2,1,227072,227072,227073,0,1,1
64868,2,2,227074,227074,227076,0,2,1
64869,5,1,227079,227079,227080,0,1,3
64870,2,2,227081,227081,227083,0,2,1
64871,1,2,227082,227083,227085,1,3,0
64872,4,1,227086,227086,227087,0,1,1
64873,3,2,227089,227089,227091,0,2,2
64874,1,3,227090,227091,227094,1,4,0
64875,5,2,227095,227095,227097,0,2,1
64876,5,3,227100,227100,227103,0,3,3
64877,4,1,227104,227104,227105,0,1,1
64878,4,1,227108,227108,227109,0,1,3
64879,6,1,227114,227114,227115,0,1,5
64880,3,2,227117,227117,227119,0,2,2
64881,1,1,227118,227119,227120,1,2,0
64882,6,3,227124,227124,227127,0,3,4
64883,2,2,227126,227127,227129,1,3,0
64884,4,2,227130,227130,227132,0,2,1
64885,4,2,227134,227134,227136,0,2,2
64886,2,2,227136,227136,227138,0,2,0
64887,6,2,227142,227142,227144,0,2,4
64888,1,3,227143,227144,227147,1,4,0
64889,1,1,227144,227147,227148,3,4,0
64890,5,2,227149,227149,227151,0,2,1
64891,4,1,227153,227153,227154,0,1,2
64892,2,1,227155,227155,227156,0,1,1
64893,3,1,227158,227158,227159,0,1,2
64894,3,1,227161,227161,227162,0,1,2
64895,6,1,227167,227167,227168,0,1,5
64896,3,3,227170,227170,227173,0,3,2
64897,6,2,227176,227176,227178,0,2,3
64898,2,3,227178,227178,227181,0,3,0
64899,3,3,227181,227181,227184,0,3,0
64900,3,2,227184,227184,227186,0,2,0
64901,1,2,227185,227186,227188,1,3,0
64902,5,3,227190,227190,227193,0,3,2
64903,3,1,227193,227193,227194,0,1,0
64904,2,3,227195,227195,227198,0,3,1
64905,1,1,227196,227198,227199,2,3,0
64906,6,3,227202,227202,227205,0,3,3
64907,5,1,227207,227207,227208,0,1,2
64908,3,3,227210,227210,227213,0,3,2
64909,6,3,227216,227216,227219,0,3,3
64910,6,1,227222,227222,227223,0,1,3
64911,2,1,227224,227224,227225,0,1,1
64912,6,2,227230,227230,227232,0,2,5
64913,2,1,227232,227232,227233,0,1,0
64914,1,1,227233,227233,227234,0,1,0
64915,2,1,227235,227235,227236,0,1,1
64916,5,3,227240,227240,227243,0,3,4
64917,5,3,227245,227245,227248,0,3,2
64918,6,1,227251,227251,227252,0,1,3
64919,3,2,227254,227254,227256,0,2,2
64920,1,2,227255,227256,227258,1,3,0
64921,2,3,227257,227258,227261,1,4,0
64922,3,2,227260,227261,227263,1,3,0
64923,3,3,227263,227263,227266,0,3,0
64924,3,2,227266,227266,227268,0,2,0
64925,5,2,227271,227271,227273,0,2,3
64926,2,1,227273,227273,227274,0,1,0
64927,5,1,227278,227278,227279,0,1,4
64928,6,1,227284,227284,227285,0,1,5
64929,6,3,227290,227290,227293,0,3,5
64930,6,1,227296,227296,227297,0,1,3
64931,4,1,227300,227300,227301,0,1,3
64932,5,1,227305,227305,227306,0,1,4
64933,4,3,227309,227309,227312,0,3,3
64934,2,3,227311,227312,227315,1,4,0
64935,5,1,227316,227316,227317,0,1,1
64936,2,1,227318,227318,227319,0,1,1
64937,5,3,227323,227323,227326,0,3,4
64938,1,1,227324,227326,227327,2,3,0
64939,4,2,227328,227328,227330,0,2,1
64940,5,1,227333,227333,227334,0,1,3
64941,3,1,227336,227336,227337,0,1,2
64942,5,2,227341,227341,227343,0,2,4
64943,6,3,227347,227347,227350,0,3,4
64944,2,3,227349,227350,227353,1,4,0
64945,3,2,227352,227353,227355,1,3,0
64946,1,1,227353,227355,227356,2,3,0
64947,4,1,227357,227357,227358,0,1,1
64948,3,1,227360,227360,227361,0,1,2
64949,5,2,227365,227365,227367,0,2,4
64950,4,2,227369,227369,227371,0,2,2
64951,1,3,227370,227371,227374,1,4,0
64952,3,2,227373,227374,227376,1,3,0
64953,3,3,227376,227376,227379,0,3,0
64954,5,2,227381,227381,227383,0,2,2
64955,2,3,227383,227383,227386,0,3,0
64956,6,2,227389,227389,227391,0,2,3
64957,6,1,227395,227395,227396,0,1,4
64958,4,2,227399,227399,227401,0,2,3
64959,4,1,227403,227403,227404,0,1,2
64960,2,1,227405,227405,227406,0,1,1
64961,2,2,227407,227407,227409,0,2,1
64962,3,2,227410,227410,227412,0,2,1
64963,1,3,227411,227412,227415,1,4,0
64964,4,3,227415,227415,227418,0,3,0
64965,2,3,227417,227418,227421,1,4,0
64966,4,3,227421,227421,227424,0,3,0
64967,5,3,227426,227426,227429,0,3,2
64968,2,2,227428,227429,227431,1,3,0
64969,1,1,227429,227431,227432,2,3,0
64970,5,1,227434,227434,227435,0,1,2
64971,3,1,227437,227437,227438,0,1,2
64972,5,1,227442,227442,227443,0,1,4
64973,2,2,227444,227444,227446,0,2,1
64974,1,2,227445,227446,227448,1,3,0
64975,6,1,227451,227451,227452,0,1,3
64976,6,2,227457,227457,227459,0,2,5
64977,3,3,227460,227460,227463,0,3,1
64978,3,1,227463,227463,227464,0,1,0
64979,6,2,227469,227469,227471,0,2,5
64980,3,2,227472,227472,227474,0,2,1
64981,4,3,227476,227476,227479,0,3,2
64982,6,2,227482,227482,227484,0,2,3
64983,1,2,227483,227484,227486,1,3,0
64984,6,2,227489,227489,227491,0,2,3
64985,4,2,227493,227493,227495,0,2,2
64986,2,3,227495,227495,227498,0,3,0
64987,3,1,227498,227498,227499,0,1,0
64988,4,3,227502,227502,227505,0,3,3
64989,4,2,227506,227506,227508,0,2,1
64990,3,3,227509,227509,227512,0,3,1
64991,6,3,227515,227515,227518,0,3,3
64992,1,2,227516,227518,227520,2,4,0
64993,1,3,227517,227520,227523,3,6,0
64994,6,1,227523,227523,227524,0,1,0
64995,3,3,227526,227526,227529,0,3,2
64996,2,3,227528,227529,227532,1,4,0
64997,3,3,227531,227532,227535,1,4,0
64998,4,2,227535,227535,227537,0,2,0
64999,5,2,227540,227540,227542,0,2,3
65000,2,3,227542,227542,227545,0,3,0
65001,4,1,227546,227546,227547,0,1,1
65002,4,1,227550,227550,227551,0,1,3
65003,6,1,227556,227556,227557,0,1,5
65004,1,1,227557,227557,227558,0,1,0
65005,4,1,227561,227561,227562,0,1,3
65006,1,1,227562,227562,227563,0,1,0
65007,3,2,227565,227565,227567,0,2,2
65008,5,1,227570,227570,227571,0,1,3
65009,4,2,227574,227574,227576,0,2,3
65010,2,2,227576,227576,227578,0,2,0
65011,2,3,227578,227578,227581,0,3,0
65012,1,3,227579,227581,227584,2,5,0
65013,6,1,227585,227585,227586,0,1,1
65014,6,3,227591,227591,227594,0,3,5
65015,3,1,227594,227594,227595,0,1,0
65016,2,2,227596,227596,227598,0,2,1
65017,1,3,227597,227598,227601,1,4,0
65018,1,1,227598,227601,227602,3,4,0
65019,4,2,227602,227602,227604,0,2,0
65020,1,1,227603,227604,227605,1,2,0
65021,1,1,227604,227605,227606,1,2,0
65022,2,1,227606,227606,227607,0,1,0
65023,4,1,227610,227610,227611,0,1,3
65024,1,2,227611,227611,227613,0,2,0
65025,3,1,227614,227614,227615,0,1,1
65026,4,3,227618,227618,227621,0,3,3
65027,1,3,227619,227621,227624,2,5,0
65028,6,2,227625,227625,227627,0,2,1
65029,6,2,227631,227631,227633,0,2,4
65030,5,1,227636,227636,227637,0,1,3
65031,4,3,227640,227640,227643,0,3,3
65032,6,1,227646,227646,227647,0,1,3
65033,2,3,227648,227648,227651,0,3,1
65034,3,3,227651,227651,227654,0,3,0
65035,1,3,227652,227654,227657,2,5,0
65036,3,3,227655,227657,227660,2,5,0
65037,4,2,227659,227660,227662,1,3,0
65038,6,3,227665,227665,227668,0,3,3
65039,1,1,227666,227668,227669,2,3,0
65040,5,1,227671,227671,227672,0,1,2
65041,3,1,227674,227674,227675,0,1,2
65042,1,1,227675,227675,227676,0,1,0
65043,1,3,227676,227676,227679,0,3,0
65044,5,3,227681,227681,227684,0,3,2
65045,3,3,227684,227684,227687,0,3,0
65046,6,3,227690,227690,227693,0,3,3
65047,5,1,227695,227695,227696,0,1,2
65048,5,3,227700,227700,227703,0,3,4
65049,4,2,227704,227704,227706,0,2,1
65050,1,2,227705,227706,227708,1,3,0
65051,6,3,227711,227711,227714,0,3,3
65052,5,2,227716,227716,227718,0,2,2
65053,1,3,227717,227718,227721,1,4,0
65054,4,1,227721,227721,227722,0,1,0
65055,6,3,227727,227727,227730,0,3,5
65056,3,1,227730,227730,227731,0,1,0
65057,5,2,227735,227735,227737,0,2,4
65058,1,1,227736,227737,227738,1,2,0
65059,6,2,227742,227742,227744,0,2,4
65060,4,1,227746,227746,227747,0,1,2
65061,2,3,227748,227748,227751,0,3,1
65062,4,2,227752,227752,227754,0,2,1
65063,6,2,227758,227758,227760,0,2,4
65064,2,3,227760,227760,227763,0,3,0
65065,5,1,227765,227765,227766,0,1,2
65066,2,2,227767,227767,227769,0,2,1
65067,4,2,227771,227771,227773,0,2,2
65068,4,1,227775,227775,227776,0,1,2
65069,3,2,227778,227778,227780,0,2,2
65070,2,2,227780,227780,227782,0,2,0
65071,3,1,227783,227783,227784,0,1,1
65072,3,1,227786,227786,227787,0,1,2
65073,6,2,227792,227792,227794,0,2,5
65074,1,2,227793,227794,227796,1,3,0
65075,4,2,227797,227797,227799,0,2,1
65076,3,2,227800,227800,227802,0,2,1
65077,5,3,227805,227805,227808,0,3,3
65078,6,1,227811,227811,227812,0,1,3
65079,4,2,227815,227815,227817,0,2,3
65080,1,3,227816,227817,227820,1,4,0
65081,6,3,227822,227822,227825,0,3,2
65082,1,1,227823,227825,227826,2,3,0
65083,1,3,227824,227826,227829,2,5,0
65084,5,3,227829,227829,227832,0,3,0
65085,6,3,227835,227835,227838,0,3,3
65086,1,3,227836,227838,227841,2,5,0
65087,3,3,227839,227841,227844,2,5,0
65088,4,3,227843,227844,227847,1,4,0
65089,3,2,227846,227847,227849,1,3,0
65090,4,3,227850,227850,227853,0,3,1
65091,5,1,227855,227855,227856,0,1,2
65092,6,1,227861,227861,227862,0,1,5
65093,5,1,227866,227866,227867,0,1,4
65094,5,1,227871,227871,227872,0,1,4
65095,4,1,227875,227875,227876,0,1,3
65096,5,1,227880,227880,227881,0,1,4
65097,1,3,227881,227881,227884,0,3,0
65098,4,2,227885,227885,227887,0,2,1
65099,4,1,227889,227889,227890,0,1,2
65100,3,1,227892,227892,227893,0,1,2
65101,6,2,227898,227898,227900,0,2,5
65102,5,3,227903,227903,227906,0,3,3
65103,1,2,227904,227906,227908,2,4,0
65104,2,1,227906,227908,227909,2,3,0
65105,3,1,227909,227909,227910,0,1,0
65106,1,2,227910,227910,227912,0,2,0
65107,6,2,227916,227916,227918,0,2,4
65108,1,2,227917,227918,227920,1,3,0
65109,6,3,227923,227923,227926,0,3,3
65110,6,3,227929,227929,227932,0,3,3
65111,6,3,227935,227935,227938,0,3,3
65112,2,1,227937,227938,227939,1,2,0
65113,6,3,227943,227943,227946,0,3,4
65114,1,2,227944,227946,227948,2,4,0
65115,3,3,227947,227948,227951,1,4,0
65116,1,3,227948,227951,227954,3,6,0
65117,3,1,227951,227954,227955,3,4,0
65118,4,2,227955,227955,227957,0,2,0
65119,3,3,227958,227958,227961,0,3,1
65120,4,3,227962,227962,227965,0,3,1
65121,3,2,227965,227965,227967,0,2,0
65122,6,3,227971,227971,227974,0,3,4
65123,4,1,227975,227975,227976,0,1,1
65124,5,3,227980,227980,227983,0,3,4
65125,3,1,227983,227983,227984,0,1,0
65126,6,2,227989,227989,227991,0,2,5
65127,3,2,227992,227992,227994,0,2,1
65128,2,3,227994,227994,227997,0,3,0
65129,3,2,227997,227997,227999,0,2,0
65130,1,1,227998,227999,228000,1,2,0
65131,5,2,228003,228003,228005,0,2,3
65132,2,3,228005,228005,228008,0,3,0
65133,4,2,228009,228009,228011,0,2,1
65134,1,1,228010,228011,228012,1,2,0
65135,3,3,228013,228013,228016,0,3,1
65136,5,1,228018,228018,228019,0,1,2
65137,6,1,228024,228024,228025,0,1,5
65138,4,1,228028,228028,228029,0,1,3
65139,2,2,228030,228030,228032,0,2,1
65140,1,1,228031,228032,228033,1,2,0
65141,6,2,228037,228037,228039,0,2,4
65142,6,3,228043,228043,228046,0,3,4
65143,2,3,228045,228046,228049,1,4,0
65144,6,3,228051,228051,228054,0,3,2
65145,2,1,228053,228054,228055,1,2,0
65146,2,1,228055,228055,228056,0,1,0
65147,6,1,228061,228061,228062,0,1,5
65148,2,3,228063,228063,228066,0,3,1
65149,6,2,228069,228069,228071,0,2,3
65150,2,2,228071,228071,228073,0,2,0
65151,1,1,228072,228073,228074,1,2,0
65152,3,3,228075,228075,228078,0,3,1
65153,4,1,228079,228079,228080,0,1,1
65154,1,2,228080,228080,228082,0,2,0
65155,6,1,228086,228086,228087,0,1,4
65156,1,2,228087,228087,228089,0,2,0
65157,5,3,228092,228092,228095,0,3,3
65158,4,3,228096,228096,228099,0,3,1
65159,2,1,228098,228099,228100,1,2,0
65160,4,3,228102,228102,228105,0,3,2
65161,6,1,228108,228108,228109,0,1,3
65162,1,3,228109,228109,228112,0,3,0
65163,2,1,228111,228112,228113,1,2,0
65164,6,3,228117,228117,228120,0,3,4
65165,2,1,228119,228120,228121,1,2,0
65166,1,3,228120,228121,228124,1,4,0
65167,5,3,228125,228125,228128,0,3,1
65168,1,2,228126,228128,228130,2,4,0
65169,1,1,228127,228130,228131,3,4,0
65170,1,3,228128,228131,228134,3,6,0
65171,3,1,228131,228134,228135,3,4,0
65172,1,3,228132,228135,228138,3,6,0
65173,1,1,228133,228138,228139,5,6,0
65174,6,1,228139,228139,228140,0,1,0
65175,6,1,228145,228145,228146,0,1,5
65176,5,2,228150,228150,228152,0,2,4
65177,2,2,228152,228152,228154,0,2,0
65178,2,1,228154,228154,228155,0,1,0
65179,5,3,228159,228159,228162,0,3,4
65180,6,1,228165,228165,228166,0,1,3
65181,4,1,228169,228169,228170,0,1,3
65182,5,2,228174,228174,228176,0,2,4
65183,2,1,228176,228176,228177,0,1,0
65184,2,2,228178,228178,228180,0,2,1
65185,3,3,228181,228181,228184,0,3,1
65186,5,1,228186,228186,228187,0,1,2
65187,4,1,228190,228190,228191,0,1,3
65188,4,3,228194,228194,228197,0,3,3
65189,4,3,228198,228198,228201,0,3,1
65190,3,3,228201,228201,228204,0,3,0
65191,2,2,228203,228204,228206,1,3,0
65192,6,3,228209,228209,228212,0,3,3
65193,4,3,228213,228213,228216,0,3,1
65194,1,2,228214,228216,228218,2,4,0
65195,5,1,228219,228219,228220,0,1,1
65196,5,1,228224,228224,228225,0,1,4
65197,1,1,228225,228225,228226,0,1,0
65198,3,1,228228,228228,228229,0,1,2
65199,6,2,228234,228234,228236,0,2,5
65200,4,2,228238,228238,228240,0,2,2
65201,5,2,228243,228243,228245,0,2,3
65202,1,3,228244,228245,228248,1,4,0
65203,2,2,228246,228248,228250,2,4,0
65204,2,3,228248,228250,228253,2,5,0
65205,5,3,228253,228253,228256,0,3,0
65206,2,3,228255,228256,228259,1,4,0
65207,6,1,228261,228261,228262,0,1,2
65208,2,3,228263,228263,228266,0,3,1
65209,1,1,228264,228266,228267,2,3,0
65210,6,2,228270,228270,228272,0,2,3
65211,5,2,228275,228275,228277,0,2,3
65212,3,3,228278,228278,228281,0,3,1
65213,1,2,228279,228281,228283,2,4,0
65214,5,3,228284,228284,228287,0,3,1
65215,4,2,228288,228288,228290,0,2,1
65216,4,2,228292,228292,228294,0,2,2
65217,3,1,228295,228295,228296,0,1,1
65218,4,1,228299,228299,228300,0,1,3
65219,1,2,228300,228300,228302,0,2,0
65220,3,3,228303,228303,228306,0,3,1
65221,3,3,228306,228306,228309,0,3,0
65222,4,3,228310,228310,228313,0,3,1
65223,4,1,228314,228314,228315,0,1,1
65224,3,1,228317,228317,228318,0,1,2
65225,6,2,228323,228323,228325,0,2,5
65226,4,3,228327,228327,228330,0,3,2
65227,4,1,228331,228331,228332,0,1,1
65228,6,3,228337,228337,228340,0,3,5
65229,6,3,228343,228343,228346,0,3,3
65230,6,1,228349,228349,228350,0,1,3
65231,1,1,228350,228350,228351,0,1,0
65232,5,1,228355,228355,228356,0,1,4
65233,3,1,228358,228358,228359,0,1,2
65234,5,1,228363,228363,228364,0,1,4
65235,3,3,228366,228366,228369,0,3,2
65236,5,1,228371,228371,228372,0,1,2
65237,5,2,228376,228376,228378,0,2,4
65238,6,2,228382,228382,228384,0,2,4
65239,2,2,228384,228384,228386,0,2,0
65240,6,3,228390,228390,228393,0,3,4
65241,6,3,228396,228396,228399,0,3,3
65242,1,2,228397,228399,228401,2,4,0
65243,2,2,228399,228401,228403,2,4,0
65244,3,2,228402,228403,228405,1,3,0
65245,1,1,228403,228405,228406,2,3,0
65246,5,3,228408,228408,228411,0,3,2
65247,1,3,228409,228411,228414,2,5,0
65248,2,1,228411,228414,228415,3,4,0
65249,1,3,228412,228415,228418,3,6,0
65250,1,3,228413,228418,228421,5,8,0
65251,3,1,228416,228421,228422,5,6,0
65252,3,2,228419,228422,228424,3,5,0
65253,3,3,228422,228424,228427,2,5,0
65254,5,3,228427,228427,228430,0,3,0
65255,6,1,228433,228433,228434,0,1,3
65256,1,1,228434,228434,228435,0,1,0
65257,5,2,228439,228439,228441,0,2,4
65258,3,1,228442,228442,228443,0,1,1
65259,2,2,228444,228444,228446,0,2,1
65260,2,3,228446,228446,228449,0,3,0
65261,6,2,228452,228452,228454,0,2,3
65262,3,2,228455,228455,228457,0,2,1
65263,5,1,228460,228460,228461,0,1,3
65264,2,3,228462,228462,228465,0,3,1
65265,5,2,228467,228467,228469,0,2,2
65266,4,1,228471,228471,228472,0,1,2
65267,1,2,228472,228472,228474,0,2,0
65268,5,3,228477,228477,228480,0,3,3
65269,3,3,228480,228480,228483,0,3,0
65270,1,1,228481,228483,228484,2,3,0
65271,6,2,228487,228487,228489,0,2,3
65272,2,2,228489,228489,228491,0,2,0
65273,2,1,228491,228491,228492,0,1,0
65274,6,3,228497,228497,228500,0,3,5
65275,6,1,228503,228503,228504,0,1,3
65276,1,1,228504,228504,228505,0,1,0
65277,4,2,228508,228508,228510,0,2,3
65278,4,2,228512,228512,228514,0,2,2
65279,2,1,228514,228514,228515,0,1,0
65280,4,2,228518,228518,228520,0,2,3
65281,3,3,228521,228521,228524,0,3,1
65282,4,1,228525,228525,228526,0,1,1
65283,4,3,228529,228529,228532,0,3,3
65284,1,1,228530,228532,228533,2,3,0
65285,4,2,228534,228534,228536,0,2,1
65286,6,2,228540,228540,228542,0,2,4
65287,5,1,228545,228545,228546,0,1,3
65288,4,2,228549,228549,228551,0,2,3
65289,5,3,228554,228554,228557,0,3,3
65290,4,2,228558,228558,228560,0,2,1
65291,1,2,228559,228560,228562,1,3,0
65292,6,3,228565,228565,228568,0,3,3
65293,1,3,228566,228568,228571,2,5,0
65294,5,1,228571,228571,228572,0,1,0
65295,1,3,228572,228572,228575,0,3,0
65296,5,2,228577,228577,228579,0,2,2
65297,4,3,228581,228581,228584,0,3,2
65298,5,2,228586,228586,228588,0,2,2
65299,2,1,228588,228588,228589,0,1,0
65300,4,3,228592,228592,228595,0,3,3
65301,3,3,228595,228595,228598,0,3,0
65302,6,3,228601,228601,228604,0,3,3
65303,1,2,228602,228604,228606,2,4,0
65304,1,2,228603,228606,228608,3,5,0
65305,2,2,228605,228608,228610,3,5,0
65306,3,3,228608,228610,228613,2,5,0
65307,6,1,228614,228614,228615,0,1,1
65308,1,2,228615,228615,228617,0,2,0
65309,6,3,228621,228621,228624,0,3,4
65310,4,3,228625,228625,228628,0,3,1
65311,1,2,228626,228628,228630,2,4,0
65312,4,1,228630,228630,228631,0,1,0
65313,3,1,228633,228633,228634,0,1,2
65314,4,1,228637,228637,228638,0,1,3
65315,1,2,228638,228638,228640,0,2,0
65316,2,3,228640,228640,228643,0,3,0
65317,1,1,228641,228643,228644,2,3,0
65318,1,1,228642,228644,228645,2,3,0
65319,1,2,228643,228645,228647,2,4,0
65320,5,2,228648,228648,228650,0,2,1
65321,1,1,228649,228650,228651,1,2,0
65322,3,1,228652,228652,228653,0,1,1
65323,3,3,228655,228655,228658,0,3,2
65324,3,3,228658,228658,228661,0,3,0
65325,6,2,228664,228664,228666,0,2,3
65326,5,1,228669,228669,228670,0,1,3
65327,2,1,228671,228671,228672,0,1,1
65328,3,3,228674,228674,228677,0,3,2
65329,2,2,228676,228677,228679,1,3,0
65330,1,1,228677,228679,228680,2,3,0
65331,5,3,228682,228682,228685,0,3,2
65332,6,2,228688,228688,228690,0,2,3
65333,6,3,228694,228694,228697,0,3,4
65334,1,2,228695,228697,228699,2,4,0
65335,4,2,228699,228699,228701,0,2,0
65336,1,3,228700,228701,228704,1,4,0
65337,2,1,228702,228704,228705,2,3,0
65338,2,1,228704,228705,228706,1,2,0
65339,6,1,228710,228710,228711,0,1,4
65340,4,1,228714,228714,228715,0,1,3
65341,2,2,228716,228716,228718,0,2,1
65342,4,1,228720,228720,228721,0,1,2
65343,1,1,228721,228721,228722,0,1,0
65344,1,1,228722,228722,228723,0,1,0
65345,5,2,228727,228727,228729,0,2,4
65346,1,2,228728,228729,228731,1,3,0
65347,2,1,228730,228731,228732,1,2,0
65348,2,3,228732,228732,228735,0,3,0
65349,3,3,228735,228735,228738,0,3,0
65350,6,3,228741,228741,228744,0,3,3
65351,5,3,228746,228746,228749,0,3,2
65352,6,1,228752,228752,228753,0,1,3
65353,4,2,228756,228756,228758,0,2,3
65354,3,3,228759,228759,228762,0,3,1
65355,5,3,228764,228764,228767,0,3,2
65356,1,2,228765,228767,228769,2,4,0
65357,1,2,228766,228769,228771,3,5,0
65358,3,1,228769,228771,228772,2,3,0
65359,3,1,228772,228772,228773,0,1,0
65360,5,1,228777,228777,228778,0,1,4
65361,1,1,228778,228778,228779,0,1,0
65362,3,2,228781,228781,228783,0,2,2
65363,6,2,228787,228787,228789,0,2,4
65364,6,3,228793,228793,228796,0,3,4
65365,2,3,228795,228796,228799,1,4,0
65366,2,3,228797,228799,228802,2,5,0
65367,6,3,228803,228803,228806,0,3,1
65368,2,2,228805,228806,228808,1,3,0
65369,1,3,228806,228808,228811,2,5,0
65370,2,2,228808,228811,228813,3,5,0
65371,2,2,228810,228813,228815,3,5,0
65372,1,1,228811,228815,228816,4,5,0
65373,1,1,228812,228816,228817,4,5,0
65374,2,1,228814,228817,228818,3,4,0
65375,1,3,228815,228818,228821,3,6,0
65376,2,2,228817,228821,228823,4,6,0
65377,3,2,228820,228823,228825,3,5,0
65378,4,2,228824,228825,228827,1,3,0
65379,6,3,228830,228830,228833,0,3,3
65380,3,3,228833,228833,228836,0,3,0
65381,6,2,228839,228839,228841,0,2,3
65382,1,3,228840,228841,228844,1,4,0
65383,1,1,228841,228844,228845,3,4,0
65384,4,3,228845,228845,228848,0,3,0
65385,2,2,228847,228848,228850,1,3,0
65386,3,2,228850,228850,228852,0,2,0
65387,1,2,228851,228852,228854,1,3,0
65388,2,3,228853,228854,228857,1,4,0
65389,6,2,228859,228859,228861,0,2,2
65390,3,3,228862,228862,228865,0,3,1
65391,4,1,228866,228866,228867,0,1,1
65392,4,2,228870,228870,228872,0,2,3
65393,3,3,228873,228873,228876,0,3,1
65394,3,1,228876,228876,228877,0,1,0
65395,3,3,228879,228879,228882,0,3,2
65396,5,2,228884,228884,228886,0,2,2
65397,3,2,228887,228887,228889,0,2,1
65398,1,2,228888,228889,228891,1,3,0
65399,5,1,228893,228893,228894,0,1,2
65400,3,3,228896,228896,228899,0,3,2
65401,5,1,228901,228901,228902,0,1,2
65402,1,1,228902,228902,228903,0,1,0
65403,6,1,228908,228908,228909,0,1,5
65404,4,3,228912,228912,228915,0,3,3
65405,6,1,228918,228918,228919,0,1,3
65406,4,3,228922,228922,228925,0,3,3
65407,6,3,228928,228928,228931,0,3,3
65408,4,2,228932,228932,228934,0,2,1
65409,6,2,228938,228938,228940,0,2,4
65410,4,1,228942,228942,228943,0,1,2
65411,5,3,228947,228947,228950,0,3,4
65412,3,2,228950,228950,228952,0,2,0
65413,2,2,228952,228952,228954,0,2,0
65414,5,1,228957,228957,228958,0,1,3
65415,5,1,228962,228962,228963,0,1,4
65416,1,3,228963,228963,228966,0,3,0
65417,5,3,228968,228968,228971,0,3,2
65418,2,2,228970,228971,228973,1,3,0
65419,4,2,228974,228974,228976,0,2,1
65420,5,2,228979,228979,228981,0,2,3
65421,2,3,228981,228981,228984,0,3,0
65422,4,1,228985,228985,228986,0,1,1
65423,6,1,228991,228991,228992,0,1,5
65424,5,1,228996,228996,228997,0,1,4
65425,1,1,228997,228997,228998,0,1,0
65426,5,2,229002,229002,229004,0,2,4
65427,2,2,229004,229004,229006,0,2,0
65428,4,1,229008,229008,229009,0,1,2
65429,4,1,229012,229012,229013,0,1,3
65430,6,2,229018,229018,229020,0,2,5
65431,2,1,229020,229020,229021,0,1,0
65432,4,3,229024,229024,229027,0,3,3
65433,2,3,229026,229027,229030,1,4,0
65434,3,2,229029,229030,229032,1,3,0
65435,4,3,229033,229033,229036,0,3,1
65436,3,3,229036,229036,229039,0,3,0
65437,4,1,229040,229040,229041,0,1,1
65438,2,1,229042,229042,229043,0,1,1
65439,4,3,229046,229046,229049,0,3,3
65440,6,2,229052,229052,229054,0,2,3
65441,3,1,229055,229055,229056,0,1,1
65442,5,1,229060,229060,229061,0,1,4
65443,5,2,229065,229065,229067,0,2,4
65444,3,3,229068,229068,229071,0,3,1
65445,2,3,229070,229071,229074,1,4,0
65446,1,2,229071,229074,229076,3,5,0
65447,1,3,229072,229076,229079,4,7,0
65448,4,1,229076,229079,229080,3,4,0
65449,3,3,229079,229080,229083,1,4,0
65450,6,3,229085,229085,229088,0,3,2
65451,5,3,229090,229090,229093,0,3,2
65452,2,2,229092,229093,229095,1,3,0
65453,4,2,229096,229096,229098,0,2,1
65454,3,1,229099,229099,229100,0,1,1
65455,1,3,229100,229100,229103,0,3,0
65456,4,1,229104,229104,229105,0,1,1
65457,6,1,229110,229110,229111,0,1,5
65458,6,2,229116,229116,229118,0,2,5
65459,3,1,229119,229119,229120,0,1,1
65460,3,3,229122,229122,229125,0,3,2
65461,1,1,229123,229125,229126,2,3,0
65462,4,1,229127,229127,229128,0,1,1
65463,4,2,229131,229131,229133,0,2,3
65464,3,2,229134,229134,229136,0,2,1
65465,3,3,229137,229137,229140,0,3,1
65466,1,2,229138,229140,229142,2,4,0
65467,1,2,229139,229142,229144,3,5,0
65468,3,3,229142,229144,229147,2,5,0
65469,2,3,229144,229147,229150,3,6,0
65470,4,2,229148,229150,229152,2,4,0
65471,2,1,229150,229152,229153,2,3,0
65472,4,1,229154,229154,229155,0,1,1
65473,1,1,229155,229155,229156,0,1,0
65474,3,1,229158,229158,229159,0,1,2
65475,2,1,229160,229160,229161,0,1,1
65476,5,1,229165,229165,229166,0,1,4
65477,4,2,229169,229169,229171,0,2,3
65478,4,2,229173,229173,229175,0,2,2
65479,5,2,229178,229178,229180,0,2,3
65480,3,1,229181,229181,229182,0,1,1
65481,3,1,229184,229184,229185,0,1,2
65482,3,2,229187,229187,229189,0,2,2
65483,5,2,229192,229192,229194,0,2,3
65484,2,2,229194,229194,229196,0,2,0
65485,1,3,229195,229196,229199,1,4,0
65486,3,2,229198,229199,229201,1,3,0
65487,2,1,229200,229201,229202,1,2,0
65488,4,1,229204,229204,229205,0,1,2
65489,1,1,229205,229205,229206,0,1,0
65490,1,2,229206,229206,229208,0,2,0
65491,6,3,229212,229212,229215,0,3,4
65492,2,1,229214,229215,229216,1,2,0
65493,2,3,229216,229216,229219,0,3,0
65494,6,3,229222,229222,229225,0,3,3
65495,3,2,229225,229225,229227,0,2,0
65496,3,1,229228,229228,229229,0,1,1
65497,5,1,229233,229233,229234,0,1,4
65498,4,1,229237,229237,229238,0,1,3
65499,4,3,229241,229241,229244,0,3,3
65500,1,3,229242,229244,229247,2,5,0
65501,4,2,229246,229247,229249,1,3,0
65502,6,1,229252,229252,229253,0,1,3
65503,2,2,229254,229254,229256,0,2,1
65504,6,2,229260,229260,229262,0,2,4
65505,3,3,229263,229263,229266,0,3,1
65506,6,3,229269,229269,229272,0,3,3
65507,2,1,229271,229272,229273,1,2,0
65508,4,3,229275,229275,229278,0,3,2
65509,2,2,229277,229278,229280,1,3,0
65510,1,2,229278,229280,229282,2,4,0
65511,2,3,229280,229282,229285,2,5,0
65512,5,2,229285,229285,229287,0,2,0
65513,2,1,229287,229287,229288,0,1,0
65514,3,2,229290,229290,229292,0,2,2
65515,2,2,229292,229292,229294,0,2,0
65516,6,3,229298,229298,229301,0,3,4
65517,4,1,229302,229302,229303,0,1,1
65518,1,3,229303,229303,229306,0,3,0
65519,6,3,229309,229309,229312,0,3,3
65520,4,3,229313,229313,229316,0,3,1
65521,1,2,229314,229316,229318,2,4,0
65522,2,3,229316,229318,229321,2,5,0
65523,2,1,229318,229321,229322,3,4,0
65524,3,3,229321,229322,229325,1,4,0
65525,6,2,229327,229327,229329,0,2,2
65526,4,1,229331,229331,229332,0,1,2
65527,6,1,229337,229337,229338,0,1,5
65528,2,1,229339,229339,229340,0,1,1
65529,5,3,229344,229344,229347,0,3,4
65530,2,3,229346,229347,229350,1,4,0
65531,3,1,229349,229350,229351,1,2,0
65532,6,3,229355,229355,229358,0,3,4
65533,3,3,229358,229358,229361,0,3,0
65534,6,1,229364,229364,229365,0,1,3
65535,6,1,229370,229370,229371,0,1,5
65536,6,2,229376,229376,229378,0,2,5
65537,3,1,229379,229379,229380,0,1,1
65538,5,2,229384,229384,229386,0,2,4
65539,5,3,229389,229389,229392,0,3,3
65540,6,3,229395,229395,229398,0,3,3
65541,2,3,229397,229398,229401,1,4,0
65542,4,2,229401,229401,229403,0,2,0
65543,1,1,229402,229403,229404,1,2,0
65544,4,2,229406,229406,229408,0,2,2
65545,4,2,229410,229410,229412,0,2,2
65546,3,1,229413,229413,229414,0,1,1
65547,3,2,229416,229416,229418,0,2,2
65548,4,1,229420,229420,229421,0,1,2
65549,3,1,229423,229423,229424,0,1,2
65550,4,1,229427,229427,229428,0,1,3
65551,1,1,229428,229428,229429,0,1,0
65552,6,1,229434,229434,229435,0,1,5
65553,1,2,229435,229435,229437,0,2,0
65554,6,1,229441,229441,229442,0,1,4
65555,2,3,229443,229443,229446,0,3,1
65556,6,2,229449,229449,229451,0,2,3
65557,3,1,229452,229452,229453,0,1,1
65558,2,2,229454,229454,229456,0,2,1
65559,1,3,229455,229456,229459,1,4,0
65560,2,1,229457,229459,229460,2,3,0
65561,1,1,229458,229460,229461,2,3,0
65562,3,2,229461,229461,229463,0,2,0
65563,3,2,229464,229464,229466,0,2,1
65564,6,3,229470,229470,229473,0,3,4
65565,3,1,229473,229473,229474,0,1,0
65566,6,2,229479,229479,229481,0,2,5
65567,6,2,229485,229485,229487,0,2,4
65568,6,3,229491,229491,229494,0,3,4
65569,3,3,229494,229494,229497,0,3,0
65570,1,1,229495,229497,229498,2,3,0
65571,6,2,229501,229501,229503,0,2,3
65572,1,3,229502,229503,229506,1,4,0
65573,6,2,229508,229508,229510,0,2,2
65574,4,2,229512,229512,229514,0,2,2
65575,5,3,229517,229517,229520,0,3,3
65576,4,1,229521,229521,229522,0,1,1
65577,6,3,229527,229527,229530,0,3,5
65578,2,2,229529,229530,229532,1,3,0
65579,4,2,229533,229533,229535,0,2,1
65580,5,1,229538,229538,229539,0,1,3
65581,5,1,229543,229543,229544,0,1,4
65582,4,3,229547,229547,229550,0,3,3
65583,2,1,229549,229550,229551,1,2,0
65584,4,2,229553,229553,229555,0,2,2
65585,6,3,229559,229559,229562,0,3,4
65586,5,2,229564,229564,229566,0,2,2
65587,6,1,229570,229570,229571,0,1,4
65588,5,2,229575,229575,229577,0,2,4
65589,1,3,229576,229577,229580,1,4,0
65590,1,2,229577,229580,229582,3,5,0
65591,3,3,229580,229582,229585,2,5,0
65592,5,3,229585,229585,229588,0,3,0
65593,2,1,229587,229588,229589,1,2,0
65594,2,2,229589,229589,229591,0,2,0
65595,3,1,229592,229592,229593,0,1,1
65596,3,3,229595,229595,229598,0,3,2
65597,6,2,229601,229601,229603,0,2,3
65598,2,2,229603,229603,229605,0,2,0
65599,6,1,229609,229609,229610,0,1,4
65600,5,3,229614,229614,229617,0,3,4
65601,5,1,229619,229619,229620,0,1,2
65602,3,1,229622,229622,229623,0,1,2
65603,6,2,229628,229628,229630,0,2,5
65604,5,1,229633,229633,229634,0,1,3
65605,6,2,229639,229639,229641,0,2,5
65606,4,3,229643,229643,229646,0,3,2
65607,1,2,229644,229646,229648,2,4,0
65608,5,3,229649,229649,229652,0,3,1
65609,4,3,229653,229653,229656,0,3,1
65610,2,1,229655,229656,229657,1,2,0
65611,2,1,229657,229657,229658,0,1,0
65612,6,3,229663,229663,229666,0,3,5
65613,5,2,229668,229668,229670,0,2,2
65614,1,2,229669,229670,229672,1,3,0
65615,5,3,229674,229674,229677,0,3,2
65616,1,1,229675,229677,229678,2,3,0
65617,3,1,229678,229678,229679,0,1,0
65618,1,3,229679,229679,229682,0,3,0
65619,2,1,229681,229682,229683,1,2,0
65620,3,1,229684,229684,229685,0,1,1
65621,3,1,229687,229687,229688,0,1,2
65622,1,2,229688,229688,229690,0,2,0
65623,4,3,229692,229692,229695,0,3,2
65624,4,1,229696,229696,229697,0,1,1
65625,1,1,229697,229697,229698,0,1,0
65626,4,1,229701,229701,229702,0,1,3
65627,6,1,229707,229707,229708,0,1,5
65628,1,2,229708,229708,229710,0,2,0
65629,6,2,229714,229714,229716,0,2,4
65630,6,3,229720,229720,229723,0,3,4
65631,3,1,229723,229723,229724,0,1,0
65632,2,2,229725,229725,229727,0,2,1
65633,2,1,229727,229727,229728,0,1,0
65634,1,1,229728,229728,229729,0,1,0
65635,6,2,229734,229734,229736,0,2,5
65636,3,3,229737,229737,229740,0,3,1
65637,2,1,229739,229740,229741,1,2,0
65638,6,1,229745,229745,229746,0,1,4
65639,5,3,229750,229750,229753,0,3,4
65640,3,2,229753,229753,229755,0,2,0
65641,2,3,229755,229755,229758,0,3,0
65642,6,1,229761,229761,229762,0,1,3
65643,4,3,229765,229765,229768,0,3,3
65644,3,3,229768,229768,229771,0,3,0
65645,4,2,229772,229772,229774,0,2,1
65646,1,2,229773,229774,229776,1,3,0
65647,2,1,229775,229776,229777,1,2,0
65648,6,1,229781,229781,229782,0,1,4
65649,4,3,229785,229785,229788,0,3,3
65650,6,1,229791,229791,229792,0,1,3
65651,1,2,229792,229792,229794,0,2,0
65652,1,2,229793,229794,229796,1,3,0
65653,3,1,229796,229796,229797,0,1,0
65654,5,2,229801,229801,229803,0,2,4
65655,3,1,229804,229804,229805,0,1,1
65656,2,1,229806,229806,229807,0,1,1
65657,2,3,229808,229808,229811,0,3,1
65658,3,3,229811,229811,229814,0,3,0
65659,4,3,229815,229815,229818,0,3,1
65660,5,1,229820,229820,229821,0,1,2
65661,4,2,229824,229824,229826,0,2,3
65662,2,2,229826,229826,229828,0,2,0
65663,1,3,229827,229828,229831,1,4,0
65664,1,2,229828,229831,229833,3,5,0
65665,6,1,229834,229834,229835,0,1,1
65666,4,3,229838,229838,229841,0,3,3
65667,1,1,229839,229841,229842,2,3,0
65668,3,2,229842,229842,229844,0,2,0
65669,2,2,229844,229844,229846,0,2,0
65670,4,1,229848,229848,229849,0,1,2
65671,5,3,229853,229853,229856,0,3,4
65672,2,3,229855,229856,229859,1,4,0
65673,4,2,229859,229859,229861,0,2,0
65674,5,1,229864,229864,229865,0,1,3
65675,2,2,229866,229866,229868,0,2,1
65676,5,1,229871,229871,229872,0,1,3
65677,1,2,229872,229872,229874,0,2,0
65678,5,3,229877,229877,229880,0,3,3
65679,6,3,229883,229883,229886,0,3,3
65680,5,3,229888,229888,229891,0,3,2
65681,6,3,229894,229894,229897,0,3,3
65682,2,3,229896,229897,229900,1,4,0
65683,4,3,229900,229900,229903,0,3,0
65684,2,1,229902,229903,229904,1,2,0
65685,3,3,229905,229905,229908,0,3,1
65686,5,2,229910,229910,229912,0,2,2
65687,4,2,229914,229914,229916,0,2,2
65688,5,3,229919,229919,229922,0,3,3
65689,4,1,229923,229923,229924,0,1,1
65690,2,2,229925,229925,229927,0,2,1
65691,3,3,229928,229928,229931,0,3,1
65692,5,2,229933,229933,229935,0,2,2
65693,6,2,229939,229939,229941,0,2,4
65694,4,3,229943,229943,229946,0,3,2
65695,5,3,229948,229948,229951,0,3,2
65696,3,2,229951,229951,229953,0,2,0
65697,6,1,229957,229957,229958,0,1,4
65698,3,2,229960,229960,229962,0,2,2
65699,3,2,229963,229963,229965,0,2,1
65700,1,2,229964,229965,229967,1,3,0
65701,6,1,229970,229970,229971,0,1,3
65702,2,1,229972,229972,229973,0,1,1
65703,4,3,229976,229976,229979,0,3,3
65704,3,1,229979,229979,229980,0,1,0
65705,5,2,229984,229984,229986,0,2,4
65706,6,1,229990,229990,229991,0,1,4
65707,3,1,229993,229993,229994,0,1,2
65708,2,1,229995,229995,229996,0,1,1
65709,1,2,229996,229996,229998,0,2,0
65710,4,2,230000,230000,230002,0,2,2
65711,2,3,230002,230002,230005,0,3,0
65712,2,3,230004,230005,230008,1,4,0
65713,3,3,230007,230008,230011,1,4,0
65714,1,3,230008,230011,230014,3,6,0
65715,2,3,230010,230014,230017,4,7,0
65716,1,1,230011,230017,230018,6,7,0
65717,1,3,230012,230018,230021,6,9,0
65718,3,1,230015,230021,230022,6,7,0
65719,4,2,230019,230022,230024,3,5,0
65720,6,3,230025,230025,230028,0,3,1
65721,5,3,230030,230030,230033,0,3,2
65722,3,1,230033,230033,230034,0,1,0
65723,3,3,230036,230036,230039,0,3,2
65724,3,1,230039,230039,230040,0,1,0
65725,1,3,230040,230040,230043,0,3,0
65726,6,3,230046,230046,230049,0,3,3
65727,5,3,230051,230051,230054,0,3,2
65728,2,3,230053,230054,230057,1,4,0
65729,2,2,230055,230057,230059,2,4,0
65730,6,3,230061,230061,230064,0,3,2
65731,2,1,230063,230064,230065,1,2,0
65732,2,1,230065,230065,230066,0,1,0
65733,5,1,230070,230070,230071,0,1,4
65734,5,1,230075,230075,230076,0,1,4
65735,4,1,230079,230079,230080,0,1,3
65736,1,2,230080,230080,230082,0,2,0
65737,3,2,230083,230083,230085,0,2,1
65738,2,1,230085,230085,230086,0,1,0
65739,4,1,230089,230089,230090,0,1,3
65740,1,1,230090,230090,230091,0,1,0
65741,6,2,230096,230096,230098,0,2,5
65742,3,3,230099,230099,230102,0,3,1
65743,2,1,230101,230102,230103,1,2,0
65744,6,1,230107,230107,230108,0,1,4
65745,5,1,230112,230112,230113,0,1,4
65746,2,2,230114,230114,230116,0,2,1
65747,4,1,230118,230118,230119,0,1,2
65748,4,1,230122,230122,230123,0,1,3
65749,3,2,230125,230125,230127,0,2,2
65750,5,1,230130,230130,230131,0,1,3
65751,6,3,230136,230136,230139,0,3,5
65752,4,2,230140,230140,230142,0,2,1
65753,1,2,230141,230142,230144,1,3,0
65754,5,3,230146,230146,230149,0,3,2
65755,6,1,230152,230152,230153,0,1,3
65756,1,1,230153,230153,230154,0,1,0
65757,5,2,230158,230158,230160,0,2,4
65758,2,3,230160,230160,230163,0,3,0
65759,5,3,230165,230165,230168,0,3,2
65760,5,3,230170,230170,230173,0,3,2
65761,2,3,230172,230173,230176,1,4,0
65762,2,1,230174,230176,230177,2,3,0
65763,1,3,230175,230177,230180,2,5,0
65764,1,1,230176,230180,230181,4,5,0
65765,3,2,230179,230181,230183,2,4,0
65766,4,2,230183,230183,230185,0,2,0
65767,5,2,230188,230188,230190,0,2,3
65768,2,2,230190,230190,230192,0,2,0
65769,4,1,230194,230194,230195,0,1,2
65770,5,2,230199,230199,230201,0,2,4
65771,5,2,230204,230204,230206,0,2,3
65772,2,3,230206,230206,230209,0,3,0
65773,1,3,230207,230209,230212,2,5,0
65774,4,1,230211,230212,230213,1,2,0
65775,5,1,230216,230216,230217,0,1,3
65776,1,2,230217,230217,230219,0,2,0
65777,2,2,230219,230219,230221,0,2,0
65778,2,3,230221,230221,230224,0,3,0
65779,4,2,230225,230225,230227,0,2,1
65780,6,1,230231,230231,230232,0,1,4
65781,4,2,230235,230235,230237,0,2,3
65782,2,2,230237,230237,230239,0,2,0
65783,2,2,230239,230239,230241,0,2,0
65784,5,1,230244,230244,230245,0,1,3
65785,5,2,230249,230249,230251,0,2,4
65786,4,3,230253,230253,230256,0,3,2
65787,5,1,230258,230258,230259,0,1,2
65788,6,1,230264,230264,230265,0,1,5
65789,5,2,230269,230269,230271,0,2,4
65790,6,2,230275,230275,230277,0,2,4
65791,5,2,230280,230280,230282,0,2,3
65792,3,2,230283,230283,230285,0,2,1
65793,3,3,230286,230286,230289,0,3,1
65794,6,3,230292,230292,230295,0,3,3
65795,2,1,230294,230295,230296,1,2,0
65796,5,3,230299,230299,230302,0,3,3
65797,1,2,230300,230302,230304,2,4,0
65798,2,2,230302,230304,230306,2,4,0
65799,4,2,230306,230306,230308,0,2,0
65800,6,2,230312,230312,230314,0,2,4
65801,1,1,230313,230314,230315,1,2,0
65802,6,1,230319,230319,230320,0,1,4
65803,1,3,230320,230320,230323,0,3,0
65804,4,3,230324,230324,230327,0,3,1
65805,5,3,230329,230329,230332,0,3,2
65806,4,1,230333,230333,230334,0,1,1
65807,6,2,230339,230339,230341,0,2,5
65808,2,3,230341,230341,230344,0,3,0
65809,2,3,230343,230344,230347,1,4,0
65810,5,1,230348,230348,230349,0,1,1
65811,5,2,230353,230353,230355,0,2,4
65812,3,1,230356,230356,230357,0,1,1
65813,5,2,230361,230361,230363,0,2,4
65814,1,2,230362,230363,230365,1,3,0
65815,6,2,230368,230368,230370,0,2,3
65816,6,3,230374,230374,230377,0,3,4
65817,4,1,230378,230378,230379,0,1,1
65818,6,3,230384,230384,230387,0,3,5
65819,4,3,230388,230388,230391,0,3,1
65820,3,2,230391,230391,230393,0,2,0
65821,4,1,230395,230395,230396,0,1,2
65822,2,2,230397,230397,230399,0,2,1
65823,1,1,230398,230399,230400,1,2,0
65824,1,3,230399,230400,230403,1,4,0
65825,5,1,230404,230404,230405,0,1,1
65826,2,2,230406,230406,230408,0,2,1
65827,5,1,230411,230411,230412,0,1,3
65828,5,1,230416,230416,230417,0,1,4
65829,3,1,230419,230419,230420,0,1,2
65830,4,3,230423,230423,230426,0,3,3
65831,6,1,230429,230429,230430,0,1,3
65832,4,2,230433,230433,230435,0,2,3
65833,6,2,230439,230439,230441,0,2,4
65834,5,1,230444,230444,230445,0,1,3
65835,5,1,230449,230449,230450,0,1,4
65836,1,3,230450,230450,230453,0,3,0
65837,2,2,230452,230453,230455,1,3,0
65838,6,3,230458,230458,230461,0,3,3
65839,2,3,230460,230461,230464,1,4,0
65840,3,3,230463,230464,230467,1,4,0
65841,4,2,230467,230467,230469,0,2,0
65842,5,1,230472,230472,230473,0,1,3
65843,4,3,230476,230476,230479,0,3,3
65844,4,1,230480,230480,230481,0,1,1
65845,5,3,230485,230485,230488,0,3,4
65846,4,3,230489,230489,230492,0,3,1
65847,3,3,230492,230492,230495,0,3,0
65848,2,2,230494,230495,230497,1,3,0
65849,3,2,230497,230497,230499,0,2,0
65850,1,1,230498,230499,230500,1,2,0
65851,3,3,230501,230501,230504,0,3,1
65852,3,1,230504,230504,230505,0,1,0
65853,1,1,230505,230505,230506,0,1,0
65854,3,1,230508,230508,230509,0,1,2
65855,4,3,230512,230512,230515,0,3,3
65856,1,3,230513,230515,230518,2,5,0
65857,5,2,230518,230518,230520,0,2,0
65858,1,3,230519,230520,230523,1,4,0
65859,4,3,230523,230523,230526,0,3,0
65860,5,3,230528,230528,230531,0,3,2
65861,1,1,230529,230531,230532,2,3,0
65862,6,2,230535,230535,230537,0,2,3
65863,6,1,230541,230541,230542,0,1,4
65864,2,1,230543,230543,230544,0,1,1
65865,3,1,230546,230546,230547,0,1,2
65866,4,2,230550,230550,230552,0,2,3
65867,3,3,230553,230553,230556,0,3,1
65868,6,3,230559,230559,230562,0,3,3
65869,6,1,230565,230565,230566,0,1,3
65870,4,3,230569,230569,230572,0,3,3
65871,4,2,230573,230573,230575,0,2,1
65872,5,1,230578,230578,230579,0,1,3
65873,4,3,230582,230582,230585,0,3,3
65874,5,2,230587,230587,230589,0,2,2
65875,1,3,230588,230589,230592,1,4,0
65876,1,1,230589,230592,230593,3,4,0
65877,5,3,230594,230594,230597,0,3,1
65878,1,1,230595,230597,230598,2,3,0
65879,5,3,230600,230600,230603,0,3,2
65880,4,1,230604,230604,230605,0,1,1
65881,3,2,230607,230607,230609,0,2,2
65882,5,1,230612,230612,230613,0,1,3
65883,1,2,230613,230613,230615,0,2,0
65884,3,2,230616,230616,230618,0,2,1
65885,1,2,230617,230618,230620,1,3,0
65886,6,2,230623,230623,230625,0,2,3
65887,2,2,230625,230625,230627,0,2,0
65888,4,3,230629,230629,230632,0,3,2
65889,2,2,230631,230632,230634,1,3,0
65890,5,3,230636,230636,230639,0,3,2
65891,2,1,230638,230639,230640,1,2,0
65892,4,1,230642,230642,230643,0,1,2
65893,3,3,230645,230645,230648,0,3,2
65894,6,2,230651,230651,230653,0,2,3
65895,6,3,230657,230657,230660,0,3,4
65896,4,1,230661,230661,230662,0,1,1
65897,1,1,230662,230662,230663,0,1,0
65898,4,1,230666,230666,230667,0,1,3
65899,2,3,230668,230668,230671,0,3,1
65900,2,2,230670,230671,230673,1,3,0
65901,2,3,230672,230673,230676,1,4,0
65902,6,3,230678,230678,230681,0,3,2
65903,2,3,230680,230681,230684,1,4,0
65904,3,1,230683,230684,230685,1,2,0
65905,5,3,230688,230688,230691,0,3,3
65906,2,3,230690,230691,230694,1,4,0
65907,1,2,230691,230694,230696,3,5,0
65908,3,2,230694,230696,230698,2,4,0
65909,4,2,230698,230698,230700,0,2,0
65910,4,2,230702,230702,230704,0,2,2
65911,1,3,230703,230704,230707,1,4,0
65912,2,3,230705,230707,230710,2,5,0
65913,6,2,230711,230711,230713,0,2,1
65914,1,3,230712,230713,230716,1,4,0
65915,4,2,230716,230716,230718,0,2,0
65916,6,2,230722,230722,230724,0,2,4
65917,4,3,230726,230726,230729,0,3,2
65918,5,3,230731,230731,230734,0,3,2
65919,4,2,230735,230735,230737,0,2,1
65920,1,1,230736,230737,230738,1,2,0
65921,3,1,230739,230739,230740,0,1,1
65922,1,1,230740,230740,230741,0,1,0
65923,2,2,230742,230742,230744,0,2,1
65924,3,1,230745,230745,230746,0,1,1
65925,3,2,230748,230748,230750,0,2,2
65926,2,1,230750,230750,230751,0,1,0
65927,5,2,230755,230755,230757,0,2,4
65928,4,2,230759,230759,230761,0,2,2
65929,5,1,230764,230764,230765,0,1,3
65930,2,2,230766,230766,230768,0,2,1
65931,3,2,230769,230769,230771,0,2,1
65932,1,1,230770,230771,230772,1,2,0
65933,4,3,230774,230774,230777,0,3,2
65934,1,3,230775,230777,230780,2,5,0
65935,5,2,230780,230780,230782,0,2,0
65936,5,2,230785,230785,230787,0,2,3
65937,4,3,230789,230789,230792,0,3,2
65938,1,3,230790,230792,230795,2,5,0
65939,5,1,230795,230795,230796,0,1,0
65940,5,1,230800,230800,230801,0,1,4
65941,6,3,230806,230806,230809,0,3,5
65942,4,1,230810,230810,230811,0,1,1
65943,5,2,230815,230815,230817,0,2,4
65944,3,1,230818,230818,230819,0,1,1
65945,6,2,230824,230824,230826,0,2,5
65946,5,3,230829,230829,230832,0,3,3
65947,3,3,230832,230832,230835,0,3,0
65948,1,2,230833,230835,230837,2,4,0
65949,3,2,230836,230837,230839,1,3,0
65950,5,3,230841,230841,230844,0,3,2
65951,3,1,230844,230844,230845,0,1,0
65952,5,2,230849,230849,230851,0,2,4
65953,3,2,230852,230852,230854,0,2,1
65954,3,1,230855,230855,230856,0,1,1
65955,6,1,230861,230861,230862,0,1,5
65956,1,1,230862,230862,230863,0,1,0
65957,5,2,230867,230867,230869,0,2,4
65958,1,2,230868,230869,230871,1,3,0
65959,2,3,230870,230871,230874,1,4,0
65960,1,2,230871,230874,230876,3,5,0
65961,4,2,230875,230876,230878,1,3,0
65962,3,1,230878,230878,230879,0,1,0
65963,2,1,230880,230880,230881,0,1,1
65964,4,2,230884,230884,230886,0,2,3
65965,2,1,230886,230886,230887,0,1,0
65966,1,2,230887,230887,230889,0,2,0
65967,3,3,230890,230890,230893,0,3,1
65968,5,2,230895,230895,230897,0,2,2
65969,6,1,230901,230901,230902,0,1,4
65970,1,1,230902,230902,230903,0,1,0
65971,6,3,230908,230908,230911,0,3,5
65972,4,3,230912,230912,230915,0,3,1
65973,3,2,230915,230915,230917,0,2,0
65974,3,3,230918,230918,230921,0,3,1
65975,1,1,230919,230921,230922,2,3,0
65976,5,3,230924,230924,230927,0,3,2
65977,3,2,230927,230927,230929,0,2,0
65978,4,1,230931,230931,230932,0,1,2
65979,3,3,230934,230934,230937,0,3,2
65980,1,1,230935,230937,230938,2,3,0
65981,2,3,230937,230938,230941,1,4,0
65982,5,2,230942,230942,230944,0,2,1
65983,5,1,230947,230947,230948,0,1,3
65984,3,3,230950,230950,230953,0,3,2
65985,2,1,230952,230953,230954,1,2,0
65986,3,1,230955,230955,230956,0,1,1
65987,6,3,230961,230961,230964,0,3,5
65988,6,3,230967,230967,230970,0,3,3
65989,5,1,230972,230972,230973,0,1,2
65990,5,1,230977,230977,230978,0,1,4
65991,4,2,230981,230981,230983,0,2,3
65992,1,1,230982,230983,230984,1,2,0
65993,2,2,230984,230984,230986,0,2,0
65994,1,1,230985,230986,230987,1,2,0
65995,1,1,230986,230987,230988,1,2,0
65996,6,2,230992,230992,230994,0,2,4
65997,3,1,230995,230995,230996,0,1,1
65998,4,3,230999,230999,231002,0,3,3
65999,6,2,231005,231005,231007,0,2,3
66000,2,2,231007,231007,231009,0,2,0
66001,6,1,231013,231013,231014,0,1,4
66002,2,1,231015,231015,231016,0,1,1
66003,5,2,231020,231020,231022,0,2,4
66004,3,1,231023,231023,231024,0,1,1
66005,1,2,231024,231024,231026,0,2,0
66006,2,2,231026,231026,231028,0,2,0
66007,5,1,231031,231031,231032,0,1,3
66008,2,1,231033,231033,231034,0,1,1
66009,1,1,231034,231034,231035,0,1,0
66010,1,2,231035,231035,231037,0,2,0
66011,6,2,231041,231041,231043,0,2,4
66012,1,3,231042,231043,231046,1,4,0
66013,4,3,231046,231046,231049,0,3,0
66014,5,2,231051,231051,231053,0,2,2
66015,2,1,231053,231053,231054,0,1,0
66016,1,2,231054,231054,231056,0,2,0
66017,6,2,231060,231060,231062,0,2,4
66018,1,1,231061,231062,231063,1,2,0
66019,1,2,231062,231063,231065,1,3,0
66020,3,2,231065,231065,231067,0,2,0
66021,5,2,231070,231070,231072,0,2,3
66022,2,2,231072,231072,231074,0,2,0
66023,1,3,231073,231074,231077,1,4,0
66024,1,2,231074,231077,231079,3,5,0
66025,2,3,231076,231079,231082,3,6,0
66026,1,1,231077,231082,231083,5,6,0
66027,1,2,231078,231083,231085,5,7,0
66028,3,3,231081,231085,231088,4,7,0
66029,2,3,231083,231088,231091,5,8,0
66030,1,2,231084,231091,231093,7,9,0
66031,3,1,231087,231093,231094,6,7,0
66032,1,3,231088,231094,231097,6,9,0
66033,1,1,231089,231097,231098,8,9,0
66034,2,2,231091,231098,231100,7,9,0
66035,6,2,231097,231100,231102,3,5,0
66036,1,1,231098,231102,231103,4,5,0
66037,4,1,231102,231103,231104,1,2,0
66038,1,2,231103,231104,231106,1,3,0
66039,4,3,231107,231107,231110,0,3,1
66040,5,3,231112,231112,231115,0,3,2
66041,6,1,231118,231118,231119,0,1,3
66042,6,1,231124,231124,231125,0,1,5
66043,4,1,231128,231128,231129,0,1,3
66044,2,1,231130,231130,231131,0,1,1
66045,5,1,231135,231135,231136,0,1,4
66046,4,3,231139,231139,231142,0,3,3
66047,4,2,231143,231143,231145,0,2,1
66048,4,1,231147,231147,231148,0,1,2
66049,5,1,231152,231152,231153,0,1,4
66050,1,1,231153,231153,231154,0,1,0
66051,4,3,231157,231157,231160,0,3,3
66052,1,1,231158,231160,231161,2,3,0
66053,6,1,231164,231164,231165,0,1,3
66054,3,2,231167,231167,231169,0,2,2
66055,3,1,231170,231170,231171,0,1,1
66056,5,2,231175,231175,231177,0,2,4
66057,1,2,231176,231177,231179,1,3,0
66058,5,1,231181,231181,231182,0,1,2
66059,3,3,231184,231184,231187,0,3,2
66060,6,2,231190,231190,231192,0,2,3
66061,1,3,231191,231192,231195,1,4,0
66062,1,1,231192,231195,231196,3,4,0
66063,1,3,231193,231196,231199,3,6,0
66064,5,3,231198,231199,231202,1,4,0
66065,4,3,231202,231202,231205,0,3,0
66066,4,3,231206,231206,231209,0,3,1
66067,2,3,231208,231209,231212,1,4,0
66068,5,2,231213,231213,231215,0,2,1
66069,5,3,231218,231218,231221,0,3,3
66070,2,3,231220,231221,231224,1,4,0
66071,3,3,231223,231224,231227,1,4,0
66072,6,2,231229,231229,231231,0,2,2
66073,5,2,231234,231234,231236,0,2,3
66074,4,2,231238,231238,231240,0,2,2
66075,3,1,231241,231241,231242,0,1,1
66076,2,2,231243,231243,231245,0,2,1
66077,1,2,231244,231245,231247,1,3,0
66078,1,1,231245,231247,231248,2,3,0
66079,1,1,231246,231248,231249,2,3,0
66080,3,1,231249,231249,231250,0,1,0
66081,1,3,231250,231250,231253,0,3,0
66082,5,1,231255,231255,231256,0,1,2
66083,1,1,231256,231256,231257,0,1,0
66084,6,3,231262,231262,231265,0,3,5
66085,3,3,231265,231265,231268,0,3,0
66086,4,3,231269,231269,231272,0,3,1
66087,4,3,231273,231273,231276,0,3,1
66088,5,3,231278,231278,231281,0,3,2
66089,3,3,231281,231281,231284,0,3,0
66090,6,1,231287,231287,231288,0,1,3
66091,5,1,231292,231292,231293,0,1,4
66092,2,3,231294,231294,231297,0,3,1
66093,3,1,231297,231297,231298,0,1,0
66094,3,1,231300,231300,231301,0,1,2
66095,3,1,231303,231303,231304,0,1,2
66096,4,3,231307,231307,231310,0,3,3
66097,1,2,231308,231310,231312,2,4,0
66098,6,1,231314,231314,231315,0,1,2
66099,2,2,231316,231316,231318,0,2,1
66100,1,1,231317,231318,231319,1,2,0
66101,4,1,231321,231321,231322,0,1,2
66102,5,2,231326,231326,231328,0,2,4
66103,5,1,231331,231331,231332,0,1,3
66104,5,1,231336,231336,231337,0,1,4
66105,2,3,231338,231338,231341,0,3,1
66106,6,2,231344,231344,231346,0,2,3
66107,5,3,231349,231349,231352,0,3,3
66108,2,2,231351,231352,231354,1,3,0
66109,3,2,231354,231354,231356,0,2,0
66110,6,2,231360,231360,231362,0,2,4
66111,5,2,231365,231365,231367,0,2,3
66112,5,3,231370,231370,231373,0,3,3
66113,3,1,231373,231373,231374,0,1,0
66114,5,3,231378,231378,231381,0,3,4
66115,1,2,231379,231381,231383,2,4,0
66116,3,2,231382,231383,231385,1,3,0
66117,3,3,231385,231385,231388,0,3,0
66118,3,3,231388,231388,231391,0,3,0
66119,6,3,231394,231394,231397,0,3,3
66120,5,2,231399,231399,231401,0,2,2
66121,5,3,231404,231404,231407,0,3,3
66122,3,3,231407,231407,231410,0,3,0
66123,2,3,231409,231410,231413,1,4,0
66124,6,3,231415,231415,231418,0,3,2
66125,1,2,231416,231418,231420,2,4,0
66126,2,2,231418,231420,231422,2,4,0
66127,1,1,231419,231422,231423,3,4,0
66128,6,2,231425,231425,231427,0,2,2
66129,3,1,231428,231428,231429,0,1,1
66130,1,2,231429,231429,231431,0,2,0
66131,3,3,231432,231432,231435,0,3,1
66132,5,1,231437,231437,231438,0,1,2
66133,5,2,231442,231442,231444,0,2,4
66134,3,1,231445,231445,231446,0,1,1
66135,4,2,231449,231449,231451,0,2,3
66136,3,2,231452,231452,231454,0,2,1
66137,4,3,231456,231456,231459,0,3,2
66138,2,3,231458,231459,231462,1,4,0
66139,4,2,231462,231462,231464,0,2,0
66140,1,3,231463,231464,231467,1,4,0
66141,1,1,231464,231467,231468,3,4,0
66142,1,1,231465,231468,231469,3,4,0
66143,3,2,231468,231469,231471,1,3,0
66144,6,1,231474,231474,231475,0,1,3
66145,3,1,231477,231477,231478,0,1,2
66146,3,1,231480,231480,231481,0,1,2
66147,2,3,231482,231482,231485,0,3,1
66148,4,3,231486,231486,231489,0,3,1
66149,5,3,231491,231491,231494,0,3,2
66150,5,3,231496,231496,231499,0,3,2
66151,2,3,231498,231499,231502,1,4,0
66152,1,3,231499,231502,231505,3,6,0
66153,6,1,231505,231505,231506,0,1,0
66154,4,3,231509,231509,231512,0,3,3
66155,2,3,231511,231512,231515,1,4,0
66156,3,1,231514,231515,231516,1,2,0
66157,6,1,231520,231520,231521,0,1,4
66158,4,3,231524,231524,231527,0,3,3
66159,2,3,231526,231527,231530,1,4,0
66160,3,3,231529,231530,231533,1,4,0
66161,1,1,231530,231533,231534,3,4,0
66162,2,1,231532,231534,231535,2,3,0
66163,5,2,231537,231537,231539,0,2,2
66164,6,1,231543,231543,231544,0,1,4
66165,2,1,231545,231545,231546,0,1,1
66166,3,1,231548,231548,231549,0,1,2
66167,1,1,231549,231549,231550,0,1,0
66168,6,2,231555,231555,231557,0,2,5
66169,3,2,231558,231558,231560,0,2,1
66170,6,2,231564,231564,231566,0,2,4
66171,5,3,231569,231569,231572,0,3,3
66172,4,3,231573,231573,231576,0,3,1
66173,5,3,231578,231578,231581,0,3,2
66174,4,2,231582,231582,231584,0,2,1
66175,1,1,231583,231584,231585,1,2,0
66176,2,1,231585,231585,231586,0,1,0
66177,5,2,231590,231590,231592,0,2,4
66178,2,3,231592,231592,231595,0,3,0
66179,1,2,231593,231595,231597,2,4,0
66180,1,3,231594,231597,231600,3,6,0
66181,1,3,231595,231600,231603,5,8,0
66182,6,2,231601,231603,231605,2,4,0
66183,1,2,231602,231605,231607,3,5,0
66184,1,3,231603,231607,231610,4,7,0
66185,2,2,231605,231610,231612,5,7,0
66186,5,3,231610,231612,231615,2,5,0
66187,6,2,231616,231616,231618,0,2,1
66188,4,3,231620,231620,231623,0,3,2
66189,5,1,231625,231625,231626,0,1,2
66190,6,1,231631,231631,231632,0,1,5
66191,6,3,231637,231637,231640,0,3,5
66192,3,2,231640,231640,231642,0,2,0
66193,4,1,231644,231644,231645,0,1,2
66194,2,1,231646,231646,231647,0,1,1
66195,1,2,231647,231647,231649,0,2,0
66196,1,3,231648,231649,231652,1,4,0
66197,6,2,231654,231654,231656,0,2,2
66198,4,2,231658,231658,231660,0,2,2
66199,2,1,231660,231660,231661,0,1,0
66200,6,3,231666,231666,231669,0,3,5
66201,3,3,231669,231669,231672,0,3,0
66202,4,2,231673,231673,231675,0,2,1
66203,2,2,231675,231675,231677,0,2,0
66204,2,3,231677,231677,231680,0,3,0
66205,1,3,231678,231680,231683,2,5,0
66206,5,3,231683,231683,231686,0,3,0
66207,4,1,231687,231687,231688,0,1,1
66208,5,3,231692,231692,231695,0,3,4
66209,5,3,231697,231697,231700,0,3,2
66210,3,1,231700,231700,231701,0,1,0
66211,3,1,231703,231703,231704,0,1,2
66212,6,2,231709,231709,231711,0,2,5
66213,1,3,231710,231711,231714,1,4,0
66214,3,3,231713,231714,231717,1,4,0
66215,5,2,231718,231718,231720,0,2,1
66216,3,1,231721,231721,231722,0,1,1
66217,5,1,231726,231726,231727,0,1,4
66218,2,2,231728,231728,231730,0,2,1
66219,6,1,231734,231734,231735,0,1,4
66220,2,2,231736,231736,231738,0,2,1
66221,4,2,231740,231740,231742,0,2,2
66222,4,2,231744,231744,231746,0,2,2
66223,4,1,231748,231748,231749,0,1,2
66224,5,3,231753,231753,231756,0,3,4
66225,5,1,231758,231758,231759,0,1,2
66226,5,3,231763,231763,231766,0,3,4
66227,4,2,231767,231767,231769,0,2,1
66228,6,2,231773,231773,231775,0,2,4
66229,6,1,231779,231779,231780,0,1,4
66230,5,3,231784,231784,231787,0,3,4
66231,3,1,231787,231787,231788,0,1,0
66232,2,3,231789,231789,231792,0,3,1
66233,1,2,231790,231792,231794,2,4,0
66234,4,1,231794,231794,231795,0,1,0
66235,4,3,231798,231798,231801,0,3,3
66236,2,1,231800,231801,231802,1,2,0
66237,4,2,231804,231804,231806,0,2,2
66238,6,3,231810,231810,231813,0,3,4
66239,6,1,231816,231816,231817,0,1,3
66240,4,3,231820,231820,231823,0,3,3
66241,5,3,231825,231825,231828,0,3,2
66242,3,3,231828,231828,231831,0,3,0
66243,2,1,231830,231831,231832,1,2,0
66244,5,2,231835,231835,231837,0,2,3
66245,1,2,231836,231837,231839,1,3,0
66246,3,3,231839,231839,231842,0,3,0
66247,5,3,231844,231844,231847,0,3,2
66248,4,3,231848,231848,231851,0,3,1
66249,4,3,231852,231852,231855,0,3,1
66250,2,2,231854,231855,231857,1,3,0
66251,6,1,231860,231860,231861,0,1,3
66252,2,1,231862,231862,231863,0,1,1
66253,2,3,231864,231864,231867,0,3,1
66254,2,3,231866,231867,231870,1,4,0
66255,3,2,231869,231870,231872,1,3,0
66256,6,1,231875,231875,231876,0,1,3
66257,5,1,231880,231880,231881,0,1,4
66258,2,2,231882,231882,231884,0,2,1
66259,6,1,231888,231888,231889,0,1,4
66260,4,1,231892,231892,231893,0,1,3
66261,3,2,231895,231895,231897,0,2,2
66262,2,2,231897,231897,231899,0,2,0
66263,5,1,231902,231902,231903,0,1,3
66264,6,1,231908,231908,231909,0,1,5
66265,2,1,231910,231910,231911,0,1,1
66266,2,3,231912,231912,231915,0,3,1
66267,6,2,231918,231918,231920,0,2,3
66268,6,1,231924,231924,231925,0,1,4
66269,1,2,231925,231925,231927,0,2,0
66270,4,3,231929,231929,231932,0,3,2
66271,3,1,231932,231932,231933,0,1,0
66272,4,3,231936,231936,231939,0,3,3
66273,5,1,231941,231941,231942,0,1,2
66274,5,2,231946,231946,231948,0,2,4
66275,6,3,231952,231952,231955,0,3,4
66276,5,3,231957,231957,231960,0,3,2
66277,3,1,231960,231960,231961,0,1,0
66278,3,2,231963,231963,231965,0,2,2
66279,6,3,231969,231969,231972,0,3,4
66280,2,1,231971,231972,231973,1,2,0
66281,3,2,231974,231974,231976,0,2,1
66282,2,3,231976,231976,231979,0,3,0
66283,5,3,231981,231981,231984,0,3,2
66284,4,1,231985,231985,231986,0,1,1
66285,2,2,231987,231987,231989,0,2,1
66286,1,1,231988,231989,231990,1,2,0
66287,4,2,231992,231992,231994,0,2,2
66288,6,1,231998,231998,231999,0,1,4
66289,1,2,231999,231999,232001,0,2,0
66290,5,2,232004,232004,232006,0,2,3
66291,1,3,232005,232006,232009,1,4,0
66292,5,2,232010,232010,232012,0,2,1
66293,1,3,232011,232012,232015,1,4,0
66294,6,1,232017,232017,232018,0,1,2
66295,2,3,232019,232019,232022,0,3,1
66296,4,2,232023,232023,232025,0,2,1
66297,2,3,232025,232025,232028,0,3,0
66298,4,2,232029,232029,232031,0,2,1
66299,4,1,232033,232033,232034,0,1,2
66300,4,1,232037,232037,232038,0,1,3
66301,6,3,232043,232043,232046,0,3,5
66302,1,3,232044,232046,232049,2,5,0
66303,6,2,232050,232050,232052,0,2,1
66304,4,3,232054,232054,232057,0,3,2
66305,2,3,232056,232057,232060,1,4,0
66306,1,3,232057,232060,232063,3,6,0
66307,2,1,232059,232063,232064,4,5,0
66308,4,1,232063,232064,232065,1,2,0
66309,1,2,232064,232065,232067,1,3,0
66310,6,1,232070,232070,232071,0,1,3
66311,2,2,232072,232072,232074,0,2,1
66312,3,3,232075,232075,232078,0,3,1
66313,2,2,232077,232078,232080,1,3,0
66314,1,2,232078,232080,232082,2,4,0
66315,4,1,232082,232082,232083,0,1,0
66316,2,2,232084,232084,232086,0,2,1
66317,1,1,232085,232086,232087,1,2,0
66318,6,2,232091,232091,232093,0,2,4
66319,6,3,232097,232097,232100,0,3,4
66320,2,3,232099,232100,232103,1,4,0
66321,2,1,232101,232103,232104,2,3,0
66322,5,2,232106,232106,232108,0,2,2
66323,3,2,232109,232109,232111,0,2,1
66324,5,2,232114,232114,232116,0,2,3
66325,5,1,232119,232119,232120,0,1,3
66326,5,1,232124,232124,232125,0,1,4
66327,2,2,232126,232126,232128,0,2,1
66328,2,1,232128,232128,232129,0,1,0
66329,2,1,232130,232130,232131,0,1,1
66330,6,3,232136,232136,232139,0,3,5
66331,2,1,232138,232139,232140,1,2,0
66332,4,1,232142,232142,232143,0,1,2
66333,1,2,232143,232143,232145,0,2,0
66334,3,3,232146,232146,232149,0,3,1
66335,1,2,232147,232149,232151,2,4,0
66336,3,2,232150,232151,232153,1,3,0
66337,1,2,232151,232153,232155,2,4,0
66338,5,3,232156,232156,232159,0,3,1
66339,2,3,232158,232159,232162,1,4,0
66340,4,3,232162,232162,232165,0,3,0
66341,5,1,232167,232167,232168,0,1,2
66342,1,1,232168,232168,232169,0,1,0
66343,3,1,232171,232171,232172,0,1,2
66344,2,1,232173,232173,232174,0,1,1
66345,3,1,232176,232176,232177,0,1,2
66346,4,3,232180,232180,232183,0,3,3
66347,1,1,232181,232183,232184,2,3,0
66348,1,3,232182,232184,232187,2,5,0
66349,2,1,232184,232187,232188,3,4,0
66350,5,1,232189,232189,232190,0,1,1
66351,5,1,232194,232194,232195,0,1,4
66352,4,1,232198,232198,232199,0,1,3
66353,1,1,232199,232199,232200,0,1,0
66354,3,3,232202,232202,232205,0,3,2
66355,2,2,232204,232205,232207,1,3,0
66356,5,1,232209,232209,232210,0,1,2
66357,6,2,232215,232215,232217,0,2,5
66358,4,1,232219,232219,232220,0,1,2
66359,6,2,232225,232225,232227,0,2,5
66360,4,3,232229,232229,232232,0,3,2
66361,1,2,232230,232232,232234,2,4,0
66362,6,1,232236,232236,232237,0,1,2
66363,1,2,232237,232237,232239,0,2,0
66364,4,1,232241,232241,232242,0,1,2
66365,3,2,232244,232244,232246,0,2,2
66366,5,1,232249,232249,232250,0,1,3
66367,2,3,232251,232251,232254,0,3,1
66368,5,3,232256,232256,232259,0,3,2
66369,4,3,232260,232260,232263,0,3,1
66370,3,3,232263,232263,232266,0,3,0
66371,2,3,232265,232266,232269,1,4,0
66372,6,2,232271,232271,232273,0,2,2
66373,6,2,232277,232277,232279,0,2,4
66374,2,2,232279,232279,232281,0,2,0
66375,6,2,232285,232285,232287,0,2,4
66376,1,1,232286,232287,232288,1,2,0
66377,1,2,232287,232288,232290,1,3,0
66378,5,3,232292,232292,232295,0,3,2
66379,6,2,232298,232298,232300,0,2,3
66380,3,3,232301,232301,232304,0,3,1
66381,5,2,232306,232306,232308,0,2,2
66382,4,3,232310,232310,232313,0,3,2
66383,2,2,232312,232313,232315,1,3,0
66384,2,3,232314,232315,232318,1,4,0
66385,4,1,232318,232318,232319,0,1,0
66386,5,3,232323,232323,232326,0,3,4
66387,1,2,232324,232326,232328,2,4,0
66388,2,2,232326,232328,232330,2,4,0
66389,4,2,232330,232330,232332,0,2,0
66390,5,1,232335,232335,232336,0,1,3
66391,4,2,232339,232339,232341,0,2,3
66392,6,3,232345,232345,232348,0,3,4
66393,5,2,232350,232350,232352,0,2,2
66394,1,2,232351,232352,232354,1,3,0
66395,4,2,232355,232355,232357,0,2,1
66396,4,1,232359,232359,232360,0,1,2
66397,2,1,232361,232361,232362,0,1,1
66398,4,2,232365,232365,232367,0,2,3
66399,4,3,232369,232369,232372,0,3,2
66400,4,3,232373,232373,232376,0,3,1
66401,3,3,232376,232376,232379,0,3,0
66402,1,3,232377,232379,232382,2,5,0
66403,4,2,232381,232382,232384,1,3,0
66404,6,2,232387,232387,232389,0,2,3
66405,1,3,232388,232389,232392,1,4,0
66406,4,1,232392,232392,232393,0,1,0
66407,5,2,232397,232397,232399,0,2,4
66408,2,2,232399,232399,232401,0,2,0
66409,1,2,232400,232401,232403,1,3,0
66410,1,3,232401,232403,232406,2,5,0
66411,2,1,232403,232406,232407,3,4,0
66412,3,2,232406,232407,232409,1,3,0
66413,1,2,232407,232409,232411,2,4,0
66414,4,2,232411,232411,232413,0,2,0
66415,3,2,232414,232414,232416,0,2,1
66416,6,1,232420,232420,232421,0,1,4
66417,5,2,232425,232425,232427,0,2,4
66418,5,2,232430,232430,232432,0,2,3
66419,4,3,232434,232434,232437,0,3,2
66420,5,2,232439,232439,232441,0,2,2
66421,4,1,232443,232443,232444,0,1,2
66422,6,3,232449,232449,232452,0,3,5
66423,2,1,232451,232452,232453,1,2,0
66424,6,1,232457,232457,232458,0,1,4
66425,6,3,232463,232463,232466,0,3,5
66426,4,3,232467,232467,232470,0,3,1
66427,6,1,232473,232473,232474,0,1,3
66428,4,3,232477,232477,232480,0,3,3
66429,3,2,232480,232480,232482,0,2,0
66430,6,2,232486,232486,232488,0,2,4
66431,6,1,232492,232492,232493,0,1,4
66432,6,3,232498,232498,232501,0,3,5
66433,6,3,232504,232504,232507,0,3,3
66434,1,3,232505,232507,232510,2,5,0
66435,6,2,232511,232511,232513,0,2,1
66436,1,1,232512,232513,232514,1,2,0
66437,2,1,232514,232514,232515,0,1,0
66438,2,1,232516,232516,232517,0,1,1
66439,3,3,232519,232519,232522,0,3,2
66440,3,3,232522,232522,232525,0,3,0
66441,2,2,232524,232525,232527,1,3,0
66442,1,2,232525,232527,232529,2,4,0
66443,2,2,232527,232529,232531,2,4,0
66444,6,3,232533,232533,232536,0,3,2
66445,3,1,232536,232536,232537,0,1,0
66446,4,2,232540,232540,232542,0,2,3
66447,6,1,232546,232546,232547,0,1,4
66448,1,1,232547,232547,232548,0,1,0
66449,1,1,232548,232548,232549,0,1,0
66450,1,3,232549,232549,232552,0,3,0
66451,6,2,232555,232555,232557,0,2,3
66452,5,3,232560,232560,232563,0,3,3
66453,5,3,232565,232565,232568,0,3,2
66454,2,3,232567,232568,232571,1,4,0
66455,2,2,232569,232571,232573,2,4,0
66456,5,1,232574,232574,232575,0,1,1
66457,5,2,232579,232579,232581,0,2,4
66458,1,2,232580,232581,232583,1,3,0
66459,5,1,232585,232585,232586,0,1,2
66460,4,3,232589,232589,232592,0,3,3
66461,4,3,232593,232593,232596,0,3,1
66462,2,3,232595,232596,232599,1,4,0
66463,5,3,232600,232600,232603,0,3,1
66464,5,1,232605,232605,232606,0,1,2
66465,1,3,232606,232606,232609,0,3,0
66466,6,2,232612,232612,232614,0,2,3
66467,4,1,232616,232616,232617,0,1,2
66468,2,3,232618,232618,232621,0,3,1
66469,4,3,232622,232622,232625,0,3,1
66470,4,2,232626,232626,232628,0,2,1
66471,3,3,232629,232629,232632,0,3,1
66472,3,1,232632,232632,232633,0,1,0
66473,6,2,232638,232638,232640,0,2,5
66474,6,1,232644,232644,232645,0,1,4
66475,4,1,232648,232648,232649,0,1,3
66476,5,3,232653,232653,232656,0,3,4
66477,5,3,232658,232658,232661,0,3,2
66478,5,1,232663,232663,232664,0,1,2
66479,1,2,232664,232664,232666,0,2,0
66480,5,2,232669,232669,232671,0,2,3
66481,6,3,232675,232675,232678,0,3,4
66482,3,3,232678,232678,232681,0,3,0
66483,6,1,232684,232684,232685,0,1,3
66484,3,1,232687,232687,232688,0,1,2
66485,6,1,232693,232693,232694,0,1,5
66486,4,3,232697,232697,232700,0,3,3
66487,5,1,232702,232702,232703,0,1,2
66488,3,1,232705,232705,232706,0,1,2
66489,4,2,232709,232709,232711,0,2,3
66490,1,3,232710,232711,232714,1,4,0
66491,3,2,232713,232714,232716,1,3,0
66492,1,1,232714,232716,232717,2,3,0
66493,4,1,232718,232718,232719,0,1,1
66494,3,1,232721,232721,232722,0,1,2
66495,3,2,232724,232724,232726,0,2,2
66496,4,1,232728,232728,232729,0,1,2
66497,5,1,232733,232733,232734,0,1,4
66498,1,1,232734,232734,232735,0,1,0
66499,3,3,232737,232737,232740,0,3,2
66500,3,2,232740,232740,232742,0,2,0
66501,3,1,232743,232743,232744,0,1,1
66502,1,1,232744,232744,232745,0,1,0
66503,4,2,232748,232748,232750,0,2,3
66504,5,3,232753,232753,232756,0,3,3
66505,6,2,232759,232759,232761,0,2,3
66506,3,1,232762,232762,232763,0,1,1
66507,4,2,232766,232766,232768,0,2,3
66508,2,3,232768,232768,232771,0,3,0
66509,5,2,232773,232773,232775,0,2,2
66510,6,1,232779,232779,232780,0,1,4
66511,1,1,232780,232780,232781,0,1,0
66512,2,1,232782,232782,232783,0,1,1
66513,6,1,232788,232788,232789,0,1,5
66514,3,3,232791,232791,232794,0,3,2
66515,1,3,232792,232794,232797,2,5,0
66516,3,1,232795,232797,232798,2,3,0
66517,6,2,232801,232801,232803,0,2,3
66518,4,1,232805,232805,232806,0,1,2
66519,4,2,232809,232809,232811,0,2,3
66520,5,3,232814,232814,232817,0,3,3
66521,5,1,232819,232819,232820,0,1,2
66522,6,2,232825,232825,232827,0,2,5
66523,2,1,232827,232827,232828,0,1,0
66524,6,2,232833,232833,232835,0,2,5
66525,2,3,232835,232835,232838,0,3,0
66526,5,2,232840,232840,232842,0,2,2
66527,3,2,232843,232843,232845,0,2,1
66528,6,1,232849,232849,232850,0,1,4
66529,1,2,232850,232850,232852,0,2,0
66530,5,3,232855,232855,232858,0,3,3
66531,4,1,232859,232859,232860,0,1,1
66532,6,3,232865,232865,232868,0,3,5
66533,3,1,232868,232868,232869,0,1,0
66534,2,3,232870,232870,232873,0,3,1
66535,4,1,232874,232874,232875,0,1,1
66536,2,1,232876,232876,232877,0,1,1
66537,1,2,232877,232877,232879,0,2,0
66538,1,1,232878,232879,232880,1,2,0
66539,1,1,232879,232880,232881,1,2,0
66540,1,3,232880,232881,232884,1,4,0
66541,4,1,232884,232884,232885,0,1,0
66542,4,1,232888,232888,232889,0,1,3
66543,2,1,232890,232890,232891,0,1,1
66544,3,2,232893,232893,232895,0,2,2
66545,3,2,232896,232896,232898,0,2,1
66546,1,3,232897,232898,232901,1,4,0
66547,5,2,232902,232902,232904,0,2,1
66548,4,2,232906,232906,232908,0,2,2
66549,2,1,232908,232908,232909,0,1,0
66550,3,3,232911,232911,232914,0,3,2
66551,2,3,232913,232914,232917,1,4,0
66552,5,1,232918,232918,232919,0,1,1
66553,2,2,232920,232920,232922,0,2,1
66554,6,1,232926,232926,232927,0,1,4
66555,1,1,232927,232927,232928,0,1,0
66556,3,1,232930,232930,232931,0,1,2
66557,1,1,232931,232931,232932,0,1,0
66558,1,2,232932,232932,232934,0,2,0
66559,2,1,232934,232934,232935,0,1,0
66560,4,1,232938,232938,232939,0,1,3
66561,4,1,232942,232942,232943,0,1,3
66562,3,1,232945,232945,232946,0,1,2
66563,1,1,232946,232946,232947,0,1,0
66564,1,3,232947,232947,232950,0,3,0
66565,5,2,232952,232952,232954,0,2,2
66566,3,1,232955,232955,232956,0,1,1
66567,6,1,232961,232961,232962,0,1,5
66568,1,3,232962,232962,232965,0,3,0
66569,5,1,232967,232967,232968,0,1,2
66570,1,1,232968,232968,232969,0,1,0
66571,6,2,232974,232974,232976,0,2,5
66572,3,3,232977,232977,232980,0,3,1
66573,5,3,232982,232982,232985,0,3,2
66574,6,2,232988,232988,232990,0,2,3
66575,3,3,232991,232991,232994,0,3,1
66576,6,3,232997,232997,233000,0,3,3
66577,1,1,232998,233000,233001,2,3,0
66578,3,2,233001,233001,233003,0,2,0
66579,6,1,233007,233007,233008,0,1,4
66580,4,2,233011,233011,233013,0,2,3
66581,2,1,233013,233013,233014,0,1,0
66582,4,3,233017,233017,233020,0,3,3
66583,1,3,233018,233020,233023,2,5,0
66584,4,3,233022,233023,233026,1,4,0
66585,1,3,233023,233026,233029,3,6,0
66586,4,2,233027,233029,233031,2,4,0
66587,6,1,233033,233033,233034,0,1,2
66588,1,3,233034,233034,233037,0,3,0
66589,4,2,233038,233038,233040,0,2,1
66590,4,1,233042,233042,233043,0,1,2
66591,6,2,233048,233048,233050,0,2,5
66592,3,1,233051,233051,233052,0,1,1
66593,5,1,233056,233056,233057,0,1,4
66594,6,2,233062,233062,233064,0,2,5
66595,2,1,233064,233064,233065,0,1,0
66596,1,1,233065,233065,233066,0,1,0
66597,6,2,233071,233071,233073,0,2,5
66598,4,3,233075,233075,233078,0,3,2
66599,6,2,233081,233081,233083,0,2,3
66600,1,2,233082,233083,233085,1,3,0
66601,6,1,233088,233088,233089,0,1,3
66602,3,3,233091,233091,233094,0,3,2
66603,3,2,233094,233094,233096,0,2,0
66604,2,2,233096,233096,233098,0,2,0
66605,6,2,233102,233102,233104,0,2,4
66606,2,2,233104,233104,233106,0,2,0
66607,4,3,233108,233108,233111,0,3,2
66608,5,2,233113,233113,233115,0,2,2
66609,3,2,233116,233116,233118,0,2,1
66610,6,2,233122,233122,233124,0,2,4
66611,2,1,233124,233124,233125,0,1,0
66612,3,1,233127,233127,233128,0,1,2
66613,1,2,233128,233128,233130,0,2,0
66614,4,3,233132,233132,233135,0,3,2
66615,1,3,233133,233135,233138,2,5,0
66616,6,2,233139,233139,233141,0,2,1
66617,1,3,233140,233141,233144,1,4,0
66618,5,2,233145,233145,233147,0,2,1
66619,1,1,233146,233147,233148,1,2,0
66620,2,1,233148,233148,233149,0,1,0
66621,5,3,233153,233153,233156,0,3,4
66622,1,3,233154,233156,233159,2,5,0
66623,4,2,233158,233159,233161,1,3,0
66624,5,2,233163,233163,233165,0,2,2
66625,2,1,233165,233165,233166,0,1,0
66626,4,3,233169,233169,233172,0,3,3
66627,3,2,233172,233172,233174,0,2,0
66628,4,3,233176,233176,233179,0,3,2
66629,5,3,233181,233181,233184,0,3,2
66630,1,1,233182,233184,233185,2,3,0
66631,5,1,233187,233187,233188,0,1,2
66632,4,3,233191,233191,233194,0,3,3
66633,1,3,233192,233194,233197,2,5,0
66634,3,1,233195,233197,233198,2,3,0
66635,5,2,233200,233200,233202,0,2,2
66636,4,2,233204,233204,233206,0,2,2
66637,5,1,233209,233209,233210,0,1,3
66638,4,1,233213,233213,233214,0,1,3
66639,4,2,233217,233217,233219,0,2,3
66640,4,2,233221,233221,233223,0,2,2
66641,2,3,233223,233223,233226,0,3,0
66642,5,1,233228,233228,233229,0,1,2
66643,4,1,233232,233232,233233,0,1,3
66644,5,3,233237,233237,233240,0,3,4
66645,1,1,233238,233240,233241,2,3,0
66646,3,1,233241,233241,233242,0,1,0
66647,5,1,233246,233246,233247,0,1,4
66648,1,3,233247,233247,233250,0,3,0
66649,3,1,233250,233250,233251,0,1,0
66650,4,3,233254,233254,233257,0,3,3
66651,5,2,233259,233259,233261,0,2,2
66652,4,2,233263,233263,233265,0,2,2
66653,1,3,233264,233265,233268,1,4,0
66654,3,2,233267,233268,233270,1,3,0
66655,4,2,233271,233271,233273,0,2,1
66656,6,2,233277,233277,233279,0,2,4
66657,2,2,233279,233279,233281,0,2,0
66658,3,3,233282,233282,233285,0,3,1
66659,4,1,233286,233286,233287,0,1,1
66660,4,3,233290,233290,233293,0,3,3
66661,3,3,233293,233293,233296,0,3,0
66662,2,2,233295,233296,233298,1,3,0
66663,5,3,233300,233300,233303,0,3,2
66664,3,1,233303,233303,233304,0,1,0
66665,3,1,233306,233306,233307,0,1,2
66666,1,1,233307,233307,233308,0,1,0
66667,4,2,233311,233311,233313,0,2,3
66668,3,1,233314,233314,233315,0,1,1
66669,3,1,233317,233317,233318,0,1,2
66670,3,3,233320,233320,233323,0,3,2
66671,4,1,233324,233324,233325,0,1,1
66672,4,3,233328,233328,233331,0,3,3
66673,1,1,233329,233331,233332,2,3,0
66674,6,3,233335,233335,233338,0,3,3
66675,5,1,233340,233340,233341,0,1,2
66676,3,2,233343,233343,233345,0,2,2
66677,4,1,233347,233347,233348,0,1,2
66678,6,1,233353,233353,233354,0,1,5
66679,2,3,233355,233355,233358,0,3,1
66680,2,2,233357,233358,233360,1,3,0
66681,3,2,233360,233360,233362,0,2,0
66682,1,1,233361,233362,233363,1,2,0
66683,4,1,233365,233365,233366,0,1,2
66684,2,1,233367,233367,233368,0,1,1
66685,6,2,233373,233373,233375,0,2,5
66686,5,1,233378,233378,233379,0,1,3
66687,5,2,233383,233383,233385,0,2,4
66688,5,1,233388,233388,233389,0,1,3
66689,6,1,233394,233394,233395,0,1,5
66690,3,1,233397,233397,233398,0,1,2
66691,4,1,233401,233401,233402,0,1,3
66692,6,1,233407,233407,233408,0,1,5
66693,5,1,233412,233412,233413,0,1,4
66694,2,1,233414,233414,233415,0,1,1
66695,2,2,233416,233416,233418,0,2,1
66696,2,1,233418,233418,233419,0,1,0
66697,6,2,233424,233424,233426,0,2,5
66698,3,2,233427,233427,233429,0,2,1
66699,4,2,233431,233431,233433,0,2,2
66700,6,3,233437,233437,233440,0,3,4
66701,6,3,233443,233443,233446,0,3,3
66702,3,1,233446,233446,233447,0,1,0
66703,3,3,233449,233449,233452,0,3,2
66704,6,1,233455,233455,233456,0,1,3
66705,4,2,233459,233459,233461,0,2,3
66706,1,2,233460,233461,233463,1,3,0
66707,4,2,233464,233464,233466,0,2,1
66708,6,3,233470,233470,233473,0,3,4
66709,1,2,233471,233473,233475,2,4,0
66710,6,3,233477,233477,233480,0,3,2
66711,5,1,233482,233482,233483,0,1,2
66712,6,3,233488,233488,233491,0,3,5
66713,3,3,233491,233491,233494,0,3,0
66714,4,2,233495,233495,233497,0,2,1
66715,1,2,233496,233497,233499,1,3,0
66716,2,3,233498,233499,233502,1,4,0
66717,2,3,233500,233502,233505,2,5,0
66718,1,1,233501,233505,233506,4,5,0
66719,3,2,233504,233506,233508,2,4,0
66720,2,3,233506,233508,233511,2,5,0
66721,4,1,233510,233511,233512,1,2,0
66722,5,3,233515,233515,233518,0,3,3
66723,5,1,233520,233520,233521,0,1,2
66724,2,2,233522,233522,233524,0,2,1
66725,5,2,233527,233527,233529,0,2,3
66726,5,3,233532,233532,233535,0,3,3
66727,5,3,233537,233537,233540,0,3,2
66728,4,3,233541,233541,233544,0,3,1
66729,3,2,233544,233544,233546,0,2,0
66730,3,1,233547,233547,233548,0,1,1
66731,3,3,233550,233550,233553,0,3,2
66732,2,2,233552,233553,233555,1,3,0
66733,1,3,233553,233555,233558,2,5,0
66734,4,3,233557,233558,233561,1,4,0
66735,2,3,233559,233561,233564,2,5,0
66736,1,2,233560,233564,233566,4,6,0
66737,1,1,233561,233566,233567,5,6,0
66738,5,1,233566,233567,233568,1,2,0
66739,3,1,233569,233569,233570,0,1,1
66740,3,1,233572,233572,233573,0,1,2
66741,5,2,233577,233577,233579,0,2,4
66742,1,2,233578,233579,233581,1,3,0
66743,3,2,233581,233581,233583,0,2,0
66744,5,1,233586,233586,233587,0,1,3
66745,2,3,233588,233588,233591,0,3,1
66746,4,2,233592,233592,233594,0,2,1
66747,4,3,233596,233596,233599,0,3,2
66748,1,3,233597,233599,233602,2,5,0
66749,6,2,233603,233603,233605,0,2,1
66750,1,3,233604,233605,233608,1,4,0
66751,4,3,233608,233608,233611,0,3,0
66752,4,1,233612,233612,233613,0,1,1
66753,3,2,233615,233615,233617,0,2,2
66754,5,1,233620,233620,233621,0,1,3
66755,3,1,233623,233623,233624,0,1,2
66756,2,3,233625,233625,233628,0,3,1
66757,4,1,233629,233629,233630,0,1,1
66758,3,1,233632,233632,233633,0,1,2
66759,2,2,233634,233634,233636,0,2,1
66760,3,1,233637,233637,233638,0,1,1
66761,1,1,233638,233638,233639,0,1,0
66762,4,3,233642,233642,233645,0,3,3
66763,1,1,233643,233645,233646,2,3,0
66764,1,1,233644,233646,233647,2,3,0
66765,5,2,233649,233649,233651,0,2,2
66766,5,3,233654,233654,233657,0,3,3
66767,5,1,233659,233659,233660,0,1,2
66768,2,1,233661,233661,233662,0,1,1
66769,4,2,233665,233665,233667,0,2,3
66770,1,1,233666,233667,233668,1,2,0
66771,4,2,233670,233670,233672,0,2,2
66772,4,1,233674,233674,233675,0,1,2
66773,3,3,233677,233677,233680,0,3,2
66774,3,3,233680,233680,233683,0,3,0
66775,4,3,233684,233684,233687,0,3,1
66776,2,2,233686,233687,233689,1,3,0
66777,1,3,233687,233689,233692,2,5,0
66778,1,3,233688,233692,233695,4,7,0
66779,1,2,233689,233695,233697,6,8,0
66780,2,2,233691,233697,233699,6,8,0
66781,2,3,233693,233699,233702,6,9,0
66782,5,1,233698,233702,233703,4,5,0
66783,3,2,233701,233703,233705,2,4,0
66784,3,2,233704,233705,233707,1,3,0
66785,4,2,233708,233708,233710,0,2,1
66786,1,2,233709,233710,233712,1,3,0
66787,6,2,233715,233715,233717,0,2,3
66788,5,1,233720,233720,233721,0,1,3
66789,1,1,233721,233721,233722,0,1,0
66790,4,1,233725,233725,233726,0,1,3
66791,1,1,233726,233726,233727,0,1,0
66792,3,1,233729,233729,233730,0,1,2
66793,2,2,233731,233731,233733,0,2,1
66794,6,1,233737,233737,233738,0,1,4
66795,2,2,233739,233739,233741,0,2,1
66796,5,1,233744,233744,233745,0,1,3
66797,5,1,233749,233749,233750,0,1,4
66798,3,2,233752,233752,233754,0,2,2
66799,1,1,233753,233754,233755,1,2,0
66800,4,3,233757,233757,233760,0,3,2
66801,1,3,233758,233760,233763,2,5,0
66802,5,2,233763,233763,233765,0,2,0
66803,6,3,233769,233769,233772,0,3,4
66804,3,2,233772,233772,233774,0,2,0
66805,6,1,233778,233778,233779,0,1,4
66806,2,1,233780,233780,233781,0,1,1
66807,4,2,233784,233784,233786,0,2,3
66808,3,1,233787,233787,233788,0,1,1
66809,5,3,233792,233792,233795,0,3,4
66810,3,3,233795,233795,233798,0,3,0
66811,4,3,233799,233799,233802,0,3,1
66812,5,1,233804,233804,233805,0,1,2
66813,2,2,233806,233806,233808,0,2,1
66814,5,2,233811,233811,233813,0,2,3
66815,4,3,233815,233815,233818,0,3,2
66816,6,3,233821,233821,233824,0,3,3
66817,6,1,233827,233827,233828,0,1,3
66818,2,2,233829,233829,233831,0,2,1
66819,6,3,233835,233835,233838,0,3,4
66820,2,1,233837,233838,233839,1,2,0
66821,1,1,233838,233839,233840,1,2,0
66822,5,3,233843,233843,233846,0,3,3
66823,5,1,233848,233848,233849,0,1,2
66824,6,2,233854,233854,233856,0,2,5
66825,4,2,233858,233858,233860,0,2,2
66826,3,3,233861,233861,233864,0,3,1
66827,1,1,233862,233864,233865,2,3,0
66828,3,3,233865,233865,233868,0,3,0
66829,3,3,233868,233868,233871,0,3,0
66830,1,3,233869,233871,233874,2,5,0
66831,5,3,233874,233874,233877,0,3,0
66832,1,3,233875,233877,233880,2,5,0
66833,3,3,233878,233880,233883,2,5,0
66834,3,1,233881,233883,233884,2,3,0
66835,6,3,233887,233887,233890,0,3,3
66836,1,3,233888,233890,233893,2,5,0
66837,4,2,233892,233893,233895,1,3,0
66838,1,1,233893,233895,233896,2,3,0
66839,5,1,233898,233898,233899,0,1,2
66840,4,1,233902,233902,233903,0,1,3
66841,2,2,233904,233904,233906,0,2,1
66842,2,1,233906,233906,233907,0,1,0
66843,1,1,233907,233907,233908,0,1,0
66844,6,2,233913,233913,233915,0,2,5
66845,6,1,233919,233919,233920,0,1,4
66846,3,3,233922,233922,233925,0,3,2
66847,2,2,233924,233925,233927,1,3,0
66848,1,1,233925,233927,233928,2,3,0
66849,1,1,233926,233928,233929,2,3,0
66850,6,1,233932,233932,233933,0,1,3
66851,6,1,233938,233938,233939,0,1,5
66852,4,2,233942,233942,233944,0,2,3
66853,4,3,233946,233946,233949,0,3,2
66854,6,3,233952,233952,233955,0,3,3
66855,2,3,233954,233955,233958,1,4,0
66856,2,1,233956,233958,233959,2,3,0
66857,4,1,233960,233960,233961,0,1,1
66858,3,2,233963,233963,233965,0,2,2
66859,2,3,233965,233965,233968,0,3,0
66860,1,1,233966,233968,233969,2,3,0
66861,1,3,233967,233969,233972,2,5,0
66862,1,2,233968,233972,233974,4,6,0
66863,1,3,233969,233974,233977,5,8,0
66864,3,3,233972,233977,233980,5,8,0
66865,2,2,233974,233980,233982,6,8,0
66866,6,3,233980,233982,233985,2,5,0
66867,5,1,233985,233985,233986,0,1,0
66868,1,3,233986,233986,233989,0,3,0
66869,1,1,233987,233989,233990,2,3,0
66870,2,1,233989,233990,233991,1,2,0
66871,4,3,233993,233993,233996,0,3,2
66872,6,1,233999,233999,234000,0,1,3
66873,5,2,234004,234004,234006,0,2,4
66874,5,1,234009,234009,234010,0,1,3
66875,4,3,234013,234013,234016,0,3,3
66876,5,2,234018,234018,234020,0,2,2
66877,6,3,234024,234024,234027,0,3,4
66878,4,3,234028,234028,234031,0,3,1
66879,4,3,234032,234032,234035,0,3,1
66880,1,1,234033,234035,234036,2,3,0
66881,1,3,234034,234036,234039,2,5,0
66882,2,1,234036,234039,234040,3,4,0
66883,3,3,234039,234040,234043,1,4,0
66884,5,1,234044,234044,234045,0,1,1
66885,1,3,234045,234045,234048,0,3,0
66886,4,3,234049,234049,234052,0,3,1
66887,6,1,234055,234055,234056,0,1,3
66888,2,2,234057,234057,234059,0,2,1
66889,2,1,234059,234059,234060,0,1,0
66890,2,1,234061,234061,234062,0,1,1
66891,4,3,234065,234065,234068,0,3,3
66892,6,1,234071,234071,234072,0,1,3
66893,2,2,234073,234073,234075,0,2,1
66894,3,1,234076,234076,234077,0,1,1
66895,3,1,234079,234079,234080,0,1,2
66896,1,3,234080,234080,234083,0,3,0
66897,6,1,234086,234086,234087,0,1,3
66898,5,3,234091,234091,234094,0,3,4
66899,4,3,234095,234095,234098,0,3,1
66900,5,2,234100,234100,234102,0,2,2
66901,4,2,234104,234104,234106,0,2,2
66902,1,2,234105,234106,234108,1,3,0
66903,2,3,234107,234108,234111,1,4,0
66904,1,3,234108,234111,234114,3,6,0
66905,2,2,234110,234114,234116,4,6,0
66906,6,1,234116,234116,234117,0,1,0
66907,4,1,234120,234120,234121,0,1,3
66908,4,2,234124,234124,234126,0,2,3
66909,2,2,234126,234126,234128,0,2,0
66910,6,1,234132,234132,234133,0,1,4
66911,4,2,234136,234136,234138,0,2,3
66912,1,1,234137,234138,234139,1,2,0
66913,4,3,234141,234141,234144,0,3,2
66914,2,3,234143,234144,234147,1,4,0
66915,6,2,234149,234149,234151,0,2,2
66916,2,1,234151,234151,234152,0,1,0
66917,2,2,234153,234153,234155,0,2,1
66918,6,2,234159,234159,234161,0,2,4
66919,1,2,234160,234161,234163,1,3,0
66920,2,3,234162,234163,234166,1,4,0
66921,3,3,234165,234166,234169,1,4,0
66922,4,1,234169,234169,234170,0,1,0
66923,3,3,234172,234172,234175,0,3,2
66924,2,2,234174,234175,234177,1,3,0
66925,2,1,234176,234177,234178,1,2,0
66926,3,2,234179,234179,234181,0,2,1
66927,4,3,234183,234183,234186,0,3,2
66928,6,1,234189,234189,234190,0,1,3
66929,2,3,234191,234191,234194,0,3,1
66930,5,2,234196,234196,234198,0,2,2
66931,1,3,234197,234198,234201,1,4,0
66932,3,2,234200,234201,234203,1,3,0
66933,2,3,234202,234203,234206,1,4,0
66934,2,1,234204,234206,234207,2,3,0
66935,4,3,234208,234208,234211,0,3,1
66936,1,2,234209,234211,234213,2,4,0
66937,6,2,234215,234215,234217,0,2,2
66938,6,1,234221,234221,234222,0,1,4
66939,6,2,234227,234227,234229,0,2,5
66940,2,2,234229,234229,234231,0,2,0
66941,3,3,234232,234232,234235,0,3,1
66942,6,3,234238,234238,234241,0,3,3
66943,6,3,234244,234244,234247,0,3,3
66944,5,2,234249,234249,234251,0,2,2
66945,1,1,234250,234251,234252,1,2,0
66946,2,1,234252,234252,234253,0,1,0
66947,3,1,234255,234255,234256,0,1,2
66948,2,2,234257,234257,234259,0,2,1
66949,4,3,234261,234261,234264,0,3,2
66950,5,1,234266,234266,234267,0,1,2
66951,5,3,234271,234271,234274,0,3,4
66952,5,1,234276,234276,234277,0,1,2
66953,4,2,234280,234280,234282,0,2,3
66954,4,1,234284,234284,234285,0,1,2
66955,5,2,234289,234289,234291,0,2,4
66956,6,3,234295,234295,234298,0,3,4
66957,4,1,234299,234299,234300,0,1,1
66958,4,1,234303,234303,234304,0,1,3
66959,6,2,234309,234309,234311,0,2,5
66960,3,1,234312,234312,234313,0,1,1
66961,6,2,234318,234318,234320,0,2,5
66962,5,3,234323,234323,234326,0,3,3
66963,1,2,234324,234326,234328,2,4,0
66964,6,3,234330,234330,234333,0,3,2
66965,6,2,234336,234336,234338,0,2,3
66966,2,3,234338,234338,234341,0,3,0
66967,4,3,234342,234342,234345,0,3,1
66968,4,3,234346,234346,234349,0,3,1
66969,2,1,234348,234349,234350,1,2,0
66970,3,3,234351,234351,234354,0,3,1
66971,6,2,234357,234357,234359,0,2,3
66972,1,3,234358,234359,234362,1,4,0
66973,1,1,234359,234362,234363,3,4,0
66974,3,3,234362,234363,234366,1,4,0
66975,4,1,234366,234366,234367,0,1,0
66976,5,2,234371,234371,234373,0,2,4
66977,1,2,234372,234373,234375,1,3,0
66978,2,2,234374,234375,234377,1,3,0
66979,1,1,234375,234377,234378,2,3,0
66980,4,3,234379,234379,234382,0,3,1
66981,1,3,234380,234382,234385,2,5,0
66982,2,1,234382,234385,234386,3,4,0
66983,2,3,234384,234386,234389,2,5,0
66984,3,2,234387,234389,234391,2,4,0
66985,5,3,234392,234392,234395,0,3,1
66986,6,1,234398,234398,234399,0,1,3
66987,3,1,234401,234401,234402,0,1,2
66988,5,3,234406,234406,234409,0,3,4
66989,3,3,234409,234409,234412,0,3,0
66990,5,1,234414,234414,234415,0,1,2
66991,5,3,234419,234419,234422,0,3,4
66992,2,1,234421,234422,234423,1,2,0
66993,2,2,234423,234423,234425,0,2,0
66994,5,1,234428,234428,234429,0,1,3
66995,3,1,234431,234431,234432,0,1,2
66996,4,1,234435,234435,234436,0,1,3
66997,1,2,234436,234436,234438,0,2,0
66998,1,1,234437,234438,234439,1,2,0
66999,4,1,234441,234441,234442,0,1,2
67000,4,2,234445,234445,234447,0,2,3
67001,1,3,234446,234447,234450,1,4,0
67002,3,1,234449,234450,234451,1,2,0
67003,1,3,234450,234451,234454,1,4,0
67004,4,3,234454,234454,234457,0,3,0
67005,4,2,234458,234458,234460,0,2,1
67006,2,1,234460,234460,234461,0,1,0
67007,5,3,234465,234465,234468,0,3,4
67008,5,2,234470,234470,234472,0,2,2
67009,3,1,234473,234473,234474,0,1,1
67010,6,3,234479,234479,234482,0,3,5
67011,6,2,234485,234485,234487,0,2,3
67012,2,1,234487,234487,234488,0,1,0
67013,2,2,234489,234489,234491,0,2,1
67014,1,2,234490,234491,234493,1,3,0
67015,5,1,234495,234495,234496,0,1,2
67016,5,2,234500,234500,234502,0,2,4
67017,3,1,234503,234503,234504,0,1,1
67018,2,2,234505,234505,234507,0,2,1
67019,3,3,234508,234508,234511,0,3,1
67020,6,2,234514,234514,234516,0,2,3
67021,4,1,234518,234518,234519,0,1,2
67022,1,2,234519,234519,234521,0,2,0
67023,3,1,234522,234522,234523,0,1,1
67024,6,2,234528,234528,234530,0,2,5
67025,6,1,234534,234534,234535,0,1,4
67026,6,2,234540,234540,234542,0,2,5
67027,3,3,234543,234543,234546,0,3,1
67028,1,3,234544,234546,234549,2,5,0
67029,1,3,234545,234549,234552,4,7,0
67030,3,2,234548,234552,234554,4,6,0
67031,1,2,234549,234554,234556,5,7,0
67032,2,3,234551,234556,234559,5,8,0
67033,3,3,234554,234559,234562,5,8,0
67034,2,1,234556,234562,234563,6,7,0
67035,1,2,234557,234563,234565,6,8,0
67036,1,2,234558,234565,234567,7,9,0
67037,6,3,234564,234567,234570,3,6,0
67038,5,2,234569,234570,234572,1,3,0
67039,4,3,234573,234573,234576,0,3,1
67040,2,2,234575,234576,234578,1,3,0
67041,3,2,234578,234578,234580,0,2,0
67042,1,1,234579,234580,234581,1,2,0
67043,6,2,234585,234585,234587,0,2,4
67044,1,2,234586,234587,234589,1,3,0
67045,6,1,234592,234592,234593,0,1,3
67046,6,3,234598,234598,234601,0,3,5
67047,2,1,234600,234601,234602,1,2,0
67048,2,2,234602,234602,234604,0,2,0
67049,3,1,234605,234605,234606,0,1,1
67050,4,3,234609,234609,234612,0,3,3
67051,3,2,234612,234612,234614,0,2,0
67052,5,2,234617,234617,234619,0,2,3
67053,2,3,234619,234619,234622,0,3,0
67054,6,1,234625,234625,234626,0,1,3
67055,4,3,234629,234629,234632,0,3,3
67056,6,3,234635,234635,234638,0,3,3
67057,3,3,234638,234638,234641,0,3,0
67058,1,3,234639,234641,234644,2,5,0
67059,1,3,234640,234644,234647,4,7,0
67060,5,1,234645,234647,234648,2,3,0
67061,3,3,234648,234648,234651,0,3,0
67062,2,1,234650,234651,234652,1,2,0
67063,3,3,234653,234653,234656,0,3,1
67064,5,2,234658,234658,234660,0,2,2
67065,2,1,234660,234660,234661,0,1,0
67066,4,2,234664,234664,234666,0,2,3
67067,3,3,234667,234667,234670,0,3,1
67068,5,2,234672,234672,234674,0,2,2
67069,4,3,234676,234676,234679,0,3,2
67070,6,3,234682,234682,234685,0,3,3
67071,2,2,234684,234685,234687,1,3,0
67072,1,2,234685,234687,234689,2,4,0
67073,5,2,234690,234690,234692,0,2,1
67074,2,2,234692,234692,234694,0,2,0
67075,5,3,234697,234697,234700,0,3,3
67076,1,2,234698,234700,234702,2,4,0
67077,5,3,234703,234703,234706,0,3,1
67078,6,1,234709,234709,234710,0,1,3
67079,4,1,234713,234713,234714,0,1,3
67080,6,2,234719,234719,234721,0,2,5
67081,5,1,234724,234724,234725,0,1,3
67082,6,1,234730,234730,234731,0,1,5
67083,6,1,234736,234736,234737,0,1,5
67084,3,2,234739,234739,234741,0,2,2
67085,6,3,234745,234745,234748,0,3,4
67086,2,3,234747,234748,234751,1,4,0
67087,2,1,234749,234751,234752,2,3,0
67088,5,1,234754,234754,234755,0,1,2
67089,1,1,234755,234755,234756,0,1,0
67090,3,3,234758,234758,234761,0,3,2
67091,4,2,234762,234762,234764,0,2,1
67092,1,1,234763,234764,234765,1,2,0
67093,4,2,234767,234767,234769,0,2,2
67094,6,1,234773,234773,234774,0,1,4
67095,5,3,234778,234778,234781,0,3,4
67096,3,1,234781,234781,234782,0,1,0
67097,5,1,234786,234786,234787,0,1,4
67098,3,2,234789,234789,234791,0,2,2
67099,3,1,234792,234792,234793,0,1,1
67100,6,1,234798,234798,234799,0,1,5
67101,2,1,234800,234800,234801,0,1,1
67102,6,3,234806,234806,234809,0,3,5
67103,4,1,234810,234810,234811,0,1,1
67104,6,3,234816,234816,234819,0,3,5
67105,2,3,234818,234819,234822,1,4,0
67106,4,1,234822,234822,234823,0,1,0
67107,2,2,234824,234824,234826,0,2,1
67108,5,1,234829,234829,234830,0,1,3
67109,6,1,234835,234835,234836,0,1,5
67110,2,2,234837,234837,234839,0,2,1
67111,3,1,234840,234840,234841,0,1,1
67112,6,3,234846,234846,234849,0,3,5
67113,1,2,234847,234849,234851,2,4,0
67114,6,3,234853,234853,234856,0,3,2
67115,1,2,234854,234856,234858,2,4,0
67116,1,2,234855,234858,234860,3,5,0
67117,3,3,234858,234860,234863,2,5,0
67118,3,2,234861,234863,234865,2,4,0
67119,5,3,234866,234866,234869,0,3,1
67120,4,1,234870,234870,234871,0,1,1
67121,5,2,234875,234875,234877,0,2,4
67122,5,1,234880,234880,234881,0,1,3
67123,1,1,234881,234881,234882,0,1,0
67124,4,2,234885,234885,234887,0,2,3
67125,5,1,234890,234890,234891,0,1,3
67126,2,2,234892,234892,234894,0,2,1
67127,4,2,234896,234896,234898,0,2,2
67128,3,3,234899,234899,234902,0,3,1
67129,4,3,234903,234903,234906,0,3,1
67130,3,1,234906,234906,234907,0,1,0
67131,6,2,234912,234912,234914,0,2,5
67132,1,1,234913,234914,234915,1,2,0
67133,3,2,234916,234916,234918,0,2,1
67134,1,1,234917,234918,234919,1,2,0
67135,3,3,234920,234920,234923,0,3,1
67136,6,3,234926,234926,234929,0,3,3
67137,1,1,234927,234929,234930,2,3,0
67138,3,2,234930,234930,234932,0,2,0
67139,2,2,234932,234932,234934,0,2,0
67140,1,1,234933,234934,234935,1,2,0
67141,5,1,234938,234938,234939,0,1,3
67142,4,2,234942,234942,234944,0,2,3
67143,2,1,234944,234944,234945,0,1,0
67144,5,1,234949,234949,234950,0,1,4
67145,3,2,234952,234952,234954,0,2,2
67146,5,3,234957,234957,234960,0,3,3
67147,6,2,234963,234963,234965,0,2,3
67148,1,2,234964,234965,234967,1,3,0
67149,3,2,234967,234967,234969,0,2,0
67150,4,3,234971,234971,234974,0,3,2
67151,6,2,234977,234977,234979,0,2,3
67152,1,1,234978,234979,234980,1,2,0
67153,5,1,234983,234983,234984,0,1,3
67154,4,3,234987,234987,234990,0,3,3
67155,4,3,234991,234991,234994,0,3,1
67156,1,1,234992,234994,234995,2,3,0
67157,1,1,234993,234995,234996,2,3,0
67158,6,3,234999,234999,235002,0,3,3
67159,6,2,235005,235005,235007,0,2,3
67160,3,2,235008,235008,235010,0,2,1
67161,1,1,235009,235010,235011,1,2,0
67162,1,2,235010,235011,235013,1,3,0
67163,4,1,235014,235014,235015,0,1,1
67164,4,3,235018,235018,235021,0,3,3
67165,6,1,235024,235024,235025,0,1,3
67166,1,1,235025,235025,235026,0,1,0
67167,3,2,235028,235028,235030,0,2,2
67168,6,3,235034,235034,235037,0,3,4
67169,1,1,235035,235037,235038,2,3,0
67170,2,2,235037,235038,235040,1,3,0
67171,6,1,235043,235043,235044,0,1,3
67172,6,1,235049,235049,235050,0,1,5
67173,5,2,235054,235054,235056,0,2,4
67174,4,2,235058,235058,235060,0,2,2
67175,2,1,235060,235060,235061,0,1,0
67176,6,2,235066,235066,235068,0,2,5
67177,4,2,235070,235070,235072,0,2,2
67178,2,2,235072,235072,235074,0,2,0
67179,3,2,235075,235075,235077,0,2,1
67180,1,3,235076,235077,235080,1,4,0
67181,2,3,235078,235080,235083,2,5,0
67182,2,1,235080,235083,235084,3,4,0
67183,3,2,235083,235084,235086,1,3,0
67184,2,3,235085,235086,235089,1,4,0
67185,1,1,235086,235089,235090,3,4,0
67186,2,2,235088,235090,235092,2,4,0
67187,6,1,235094,235094,235095,0,1,2
67188,2,2,235096,235096,235098,0,2,1
67189,5,1,235101,235101,235102,0,1,3
67190,2,3,235103,235103,235106,0,3,1
67191,6,3,235109,235109,235112,0,3,3
67192,1,2,235110,235112,235114,2,4,0
67193,4,1,235114,235114,235115,0,1,0
67194,3,1,235117,235117,235118,0,1,2
67195,3,3,235120,235120,235123,0,3,2
67196,1,2,235121,235123,235125,2,4,0
67197,3,2,235124,235125,235127,1,3,0
67198,5,2,235129,235129,235131,0,2,2
67199,4,3,235133,235133,235136,0,3,2
67200,3,3,235136,235136,235139,0,3,0
67201,1,1,235137,235139,235140,2,3,0
67202,5,1,235142,235142,235143,0,1,2
67203,5,1,235147,235147,235148,0,1,4
67204,3,3,235150,235150,235153,0,3,2
67205,1,1,235151,235153,235154,2,3,0
67206,3,1,235154,235154,235155,0,1,0
67207,1,2,235155,235155,235157,0,2,0
67208,5,2,235160,235160,235162,0,2,3
67209,6,3,235166,235166,235169,0,3,4
67210,6,2,235172,235172,235174,0,2,3
67211,1,1,235173,235174,235175,1,2,0
67212,2,2,235175,235175,235177,0,2,0
67213,4,3,235179,235179,235182,0,3,2
67214,3,1,235182,235182,235183,0,1,0
67215,4,1,235186,235186,235187,0,1,3
67216,4,2,235190,235190,235192,0,2,3
67217,6,2,235196,235196,235198,0,2,4
67218,6,3,235202,235202,235205,0,3,4
67219,4,2,235206,235206,235208,0,2,1
67220,3,3,235209,235209,235212,0,3,1
67221,6,2,235215,235215,235217,0,2,3
67222,1,2,235216,235217,235219,1,3,0
67223,5,1,235221,235221,235222,0,1,2
67224,1,1,235222,235222,235223,0,1,0
67225,6,2,235228,235228,235230,0,2,5
67226,3,1,235231,235231,235232,0,1,1
67227,5,1,235236,235236,235237,0,1,4
67228,4,3,235240,235240,235243,0,3,3
67229,4,2,235244,235244,235246,0,2,1
67230,2,2,235246,235246,235248,0,2,0
67231,5,2,235251,235251,235253,0,2,3
67232,6,1,235257,235257,235258,0,1,4
67233,6,1,235263,235263,235264,0,1,5
67234,4,2,235267,235267,235269,0,2,3
67235,5,1,235272,235272,235273,0,1,3
67236,2,2,235274,235274,235276,0,2,1
67237,5,2,235279,235279,235281,0,2,3
67238,6,3,235285,235285,235288,0,3,4
67239,5,2,235290,235290,235292,0,2,2
67240,2,1,235292,235292,235293,0,1,0
67241,6,3,235298,235298,235301,0,3,5
67242,4,2,235302,235302,235304,0,2,1
67243,2,2,235304,235304,235306,0,2,0
67244,3,2,235307,235307,235309,0,2,1
67245,3,2,235310,235310,235312,0,2,1
67246,3,2,235313,235313,235315,0,2,1
67247,2,3,235315,235315,235318,0,3,0
67248,4,2,235319,235319,235321,0,2,1
67249,4,2,235323,235323,235325,0,2,2
67250,2,3,235325,235325,235328,0,3,0
67251,2,3,235327,235328,235331,1,4,0
67252,4,3,235331,235331,235334,0,3,0
67253,3,2,235334,235334,235336,0,2,0
67254,5,1,235339,235339,235340,0,1,3
67255,5,1,235344,235344,235345,0,1,4
67256,3,2,235347,235347,235349,0,2,2
67257,2,1,235349,235349,235350,0,1,0
67258,2,1,235351,235351,235352,0,1,1
67259,5,3,235356,235356,235359,0,3,4
67260,5,1,235361,235361,235362,0,1,2
67261,3,3,235364,235364,235367,0,3,2
67262,4,3,235368,235368,235371,0,3,1
67263,1,1,235369,235371,235372,2,3,0
67264,4,3,235373,235373,235376,0,3,1
67265,3,3,235376,235376,235379,0,3,0
67266,2,1,235378,235379,235380,1,2,0
67267,1,2,235379,235380,235382,1,3,0
67268,1,2,235380,235382,235384,2,4,0
67269,3,2,235383,235384,235386,1,3,0
67270,3,1,235386,235386,235387,0,1,0
67271,3,3,235389,235389,235392,0,3,2
67272,2,2,235391,235392,235394,1,3,0
67273,2,1,235393,235394,235395,1,2,0
67274,6,2,235399,235399,235401,0,2,4
67275,6,1,235405,235405,235406,0,1,4
67276,2,2,235407,235407,235409,0,2,1
67277,6,3,235413,235413,235416,0,3,4
67278,1,2,235414,235416,235418,2,4,0
67279,2,1,235416,235418,235419,2,3,0
67280,3,2,235419,235419,235421,0,2,0
67281,6,1,235425,235425,235426,0,1,4
67282,1,1,235426,235426,235427,0,1,0
67283,2,3,235428,235428,235431,0,3,1
67284,6,1,235434,235434,235435,0,1,3
67285,5,1,235439,235439,235440,0,1,4
67286,5,1,235444,235444,235445,0,1,4
67287,3,2,235447,235447,235449,0,2,2
67288,2,3,235449,235449,235452,0,3,0
67289,6,1,235455,235455,235456,0,1,3
67290,6,3,235461,235461,235464,0,3,5
67291,4,3,235465,235465,235468,0,3,1
67292,6,2,235471,235471,235473,0,2,3
67293,2,1,235473,235473,235474,0,1,0
67294,6,3,235479,235479,235482,0,3,5
67295,1,2,235480,235482,235484,2,4,0
67296,5,3,235485,235485,235488,0,3,1
67297,6,1,235491,235491,235492,0,1,3
67298,1,3,235492,235492,235495,0,3,0
67299,3,3,235495,235495,235498,0,3,0
67300,1,2,235496,235498,235500,2,4,0
67301,1,3,235497,235500,235503,3,6,0
67302,2,1,235499,235503,235504,4,5,0
67303,1,3,235500,235504,235507,4,7,0
67304,1,3,235501,235507,235510,6,9,0
67305,4,2,235505,235510,235512,5,7,0
67306,1,3,235506,235512,235515,6,9,0
67307,2,2,235508,235515,235517,7,9,0
67308,6,1,235514,235517,235518,3,4,0
67309,3,1,235517,235518,235519,1,2,0
67310,3,2,235520,235520,235522,0,2,1
67311,1,2,235521,235522,235524,1,3,0
67312,3,3,235524,235524,235527,0,3,0
67313,3,2,235527,235527,235529,0,2,0
67314,5,1,235532,235532,235533,0,1,3
67315,2,1,235534,235534,235535,0,1,1
67316,6,3,235540,235540,235543,0,3,5
67317,3,3,235543,235543,235546,0,3,0
67318,5,2,235548,235548,235550,0,2,2
67319,3,2,235551,235551,235553,0,2,1
67320,6,3,235557,235557,235560,0,3,4
67321,3,1,235560,235560,235561,0,1,0
67322,1,2,235561,235561,235563,0,2,0
67323,6,3,235567,235567,235570,0,3,4
67324,3,1,235570,235570,235571,0,1,0
67325,3,1,235573,235573,235574,0,1,2
67326,4,3,235577,235577,235580,0,3,3
67327,1,3,235578,235580,235583,2,5,0
67328,1,3,235579,235583,235586,4,7,0
67329,6,3,235585,235586,235589,1,4,0
67330,6,3,235591,235591,235594,0,3,2
67331,2,1,235593,235594,235595,1,2,0
67332,1,3,235594,235595,235598,1,4,0
67333,3,1,235597,235598,235599,1,2,0
67334,5,3,235602,235602,235605,0,3,3
67335,6,3,235608,235608,235611,0,3,3
67336,1,2,235609,235611,235613,2,4,0
67337,6,2,235615,235615,235617,0,2,2
67338,2,3,235617,235617,235620,0,3,0
67339,3,2,235620,235620,235622,0,2,0
67340,1,1,235621,235622,235623,1,2,0
67341,4,1,235625,235625,235626,0,1,2
67342,4,3,235629,235629,235632,0,3,3
67343,2,1,235631,235632,235633,1,2,0
67344,3,1,235634,235634,235635,0,1,1
67345,1,2,235635,235635,235637,0,2,0
67346,4,2,235639,235639,235641,0,2,2
67347,3,2,235642,235642,235644,0,2,1
67348,3,1,235645,235645,235646,0,1,1
67349,3,2,235648,235648,235650,0,2,2
67350,3,3,235651,235651,235654,0,3,1
67351,6,3,235657,235657,235660,0,3,3
67352,6,2,235663,235663,235665,0,2,3
67353,2,3,235665,235665,235668,0,3,0
67354,4,3,235669,235669,235672,0,3,1
67355,1,2,235670,235672,235674,2,4,0
67356,4,3,235674,235674,235677,0,3,0
67357,1,2,235675,235677,235679,2,4,0
67358,2,2,235677,235679,235681,2,4,0
67359,2,2,235679,235681,235683,2,4,0
67360,6,1,235685,235685,235686,0,1,2
67361,2,3,235687,235687,235690,0,3,1
67362,2,3,235689,235690,235693,1,4,0
67363,6,1,235695,235695,235696,0,1,2
67364,3,1,235698,235698,235699,0,1,2
67365,3,3,235701,235701,235704,0,3,2
67366,2,1,235703,235704,235705,1,2,0
67367,2,2,235705,235705,235707,0,2,0
67368,5,3,235710,235710,235713,0,3,3
67369,4,3,235714,235714,235717,0,3,1
67370,3,3,235717,235717,235720,0,3,0
67371,2,3,235719,235720,235723,1,4,0
67372,2,2,235721,235723,235725,2,4,0
67373,3,2,235724,235725,235727,1,3,0
67374,6,3,235730,235730,235733,0,3,3
67375,3,3,235733,235733,235736,0,3,0
67376,6,2,235739,235739,235741,0,2,3
67377,2,2,235741,235741,235743,0,2,0
67378,1,2,235742,235743,235745,1,3,0
67379,5,1,235747,235747,235748,0,1,2
67380,4,1,235751,235751,235752,0,1,3
67381,2,1,235753,235753,235754,0,1,1
67382,1,2,235754,235754,235756,0,2,0
67383,6,2,235760,235760,235762,0,2,4
67384,6,3,235766,235766,235769,0,3,4
67385,2,3,235768,235769,235772,1,4,0
67386,6,2,235774,235774,235776,0,2,2
67387,6,1,235780,235780,235781,0,1,4
67388,5,1,235785,235785,235786,0,1,4
67389,5,1,235790,235790,235791,0,1,4
67390,4,1,235794,235794,235795,0,1,3
67391,6,3,235800,235800,235803,0,3,5
67392,4,1,235804,235804,235805,0,1,1
67393,3,1,235807,235807,235808,0,1,2
67394,5,1,235812,235812,235813,0,1,4
67395,1,2,235813,235813,235815,0,2,0
67396,4,1,235817,235817,235818,0,1,2
67397,2,2,235819,235819,235821,0,2,1
67398,6,3,235825,235825,235828,0,3,4
67399,5,2,235830,235830,235832,0,2,2
67400,4,3,235834,235834,235837,0,3,2
67401,5,2,235839,235839,235841,0,2,2
67402,5,3,235844,235844,235847,0,3,3
67403,5,2,235849,235849,235851,0,2,2
67404,6,1,235855,235855,235856,0,1,4
67405,1,2,235856,235856,235858,0,2,0
67406,5,1,235861,235861,235862,0,1,3
67407,5,1,235866,235866,235867,0,1,4
67408,3,1,235869,235869,235870,0,1,2
67409,3,2,235872,235872,235874,0,2,2
67410,3,1,235875,235875,235876,0,1,1
67411,4,3,235879,235879,235882,0,3,3
67412,1,3,235880,235882,235885,2,5,0
67413,2,2,235882,235885,235887,3,5,0
67414,4,1,235886,235887,235888,1,2,0
67415,4,3,235890,235890,235893,0,3,2
67416,4,3,235894,235894,235897,0,3,1
67417,1,2,235895,235897,235899,2,4,0
67418,4,2,235899,235899,235901,0,2,0
67419,2,3,235901,235901,235904,0,3,0
67420,3,3,235904,235904,235907,0,3,0
67421,4,1,235908,235908,235909,0,1,1
67422,3,1,235911,235911,235912,0,1,2
67423,6,2,235917,235917,235919,0,2,5
67424,4,2,235921,235921,235923,0,2,2
67425,2,1,235923,235923,235924,0,1,0
67426,3,1,235926,235926,235927,0,1,2
67427,3,1,235929,235929,235930,0,1,2
67428,3,1,235932,235932,235933,0,1,2
67429,5,3,235937,235937,235940,0,3,4
67430,6,1,235943,235943,235944,0,1,3
67431,3,1,235946,235946,235947,0,1,2
67432,5,1,235951,235951,235952,0,1,4
67433,6,2,235957,235957,235959,0,2,5
67434,4,2,235961,235961,235963,0,2,2
67435,2,1,235963,235963,235964,0,1,0
67436,5,1,235968,235968,235969,0,1,4
67437,6,1,235974,235974,235975,0,1,5
67438,1,2,235975,235975,235977,0,2,0
67439,3,3,235978,235978,235981,0,3,1
67440,2,1,235980,235981,235982,1,2,0
67441,5,3,235985,235985,235988,0,3,3
67442,1,3,235986,235988,235991,2,5,0
67443,6,2,235992,235992,235994,0,2,1
67444,5,2,235997,235997,235999,0,2,3
67445,6,1,236003,236003,236004,0,1,4
67446,2,2,236005,236005,236007,0,2,1
67447,1,3,236006,236007,236010,1,4,0
67448,2,3,236008,236010,236013,2,5,0
67449,5,2,236013,236013,236015,0,2,0
67450,5,3,236018,236018,236021,0,3,3
67451,6,1,236024,236024,236025,0,1,3
67452,6,1,236030,236030,236031,0,1,5
67453,3,2,236033,236033,236035,0,2,2
67454,4,3,236037,236037,236040,0,3,2
67455,6,1,236043,236043,236044,0,1,3
67456,4,3,236047,236047,236050,0,3,3
67457,3,2,236050,236050,236052,0,2,0
67458,6,3,236056,236056,236059,0,3,4
67459,1,2,236057,236059,236061,2,4,0
67460,3,2,236060,236061,236063,1,3,0
67461,2,3,236062,236063,236066,1,4,0
67462,3,1,236065,236066,236067,1,2,0
67463,6,2,236071,236071,236073,0,2,4
67464,6,2,236077,236077,236079,0,2,4
67465,3,1,236080,236080,236081,0,1,1
67466,3,1,236083,236083,236084,0,1,2
67467,5,3,236088,236088,236091,0,3,4
67468,5,2,236093,236093,236095,0,2,2
67469,1,3,236094,236095,236098,1,4,0
67470,3,2,236097,236098,236100,1,3,0
67471,3,1,236100,236100,236101,0,1,0
67472,1,2,236101,236101,236103,0,2,0
67473,5,1,236106,236106,236107,0,1,3
67474,3,1,236109,236109,236110,0,1,2
67475,1,3,236110,236110,236113,0,3,0
67476,4,3,236114,236114,236117,0,3,1
67477,1,1,236115,236117,236118,2,3,0
67478,1,3,236116,236118,236121,2,5,0
67479,2,2,236118,236121,236123,3,5,0
67480,6,1,236124,236124,236125,0,1,1
67481,2,2,236126,236126,236128,0,2,1
67482,4,1,236130,236130,236131,0,1,2
67483,2,1,236132,236132,236133,0,1,1
67484,3,3,236135,236135,236138,0,3,2
67485,4,1,236139,236139,236140,0,1,1
67486,6,3,236145,236145,236148,0,3,5
67487,6,1,236151,236151,236152,0,1,3
67488,1,2,236152,236152,236154,0,2,0
67489,1,2,236153,236154,236156,1,3,0
67490,2,3,236155,236156,236159,1,4,0
67491,5,1,236160,236160,236161,0,1,1
67492,4,2,236164,236164,236166,0,2,3
67493,1,2,236165,236166,236168,1,3,0
67494,5,2,236170,236170,236172,0,2,2
67495,2,1,236172,236172,236173,0,1,0
67496,4,3,236176,236176,236179,0,3,3
67497,3,3,236179,236179,236182,0,3,0
67498,4,2,236183,236183,236185,0,2,1
67499,2,1,236185,236185,236186,0,1,0
67500,2,1,236187,236187,236188,0,1,1
67501,6,1,236193,236193,236194,0,1,5
67502,4,2,236197,236197,236199,0,2,3
67503,2,2,236199,236199,236201,0,2,0
67504,1,2,236200,236201,236203,1,3,0
67505,6,1,236206,236206,236207,0,1,3
67506,5,2,236211,236211,236213,0,2,4
67507,1,2,236212,236213,236215,1,3,0
67508,1,3,236213,236215,236218,2,5,0
67509,1,3,236214,236218,236221,4,7,0
67510,1,3,236215,236221,236224,6,9,0
67511,4,3,236219,236224,236227,5,8,0
67512,2,3,236221,236227,236230,6,9,0
67513,5,1,236226,236230,236231,4,5,0
67514,1,2,236227,236231,236233,4,6,0
67515,6,1,236233,236233,236234,0,1,0
67516,4,3,236237,236237,236240,0,3,3
67517,6,1,236243,236243,236244,0,1,3
67518,1,3,236244,236244,236247,0,3,0
67519,5,1,236249,236249,236250,0,1,2
67520,4,1,236253,236253,236254,0,1,3
67521,2,1,236255,236255,236256,0,1,1
67522,3,2,236258,236258,236260,0,2,2
67523,5,2,236263,236263,236265,0,2,3
67524,5,2,236268,236268,236270,0,2,3
67525,6,2,236274,236274,236276,0,2,4
67526,3,1,236277,236277,236278,0,1,1
67527,5,1,236282,236282,236283,0,1,4
67528,6,2,236288,236288,236290,0,2,5
67529,3,2,236291,236291,236293,0,2,1
67530,6,2,236297,236297,236299,0,2,4
67531,1,3,236298,236299,236302,1,4,0
67532,1,2,236299,236302,236304,3,5,0
67533,1,2,236300,236304,236306,4,6,0
67534,5,2,236305,236306,236308,1,3,0
67535,3,3,236308,236308,236311,0,3,0
67536,3,2,236311,236311,236313,0,2,0
67537,1,2,236312,236313,236315,1,3,0
67538,4,1,236316,236316,236317,0,1,1
67539,3,1,236319,236319,236320,0,1,2
67540,5,2,236324,236324,236326,0,2,4
67541,4,3,236328,236328,236331,0,3,2
67542,1,1,236329,236331,236332,2,3,0
67543,1,1,236330,236332,236333,2,3,0
67544,6,1,236336,236336,236337,0,1,3
67545,3,3,236339,236339,236342,0,3,2
67546,6,2,236345,236345,236347,0,2,3
67547,6,1,236351,236351,236352,0,1,4
67548,4,2,236355,236355,236357,0,2,3
67549,3,1,236358,236358,236359,0,1,1
67550,3,2,236361,236361,236363,0,2,2
67551,3,3,236364,236364,236367,0,3,1
67552,4,2,236368,236368,236370,0,2,1
67553,3,3,236371,236371,236374,0,3,1
67554,1,3,236372,236374,236377,2,5,0
67555,6,2,236378,236378,236380,0,2,1
67556,4,1,236382,236382,236383,0,1,2
67557,5,2,236387,236387,236389,0,2,4
67558,1,2,236388,236389,236391,1,3,0
67559,6,1,236394,236394,236395,0,1,3
67560,5,1,236399,236399,236400,0,1,4
67561,1,1,236400,236400,236401,0,1,0
67562,4,3,236404,236404,236407,0,3,3
67563,2,2,236406,236407,236409,1,3,0
67564,1,2,236407,236409,236411,2,4,0
67565,2,3,236409,236411,236414,2,5,0
67566,1,3,236410,236414,236417,4,7,0
67567,6,1,236416,236417,236418,1,2,0
67568,2,2,236418,236418,236420,0,2,0
67569,3,2,236421,236421,236423,0,2,1
67570,1,3,236422,236423,236426,1,4,0
67571,4,2,236426,236426,236428,0,2,0
67572,4,2,236430,236430,236432,0,2,2
67573,1,1,236431,236432,236433,1,2,0
67574,4,2,236435,236435,236437,0,2,2
67575,6,2,236441,236441,236443,0,2,4
67576,2,1,236443,236443,236444,0,1,0
67577,3,1,236446,236446,236447,0,1,2
67578,1,3,236447,236447,236450,0,3,0
67579,5,2,236452,236452,236454,0,2,2
67580,4,1,236456,236456,236457,0,1,2
67581,5,2,236461,236461,236463,0,2,4
67582,6,3,236467,236467,236470,0,3,4
67583,1,1,236468,236470,236471,2,3,0
67584,6,1,236474,236474,236475,0,1,3
67585,2,1,236476,236476,236477,0,1,1
67586,3,3,236479,236479,236482,0,3,2
67587,5,3,236484,236484,236487,0,3,2
67588,2,3,236486,236487,236490,1,4,0
67589,3,3,236489,236490,236493,1,4,0
67590,1,1,236490,236493,236494,3,4,0
67591,5,3,236495,236495,236498,0,3,1
67592,2,3,236497,236498,236501,1,4,0
67593,4,1,236501,236501,236502,0,1,0
67594,1,3,236502,236502,236505,0,3,0
67595,5,2,236507,236507,236509,0,2,2
67596,5,3,236512,236512,236515,0,3,3
67597,3,3,236515,236515,236518,0,3,0
67598,4,3,236519,236519,236522,0,3,1
67599,1,3,236520,236522,236525,2,5,0
67600,5,2,236525,236525,236527,0,2,0
67601,6,2,236531,236531,236533,0,2,4
67602,1,1,236532,236533,236534,1,2,0
67603,5,1,236537,236537,236538,0,1,3
67604,5,2,236542,236542,236544,0,2,4
67605,2,1,236544,236544,236545,0,1,0
67606,6,3,236550,236550,236553,0,3,5
67607,1,2,236551,236553,236555,2,4,0
67608,1,2,236552,236555,236557,3,5,0
67609,4,1,236556,236557,236558,1,2,0
67610,2,2,236558,236558,236560,0,2,0
67611,5,3,236563,236563,236566,0,3,3
67612,4,2,236567,236567,236569,0,2,1
67613,1,3,236568,236569,236572,1,4,0
67614,1,2,236569,236572,236574,3,5,0
67615,5,1,236574,236574,236575,0,1,0
67616,1,1,236575,236575,236576,0,1,0
67617,3,1,236578,236578,236579,0,1,2
67618,3,2,236581,236581,236583,0,2,2
67619,4,3,236585,236585,236588,0,3,2
67620,3,3,236588,236588,236591,0,3,0
67621,5,3,236593,236593,236596,0,3,2
67622,4,3,236597,236597,236600,0,3,1
67623,5,3,236602,236602,236605,0,3,2
67624,5,1,236607,236607,236608,0,1,2
67625,6,2,236613,236613,236615,0,2,5
67626,1,3,236614,236615,236618,1,4,0
67627,4,1,236618,236618,236619,0,1,0
67628,4,3,236622,236622,236625,0,3,3
67629,2,2,236624,236625,236627,1,3,0
67630,2,3,236626,236627,236630,1,4,0
67631,3,2,236629,236630,236632,1,3,0
67632,4,3,236633,236633,236636,0,3,1
67633,6,2,236639,236639,236641,0,2,3
67634,1,1,236640,236641,236642,1,2,0
67635,1,1,236641,236642,236643,1,2,0
67636,6,2,236647,236647,236649,0,2,4
67637,2,2,236649,236649,236651,0,2,0
67638,6,3,236655,236655,236658,0,3,4
67639,3,1,236658,236658,236659,0,1,0
67640,6,1,236664,236664,236665,0,1,5
67641,1,3,236665,236665,236668,0,3,0
67642,5,2,236670,236670,236672,0,2,2
67643,2,3,236672,236672,236675,0,3,0
67644,4,2,236676,236676,236678,0,2,1
67645,2,2,236678,236678,236680,0,2,0
67646,5,2,236683,236683,236685,0,2,3
67647,6,3,236689,236689,236692,0,3,4
67648,2,1,236691,236692,236693,1,2,0
67649,6,2,236697,236697,236699,0,2,4
67650,6,3,236703,236703,236706,0,3,4
67651,2,3,236705,236706,236709,1,4,0
67652,4,1,236709,236709,236710,0,1,0
67653,4,1,236713,236713,236714,0,1,3
67654,4,1,236717,236717,236718,0,1,3
67655,6,3,236723,236723,236726,0,3,5
67656,5,2,236728,236728,236730,0,2,2
67657,2,3,236730,236730,236733,0,3,0
67658,4,1,236734,236734,236735,0,1,1
67659,1,1,236735,236735,236736,0,1,0
67660,5,1,236740,236740,236741,0,1,4
67661,6,1,236746,236746,236747,0,1,5
67662,6,2,236752,236752,236754,0,2,5
67663,5,1,236757,236757,236758,0,1,3
67664,4,1,236761,236761,236762,0,1,3
67665,5,3,236766,236766,236769,0,3,4
67666,3,3,236769,236769,236772,0,3,0
67667,6,1,236775,236775,236776,0,1,3
67668,5,2,236780,236780,236782,0,2,4
67669,6,3,236786,236786,236789,0,3,4
67670,5,2,236791,236791,236793,0,2,2
67671,6,3,236797,236797,236800,0,3,4
67672,4,1,236801,236801,236802,0,1,1
67673,5,2,236806,236806,236808,0,2,4
67674,6,3,236812,236812,236815,0,3,4
67675,5,2,236817,236817,236819,0,2,2
67676,3,1,236820,236820,236821,0,1,1
67677,3,1,236823,236823,236824,0,1,2
67678,4,1,236827,236827,236828,0,1,3
67679,1,1,236828,236828,236829,0,1,0
67680,6,1,236834,236834,236835,0,1,5
67681,2,2,236836,236836,236838,0,2,1
67682,1,1,236837,236838,236839,1,2,0
67683,2,2,236839,236839,236841,0,2,0
67684,2,2,236841,236841,236843,0,2,0
67685,5,2,236846,236846,236848,0,2,3
67686,1,1,236847,236848,236849,1,2,0
67687,2,2,236849,236849,236851,0,2,0
67688,5,1,236854,236854,236855,0,1,3
67689,5,3,236859,236859,236862,0,3,4
67690,5,2,236864,236864,236866,0,2,2
67691,4,3,236868,236868,236871,0,3,2
67692,1,3,236869,236871,236874,2,5,0
67693,1,2,236870,236874,236876,4,6,0
67694,2,2,236872,236876,236878,4,6,0
67695,2,1,236874,236878,236879,4,5,0
67696,6,1,236880,236880,236881,0,1,1
67697,3,2,236883,236883,236885,0,2,2
67698,5,3,236888,236888,236891,0,3,3
67699,5,1,236893,236893,236894,0,1,2
67700,2,1,236895,236895,236896,0,1,1
67701,6,1,236901,236901,236902,0,1,5
67702,5,2,236906,236906,236908,0,2,4
67703,1,1,236907,236908,236909,1,2,0
67704,1,2,236908,236909,236911,1,3,0
67705,1,3,236909,236911,236914,2,5,0
67706,4,1,236913,236914,236915,1,2,0
67707,5,1,236918,236918,236919,0,1,3
67708,1,3,236919,236919,236922,0,3,0
67709,2,3,236921,236922,236925,1,4,0
67710,6,3,236927,236927,236930,0,3,2
67711,3,1,236930,236930,236931,0,1,0
67712,2,3,236932,236932,236935,0,3,1
67713,4,2,236936,236936,236938,0,2,1
67714,2,1,236938,236938,236939,0,1,0
67715,6,3,236944,236944,236947,0,3,5
67716,6,1,236950,236950,236951,0,1,3
67717,6,1,236956,236956,236957,0,1,5
67718,4,1,236960,236960,236961,0,1,3
67719,2,2,236962,236962,236964,0,2,1
67720,2,3,236964,236964,236967,0,3,0
67721,2,1,236966,236967,236968,1,2,0
67722,2,3,236968,236968,236971,0,3,0
67723,3,1,236971,236971,236972,0,1,0
67724,4,3,236975,236975,236978,0,3,3
67725,2,2,236977,236978,236980,1,3,0
67726,6,2,236983,236983,236985,0,2,3
67727,4,2,236987,236987,236989,0,2,2
67728,6,1,236993,236993,236994,0,1,4
67729,1,2,236994,236994,236996,0,2,0
67730,2,2,236996,236996,236998,0,2,0
67731,5,3,237001,237001,237004,0,3,3
67732,1,2,237002,237004,237006,2,4,0
67733,3,2,237005,237006,237008,1,3,0
67734,5,3,237010,237010,237013,0,3,2
67735,6,1,237016,237016,237017,0,1,3
67736,4,1,237020,237020,237021,0,1,3
67737,6,3,237026,237026,237029,0,3,5
67738,1,3,237027,237029,237032,2,5,0
67739,1,3,237028,237032,237035,4,7,0
67740,5,1,237033,237035,237036,2,3,0
67741,5,2,237038,237038,237040,0,2,2
67742,5,1,237043,237043,237044,0,1,3
67743,3,1,237046,237046,237047,0,1,2
67744,6,3,237052,237052,237055,0,3,5
67745,5,3,237057,237057,237060,0,3,2
67746,6,3,237063,237063,237066,0,3,3
67747,2,2,237065,237066,237068,1,3,0
67748,5,2,237070,237070,237072,0,2,2
67749,5,1,237075,237075,237076,0,1,3
67750,4,1,237079,237079,237080,0,1,3
67751,1,1,237080,237080,237081,0,1,0
67752,6,3,237086,237086,237089,0,3,5
67753,3,1,237089,237089,237090,0,1,0
67754,5,1,237094,237094,237095,0,1,4
67755,2,3,237096,237096,237099,0,3,1
67756,1,3,237097,237099,237102,2,5,0
67757,5,2,237102,237102,237104,0,2,0
67758,1,2,237103,237104,237106,1,3,0
67759,1,2,237104,237106,237108,2,4,0
67760,4,3,237108,237108,237111,0,3,0
67761,2,1,237110,237111,237112,1,2,0
67762,1,2,237111,237112,237114,1,3,0
67763,5,1,237116,237116,237117,0,1,2
67764,2,1,237118,237118,237119,0,1,1
67765,5,3,237123,237123,237126,0,3,4
67766,3,1,237126,237126,237127,0,1,0
67767,4,2,237130,237130,237132,0,2,3
67768,4,2,237134,237134,237136,0,2,2
67769,1,1,237135,237136,237137,1,2,0
67770,4,2,237139,237139,237141,0,2,2
67771,6,2,237145,237145,237147,0,2,4
67772,4,2,237149,237149,237151,0,2,2
67773,2,2,237151,237151,237153,0,2,0
67774,4,3,237155,237155,237158,0,3,2
67775,5,1,237160,237160,237161,0,1,2
67776,6,1,237166,237166,237167,0,1,5
67777,3,3,237169,237169,237172,0,3,2
67778,6,1,237175,237175,237176,0,1,3
67779,2,2,237177,237177,237179,0,2,1
67780,6,3,237183,237183,237186,0,3,4
67781,2,2,237185,237186,237188,1,3,0
67782,6,2,237191,237191,237193,0,2,3
67783,4,3,237195,237195,237198,0,3,2
67784,1,2,237196,237198,237200,2,4,0
67785,3,2,237199,237200,237202,1,3,0
67786,3,3,237202,237202,237205,0,3,0
67787,1,2,237203,237205,237207,2,4,0
67788,1,3,237204,237207,237210,3,6,0
67789,4,1,237208,237210,237211,2,3,0
67790,3,3,237211,237211,237214,0,3,0
67791,5,2,237216,237216,237218,0,2,2
67792,4,2,237220,237220,237222,0,2,2
67793,6,2,237226,237226,237228,0,2,4
67794,4,3,237230,237230,237233,0,3,2
67795,1,2,237231,237233,237235,2,4,0
67796,3,3,237234,237235,237238,1,4,0
67797,4,1,237238,237238,237239,0,1,0
67798,3,3,237241,237241,237244,0,3,2
67799,3,3,237244,237244,237247,0,3,0
67800,3,1,237247,237247,237248,0,1,0
67801,4,3,237251,237251,237254,0,3,3
67802,3,2,237254,237254,237256,0,2,0
67803,6,2,237260,237260,237262,0,2,4
67804,4,3,237264,237264,237267,0,3,2
67805,3,2,237267,237267,237269,0,2,0
67806,6,3,237273,237273,237276,0,3,4
67807,3,1,237276,237276,237277,0,1,0
67808,4,3,237280,237280,237283,0,3,3
67809,5,1,237285,237285,237286,0,1,2
67810,5,3,237290,237290,237293,0,3,4
67811,4,3,237294,237294,237297,0,3,1
67812,6,3,237300,237300,237303,0,3,3
67813,1,3,237301,237303,237306,2,5,0
67814,3,1,237304,237306,237307,2,3,0
67815,6,1,237310,237310,237311,0,1,3
67816,4,3,237314,237314,237317,0,3,3
67817,4,1,237318,237318,237319,0,1,1
67818,4,3,237322,237322,237325,0,3,3
67819,1,3,237323,237325,237328,2,5,0
67820,1,3,237324,237328,237331,4,7,0
67821,6,1,237330,237331,237332,1,2,0
67822,5,1,237335,237335,237336,0,1,3
67823,2,3,237337,237337,237340,0,3,1
67824,2,2,237339,237340,237342,1,3,0
67825,4,1,237343,237343,237344,0,1,1
67826,4,1,237347,237347,237348,0,1,3
67827,6,3,237353,237353,237356,0,3,5
67828,5,1,237358,237358,237359,0,1,2
67829,6,2,237364,237364,237366,0,2,5
67830,6,1,237370,237370,237371,0,1,4
67831,3,1,237373,237373,237374,0,1,2
67832,1,1,237374,237374,237375,0,1,0
67833,3,3,237377,237377,237380,0,3,2
67834,6,1,237383,237383,237384,0,1,3
67835,1,3,237384,237384,237387,0,3,0
67836,2,2,237386,237387,237389,1,3,0
67837,4,3,237390,237390,237393,0,3,1
67838,4,3,237394,237394,237397,0,3,1
67839,4,3,237398,237398,237401,0,3,1
67840,4,1,237402,237402,237403,0,1,1
67841,2,2,237404,237404,237406,0,2,1
67842,5,1,237409,237409,237410,0,1,3
67843,4,2,237413,237413,237415,0,2,3
67844,6,2,237419,237419,237421,0,2,4
67845,3,2,237422,237422,237424,0,2,1
67846,3,1,237425,237425,237426,0,1,1
67847,4,2,237429,237429,237431,0,2,3
67848,5,3,237434,237434,237437,0,3,3
67849,2,2,237436,237437,237439,1,3,0
67850,1,2,237437,237439,237441,2,4,0
67851,1,1,237438,237441,237442,3,4,0
67852,2,2,237440,237442,237444,2,4,0
67853,3,3,237443,237444,237447,1,4,0
67854,4,1,237447,237447,237448,0,1,0
67855,1,3,237448,237448,237451,0,3,0
67856,5,3,237453,237453,237456,0,3,2
67857,6,1,237459,237459,237460,0,1,3
67858,1,3,237460,237460,237463,0,3,0
67859,4,1,237464,237464,237465,0,1,1
67860,3,3,237467,237467,237470,0,3,2
67861,3,1,237470,237470,237471,0,1,0
67862,1,3,237471,237471,237474,0,3,0
67863,3,1,237474,237474,237475,0,1,0
67864,3,1,237477,237477,237478,0,1,2
67865,4,1,237481,237481,237482,0,1,3
67866,5,2,237486,237486,237488,0,2,4
67867,4,3,237490,237490,237493,0,3,2
67868,1,2,237491,237493,237495,2,4,0
67869,6,3,237497,237497,237500,0,3,2
67870,2,3,237499,237500,237503,1,4,0
67871,3,1,237502,237503,237504,1,2,0
67872,2,3,237504,237504,237507,0,3,0
67873,4,1,237508,237508,237509,0,1,1
67874,2,1,237510,237510,237511,0,1,1
67875,3,3,237513,237513,237516,0,3,2
67876,2,1,237515,237516,237517,1,2,0
67877,2,1,237517,237517,237518,0,1,0
67878,5,3,237522,237522,237525,0,3,4
67879,3,3,237525,237525,237528,0,3,0
67880,5,3,237530,237530,237533,0,3,2
67881,2,1,237532,237533,237534,1,2,0
67882,3,1,237535,237535,237536,0,1,1
67883,6,1,237541,237541,237542,0,1,5
67884,3,3,237544,237544,237547,0,3,2
67885,2,2,237546,237547,237549,1,3,0
67886,1,1,237547,237549,237550,2,3,0
67887,2,3,237549,237550,237553,1,4,0
67888,1,2,237550,237553,237555,3,5,0
67889,2,1,237552,237555,237556,3,4,0
67890,5,3,237557,237557,237560,0,3,1
67891,4,2,237561,237561,237563,0,2,1
67892,5,2,237566,237566,237568,0,2,3
67893,2,2,237568,237568,237570,0,2,0
67894,1,1,237569,237570,237571,1,2,0
67895,4,2,237573,237573,237575,0,2,2
67896,5,2,237578,237578,237580,0,2,3
67897,1,1,237579,237580,237581,1,2,0
67898,4,1,237583,237583,237584,0,1,2
67899,6,2,237589,237589,237591,0,2,5
67900,6,2,237595,237595,237597,0,2,4
67901,2,1,237597,237597,237598,0,1,0
67902,3,1,237600,237600,237601,0,1,2
67903,2,3,237602,237602,237605,0,3,1
67904,3,3,237605,237605,237608,0,3,0
67905,3,2,237608,237608,237610,0,2,0
67906,5,1,237613,237613,237614,0,1,3
67907,4,3,237617,237617,237620,0,3,3
67908,2,1,237619,237620,237621,1,2,0
67909,6,3,237625,237625,237628,0,3,4
67910,3,1,237628,237628,237629,0,1,0
67911,2,3,237630,237630,237633,0,3,1
67912,3,1,237633,237633,237634,0,1,0
67913,3,2,237636,237636,237638,0,2,2
67914,2,3,237638,237638,237641,0,3,0
67915,6,2,237644,237644,237646,0,2,3
67916,3,3,237647,237647,237650,0,3,1
67917,3,1,237650,237650,237651,0,1,0
67918,5,2,237655,237655,237657,0,2,4
67919,4,3,237659,237659,237662,0,3,2
67920,3,1,237662,237662,237663,0,1,0
67921,1,3,237663,237663,237666,0,3,0
67922,2,1,237665,237666,237667,1,2,0
67923,5,3,237670,237670,237673,0,3,3
67924,1,3,237671,237673,237676,2,5,0
67925,4,1,237675,237676,237677,1,2,0
67926,6,2,237681,237681,237683,0,2,4
67927,6,1,237687,237687,237688,0,1,4
67928,3,3,237690,237690,237693,0,3,2
67929,6,3,237696,237696,237699,0,3,3
67930,6,2,237702,237702,237704,0,2,3
67931,5,2,237707,237707,237709,0,2,3
67932,3,2,237710,237710,237712,0,2,1
67933,4,1,237714,237714,237715,0,1,2
67934,6,2,237720,237720,237722,0,2,5
67935,1,2,237721,237722,237724,1,3,0
67936,2,1,237723,237724,237725,1,2,0
67937,4,2,237727,237727,237729,0,2,2
67938,2,1,237729,237729,237730,0,1,0
67939,2,2,237731,237731,237733,0,2,1
67940,5,1,237736,237736,237737,0,1,3
67941,2,2,237738,237738,237740,0,2,1
67942,3,1,237741,237741,237742,0,1,1
67943,4,3,237745,237745,237748,0,3,3
67944,3,2,237748,237748,237750,0,2,0
67945,6,2,237754,237754,237756,0,2,4
67946,6,1,237760,237760,237761,0,1,4
67947,2,3,237762,237762,237765,0,3,1
67948,1,3,237763,237765,237768,2,5,0
67949,2,3,237765,237768,237771,3,6,0
67950,3,1,237768,237771,237772,3,4,0
67951,2,3,237770,237772,237775,2,5,0
67952,5,1,237775,237775,237776,0,1,0
67953,2,2,237777,237777,237779,0,2,1
67954,5,1,237782,237782,237783,0,1,3
67955,5,2,237787,237787,237789,0,2,4
67956,6,2,237793,237793,237795,0,2,4
67957,3,1,237796,237796,237797,0,1,1
67958,4,2,237800,237800,237802,0,2,3
67959,2,1,237802,237802,237803,0,1,0
67960,3,1,237805,237805,237806,0,1,2
67961,3,3,237808,237808,237811,0,3,2
67962,2,2,237810,237811,237813,1,3,0
67963,6,1,237816,237816,237817,0,1,3
67964,6,3,237822,237822,237825,0,3,5
67965,3,1,237825,237825,237826,0,1,0
67966,2,2,237827,237827,237829,0,2,1
67967,2,1,237829,237829,237830,0,1,0
67968,1,1,237830,237830,237831,0,1,0
67969,5,3,237835,237835,237838,0,3,4
67970,3,1,237838,237838,237839,0,1,0
67971,4,1,237842,237842,237843,0,1,3
67972,4,2,237846,237846,237848,0,2,3
67973,5,1,237851,237851,237852,0,1,3
67974,2,3,237853,237853,237856,0,3,1
67975,2,3,237855,237856,237859,1,4,0
67976,4,3,237859,237859,237862,0,3,0
67977,1,2,237860,237862,237864,2,4,0
67978,2,2,237862,237864,237866,2,4,0
67979,2,2,237864,237866,237868,2,4,0
67980,1,2,237865,237868,237870,3,5,0
67981,2,2,237867,237870,237872,3,5,0
67982,6,1,237873,237873,237874,0,1,1
67983,1,3,237874,237874,237877,0,3,0
67984,1,1,237875,237877,237878,2,3,0
67985,4,3,237879,237879,237882,0,3,1
67986,3,3,237882,237882,237885,0,3,0
67987,4,3,237886,237886,237889,0,3,1
67988,5,1,237891,237891,237892,0,1,2
67989,3,1,237894,237894,237895,0,1,2
67990,3,1,237897,237897,237898,0,1,2
67991,6,3,237903,237903,237906,0,3,5
67992,3,2,237906,237906,237908,0,2,0
67993,1,3,237907,237908,237911,1,4,0
67994,5,2,237912,237912,237914,0,2,1
67995,3,2,237915,237915,237917,0,2,1
67996,2,2,237917,237917,237919,0,2,0
67997,2,1,237919,237919,237920,0,1,0
67998,1,1,237920,237920,237921,0,1,0
67999,1,3,237921,237921,237924,0,3,0
68000,1,2,237922,237924,237926,2,4,0
68001,5,1,237927,237927,237928,0,1,1
68002,1,1,237928,237928,237929,0,1,0
68003,5,3,237933,237933,237936,0,3,4
68004,5,1,237938,237938,237939,0,1,2
68005,4,1,237942,237942,237943,0,1,3
68006,3,2,237945,237945,237947,0,2,2
68007,4,2,237949,237949,237951,0,2,2
68008,6,3,237955,237955,237958,0,3,4
68009,5,3,237960,237960,237963,0,3,2
68010,3,2,237963,237963,237965,0,2,0
68011,5,3,237968,237968,237971,0,3,3
68012,1,3,237969,237971,237974,2,5,0
68013,5,3,237974,237974,237977,0,3,0
68014,3,1,237977,237977,237978,0,1,0
68015,1,3,237978,237978,237981,0,3,0
68016,3,1,237981,237981,237982,0,1,0
68017,5,1,237986,237986,237987,0,1,4
68018,3,1,237989,237989,237990,0,1,2
68019,2,3,237991,237991,237994,0,3,1
68020,4,3,237995,237995,237998,0,3,1
68021,6,1,238001,238001,238002,0,1,3
68022,3,3,238004,238004,238007,0,3,2
68023,6,3,238010,238010,238013,0,3,3
68024,5,2,238015,238015,238017,0,2,2
68025,2,1,238017,238017,238018,0,1,0
68026,2,1,238019,238019,238020,0,1,1
68027,1,3,238020,238020,238023,0,3,0
68028,5,3,238025,238025,238028,0,3,2
68029,1,1,238026,238028,238029,2,3,0
68030,6,1,238032,238032,238033,0,1,3
68031,3,3,238035,238035,238038,0,3,2
68032,2,2,238037,238038,238040,1,3,0
68033,4,1,238041,238041,238042,0,1,1
68034,6,2,238047,238047,238049,0,2,5
68035,4,1,238051,238051,238052,0,1,2
68036,2,3,238053,238053,238056,0,3,1
68037,3,2,238056,238056,238058,0,2,0
68038,4,1,238060,238060,238061,0,1,2
68039,4,3,238064,238064,238067,0,3,3
68040,2,2,238066,238067,238069,1,3,0
68041,3,3,238069,238069,238072,0,3,0
68042,2,2,238071,238072,238074,1,3,0
68043,3,3,238074,238074,238077,0,3,0
68044,1,3,238075,238077,238080,2,5,0
68045,2,3,238077,238080,238083,3,6,0
68046,6,1,238083,238083,238084,0,1,0
68047,2,1,238085,238085,238086,0,1,1
68048,5,2,238090,238090,238092,0,2,4
68049,4,1,238094,238094,238095,0,1,2
68050,6,3,238100,238100,238103,0,3,5
68051,5,2,238105,238105,238107,0,2,2
68052,5,1,238110,238110,238111,0,1,3
68053,5,1,238115,238115,238116,0,1,4
68054,1,2,238116,238116,238118,0,2,0
68055,5,3,238121,238121,238124,0,3,3
68056,5,2,238126,238126,238128,0,2,2
68057,6,3,238132,238132,238135,0,3,4
68058,3,1,238135,238135,238136,0,1,0
68059,2,1,238137,238137,238138,0,1,1
68060,5,2,238142,238142,238144,0,2,4
68061,3,1,238145,238145,238146,0,1,1
68062,2,2,238147,238147,238149,0,2,1
68063,2,1,238149,238149,238150,0,1,0
68064,3,3,238152,238152,238155,0,3,2
68065,4,3,238156,238156,238159,0,3,1
68066,5,2,238161,238161,238163,0,2,2
68067,4,2,238165,238165,238167,0,2,2
68068,6,2,238171,238171,238173,0,2,4
68069,6,2,238177,238177,238179,0,2,4
68070,2,2,238179,238179,238181,0,2,0
68071,3,2,238182,238182,238184,0,2,1
68072,3,3,238185,238185,238188,0,3,1
68073,2,1,238187,238188,238189,1,2,0
68074,1,2,238188,238189,238191,1,3,0
68075,6,3,238194,238194,238197,0,3,3
68076,6,3,238200,238200,238203,0,3,3
68077,4,2,238204,238204,238206,0,2,1
68078,5,2,238209,238209,238211,0,2,3
68079,4,1,238213,238213,238214,0,1,2
68080,6,3,238219,238219,238222,0,3,5
68081,5,2,238224,238224,238226,0,2,2
68082,4,2,238228,238228,238230,0,2,2
68083,3,2,238231,238231,238233,0,2,1
68084,6,3,238237,238237,238240,0,3,4
68085,1,3,238238,238240,238243,2,5,0
68086,6,1,238244,238244,238245,0,1,1
68087,5,1,238249,238249,238250,0,1,4
68088,4,2,238253,238253,238255,0,2,3
68089,1,2,238254,238255,238257,1,3,0
68090,3,3,238257,238257,238260,0,3,0
68091,5,3,238262,238262,238265,0,3,2
68092,4,1,238266,238266,238267,0,1,1
68093,6,1,238272,238272,238273,0,1,5
68094,1,2,238273,238273,238275,0,2,0
68095,2,2,238275,238275,238277,0,2,0
68096,2,3,238277,238277,238280,0,3,0
68097,4,3,238281,238281,238284,0,3,1
68098,3,3,238284,238284,238287,0,3,0
68099,5,3,238289,238289,238292,0,3,2
68100,6,2,238295,238295,238297,0,2,3
68101,2,2,238297,238297,238299,0,2,0
68102,5,3,238302,238302,238305,0,3,3
68103,1,1,238303,238305,238306,2,3,0
68104,4,1,238307,238307,238308,0,1,1
68105,6,3,238313,238313,238316,0,3,5
68106,4,3,238317,238317,238320,0,3,1
68107,6,2,238323,238323,238325,0,2,3
68108,6,3,238329,238329,238332,0,3,4
68109,3,3,238332,238332,238335,0,3,0
68110,2,3,238334,238335,238338,1,4,0
68111,6,1,238340,238340,238341,0,1,2
68112,6,1,238346,238346,238347,0,1,5
68113,5,3,238351,238351,238354,0,3,4
68114,4,2,238355,238355,238357,0,2,1
68115,2,3,238357,238357,238360,0,3,0
68116,2,3,238359,238360,238363,1,4,0
68117,3,1,238362,238363,238364,1,2,0
68118,5,1,238367,238367,238368,0,1,3
68119,2,2,238369,238369,238371,0,2,1
68120,6,2,238375,238375,238377,0,2,4
68121,4,2,238379,238379,238381,0,2,2
68122,4,3,238383,238383,238386,0,3,2
68123,3,2,238386,238386,238388,0,2,0
68124,3,1,238389,238389,238390,0,1,1
68125,6,1,238395,238395,238396,0,1,5
68126,2,2,238397,238397,238399,0,2,1
68127,2,3,238399,238399,238402,0,3,0
68128,5,3,238404,238404,238407,0,3,2
68129,2,1,238406,238407,238408,1,2,0
68130,6,1,238412,238412,238413,0,1,4
68131,2,3,238414,238414,238417,0,3,1
68132,6,1,238420,238420,238421,0,1,3
68133,2,2,238422,238422,238424,0,2,1
68134,5,1,238427,238427,238428,0,1,3
68135,5,1,238432,238432,238433,0,1,4
68136,2,1,238434,238434,238435,0,1,1
68137,2,3,238436,238436,238439,0,3,1
68138,6,1,238442,238442,238443,0,1,3
68139,2,2,238444,238444,238446,0,2,1
68140,1,3,238445,238446,238449,1,4,0
68141,3,2,238448,238449,238451,1,3,0
68142,5,1,238453,238453,238454,0,1,2
68143,3,1,238456,238456,238457,0,1,2
68144,5,3,238461,238461,238464,0,3,4
68145,6,3,238467,238467,238470,0,3,3
68146,5,3,238472,238472,238475,0,3,2
68147,4,3,238476,238476,238479,0,3,1
68148,4,3,238480,238480,238483,0,3,1
68149,5,2,238485,238485,238487,0,2,2
68150,5,2,238490,238490,238492,0,2,3
68151,6,2,238496,238496,238498,0,2,4
68152,1,2,238497,238498,238500,1,3,0
68153,4,3,238501,238501,238504,0,3,1
68154,4,3,238505,238505,238508,0,3,1
68155,1,1,238506,238508,238509,2,3,0
68156,1,3,238507,238509,238512,2,5,0
68157,1,1,238508,238512,238513,4,5,0
68158,4,3,238512,238513,238516,1,4,0
68159,4,2,238516,238516,238518,0,2,0
68160,3,3,238519,238519,238522,0,3,1
68161,1,3,238520,238522,238525,2,5,0
68162,4,1,238524,238525,238526,1,2,0
68163,4,3,238528,238528,238531,0,3,2
68164,3,1,238531,238531,238532,0,1,0
68165,4,3,238535,238535,238538,0,3,3
68166,2,3,238537,238538,238541,1,4,0
68167,4,3,238541,238541,238544,0,3,0
68168,3,1,238544,238544,238545,0,1,0
68169,2,2,238546,238546,238548,0,2,1
68170,2,3,238548,238548,238551,0,3,0
68171,6,2,238554,238554,238556,0,2,3
68172,3,3,238557,238557,238560,0,3,1
68173,6,1,238563,238563,238564,0,1,3
68174,5,1,238568,238568,238569,0,1,4
68175,5,1,238573,238573,238574,0,1,4
68176,4,2,238577,238577,238579,0,2,3
68177,4,3,238581,238581,238584,0,3,2
68178,3,2,238584,238584,238586,0,2,0
68179,2,2,238586,238586,238588,0,2,0
68180,6,1,238592,238592,238593,0,1,4
68181,3,2,238595,238595,238597,0,2,2
68182,6,2,238601,238601,238603,0,2,4
68183,1,3,238602,238603,238606,1,4,0
68184,3,1,238605,238606,238607,1,2,0
68185,1,2,238606,238607,238609,1,3,0
68186,4,1,238610,238610,238611,0,1,1
68187,4,2,238614,238614,238616,0,2,3
68188,4,3,238618,238618,238621,0,3,2
68189,2,3,238620,238621,238624,1,4,0
68190,4,2,238624,238624,238626,0,2,0
68191,6,1,238630,238630,238631,0,1,4
68192,4,2,238634,238634,238636,0,2,3
68193,1,2,238635,238636,238638,1,3,0
68194,6,1,238641,238641,238642,0,1,3
68195,2,3,238643,238643,238646,0,3,1
68196,2,1,238645,238646,238647,1,2,0
68197,1,3,238646,238647,238650,1,4,0
68198,1,1,238647,238650,238651,3,4,0
68199,6,3,238653,238653,238656,0,3,2
68200,2,2,238655,238656,238658,1,3,0
68201,5,2,238660,238660,238662,0,2,2
68202,4,2,238664,238664,238666,0,2,2
68203,1,3,238665,238666,238669,1,4,0
68204,2,3,238667,238669,238672,2,5,0
68205,3,2,238670,238672,238674,2,4,0
68206,3,2,238673,238674,238676,1,3,0
68207,6,2,238679,238679,238681,0,2,3
68208,6,2,238685,238685,238687,0,2,4
68209,3,3,238688,238688,238691,0,3,1
68210,5,1,238693,238693,238694,0,1,2
68211,3,2,238696,238696,238698,0,2,2
68212,2,2,238698,238698,238700,0,2,0
68213,3,3,238701,238701,238704,0,3,1
68214,4,2,238705,238705,238707,0,2,1
68215,6,1,238711,238711,238712,0,1,4
68216,1,2,238712,238712,238714,0,2,0
68217,6,3,238718,238718,238721,0,3,4
68218,6,1,238724,238724,238725,0,1,3
68219,5,3,238729,238729,238732,0,3,4
68220,2,1,238731,238732,238733,1,2,0
68221,3,2,238734,238734,238736,0,2,1
68222,2,2,238736,238736,238738,0,2,0
68223,1,1,238737,238738,238739,1,2,0
68224,3,1,238740,238740,238741,0,1,1
68225,6,3,238746,238746,238749,0,3,5
68226,4,2,238750,238750,238752,0,2,1
68227,1,2,238751,238752,238754,1,3,0
68228,1,1,238752,238754,238755,2,3,0
68229,6,1,238758,238758,238759,0,1,3
68230,6,2,238764,238764,238766,0,2,5
68231,4,2,238768,238768,238770,0,2,2
68232,2,1,238770,238770,238771,0,1,0
68233,4,1,238774,238774,238775,0,1,3
68234,1,1,238775,238775,238776,0,1,0
68235,3,3,238778,238778,238781,0,3,2
68236,5,2,238783,238783,238785,0,2,2
68237,6,1,238789,238789,238790,0,1,4
68238,6,1,238795,238795,238796,0,1,5
68239,5,3,238800,238800,238803,0,3,4
68240,2,1,238802,238803,238804,1,2,0
68241,2,2,238804,238804,238806,0,2,0
68242,5,3,238809,238809,238812,0,3,3
68243,3,3,238812,238812,238815,0,3,0
68244,3,2,238815,238815,238817,0,2,0
68245,1,3,238816,238817,238820,1,4,0
68246,1,2,238817,238820,238822,3,5,0
68247,4,1,238821,238822,238823,1,2,0
68248,4,2,238825,238825,238827,0,2,2
68249,4,3,238829,238829,238832,0,3,2
68250,6,2,238835,238835,238837,0,2,3
68251,6,3,238841,238841,238844,0,3,4
68252,1,2,238842,238844,238846,2,4,0
68253,2,1,238844,238846,238847,2,3,0
68254,6,2,238850,238850,238852,0,2,3
68255,1,3,238851,238852,238855,1,4,0
68256,1,3,238852,238855,238858,3,6,0
68257,1,1,238853,238858,238859,5,6,0
68258,2,1,238855,238859,238860,4,5,0
68259,6,2,238861,238861,238863,0,2,1
68260,6,3,238867,238867,238870,0,3,4
68261,5,3,238872,238872,238875,0,3,2
68262,1,3,238873,238875,238878,2,5,0
68263,1,2,238874,238878,238880,4,6,0
68264,2,2,238876,238880,238882,4,6,0
68265,4,2,238880,238882,238884,2,4,0
68266,3,3,238883,238884,238887,1,4,0
68267,5,2,238888,238888,238890,0,2,1
68268,2,3,238890,238890,238893,0,3,0
68269,3,3,238893,238893,238896,0,3,0
68270,6,1,238899,238899,238900,0,1,3
68271,5,3,238904,238904,238907,0,3,4
68272,1,3,238905,238907,238910,2,5,0
68273,2,2,238907,238910,238912,3,5,0
68274,2,3,238909,238912,238915,3,6,0
68275,6,3,238915,238915,238918,0,3,0
68276,3,1,238918,238918,238919,0,1,0
68277,5,1,238923,238923,238924,0,1,4
68278,2,1,238925,238925,238926,0,1,1
68279,5,1,238930,238930,238931,0,1,4
68280,5,1,238935,238935,238936,0,1,4
68281,1,1,238936,238936,238937,0,1,0
68282,6,3,238942,238942,238945,0,3,5
68283,4,2,238946,238946,238948,0,2,1
68284,6,2,238952,238952,238954,0,2,4
68285,3,1,238955,238955,238956,0,1,1
68286,3,3,238958,238958,238961,0,3,2
68287,1,2,238959,238961,238963,2,4,0
68288,6,1,238965,238965,238966,0,1,2
68289,1,2,238966,238966,238968,0,2,0
68290,4,1,238970,238970,238971,0,1,2
68291,3,3,238973,238973,238976,0,3,2
68292,3,3,238976,238976,238979,0,3,0
68293,5,3,238981,238981,238984,0,3,2
68294,1,2,238982,238984,238986,2,4,0
68295,1,1,238983,238986,238987,3,4,0
68296,1,1,238984,238987,238988,3,4,0
68297,6,2,238990,238990,238992,0,2,2
68298,5,1,238995,238995,238996,0,1,3
68299,4,3,238999,238999,239002,0,3,3
68300,1,1,239000,239002,239003,2,3,0
68301,6,2,239006,239006,239008,0,2,3
68302,2,1,239008,239008,239009,0,1,0
68303,3,2,239011,239011,239013,0,2,2
68304,4,2,239015,239015,239017,0,2,2
68305,2,2,239017,239017,239019,0,2,0
68306,2,1,239019,239019,239020,0,1,0
68307,4,3,239023,239023,239026,0,3,3
68308,2,3,239025,239026,239029,1,4,0
68309,3,2,239028,239029,239031,1,3,0
68310,5,2,239033,239033,239035,0,2,2
68311,4,2,239037,239037,239039,0,2,2
68312,4,1,239041,239041,239042,0,1,2
68313,3,2,239044,239044,239046,0,2,2
68314,1,1,239045,239046,239047,1,2,0
68315,4,2,239049,239049,239051,0,2,2
68316,2,3,239051,239051,239054,0,3,0
68317,1,2,239052,239054,239056,2,4,0
68318,1,2,239053,239056,239058,3,5,0
68319,6,3,239059,239059,239062,0,3,1
68320,5,3,239064,239064,239067,0,3,2
68321,6,2,239070,239070,239072,0,2,3
68322,3,2,239073,239073,239075,0,2,1
68323,4,3,239077,239077,239080,0,3,2
68324,6,3,239083,239083,239086,0,3,3
68325,3,2,239086,239086,239088,0,2,0
68326,5,1,239091,239091,239092,0,1,3
68327,3,2,239094,239094,239096,0,2,2
68328,1,3,239095,239096,239099,1,4,0
68329,5,1,239100,239100,239101,0,1,1
68330,4,1,239104,239104,239105,0,1,3
68331,1,2,239105,239105,239107,0,2,0
68332,5,2,239110,239110,239112,0,2,3
68333,6,3,239116,239116,239119,0,3,4
68334,6,1,239122,239122,239123,0,1,3
68335,2,3,239124,239124,239127,0,3,1
68336,5,1,239129,239129,239130,0,1,2
68337,5,2,239134,239134,239136,0,2,4
68338,4,3,239138,239138,239141,0,3,2
68339,6,3,239144,239144,239147,0,3,3
68340,1,1,239145,239147,239148,2,3,0
68341,6,2,239151,239151,239153,0,2,3
68342,5,3,239156,239156,239159,0,3,3
68343,1,3,239157,239159,239162,2,5,0
68344,4,1,239161,239162,239163,1,2,0
68345,3,2,239164,239164,239166,0,2,1
68346,2,3,239166,239166,239169,0,3,0
68347,2,2,239168,239169,239171,1,3,0
68348,6,2,239174,239174,239176,0,2,3
68349,6,3,239180,239180,239183,0,3,4
68350,5,2,239185,239185,239187,0,2,2
68351,1,3,239186,239187,239190,1,4,0
68352,1,2,239187,239190,239192,3,5,0
68353,4,1,239191,239192,239193,1,2,0
68354,2,1,239193,239193,239194,0,1,0
68355,2,2,239195,239195,239197,0,2,1
68356,3,1,239198,239198,239199,0,1,1
68357,3,1,239201,239201,239202,0,1,2
68358,1,2,239202,239202,239204,0,2,0
68359,5,1,239207,239207,239208,0,1,3
68360,6,3,239213,239213,239216,0,3,5
68361,2,1,239215,239216,239217,1,2,0
68362,6,3,239221,239221,239224,0,3,4
68363,4,1,239225,239225,239226,0,1,1
68364,3,1,239228,239228,239229,0,1,2
68365,2,2,239230,239230,239232,0,2,1
68366,3,1,239233,239233,239234,0,1,1
68367,3,2,239236,239236,239238,0,2,2
68368,4,1,239240,239240,239241,0,1,2
68369,5,1,239245,239245,239246,0,1,4
68370,3,3,239248,239248,239251,0,3,2
68371,2,2,239250,239251,239253,1,3,0
68372,6,2,239256,239256,239258,0,2,3
68373,3,2,239259,239259,239261,0,2,1
68374,3,1,239262,239262,239263,0,1,1
68375,4,1,239266,239266,239267,0,1,3
68376,6,1,239272,239272,239273,0,1,5
68377,1,1,239273,239273,239274,0,1,0
68378,6,3,239279,239279,239282,0,3,5
68379,2,1,239281,239282,239283,1,2,0
68380,5,3,239286,239286,239289,0,3,3
68381,1,2,239287,239289,239291,2,4,0
68382,1,3,239288,239291,239294,3,6,0
68383,4,1,239292,239294,239295,2,3,0
68384,1,2,239293,239295,239297,2,4,0
68385,4,3,239297,239297,239300,0,3,0
68386,2,1,239299,239300,239301,1,2,0
68387,1,3,239300,239301,239304,1,4,0
68388,6,1,239306,239306,239307,0,1,2
68389,4,2,239310,239310,239312,0,2,3
68390,1,1,239311,239312,239313,1,2,0
68391,1,2,239312,239313,239315,1,3,0
68392,3,1,239315,239315,239316,0,1,0
68393,6,1,239321,239321,239322,0,1,5
68394,5,2,239326,239326,239328,0,2,4
68395,5,3,239331,239331,239334,0,3,3
68396,4,2,239335,239335,239337,0,2,1
68397,3,2,239338,239338,239340,0,2,1
68398,3,3,239341,239341,239344,0,3,1
68399,4,1,239345,239345,239346,0,1,1
68400,6,1,239351,239351,239352,0,1,5
68401,6,1,239357,239357,239358,0,1,5
68402,6,1,239363,239363,239364,0,1,5
68403,2,1,239365,239365,239366,0,1,1
68404,1,2,239366,239366,239368,0,2,0
68405,4,3,239370,239370,239373,0,3,2
68406,1,3,239371,239373,239376,2,5,0
68407,2,1,239373,239376,239377,3,4,0
68408,2,1,239375,239377,239378,2,3,0
68409,1,3,239376,239378,239381,2,5,0
68410,2,3,239378,239381,239384,3,6,0
68411,5,2,239383,239384,239386,1,3,0
68412,5,2,239388,239388,239390,0,2,2
68413,6,1,239394,239394,239395,0,1,4
68414,1,3,239395,239395,239398,0,3,0
68415,1,2,239396,239398,239400,2,4,0
68416,6,3,239402,239402,239405,0,3,2
68417,3,2,239405,239405,239407,0,2,0
68418,5,1,239410,239410,239411,0,1,3
68419,5,1,239415,239415,239416,0,1,4
68420,6,2,239421,239421,239423,0,2,5
68421,5,2,239426,239426,239428,0,2,3
68422,3,3,239429,239429,239432,0,3,1
68423,2,1,239431,239432,239433,1,2,0
68424,5,3,239436,239436,239439,0,3,3
68425,3,3,239439,239439,239442,0,3,0
68426,6,1,239445,239445,239446,0,1,3
68427,3,2,239448,239448,239450,0,2,2
68428,5,1,239453,239453,239454,0,1,3
68429,5,3,239458,239458,239461,0,3,4
68430,2,2,239460,239461,239463,1,3,0
68431,5,1,239465,239465,239466,0,1,2
68432,3,1,239468,239468,239469,0,1,2
68433,3,3,239471,239471,239474,0,3,2
68434,2,3,239473,239474,239477,1,4,0
68435,4,2,239477,239477,239479,0,2,0
68436,2,2,239479,239479,239481,0,2,0
68437,3,3,239482,239482,239485,0,3,1
68438,4,1,239486,239486,239487,0,1,1
68439,2,3,239488,239488,239491,0,3,1
68440,5,1,239493,239493,239494,0,1,2
68441,5,2,239498,239498,239500,0,2,4
68442,1,1,239499,239500,239501,1,2,0
68443,5,3,239504,239504,239507,0,3,3
68444,1,2,239505,239507,239509,2,4,0
68445,5,2,239510,239510,239512,0,2,1
68446,6,1,239516,239516,239517,0,1,4
68447,2,3,239518,239518,239521,0,3,1
68448,5,1,239523,239523,239524,0,1,2
68449,1,3,239524,239524,239527,0,3,0
68450,1,1,239525,239527,239528,2,3,0
68451,4,1,239529,239529,239530,0,1,1
68452,5,2,239534,239534,239536,0,2,4
68453,5,2,239539,239539,239541,0,2,3
68454,6,3,239545,239545,239548,0,3,4
68455,2,1,239547,239548,239549,1,2,0
68456,6,1,239553,239553,239554,0,1,4
68457,1,3,239554,239554,239557,0,3,0
68458,2,3,239556,239557,239560,1,4,0
68459,1,2,239557,239560,239562,3,5,0
68460,5,2,239562,239562,239564,0,2,0
68461,4,2,239566,239566,239568,0,2,2
68462,6,2,239572,239572,239574,0,2,4
68463,3,1,239575,239575,239576,0,1,1
68464,3,2,239578,239578,239580,0,2,2
68465,5,3,239583,239583,239586,0,3,3
68466,3,2,239586,239586,239588,0,2,0
68467,4,2,239590,239590,239592,0,2,2
68468,4,3,239594,239594,239597,0,3,2
68469,2,3,239596,239597,239600,1,4,0
68470,6,3,239602,239602,239605,0,3,2
68471,6,1,239608,239608,239609,0,1,3
68472,5,1,239613,239613,239614,0,1,4
68473,6,2,239619,239619,239621,0,2,5
68474,6,3,239625,239625,239628,0,3,4
68475,5,3,239630,239630,239633,0,3,2
68476,2,3,239632,239633,239636,1,4,0
68477,4,1,239636,239636,239637,0,1,0
68478,1,3,239637,239637,239640,0,3,0
68479,4,1,239641,239641,239642,0,1,1
68480,5,1,239646,239646,239647,0,1,4
68481,2,3,239648,239648,239651,0,3,1
68482,5,2,239653,239653,239655,0,2,2
68483,5,3,239658,239658,239661,0,3,3
68484,5,3,239663,239663,239666,0,3,2
68485,3,1,239666,239666,239667,0,1,0
68486,6,3,239672,239672,239675,0,3,5
68487,4,1,239676,239676,239677,0,1,1
68488,2,2,239678,239678,239680,0,2,1
68489,6,1,239684,239684,239685,0,1,4
68490,4,2,239688,239688,239690,0,2,3
68491,6,1,239694,239694,239695,0,1,4
68492,1,1,239695,239695,239696,0,1,0
68493,1,1,239696,239696,239697,0,1,0
68494,5,2,239701,239701,239703,0,2,4
68495,6,2,239707,239707,239709,0,2,4
68496,2,3,239709,239709,239712,0,3,0
68497,2,3,239711,239712,239715,1,4,0
68498,5,2,239716,239716,239718,0,2,1
68499,4,1,239720,239720,239721,0,1,2
68500,2,1,239722,239722,239723,0,1,1
68501,5,3,239727,239727,239730,0,3,4
68502,2,3,239729,239730,239733,1,4,0
68503,4,1,239733,239733,239734,0,1,0
68504,6,2,239739,239739,239741,0,2,5
68505,5,3,239744,239744,239747,0,3,3
68506,6,3,239750,239750,239753,0,3,3
68507,5,1,239755,239755,239756,0,1,2
68508,6,1,239761,239761,239762,0,1,5
68509,2,2,239763,239763,239765,0,2,1
68510,5,3,239768,239768,239771,0,3,3
68511,3,1,239771,239771,239772,0,1,0
68512,6,3,239777,239777,239780,0,3,5
68513,3,2,239780,239780,239782,0,2,0
68514,5,3,239785,239785,239788,0,3,3
68515,2,2,239787,239788,239790,1,3,0
68516,1,1,239788,239790,239791,2,3,0
68517,2,3,239790,239791,239794,1,4,0
68518,3,1,239793,239794,239795,1,2,0
68519,4,3,239797,239797,239800,0,3,2
68520,1,3,239798,239800,239803,2,5,0
68521,5,2,239803,239803,239805,0,2,0
68522,4,3,239807,239807,239810,0,3,2
68523,1,3,239808,239810,239813,2,5,0
68524,3,1,239811,239813,239814,2,3,0
68525,3,3,239814,239814,239817,0,3,0
68526,3,2,239817,239817,239819,0,2,0
68527,5,2,239822,239822,239824,0,2,3
68528,2,1,239824,239824,239825,0,1,0
68529,4,3,239828,239828,239831,0,3,3
68530,4,2,239832,239832,239834,0,2,1
68531,6,1,239838,239838,239839,0,1,4
68532,1,3,239839,239839,239842,0,3,0
68533,3,1,239842,239842,239843,0,1,0
68534,2,1,239844,239844,239845,0,1,1
68535,5,3,239849,239849,239852,0,3,4
68536,5,2,239854,239854,239856,0,2,2
68537,6,1,239860,239860,239861,0,1,4
68538,6,1,239866,239866,239867,0,1,5
68539,6,1,239872,239872,239873,0,1,5
68540,6,1,239878,239878,239879,0,1,5
68541,1,1,239879,239879,239880,0,1,0
68542,5,1,239884,239884,239885,0,1,4
68543,4,3,239888,239888,239891,0,3,3
68544,2,1,239890,239891,239892,1,2,0
68545,4,2,239894,239894,239896,0,2,2
68546,1,3,239895,239896,239899,1,4,0
68547,1,2,239896,239899,239901,3,5,0
68548,2,2,239898,239901,239903,3,5,0
68549,6,3,239904,239904,239907,0,3,1
68550,5,2,239909,239909,239911,0,2,2
68551,3,3,239912,239912,239915,0,3,1
68552,1,3,239913,239915,239918,2,5,0
68553,1,1,239914,239918,239919,4,5,0
68554,2,2,239916,239919,239921,3,5,0
68555,5,1,239921,239921,239922,0,1,0
68556,4,2,239925,239925,239927,0,2,3
68557,6,3,239931,239931,239934,0,3,4
68558,3,1,239934,239934,239935,0,1,0
68559,2,3,239936,239936,239939,0,3,1
68560,6,3,239942,239942,239945,0,3,3
68561,3,3,239945,239945,239948,0,3,0
68562,2,1,239947,239948,239949,1,2,0
68563,1,1,239948,239949,239950,1,2,0
68564,3,1,239951,239951,239952,0,1,1
68565,2,3,239953,239953,239956,0,3,1
68566,3,3,239956,239956,239959,0,3,0
68567,5,2,239961,239961,239963,0,2,2
68568,3,1,239964,239964,239965,0,1,1
68569,5,3,239969,239969,239972,0,3,4
68570,2,3,239971,239972,239975,1,4,0
68571,3,1,239974,239975,239976,1,2,0
68572,2,2,239976,239976,239978,0,2,0
68573,1,2,239977,239978,239980,1,3,0
68574,4,1,239981,239981,239982,0,1,1
68575,4,2,239985,239985,239987,0,2,3
68576,3,1,239988,239988,239989,0,1,1
68577,3,1,239991,239991,239992,0,1,2
68578,4,3,239995,239995,239998,0,3,3
68579,4,2,239999,239999,240001,0,2,1
68580,2,3,240001,240001,240004,0,3,0
68581,2,3,240003,240004,240007,1,4,0
68582,2,3,240005,240007,240010,2,5,0
68583,3,3,240008,240010,240013,2,5,0
68584,5,3,240013,240013,240016,0,3,0
68585,4,2,240017,240017,240019,0,2,1
68586,4,2,240021,240021,240023,0,2,2
68587,4,1,240025,240025,240026,0,1,2
68588,6,3,240031,240031,240034,0,3,5
68589,5,2,240036,240036,240038,0,2,2
68590,6,1,240042,240042,240043,0,1,4
68591,2,3,240044,240044,240047,0,3,1
68592,6,3,240050,240050,240053,0,3,3
68593,1,1,240051,240053,240054,2,3,0
68594,2,1,240053,240054,240055,1,2,0
68595,2,1,240055,240055,240056,0,1,0
68596,5,3,240060,240060,240063,0,3,4
68597,4,2,240064,240064,240066,0,2,1
68598,1,1,240065,240066,240067,1,2,0
68599,4,2,240069,240069,240071,0,2,2
68600,6,2,240075,240075,240077,0,2,4
68601,2,1,240077,240077,240078,0,1,0
68602,1,1,240078,240078,240079,0,1,0
68603,3,2,240081,240081,240083,0,2,2
68604,5,1,240086,240086,240087,0,1,3
68605,2,1,240088,240088,240089,0,1,1
68606,4,1,240092,240092,240093,0,1,3
68607,4,2,240096,240096,240098,0,2,3
68608,5,1,240101,240101,240102,0,1,3
68609,1,1,240102,240102,240103,0,1,0
68610,4,3,240106,240106,240109,0,3,3
68611,5,1,240111,240111,240112,0,1,2
68612,3,1,240114,240114,240115,0,1,2
68613,5,3,240119,240119,240122,0,3,4
68614,5,2,240124,240124,240126,0,2,2
68615,4,1,240128,240128,240129,0,1,2
68616,5,3,240133,240133,240136,0,3,4
68617,1,2,240134,240136,240138,2,4,0
68618,5,3,240139,240139,240142,0,3,1
68619,2,2,240141,240142,240144,1,3,0
68620,4,3,240145,240145,240148,0,3,1
68621,4,3,240149,240149,240152,0,3,1
68622,5,1,240154,240154,240155,0,1,2
68623,3,3,240157,240157,240160,0,3,2
68624,1,3,240158,240160,240163,2,5,0
68625,6,1,240164,240164,240165,0,1,1
68626,2,3,240166,240166,240169,0,3,1
68627,1,3,240167,240169,240172,2,5,0
68628,3,2,240170,240172,240174,2,4,0
68629,6,1,240176,240176,240177,0,1,2
68630,2,3,240178,240178,240181,0,3,1
68631,2,1,240180,240181,240182,1,2,0
68632,5,2,240185,240185,240187,0,2,3
68633,2,3,240187,240187,240190,0,3,0
68634,1,2,240188,240190,240192,2,4,0
68635,4,1,240192,240192,240193,0,1,0
68636,5,3,240197,240197,240200,0,3,4
68637,1,1,240198,240200,240201,2,3,0
68638,2,3,240200,240201,240204,1,4,0
68639,1,1,240201,240204,240205,3,4,0
68640,2,2,240203,240205,240207,2,4,0
68641,1,1,240204,240207,240208,3,4,0
68642,4,2,240208,240208,240210,0,2,0
68643,1,3,240209,240210,240213,1,4,0
68644,4,3,240213,240213,240216,0,3,0
68645,5,3,240218,240218,240221,0,3,2
68646,2,1,240220,240221,240222,1,2,0
68647,2,1,240222,240222,240223,0,1,0
68648,6,1,240228,240228,240229,0,1,5
68649,6,3,240234,240234,240237,0,3,5
68650,6,3,240240,240240,240243,0,3,3
68651,2,3,240242,240243,240246,1,4,0
68652,1,2,240243,240246,240248,3,5,0
68653,6,1,240249,240249,240250,0,1,1
68654,6,2,240255,240255,240257,0,2,5
68655,6,1,240261,240261,240262,0,1,4
68656,3,2,240264,240264,240266,0,2,2
68657,5,3,240269,240269,240272,0,3,3
68658,4,3,240273,240273,240276,0,3,1
68659,4,3,240277,240277,240280,0,3,1
68660,2,1,240279,240280,240281,1,2,0
68661,5,3,240284,240284,240287,0,3,3
68662,6,1,240290,240290,240291,0,1,3
68663,4,1,240294,240294,240295,0,1,3
68664,1,3,240295,240295,240298,0,3,0
68665,6,1,240301,240301,240302,0,1,3
68666,4,3,240305,240305,240308,0,3,3
68667,1,2,240306,240308,240310,2,4,0
68668,6,1,240312,240312,240313,0,1,2
68669,4,2,240316,240316,240318,0,2,3
68670,4,1,240320,240320,240321,0,1,2
68671,3,2,240323,240323,240325,0,2,2
68672,4,3,240327,240327,240330,0,3,2
68673,5,1,240332,240332,240333,0,1,2
68674,3,2,240335,240335,240337,0,2,2
68675,2,3,240337,240337,240340,0,3,0
68676,6,2,240343,240343,240345,0,2,3
68677,5,3,240348,240348,240351,0,3,3
68678,3,1,240351,240351,240352,0,1,0
68679,4,2,240355,240355,240357,0,2,3
68680,3,2,240358,240358,240360,0,2,1
68681,6,3,240364,240364,240367,0,3,4
68682,6,2,240370,240370,240372,0,2,3
68683,5,1,240375,240375,240376,0,1,3
68684,3,3,240378,240378,240381,0,3,2
68685,6,1,240384,240384,240385,0,1,3
68686,2,3,240386,240386,240389,0,3,1
68687,3,1,240389,240389,240390,0,1,0
68688,1,2,240390,240390,240392,0,2,0
68689,6,3,240396,240396,240399,0,3,4
68690,6,1,240402,240402,240403,0,1,3
68691,4,3,240406,240406,240409,0,3,3
68692,2,2,240408,240409,240411,1,3,0
68693,5,2,240413,240413,240415,0,2,2
68694,6,1,240419,240419,240420,0,1,4
68695,1,2,240420,240420,240422,0,2,0
68696,3,2,240423,240423,240425,0,2,1
68697,3,1,240426,240426,240427,0,1,1
68698,5,1,240431,240431,240432,0,1,4
68699,6,1,240437,240437,240438,0,1,5
68700,3,3,240440,240440,240443,0,3,2
68701,1,3,240441,240443,240446,2,5,0
68702,3,2,240444,240446,240448,2,4,0
68703,4,2,240448,240448,240450,0,2,0
68704,2,2,240450,240450,240452,0,2,0
68705,6,3,240456,240456,240459,0,3,4
68706,3,3,240459,240459,240462,0,3,0
68707,2,1,240461,240462,240463,1,2,0
68708,5,3,240466,240466,240469,0,3,3
68709,3,3,240469,240469,240472,0,3,0
68710,4,1,240473,240473,240474,0,1,1
68711,2,3,240475,240475,240478,0,3,1
68712,1,2,240476,240478,240480,2,4,0
68713,4,3,240480,240480,240483,0,3,0
68714,3,1,240483,240483,240484,0,1,0
68715,1,3,240484,240484,240487,0,3,0
68716,1,2,240485,240487,240489,2,4,0
68717,6,1,240491,240491,240492,0,1,2
68718,2,2,240493,240493,240495,0,2,1
68719,4,3,240497,240497,240500,0,3,2
68720,5,1,240502,240502,240503,0,1,2
68721,2,2,240504,240504,240506,0,2,1
68722,4,3,240508,240508,240511,0,3,2
68723,3,1,240511,240511,240512,0,1,0
68724,6,3,240517,240517,240520,0,3,5
68725,4,3,240521,240521,240524,0,3,1
68726,4,2,240525,240525,240527,0,2,1
68727,4,3,240529,240529,240532,0,3,2
68728,3,2,240532,240532,240534,0,2,0
68729,1,3,240533,240534,240537,1,4,0
68730,4,3,240537,240537,240540,0,3,0
68731,6,1,240543,240543,240544,0,1,3
68732,3,3,240546,240546,240549,0,3,2
68733,3,1,240549,240549,240550,0,1,0
68734,5,3,240554,240554,240557,0,3,4
68735,3,1,240557,240557,240558,0,1,0
68736,6,2,240563,240563,240565,0,2,5
68737,6,2,240569,240569,240571,0,2,4
68738,1,2,240570,240571,240573,1,3,0
68739,2,2,240572,240573,240575,1,3,0
68740,5,2,240577,240577,240579,0,2,2
68741,5,3,240582,240582,240585,0,3,3
68742,1,3,240583,240585,240588,2,5,0
68743,3,1,240586,240588,240589,2,3,0
68744,1,3,240587,240589,240592,2,5,0
68745,6,2,240593,240593,240595,0,2,1
68746,6,2,240599,240599,240601,0,2,4
68747,4,2,240603,240603,240605,0,2,2
68748,4,3,240607,240607,240610,0,3,2
68749,2,3,240609,240610,240613,1,4,0
68750,2,2,240611,240613,240615,2,4,0
68751,3,1,240614,240615,240616,1,2,0
68752,4,3,240618,240618,240621,0,3,2
68753,2,2,240620,240621,240623,1,3,0
68754,3,2,240623,240623,240625,0,2,0
68755,2,1,240625,240625,240626,0,1,0
68756,6,1,240631,240631,240632,0,1,5
68757,1,3,240632,240632,240635,0,3,0
68758,5,2,240637,240637,240639,0,2,2
68759,4,3,240641,240641,240644,0,3,2
68760,6,3,240647,240647,240650,0,3,3
68761,2,3,240649,240650,240653,1,4,0
68762,4,2,240653,240653,240655,0,2,0
68763,5,1,240658,240658,240659,0,1,3
68764,5,2,240663,240663,240665,0,2,4
68765,6,1,240669,240669,240670,0,1,4
68766,3,1,240672,240672,240673,0,1,2
68767,3,1,240675,240675,240676,0,1,2
68768,2,2,240677,240677,240679,0,2,1
68769,1,3,240678,240679,240682,1,4,0
68770,4,3,240682,240682,240685,0,3,0
68771,4,1,240686,240686,240687,0,1,1
68772,5,2,240691,240691,240693,0,2,4
68773,6,2,240697,240697,240699,0,2,4
68774,2,3,240699,240699,240702,0,3,0
68775,5,2,240704,240704,240706,0,2,2
68776,5,3,240709,240709,240712,0,3,3
68777,6,3,240715,240715,240718,0,3,3
68778,6,2,240721,240721,240723,0,2,3
68779,3,3,240724,240724,240727,0,3,1
68780,4,3,240728,240728,240731,0,3,1
68781,2,3,240730,240731,240734,1,4,0
68782,1,2,240731,240734,240736,3,5,0
68783,5,1,240736,240736,240737,0,1,0
68784,4,3,240740,240740,240743,0,3,3
68785,5,1,240745,240745,240746,0,1,2
68786,2,1,240747,240747,240748,0,1,1
68787,5,3,240752,240752,240755,0,3,4
68788,5,1,240757,240757,240758,0,1,2
68789,1,3,240758,240758,240761,0,3,0
68790,4,2,240762,240762,240764,0,2,1
68791,2,3,240764,240764,240767,0,3,0
68792,1,3,240765,240767,240770,2,5,0
68793,4,3,240769,240770,240773,1,4,0
68794,2,2,240771,240773,240775,2,4,0
68795,6,3,240777,240777,240780,0,3,2
68796,5,2,240782,240782,240784,0,2,2
68797,1,1,240783,240784,240785,1,2,0
68798,5,3,240788,240788,240791,0,3,3
68799,6,1,240794,240794,240795,0,1,3
68800,1,3,240795,240795,240798,0,3,0
68801,3,2,240798,240798,240800,0,2,0
68802,5,2,240803,240803,240805,0,2,3
68803,2,2,240805,240805,240807,0,2,0
68804,5,3,240810,240810,240813,0,3,3
68805,3,2,240813,240813,240815,0,2,0
68806,6,2,240819,240819,240821,0,2,4
68807,1,3,240820,240821,240824,1,4,0
68808,2,3,240822,240824,240827,2,5,0
68809,2,3,240824,240827,240830,3,6,0
68810,1,1,240825,240830,240831,5,6,0
68811,1,2,240826,240831,240833,5,7,0
68812,6,1,240832,240833,240834,1,2,0
68813,5,3,240837,240837,240840,0,3,3
68814,6,3,240843,240843,240846,0,3,3
68815,4,3,240847,240847,240850,0,3,1
68816,5,1,240852,240852,240853,0,1,2
68817,4,3,240856,240856,240859,0,3,3
68818,5,1,240861,240861,240862,0,1,2
68819,2,2,240863,240863,240865,0,2,1
68820,1,2,240864,240865,240867,1,3,0
68821,2,1,240866,240867,240868,1,2,0
68822,2,2,240868,240868,240870,0,2,0
68823,1,3,240869,240870,240873,1,4,0
68824,3,3,240872,240873,240876,1,4,0
68825,2,3,240874,240876,240879,2,5,0
68826,6,3,240880,240880,240883,0,3,1
68827,3,3,240883,240883,240886,0,3,0
68828,1,3,240884,240886,240889,2,5,0
68829,1,3,240885,240889,240892,4,7,0
68830,3,2,240888,240892,240894,4,6,0
68831,5,1,240893,240894,240895,1,2,0
68832,2,3,240895,240895,240898,0,3,0
68833,1,2,240896,240898,240900,2,4,0
68834,5,3,240901,240901,240904,0,3,1
68835,2,3,240903,240904,240907,1,4,0
68836,3,1,240906,240907,240908,1,2,0
68837,2,2,240908,240908,240910,0,2,0
68838,2,2,240910,240910,240912,0,2,0
68839,6,3,240916,240916,240919,0,3,4
68840,2,3,240918,240919,240922,1,4,0
68841,2,2,240920,240922,240924,2,4,0
68842,6,1,240926,240926,240927,0,1,2
68843,1,3,240927,240927,240930,0,3,0
68844,5,1,240932,240932,240933,0,1,2
68845,4,3,240936,240936,240939,0,3,3
68846,3,2,240939,240939,240941,0,2,0
68847,1,1,240940,240941,240942,1,2,0
68848,4,1,240944,240944,240945,0,1,2
68849,4,2,240948,240948,240950,0,2,3
68850,2,3,240950,240950,240953,0,3,0
68851,6,1,240956,240956,240957,0,1,3
68852,5,3,240961,240961,240964,0,3,4
68853,4,3,240965,240965,240968,0,3,1
68854,1,2,240966,240968,240970,2,4,0
68855,2,3,240968,240970,240973,2,5,0
68856,6,3,240974,240974,240977,0,3,1
68857,6,1,240980,240980,240981,0,1,3
68858,4,3,240984,240984,240987,0,3,3
68859,1,1,240985,240987,240988,2,3,0
68860,1,3,240986,240988,240991,2,5,0
68861,1,3,240987,240991,240994,4,7,0
68862,1,1,240988,240994,240995,6,7,0
68863,1,1,240989,240995,240996,6,7,0
68864,3,3,240992,240996,240999,4,7,0
68865,3,3,240995,240999,241002,4,7,0
68866,5,2,241000,241002,241004,2,4,0
68867,3,1,241003,241004,241005,1,2,0
68868,2,1,241005,241005,241006,0,1,0
68869,6,3,241011,241011,241014,0,3,5
68870,6,2,241017,241017,241019,0,2,3
68871,6,2,241023,241023,241025,0,2,4
68872,5,3,241028,241028,241031,0,3,3
68873,2,3,241030,241031,241034,1,4,0
68874,2,3,241032,241034,241037,2,5,0
68875,5,1,241037,241037,241038,0,1,0
68876,2,1,241039,241039,241040,0,1,1
68877,4,1,241043,241043,241044,0,1,3
68878,2,2,241045,241045,241047,0,2,1
68879,1,1,241046,241047,241048,1,2,0
68880,5,2,241051,241051,241053,0,2,3
68881,3,1,241054,241054,241055,0,1,1
68882,1,2,241055,241055,241057,0,2,0
68883,6,2,241061,241061,241063,0,2,4
68884,3,3,241064,241064,241067,0,3,1
68885,4,2,241068,241068,241070,0,2,1
68886,3,2,241071,241071,241073,0,2,1
68887,4,1,241075,241075,241076,0,1,2
68888,1,2,241076,241076,241078,0,2,0
68889,6,1,241082,241082,241083,0,1,4
68890,3,2,241085,241085,241087,0,2,2
68891,5,1,241090,241090,241091,0,1,3
68892,4,2,241094,241094,241096,0,2,3
68893,1,3,241095,241096,241099,1,4,0
68894,4,3,241099,241099,241102,0,3,0
68895,5,2,241104,241104,241106,0,2,2
68896,6,3,241110,241110,241113,0,3,4
68897,4,2,241114,241114,241116,0,2,1
68898,1,2,241115,241116,241118,1,3,0
68899,6,3,241121,241121,241124,0,3,3
68900,5,1,241126,241126,241127,0,1,2
68901,4,2,241130,241130,241132,0,2,3
68902,3,3,241133,241133,241136,0,3,1
68903,5,3,241138,241138,241141,0,3,2
68904,2,2,241140,241141,241143,1,3,0
68905,2,3,241142,241143,241146,1,4,0
68906,2,2,241144,241146,241148,2,4,0
68907,6,1,241150,241150,241151,0,1,2
68908,1,1,241151,241151,241152,0,1,0
68909,1,2,241152,241152,241154,0,2,0
68910,5,3,241157,241157,241160,0,3,3
68911,6,2,241163,241163,241165,0,2,3
68912,2,1,241165,241165,241166,0,1,0
68913,1,1,241166,241166,241167,0,1,0
68914,4,1,241170,241170,241171,0,1,3
68915,1,1,241171,241171,241172,0,1,0
68916,3,1,241174,241174,241175,0,1,2
68917,1,2,241175,241175,241177,0,2,0
68918,2,3,241177,241177,241180,0,3,0
68919,2,2,241179,241180,241182,1,3,0
68920,6,3,241185,241185,241188,0,3,3
68921,1,2,241186,241188,241190,2,4,0
68922,3,3,241189,241190,241193,1,4,0
68923,4,2,241193,241193,241195,0,2,0
68924,4,1,241197,241197,241198,0,1,2
68925,2,2,241199,241199,241201,0,2,1
68926,1,2,241200,241201,241203,1,3,0
68927,4,3,241204,241204,241207,0,3,1
68928,2,2,241206,241207,241209,1,3,0
68929,4,1,241210,241210,241211,0,1,1
68930,1,2,241211,241211,241213,0,2,0
68931,2,1,241213,241213,241214,0,1,0
68932,6,2,241219,241219,241221,0,2,5
68933,2,1,241221,241221,241222,0,1,0
68934,4,1,241225,241225,241226,0,1,3
68935,1,1,241226,241226,241227,0,1,0
68936,1,1,241227,241227,241228,0,1,0
68937,4,2,241231,241231,241233,0,2,3
68938,3,3,241234,241234,241237,0,3,1
68939,1,3,241235,241237,241240,2,5,0
68940,3,1,241238,241240,241241,2,3,0
68941,4,1,241242,241242,241243,0,1,1
68942,2,2,241244,241244,241246,0,2,1
68943,1,3,241245,241246,241249,1,4,0
68944,5,3,241250,241250,241253,0,3,1
68945,3,1,241253,241253,241254,0,1,0
68946,6,1,241259,241259,241260,0,1,5
68947,3,3,241262,241262,241265,0,3,2
68948,4,3,241266,241266,241269,0,3,1
68949,5,1,241271,241271,241272,0,1,2
68950,4,1,241275,241275,241276,0,1,3
68951,6,3,241281,241281,241284,0,3,5
68952,4,1,241285,241285,241286,0,1,1
68953,2,1,241287,241287,241288,0,1,1
68954,3,2,241290,241290,241292,0,2,2
68955,6,1,241296,241296,241297,0,1,4
68956,6,3,241302,241302,241305,0,3,5
68957,1,3,241303,241305,241308,2,5,0
68958,1,1,241304,241308,241309,4,5,0
68959,1,1,241305,241309,241310,4,5,0
68960,6,2,241311,241311,241313,0,2,1
68961,4,3,241315,241315,241318,0,3,2
68962,2,3,241317,241318,241321,1,4,0
68963,4,1,241321,241321,241322,0,1,0
68964,2,3,241323,241323,241326,0,3,1
68965,1,3,241324,241326,241329,2,5,0
68966,4,2,241328,241329,241331,1,3,0
68967,4,3,241332,241332,241335,0,3,1
68968,5,1,241337,241337,241338,0,1,2
68969,2,3,241339,241339,241342,0,3,1
68970,2,3,241341,241342,241345,1,4,0
68971,2,1,241343,241345,241346,2,3,0
68972,6,2,241349,241349,241351,0,2,3
68973,4,3,241353,241353,241356,0,3,2
68974,3,2,241356,241356,241358,0,2,0
68975,5,1,241361,241361,241362,0,1,3
68976,3,3,241364,241364,241367,0,3,2
68977,3,1,241367,241367,241368,0,1,0
68978,4,1,241371,241371,241372,0,1,3
68979,2,2,241373,241373,241375,0,2,1
68980,5,2,241378,241378,241380,0,2,3
68981,5,1,241383,241383,241384,0,1,3
68982,3,3,241386,241386,241389,0,3,2
68983,3,1,241389,241389,241390,0,1,0
68984,4,2,241393,241393,241395,0,2,3
68985,4,1,241397,241397,241398,0,1,2
68986,6,2,241403,241403,241405,0,2,5
68987,6,3,241409,241409,241412,0,3,4
68988,1,2,241410,241412,241414,2,4,0
68989,1,2,241411,241414,241416,3,5,0
68990,6,2,241417,241417,241419,0,2,1
68991,6,1,241423,241423,241424,0,1,4
68992,2,1,241425,241425,241426,0,1,1
68993,3,2,241428,241428,241430,0,2,2
68994,1,1,241429,241430,241431,1,2,0
68995,5,2,241434,241434,241436,0,2,3
68996,4,2,241438,241438,241440,0,2,2
68997,3,1,241441,241441,241442,0,1,1
68998,5,3,241446,241446,241449,0,3,4
68999,3,1,241449,241449,241450,0,1,0
69000,4,2,241453,241453,241455,0,2,3
69001,6,3,241459,241459,241462,0,3,4
69002,6,3,241465,241465,241468,0,3,3
69003,5,2,241470,241470,241472,0,2,2
69004,4,3,241474,241474,241477,0,3,2
69005,5,2,241479,241479,241481,0,2,2
69006,5,2,241484,241484,241486,0,2,3
69007,2,2,241486,241486,241488,0,2,0
69008,5,3,241491,241491,241494,0,3,3
69009,3,1,241494,241494,241495,0,1,0
69010,2,1,241496,241496,241497,0,1,1
69011,4,1,241500,241500,241501,0,1,3
69012,6,3,241506,241506,241509,0,3,5
69013,4,1,241510,241510,241511,0,1,1
69014,6,1,241516,241516,241517,0,1,5
69015,1,2,241517,241517,241519,0,2,0
69016,3,2,241520,241520,241522,0,2,1
69017,2,3,241522,241522,241525,0,3,0
69018,4,2,241526,241526,241528,0,2,1
69019,4,2,241530,241530,241532,0,2,2
69020,1,2,241531,241532,241534,1,3,0
69021,2,2,241533,241534,241536,1,3,0
69022,5,2,241538,241538,241540,0,2,2
69023,3,3,241541,241541,241544,0,3,1
69024,5,2,241546,241546,241548,0,2,2
69025,2,2,241548,241548,241550,0,2,0
69026,2,1,241550,241550,241551,0,1,0
69027,2,3,241552,241552,241555,0,3,1
69028,1,1,241553,241555,241556,2,3,0
69029,1,2,241554,241556,241558,2,4,0
69030,1,2,241555,241558,241560,3,5,0
69031,5,2,241560,241560,241562,0,2,0
69032,2,1,241562,241562,241563,0,1,0
69033,1,1,241563,241563,241564,0,1,0
69034,3,2,241566,241566,241568,0,2,2
69035,2,3,241568,241568,241571,0,3,0
69036,2,2,241570,241571,241573,1,3,0
69037,3,2,241573,241573,241575,0,2,0
69038,2,2,241575,241575,241577,0,2,0
69039,2,1,241577,241577,241578,0,1,0
69040,6,2,241583,241583,241585,0,2,5
69041,6,3,241589,241589,241592,0,3,4
69042,2,3,241591,241592,241595,1,4,0
69043,4,2,241595,241595,241597,0,2,0
69044,3,1,241598,241598,241599,0,1,1
69045,3,2,241601,241601,241603,0,2,2
69046,6,1,241607,241607,241608,0,1,4
69047,3,1,241610,241610,241611,0,1,2
69048,1,3,241611,241611,241614,0,3,0
69049,4,2,241615,241615,241617,0,2,1
69050,4,2,241619,241619,241621,0,2,2
69051,6,3,241625,241625,241628,0,3,4
69052,1,3,241626,241628,241631,2,5,0
69053,4,1,241630,241631,241632,1,2,0
69054,3,1,241633,241633,241634,0,1,1
69055,5,2,241638,241638,241640,0,2,4
69056,6,2,241644,241644,241646,0,2,4
69057,1,1,241645,241646,241647,1,2,0
69058,5,3,241650,241650,241653,0,3,3
69059,6,3,241656,241656,241659,0,3,3
69060,3,2,241659,241659,241661,0,2,0
69061,3,2,241662,241662,241664,0,2,1
69062,3,2,241665,241665,241667,0,2,1
69063,5,1,241670,241670,241671,0,1,3
69064,2,1,241672,241672,241673,0,1,1
69065,1,3,241673,241673,241676,0,3,0
69066,2,1,241675,241676,241677,1,2,0
69067,4,2,241679,241679,241681,0,2,2
69068,3,2,241682,241682,241684,0,2,1
69069,5,2,241687,241687,241689,0,2,3
69070,4,3,241691,241691,241694,0,3,2
69071,6,2,241697,241697,241699,0,2,3
69072,5,3,241702,241702,241705,0,3,3
69073,6,1,241708,241708,241709,0,1,3
69074,5,1,241713,241713,241714,0,1,4
69075,1,1,241714,241714,241715,0,1,0
69076,5,1,241719,241719,241720,0,1,4
69077,2,2,241721,241721,241723,0,2,1
69078,6,1,241727,241727,241728,0,1,4
69079,6,3,241733,241733,241736,0,3,5
69080,4,1,241737,241737,241738,0,1,1
69081,4,2,241741,241741,241743,0,2,3
69082,5,1,241746,241746,241747,0,1,3
69083,6,1,241752,241752,241753,0,1,5
69084,5,3,241757,241757,241760,0,3,4
69085,4,1,241761,241761,241762,0,1,1
69086,2,1,241763,241763,241764,0,1,1
69087,1,3,241764,241764,241767,0,3,0
69088,3,2,241767,241767,241769,0,2,0
69089,3,2,241770,241770,241772,0,2,1
69090,6,2,241776,241776,241778,0,2,4
69091,1,1,241777,241778,241779,1,2,0
69092,5,1,241782,241782,241783,0,1,3
69093,2,2,241784,241784,241786,0,2,1
69094,5,1,241789,241789,241790,0,1,3
69095,6,1,241795,241795,241796,0,1,5
69096,4,1,241799,241799,241800,0,1,3
69097,4,2,241803,241803,241805,0,2,3
69098,2,2,241805,241805,241807,0,2,0
69099,3,1,241808,241808,241809,0,1,1
69100,3,3,241811,241811,241814,0,3,2
69101,2,3,241813,241814,241817,1,4,0
69102,6,2,241819,241819,241821,0,2,2
69103,5,3,241824,241824,241827,0,3,3
69104,1,1,241825,241827,241828,2,3,0
69105,6,2,241831,241831,241833,0,2,3
69106,2,3,241833,241833,241836,0,3,0
69107,2,3,241835,241836,241839,1,4,0
69108,5,3,241840,241840,241843,0,3,1
69109,4,2,241844,241844,241846,0,2,1
69110,4,1,241848,241848,241849,0,1,2
69111,5,1,241853,241853,241854,0,1,4
69112,4,1,241857,241857,241858,0,1,3
69113,4,3,241861,241861,241864,0,3,3
69114,6,1,241867,241867,241868,0,1,3
69115,4,2,241871,241871,241873,0,2,3
69116,6,3,241877,241877,241880,0,3,4
69117,6,2,241883,241883,241885,0,2,3
69118,5,3,241888,241888,241891,0,3,3
69119,6,2,241894,241894,241896,0,2,3
69120,1,1,241895,241896,241897,1,2,0
69121,6,1,241901,241901,241902,0,1,4
69122,6,2,241907,241907,241909,0,2,5
69123,4,3,241911,241911,241914,0,3,2
69124,6,2,241917,241917,241919,0,2,3
69125,1,1,241918,241919,241920,1,2,0
69126,6,1,241924,241924,241925,0,1,4
69127,1,1,241925,241925,241926,0,1,0
69128,1,2,241926,241926,241928,0,2,0
69129,1,3,241927,241928,241931,1,4,0
69130,3,3,241930,241931,241934,1,4,0
69131,5,1,241935,241935,241936,0,1,1
69132,1,2,241936,241936,241938,0,2,0
69133,2,1,241938,241938,241939,0,1,0
69134,1,2,241939,241939,241941,0,2,0
69135,2,3,241941,241941,241944,0,3,0
69136,3,2,241944,241944,241946,0,2,0
69137,2,1,241946,241946,241947,0,1,0
69138,3,1,241949,241949,241950,0,1,2
69139,4,1,241953,241953,241954,0,1,3
69140,6,3,241959,241959,241962,0,3,5
69141,5,2,241964,241964,241966,0,2,2
69142,3,2,241967,241967,241969,0,2,1
69143,6,2,241973,241973,241975,0,2,4
69144,6,2,241979,241979,241981,0,2,4
69145,4,3,241983,241983,241986,0,3,2
69146,1,2,241984,241986,241988,2,4,0
69147,2,2,241986,241988,241990,2,4,0
69148,2,2,241988,241990,241992,2,4,0
69149,4,1,241992,241992,241993,0,1,0
69150,6,2,241998,241998,242000,0,2,5
69151,5,3,242003,242003,242006,0,3,3
69152,4,2,242007,242007,242009,0,2,1
69153,4,3,242011,242011,242014,0,3,2
69154,4,3,242015,242015,242018,0,3,1
69155,6,3,242021,242021,242024,0,3,3
69156,2,1,242023,242024,242025,1,2,0
69157,6,3,242029,242029,242032,0,3,4
69158,4,1,242033,242033,242034,0,1,1
69159,1,1,242034,242034,242035,0,1,0
69160,3,2,242037,242037,242039,0,2,2
69161,4,1,242041,242041,242042,0,1,2
69162,3,1,242044,242044,242045,0,1,2
69163,3,2,242047,242047,242049,0,2,2
69164,6,3,242053,242053,242056,0,3,4
69165,6,3,242059,242059,242062,0,3,3
69166,3,3,242062,242062,242065,0,3,0
69167,4,3,242066,242066,242069,0,3,1
69168,5,3,242071,242071,242074,0,3,2
69169,1,2,242072,242074,242076,2,4,0
69170,4,2,242076,242076,242078,0,2,0
69171,3,2,242079,242079,242081,0,2,1
69172,2,3,242081,242081,242084,0,3,0
69173,5,2,242086,242086,242088,0,2,2
69174,2,2,242088,242088,242090,0,2,0
69175,4,2,242092,242092,242094,0,2,2
69176,5,1,242097,242097,242098,0,1,3
69177,6,1,242103,242103,242104,0,1,5
69178,4,3,242107,242107,242110,0,3,3
69179,5,2,242112,242112,242114,0,2,2
69180,1,2,242113,242114,242116,1,3,0
69181,5,3,242118,242118,242121,0,3,2
69182,5,3,242123,242123,242126,0,3,2
69183,3,2,242126,242126,242128,0,2,0
69184,6,2,242132,242132,242134,0,2,4
69185,5,1,242137,242137,242138,0,1,3
69186,6,1,242143,242143,242144,0,1,5
69187,1,3,242144,242144,242147,0,3,0
69188,4,2,242148,242148,242150,0,2,1
69189,3,3,242151,242151,242154,0,3,1
69190,4,2,242155,242155,242157,0,2,1
69191,3,3,242158,242158,242161,0,3,1
69192,5,1,242163,242163,242164,0,1,2
69193,1,1,242164,242164,242165,0,1,0
69194,4,3,242168,242168,242171,0,3,3
69195,5,3,242173,242173,242176,0,3,2
69196,3,2,242176,242176,242178,0,2,0
69197,4,1,242180,242180,242181,0,1,2
69198,5,1,242185,242185,242186,0,1,4
69199,2,3,242187,242187,242190,0,3,1
69200,5,2,242192,242192,242194,0,2,2
69201,3,1,242195,242195,242196,0,1,1
69202,4,1,242199,242199,242200,0,1,3
69203,5,2,242204,242204,242206,0,2,4
69204,5,1,242209,242209,242210,0,1,3
69205,4,3,242213,242213,242216,0,3,3
69206,5,3,242218,242218,242221,0,3,2
69207,6,3,242224,242224,242227,0,3,3
69208,3,2,242227,242227,242229,0,2,0
69209,1,2,242228,242229,242231,1,3,0
69210,1,3,242229,242231,242234,2,5,0
69211,6,3,242235,242235,242238,0,3,1
69212,1,1,242236,242238,242239,2,3,0
69213,4,2,242240,242240,242242,0,2,1
69214,4,1,242244,242244,242245,0,1,2
69215,5,3,242249,242249,242252,0,3,4
69216,1,1,242250,242252,242253,2,3,0
69217,1,2,242251,242253,242255,2,4,0
69218,3,2,242254,242255,242257,1,3,0
69219,3,3,242257,242257,242260,0,3,0
69220,5,1,242262,242262,242263,0,1,2
69221,6,1,242268,242268,242269,0,1,5
69222,2,1,242270,242270,242271,0,1,1
69223,6,2,242276,242276,242278,0,2,5
69224,6,1,242282,242282,242283,0,1,4
69225,6,2,242288,242288,242290,0,2,5
69226,4,2,242292,242292,242294,0,2,2
69227,1,2,242293,242294,242296,1,3,0
69228,3,2,242296,242296,242298,0,2,0
69229,3,1,242299,242299,242300,0,1,1
69230,1,2,242300,242300,242302,0,2,0
69231,2,1,242302,242302,242303,0,1,0
69232,6,2,242308,242308,242310,0,2,5
69233,3,1,242311,242311,242312,0,1,1
69234,5,3,242316,242316,242319,0,3,4
69235,2,3,242318,242319,242322,1,4,0
69236,4,3,242322,242322,242325,0,3,0
69237,5,2,242327,242327,242329,0,2,2
69238,6,3,242333,242333,242336,0,3,4
69239,5,3,242338,242338,242341,0,3,2
69240,2,3,242340,242341,242344,1,4,0
69241,5,3,242345,242345,242348,0,3,1
69242,1,1,242346,242348,242349,2,3,0
69243,6,2,242352,242352,242354,0,2,3
69244,6,3,242358,242358,242361,0,3,4
69245,4,2,242362,242362,242364,0,2,1
69246,1,2,242363,242364,242366,1,3,0
69247,6,3,242369,242369,242372,0,3,3
69248,3,1,242372,242372,242373,0,1,0
69249,6,1,242378,242378,242379,0,1,5
69250,2,3,242380,242380,242383,0,3,1
69251,5,3,242385,242385,242388,0,3,2
69252,5,2,242390,242390,242392,0,2,2
69253,3,3,242393,242393,242396,0,3,1
69254,1,1,242394,242396,242397,2,3,0
69255,3,3,242397,242397,242400,0,3,0
69256,6,1,242403,242403,242404,0,1,3
69257,3,3,242406,242406,242409,0,3,2
69258,4,3,242410,242410,242413,0,3,1
69259,1,2,242411,242413,242415,2,4,0
69260,6,2,242417,242417,242419,0,2,2
69261,2,1,242419,242419,242420,0,1,0
69262,6,1,242425,242425,242426,0,1,5
69263,3,2,242428,242428,242430,0,2,2
69264,4,2,242432,242432,242434,0,2,2
69265,5,2,242437,242437,242439,0,2,3
69266,5,2,242442,242442,242444,0,2,3
69267,6,3,242448,242448,242451,0,3,4
69268,1,1,242449,242451,242452,2,3,0
69269,1,3,242450,242452,242455,2,5,0
69270,5,2,242455,242455,242457,0,2,0
69271,6,2,242461,242461,242463,0,2,4
69272,1,1,242462,242463,242464,1,2,0
69273,4,2,242466,242466,242468,0,2,2
69274,6,3,242472,242472,242475,0,3,4
69275,3,2,242475,242475,242477,0,2,0
69276,3,2,242478,242478,242480,0,2,1
69277,1,3,242479,242480,242483,1,4,0
69278,1,1,242480,242483,242484,3,4,0
69279,3,2,242483,242484,242486,1,3,0
69280,4,2,242487,242487,242489,0,2,1
69281,5,1,242492,242492,242493,0,1,3
69282,5,3,242497,242497,242500,0,3,4
69283,5,1,242502,242502,242503,0,1,2
69284,4,3,242506,242506,242509,0,3,3
69285,1,2,242507,242509,242511,2,4,0
69286,1,2,242508,242511,242513,3,5,0
69287,6,1,242514,242514,242515,0,1,1
69288,2,3,242516,242516,242519,0,3,1
69289,3,1,242519,242519,242520,0,1,0
69290,1,1,242520,242520,242521,0,1,0
69291,3,1,242523,242523,242524,0,1,2
69292,1,3,242524,242524,242527,0,3,0
69293,3,2,242527,242527,242529,0,2,0
69294,2,3,242529,242529,242532,0,3,0
69295,1,2,242530,242532,242534,2,4,0
69296,5,2,242535,242535,242537,0,2,1
69297,4,1,242539,242539,242540,0,1,2
69298,5,2,242544,242544,242546,0,2,4
69299,6,1,242550,242550,242551,0,1,4
69300,4,1,242554,242554,242555,0,1,3
69301,1,2,242555,242555,242557,0,2,0
69302,1,2,242556,242557,242559,1,3,0
69303,5,2,242561,242561,242563,0,2,2
69304,5,2,242566,242566,242568,0,2,3
69305,3,1,242569,242569,242570,0,1,1
69306,1,2,242570,242570,242572,0,2,0
69307,3,2,242573,242573,242575,0,2,1
69308,4,3,242577,242577,242580,0,3,2
69309,1,3,242578,242580,242583,2,5,0
69310,2,1,242580,242583,242584,3,4,0
69311,1,3,242581,242584,242587,3,6,0
69312,4,2,242585,242587,242589,2,4,0
69313,2,1,242587,242589,242590,2,3,0
69314,1,2,242588,242590,242592,2,4,0
69315,2,2,242590,242592,242594,2,4,0
69316,6,1,242596,242596,242597,0,1,2
69317,2,3,242598,242598,242601,0,3,1
69318,6,2,242604,242604,242606,0,2,3
69319,5,3,242609,242609,242612,0,3,3
69320,4,1,242613,242613,242614,0,1,1
69321,4,3,242617,242617,242620,0,3,3
69322,6,2,242623,242623,242625,0,2,3
69323,6,3,242629,242629,242632,0,3,4
69324,2,2,242631,242632,242634,1,3,0
69325,4,1,242635,242635,242636,0,1,1
69326,5,1,242640,242640,242641,0,1,4
69327,4,2,242644,242644,242646,0,2,3
69328,3,2,242647,242647,242649,0,2,1
69329,6,1,242653,242653,242654,0,1,4
69330,2,1,242655,242655,242656,0,1,1
69331,4,2,242659,242659,242661,0,2,3
69332,2,1,242661,242661,242662,0,1,0
69333,6,3,242667,242667,242670,0,3,5
69334,2,2,242669,242670,242672,1,3,0
69335,6,3,242675,242675,242678,0,3,3
69336,4,3,242679,242679,242682,0,3,1
69337,5,3,242684,242684,242687,0,3,2
69338,3,3,242687,242687,242690,0,3,0
69339,1,2,242688,242690,242692,2,4,0
69340,2,1,242690,242692,242693,2,3,0
69341,1,2,242691,242693,242695,2,4,0
69342,4,1,242695,242695,242696,0,1,0
69343,3,1,242698,242698,242699,0,1,2
69344,1,1,242699,242699,242700,0,1,0
69345,6,1,242705,242705,242706,0,1,5
69346,4,1,242709,242709,242710,0,1,3
69347,2,3,242711,242711,242714,0,3,1
69348,3,2,242714,242714,242716,0,2,0
69349,2,1,242716,242716,242717,0,1,0
69350,4,1,242720,242720,242721,0,1,3
69351,5,1,242725,242725,242726,0,1,4
69352,1,2,242726,242726,242728,0,2,0
69353,1,1,242727,242728,242729,1,2,0
69354,1,1,242728,242729,242730,1,2,0
69355,3,3,242731,242731,242734,0,3,1
69356,2,3,242733,242734,242737,1,4,0
69357,5,3,242738,242738,242741,0,3,1
69358,1,2,242739,242741,242743,2,4,0
69359,2,3,242741,242743,242746,2,5,0
69360,5,1,242746,242746,242747,0,1,0
69361,3,3,242749,242749,242752,0,3,2
69362,5,1,242754,242754,242755,0,1,2
69363,1,3,242755,242755,242758,0,3,0
69364,4,1,242759,242759,242760,0,1,1
69365,4,3,242763,242763,242766,0,3,3
69366,5,2,242768,242768,242770,0,2,2
69367,6,1,242774,242774,242775,0,1,4
69368,2,3,242776,242776,242779,0,3,1
69369,6,3,242782,242782,242785,0,3,3
69370,1,2,242783,242785,242787,2,4,0
69371,3,2,242786,242787,242789,1,3,0
69372,3,1,242789,242789,242790,0,1,0
69373,2,2,242791,242791,242793,0,2,1
69374,3,1,242794,242794,242795,0,1,1
69375,1,3,242795,242795,242798,0,3,0
69376,3,2,242798,242798,242800,0,2,0
69377,1,3,242799,242800,242803,1,4,0
69378,1,2,242800,242803,242805,3,5,0
69379,3,3,242803,242805,242808,2,5,0
69380,5,3,242808,242808,242811,0,3,0
69381,4,3,242812,242812,242815,0,3,1
69382,1,2,242813,242815,242817,2,4,0
69383,6,2,242819,242819,242821,0,2,2
69384,2,3,242821,242821,242824,0,3,0
69385,5,1,242826,242826,242827,0,1,2
69386,2,2,242828,242828,242830,0,2,1
69387,3,1,242831,242831,242832,0,1,1
69388,6,3,242837,242837,242840,0,3,5
69389,2,3,242839,242840,242843,1,4,0
69390,2,3,242841,242843,242846,2,5,0
69391,1,1,242842,242846,242847,4,5,0
69392,1,3,242843,242847,242850,4,7,0
69393,2,1,242845,242850,242851,5,6,0
69394,2,1,242847,242851,242852,4,5,0
69395,4,1,242851,242852,242853,1,2,0
69396,4,1,242855,242855,242856,0,1,2
69397,5,2,242860,242860,242862,0,2,4
69398,5,2,242865,242865,242867,0,2,3
69399,4,1,242869,242869,242870,0,1,2
69400,5,1,242874,242874,242875,0,1,4
69401,4,3,242878,242878,242881,0,3,3
69402,1,1,242879,242881,242882,2,3,0
69403,5,2,242884,242884,242886,0,2,2
69404,5,3,242889,242889,242892,0,3,3
69405,5,1,242894,242894,242895,0,1,2
69406,6,3,242900,242900,242903,0,3,5
69407,5,3,242905,242905,242908,0,3,2
69408,2,1,242907,242908,242909,1,2,0
69409,1,1,242908,242909,242910,1,2,0
69410,5,3,242913,242913,242916,0,3,3
69411,3,1,242916,242916,242917,0,1,0
69412,4,2,242920,242920,242922,0,2,3
69413,4,2,242924,242924,242926,0,2,2
69414,5,1,242929,242929,242930,0,1,3
69415,4,2,242933,242933,242935,0,2,3
69416,4,3,242937,242937,242940,0,3,2
69417,2,3,242939,242940,242943,1,4,0
69418,5,3,242944,242944,242947,0,3,1
69419,4,3,242948,242948,242951,0,3,1
69420,1,1,242949,242951,242952,2,3,0
69421,5,1,242954,242954,242955,0,1,2
69422,6,3,242960,242960,242963,0,3,5
69423,1,1,242961,242963,242964,2,3,0
69424,1,3,242962,242964,242967,2,5,0
69425,4,2,242966,242967,242969,1,3,0
69426,6,1,242972,242972,242973,0,1,3
69427,5,1,242977,242977,242978,0,1,4
69428,4,1,242981,242981,242982,0,1,3
69429,3,2,242984,242984,242986,0,2,2
69430,2,2,242986,242986,242988,0,2,0
69431,3,1,242989,242989,242990,0,1,1
69432,2,2,242991,242991,242993,0,2,1
69433,2,3,242993,242993,242996,0,3,0
69434,3,1,242996,242996,242997,0,1,0
69435,4,1,243000,243000,243001,0,1,3
69436,1,2,243001,243001,243003,0,2,0
69437,5,3,243006,243006,243009,0,3,3
69438,4,2,243010,243010,243012,0,2,1
69439,2,3,243012,243012,243015,0,3,0
69440,2,2,243014,243015,243017,1,3,0
69441,5,1,243019,243019,243020,0,1,2
69442,4,3,243023,243023,243026,0,3,3
69443,2,2,243025,243026,243028,1,3,0
69444,6,2,243031,243031,243033,0,2,3
69445,6,3,243037,243037,243040,0,3,4
69446,4,1,243041,243041,243042,0,1,1
69447,6,1,243047,243047,243048,0,1,5
69448,3,3,243050,243050,243053,0,3,2
69449,4,1,243054,243054,243055,0,1,1
69450,4,3,243058,243058,243061,0,3,3
69451,2,2,243060,243061,243063,1,3,0
69452,4,1,243064,243064,243065,0,1,1
69453,4,2,243068,243068,243070,0,2,3
69454,6,3,243074,243074,243077,0,3,4
69455,6,2,243080,243080,243082,0,2,3
69456,5,1,243085,243085,243086,0,1,3
69457,5,2,243090,243090,243092,0,2,4
69458,6,1,243096,243096,243097,0,1,4
69459,3,1,243099,243099,243100,0,1,2
69460,4,2,243103,243103,243105,0,2,3
69461,1,2,243104,243105,243107,1,3,0
69462,2,2,243106,243107,243109,1,3,0
69463,4,2,243110,243110,243112,0,2,1
69464,3,1,243113,243113,243114,0,1,1
69465,3,1,243116,243116,243117,0,1,2
69466,3,2,243119,243119,243121,0,2,2
69467,1,1,243120,243121,243122,1,2,0
69468,4,1,243124,243124,243125,0,1,2
69469,4,2,243128,243128,243130,0,2,3
69470,5,1,243133,243133,243134,0,1,3
69471,3,3,243136,243136,243139,0,3,2
69472,4,3,243140,243140,243143,0,3,1
69473,2,2,243142,243143,243145,1,3,0
69474,3,3,243145,243145,243148,0,3,0
69475,5,2,243150,243150,243152,0,2,2
69476,2,2,243152,243152,243154,0,2,0
69477,6,1,243158,243158,243159,0,1,4
69478,3,1,243161,243161,243162,0,1,2
69479,6,1,243167,243167,243168,0,1,5
69480,6,2,243173,243173,243175,0,2,5
69481,6,3,243179,243179,243182,0,3,4
69482,2,2,243181,243182,243184,1,3,0
69483,2,2,243183,243184,243186,1,3,0
69484,4,3,243187,243187,243190,0,3,1
69485,6,3,243193,243193,243196,0,3,3
69486,2,2,243195,243196,243198,1,3,0
69487,3,1,243198,243198,243199,0,1,0
69488,4,2,243202,243202,243204,0,2,3
69489,4,1,243206,243206,243207,0,1,2
69490,5,3,243211,243211,243214,0,3,4
69491,4,3,243215,243215,243218,0,3,1
69492,3,1,243218,243218,243219,0,1,0
69493,3,1,243221,243221,243222,0,1,2
69494,4,3,243225,243225,243228,0,3,3
69495,6,1,243231,243231,243232,0,1,3
69496,6,2,243237,243237,243239,0,2,5
69497,4,3,243241,243241,243244,0,3,2
69498,6,2,243247,243247,243249,0,2,3
69499,2,1,243249,243249,243250,0,1,0
69500,2,3,243251,243251,243254,0,3,1
69501,1,2,243252,243254,243256,2,4,0
69502,3,3,243255,243256,243259,1,4,0
69503,4,1,243259,243259,243260,0,1,0
69504,4,2,243263,243263,243265,0,2,3
69505,1,3,243264,243265,243268,1,4,0
69506,1,2,243265,243268,243270,3,5,0
69507,5,2,243270,243270,243272,0,2,0
69508,4,2,243274,243274,243276,0,2,2
69509,2,1,243276,243276,243277,0,1,0
69510,2,2,243278,243278,243280,0,2,1
69511,6,1,243284,243284,243285,0,1,4
69512,2,3,243286,243286,243289,0,3,1
69513,2,1,243288,243289,243290,1,2,0
69514,6,3,243294,243294,243297,0,3,4
69515,5,3,243299,243299,243302,0,3,2
69516,1,1,243300,243302,243303,2,3,0
69517,4,1,243304,243304,243305,0,1,1
69518,3,2,243307,243307,243309,0,2,2
69519,4,2,243311,243311,243313,0,2,2
69520,2,3,243313,243313,243316,0,3,0
69521,4,3,243317,243317,243320,0,3,1
69522,5,3,243322,243322,243325,0,3,2
69523,3,2,243325,243325,243327,0,2,0
69524,5,2,243330,243330,243332,0,2,3
69525,6,1,243336,243336,243337,0,1,4
69526,5,3,243341,243341,243344,0,3,4
69527,2,1,243343,243344,243345,1,2,0
69528,3,2,243346,243346,243348,0,2,1
69529,3,3,243349,243349,243352,0,3,1
69530,3,2,243352,243352,243354,0,2,0
69531,2,2,243354,243354,243356,0,2,0
69532,2,2,243356,243356,243358,0,2,0
69533,5,1,243361,243361,243362,0,1,3
69534,4,1,243365,243365,243366,0,1,3
69535,2,3,243367,243367,243370,0,3,1
69536,6,3,243373,243373,243376,0,3,3
69537,1,2,243374,243376,243378,2,4,0
69538,4,2,243378,243378,243380,0,2,0
69539,1,3,243379,243380,243383,1,4,0
69540,4,1,243383,243383,243384,0,1,0
69541,6,2,243389,243389,243391,0,2,5
69542,2,1,243391,243391,243392,0,1,0
69543,1,1,243392,243392,243393,0,1,0
69544,2,2,243394,243394,243396,0,2,1
69545,6,1,243400,243400,243401,0,1,4
69546,5,3,243405,243405,243408,0,3,4
69547,6,2,243411,243411,243413,0,2,3
69548,3,1,243414,243414,243415,0,1,1
69549,2,1,243416,243416,243417,0,1,1
69550,6,1,243422,243422,243423,0,1,5
69551,1,2,243423,243423,243425,0,2,0
69552,1,2,243424,243425,243427,1,3,0
69553,3,3,243427,243427,243430,0,3,0
69554,6,1,243433,243433,243434,0,1,3
69555,3,1,243436,243436,243437,0,1,2
69556,5,1,243441,243441,243442,0,1,4
69557,1,1,243442,243442,243443,0,1,0
69558,6,2,243448,243448,243450,0,2,5
69559,1,2,243449,243450,243452,1,3,0
69560,3,3,243452,243452,243455,0,3,0
69561,1,2,243453,243455,243457,2,4,0
69562,5,2,243458,243458,243460,0,2,1
69563,6,3,243464,243464,243467,0,3,4
69564,3,1,243467,243467,243468,0,1,0
69565,5,2,243472,243472,243474,0,2,4
69566,5,2,243477,243477,243479,0,2,3
69567,5,2,243482,243482,243484,0,2,3
69568,5,2,243487,243487,243489,0,2,3
69569,1,1,243488,243489,243490,1,2,0
69570,5,1,243493,243493,243494,0,1,3
69571,3,1,243496,243496,243497,0,1,2
69572,5,3,243501,243501,243504,0,3,4
69573,3,1,243504,243504,243505,0,1,0
69574,6,3,243510,243510,243513,0,3,5
69575,5,3,243515,243515,243518,0,3,2
69576,3,1,243518,243518,243519,0,1,0
69577,2,2,243520,243520,243522,0,2,1
69578,1,3,243521,243522,243525,1,4,0
69579,4,2,243525,243525,243527,0,2,0
69580,2,2,243527,243527,243529,0,2,0
69581,3,2,243530,243530,243532,0,2,1
69582,2,2,243532,243532,243534,0,2,0
69583,6,3,243538,243538,243541,0,3,4
69584,4,3,243542,243542,243545,0,3,1
69585,5,2,243547,243547,243549,0,2,2
69586,6,1,243553,243553,243554,0,1,4
69587,2,2,243555,243555,243557,0,2,1
69588,1,1,243556,243557,243558,1,2,0
69589,1,2,243557,243558,243560,1,3,0
69590,2,2,243559,243560,243562,1,3,0
69591,6,2,243565,243565,243567,0,2,3
69592,4,1,243569,243569,243570,0,1,2
69593,2,3,243571,243571,243574,0,3,1
69594,2,1,243573,243574,243575,1,2,0
69595,4,2,243577,243577,243579,0,2,2
69596,4,1,243581,243581,243582,0,1,2
69597,4,3,243585,243585,243588,0,3,3
69598,5,1,243590,243590,243591,0,1,2
69599,5,1,243595,243595,243596,0,1,4
69600,1,3,243596,243596,243599,0,3,0
69601,2,3,243598,243599,243602,1,4,0
69602,5,3,243603,243603,243606,0,3,1
69603,2,1,243605,243606,243607,1,2,0
69604,1,2,243606,243607,243609,1,3,0
69605,3,2,243609,243609,243611,0,2,0
69606,6,2,243615,243615,243617,0,2,4
69607,2,2,243617,243617,243619,0,2,0
69608,4,1,243621,243621,243622,0,1,2
69609,6,1,243627,243627,243628,0,1,5
69610,2,2,243629,243629,243631,0,2,1
69611,2,2,243631,243631,243633,0,2,0
69612,4,2,243635,243635,243637,0,2,2
69613,6,2,243641,243641,243643,0,2,4
69614,3,2,243644,243644,243646,0,2,1
69615,1,1,243645,243646,243647,1,2,0
69616,3,1,243648,243648,243649,0,1,1
69617,2,2,243650,243650,243652,0,2,1
69618,1,1,243651,243652,243653,1,2,0
69619,5,1,243656,243656,243657,0,1,3
69620,2,1,243658,243658,243659,0,1,1
69621,2,2,243660,243660,243662,0,2,1
69622,2,1,243662,243662,243663,0,1,0
69623,4,2,243666,243666,243668,0,2,3
69624,2,3,243668,243668,243671,0,3,0
69625,4,3,243672,243672,243675,0,3,1
69626,3,3,243675,243675,243678,0,3,0
69627,2,2,243677,243678,243680,1,3,0
69628,6,2,243683,243683,243685,0,2,3
69629,1,3,243684,243685,243688,1,4,0
69630,4,2,243688,243688,243690,0,2,0
69631,3,1,243691,243691,243692,0,1,1
69632,3,1,243694,243694,243695,0,1,2
69633,1,1,243695,243695,243696,0,1,0
69634,3,3,243698,243698,243701,0,3,2
69635,4,3,243702,243702,243705,0,3,1
69636,6,2,243708,243708,243710,0,2,3
69637,3,2,243711,243711,243713,0,2,1
69638,3,3,243714,243714,243717,0,3,1
69639,4,3,243718,243718,243721,0,3,1
69640,2,3,243720,243721,243724,1,4,0
69641,4,1,243724,243724,243725,0,1,0
69642,3,3,243727,243727,243730,0,3,2
69643,2,1,243729,243730,243731,1,2,0
69644,2,3,243731,243731,243734,0,3,0
69645,5,2,243736,243736,243738,0,2,2
69646,5,3,243741,243741,243744,0,3,3
69647,5,2,243746,243746,243748,0,2,2
69648,3,1,243749,243749,243750,0,1,1
69649,1,2,243750,243750,243752,0,2,0
69650,6,1,243756,243756,243757,0,1,4
69651,3,1,243759,243759,243760,0,1,2
69652,2,2,243761,243761,243763,0,2,1
69653,6,1,243767,243767,243768,0,1,4
69654,6,1,243773,243773,243774,0,1,5
69655,1,2,243774,243774,243776,0,2,0
69656,3,3,243777,243777,243780,0,3,1
69657,2,3,243779,243780,243783,1,4,0
69658,2,3,243781,243783,243786,2,5,0
69659,6,2,243787,243787,243789,0,2,1
69660,5,2,243792,243792,243794,0,2,3
69661,4,3,243796,243796,243799,0,3,2
69662,5,1,243801,243801,243802,0,1,2
69663,3,1,243804,243804,243805,0,1,2
69664,1,1,243805,243805,243806,0,1,0
69665,6,1,243811,243811,243812,0,1,5
69666,1,1,243812,243812,243813,0,1,0
69667,4,1,243816,243816,243817,0,1,3
69668,6,2,243822,243822,243824,0,2,5
69669,4,2,243826,243826,243828,0,2,2
69670,4,2,243830,243830,243832,0,2,2
69671,5,2,243835,243835,243837,0,2,3
69672,2,2,243837,243837,243839,0,2,0
69673,5,1,243842,243842,243843,0,1,3
69674,1,2,243843,243843,243845,0,2,0
69675,6,3,243849,243849,243852,0,3,4
69676,2,3,243851,243852,243855,1,4,0
69677,2,1,243853,243855,243856,2,3,0
69678,5,2,243858,243858,243860,0,2,2
69679,4,2,243862,243862,243864,0,2,2
69680,1,3,243863,243864,243867,1,4,0
69681,1,2,243864,243867,243869,3,5,0
69682,5,3,243869,243869,243872,0,3,0
69683,2,3,243871,243872,243875,1,4,0
69684,6,3,243877,243877,243880,0,3,2
69685,4,2,243881,243881,243883,0,2,1
69686,2,1,243883,243883,243884,0,1,0
69687,3,2,243886,243886,243888,0,2,2
69688,2,3,243888,243888,243891,0,3,0
69689,3,1,243891,243891,243892,0,1,0
69690,6,3,243897,243897,243900,0,3,5
69691,1,3,243898,243900,243903,2,5,0
69692,2,2,243900,243903,243905,3,5,0
69693,1,2,243901,243905,243907,4,6,0
69694,3,1,243904,243907,243908,3,4,0
69695,1,1,243905,243908,243909,3,4,0
69696,5,1,243910,243910,243911,0,1,1
69697,1,2,243911,243911,243913,0,2,0
69698,2,2,243913,243913,243915,0,2,0
69699,1,2,243914,243915,243917,1,3,0
69700,2,1,243916,243917,243918,1,2,0
69701,6,3,243922,243922,243925,0,3,4
69702,2,2,243924,243925,243927,1,3,0
69703,1,2,243925,243927,243929,2,4,0
69704,3,1,243928,243929,243930,1,2,0
69705,5,3,243933,243933,243936,0,3,3
69706,4,1,243937,243937,243938,0,1,1
69707,5,1,243942,243942,243943,0,1,4
69708,3,3,243945,243945,243948,0,3,2
69709,3,2,243948,243948,243950,0,2,0
69710,4,1,243952,243952,243953,0,1,2
69711,6,2,243958,243958,243960,0,2,5
69712,1,2,243959,243960,243962,1,3,0
69713,2,1,243961,243962,243963,1,2,0
69714,5,3,243966,243966,243969,0,3,3
69715,2,3,243968,243969,243972,1,4,0
69716,3,3,243971,243972,243975,1,4,0
69717,1,2,243972,243975,243977,3,5,0
69718,4,3,243976,243977,243980,1,4,0
69719,3,2,243979,243980,243982,1,3,0
69720,4,1,243983,243983,243984,0,1,1
69721,1,3,243984,243984,243987,0,3,0
69722,1,3,243985,243987,243990,2,5,0
69723,1,2,243986,243990,243992,4,6,0
69724,6,2,243992,243992,243994,0,2,0
69725,6,1,243998,243998,243999,0,1,4
69726,2,3,244000,244000,244003,0,3,1
69727,6,2,244006,244006,244008,0,2,3
69728,6,3,244012,244012,244015,0,3,4
69729,5,3,244017,244017,244020,0,3,2
69730,6,3,244023,244023,244026,0,3,3
69731,4,1,244027,244027,244028,0,1,1
69732,4,1,244031,244031,244032,0,1,3
69733,2,2,244033,244033,244035,0,2,1
69734,4,2,244037,244037,244039,0,2,2
69735,1,3,244038,244039,244042,1,4,0
69736,2,3,244040,244042,244045,2,5,0
69737,2,3,244042,244045,244048,3,6,0
69738,5,1,244047,244048,244049,1,2,0
69739,6,1,244053,244053,244054,0,1,4
69740,1,3,244054,244054,244057,0,3,0
69741,6,3,244060,244060,244063,0,3,3
69742,5,1,244065,244065,244066,0,1,2
69743,5,1,244070,244070,244071,0,1,4
69744,5,2,244075,244075,244077,0,2,4
69745,5,3,244080,244080,244083,0,3,3
69746,6,2,244086,244086,244088,0,2,3
69747,1,3,244087,244088,244091,1,4,0
69748,6,1,244093,244093,244094,0,1,2
69749,6,2,244099,244099,244101,0,2,5
69750,3,1,244102,244102,244103,0,1,1
69751,3,2,244105,244105,244107,0,2,2
69752,4,3,244109,244109,244112,0,3,2
69753,6,3,244115,244115,244118,0,3,3
69754,1,1,244116,244118,244119,2,3,0
69755,2,3,244118,244119,244122,1,4,0
69756,4,3,244122,244122,244125,0,3,0
69757,5,3,244127,244127,244130,0,3,2
69758,1,3,244128,244130,244133,2,5,0
69759,6,1,244134,244134,244135,0,1,1
69760,5,3,244139,244139,244142,0,3,4
69761,4,1,244143,244143,244144,0,1,1
69762,3,1,244146,244146,244147,0,1,2
69763,2,3,244148,244148,244151,0,3,1
69764,6,1,244154,244154,244155,0,1,3
69765,6,1,244160,244160,244161,0,1,5
69766,6,2,244166,244166,244168,0,2,5
69767,1,2,244167,244168,244170,1,3,0
69768,2,1,244169,244170,244171,1,2,0
69769,4,3,244173,244173,244176,0,3,2
69770,6,2,244179,244179,244181,0,2,3
69771,2,1,244181,244181,244182,0,1,0
69772,6,1,244187,244187,244188,0,1,5
69773,1,1,244188,244188,244189,0,1,0
69774,4,3,244192,244192,244195,0,3,3
69775,4,2,244196,244196,244198,0,2,1
69776,6,1,244202,244202,244203,0,1,4
69777,6,1,244208,244208,244209,0,1,5
69778,2,2,244210,244210,244212,0,2,1
69779,3,1,244213,244213,244214,0,1,1
69780,3,2,244216,244216,244218,0,2,2
69781,5,1,244221,244221,244222,0,1,3
69782,5,2,244226,244226,244228,0,2,4
69783,5,1,244231,244231,244232,0,1,3
69784,1,3,244232,244232,244235,0,3,0
69785,4,3,244236,244236,244239,0,3,1
69786,2,2,244238,244239,244241,1,3,0
69787,1,2,244239,244241,244243,2,4,0
69788,3,2,244242,244243,244245,1,3,0
69789,4,3,244246,244246,244249,0,3,1
69790,2,3,244248,244249,244252,1,4,0
69791,5,1,244253,244253,244254,0,1,1
69792,4,1,244257,244257,244258,0,1,3
69793,1,2,244258,244258,244260,0,2,0
69794,4,1,244262,244262,244263,0,1,2
69795,6,2,244268,244268,244270,0,2,5
69796,1,3,244269,244270,244273,1,4,0
69797,3,2,244272,244273,244275,1,3,0
69798,6,3,244278,244278,244281,0,3,3
69799,4,1,244282,244282,244283,0,1,1
69800,3,1,244285,244285,244286,0,1,2
69801,1,1,244286,244286,244287,0,1,0
69802,6,3,244292,244292,244295,0,3,5
69803,6,1,244298,244298,244299,0,1,3
69804,3,2,244301,244301,244303,0,2,2
69805,3,1,244304,244304,244305,0,1,1
69806,4,2,244308,244308,244310,0,2,3
69807,4,1,244312,244312,244313,0,1,2
69808,1,2,244313,244313,244315,0,2,0
69809,4,2,244317,244317,244319,0,2,2
69810,3,3,244320,244320,244323,0,3,1
69811,1,3,244321,244323,244326,2,5,0
69812,5,3,244326,244326,244329,0,3,0
69813,4,2,244330,244330,244332,0,2,1
69814,5,1,244335,244335,244336,0,1,3
69815,2,2,244337,244337,244339,0,2,1
69816,1,1,244338,244339,244340,1,2,0
69817,3,2,244341,244341,244343,0,2,1
69818,4,3,244345,244345,244348,0,3,2
69819,5,3,244350,244350,244353,0,3,2
69820,3,1,244353,244353,244354,0,1,0
69821,2,3,244355,244355,244358,0,3,1
69822,6,3,244361,244361,244364,0,3,3
69823,4,3,244365,244365,244368,0,3,1
69824,4,3,244369,244369,244372,0,3,1
69825,6,1,244375,244375,244376,0,1,3
69826,3,3,244378,244378,244381,0,3,2
69827,1,3,244379,244381,244384,2,5,0
69828,4,1,244383,244384,244385,1,2,0
69829,5,1,244388,244388,244389,0,1,3
69830,4,1,244392,244392,244393,0,1,3
69831,3,1,244395,244395,244396,0,1,2
69832,3,2,244398,244398,244400,0,2,2
69833,6,3,244404,244404,244407,0,3,4
69834,2,3,244406,244407,244410,1,4,0
69835,5,3,244411,244411,244414,0,3,1
69836,6,2,244417,244417,244419,0,2,3
69837,6,3,244423,244423,244426,0,3,4
69838,3,1,244426,244426,244427,0,1,0
69839,1,3,244427,244427,244430,0,3,0
69840,4,3,244431,244431,244434,0,3,1
69841,1,3,244432,244434,244437,2,5,0
69842,4,1,244436,244437,244438,1,2,0
69843,3,2,244439,244439,244441,0,2,1
69844,5,1,244444,244444,244445,0,1,3
69845,3,3,244447,244447,244450,0,3,2
69846,3,1,244450,244450,244451,0,1,0
69847,1,3,244451,244451,244454,0,3,0
69848,4,2,244455,244455,244457,0,2,1
69849,3,2,244458,244458,244460,0,2,1
69850,2,2,244460,244460,244462,0,2,0
69851,1,3,244461,244462,244465,1,4,0
69852,1,1,244462,244465,244466,3,4,0
69853,1,3,244463,244466,244469,3,6,0
69854,5,2,244468,244469,244471,1,3,0
69855,3,2,244471,244471,244473,0,2,0
69856,4,2,244475,244475,244477,0,2,2
69857,2,3,244477,244477,244480,0,3,0
69858,3,3,244480,244480,244483,0,3,0
69859,6,2,244486,244486,244488,0,2,3
69860,5,2,244491,244491,244493,0,2,3
69861,5,1,244496,244496,244497,0,1,3
69862,4,1,244500,244500,244501,0,1,3
69863,6,3,244506,244506,244509,0,3,5
69864,1,1,244507,244509,244510,2,3,0
69865,2,2,244509,244510,244512,1,3,0
69866,6,1,244515,244515,244516,0,1,3
69867,3,3,244518,244518,244521,0,3,2
69868,1,1,244519,244521,244522,2,3,0
69869,2,1,244521,244522,244523,1,2,0
69870,5,1,244526,244526,244527,0,1,3
69871,1,1,244527,244527,244528,0,1,0
69872,3,1,244530,244530,244531,0,1,2
69873,1,3,244531,244531,244534,0,3,0
69874,4,1,244535,244535,244536,0,1,1
69875,2,1,244537,244537,244538,0,1,1
69876,4,1,244541,244541,244542,0,1,3
69877,2,3,244543,244543,244546,0,3,1
69878,5,3,244548,244548,244551,0,3,2
69879,1,1,244549,244551,244552,2,3,0
69880,6,1,244555,244555,244556,0,1,3
69881,5,3,244560,244560,244563,0,3,4
69882,5,1,244565,244565,244566,0,1,2
69883,6,1,244571,244571,244572,0,1,5
69884,4,3,244575,244575,244578,0,3,3
69885,3,1,244578,244578,244579,0,1,0
69886,2,2,244580,244580,244582,0,2,1
69887,4,3,244584,244584,244587,0,3,2
69888,3,1,244587,244587,244588,0,1,0
69889,5,1,244592,244592,244593,0,1,4
69890,3,1,244595,244595,244596,0,1,2
69891,1,1,244596,244596,244597,0,1,0
69892,2,1,244598,244598,244599,0,1,1
69893,5,1,244603,244603,244604,0,1,4
69894,5,2,244608,244608,244610,0,2,4
69895,1,2,244609,244610,244612,1,3,0
69896,1,3,244610,244612,244615,2,5,0
69897,4,1,244614,244615,244616,1,2,0
69898,1,1,244615,244616,244617,1,2,0
69899,4,1,244619,244619,244620,0,1,2
69900,5,2,244624,244624,244626,0,2,4
69901,4,3,244628,244628,244631,0,3,2
69902,3,2,244631,244631,244633,0,2,0
69903,6,3,244637,244637,244640,0,3,4
69904,4,1,244641,244641,244642,0,1,1
69905,4,2,244645,244645,244647,0,2,3
69906,4,1,244649,244649,244650,0,1,2
69907,5,2,244654,244654,244656,0,2,4
69908,5,2,244659,244659,244661,0,2,3
69909,4,3,244663,244663,244666,0,3,2
69910,6,2,244669,244669,244671,0,2,3
69911,6,2,244675,244675,244677,0,2,4
69912,3,2,244678,244678,244680,0,2,1
69913,4,3,244682,244682,244685,0,3,2
69914,4,2,244686,244686,244688,0,2,1
69915,5,1,244691,244691,244692,0,1,3
69916,4,3,244695,244695,244698,0,3,3
69917,4,3,244699,244699,244702,0,3,1
69918,5,3,244704,244704,244707,0,3,2
69919,3,3,244707,244707,244710,0,3,0
69920,4,2,244711,244711,244713,0,2,1
69921,1,2,244712,244713,244715,1,3,0
69922,3,3,244715,244715,244718,0,3,0
69923,1,1,244716,244718,244719,2,3,0
69924,4,2,244720,244720,244722,0,2,1
69925,5,2,244725,244725,244727,0,2,3
69926,5,2,244730,244730,244732,0,2,3
69927,6,3,244736,244736,244739,0,3,4
69928,4,1,244740,244740,244741,0,1,1
69929,4,2,244744,244744,244746,0,2,3
69930,1,2,244745,244746,244748,1,3,0
69931,6,2,244751,244751,244753,0,2,3
69932,6,1,244757,244757,244758,0,1,4
69933,4,2,244761,244761,244763,0,2,3
69934,6,1,244767,244767,244768,0,1,4
69935,5,2,244772,244772,244774,0,2,4
69936,5,1,244777,244777,244778,0,1,3
69937,1,3,244778,244778,244781,0,3,0
69938,6,3,244784,244784,244787,0,3,3
69939,1,1,244785,244787,244788,2,3,0
69940,4,2,244789,244789,244791,0,2,1
69941,2,1,244791,244791,244792,0,1,0
69942,5,1,244796,244796,244797,0,1,4
69943,5,3,244801,244801,244804,0,3,4
69944,1,1,244802,244804,244805,2,3,0
69945,2,2,244804,244805,244807,1,3,0
69946,6,3,244810,244810,244813,0,3,3
69947,2,3,244812,244813,244816,1,4,0
69948,1,1,244813,244816,244817,3,4,0
69949,1,2,244814,244817,244819,3,5,0
69950,5,3,244819,244819,244822,0,3,0
69951,1,2,244820,244822,244824,2,4,0
69952,5,3,244825,244825,244828,0,3,1
69953,4,2,244829,244829,244831,0,2,1
69954,4,2,244833,244833,244835,0,2,2
69955,6,2,244839,244839,244841,0,2,4
69956,3,2,244842,244842,244844,0,2,1
69957,3,2,244845,244845,244847,0,2,1
69958,3,2,244848,244848,244850,0,2,1
69959,6,2,244854,244854,244856,0,2,4
69960,3,2,244857,244857,244859,0,2,1
69961,4,3,244861,244861,244864,0,3,2
69962,6,2,244867,244867,244869,0,2,3
69963,3,2,244870,244870,244872,0,2,1
69964,1,2,244871,244872,244874,1,3,0
69965,4,2,244875,244875,244877,0,2,1
69966,2,3,244877,244877,244880,0,3,0
69967,6,1,244883,244883,244884,0,1,3
69968,6,1,244889,244889,244890,0,1,5
69969,2,1,244891,244891,244892,0,1,1
69970,4,2,244895,244895,244897,0,2,3
69971,1,1,244896,244897,244898,1,2,0
69972,2,3,244898,244898,244901,0,3,0
69973,5,1,244903,244903,244904,0,1,2
69974,1,1,244904,244904,244905,0,1,0
69975,2,2,244906,244906,244908,0,2,1
69976,5,1,244911,244911,244912,0,1,3
69977,2,3,244913,244913,244916,0,3,1
69978,3,2,244916,244916,244918,0,2,0
69979,4,3,244920,244920,244923,0,3,2
69980,2,1,244922,244923,244924,1,2,0
69981,4,3,244926,244926,244929,0,3,2
69982,2,3,244928,244929,244932,1,4,0
69983,5,2,244933,244933,244935,0,2,1
69984,2,2,244935,244935,244937,0,2,0
69985,3,2,244938,244938,244940,0,2,1
69986,3,2,244941,244941,244943,0,2,1
69987,2,3,244943,244943,244946,0,3,0
69988,2,3,244945,244946,244949,1,4,0
69989,3,3,244948,244949,244952,1,4,0
69990,5,2,244953,244953,244955,0,2,1
69991,6,2,244959,244959,244961,0,2,4
69992,5,1,244964,244964,244965,0,1,3
69993,6,2,244970,244970,244972,0,2,5
69994,6,3,244976,244976,244979,0,3,4
69995,2,1,244978,244979,244980,1,2,0
69996,5,3,244983,244983,244986,0,3,3
69997,5,3,244988,244988,244991,0,3,2
69998,1,1,244989,244991,244992,2,3,0
69999,6,3,244995,244995,244998,0,3,3
70000,5,3,245000,245000,245003,0,3,2
70001,1,2,245001,245003,245005,2,4,0
70002,3,1,245004,245005,245006,1,2,0
70003,6,3,245010,245010,245013,0,3,4
70004,5,3,245015,245015,245018,0,3,2
70005,1,2,245016,245018,245020,2,4,0
70006,4,3,245020,245020,245023,0,3,0
70007,2,1,245022,245023,245024,1,2,0
70008,4,1,245026,245026,245027,0,1,2
70009,3,1,245029,245029,245030,0,1,2
70010,6,1,245035,245035,245036,0,1,5
70011,4,2,245039,245039,245041,0,2,3
70012,6,3,245045,245045,245048,0,3,4
70013,6,2,245051,245051,245053,0,2,3
70014,3,1,245054,245054,245055,0,1,1
70015,4,2,245058,245058,245060,0,2,3
70016,6,3,245064,245064,245067,0,3,4
70017,5,2,245069,245069,245071,0,2,2
70018,2,1,245071,245071,245072,0,1,0
70019,6,1,245077,245077,245078,0,1,5
70020,2,3,245079,245079,245082,0,3,1
70021,1,1,245080,245082,245083,2,3,0
70022,2,2,245082,245083,245085,1,3,0
70023,5,2,245087,245087,245089,0,2,2
70024,1,3,245088,245089,245092,1,4,0
70025,5,2,245093,245093,245095,0,2,1
70026,5,2,245098,245098,245100,0,2,3
70027,2,1,245100,245100,245101,0,1,0
70028,3,2,245103,245103,245105,0,2,2
70029,6,1,245109,245109,245110,0,1,4
70030,3,2,245112,245112,245114,0,2,2
70031,5,3,245117,245117,245120,0,3,3
70032,4,3,245121,245121,245124,0,3,1
70033,3,3,245124,245124,245127,0,3,0
70034,1,3,245125,245127,245130,2,5,0
70035,3,2,245128,245130,245132,2,4,0
70036,2,3,245130,245132,245135,2,5,0
70037,1,2,245131,245135,245137,4,6,0
70038,3,3,245134,245137,245140,3,6,0
70039,2,1,245136,245140,245141,4,5,0
70040,6,1,245142,245142,245143,0,1,1
70041,4,2,245146,245146,245148,0,2,3
70042,4,2,245150,245150,245152,0,2,2
70043,4,2,245154,245154,245156,0,2,2
70044,3,3,245157,245157,245160,0,3,1
70045,2,3,245159,245160,245163,1,4,0
70046,4,2,245163,245163,245165,0,2,0
70047,6,3,245169,245169,245172,0,3,4
70048,3,3,245172,245172,245175,0,3,0
70049,1,1,245173,245175,245176,2,3,0
70050,4,3,245177,245177,245180,0,3,1
70051,5,3,245182,245182,245185,0,3,2
70052,4,1,245186,245186,245187,0,1,1
70053,6,3,245192,245192,245195,0,3,5
70054,6,1,245198,245198,245199,0,1,3
70055,2,2,245200,245200,245202,0,2,1
70056,2,1,245202,245202,245203,0,1,0
70057,4,1,245206,245206,245207,0,1,3
70058,1,3,245207,245207,245210,0,3,0
70059,1,1,245208,245210,245211,2,3,0
70060,3,2,245211,245211,245213,0,2,0
70061,6,1,245217,245217,245218,0,1,4
70062,2,3,245219,245219,245222,0,3,1
70063,3,3,245222,245222,245225,0,3,0
70064,4,2,245226,245226,245228,0,2,1
70065,4,1,245230,245230,245231,0,1,2
70066,3,1,245233,245233,245234,0,1,2
70067,6,2,245239,245239,245241,0,2,5
70068,6,3,245245,245245,245248,0,3,4
70069,1,2,245246,245248,245250,2,4,0
70070,5,3,245251,245251,245254,0,3,1
70071,1,3,245252,245254,245257,2,5,0
70072,5,1,245257,245257,245258,0,1,0
70073,1,1,245258,245258,245259,0,1,0
70074,5,2,245263,245263,245265,0,2,4
70075,4,3,245267,245267,245270,0,3,2
70076,4,2,245271,245271,245273,0,2,1
70077,5,1,245276,245276,245277,0,1,3
70078,6,2,245282,245282,245284,0,2,5
70079,1,1,245283,245284,245285,1,2,0
70080,1,3,245284,245285,245288,1,4,0
70081,5,2,245289,245289,245291,0,2,1
70082,6,1,245295,245295,245296,0,1,4
70083,6,2,245301,245301,245303,0,2,5
70084,2,1,245303,245303,245304,0,1,0
70085,2,2,245305,245305,245307,0,2,1
70086,6,3,245311,245311,245314,0,3,4
70087,6,3,245317,245317,245320,0,3,3
70088,4,2,245321,245321,245323,0,2,1
70089,2,2,245323,245323,245325,0,2,0
70090,2,3,245325,245325,245328,0,3,0
70091,4,3,245329,245329,245332,0,3,1
70092,6,1,245335,245335,245336,0,1,3
70093,3,1,245338,245338,245339,0,1,2
70094,6,2,245344,245344,245346,0,2,5
70095,5,3,245349,245349,245352,0,3,3
70096,5,2,245354,245354,245356,0,2,2
70097,2,3,245356,245356,245359,0,3,0
70098,2,2,245358,245359,245361,1,3,0
70099,2,2,245360,245361,245363,1,3,0
70100,2,3,245362,245363,245366,1,4,0
70101,1,1,245363,245366,245367,3,4,0
70102,2,3,245365,245367,245370,2,5,0
70103,6,2,245371,245371,245373,0,2,1
70104,2,3,245373,245373,245376,0,3,0
70105,5,3,245378,245378,245381,0,3,2
70106,3,3,245381,245381,245384,0,3,0
70107,5,2,245386,245386,245388,0,2,2
70108,4,2,245390,245390,245392,0,2,2
70109,6,1,245396,245396,245397,0,1,4
70110,5,3,245401,245401,245404,0,3,4
70111,3,1,245404,245404,245405,0,1,0
70112,4,1,245408,245408,245409,0,1,3
70113,6,3,245414,245414,245417,0,3,5
70114,5,2,245419,245419,245421,0,2,2
70115,1,2,245420,245421,245423,1,3,0
70116,1,2,245421,245423,245425,2,4,0
70117,6,1,245427,245427,245428,0,1,2
70118,2,3,245429,245429,245432,0,3,1
70119,5,1,245434,245434,245435,0,1,2
70120,2,3,245436,245436,245439,0,3,1
70121,4,1,245440,245440,245441,0,1,1
70122,4,2,245444,245444,245446,0,2,3
70123,6,1,245450,245450,245451,0,1,4
70124,1,3,245451,245451,245454,0,3,0
70125,6,2,245457,245457,245459,0,2,3
70126,6,3,245463,245463,245466,0,3,4
70127,2,3,245465,245466,245469,1,4,0
70128,1,3,245466,245469,245472,3,6,0
70129,2,2,245468,245472,245474,4,6,0
70130,5,3,245473,245474,245477,1,4,0
70131,4,1,245477,245477,245478,0,1,0
70132,4,3,245481,245481,245484,0,3,3
70133,3,1,245484,245484,245485,0,1,0
70134,4,1,245488,245488,245489,0,1,3
70135,6,2,245494,245494,245496,0,2,5
70136,1,3,245495,245496,245499,1,4,0
70137,5,2,245500,245500,245502,0,2,1
70138,2,3,245502,245502,245505,0,3,0
70139,6,1,245508,245508,245509,0,1,3
70140,6,3,245514,245514,245517,0,3,5
70141,2,3,245516,245517,245520,1,4,0
70142,4,2,245520,245520,245522,0,2,0
70143,6,2,245526,245526,245528,0,2,4
70144,5,2,245531,245531,245533,0,2,3
70145,6,1,245537,245537,245538,0,1,4
70146,2,2,245539,245539,245541,0,2,1
70147,6,3,245545,245545,245548,0,3,4
70148,2,3,245547,245548,245551,1,4,0
70149,5,1,245552,245552,245553,0,1,1
70150,4,1,245556,245556,245557,0,1,3
70151,6,1,245562,245562,245563,0,1,5
70152,5,1,245567,245567,245568,0,1,4
70153,6,2,245573,245573,245575,0,2,5
70154,6,2,245579,245579,245581,0,2,4
70155,4,2,245583,245583,245585,0,2,2
70156,3,1,245586,245586,245587,0,1,1
70157,2,1,245588,245588,245589,0,1,1
70158,6,3,245594,245594,245597,0,3,5
70159,6,3,245600,245600,245603,0,3,3
70160,3,1,245603,245603,245604,0,1,0
70161,1,1,245604,245604,245605,0,1,0
70162,1,1,245605,245605,245606,0,1,0
70163,5,1,245610,245610,245611,0,1,4
70164,5,3,245615,245615,245618,0,3,4
70165,5,3,245620,245620,245623,0,3,2
70166,2,2,245622,245623,245625,1,3,0
70167,5,3,245627,245627,245630,0,3,2
70168,4,2,245631,245631,245633,0,2,1
70169,3,1,245634,245634,245635,0,1,1
70170,6,1,245640,245640,245641,0,1,5
70171,5,1,245645,245645,245646,0,1,4
70172,5,3,245650,245650,245653,0,3,4
70173,5,3,245655,245655,245658,0,3,2
70174,3,1,245658,245658,245659,0,1,0
70175,4,2,245662,245662,245664,0,2,3
70176,2,1,245664,245664,245665,0,1,0
70177,1,2,245665,245665,245667,0,2,0
70178,4,2,245669,245669,245671,0,2,2
70179,3,1,245672,245672,245673,0,1,1
70180,1,2,245673,245673,245675,0,2,0
70181,4,3,245677,245677,245680,0,3,2
70182,6,1,245683,245683,245684,0,1,3
70183,2,2,245685,245685,245687,0,2,1
70184,3,2,245688,245688,245690,0,2,1
70185,1,3,245689,245690,245693,1,4,0
70186,2,1,245691,245693,245694,2,3,0
70187,5,1,245696,245696,245697,0,1,2
70188,1,3,245697,245697,245700,0,3,0
70189,3,3,245700,245700,245703,0,3,0
70190,1,3,245701,245703,245706,2,5,0
70191,1,1,245702,245706,245707,4,5,0
70192,2,1,245704,245707,245708,3,4,0
70193,3,3,245707,245708,245711,1,4,0
70194,6,2,245713,245713,245715,0,2,2
70195,1,3,245714,245715,245718,1,4,0
70196,3,2,245717,245718,245720,1,3,0
70197,5,2,245722,245722,245724,0,2,2
70198,5,2,245727,245727,245729,0,2,3
70199,2,3,245729,245729,245732,0,3,0
70200,5,1,245734,245734,245735,0,1,2
70201,2,3,245736,245736,245739,0,3,1
70202,6,1,245742,245742,245743,0,1,3
70203,5,1,245747,245747,245748,0,1,4
70204,5,3,245752,245752,245755,0,3,4
70205,4,1,245756,245756,245757,0,1,1
70206,3,3,245759,245759,245762,0,3,2
70207,1,2,245760,245762,245764,2,4,0
70208,1,3,245761,245764,245767,3,6,0
70209,2,2,245763,245767,245769,4,6,0
70210,1,3,245764,245769,245772,5,8,0
70211,4,1,245768,245772,245773,4,5,0
70212,3,1,245771,245773,245774,2,3,0
70213,4,1,245775,245775,245776,0,1,1
70214,1,3,245776,245776,245779,0,3,0
70215,3,1,245779,245779,245780,0,1,0
70216,2,1,245781,245781,245782,0,1,1
70217,1,2,245782,245782,245784,0,2,0
70218,4,3,245786,245786,245789,0,3,2
70219,2,2,245788,245789,245791,1,3,0
70220,3,3,245791,245791,245794,0,3,0
70221,2,2,245793,245794,245796,1,3,0
70222,1,2,245794,245796,245798,2,4,0
70223,1,2,245795,245798,245800,3,5,0
70224,1,3,245796,245800,245803,4,7,0
70225,4,3,245800,245803,245806,3,6,0
70226,5,1,245805,245806,245807,1,2,0
70227,1,2,245806,245807,245809,1,3,0
70228,6,2,245812,245812,245814,0,2,3
70229,2,3,245814,245814,245817,0,3,0
70230,1,3,245815,245817,245820,2,5,0
70231,1,1,245816,245820,245821,4,5,0
70232,4,1,245820,245821,245822,1,2,0
70233,6,3,245826,245826,245829,0,3,4
70234,4,1,245830,245830,245831,0,1,1
70235,4,1,245834,245834,245835,0,1,3
70236,6,1,245840,245840,245841,0,1,5
70237,6,2,245846,245846,245848,0,2,5
70238,6,3,245852,245852,245855,0,3,4
70239,2,3,245854,245855,245858,1,4,0
70240,6,3,245860,245860,245863,0,3,2
70241,5,3,245865,245865,245868,0,3,2
70242,4,3,245869,245869,245872,0,3,1
70243,5,3,245874,245874,245877,0,3,2
70244,1,1,245875,245877,245878,2,3,0
70245,4,3,245879,245879,245882,0,3,1
70246,5,2,245884,245884,245886,0,2,2
70247,4,1,245888,245888,245889,0,1,2
70248,3,2,245891,245891,245893,0,2,2
70249,6,2,245897,245897,245899,0,2,4
70250,5,1,245902,245902,245903,0,1,3
70251,5,1,245907,245907,245908,0,1,4
70252,2,1,245909,245909,245910,0,1,1
70253,6,2,245915,245915,245917,0,2,5
70254,4,3,245919,245919,245922,0,3,2
70255,6,2,245925,245925,245927,0,2,3
70256,3,1,245928,245928,245929,0,1,1
70257,5,2,245933,245933,245935,0,2,4
70258,4,3,245937,245937,245940,0,3,2
70259,4,1,245941,245941,245942,0,1,1
70260,1,1,245942,245942,245943,0,1,0
70261,3,3,245945,245945,245948,0,3,2
70262,3,3,245948,245948,245951,0,3,0
70263,6,2,245954,245954,245956,0,2,3
70264,3,3,245957,245957,245960,0,3,1
70265,1,1,245958,245960,245961,2,3,0
70266,4,2,245962,245962,245964,0,2,1
70267,3,2,245965,245965,245967,0,2,1
70268,2,2,245967,245967,245969,0,2,0
70269,1,3,245968,245969,245972,1,4,0
70270,4,1,245972,245972,245973,0,1,0
70271,2,1,245974,245974,245975,0,1,1
70272,5,1,245979,245979,245980,0,1,4
70273,4,1,245983,245983,245984,0,1,3
70274,2,3,245985,245985,245988,0,3,1
70275,4,1,245989,245989,245990,0,1,1
70276,1,3,245990,245990,245993,0,3,0
70277,3,3,245993,245993,245996,0,3,0
70278,3,1,245996,245996,245997,0,1,0
70279,5,1,246001,246001,246002,0,1,4
70280,6,3,246007,246007,246010,0,3,5
70281,6,1,246013,246013,246014,0,1,3
70282,3,2,246016,246016,246018,0,2,2
70283,5,2,246021,246021,246023,0,2,3
70284,1,3,246022,246023,246026,1,4,0
70285,6,3,246028,246028,246031,0,3,2
70286,5,2,246033,246033,246035,0,2,2
70287,4,2,246037,246037,246039,0,2,2
70288,2,1,246039,246039,246040,0,1,0
70289,5,3,246044,246044,246047,0,3,4
70290,1,1,246045,246047,246048,2,3,0
70291,1,2,246046,246048,246050,2,4,0
70292,4,3,246050,246050,246053,0,3,0
70293,6,3,246056,246056,246059,0,3,3
70294,6,2,246062,246062,246064,0,2,3
70295,2,2,246064,246064,246066,0,2,0
70296,6,3,246070,246070,246073,0,3,4
70297,1,3,246071,246073,246076,2,5,0
70298,4,3,246075,246076,246079,1,4,0
70299,1,2,246076,246079,246081,3,5,0
70300,3,3,246079,246081,246084,2,5,0
70301,4,1,246083,246084,246085,1,2,0
70302,3,1,246086,246086,246087,0,1,1
70303,4,3,246090,246090,246093,0,3,3
70304,2,2,246092,246093,246095,1,3,0
70305,4,1,246096,246096,246097,0,1,1
70306,5,2,246101,246101,246103,0,2,4
70307,5,1,246106,246106,246107,0,1,3
70308,5,1,246111,246111,246112,0,1,4
70309,5,1,246116,246116,246117,0,1,4
70310,4,2,246120,246120,246122,0,2,3
70311,1,2,246121,246122,246124,1,3,0
70312,6,2,246127,246127,246129,0,2,3
70313,3,1,246130,246130,246131,0,1,1
70314,1,3,246131,246131,246134,0,3,0
70315,5,3,246136,246136,246139,0,3,2
70316,1,3,246137,246139,246142,2,5,0
70317,4,3,246141,246142,246145,1,4,0
70318,6,2,246147,246147,246149,0,2,2
70319,5,3,246152,246152,246155,0,3,3
70320,2,1,246154,246155,246156,1,2,0
70321,5,1,246159,246159,246160,0,1,3
70322,6,1,246165,246165,246166,0,1,5
70323,5,1,246170,246170,246171,0,1,4
70324,3,2,246173,246173,246175,0,2,2
70325,3,1,246176,246176,246177,0,1,1
70326,4,1,246180,246180,246181,0,1,3
70327,1,3,246181,246181,246184,0,3,0
70328,2,3,246183,246184,246187,1,4,0
70329,2,3,246185,246187,246190,2,5,0
70330,4,3,246189,246190,246193,1,4,0
70331,5,2,246194,246194,246196,0,2,1
70332,5,3,246199,246199,246202,0,3,3
70333,2,2,246201,246202,246204,1,3,0
70334,1,3,246202,246204,246207,2,5,0
70335,6,1,246208,246208,246209,0,1,1
70336,2,2,246210,246210,246212,0,2,1
70337,2,1,246212,246212,246213,0,1,0
70338,4,3,246216,246216,246219,0,3,3
70339,1,1,246217,246219,246220,2,3,0
70340,6,1,246223,246223,246224,0,1,3
70341,1,2,246224,246224,246226,0,2,0
70342,4,2,246228,246228,246230,0,2,2
70343,4,2,246232,246232,246234,0,2,2
70344,6,1,246238,246238,246239,0,1,4
70345,6,1,246244,246244,246245,0,1,5
70346,2,2,246246,246246,246248,0,2,1
70347,3,2,246249,246249,246251,0,2,1
70348,1,3,246250,246251,246254,1,4,0
70349,5,1,246255,246255,246256,0,1,1
70350,1,2,246256,246256,246258,0,2,0
70351,6,3,246262,246262,246265,0,3,4
70352,2,2,246264,246265,246267,1,3,0
70353,5,1,246269,246269,246270,0,1,2
70354,3,1,246272,246272,246273,0,1,2
70355,1,2,246273,246273,246275,0,2,0
70356,5,3,246278,246278,246281,0,3,3
70357,5,2,246283,246283,246285,0,2,2
70358,1,2,246284,246285,246287,1,3,0
70359,1,1,246285,246287,246288,2,3,0
70360,6,2,246291,246291,246293,0,2,3
70361,2,1,246293,246293,246294,0,1,0
70362,1,2,246294,246294,246296,0,2,0
70363,2,3,246296,246296,246299,0,3,0
70364,6,3,246302,246302,246305,0,3,3
70365,3,1,246305,246305,246306,0,1,0
70366,2,1,246307,246307,246308,0,1,1
70367,5,2,246312,246312,246314,0,2,4
70368,6,3,246318,246318,246321,0,3,4
70369,2,1,246320,246321,246322,1,2,0
70370,5,1,246325,246325,246326,0,1,3
70371,4,1,246329,246329,246330,0,1,3
70372,3,1,246332,246332,246333,0,1,2
70373,1,1,246333,246333,246334,0,1,0
70374,3,2,246336,246336,246338,0,2,2
70375,2,3,246338,246338,246341,0,3,0
70376,4,2,246342,246342,246344,0,2,1
70377,5,2,246347,246347,246349,0,2,3
70378,6,1,246353,246353,246354,0,1,4
70379,6,3,246359,246359,246362,0,3,5
70380,4,1,246363,246363,246364,0,1,1
70381,4,2,246367,246367,246369,0,2,3
70382,1,2,246368,246369,246371,1,3,0
70383,5,3,246373,246373,246376,0,3,2
70384,5,3,246378,246378,246381,0,3,2
70385,3,3,246381,246381,246384,0,3,0
70386,4,2,246385,246385,246387,0,2,1
70387,1,3,246386,246387,246390,1,4,0
70388,6,2,246392,246392,246394,0,2,2
70389,6,2,246398,246398,246400,0,2,4
70390,6,3,246404,246404,246407,0,3,4
70391,3,1,246407,246407,246408,0,1,0
70392,5,2,246412,246412,246414,0,2,4
70393,2,1,246414,246414,246415,0,1,0
70394,3,2,246417,246417,246419,0,2,2
70395,2,3,246419,246419,246422,0,3,0
70396,1,2,246420,246422,246424,2,4,0
70397,5,3,246425,246425,246428,0,3,1
70398,6,3,246431,246431,246434,0,3,3
70399,3,2,246434,246434,246436,0,2,0
70400,1,1,246435,246436,246437,1,2,0
70401,2,2,246437,246437,246439,0,2,0
70402,5,1,246442,246442,246443,0,1,3
70403,6,3,246448,246448,246451,0,3,5
70404,2,3,246450,246451,246454,1,4,0
70405,5,2,246455,246455,246457,0,2,1
70406,4,2,246459,246459,246461,0,2,2
70407,2,2,246461,246461,246463,0,2,0
70408,5,2,246466,246466,246468,0,2,3
70409,2,2,246468,246468,246470,0,2,0
70410,5,1,246473,246473,246474,0,1,3
70411,3,1,246476,246476,246477,0,1,2
70412,6,2,246482,246482,246484,0,2,5
70413,4,2,246486,246486,246488,0,2,2
70414,3,3,246489,246489,246492,0,3,1
70415,2,3,246491,246492,246495,1,4,0
70416,3,1,246494,246495,246496,1,2,0
70417,4,3,246498,246498,246501,0,3,2
70418,6,2,246504,246504,246506,0,2,3
70419,5,1,246509,246509,246510,0,1,3
70420,1,2,246510,246510,246512,0,2,0
70421,2,3,246512,246512,246515,0,3,0
70422,5,1,246517,246517,246518,0,1,2
70423,4,2,246521,246521,246523,0,2,3
70424,3,2,246524,246524,246526,0,2,1
70425,2,2,246526,246526,246528,0,2,0
70426,4,1,246530,246530,246531,0,1,2
70427,2,2,246532,246532,246534,0,2,1
70428,4,2,246536,246536,246538,0,2,2
70429,6,2,246542,246542,246544,0,2,4
70430,3,3,246545,246545,246548,0,3,1
70431,2,1,246547,246548,246549,1,2,0
70432,6,2,246553,246553,246555,0,2,4
70433,1,2,246554,246555,246557,1,3,0
70434,3,1,246557,246557,246558,0,1,0
70435,1,2,246558,246558,246560,0,2,0
70436,1,1,246559,246560,246561,1,2,0
70437,3,2,246562,246562,246564,0,2,1
70438,3,1,246565,246565,246566,0,1,1
70439,3,3,246568,246568,246571,0,3,2
70440,3,3,246571,246571,246574,0,3,0
70441,6,3,246577,246577,246580,0,3,3
70442,2,1,246579,246580,246581,1,2,0
70443,4,1,246583,246583,246584,0,1,2
70444,5,1,246588,246588,246589,0,1,4
70445,1,3,246589,246589,246592,0,3,0
70446,4,1,246593,246593,246594,0,1,1
70447,6,3,246599,246599,246602,0,3,5
70448,6,1,246605,246605,246606,0,1,3
70449,5,3,246610,246610,246613,0,3,4
70450,1,3,246611,246613,246616,2,5,0
70451,1,1,246612,246616,246617,4,5,0
70452,3,2,246615,246617,246619,2,4,0
70453,5,1,246620,246620,246621,0,1,1
70454,2,2,246622,246622,246624,0,2,1
70455,1,2,246623,246624,246626,1,3,0
70456,4,3,246627,246627,246630,0,3,1
70457,2,1,246629,246630,246631,1,2,0
70458,4,1,246633,246633,246634,0,1,2
70459,2,2,246635,246635,246637,0,2,1
70460,3,2,246638,246638,246640,0,2,1
70461,2,1,246640,246640,246641,0,1,0
70462,1,3,246641,246641,246644,0,3,0
70463,1,2,246642,246644,246646,2,4,0
70464,4,1,246646,246646,246647,0,1,0
70465,2,2,246648,246648,246650,0,2,1
70466,6,2,246654,246654,246656,0,2,4
70467,6,3,246660,246660,246663,0,3,4
70468,6,3,246666,246666,246669,0,3,3
70469,2,3,246668,246669,246672,1,4,0
70470,2,2,246670,246672,246674,2,4,0
70471,6,3,246676,246676,246679,0,3,2
70472,5,3,246681,246681,246684,0,3,2
70473,3,1,246684,246684,246685,0,1,0
70474,1,1,246685,246685,246686,0,1,0
70475,5,2,246690,246690,246692,0,2,4
70476,3,2,246693,246693,246695,0,2,1
70477,5,1,246698,246698,246699,0,1,3
70478,3,1,246701,246701,246702,0,1,2
70479,6,3,246707,246707,246710,0,3,5
70480,3,3,246710,246710,246713,0,3,0
70481,5,1,246715,246715,246716,0,1,2
70482,1,1,246716,246716,246717,0,1,0
70483,3,2,246719,246719,246721,0,2,2
70484,2,1,246721,246721,246722,0,1,0
70485,2,1,246723,246723,246724,0,1,1
70486,1,2,246724,246724,246726,0,2,0
70487,3,2,246727,246727,246729,0,2,1
70488,6,2,246733,246733,246735,0,2,4
70489,2,1,246735,246735,246736,0,1,0
70490,2,2,246737,246737,246739,0,2,1
70491,1,2,246738,246739,246741,1,3,0
70492,1,1,246739,246741,246742,2,3,0
70493,1,3,246740,246742,246745,2,5,0
70494,4,1,246744,246745,246746,1,2,0
70495,2,3,246746,246746,246749,0,3,0
70496,3,1,246749,246749,246750,0,1,0
70497,3,1,246752,246752,246753,0,1,2
70498,1,1,246753,246753,246754,0,1,0
70499,2,1,246755,246755,246756,0,1,1
70500,2,3,246757,246757,246760,0,3,1
70501,6,3,246763,246763,246766,0,3,3
70502,1,1,246764,246766,246767,2,3,0
70503,4,2,246768,246768,246770,0,2,1
70504,3,2,246771,246771,246773,0,2,1
70505,4,2,246775,246775,246777,0,2,2
70506,2,1,246777,246777,246778,0,1,0
70507,1,2,246778,246778,246780,0,2,0
70508,1,1,246779,246780,246781,1,2,0
70509,2,2,246781,246781,246783,0,2,0
70510,6,2,246787,246787,246789,0,2,4
70511,2,2,246789,246789,246791,0,2,0
70512,2,1,246791,246791,246792,0,1,0
70513,2,2,246793,246793,246795,0,2,1
70514,1,1,246794,246795,246796,1,2,0
70515,1,3,246795,246796,246799,1,4,0
70516,2,2,246797,246799,246801,2,4,0
70517,4,1,246801,246801,246802,0,1,0
70518,1,3,246802,246802,246805,0,3,0
70519,6,2,246808,246808,246810,0,2,3
70520,1,2,246809,246810,246812,1,3,0
70521,1,2,246810,246812,246814,2,4,0
70522,4,3,246814,246814,246817,0,3,0
70523,1,1,246815,246817,246818,2,3,0
70524,3,3,246818,246818,246821,0,3,0
70525,4,2,246822,246822,246824,0,2,1
70526,3,1,246825,246825,246826,0,1,1
70527,1,3,246826,246826,246829,0,3,0
70528,5,3,246831,246831,246834,0,3,2
70529,3,3,246834,246834,246837,0,3,0
70530,6,2,246840,246840,246842,0,2,3
70531,4,2,246844,246844,246846,0,2,2
70532,1,3,246845,246846,246849,1,4,0
70533,1,3,246846,246849,246852,3,6,0
70534,2,3,246848,246852,246855,4,7,0
70535,4,3,246852,246855,246858,3,6,0
70536,1,1,246853,246858,246859,5,6,0
70537,6,2,246859,246859,246861,0,2,0
70538,4,1,246863,246863,246864,0,1,2
70539,2,3,246865,246865,246868,0,3,1
70540,5,3,246870,246870,246873,0,3,2
70541,2,3,246872,246873,246876,1,4,0
70542,3,1,246875,246876,246877,1,2,0
70543,2,2,246877,246877,246879,0,2,0
70544,1,2,246878,246879,246881,1,3,0
70545,1,2,246879,246881,246883,2,4,0
70546,6,2,246885,246885,246887,0,2,2
70547,2,1,246887,246887,246888,0,1,0
70548,4,1,246891,246891,246892,0,1,3
70549,2,3,246893,246893,246896,0,3,1
70550,3,1,246896,246896,246897,0,1,0
70551,4,3,246900,246900,246903,0,3,3
70552,2,1,246902,246903,246904,1,2,0
70553,3,2,246905,246905,246907,0,2,1
70554,6,3,246911,246911,246914,0,3,4
70555,1,2,246912,246914,246916,2,4,0
70556,5,3,246917,246917,246920,0,3,1
70557,5,1,246922,246922,246923,0,1,2
70558,1,1,246923,246923,246924,0,1,0
70559,1,1,246924,246924,246925,0,1,0
70560,5,3,246929,246929,246932,0,3,4
70561,3,2,246932,246932,246934,0,2,0
70562,3,2,246935,246935,246937,0,2,1
70563,2,2,246937,246937,246939,0,2,0
70564,1,1,246938,246939,246940,1,2,0
70565,2,2,246940,246940,246942,0,2,0
70566,4,1,246944,246944,246945,0,1,2
70567,2,1,246946,246946,246947,0,1,1
70568,2,1,246948,246948,246949,0,1,1
70569,1,1,246949,246949,246950,0,1,0
70570,2,1,246951,246951,246952,0,1,1
70571,5,2,246956,246956,246958,0,2,4
70572,5,1,246961,246961,246962,0,1,3
70573,1,3,246962,246962,246965,0,3,0
70574,1,1,246963,246965,246966,2,3,0
70575,6,3,246969,246969,246972,0,3,3
70576,1,1,246970,246972,246973,2,3,0
70577,1,1,246971,246973,246974,2,3,0
70578,5,2,246976,246976,246978,0,2,2
70579,6,1,246982,246982,246983,0,1,4
70580,6,1,246988,246988,246989,0,1,5
70581,3,1,246991,246991,246992,0,1,2
70582,4,2,246995,246995,246997,0,2,3
70583,3,2,246998,246998,247000,0,2,1
70584,1,1,246999,247000,247001,1,2,0
70585,5,2,247004,247004,247006,0,2,3
70586,4,2,247008,247008,247010,0,2,2
70587,1,2,247009,247010,247012,1,3,0
70588,4,2,247013,247013,247015,0,2,1
70589,4,3,247017,247017,247020,0,3,2
70590,6,2,247023,247023,247025,0,2,3
70591,2,1,247025,247025,247026,0,1,0
70592,4,2,247029,247029,247031,0,2,3
70593,5,2,247034,247034,247036,0,2,3
70594,3,2,247037,247037,247039,0,2,1
70595,6,2,247043,247043,247045,0,2,4
70596,3,1,247046,247046,247047,0,1,1
70597,3,3,247049,247049,247052,0,3,2
70598,4,2,247053,247053,247055,0,2,1
70599,4,2,247057,247057,247059,0,2,2
70600,1,3,247058,247059,247062,1,4,0
70601,3,2,247061,247062,247064,1,3,0
70602,5,1,247066,247066,247067,0,1,2
70603,6,1,247072,247072,247073,0,1,5
70604,2,1,247074,247074,247075,0,1,1
70605,1,2,247075,247075,247077,0,2,0
70606,3,1,247078,247078,247079,0,1,1
70607,5,3,247083,247083,247086,0,3,4
70608,6,3,247089,247089,247092,0,3,3
70609,5,3,247094,247094,247097,0,3,2
70610,3,3,247097,247097,247100,0,3,0
70611,2,1,247099,247100,247101,1,2,0
70612,1,1,247100,247101,247102,1,2,0
70613,1,1,247101,247102,247103,1,2,0
70614,1,2,247102,247103,247105,1,3,0
70615,5,2,247107,247107,247109,0,2,2
70616,1,1,247108,247109,247110,1,2,0
70617,5,1,247113,247113,247114,0,1,3
70618,2,2,247115,247115,247117,0,2,1
70619,6,2,247121,247121,247123,0,2,4
70620,2,3,247123,247123,247126,0,3,0
70621,4,2,247127,247127,247129,0,2,1
70622,5,3,247132,247132,247135,0,3,3
70623,6,2,247138,247138,247140,0,2,3
70624,4,2,247142,247142,247144,0,2,2
70625,5,2,247147,247147,247149,0,2,3
70626,5,3,247152,247152,247155,0,3,3
70627,1,2,247153,247155,247157,2,4,0
70628,6,2,247159,247159,247161,0,2,2
70629,1,2,247160,247161,247163,1,3,0
70630,3,2,247163,247163,247165,0,2,0
70631,2,3,247165,247165,247168,0,3,0
70632,4,1,247169,247169,247170,0,1,1
70633,4,3,247173,247173,247176,0,3,3
70634,4,2,247177,247177,247179,0,2,1
70635,2,1,247179,247179,247180,0,1,0
70636,1,3,247180,247180,247183,0,3,0
70637,6,1,247186,247186,247187,0,1,3
70638,2,2,247188,247188,247190,0,2,1
70639,6,3,247194,247194,247197,0,3,4
70640,5,2,247199,247199,247201,0,2,2
70641,3,1,247202,247202,247203,0,1,1
70642,2,2,247204,247204,247206,0,2,1
70643,1,2,247205,247206,247208,1,3,0
70644,3,3,247208,247208,247211,0,3,0
70645,6,3,247214,247214,247217,0,3,3
70646,6,1,247220,247220,247221,0,1,3
70647,2,1,247222,247222,247223,0,1,1
70648,6,2,247228,247228,247230,0,2,5
70649,1,1,247229,247230,247231,1,2,0
70650,5,2,247234,247234,247236,0,2,3
70651,5,2,247239,247239,247241,0,2,3
70652,6,3,247245,247245,247248,0,3,4
70653,6,1,247251,247251,247252,0,1,3
70654,3,3,247254,247254,247257,0,3,2
70655,5,1,247259,247259,247260,0,1,2
70656,4,1,247263,247263,247264,0,1,3
70657,4,2,247267,247267,247269,0,2,3
70658,3,2,247270,247270,247272,0,2,1
70659,5,2,247275,247275,247277,0,2,3
70660,6,3,247281,247281,247284,0,3,4
70661,6,2,247287,247287,247289,0,2,3
70662,5,3,247292,247292,247295,0,3,3
70663,5,2,247297,247297,247299,0,2,2
70664,6,1,247303,247303,247304,0,1,4
70665,1,1,247304,247304,247305,0,1,0
70666,4,1,247308,247308,247309,0,1,3
70667,4,2,247312,247312,247314,0,2,3
70668,6,3,247318,247318,247321,0,3,4
70669,6,1,247324,247324,247325,0,1,3
70670,3,2,247327,247327,247329,0,2,2
70671,3,3,247330,247330,247333,0,3,1
70672,1,3,247331,247333,247336,2,5,0
70673,3,3,247334,247336,247339,2,5,0
70674,5,1,247339,247339,247340,0,1,0
70675,2,2,247341,247341,247343,0,2,1
70676,6,1,247347,247347,247348,0,1,4
70677,3,2,247350,247350,247352,0,2,2
70678,3,3,247353,247353,247356,0,3,1
70679,5,3,247358,247358,247361,0,3,2
70680,2,2,247360,247361,247363,1,3,0
70681,5,2,247365,247365,247367,0,2,2
70682,1,3,247366,247367,247370,1,4,0
70683,6,2,247372,247372,247374,0,2,2
70684,4,2,247376,247376,247378,0,2,2
70685,2,2,247378,247378,247380,0,2,0
70686,1,1,247379,247380,247381,1,2,0
70687,1,3,247380,247381,247384,1,4,0
70688,5,1,247385,247385,247386,0,1,1
70689,1,2,247386,247386,247388,0,2,0
70690,3,3,247389,247389,247392,0,3,1
70691,2,3,247391,247392,247395,1,4,0
70692,2,3,247393,247395,247398,2,5,0
70693,6,3,247399,247399,247402,0,3,1
70694,3,1,247402,247402,247403,0,1,0
70695,2,1,247404,247404,247405,0,1,1
70696,3,1,247407,247407,247408,0,1,2
70697,5,1,247412,247412,247413,0,1,4
70698,4,3,247416,247416,247419,0,3,3
70699,5,2,247421,247421,247423,0,2,2
70700,1,3,247422,247423,247426,1,4,0
70701,4,2,247426,247426,247428,0,2,0
70702,6,3,247432,247432,247435,0,3,4
70703,6,1,247438,247438,247439,0,1,3
70704,1,1,247439,247439,247440,0,1,0
70705,6,1,247445,247445,247446,0,1,5
70706,5,3,247450,247450,247453,0,3,4
70707,4,3,247454,247454,247457,0,3,1
70708,1,2,247455,247457,247459,2,4,0
70709,5,3,247460,247460,247463,0,3,1
70710,1,3,247461,247463,247466,2,5,0
70711,4,3,247465,247466,247469,1,4,0
70712,5,3,247470,247470,247473,0,3,1
70713,5,2,247475,247475,247477,0,2,2
70714,2,3,247477,247477,247480,0,3,0
70715,6,3,247483,247483,247486,0,3,3
70716,6,2,247489,247489,247491,0,2,3
70717,6,1,247495,247495,247496,0,1,4
70718,6,2,247501,247501,247503,0,2,5
70719,1,1,247502,247503,247504,1,2,0
70720,5,3,247507,247507,247510,0,3,3
70721,6,2,247513,247513,247515,0,2,3
70722,5,1,247518,247518,247519,0,1,3
70723,4,2,247522,247522,247524,0,2,3
70724,5,3,247527,247527,247530,0,3,3
70725,6,2,247533,247533,247535,0,2,3
70726,2,1,247535,247535,247536,0,1,0
70727,6,2,247541,247541,247543,0,2,5
70728,3,2,247544,247544,247546,0,2,1
70729,1,2,247545,247546,247548,1,3,0
70730,1,2,247546,247548,247550,2,4,0
70731,4,2,247550,247550,247552,0,2,0
70732,1,1,247551,247552,247553,1,2,0
70733,5,2,247556,247556,247558,0,2,3
70734,4,2,247560,247560,247562,0,2,2
70735,6,2,247566,247566,247568,0,2,4
70736,4,2,247570,247570,247572,0,2,2
70737,2,3,247572,247572,247575,0,3,0
70738,2,2,247574,247575,247577,1,3,0
70739,2,3,247576,247577,247580,1,4,0
70740,4,2,247580,247580,247582,0,2,0
70741,3,3,247583,247583,247586,0,3,1
70742,6,1,247589,247589,247590,0,1,3
70743,1,2,247590,247590,247592,0,2,0
70744,4,3,247594,247594,247597,0,3,2
70745,6,1,247600,247600,247601,0,1,3
70746,4,2,247604,247604,247606,0,2,3
70747,4,1,247608,247608,247609,0,1,2
70748,2,3,247610,247610,247613,0,3,1
70749,2,1,247612,247613,247614,1,2,0
70750,4,3,247616,247616,247619,0,3,2
70751,2,2,247618,247619,247621,1,3,0
70752,5,3,247623,247623,247626,0,3,2
70753,4,3,247627,247627,247630,0,3,1
70754,5,1,247632,247632,247633,0,1,2
70755,2,3,247634,247634,247637,0,3,1
70756,6,1,247640,247640,247641,0,1,3
70757,3,3,247643,247643,247646,0,3,2
70758,2,1,247645,247646,247647,1,2,0
70759,6,2,247651,247651,247653,0,2,4
70760,1,2,247652,247653,247655,1,3,0
70761,4,2,247656,247656,247658,0,2,1
70762,2,2,247658,247658,247660,0,2,0
70763,1,3,247659,247660,247663,1,4,0
70764,6,2,247665,247665,247667,0,2,2
70765,1,1,247666,247667,247668,1,2,0
70766,5,1,247671,247671,247672,0,1,3
70767,1,3,247672,247672,247675,0,3,0
70768,4,2,247676,247676,247678,0,2,1
70769,2,2,247678,247678,247680,0,2,0
70770,4,3,247682,247682,247685,0,3,2
70771,1,1,247683,247685,247686,2,3,0
70772,1,3,247684,247686,247689,2,5,0
70773,5,2,247689,247689,247691,0,2,0
70774,4,3,247693,247693,247696,0,3,2
70775,4,3,247697,247697,247700,0,3,1
70776,6,1,247703,247703,247704,0,1,3
70777,4,2,247707,247707,247709,0,2,3
70778,1,3,247708,247709,247712,1,4,0
70779,3,3,247711,247712,247715,1,4,0
70780,3,3,247714,247715,247718,1,4,0
70781,1,1,247715,247718,247719,3,4,0
70782,4,1,247719,247719,247720,0,1,0
70783,6,2,247725,247725,247727,0,2,5
70784,2,1,247727,247727,247728,0,1,0
70785,6,3,247733,247733,247736,0,3,5
70786,1,3,247734,247736,247739,2,5,0
70787,2,3,247736,247739,247742,3,6,0
70788,3,1,247739,247742,247743,3,4,0
70789,1,1,247740,247743,247744,3,4,0
70790,6,3,247746,247746,247749,0,3,2
70791,1,1,247747,247749,247750,2,3,0
70792,2,2,247749,247750,247752,1,3,0
70793,4,2,247753,247753,247755,0,2,1
70794,5,1,247758,247758,247759,0,1,3
70795,3,3,247761,247761,247764,0,3,2
70796,4,2,247765,247765,247767,0,2,1
70797,5,2,247770,247770,247772,0,2,3
70798,6,1,247776,247776,247777,0,1,4
70799,6,1,247782,247782,247783,0,1,5
70800,6,3,247788,247788,247791,0,3,5
70801,6,1,247794,247794,247795,0,1,3
70802,1,3,247795,247795,247798,0,3,0
70803,6,2,247801,247801,247803,0,2,3
70804,1,2,247802,247803,247805,1,3,0
70805,3,1,247805,247805,247806,0,1,0
70806,4,2,247809,247809,247811,0,2,3
70807,2,3,247811,247811,247814,0,3,0
70808,6,3,247817,247817,247820,0,3,3
70809,3,2,247820,247820,247822,0,2,0
70810,4,2,247824,247824,247826,0,2,2
70811,6,2,247830,247830,247832,0,2,4
70812,2,1,247832,247832,247833,0,1,0
70813,5,2,247837,247837,247839,0,2,4
70814,1,1,247838,247839,247840,1,2,0
70815,6,1,247844,247844,247845,0,1,4
70816,6,1,247850,247850,247851,0,1,5
70817,4,3,247854,247854,247857,0,3,3
70818,5,1,247859,247859,247860,0,1,2
70819,2,2,247861,247861,247863,0,2,1
70820,4,1,247865,247865,247866,0,1,2
70821,3,1,247868,247868,247869,0,1,2
70822,2,3,247870,247870,247873,0,3,1
70823,1,2,247871,247873,247875,2,4,0
70824,5,1,247876,247876,247877,0,1,1
70825,4,2,247880,247880,247882,0,2,3
70826,1,1,247881,247882,247883,1,2,0
70827,1,3,247882,247883,247886,1,4,0
70828,1,2,247883,247886,247888,3,5,0
70829,4,3,247887,247888,247891,1,4,0
70830,2,2,247889,247891,247893,2,4,0
70831,5,2,247894,247894,247896,0,2,1
70832,1,2,247895,247896,247898,1,3,0
70833,5,1,247900,247900,247901,0,1,2
70834,1,2,247901,247901,247903,0,2,0
70835,3,2,247904,247904,247906,0,2,1
70836,5,2,247909,247909,247911,0,2,3
70837,3,1,247912,247912,247913,0,1,1
70838,2,1,247914,247914,247915,0,1,1
70839,3,2,247917,247917,247919,0,2,2
70840,1,3,247918,247919,247922,1,4,0
70841,1,1,247919,247922,247923,3,4,0
70842,6,1,247925,247925,247926,0,1,2
70843,6,2,247931,247931,247933,0,2,5
70844,1,2,247932,247933,247935,1,3,0
70845,5,2,247937,247937,247939,0,2,2
70846,1,1,247938,247939,247940,1,2,0
70847,4,1,247942,247942,247943,0,1,2
70848,2,1,247944,247944,247945,0,1,1
70849,1,2,247945,247945,247947,0,2,0
70850,1,2,247946,247947,247949,1,3,0
70851,1,2,247947,247949,247951,2,4,0
70852,3,2,247950,247951,247953,1,3,0
70853,1,1,247951,247953,247954,2,3,0
70854,2,1,247953,247954,247955,1,2,0
70855,1,3,247954,247955,247958,1,4,0
70856,1,2,247955,247958,247960,3,5,0
70857,1,2,247956,247960,247962,4,6,0
70858,4,2,247960,247962,247964,2,4,0
70859,4,1,247964,247964,247965,0,1,0
70860,5,1,247969,247969,247970,0,1,4
70861,6,1,247975,247975,247976,0,1,5
70862,6,1,247981,247981,247982,0,1,5
70863,6,2,247987,247987,247989,0,2,5
70864,4,2,247991,247991,247993,0,2,2
70865,2,1,247993,247993,247994,0,1,0
70866,4,1,247997,247997,247998,0,1,3
70867,4,1,248001,248001,248002,0,1,3
70868,4,2,248005,248005,248007,0,2,3
70869,4,1,248009,248009,248010,0,1,2
70870,3,1,248012,248012,248013,0,1,2
70871,6,2,248018,248018,248020,0,2,5
70872,2,1,248020,248020,248021,0,1,0
70873,5,1,248025,248025,248026,0,1,4
70874,3,3,248028,248028,248031,0,3,2
70875,5,3,248033,248033,248036,0,3,2
70876,5,3,248038,248038,248041,0,3,2
70877,4,3,248042,248042,248045,0,3,1
70878,4,1,248046,248046,248047,0,1,1
70879,1,3,248047,248047,248050,0,3,0
70880,6,2,248053,248053,248055,0,2,3
70881,3,1,248056,248056,248057,0,1,1
70882,2,2,248058,248058,248060,0,2,1
70883,3,1,248061,248061,248062,0,1,1
70884,4,1,248065,248065,248066,0,1,3
70885,6,2,248071,248071,248073,0,2,5
70886,4,3,248075,248075,248078,0,3,2
70887,6,3,248081,248081,248084,0,3,3
70888,4,2,248085,248085,248087,0,2,1
70889,6,2,248091,248091,248093,0,2,4
70890,2,2,248093,248093,248095,0,2,0
70891,6,3,248099,248099,248102,0,3,4
70892,2,2,248101,248102,248104,1,3,0
70893,5,1,248106,248106,248107,0,1,2
70894,4,2,248110,248110,248112,0,2,3
70895,2,2,248112,248112,248114,0,2,0
70896,2,3,248114,248114,248117,0,3,0
70897,3,3,248117,248117,248120,0,3,0
70898,5,1,248122,248122,248123,0,1,2
70899,3,1,248125,248125,248126,0,1,2
70900,4,3,248129,248129,248132,0,3,3
70901,4,1,248133,248133,248134,0,1,1
70902,3,3,248136,248136,248139,0,3,2
70903,2,1,248138,248139,248140,1,2,0
70904,4,1,248142,248142,248143,0,1,2
70905,6,3,248148,248148,248151,0,3,5
70906,3,3,248151,248151,248154,0,3,0
70907,4,1,248155,248155,248156,0,1,1
70908,2,2,248157,248157,248159,0,2,1
70909,4,2,248161,248161,248163,0,2,2
70910,3,1,248164,248164,248165,0,1,1
70911,6,3,248170,248170,248173,0,3,5
70912,1,2,248171,248173,248175,2,4,0
70913,2,2,248173,248175,248177,2,4,0
70914,1,2,248174,248177,248179,3,5,0
70915,2,3,248176,248179,248182,3,6,0
70916,5,1,248181,248182,248183,1,2,0
70917,2,3,248183,248183,248186,0,3,0
70918,2,1,248185,248186,248187,1,2,0
70919,3,2,248188,248188,248190,0,2,1
70920,6,3,248194,248194,248197,0,3,4
70921,1,1,248195,248197,248198,2,3,0
70922,3,3,248198,248198,248201,0,3,0
70923,1,3,248199,248201,248204,2,5,0
70924,3,1,248202,248204,248205,2,3,0
70925,4,2,248206,248206,248208,0,2,1
70926,1,1,248207,248208,248209,1,2,0
70927,5,3,248212,248212,248215,0,3,3
70928,5,3,248217,248217,248220,0,3,2
70929,6,3,248223,248223,248226,0,3,3
70930,1,1,248224,248226,248227,2,3,0
70931,3,3,248227,248227,248230,0,3,0
70932,2,2,248229,248230,248232,1,3,0
70933,5,1,248234,248234,248235,0,1,2
70934,1,3,248235,248235,248238,0,3,0
70935,3,1,248238,248238,248239,0,1,0
70936,6,2,248244,248244,248246,0,2,5
70937,4,1,248248,248248,248249,0,1,2
70938,1,1,248249,248249,248250,0,1,0
70939,3,2,248252,248252,248254,0,2,2
70940,3,2,248255,248255,248257,0,2,1
70941,1,2,248256,248257,248259,1,3,0
70942,2,3,248258,248259,248262,1,4,0
70943,3,1,248261,248262,248263,1,2,0
70944,1,1,248262,248263,248264,1,2,0
70945,4,2,248266,248266,248268,0,2,2
70946,6,2,248272,248272,248274,0,2,4
70947,1,2,248273,248274,248276,1,3,0
70948,4,2,248277,248277,248279,0,2,1
70949,6,2,248283,248283,248285,0,2,4
70950,3,3,248286,248286,248289,0,3,1
70951,6,2,248292,248292,248294,0,2,3
70952,1,3,248293,248294,248297,1,4,0
70953,6,2,248299,248299,248301,0,2,2
70954,1,1,248300,248301,248302,1,2,0
70955,2,1,248302,248302,248303,0,1,0
70956,5,3,248307,248307,248310,0,3,4
70957,6,1,248313,248313,248314,0,1,3
70958,4,1,248317,248317,248318,0,1,3
70959,3,3,248320,248320,248323,0,3,2
70960,6,1,248326,248326,248327,0,1,3
70961,2,2,248328,248328,248330,0,2,1
70962,4,1,248332,248332,248333,0,1,2
70963,3,1,248335,248335,248336,0,1,2
70964,1,1,248336,248336,248337,0,1,0
70965,2,2,248338,248338,248340,0,2,1
70966,2,3,248340,248340,248343,0,3,0
70967,2,3,248342,248343,248346,1,4,0
70968,1,2,248343,248346,248348,3,5,0
70969,3,2,248346,248348,248350,2,4,0
70970,5,3,248351,248351,248354,0,3,1
70971,4,3,248355,248355,248358,0,3,1
70972,2,1,248357,248358,248359,1,2,0
70973,5,2,248362,248362,248364,0,2,3
70974,5,2,248367,248367,248369,0,2,3
70975,5,3,248372,248372,248375,0,3,3
70976,4,2,248376,248376,248378,0,2,1
70977,3,3,248379,248379,248382,0,3,1
70978,3,2,248382,248382,248384,0,2,0
70979,5,1,248387,248387,248388,0,1,3
70980,5,3,248392,248392,248395,0,3,4
70981,3,3,248395,248395,248398,0,3,0
70982,4,1,248399,248399,248400,0,1,1
70983,6,1,248405,248405,248406,0,1,5
70984,1,1,248406,248406,248407,0,1,0
70985,1,2,248407,248407,248409,0,2,0
70986,6,3,248413,248413,248416,0,3,4
70987,4,2,248417,248417,248419,0,2,1
70988,6,3,248423,248423,248426,0,3,4
70989,3,1,248426,248426,248427,0,1,0
70990,3,2,248429,248429,248431,0,2,2
70991,5,1,248434,248434,248435,0,1,3
70992,6,3,248440,248440,248443,0,3,5
70993,4,2,248444,248444,248446,0,2,1
70994,2,3,248446,248446,248449,0,3,0
70995,5,1,248451,248451,248452,0,1,2
70996,4,3,248455,248455,248458,0,3,3
70997,6,3,248461,248461,248464,0,3,3
70998,2,1,248463,248464,248465,1,2,0
70999,2,1,248465,248465,248466,0,1,0
71000,1,2,248466,248466,248468,0,2,0
71001,3,1,248469,248469,248470,0,1,1
71002,2,2,248471,248471,248473,0,2,1
71003,4,1,248475,248475,248476,0,1,2
71004,2,3,248477,248477,248480,0,3,1
71005,5,1,248482,248482,248483,0,1,2
71006,3,1,248485,248485,248486,0,1,2
71007,3,3,248488,248488,248491,0,3,2
71008,1,2,248489,248491,248493,2,4,0
71009,4,2,248493,248493,248495,0,2,0
71010,4,1,248497,248497,248498,0,1,2
71011,2,3,248499,248499,248502,0,3,1
71012,3,3,248502,248502,248505,0,3,0
71013,6,3,248508,248508,248511,0,3,3
71014,5,3,248513,248513,248516,0,3,2
71015,1,1,248514,248516,248517,2,3,0
71016,2,3,248516,248517,248520,1,4,0
71017,6,3,248522,248522,248525,0,3,2
71018,1,3,248523,248525,248528,2,5,0
71019,6,3,248529,248529,248532,0,3,1
71020,2,3,248531,248532,248535,1,4,0
71021,6,2,248537,248537,248539,0,2,2
71022,3,1,248540,248540,248541,0,1,1
71023,3,3,248543,248543,248546,0,3,2
71024,2,3,248545,248546,248549,1,4,0
71025,1,2,248546,248549,248551,3,5,0
71026,1,1,248547,248551,248552,4,5,0
71027,6,3,248553,248553,248556,0,3,1
71028,3,1,248556,248556,248557,0,1,0
71029,6,2,248562,248562,248564,0,2,5
71030,5,2,248567,248567,248569,0,2,3
71031,4,1,248571,248571,248572,0,1,2
71032,2,3,248573,248573,248576,0,3,1
71033,4,3,248577,248577,248580,0,3,1
71034,3,1,248580,248580,248581,0,1,0
71035,1,1,248581,248581,248582,0,1,0
71036,3,3,248584,248584,248587,0,3,2
71037,2,1,248586,248587,248588,1,2,0
71038,5,1,248591,248591,248592,0,1,3
71039,6,3,248597,248597,248600,0,3,5
71040,2,2,248599,248600,248602,1,3,0
71041,2,3,248601,248602,248605,1,4,0
71042,6,2,248607,248607,248609,0,2,2
71043,6,1,248613,248613,248614,0,1,4
71044,5,1,248618,248618,248619,0,1,4
71045,4,1,248622,248622,248623,0,1,3
71046,6,2,248628,248628,248630,0,2,5
71047,6,3,248634,248634,248637,0,3,4
71048,6,2,248640,248640,248642,0,2,3
71049,1,1,248641,248642,248643,1,2,0
71050,4,1,248645,248645,248646,0,1,2
71051,3,3,248648,248648,248651,0,3,2
71052,3,2,248651,248651,248653,0,2,0
71053,1,3,248652,248653,248656,1,4,0
71054,2,1,248654,248656,248657,2,3,0
71055,4,1,248658,248658,248659,0,1,1
71056,2,1,248660,248660,248661,0,1,1
71057,6,2,248666,248666,248668,0,2,5
71058,1,3,248667,248668,248671,1,4,0
71059,4,3,248671,248671,248674,0,3,0
71060,6,1,248677,248677,248678,0,1,3
71061,6,3,248683,248683,248686,0,3,5
71062,1,1,248684,248686,248687,2,3,0
71063,4,1,248688,248688,248689,0,1,1
71064,1,1,248689,248689,248690,0,1,0
71065,6,3,248695,248695,248698,0,3,5
71066,6,2,248701,248701,248703,0,2,3
71067,2,2,248703,248703,248705,0,2,0
71068,5,3,248708,248708,248711,0,3,3
71069,1,2,248709,248711,248713,2,4,0
71070,5,1,248714,248714,248715,0,1,1
71071,5,3,248719,248719,248722,0,3,4
71072,4,3,248723,248723,248726,0,3,1
71073,2,1,248725,248726,248727,1,2,0
71074,3,2,248728,248728,248730,0,2,1
71075,1,3,248729,248730,248733,1,4,0
71076,3,2,248732,248733,248735,1,3,0
71077,5,1,248737,248737,248738,0,1,2
71078,2,3,248739,248739,248742,0,3,1
71079,6,2,248745,248745,248747,0,2,3
71080,1,2,248746,248747,248749,1,3,0
71081,5,2,248751,248751,248753,0,2,2
71082,2,3,248753,248753,248756,0,3,0
71083,6,2,248759,248759,248761,0,2,3
71084,2,3,248761,248761,248764,0,3,0
71085,4,3,248765,248765,248768,0,3,1
71086,5,2,248770,248770,248772,0,2,2
71087,5,1,248775,248775,248776,0,1,3
71088,6,3,248781,248781,248784,0,3,5
71089,3,1,248784,248784,248785,0,1,0
71090,6,1,248790,248790,248791,0,1,5
71091,1,3,248791,248791,248794,0,3,0
71092,3,3,248794,248794,248797,0,3,0
71093,1,1,248795,248797,248798,2,3,0
71094,3,3,248798,248798,248801,0,3,0
71095,3,3,248801,248801,248804,0,3,0
71096,1,3,248802,248804,248807,2,5,0
71097,3,3,248805,248807,248810,2,5,0
71098,5,1,248810,248810,248811,0,1,0
71099,1,2,248811,248811,248813,0,2,0
71100,3,2,248814,248814,248816,0,2,1
71101,6,1,248820,248820,248821,0,1,4
71102,3,3,248823,248823,248826,0,3,2
71103,1,3,248824,248826,248829,2,5,0
71104,1,1,248825,248829,248830,4,5,0
71105,2,2,248827,248830,248832,3,5,0
71106,1,2,248828,248832,248834,4,6,0
71107,1,2,248829,248834,248836,5,7,0
71108,1,1,248830,248836,248837,6,7,0
71109,5,1,248835,248837,248838,2,3,0
71110,4,2,248839,248839,248841,0,2,1
71111,2,1,248841,248841,248842,0,1,0
71112,4,2,248845,248845,248847,0,2,3
71113,6,1,248851,248851,248852,0,1,4
71114,5,2,248856,248856,248858,0,2,4
71115,6,3,248862,248862,248865,0,3,4
71116,2,1,248864,248865,248866,1,2,0
71117,5,3,248869,248869,248872,0,3,3
71118,5,3,248874,248874,248877,0,3,2
71119,5,1,248879,248879,248880,0,1,2
71120,5,3,248884,248884,248887,0,3,4
71121,1,2,248885,248887,248889,2,4,0
71122,4,1,248889,248889,248890,0,1,0
71123,6,1,248895,248895,248896,0,1,5
71124,2,3,248897,248897,248900,0,3,1
71125,1,2,248898,248900,248902,2,4,0
71126,5,1,248903,248903,248904,0,1,1
71127,3,3,248906,248906,248909,0,3,2
71128,2,1,248908,248909,248910,1,2,0
71129,5,3,248913,248913,248916,0,3,3
71130,6,2,248919,248919,248921,0,2,3
71131,1,3,248920,248921,248924,1,4,0
71132,6,2,248926,248926,248928,0,2,2
71133,2,3,248928,248928,248931,0,3,0
71134,2,2,248930,248931,248933,1,3,0
71135,4,1,248934,248934,248935,0,1,1
71136,2,2,248936,248936,248938,0,2,1
71137,1,1,248937,248938,248939,1,2,0
71138,5,3,248942,248942,248945,0,3,3
71139,1,3,248943,248945,248948,2,5,0
71140,5,3,248948,248948,248951,0,3,0
71141,3,3,248951,248951,248954,0,3,0
71142,5,1,248956,248956,248957,0,1,2
71143,1,3,248957,248957,248960,0,3,0
71144,2,2,248959,248960,248962,1,3,0
71145,3,1,248962,248962,248963,0,1,0
71146,3,1,248965,248965,248966,0,1,2
71147,5,3,248970,248970,248973,0,3,4
71148,1,1,248971,248973,248974,2,3,0
71149,2,1,248973,248974,248975,1,2,0
71150,5,3,248978,248978,248981,0,3,3
71151,6,3,248984,248984,248987,0,3,3
71152,3,2,248987,248987,248989,0,2,0
71153,2,1,248989,248989,248990,0,1,0
71154,5,1,248994,248994,248995,0,1,4
71155,3,3,248997,248997,249000,0,3,2
71156,6,1,249003,249003,249004,0,1,3
71157,5,1,249008,249008,249009,0,1,4
71158,5,1,249013,249013,249014,0,1,4
71159,4,1,249017,249017,249018,0,1,3
71160,5,2,249022,249022,249024,0,2,4
71161,3,3,249025,249025,249028,0,3,1
71162,2,2,249027,249028,249030,1,3,0
71163,2,2,249029,249030,249032,1,3,0
71164,4,3,249033,249033,249036,0,3,1
71165,5,2,249038,249038,249040,0,2,2
71166,3,1,249041,249041,249042,0,1,1
71167,6,2,249047,249047,249049,0,2,5
71168,3,3,249050,249050,249053,0,3,1
71169,4,3,249054,249054,249057,0,3,1
71170,5,2,249059,249059,249061,0,2,2
71171,2,3,249061,249061,249064,0,3,0
71172,6,3,249067,249067,249070,0,3,3
71173,3,2,249070,249070,249072,0,2,0
71174,4,3,249074,249074,249077,0,3,2
71175,5,2,249079,249079,249081,0,2,2
71176,2,2,249081,249081,249083,0,2,0
71177,1,3,249082,249083,249086,1,4,0
71178,3,1,249085,249086,249087,1,2,0
71179,1,3,249086,249087,249090,1,4,0
71180,4,3,249090,249090,249093,0,3,0
71181,3,1,249093,249093,249094,0,1,0
71182,3,2,249096,249096,249098,0,2,2
71183,3,1,249099,249099,249100,0,1,1
71184,6,2,249105,249105,249107,0,2,5
71185,1,2,249106,249107,249109,1,3,0
71186,6,3,249112,249112,249115,0,3,3
71187,4,2,249116,249116,249118,0,2,1
71188,4,3,249120,249120,249123,0,3,2
71189,4,3,249124,249124,249127,0,3,1
71190,1,3,249125,249127,249130,2,5,0
71191,1,3,249126,249130,249133,4,7,0
71192,1,2,249127,249133,249135,6,8,0
71193,4,2,249131,249135,249137,4,6,0
71194,3,3,249134,249137,249140,3,6,0
71195,6,1,249140,249140,249141,0,1,0
71196,2,1,249142,249142,249143,0,1,1
71197,4,2,249146,249146,249148,0,2,3
71198,1,2,249147,249148,249150,1,3,0
71199,2,1,249149,249150,249151,1,2,0
71200,1,3,249150,249151,249154,1,4,0
71201,1,2,249151,249154,249156,3,5,0
71202,5,2,249156,249156,249158,0,2,0
71203,2,3,249158,249158,249161,0,3,0
71204,1,2,249159,249161,249163,2,4,0
71205,5,3,249164,249164,249167,0,3,1
71206,3,1,249167,249167,249168,0,1,0
71207,4,3,249171,249171,249174,0,3,3
71208,4,3,249175,249175,249178,0,3,1
71209,6,1,249181,249181,249182,0,1,3
71210,4,2,249185,249185,249187,0,2,3
71211,3,3,249188,249188,249191,0,3,1
71212,5,1,249193,249193,249194,0,1,2
71213,6,1,249199,249199,249200,0,1,5
71214,1,2,249200,249200,249202,0,2,0
71215,4,3,249204,249204,249207,0,3,2
71216,6,1,249210,249210,249211,0,1,3
71217,3,1,249213,249213,249214,0,1,2
71218,4,1,249217,249217,249218,0,1,3
71219,3,3,249220,249220,249223,0,3,2
71220,3,3,249223,249223,249226,0,3,0
71221,1,2,249224,249226,249228,2,4,0
71222,6,1,249230,249230,249231,0,1,2
71223,4,1,249234,249234,249235,0,1,3
71224,6,3,249240,249240,249243,0,3,5
71225,1,1,249241,249243,249244,2,3,0
71226,2,3,249243,249244,249247,1,4,0
71227,2,1,249245,249247,249248,2,3,0
71228,6,2,249251,249251,249253,0,2,3
71229,3,2,249254,249254,249256,0,2,1
71230,4,2,249258,249258,249260,0,2,2
71231,6,3,249264,249264,249267,0,3,4
71232,5,2,249269,249269,249271,0,2,2
71233,5,3,249274,249274,249277,0,3,3
71234,1,1,249275,249277,249278,2,3,0
71235,3,3,249278,249278,249281,0,3,0
71236,2,2,249280,249281,249283,1,3,0
71237,3,2,249283,249283,249285,0,2,0
71238,1,1,249284,249285,249286,1,2,0
71239,3,2,249287,249287,249289,0,2,1
71240,6,3,249293,249293,249296,0,3,4
71241,3,1,249296,249296,249297,0,1,0
71242,2,1,249298,249298,249299,0,1,1
71243,2,1,249300,249300,249301,0,1,1
71244,3,3,249303,249303,249306,0,3,2
71245,2,3,249305,249306,249309,1,4,0
71246,2,3,249307,249309,249312,2,5,0
71247,6,3,249313,249313,249316,0,3,1
71248,3,3,249316,249316,249319,0,3,0
71249,1,2,249317,249319,249321,2,4,0
71250,5,1,249322,249322,249323,0,1,1
71251,5,2,249327,249327,249329,0,2,4
71252,4,2,249331,249331,249333,0,2,2
71253,5,3,249336,249336,249339,0,3,3
71254,1,3,249337,249339,249342,2,5,0
71255,4,2,249341,249342,249344,1,3,0
71256,5,3,249346,249346,249349,0,3,2
71257,3,2,249349,249349,249351,0,2,0
71258,1,1,249350,249351,249352,1,2,0
71259,2,2,249352,249352,249354,0,2,0
71260,2,2,249354,249354,249356,0,2,0
71261,4,1,249358,249358,249359,0,1,2
71262,1,3,249359,249359,249362,0,3,0
71263,1,1,249360,249362,249363,2,3,0
71264,3,3,249363,249363,249366,0,3,0
71265,3,3,249366,249366,249369,0,3,0
71266,5,3,249371,249371,249374,0,3,2
71267,6,1,249377,249377,249378,0,1,3
71268,3,3,249380,249380,249383,0,3,2
71269,5,1,249385,249385,249386,0,1,2
71270,3,2,249388,249388,249390,0,2,2
71271,1,3,249389,249390,249393,1,4,0
71272,1,2,249390,249393,249395,3,5,0
71273,1,3,249391,249395,249398,4,7,0
71274,5,3,249396,249398,249401,2,5,0
71275,5,3,249401,249401,249404,0,3,0
71276,2,1,249403,249404,249405,1,2,0
71277,1,2,249404,249405,249407,1,3,0
71278,5,2,249409,249409,249411,0,2,2
71279,6,3,249415,249415,249418,0,3,4
71280,6,2,249421,249421,249423,0,2,3
71281,6,2,249427,249427,249429,0,2,4
71282,6,1,249433,249433,249434,0,1,4
71283,6,1,249439,249439,249440,0,1,5
71284,2,1,249441,249441,249442,0,1,1
71285,1,2,249442,249442,249444,0,2,0
71286,1,2,249443,249444,249446,1,3,0
71287,2,1,249445,249446,249447,1,2,0
71288,4,2,249449,249449,249451,0,2,2
71289,4,2,249453,249453,249455,0,2,2
71290,5,2,249458,249458,249460,0,2,3
71291,6,2,249464,249464,249466,0,2,4
71292,5,3,249469,249469,249472,0,3,3
71293,6,2,249475,249475,249477,0,2,3
71294,1,2,249476,249477,249479,1,3,0
71295,5,1,249481,249481,249482,0,1,2
71296,6,3,249487,249487,249490,0,3,5
71297,2,2,249489,249490,249492,1,3,0
71298,5,2,249494,249494,249496,0,2,2
71299,1,2,249495,249496,249498,1,3,0
71300,5,1,249500,249500,249501,0,1,2
71301,2,3,249502,249502,249505,0,3,1
71302,6,2,249508,249508,249510,0,2,3
71303,5,3,249513,249513,249516,0,3,3
71304,3,3,249516,249516,249519,0,3,0
71305,4,1,249520,249520,249521,0,1,1
71306,2,2,249522,249522,249524,0,2,1
71307,4,1,249526,249526,249527,0,1,2
71308,6,3,249532,249532,249535,0,3,5
71309,4,2,249536,249536,249538,0,2,1
71310,1,3,249537,249538,249541,1,4,0
71311,1,3,249538,249541,249544,3,6,0
71312,4,1,249542,249544,249545,2,3,0
71313,6,1,249548,249548,249549,0,1,3
71314,3,1,249551,249551,249552,0,1,2
71315,6,1,249557,249557,249558,0,1,5
71316,6,2,249563,249563,249565,0,2,5
71317,4,2,249567,249567,249569,0,2,2
71318,1,2,249568,249569,249571,1,3,0
71319,5,2,249573,249573,249575,0,2,2
71320,5,3,249578,249578,249581,0,3,3
71321,6,1,249584,249584,249585,0,1,3
71322,4,2,249588,249588,249590,0,2,3
71323,3,2,249591,249591,249593,0,2,1
71324,2,2,249593,249593,249595,0,2,0
71325,1,2,249594,249595,249597,1,3,0
71326,4,1,249598,249598,249599,0,1,1
71327,4,2,249602,249602,249604,0,2,3
71328,5,2,249607,249607,249609,0,2,3
71329,4,3,249611,249611,249614,0,3,2
71330,6,3,249617,249617,249620,0,3,3
71331,5,2,249622,249622,249624,0,2,2
71332,6,2,249628,249628,249630,0,2,4
71333,6,1,249634,249634,249635,0,1,4
71334,1,2,249635,249635,249637,0,2,0
71335,3,3,249638,249638,249641,0,3,1
71336,2,3,249640,249641,249644,1,4,0
71337,6,1,249646,249646,249647,0,1,2
71338,1,2,249647,249647,249649,0,2,0
71339,6,1,249653,249653,249654,0,1,4
71340,1,2,249654,249654,249656,0,2,0
71341,1,2,249655,249656,249658,1,3,0
71342,2,1,249657,249658,249659,1,2,0
71343,1,2,249658,249659,249661,1,3,0
71344,3,2,249661,249661,249663,0,2,0
71345,3,2,249664,249664,249666,0,2,1
71346,1,3,249665,249666,249669,1,4,0
71347,3,2,249668,249669,249671,1,3,0
71348,5,3,249673,249673,249676,0,3,2
71349,3,2,249676,249676,249678,0,2,0
71350,6,1,249682,249682,249683,0,1,4
71351,3,2,249685,249685,249687,0,2,2
71352,3,2,249688,249688,249690,0,2,1
71353,6,2,249694,249694,249696,0,2,4
71354,5,3,249699,249699,249702,0,3,3
71355,3,2,249702,249702,249704,0,2,0
71356,4,1,249706,249706,249707,0,1,2
71357,3,2,249709,249709,249711,0,2,2
71358,1,2,249710,249711,249713,1,3,0
71359,3,1,249713,249713,249714,0,1,0
71360,2,2,249715,249715,249717,0,2,1
71361,5,3,249720,249720,249723,0,3,3
71362,1,3,249721,249723,249726,2,5,0
71363,3,2,249724,249726,249728,2,4,0
71364,2,1,249726,249728,249729,2,3,0
71365,1,2,249727,249729,249731,2,4,0
71366,2,1,249729,249731,249732,2,3,0
71367,6,3,249735,249735,249738,0,3,3
71368,5,2,249740,249740,249742,0,2,2
71369,4,1,249744,249744,249745,0,1,2
71370,4,3,249748,249748,249751,0,3,3
71371,6,3,249754,249754,249757,0,3,3
71372,5,2,249759,249759,249761,0,2,2
71373,3,2,249762,249762,249764,0,2,1
71374,2,1,249764,249764,249765,0,1,0
71375,5,1,249769,249769,249770,0,1,4
71376,1,2,249770,249770,249772,0,2,0
71377,4,3,249774,249774,249777,0,3,2
71378,2,1,249776,249777,249778,1,2,0
71379,3,3,249779,249779,249782,0,3,1
71380,1,1,249780,249782,249783,2,3,0
71381,5,1,249785,249785,249786,0,1,2
71382,1,2,249786,249786,249788,0,2,0
71383,6,1,249792,249792,249793,0,1,4
71384,1,3,249793,249793,249796,0,3,0
71385,3,2,249796,249796,249798,0,2,0
71386,1,1,249797,249798,249799,1,2,0
71387,6,1,249803,249803,249804,0,1,4
71388,3,3,249806,249806,249809,0,3,2
71389,5,3,249811,249811,249814,0,3,2
71390,6,2,249817,249817,249819,0,2,3
71391,6,2,249823,249823,249825,0,2,4
71392,5,3,249828,249828,249831,0,3,3
71393,5,3,249833,249833,249836,0,3,2
71394,4,3,249837,249837,249840,0,3,1
71395,5,3,249842,249842,249845,0,3,2
71396,4,2,249846,249846,249848,0,2,1
71397,4,1,249850,249850,249851,0,1,2
71398,2,2,249852,249852,249854,0,2,1
71399,5,1,249857,249857,249858,0,1,3
71400,2,2,249859,249859,249861,0,2,1
71401,3,2,249862,249862,249864,0,2,1
71402,4,1,249866,249866,249867,0,1,2
71403,4,2,249870,249870,249872,0,2,3
71404,4,3,249874,249874,249877,0,3,2
71405,2,2,249876,249877,249879,1,3,0
71406,2,1,249878,249879,249880,1,2,0
71407,6,2,249884,249884,249886,0,2,4
71408,3,2,249887,249887,249889,0,2,1
71409,6,2,249893,249893,249895,0,2,4
71410,4,2,249897,249897,249899,0,2,2
71411,1,2,249898,249899,249901,1,3,0
71412,6,1,249904,249904,249905,0,1,3
71413,6,1,249910,249910,249911,0,1,5
71414,1,3,249911,249911,249914,0,3,0
71415,4,3,249915,249915,249918,0,3,1
71416,2,1,249917,249918,249919,1,2,0
71417,5,1,249922,249922,249923,0,1,3
71418,3,3,249925,249925,249928,0,3,2
71419,6,3,249931,249931,249934,0,3,3
71420,5,3,249936,249936,249939,0,3,2
71421,6,3,249942,249942,249945,0,3,3
71422,6,3,249948,249948,249951,0,3,3
71423,1,1,249949,249951,249952,2,3,0
71424,1,1,249950,249952,249953,2,3,0
71425,1,2,249951,249953,249955,2,4,0
71426,4,3,249955,249955,249958,0,3,0
71427,2,3,249957,249958,249961,1,4,0
71428,1,1,249958,249961,249962,3,4,0
71429,4,3,249962,249962,249965,0,3,0
71430,5,2,249967,249967,249969,0,2,2
71431,2,2,249969,249969,249971,0,2,0
71432,6,2,249975,249975,249977,0,2,4
71433,6,3,249981,249981,249984,0,3,4
71434,5,1,249986,249986,249987,0,1,2
71435,2,1,249988,249988,249989,0,1,1
71436,6,2,249994,249994,249996,0,2,5
71437,5,2,249999,249999,250001,0,2,3
71438,6,1,250005,250005,250006,0,1,4
71439,3,2,250008,250008,250010,0,2,2
71440,3,3,250011,250011,250014,0,3,1
71441,5,3,250016,250016,250019,0,3,2
71442,4,3,250020,250020,250023,0,3,1
71443,2,3,250022,250023,250026,1,4,0
71444,5,2,250027,250027,250029,0,2,1
71445,6,2,250033,250033,250035,0,2,4
71446,3,3,250036,250036,250039,0,3,1
71447,6,2,250042,250042,250044,0,2,3
71448,3,1,250045,250045,250046,0,1,1
71449,3,1,250048,250048,250049,0,1,2
71450,6,1,250054,250054,250055,0,1,5
71451,6,1,250060,250060,250061,0,1,5
71452,5,1,250065,250065,250066,0,1,4
71453,1,1,250066,250066,250067,0,1,0
71454,1,2,250067,250067,250069,0,2,0
71455,3,2,250070,250070,250072,0,2,1
71456,1,3,250071,250072,250075,1,4,0
71457,3,2,250074,250075,250077,1,3,0
71458,1,2,250075,250077,250079,2,4,0
71459,5,2,250080,250080,250082,0,2,1
71460,3,1,250083,250083,250084,0,1,1
71461,2,1,250085,250085,250086,0,1,1
71462,5,1,250090,250090,250091,0,1,4
71463,1,3,250091,250091,250094,0,3,0
71464,6,1,250097,250097,250098,0,1,3
71465,5,3,250102,250102,250105,0,3,4
71466,4,2,250106,250106,250108,0,2,1
71467,1,1,250107,250108,250109,1,2,0
71468,3,3,250110,250110,250113,0,3,1
71469,1,2,250111,250113,250115,2,4,0
71470,3,1,250114,250115,250116,1,2,0
71471,4,2,250118,250118,250120,0,2,2
71472,2,3,250120,250120,250123,0,3,0
71473,6,1,250126,250126,250127,0,1,3
71474,3,3,250129,250129,250132,0,3,2
71475,5,3,250134,250134,250137,0,3,2
71476,3,3,250137,250137,250140,0,3,0
71477,3,1,250140,250140,250141,0,1,0
71478,6,1,250146,250146,250147,0,1,5
71479,2,3,250148,250148,250151,0,3,1
71480,1,3,250149,250151,250154,2,5,0
71481,3,1,250152,250154,250155,2,3,0
71482,6,2,250158,250158,250160,0,2,3
71483,2,3,250160,250160,250163,0,3,0
71484,3,2,250163,250163,250165,0,2,0
71485,3,2,250166,250166,250168,0,2,1
71486,6,1,250172,250172,250173,0,1,4
71487,6,2,250178,250178,250180,0,2,5
71488,4,1,250182,250182,250183,0,1,2
71489,6,3,250188,250188,250191,0,3,5
71490,6,3,250194,250194,250197,0,3,3
71491,2,3,250196,250197,250200,1,4,0
71492,2,1,250198,250200,250201,2,3,0
71493,3,1,250201,250201,250202,0,1,0
71494,3,3,250204,250204,250207,0,3,2
71495,3,3,250207,250207,250210,0,3,0
71496,5,1,250212,250212,250213,0,1,2
71497,3,1,250215,250215,250216,0,1,2
71498,6,3,250221,250221,250224,0,3,5
71499,1,2,250222,250224,250226,2,4,0
71500,5,2,250227,250227,250229,0,2,1
71501,2,3,250229,250229,250232,0,3,0
71502,2,1,250231,250232,250233,1,2,0
71503,5,3,250236,250236,250239,0,3,3
71504,4,2,250240,250240,250242,0,2,1
71505,5,1,250245,250245,250246,0,1,3
71506,3,1,250248,250248,250249,0,1,2
71507,1,2,250249,250249,250251,0,2,0
71508,5,2,250254,250254,250256,0,2,3
71509,1,2,250255,250256,250258,1,3,0
71510,3,1,250258,250258,250259,0,1,0
71511,5,3,250263,250263,250266,0,3,4
71512,5,1,250268,250268,250269,0,1,2
71513,5,3,250273,250273,250276,0,3,4
71514,2,2,250275,250276,250278,1,3,0
71515,5,1,250280,250280,250281,0,1,2
71516,4,2,250284,250284,250286,0,2,3
71517,4,3,250288,250288,250291,0,3,2
71518,1,1,250289,250291,250292,2,3,0
71519,4,1,250293,250293,250294,0,1,1
71520,5,1,250298,250298,250299,0,1,4
71521,3,3,250301,250301,250304,0,3,2
71522,2,1,250303,250304,250305,1,2,0
71523,6,2,250309,250309,250311,0,2,4
71524,5,3,250314,250314,250317,0,3,3
71525,4,2,250318,250318,250320,0,2,1
71526,5,2,250323,250323,250325,0,2,3
71527,2,3,250325,250325,250328,0,3,0
71528,3,3,250328,250328,250331,0,3,0
71529,3,1,250331,250331,250332,0,1,0
71530,4,3,250335,250335,250338,0,3,3
71531,6,2,250341,250341,250343,0,2,3
71532,5,2,250346,250346,250348,0,2,3
71533,5,1,250351,250351,250352,0,1,3
71534,2,2,250353,250353,250355,0,2,1
71535,6,3,250359,250359,250362,0,3,4
71536,1,2,250360,250362,250364,2,4,0
71537,2,1,250362,250364,250365,2,3,0
71538,6,3,250368,250368,250371,0,3,3
71539,3,3,250371,250371,250374,0,3,0
71540,6,1,250377,250377,250378,0,1,3
71541,6,3,250383,250383,250386,0,3,5
71542,5,1,250388,250388,250389,0,1,2
71543,2,1,250390,250390,250391,0,1,1
71544,5,1,250395,250395,250396,0,1,4
71545,3,1,250398,250398,250399,0,1,2
71546,6,2,250404,250404,250406,0,2,5
71547,5,2,250409,250409,250411,0,2,3
71548,4,1,250413,250413,250414,0,1,2
71549,3,2,250416,250416,250418,0,2,2
71550,6,1,250422,250422,250423,0,1,4
71551,1,1,250423,250423,250424,0,1,0
71552,1,1,250424,250424,250425,0,1,0
71553,2,3,250426,250426,250429,0,3,1
71554,3,1,250429,250429,250430,0,1,0
71555,2,2,250431,250431,250433,0,2,1
71556,6,3,250437,250437,250440,0,3,4
71557,3,2,250440,250440,250442,0,2,0
71558,5,3,250445,250445,250448,0,3,3
71559,4,1,250449,250449,250450,0,1,1
71560,6,1,250455,250455,250456,0,1,5
71561,6,2,250461,250461,250463,0,2,5
71562,5,1,250466,250466,250467,0,1,3
71563,6,3,250472,250472,250475,0,3,5
71564,1,3,250473,250475,250478,2,5,0
71565,5,3,250478,250478,250481,0,3,0
71566,6,1,250484,250484,250485,0,1,3
71567,1,1,250485,250485,250486,0,1,0
71568,6,3,250491,250491,250494,0,3,5
71569,1,3,250492,250494,250497,2,5,0
71570,5,2,250497,250497,250499,0,2,0
71571,5,1,250502,250502,250503,0,1,3
71572,4,2,250506,250506,250508,0,2,3
71573,4,3,250510,250510,250513,0,3,2
71574,4,2,250514,250514,250516,0,2,1
71575,1,2,250515,250516,250518,1,3,0
71576,5,2,250520,250520,250522,0,2,2
71577,1,1,250521,250522,250523,1,2,0
71578,1,2,250522,250523,250525,1,3,0
71579,5,1,250527,250527,250528,0,1,2
71580,2,1,250529,250529,250530,0,1,1
71581,4,2,250533,250533,250535,0,2,3
71582,1,3,250534,250535,250538,1,4,0
71583,6,2,250540,250540,250542,0,2,2
71584,2,1,250542,250542,250543,0,1,0
71585,4,2,250546,250546,250548,0,2,3
71586,1,1,250547,250548,250549,1,2,0
71587,4,2,250551,250551,250553,0,2,2
71588,5,1,250556,250556,250557,0,1,3
71589,3,1,250559,250559,250560,0,1,2
71590,3,1,250562,250562,250563,0,1,2
71591,6,3,250568,250568,250571,0,3,5
71592,2,1,250570,250571,250572,1,2,0
71593,6,2,250576,250576,250578,0,2,4
71594,4,2,250580,250580,250582,0,2,2
71595,5,1,250585,250585,250586,0,1,3
71596,2,3,250587,250587,250590,0,3,1
71597,6,1,250593,250593,250594,0,1,3
71598,6,3,250599,250599,250602,0,3,5
71599,1,1,250600,250602,250603,2,3,0
71600,2,3,250602,250603,250606,1,4,0
71601,6,2,250608,250608,250610,0,2,2
71602,6,2,250614,250614,250616,0,2,4
71603,4,1,250618,250618,250619,0,1,2
71604,5,3,250623,250623,250626,0,3,4
71605,2,1,250625,250626,250627,1,2,0
71606,2,3,250627,250627,250630,0,3,0
71607,2,3,250629,250630,250633,1,4,0
71608,1,2,250630,250633,250635,3,5,0
71609,5,1,250635,250635,250636,0,1,0
71610,3,3,250638,250638,250641,0,3,2
71611,1,1,250639,250641,250642,2,3,0
71612,1,1,250640,250642,250643,2,3,0
71613,4,2,250644,250644,250646,0,2,1
71614,1,2,250645,250646,250648,1,3,0
71615,5,3,250650,250650,250653,0,3,2
71616,1,2,250651,250653,250655,2,4,0
71617,5,2,250656,250656,250658,0,2,1
71618,4,2,250660,250660,250662,0,2,2
71619,5,1,250665,250665,250666,0,1,3
71620,2,3,250667,250667,250670,0,3,1
71621,4,2,250671,250671,250673,0,2,1
71622,5,1,250676,250676,250677,0,1,3
71623,1,2,250677,250677,250679,0,2,0
71624,6,3,250683,250683,250686,0,3,4
71625,6,1,250689,250689,250690,0,1,3
71626,6,2,250695,250695,250697,0,2,5
71627,2,3,250697,250697,250700,0,3,0
71628,1,1,250698,250700,250701,2,3,0
71629,1,1,250699,250701,250702,2,3,0
71630,3,1,250702,250702,250703,0,1,0
71631,1,2,250703,250703,250705,0,2,0
71632,5,3,250708,250708,250711,0,3,3
71633,6,3,250714,250714,250717,0,3,3
71634,1,3,250715,250717,250720,2,5,0
71635,1,2,250716,250720,250722,4,6,0
71636,2,2,250718,250722,250724,4,6,0
71637,4,3,250722,250724,250727,2,5,0
71638,3,3,250725,250727,250730,2,5,0
71639,3,2,250728,250730,250732,2,4,0
71640,6,2,250734,250734,250736,0,2,2
71641,1,2,250735,250736,250738,1,3,0
71642,4,3,250739,250739,250742,0,3,1
71643,4,2,250743,250743,250745,0,2,1
71644,5,3,250748,250748,250751,0,3,3
71645,1,2,250749,250751,250753,2,4,0
71646,1,2,250750,250753,250755,3,5,0
71647,2,2,250752,250755,250757,3,5,0
71648,6,3,250758,250758,250761,0,3,1
71649,3,2,250761,250761,250763,0,2,0
71650,2,2,250763,250763,250765,0,2,0
71651,5,2,250768,250768,250770,0,2,3
71652,3,3,250771,250771,250774,0,3,1
71653,6,1,250777,250777,250778,0,1,3
71654,2,1,250779,250779,250780,0,1,1
71655,6,3,250785,250785,250788,0,3,5
71656,1,2,250786,250788,250790,2,4,0
71657,1,3,250787,250790,250793,3,6,0
71658,5,3,250792,250793,250796,1,4,0
71659,6,1,250798,250798,250799,0,1,2
71660,2,3,250800,250800,250803,0,3,1
71661,1,3,250801,250803,250806,2,5,0
71662,1,2,250802,250806,250808,4,6,0
71663,4,2,250806,250808,250810,2,4,0
71664,4,1,250810,250810,250811,0,1,0
71665,6,1,250816,250816,250817,0,1,5
71666,2,3,250818,250818,250821,0,3,1
71667,3,3,250821,250821,250824,0,3,0
71668,4,1,250825,250825,250826,0,1,1
71669,2,3,250827,250827,250830,0,3,1
71670,5,2,250832,250832,250834,0,2,2
71671,5,1,250837,250837,250838,0,1,3
71672,6,1,250843,250843,250844,0,1,5
71673,4,2,250847,250847,250849,0,2,3
71674,1,3,250848,250849,250852,1,4,0
71675,4,2,250852,250852,250854,0,2,0
71676,5,3,250857,250857,250860,0,3,3
71677,2,3,250859,250860,250863,1,4,0
71678,3,2,250862,250863,250865,1,3,0
71679,5,3,250867,250867,250870,0,3,2
71680,2,2,250869,250870,250872,1,3,0
71681,6,2,250875,250875,250877,0,2,3
71682,3,1,250878,250878,250879,0,1,1
71683,2,1,250880,250880,250881,0,1,1
71684,2,1,250882,250882,250883,0,1,1
71685,6,2,250888,250888,250890,0,2,5
71686,1,2,250889,250890,250892,1,3,0
71687,3,3,250892,250892,250895,0,3,0
71688,5,1,250897,250897,250898,0,1,2
71689,6,3,250903,250903,250906,0,3,5
71690,4,1,250907,250907,250908,0,1,1
71691,3,1,250910,250910,250911,0,1,2
71692,5,1,250915,250915,250916,0,1,4
71693,5,3,250920,250920,250923,0,3,4
71694,3,2,250923,250923,250925,0,2,0
71695,2,3,250925,250925,250928,0,3,0
71696,3,2,250928,250928,250930,0,2,0
71697,4,3,250932,250932,250935,0,3,2
71698,6,2,250938,250938,250940,0,2,3
71699,6,1,250944,250944,250945,0,1,4
71700,1,3,250945,250945,250948,0,3,0
71701,2,1,250947,250948,250949,1,2,0
71702,2,1,250949,250949,250950,0,1,0
71703,3,1,250952,250952,250953,0,1,2
71704,3,1,250955,250955,250956,0,1,2
71705,5,1,250960,250960,250961,0,1,4
71706,6,2,250966,250966,250968,0,2,5
71707,4,1,250970,250970,250971,0,1,2
71708,4,3,250974,250974,250977,0,3,3
71709,6,1,250980,250980,250981,0,1,3
71710,3,1,250983,250983,250984,0,1,2
71711,3,3,250986,250986,250989,0,3,2
71712,3,3,250989,250989,250992,0,3,0
71713,2,2,250991,250992,250994,1,3,0
71714,1,1,250992,250994,250995,2,3,0
71715,6,2,250998,250998,251000,0,2,3
71716,1,3,250999,251000,251003,1,4,0
71717,4,3,251003,251003,251006,0,3,0
71718,4,2,251007,251007,251009,0,2,1
71719,5,2,251012,251012,251014,0,2,3
71720,5,2,251017,251017,251019,0,2,3
71721,4,1,251021,251021,251022,0,1,2
71722,1,2,251022,251022,251024,0,2,0
71723,2,1,251024,251024,251025,0,1,0
71724,6,3,251030,251030,251033,0,3,5
71725,4,1,251034,251034,251035,0,1,1
71726,2,1,251036,251036,251037,0,1,1
71727,1,1,251037,251037,251038,0,1,0
71728,3,3,251040,251040,251043,0,3,2
71729,1,2,251041,251043,251045,2,4,0
71730,3,1,251044,251045,251046,1,2,0
71731,3,3,251047,251047,251050,0,3,1
71732,4,1,251051,251051,251052,0,1,1
71733,5,1,251056,251056,251057,0,1,4
71734,1,2,251057,251057,251059,0,2,0
71735,1,2,251058,251059,251061,1,3,0
71736,6,2,251064,251064,251066,0,2,3
71737,2,2,251066,251066,251068,0,2,0
71738,2,3,251068,251068,251071,0,3,0
71739,5,3,251073,251073,251076,0,3,2
71740,4,2,251077,251077,251079,0,2,1
71741,3,1,251080,251080,251081,0,1,1
71742,4,1,251084,251084,251085,0,1,3
71743,2,2,251086,251086,251088,0,2,1
71744,6,3,251092,251092,251095,0,3,4
71745,1,1,251093,251095,251096,2,3,0
71746,1,1,251094,251096,251097,2,3,0
71747,5,2,251099,251099,251101,0,2,2
71748,5,3,251104,251104,251107,0,3,3
71749,6,3,251110,251110,251113,0,3,3
71750,4,1,251114,251114,251115,0,1,1
71751,5,3,251119,251119,251122,0,3,4
71752,4,1,251123,251123,251124,0,1,1
71753,6,2,251129,251129,251131,0,2,5
71754,4,1,251133,251133,251134,0,1,2
71755,3,2,251136,251136,251138,0,2,2
71756,1,2,251137,251138,251140,1,3,0
71757,3,1,251140,251140,251141,0,1,0
71758,4,2,251144,251144,251146,0,2,3
71759,6,3,251150,251150,251153,0,3,4
71760,1,2,251151,251153,251155,2,4,0
71761,1,1,251152,251155,251156,3,4,0
71762,1,2,251153,251156,251158,3,5,0
71763,1,3,251154,251158,251161,4,7,0
71764,5,1,251159,251161,251162,2,3,0
71765,3,3,251162,251162,251165,0,3,0
71766,5,3,251167,251167,251170,0,3,2
71767,6,2,251173,251173,251175,0,2,3
71768,4,1,251177,251177,251178,0,1,2
71769,2,2,251179,251179,251181,0,2,1
71770,5,1,251184,251184,251185,0,1,3
71771,5,1,251189,251189,251190,0,1,4
71772,6,3,251195,251195,251198,0,3,5
71773,1,2,251196,251198,251200,2,4,0
71774,4,1,251200,251200,251201,0,1,0
71775,3,3,251203,251203,251206,0,3,2
71776,1,1,251204,251206,251207,2,3,0
71777,2,2,251206,251207,251209,1,3,0
71778,6,1,251212,251212,251213,0,1,3
71779,3,1,251215,251215,251216,0,1,2
71780,5,2,251220,251220,251222,0,2,4
71781,2,1,251222,251222,251223,0,1,0
71782,2,2,251224,251224,251226,0,2,1
71783,6,1,251230,251230,251231,0,1,4
71784,1,1,251231,251231,251232,0,1,0
71785,5,2,251236,251236,251238,0,2,4
71786,2,1,251238,251238,251239,0,1,0
71787,4,3,251242,251242,251245,0,3,3
71788,5,2,251247,251247,251249,0,2,2
71789,1,1,251248,251249,251250,1,2,0
71790,1,1,251249,251250,251251,1,2,0
71791,5,2,251254,251254,251256,0,2,3
71792,2,3,251256,251256,251259,0,3,0
71793,6,1,251262,251262,251263,0,1,3
71794,3,3,251265,251265,251268,0,3,2
71795,3,2,251268,251268,251270,0,2,0
71796,3,1,251271,251271,251272,0,1,1
71797,4,3,251275,251275,251278,0,3,3
71798,5,3,251280,251280,251283,0,3,2
71799,1,3,251281,251283,251286,2,5,0
71800,3,1,251284,251286,251287,2,3,0
71801,1,3,251285,251287,251290,2,5,0
71802,4,3,251289,251290,251293,1,4,0
71803,5,1,251294,251294,251295,0,1,1
71804,1,1,251295,251295,251296,0,1,0
71805,1,1,251296,251296,251297,0,1,0
71806,3,1,251299,251299,251300,0,1,2
71807,1,3,251300,251300,251303,0,3,0
71808,6,2,251306,251306,251308,0,2,3
71809,3,1,251309,251309,251310,0,1,1
71810,4,3,251313,251313,251316,0,3,3
71811,5,3,251318,251318,251321,0,3,2
71812,5,3,251323,251323,251326,0,3,2
71813,5,1,251328,251328,251329,0,1,2
71814,6,1,251334,251334,251335,0,1,5
71815,6,3,251340,251340,251343,0,3,5
71816,3,2,251343,251343,251345,0,2,0
71817,2,1,251345,251345,251346,0,1,0
71818,5,1,251350,251350,251351,0,1,4
71819,2,2,251352,251352,251354,0,2,1
71820,3,2,251355,251355,251357,0,2,1
71821,5,2,251360,251360,251362,0,2,3
71822,1,2,251361,251362,251364,1,3,0
71823,4,1,251365,251365,251366,0,1,1
71824,3,2,251368,251368,251370,0,2,2
71825,3,3,251371,251371,251374,0,3,1
71826,6,1,251377,251377,251378,0,1,3
71827,1,3,251378,251378,251381,0,3,0
71828,2,1,251380,251381,251382,1,2,0
71829,3,1,251383,251383,251384,0,1,1
71830,1,2,251384,251384,251386,0,2,0
71831,4,2,251388,251388,251390,0,2,2
71832,5,2,251393,251393,251395,0,2,3
71833,3,2,251396,251396,251398,0,2,1
71834,5,2,251401,251401,251403,0,2,3
71835,5,1,251406,251406,251407,0,1,3
71836,6,1,251412,251412,251413,0,1,5
71837,1,1,251413,251413,251414,0,1,0
71838,6,2,251419,251419,251421,0,2,5
71839,1,1,251420,251421,251422,1,2,0
71840,2,3,251422,251422,251425,0,3,0
71841,3,3,251425,251425,251428,0,3,0
71842,3,2,251428,251428,251430,0,2,0
71843,6,2,251434,251434,251436,0,2,4
71844,6,1,251440,251440,251441,0,1,4
71845,5,1,251445,251445,251446,0,1,4
71846,5,1,251450,251450,251451,0,1,4
71847,4,3,251454,251454,251457,0,3,3
71848,3,1,251457,251457,251458,0,1,0
71849,3,1,251460,251460,251461,0,1,2
71850,5,2,251465,251465,251467,0,2,4
71851,5,3,251470,251470,251473,0,3,3
71852,1,3,251471,251473,251476,2,5,0
71853,4,2,251475,251476,251478,1,3,0
71854,1,2,251476,251478,251480,2,4,0
71855,5,3,251481,251481,251484,0,3,1
71856,4,2,251485,251485,251487,0,2,1
71857,2,2,251487,251487,251489,0,2,0
71858,3,2,251490,251490,251492,0,2,1
71859,1,2,251491,251492,251494,1,3,0
71860,6,1,251497,251497,251498,0,1,3
71861,5,3,251502,251502,251505,0,3,4
71862,6,2,251508,251508,251510,0,2,3
71863,4,3,251512,251512,251515,0,3,2
71864,6,1,251518,251518,251519,0,1,3
71865,5,2,251523,251523,251525,0,2,4
71866,5,2,251528,251528,251530,0,2,3
71867,2,1,251530,251530,251531,0,1,0
71868,5,1,251535,251535,251536,0,1,4
71869,1,3,251536,251536,251539,0,3,0
71870,6,1,251542,251542,251543,0,1,3
71871,1,2,251543,251543,251545,0,2,0
71872,3,3,251546,251546,251549,0,3,1
71873,5,2,251551,251551,251553,0,2,2
71874,4,2,251555,251555,251557,0,2,2
71875,5,3,251560,251560,251563,0,3,3
71876,4,2,251564,251564,251566,0,2,1
71877,1,1,251565,251566,251567,1,2,0
71878,1,3,251566,251567,251570,1,4,0
71879,5,3,251571,251571,251574,0,3,1
71880,1,1,251572,251574,251575,2,3,0
71881,6,2,251578,251578,251580,0,2,3
71882,4,2,251582,251582,251584,0,2,2
71883,6,1,251588,251588,251589,0,1,4
71884,5,1,251593,251593,251594,0,1,4
71885,5,3,251598,251598,251601,0,3,4
71886,4,3,251602,251602,251605,0,3,1
71887,4,2,251606,251606,251608,0,2,1
71888,2,2,251608,251608,251610,0,2,0
71889,5,2,251613,251613,251615,0,2,3
71890,3,1,251616,251616,251617,0,1,1
71891,4,1,251620,251620,251621,0,1,3
71892,5,2,251625,251625,251627,0,2,4
71893,3,2,251628,251628,251630,0,2,1
71894,1,1,251629,251630,251631,1,2,0
71895,1,1,251630,251631,251632,1,2,0
71896,5,2,251635,251635,251637,0,2,3
71897,3,3,251638,251638,251641,0,3,1
71898,5,1,251643,251643,251644,0,1,2
71899,3,3,251646,251646,251649,0,3,2
71900,6,2,251652,251652,251654,0,2,3
71901,1,1,251653,251654,251655,1,2,0
71902,4,3,251657,251657,251660,0,3,2
71903,5,2,251662,251662,251664,0,2,2
71904,1,3,251663,251664,251667,1,4,0
71905,4,1,251667,251667,251668,0,1,0
71906,6,3,251673,251673,251676,0,3,5
71907,6,3,251679,251679,251682,0,3,3
71908,5,2,251684,251684,251686,0,2,2
71909,2,3,251686,251686,251689,0,3,0
71910,2,3,251688,251689,251692,1,4,0
71911,1,2,251689,251692,251694,3,5,0
71912,2,3,251691,251694,251697,3,6,0
71913,1,2,251692,251697,251699,5,7,0
71914,5,3,251697,251699,251702,2,5,0
71915,5,1,251702,251702,251703,0,1,0
71916,3,3,251705,251705,251708,0,3,2
71917,4,3,251709,251709,251712,0,3,1
71918,1,3,251710,251712,251715,2,5,0
71919,5,2,251715,251715,251717,0,2,0
71920,2,1,251717,251717,251718,0,1,0
71921,3,1,251720,251720,251721,0,1,2
71922,3,1,251723,251723,251724,0,1,2
71923,2,2,251725,251725,251727,0,2,1
71924,3,1,251728,251728,251729,0,1,1
71925,3,3,251731,251731,251734,0,3,2
71926,1,2,251732,251734,251736,2,4,0
71927,2,1,251734,251736,251737,2,3,0
71928,2,3,251736,251737,251740,1,4,0
71929,1,1,251737,251740,251741,3,4,0
71930,4,3,251741,251741,251744,0,3,0
71931,2,2,251743,251744,251746,1,3,0
71932,2,2,251745,251746,251748,1,3,0
71933,4,1,251749,251749,251750,0,1,1
71934,4,2,251753,251753,251755,0,2,3
71935,2,1,251755,251755,251756,0,1,0
71936,3,2,251758,251758,251760,0,2,2
71937,5,2,251763,251763,251765,0,2,3
71938,3,3,251766,251766,251769,0,3,1
71939,4,1,251770,251770,251771,0,1,1
71940,3,3,251773,251773,251776,0,3,2
71941,1,3,251774,251776,251779,2,5,0
71942,4,2,251778,251779,251781,1,3,0
71943,6,2,251784,251784,251786,0,2,3
71944,3,1,251787,251787,251788,0,1,1
71945,1,2,251788,251788,251790,0,2,0
71946,1,3,251789,251790,251793,1,4,0
71947,6,1,251795,251795,251796,0,1,2
71948,2,3,251797,251797,251800,0,3,1
71949,2,1,251799,251800,251801,1,2,0
71950,4,1,251803,251803,251804,0,1,2
71951,5,2,251808,251808,251810,0,2,4
71952,4,1,251812,251812,251813,0,1,2
71953,6,3,251818,251818,251821,0,3,5
71954,6,2,251824,251824,251826,0,2,3
71955,4,1,251828,251828,251829,0,1,2
71956,4,3,251832,251832,251835,0,3,3
71957,4,2,251836,251836,251838,0,2,1
71958,6,3,251842,251842,251845,0,3,4
71959,3,3,251845,251845,251848,0,3,0
71960,3,3,251848,251848,251851,0,3,0
71961,4,1,251852,251852,251853,0,1,1
71962,3,3,251855,251855,251858,0,3,2
71963,3,1,251858,251858,251859,0,1,0
71964,6,1,251864,251864,251865,0,1,5
71965,4,2,251868,251868,251870,0,2,3
71966,3,3,251871,251871,251874,0,3,1
71967,2,2,251873,251874,251876,1,3,0
71968,1,3,251874,251876,251879,2,5,0
71969,1,1,251875,251879,251880,4,5,0
71970,3,2,251878,251880,251882,2,4,0
71971,6,2,251884,251884,251886,0,2,2
71972,5,2,251889,251889,251891,0,2,3
71973,6,3,251895,251895,251898,0,3,4
71974,1,1,251896,251898,251899,2,3,0
71975,3,1,251899,251899,251900,0,1,0
71976,1,3,251900,251900,251903,0,3,0
71977,2,1,251902,251903,251904,1,2,0
71978,4,1,251906,251906,251907,0,1,2
71979,5,2,251911,251911,251913,0,2,4
71980,6,3,251917,251917,251920,0,3,4
71981,4,1,251921,251921,251922,0,1,1
71982,2,1,251923,251923,251924,0,1,1
71983,2,2,251925,251925,251927,0,2,1
71984,6,1,251931,251931,251932,0,1,4
71985,4,3,251935,251935,251938,0,3,3
71986,3,2,251938,251938,251940,0,2,0
71987,4,3,251942,251942,251945,0,3,2
71988,5,1,251947,251947,251948,0,1,2
71989,3,3,251950,251950,251953,0,3,2
71990,1,1,251951,251953,251954,2,3,0
71991,1,2,251952,251954,251956,2,4,0
71992,2,3,251954,251956,251959,2,5,0
71993,4,2,251958,251959,251961,1,3,0
71994,6,2,251964,251964,251966,0,2,3
71995,4,1,251968,251968,251969,0,1,2
71996,6,1,251974,251974,251975,0,1,5
71997,1,3,251975,251975,251978,0,3,0
71998,2,3,251977,251978,251981,1,4,0
71999,6,1,251983,251983,251984,0,1,2
72000,6,1,251989,251989,251990,0,1,5
72001,1,2,251990,251990,251992,0,2,0
72002,3,2,251993,251993,251995,0,2,1
72003,5,3,251998,251998,252001,0,3,3
72004,6,1,252004,252004,252005,0,1,3
72005,1,1,252005,252005,252006,0,1,0
72006,6,2,252011,252011,252013,0,2,5
72007,6,2,252017,252017,252019,0,2,4
72008,3,2,252020,252020,252022,0,2,1
72009,2,1,252022,252022,252023,0,1,0
72010,5,2,252027,252027,252029,0,2,4
72011,5,3,252032,252032,252035,0,3,3
72012,3,2,252035,252035,252037,0,2,0
72013,3,2,252038,252038,252040,0,2,1
72014,4,1,252042,252042,252043,0,1,2
72015,2,2,252044,252044,252046,0,2,1
72016,5,3,252049,252049,252052,0,3,3
72017,1,1,252050,252052,252053,2,3,0
72018,2,1,252052,252053,252054,1,2,0
72019,4,1,252056,252056,252057,0,1,2
72020,6,3,252062,252062,252065,0,3,5
72021,1,2,252063,252065,252067,2,4,0
72022,1,3,252064,252067,252070,3,6,0
72023,4,2,252068,252070,252072,2,4,0
72024,6,1,252074,252074,252075,0,1,2
72025,2,3,252076,252076,252079,0,3,1
72026,6,3,252082,252082,252085,0,3,3
72027,6,3,252088,252088,252091,0,3,3
72028,3,1,252091,252091,252092,0,1,0
72029,4,2,252095,252095,252097,0,2,3
72030,3,2,252098,252098,252100,0,2,1
72031,4,2,252102,252102,252104,0,2,2
72032,2,2,252104,252104,252106,0,2,0
72033,6,3,252110,252110,252113,0,3,4
72034,6,2,252116,252116,252118,0,2,3
72035,4,3,252120,252120,252123,0,3,2
72036,6,1,252126,252126,252127,0,1,3
72037,6,1,252132,252132,252133,0,1,5
72038,3,1,252135,252135,252136,0,1,2
72039,6,2,252141,252141,252143,0,2,5
72040,4,3,252145,252145,252148,0,3,2
72041,3,3,252148,252148,252151,0,3,0
72042,6,2,252154,252154,252156,0,2,3
72043,1,1,252155,252156,252157,1,2,0
72044,6,3,252161,252161,252164,0,3,4
72045,5,3,252166,252166,252169,0,3,2
72046,3,1,252169,252169,252170,0,1,0
72047,2,3,252171,252171,252174,0,3,1
72048,3,1,252174,252174,252175,0,1,0
72049,3,1,252177,252177,252178,0,1,2
72050,6,3,252183,252183,252186,0,3,5
72051,6,2,252189,252189,252191,0,2,3
72052,2,1,252191,252191,252192,0,1,0
72053,4,2,252195,252195,252197,0,2,3
72054,5,3,252200,252200,252203,0,3,3
72055,6,1,252206,252206,252207,0,1,3
72056,6,1,252212,252212,252213,0,1,5
72057,1,2,252213,252213,252215,0,2,0
72058,4,3,252217,252217,252220,0,3,2
72059,1,3,252218,252220,252223,2,5,0
72060,2,2,252220,252223,252225,3,5,0
72061,6,3,252226,252226,252229,0,3,1
72062,5,2,252231,252231,252233,0,2,2
72063,1,3,252232,252233,252236,1,4,0
72064,4,1,252236,252236,252237,0,1,0
72065,1,1,252237,252237,252238,0,1,0
72066,6,3,252243,252243,252246,0,3,5
72067,2,3,252245,252246,252249,1,4,0
72068,1,1,252246,252249,252250,3,4,0
72069,3,1,252249,252250,252251,1,2,0
72070,1,1,252250,252251,252252,1,2,0
72071,6,1,252256,252256,252257,0,1,4
72072,6,3,252262,252262,252265,0,3,5
72073,1,1,252263,252265,252266,2,3,0
72074,4,2,252267,252267,252269,0,2,1
72075,1,1,252268,252269,252270,1,2,0
72076,5,2,252273,252273,252275,0,2,3
72077,3,1,252276,252276,252277,0,1,1
72078,1,3,252277,252277,252280,0,3,0
72079,5,3,252282,252282,252285,0,3,2
72080,4,1,252286,252286,252287,0,1,1
72081,6,1,252292,252292,252293,0,1,5
72082,2,3,252294,252294,252297,0,3,1
72083,2,2,252296,252297,252299,1,3,0
72084,4,2,252300,252300,252302,0,2,1
72085,2,2,252302,252302,252304,0,2,0
72086,6,3,252308,252308,252311,0,3,4
72087,4,2,252312,252312,252314,0,2,1
72088,4,3,252316,252316,252319,0,3,2
72089,2,1,252318,252319,252320,1,2,0
72090,6,3,252324,252324,252327,0,3,4
72091,3,1,252327,252327,252328,0,1,0
72092,4,1,252331,252331,252332,0,1,3
72093,1,3,252332,252332,252335,0,3,0
72094,5,2,252337,252337,252339,0,2,2
72095,5,3,252342,252342,252345,0,3,3
72096,4,3,252346,252346,252349,0,3,1
72097,1,2,252347,252349,252351,2,4,0
72098,1,3,252348,252351,252354,3,6,0
72099,6,1,252354,252354,252355,0,1,0
72100,3,2,252357,252357,252359,0,2,2
72101,2,3,252359,252359,252362,0,3,0
72102,3,3,252362,252362,252365,0,3,0
72103,4,3,252366,252366,252369,0,3,1
72104,6,3,252372,252372,252375,0,3,3
72105,2,1,252374,252375,252376,1,2,0
72106,4,3,252378,252378,252381,0,3,2
72107,1,2,252379,252381,252383,2,4,0
72108,4,2,252383,252383,252385,0,2,0
72109,1,1,252384,252385,252386,1,2,0
72110,5,1,252389,252389,252390,0,1,3
72111,4,1,252393,252393,252394,0,1,3
72112,4,3,252397,252397,252400,0,3,3
72113,3,2,252400,252400,252402,0,2,0
72114,4,1,252404,252404,252405,0,1,2
72115,3,2,252407,252407,252409,0,2,2
72116,4,1,252411,252411,252412,0,1,2
72117,1,2,252412,252412,252414,0,2,0
72118,6,1,252418,252418,252419,0,1,4
72119,2,2,252420,252420,252422,0,2,1
72120,2,3,252422,252422,252425,0,3,0
72121,1,1,252423,252425,252426,2,3,0
72122,3,2,252426,252426,252428,0,2,0
72123,1,2,252427,252428,252430,1,3,0
72124,5,1,252432,252432,252433,0,1,2
72125,4,3,252436,252436,252439,0,3,3
72126,1,3,252437,252439,252442,2,5,0
72127,2,3,252439,252442,252445,3,6,0
72128,5,2,252444,252445,252447,1,3,0
72129,5,1,252449,252449,252450,0,1,2
72130,1,3,252450,252450,252453,0,3,0
72131,4,3,252454,252454,252457,0,3,1
72132,1,1,252455,252457,252458,2,3,0
72133,4,1,252459,252459,252460,0,1,1
72134,1,2,252460,252460,252462,0,2,0
72135,2,1,252462,252462,252463,0,1,0
72136,4,2,252466,252466,252468,0,2,3
72137,2,3,252468,252468,252471,0,3,0
72138,3,2,252471,252471,252473,0,2,0
72139,5,3,252476,252476,252479,0,3,3
72140,4,3,252480,252480,252483,0,3,1
72141,5,2,252485,252485,252487,0,2,2
72142,5,1,252490,252490,252491,0,1,3
72143,6,2,252496,252496,252498,0,2,5
72144,1,2,252497,252498,252500,1,3,0
72145,6,1,252503,252503,252504,0,1,3
72146,6,1,252509,252509,252510,0,1,5
72147,5,2,252514,252514,252516,0,2,4
72148,3,2,252517,252517,252519,0,2,1
72149,2,1,252519,252519,252520,0,1,0
72150,6,2,252525,252525,252527,0,2,5
72151,4,2,252529,252529,252531,0,2,2
72152,5,3,252534,252534,252537,0,3,3
72153,3,2,252537,252537,252539,0,2,0
72154,2,1,252539,252539,252540,0,1,0
72155,1,2,252540,252540,252542,0,2,0
72156,2,2,252542,252542,252544,0,2,0
72157,4,1,252546,252546,252547,0,1,2
72158,6,2,252552,252552,252554,0,2,5
72159,3,2,252555,252555,252557,0,2,1
72160,1,2,252556,252557,252559,1,3,0
72161,5,2,252561,252561,252563,0,2,2
72162,1,3,252562,252563,252566,1,4,0
72163,6,3,252568,252568,252571,0,3,2
72164,1,3,252569,252571,252574,2,5,0
72165,3,3,252572,252574,252577,2,5,0
72166,1,2,252573,252577,252579,4,6,0
72167,4,3,252577,252579,252582,2,5,0
72168,1,2,252578,252582,252584,4,6,0
72169,4,1,252582,252584,252585,2,3,0
72170,3,3,252585,252585,252588,0,3,0
72171,4,3,252589,252589,252592,0,3,1
72172,5,2,252594,252594,252596,0,2,2
72173,2,3,252596,252596,252599,0,3,0
72174,1,3,252597,252599,252602,2,5,0
72175,5,3,252602,252602,252605,0,3,0
72176,1,2,252603,252605,252607,2,4,0
72177,5,3,252608,252608,252611,0,3,1
72178,1,3,252609,252611,252614,2,5,0
72179,1,1,252610,252614,252615,4,5,0
72180,5,1,252615,252615,252616,0,1,0
72181,1,1,252616,252616,252617,0,1,0
72182,5,1,252621,252621,252622,0,1,4
72183,6,3,252627,252627,252630,0,3,5
72184,3,2,252630,252630,252632,0,2,0
72185,3,2,252633,252633,252635,0,2,1
72186,4,2,252637,252637,252639,0,2,2
72187,6,2,252643,252643,252645,0,2,4
72188,2,1,252645,252645,252646,0,1,0
72189,6,2,252651,252651,252653,0,2,5
72190,3,2,252654,252654,252656,0,2,1
72191,3,3,252657,252657,252660,0,3,1
72192,4,3,252661,252661,252664,0,3,1
72193,5,2,252666,252666,252668,0,2,2
72194,4,2,252670,252670,252672,0,2,2
72195,4,1,252674,252674,252675,0,1,2
72196,6,3,252680,252680,252683,0,3,5
72197,1,3,252681,252683,252686,2,5,0
72198,2,1,252683,252686,252687,3,4,0
72199,4,3,252687,252687,252690,0,3,0
72200,4,3,252691,252691,252694,0,3,1
72201,2,2,252693,252694,252696,1,3,0
72202,5,1,252698,252698,252699,0,1,2
72203,6,2,252704,252704,252706,0,2,5
72204,1,1,252705,252706,252707,1,2,0
72205,5,3,252710,252710,252713,0,3,3
72206,3,1,252713,252713,252714,0,1,0
72207,2,1,252715,252715,252716,0,1,1
72208,4,3,252719,252719,252722,0,3,3
72209,1,1,252720,252722,252723,2,3,0
72210,3,2,252723,252723,252725,0,2,0
72211,4,1,252727,252727,252728,0,1,2
72212,4,3,252731,252731,252734,0,3,3
72213,2,2,252733,252734,252736,1,3,0
72214,1,3,252734,252736,252739,2,5,0
72215,5,1,252739,252739,252740,0,1,0
72216,5,1,252744,252744,252745,0,1,4
72217,5,2,252749,252749,252751,0,2,4
72218,2,3,252751,252751,252754,0,3,0
72219,5,1,252756,252756,252757,0,1,2
72220,3,3,252759,252759,252762,0,3,2
72221,3,2,252762,252762,252764,0,2,0
72222,3,3,252765,252765,252768,0,3,1
72223,1,2,252766,252768,252770,2,4,0
72224,4,3,252770,252770,252773,0,3,0
72225,2,1,252772,252773,252774,1,2,0
72226,3,3,252775,252775,252778,0,3,1
72227,2,2,252777,252778,252780,1,3,0
72228,4,3,252781,252781,252784,0,3,1
72229,5,2,252786,252786,252788,0,2,2
72230,6,3,252792,252792,252795,0,3,4
72231,6,1,252798,252798,252799,0,1,3
72232,1,1,252799,252799,252800,0,1,0
72233,5,2,252804,252804,252806,0,2,4
72234,6,2,252810,252810,252812,0,2,4
72235,1,3,252811,252812,252815,1,4,0
72236,4,1,252815,252815,252816,0,1,0
72237,4,1,252819,252819,252820,0,1,3
72238,1,1,252820,252820,252821,0,1,0
72239,6,1,252826,252826,252827,0,1,5
72240,2,1,252828,252828,252829,0,1,1
72241,1,2,252829,252829,252831,0,2,0
72242,6,2,252835,252835,252837,0,2,4
72243,5,1,252840,252840,252841,0,1,3
72244,4,2,252844,252844,252846,0,2,3
72245,6,2,252850,252850,252852,0,2,4
72246,2,1,252852,252852,252853,0,1,0
72247,4,3,252856,252856,252859,0,3,3
72248,3,1,252859,252859,252860,0,1,0
72249,4,3,252863,252863,252866,0,3,3
72250,4,3,252867,252867,252870,0,3,1
72251,4,2,252871,252871,252873,0,2,1
72252,5,2,252876,252876,252878,0,2,3
72253,5,1,252881,252881,252882,0,1,3
72254,2,1,252883,252883,252884,0,1,1
72255,6,3,252889,252889,252892,0,3,5
72256,6,1,252895,252895,252896,0,1,3
72257,2,1,252897,252897,252898,0,1,1
72258,5,1,252902,252902,252903,0,1,4
72259,4,1,252906,252906,252907,0,1,3
72260,1,2,252907,252907,252909,0,2,0
72261,6,2,252913,252913,252915,0,2,4
72262,4,2,252917,252917,252919,0,2,2
72263,3,2,252920,252920,252922,0,2,1
72264,1,2,252921,252922,252924,1,3,0
72265,3,1,252924,252924,252925,0,1,0
72266,4,3,252928,252928,252931,0,3,3
72267,6,3,252934,252934,252937,0,3,3
72268,5,1,252939,252939,252940,0,1,2
72269,2,1,252941,252941,252942,0,1,1
72270,3,2,252944,252944,252946,0,2,2
72271,5,1,252949,252949,252950,0,1,3
72272,2,1,252951,252951,252952,0,1,1
72273,4,3,252955,252955,252958,0,3,3
72274,1,1,252956,252958,252959,2,3,0
72275,2,1,252958,252959,252960,1,2,0
72276,1,2,252959,252960,252962,1,3,0
72277,5,3,252964,252964,252967,0,3,2
72278,4,3,252968,252968,252971,0,3,1
72279,2,2,252970,252971,252973,1,3,0
72280,5,2,252975,252975,252977,0,2,2
72281,2,2,252977,252977,252979,0,2,0
72282,5,1,252982,252982,252983,0,1,3
72283,1,2,252983,252983,252985,0,2,0
72284,1,3,252984,252985,252988,1,4,0
72285,3,1,252987,252988,252989,1,2,0
72286,1,1,252988,252989,252990,1,2,0
72287,3,3,252991,252991,252994,0,3,1
72288,3,2,252994,252994,252996,0,2,0
72289,4,1,252998,252998,252999,0,1,2
72290,3,2,253001,253001,253003,0,2,2
72291,2,3,253003,253003,253006,0,3,0
72292,5,3,253008,253008,253011,0,3,2
72293,1,1,253009,253011,253012,2,3,0
72294,4,1,253013,253013,253014,0,1,1
72295,1,3,253014,253014,253017,0,3,0
72296,6,1,253020,253020,253021,0,1,3
72297,5,3,253025,253025,253028,0,3,4
72298,6,2,253031,253031,253033,0,2,3
72299,6,2,253037,253037,253039,0,2,4
72300,2,1,253039,253039,253040,0,1,0
72301,2,3,253041,253041,253044,0,3,1
72302,2,1,253043,253044,253045,1,2,0
72303,6,1,253049,253049,253050,0,1,4
72304,1,1,253050,253050,253051,0,1,0
72305,6,3,253056,253056,253059,0,3,5
72306,4,2,253060,253060,253062,0,2,1
72307,5,1,253065,253065,253066,0,1,3
72308,2,2,253067,253067,253069,0,2,1
72309,3,3,253070,253070,253073,0,3,1
72310,5,3,253075,253075,253078,0,3,2
72311,5,3,253080,253080,253083,0,3,2
72312,3,3,253083,253083,253086,0,3,0
72313,4,3,253087,253087,253090,0,3,1
72314,4,1,253091,253091,253092,0,1,1
72315,1,2,253092,253092,253094,0,2,0
72316,5,2,253097,253097,253099,0,2,3
72317,2,1,253099,253099,253100,0,1,0
72318,3,3,253102,253102,253105,0,3,2
72319,4,3,253106,253106,253109,0,3,1
72320,4,3,253110,253110,253113,0,3,1
72321,4,1,253114,253114,253115,0,1,1
72322,3,2,253117,253117,253119,0,2,2
72323,6,3,253123,253123,253126,0,3,4
72324,2,2,253125,253126,253128,1,3,0
72325,6,1,253131,253131,253132,0,1,3
72326,4,3,253135,253135,253138,0,3,3
72327,6,2,253141,253141,253143,0,2,3
72328,2,1,253143,253143,253144,0,1,0
72329,5,1,253148,253148,253149,0,1,4
72330,3,3,253151,253151,253154,0,3,2
72331,1,3,253152,253154,253157,2,5,0
72332,3,1,253155,253157,253158,2,3,0
72333,5,2,253160,253160,253162,0,2,2
72334,2,2,253162,253162,253164,0,2,0
72335,4,3,253166,253166,253169,0,3,2
72336,6,3,253172,253172,253175,0,3,3
72337,6,3,253178,253178,253181,0,3,3
72338,6,1,253184,253184,253185,0,1,3
72339,3,3,253187,253187,253190,0,3,2
72340,5,3,253192,253192,253195,0,3,2
72341,1,1,253193,253195,253196,2,3,0
72342,4,3,253197,253197,253200,0,3,1
72343,3,2,253200,253200,253202,0,2,0
72344,5,2,253205,253205,253207,0,2,3
72345,2,3,253207,253207,253210,0,3,0
72346,3,2,253210,253210,253212,0,2,0
72347,2,3,253212,253212,253215,0,3,0
72348,3,1,253215,253215,253216,0,1,0
72349,6,1,253221,253221,253222,0,1,5
72350,1,3,253222,253222,253225,0,3,0
72351,4,3,253226,253226,253229,0,3,1
72352,6,2,253232,253232,253234,0,2,3
72353,6,1,253238,253238,253239,0,1,4
72354,4,1,253242,253242,253243,0,1,3
72355,6,3,253248,253248,253251,0,3,5
72356,3,2,253251,253251,253253,0,2,0
72357,5,3,253256,253256,253259,0,3,3
72358,2,3,253258,253259,253262,1,4,0
72359,3,3,253261,253262,253265,1,4,0
72360,5,2,253266,253266,253268,0,2,1
72361,6,3,253272,253272,253275,0,3,4
72362,4,1,253276,253276,253277,0,1,1
72363,1,1,253277,253277,253278,0,1,0
72364,1,1,253278,253278,253279,0,1,0
72365,6,2,253284,253284,253286,0,2,5
72366,4,1,253288,253288,253289,0,1,2
72367,6,1,253294,253294,253295,0,1,5
72368,2,3,253296,253296,253299,0,3,1
72369,5,1,253301,253301,253302,0,1,2
72370,4,3,253305,253305,253308,0,3,3
72371,4,3,253309,253309,253312,0,3,1
72372,4,1,253313,253313,253314,0,1,1
72373,4,1,253317,253317,253318,0,1,3
72374,5,1,253322,253322,253323,0,1,4
72375,4,3,253326,253326,253329,0,3,3
72376,2,2,253328,253329,253331,1,3,0
72377,4,3,253332,253332,253335,0,3,1
72378,4,3,253336,253336,253339,0,3,1
72379,1,3,253337,253339,253342,2,5,0
72380,2,1,253339,253342,253343,3,4,0
72381,3,1,253342,253343,253344,1,2,0
72382,5,3,253347,253347,253350,0,3,3
72383,2,1,253349,253350,253351,1,2,0
72384,4,1,253353,253353,253354,0,1,2
72385,2,1,253355,253355,253356,0,1,1
72386,1,1,253356,253356,253357,0,1,0
72387,5,1,253361,253361,253362,0,1,4
72388,5,2,253366,253366,253368,0,2,4
72389,5,2,253371,253371,253373,0,2,3
72390,5,1,253376,253376,253377,0,1,3
72391,6,2,253382,253382,253384,0,2,5
72392,2,2,253384,253384,253386,0,2,0
72393,2,3,253386,253386,253389,0,3,0
72394,5,3,253391,253391,253394,0,3,2
72395,5,1,253396,253396,253397,0,1,2
72396,3,3,253399,253399,253402,0,3,2
72397,3,1,253402,253402,253403,0,1,0
72398,2,2,253404,253404,253406,0,2,1
72399,4,3,253408,253408,253411,0,3,2
72400,4,3,253412,253412,253415,0,3,1
72401,2,1,253414,253415,253416,1,2,0
72402,1,3,253415,253416,253419,1,4,0
72403,4,3,253419,253419,253422,0,3,0
72404,3,2,253422,253422,253424,0,2,0
72405,6,3,253428,253428,253431,0,3,4
72406,1,3,253429,253431,253434,2,5,0
72407,4,3,253433,253434,253437,1,4,0
72408,4,2,253437,253437,253439,0,2,0
72409,6,3,253443,253443,253446,0,3,4
72410,3,1,253446,253446,253447,0,1,0
72411,1,2,253447,253447,253449,0,2,0
72412,6,3,253453,253453,253456,0,3,4
72413,3,2,253456,253456,253458,0,2,0
72414,1,3,253457,253458,253461,1,4,0
72415,2,3,253459,253461,253464,2,5,0
72416,6,1,253465,253465,253466,0,1,1
72417,5,3,253470,253470,253473,0,3,4
72418,5,3,253475,253475,253478,0,3,2
72419,6,1,253481,253481,253482,0,1,3
72420,1,3,253482,253482,253485,0,3,0
72421,5,1,253487,253487,253488,0,1,2
72422,5,3,253492,253492,253495,0,3,4
72423,4,3,253496,253496,253499,0,3,1
72424,5,2,253501,253501,253503,0,2,2
72425,2,2,253503,253503,253505,0,2,0
72426,4,1,253507,253507,253508,0,1,2
72427,2,3,253509,253509,253512,0,3,1
72428,2,3,253511,253512,253515,1,4,0
72429,2,1,253513,253515,253516,2,3,0
72430,6,1,253519,253519,253520,0,1,3
72431,6,3,253525,253525,253528,0,3,5
72432,1,3,253526,253528,253531,2,5,0
72433,6,1,253532,253532,253533,0,1,1
72434,1,2,253533,253533,253535,0,2,0
72435,1,1,253534,253535,253536,1,2,0
72436,5,1,253539,253539,253540,0,1,3
72437,5,1,253544,253544,253545,0,1,4
72438,5,1,253549,253549,253550,0,1,4
72439,2,3,253551,253551,253554,0,3,1
72440,6,1,253557,253557,253558,0,1,3
72441,5,2,253562,253562,253564,0,2,4
72442,3,1,253565,253565,253566,0,1,1
72443,1,3,253566,253566,253569,0,3,0
72444,3,3,253569,253569,253572,0,3,0
72445,3,1,253572,253572,253573,0,1,0
72446,6,1,253578,253578,253579,0,1,5
72447,2,1,253580,253580,253581,0,1,1
72448,3,3,253583,253583,253586,0,3,2
72449,2,3,253585,253586,253589,1,4,0
72450,3,3,253588,253589,253592,1,4,0
72451,1,3,253589,253592,253595,3,6,0
72452,4,1,253593,253595,253596,2,3,0
72453,5,2,253598,253598,253600,0,2,2
72454,1,1,253599,253600,253601,1,2,0
72455,6,1,253605,253605,253606,0,1,4
72456,6,3,253611,253611,253614,0,3,5
72457,4,2,253615,253615,253617,0,2,1
72458,5,3,253620,253620,253623,0,3,3
72459,6,2,253626,253626,253628,0,2,3
72460,3,2,253629,253629,253631,0,2,1
72461,3,2,253632,253632,253634,0,2,1
72462,5,2,253637,253637,253639,0,2,3
72463,2,3,253639,253639,253642,0,3,0
72464,5,3,253644,253644,253647,0,3,2
72465,2,1,253646,253647,253648,1,2,0
72466,3,2,253649,253649,253651,0,2,1
72467,1,2,253650,253651,253653,1,3,0
72468,2,2,253652,253653,253655,1,3,0
72469,6,3,253658,253658,253661,0,3,3
72470,3,1,253661,253661,253662,0,1,0
72471,6,3,253667,253667,253670,0,3,5
72472,6,3,253673,253673,253676,0,3,3
72473,4,2,253677,253677,253679,0,2,1
72474,6,3,253683,253683,253686,0,3,4
72475,4,3,253687,253687,253690,0,3,1
72476,1,3,253688,253690,253693,2,5,0
72477,5,1,253693,253693,253694,0,1,0
72478,1,2,253694,253694,253696,0,2,0
72479,5,3,253699,253699,253702,0,3,3
72480,5,2,253704,253704,253706,0,2,2
72481,6,2,253710,253710,253712,0,2,4
72482,6,2,253716,253716,253718,0,2,4
72483,4,1,253720,253720,253721,0,1,2
72484,5,3,253725,253725,253728,0,3,4
72485,4,2,253729,253729,253731,0,2,1
72486,1,2,253730,253731,253733,1,3,0
72487,5,1,253735,253735,253736,0,1,2
72488,1,1,253736,253736,253737,0,1,0
72489,6,2,253742,253742,253744,0,2,5
72490,3,1,253745,253745,253746,0,1,1
72491,4,1,253749,253749,253750,0,1,3
72492,3,3,253752,253752,253755,0,3,2
72493,1,3,253753,253755,253758,2,5,0
72494,2,3,253755,253758,253761,3,6,0
72495,6,1,253761,253761,253762,0,1,0
72496,1,2,253762,253762,253764,0,2,0
72497,1,3,253763,253764,253767,1,4,0
72498,2,1,253765,253767,253768,2,3,0
72499,3,2,253768,253768,253770,0,2,0
72500,1,2,253769,253770,253772,1,3,0
72501,1,1,253770,253772,253773,2,3,0
72502,5,2,253775,253775,253777,0,2,2
72503,1,1,253776,253777,253778,1,2,0
72504,1,2,253777,253778,253780,1,3,0
72505,1,1,253778,253780,253781,2,3,0
72506,4,1,253782,253782,253783,0,1,1
72507,5,3,253787,253787,253790,0,3,4
72508,2,1,253789,253790,253791,1,2,0
72509,1,2,253790,253791,253793,1,3,0
72510,2,1,253792,253793,253794,1,2,0
72511,3,3,253795,253795,253798,0,3,1
72512,2,1,253797,253798,253799,1,2,0
72513,1,1,253798,253799,253800,1,2,0
72514,6,1,253804,253804,253805,0,1,4
72515,6,1,253810,253810,253811,0,1,5
72516,3,2,253813,253813,253815,0,2,2
72517,3,1,253816,253816,253817,0,1,1
72518,1,3,253817,253817,253820,0,3,0
72519,3,3,253820,253820,253823,0,3,0
72520,4,2,253824,253824,253826,0,2,1
72521,3,1,253827,253827,253828,0,1,1
72522,2,1,253829,253829,253830,0,1,1
72523,6,2,253835,253835,253837,0,2,5
72524,3,1,253838,253838,253839,0,1,1
72525,4,2,253842,253842,253844,0,2,3
72526,4,2,253846,253846,253848,0,2,2
72527,5,3,253851,253851,253854,0,3,3
72528,4,3,253855,253855,253858,0,3,1
72529,4,2,253859,253859,253861,0,2,1
72530,5,2,253864,253864,253866,0,2,3
72531,3,2,253867,253867,253869,0,2,1
72532,6,1,253873,253873,253874,0,1,4
72533,3,1,253876,253876,253877,0,1,2
72534,1,2,253877,253877,253879,0,2,0
72535,2,2,253879,253879,253881,0,2,0
72536,2,3,253881,253881,253884,0,3,0
72537,1,3,253882,253884,253887,2,5,0
72538,3,1,253885,253887,253888,2,3,0
72539,2,3,253887,253888,253891,1,4,0
72540,2,2,253889,253891,253893,2,4,0
72541,4,3,253893,253893,253896,0,3,0
72542,2,3,253895,253896,253899,1,4,0
72543,2,2,253897,253899,253901,2,4,0
72544,3,3,253900,253901,253904,1,4,0
72545,5,3,253905,253905,253908,0,3,1
72546,4,2,253909,253909,253911,0,2,1
72547,2,3,253911,253911,253914,0,3,0
72548,6,3,253917,253917,253920,0,3,3
72549,4,2,253921,253921,253923,0,2,1
72550,4,3,253925,253925,253928,0,3,2
72551,2,2,253927,253928,253930,1,3,0
72552,3,2,253930,253930,253932,0,2,0
72553,3,2,253933,253933,253935,0,2,1
72554,2,2,253935,253935,253937,0,2,0
72555,6,1,253941,253941,253942,0,1,4
72556,1,2,253942,253942,253944,0,2,0
72557,5,2,253947,253947,253949,0,2,3
72558,2,1,253949,253949,253950,0,1,0
72559,3,1,253952,253952,253953,0,1,2
72560,5,3,253957,253957,253960,0,3,4
72561,4,2,253961,253961,253963,0,2,1
72562,1,2,253962,253963,253965,1,3,0
72563,5,3,253967,253967,253970,0,3,2
72564,1,2,253968,253970,253972,2,4,0
72565,3,3,253971,253972,253975,1,4,0
72566,5,2,253976,253976,253978,0,2,1
72567,2,3,253978,253978,253981,0,3,0
72568,5,1,253983,253983,253984,0,1,2
72569,1,3,253984,253984,253987,0,3,0
72570,3,2,253987,253987,253989,0,2,0
72571,6,3,253993,253993,253996,0,3,4
72572,5,1,253998,253998,253999,0,1,2
72573,2,2,254000,254000,254002,0,2,1
72574,3,3,254003,254003,254006,0,3,1
72575,3,2,254006,254006,254008,0,2,0
72576,1,1,254007,254008,254009,1,2,0
72577,4,3,254011,254011,254014,0,3,2
72578,3,1,254014,254014,254015,0,1,0
72579,5,1,254019,254019,254020,0,1,4
72580,1,2,254020,254020,254022,0,2,0
72581,6,2,254026,254026,254028,0,2,4
72582,1,2,254027,254028,254030,1,3,0
72583,5,3,254032,254032,254035,0,3,2
72584,1,1,254033,254035,254036,2,3,0
72585,3,3,254036,254036,254039,0,3,0
72586,5,2,254041,254041,254043,0,2,2
72587,1,3,254042,254043,254046,1,4,0
72588,2,3,254044,254046,254049,2,5,0
72589,1,2,254045,254049,254051,4,6,0
72590,6,2,254051,254051,254053,0,2,0
72591,3,3,254054,254054,254057,0,3,1
72592,4,2,254058,254058,254060,0,2,1
72593,1,2,254059,254060,254062,1,3,0
72594,5,3,254064,254064,254067,0,3,2
72595,1,2,254065,254067,254069,2,4,0
72596,3,3,254068,254069,254072,1,4,0
72597,4,3,254072,254072,254075,0,3,0
72598,2,3,254074,254075,254078,1,4,0
72599,6,2,254080,254080,254082,0,2,2
72600,1,2,254081,254082,254084,1,3,0
72601,2,1,254083,254084,254085,1,2,0
72602,2,2,254085,254085,254087,0,2,0
72603,6,3,254091,254091,254094,0,3,4
72604,1,1,254092,254094,254095,2,3,0
72605,6,2,254098,254098,254100,0,2,3
72606,2,1,254100,254100,254101,0,1,0
72607,6,2,254106,254106,254108,0,2,5
72608,6,1,254112,254112,254113,0,1,4
72609,4,2,254116,254116,254118,0,2,3
72610,1,1,254117,254118,254119,1,2,0
72611,3,2,254120,254120,254122,0,2,1
72612,5,3,254125,254125,254128,0,3,3
72613,3,2,254128,254128,254130,0,2,0
72614,4,2,254132,254132,254134,0,2,2
72615,6,3,254138,254138,254141,0,3,4
72616,5,1,254143,254143,254144,0,1,2
72617,5,2,254148,254148,254150,0,2,4
72618,2,3,254150,254150,254153,0,3,0
72619,5,3,254155,254155,254158,0,3,2
72620,3,2,254158,254158,254160,0,2,0
72621,5,2,254163,254163,254165,0,2,3
72622,5,2,254168,254168,254170,0,2,3
72623,5,1,254173,254173,254174,0,1,3
72624,6,2,254179,254179,254181,0,2,5
72625,6,2,254185,254185,254187,0,2,4
72626,5,1,254190,254190,254191,0,1,3
72627,6,1,254196,254196,254197,0,1,5
72628,5,2,254201,254201,254203,0,2,4
72629,4,3,254205,254205,254208,0,3,2
72630,4,2,254209,254209,254211,0,2,1
72631,6,1,254215,254215,254216,0,1,4
72632,3,3,254218,254218,254221,0,3,2
72633,5,2,254223,254223,254225,0,2,2
72634,2,1,254225,254225,254226,0,1,0
72635,2,3,254227,254227,254230,0,3,1
72636,4,2,254231,254231,254233,0,2,1
72637,6,2,254237,254237,254239,0,2,4
72638,1,2,254238,254239,254241,1,3,0
72639,5,2,254243,254243,254245,0,2,2
72640,6,2,254249,254249,254251,0,2,4
72641,4,3,254253,254253,254256,0,3,2
72642,3,3,254256,254256,254259,0,3,0
72643,6,2,254262,254262,254264,0,2,3
72644,4,2,254266,254266,254268,0,2,2
72645,3,3,254269,254269,254272,0,3,1
72646,3,1,254272,254272,254273,0,1,0
72647,2,3,254274,254274,254277,0,3,1
72648,4,2,254278,254278,254280,0,2,1
72649,3,3,254281,254281,254284,0,3,1
72650,3,3,254284,254284,254287,0,3,0
72651,4,1,254288,254288,254289,0,1,1
72652,5,3,254293,254293,254296,0,3,4
72653,4,1,254297,254297,254298,0,1,1
72654,2,3,254299,254299,254302,0,3,1
72655,2,3,254301,254302,254305,1,4,0
72656,1,1,254302,254305,254306,3,4,0
72657,1,2,254303,254306,254308,3,5,0
72658,1,2,254304,254308,254310,4,6,0
72659,6,3,254310,254310,254313,0,3,0
72660,2,1,254312,254313,254314,1,2,0
72661,5,1,254317,254317,254318,0,1,3
72662,4,1,254321,254321,254322,0,1,3
72663,6,1,254327,254327,254328,0,1,5
72664,5,1,254332,254332,254333,0,1,4
72665,1,2,254333,254333,254335,0,2,0
72666,6,1,254339,254339,254340,0,1,4
72667,2,3,254341,254341,254344,0,3,1
72668,2,1,254343,254344,254345,1,2,0
72669,1,3,254344,254345,254348,1,4,0
72670,2,3,254346,254348,254351,2,5,0
72671,3,3,254349,254351,254354,2,5,0
72672,6,3,254355,254355,254358,0,3,1
72673,1,3,254356,254358,254361,2,5,0
72674,6,3,254362,254362,254365,0,3,1
72675,2,2,254364,254365,254367,1,3,0
72676,6,3,254370,254370,254373,0,3,3
72677,3,3,254373,254373,254376,0,3,0
72678,2,2,254375,254376,254378,1,3,0
72679,6,2,254381,254381,254383,0,2,3
72680,1,1,254382,254383,254384,1,2,0
72681,5,2,254387,254387,254389,0,2,3
72682,5,1,254392,254392,254393,0,1,3
72683,2,1,254394,254394,254395,0,1,1
72684,4,2,254398,254398,254400,0,2,3
72685,6,3,254404,254404,254407,0,3,4
72686,4,2,254408,254408,254410,0,2,1
72687,5,2,254413,254413,254415,0,2,3
72688,6,2,254419,254419,254421,0,2,4
72689,3,2,254422,254422,254424,0,2,1
72690,3,1,254425,254425,254426,0,1,1
72691,5,2,254430,254430,254432,0,2,4
72692,5,2,254435,254435,254437,0,2,3
72693,2,3,254437,254437,254440,0,3,0
72694,5,1,254442,254442,254443,0,1,2
72695,2,1,254444,254444,254445,0,1,1
72696,4,2,254448,254448,254450,0,2,3
72697,1,2,254449,254450,254452,1,3,0
72698,2,1,254451,254452,254453,1,2,0
72699,4,2,254455,254455,254457,0,2,2
72700,1,1,254456,254457,254458,1,2,0
72701,5,3,254461,254461,254464,0,3,3
72702,1,1,254462,254464,254465,2,3,0
72703,5,2,254467,254467,254469,0,2,2
72704,2,2,254469,254469,254471,0,2,0
72705,1,1,254470,254471,254472,1,2,0
72706,4,1,254474,254474,254475,0,1,2
72707,6,1,254480,254480,254481,0,1,5
72708,2,3,254482,254482,254485,0,3,1
72709,2,2,254484,254485,254487,1,3,0
72710,3,1,254487,254487,254488,0,1,0
72711,3,3,254490,254490,254493,0,3,2
72712,6,3,254496,254496,254499,0,3,3
72713,3,1,254499,254499,254500,0,1,0
72714,2,3,254501,254501,254504,0,3,1
72715,3,3,254504,254504,254507,0,3,0
72716,4,1,254508,254508,254509,0,1,1
72717,6,1,254514,254514,254515,0,1,5
72718,1,2,254515,254515,254517,0,2,0
72719,1,2,254516,254517,254519,1,3,0
72720,5,3,254521,254521,254524,0,3,2
72721,6,1,254527,254527,254528,0,1,3
72722,5,2,254532,254532,254534,0,2,4
72723,6,2,254538,254538,254540,0,2,4
72724,5,1,254543,254543,254544,0,1,3
72725,5,3,254548,254548,254551,0,3,4
72726,1,1,254549,254551,254552,2,3,0
72727,3,2,254552,254552,254554,0,2,0
72728,1,2,254553,254554,254556,1,3,0
72729,2,2,254555,254556,254558,1,3,0
72730,5,1,254560,254560,254561,0,1,2
72731,1,2,254561,254561,254563,0,2,0
72732,3,2,254564,254564,254566,0,2,1
72733,6,1,254570,254570,254571,0,1,4
72734,2,3,254572,254572,254575,0,3,1
72735,4,2,254576,254576,254578,0,2,1
72736,4,2,254580,254580,254582,0,2,2
72737,3,1,254583,254583,254584,0,1,1
72738,4,1,254587,254587,254588,0,1,3
72739,1,1,254588,254588,254589,0,1,0
72740,6,2,254594,254594,254596,0,2,5
72741,5,3,254599,254599,254602,0,3,3
72742,6,2,254605,254605,254607,0,2,3
72743,3,1,254608,254608,254609,0,1,1
72744,4,2,254612,254612,254614,0,2,3
72745,1,1,254613,254614,254615,1,2,0
72746,3,2,254616,254616,254618,0,2,1
72747,1,1,254617,254618,254619,1,2,0
72748,6,2,254623,254623,254625,0,2,4
72749,2,2,254625,254625,254627,0,2,0
72750,4,1,254629,254629,254630,0,1,2
72751,2,2,254631,254631,254633,0,2,1
72752,2,3,254633,254633,254636,0,3,0
72753,6,1,254639,254639,254640,0,1,3
72754,4,2,254643,254643,254645,0,2,3
72755,4,2,254647,254647,254649,0,2,2
72756,6,3,254653,254653,254656,0,3,4
72757,6,1,254659,254659,254660,0,1,3
72758,5,1,254664,254664,254665,0,1,4
72759,6,2,254670,254670,254672,0,2,5
72760,3,1,254673,254673,254674,0,1,1
72761,6,2,254679,254679,254681,0,2,5
72762,5,1,254684,254684,254685,0,1,3
72763,3,1,254687,254687,254688,0,1,2
72764,2,1,254689,254689,254690,0,1,1
72765,1,2,254690,254690,254692,0,2,0
72766,2,1,254692,254692,254693,0,1,0
72767,6,1,254698,254698,254699,0,1,5
72768,2,2,254700,254700,254702,0,2,1
72769,2,3,254702,254702,254705,0,3,0
72770,3,1,254705,254705,254706,0,1,0
72771,6,2,254711,254711,254713,0,2,5
72772,6,2,254717,254717,254719,0,2,4
72773,5,2,254722,254722,254724,0,2,3
72774,1,2,254723,254724,254726,1,3,0
72775,4,1,254727,254727,254728,0,1,1
72776,2,3,254729,254729,254732,0,3,1
72777,6,1,254735,254735,254736,0,1,3
72778,2,3,254737,254737,254740,0,3,1
72779,1,3,254738,254740,254743,2,5,0
72780,4,1,254742,254743,254744,1,2,0
72781,1,3,254743,254744,254747,1,4,0
72782,6,2,254749,254749,254751,0,2,2
72783,5,2,254754,254754,254756,0,2,3
72784,3,1,254757,254757,254758,0,1,1
72785,6,1,254763,254763,254764,0,1,5
72786,2,3,254765,254765,254768,0,3,1
72787,1,3,254766,254768,254771,2,5,0
72788,1,2,254767,254771,254773,4,6,0
72789,2,2,254769,254773,254775,4,6,0
72790,3,2,254772,254775,254777,3,5,0
72791,1,2,254773,254777,254779,4,6,0
72792,3,2,254776,254779,254781,3,5,0
72793,3,1,254779,254781,254782,2,3,0
72794,1,2,254780,254782,254784,2,4,0
72795,1,1,254781,254784,254785,3,4,0
72796,6,2,254787,254787,254789,0,2,2
72797,2,2,254789,254789,254791,0,2,0
72798,5,2,254794,254794,254796,0,2,3
72799,3,3,254797,254797,254800,0,3,1
72800,5,2,254802,254802,254804,0,2,2
72801,2,2,254804,254804,254806,0,2,0
72802,6,2,254810,254810,254812,0,2,4
72803,6,2,254816,254816,254818,0,2,4
72804,5,3,254821,254821,254824,0,3,3
72805,1,1,254822,254824,254825,2,3,0
72806,3,1,254825,254825,254826,0,1,0
72807,4,2,254829,254829,254831,0,2,3
72808,1,3,254830,254831,254834,1,4,0
72809,3,3,254833,254834,254837,1,4,0
72810,5,1,254838,254838,254839,0,1,1
72811,4,1,254842,254842,254843,0,1,3
72812,6,3,254848,254848,254851,0,3,5
72813,4,1,254852,254852,254853,0,1,1
72814,6,2,254858,254858,254860,0,2,5
72815,1,2,254859,254860,254862,1,3,0
72816,3,1,254862,254862,254863,0,1,0
72817,1,2,254863,254863,254865,0,2,0
72818,2,1,254865,254865,254866,0,1,0
72819,2,3,254867,254867,254870,0,3,1
72820,1,3,254868,254870,254873,2,5,0
72821,2,3,254870,254873,254876,3,6,0
72822,6,1,254876,254876,254877,0,1,0
72823,1,1,254877,254877,254878,0,1,0
72824,6,2,254883,254883,254885,0,2,5
72825,5,3,254888,254888,254891,0,3,3
72826,4,1,254892,254892,254893,0,1,1
72827,3,3,254895,254895,254898,0,3,2
72828,5,3,254900,254900,254903,0,3,2
72829,4,2,254904,254904,254906,0,2,1
72830,6,1,254910,254910,254911,0,1,4
72831,5,2,254915,254915,254917,0,2,4
72832,4,2,254919,254919,254921,0,2,2
72833,6,1,254925,254925,254926,0,1,4
72834,4,3,254929,254929,254932,0,3,3
72835,3,2,254932,254932,254934,0,2,0
72836,4,1,254936,254936,254937,0,1,2
72837,2,2,254938,254938,254940,0,2,1
72838,2,2,254940,254940,254942,0,2,0
72839,5,2,254945,254945,254947,0,2,3
72840,1,1,254946,254947,254948,1,2,0
72841,2,1,254948,254948,254949,0,1,0
72842,4,2,254952,254952,254954,0,2,3
72843,1,1,254953,254954,254955,1,2,0
72844,1,3,254954,254955,254958,1,4,0
72845,2,3,254956,254958,254961,2,5,0
72846,5,2,254961,254961,254963,0,2,0
72847,6,1,254967,254967,254968,0,1,4
72848,2,2,254969,254969,254971,0,2,1
72849,3,3,254972,254972,254975,0,3,1
72850,3,3,254975,254975,254978,0,3,0
72851,5,2,254980,254980,254982,0,2,2
72852,1,1,254981,254982,254983,1,2,0
72853,1,1,254982,254983,254984,1,2,0
72854,3,2,254985,254985,254987,0,2,1
72855,2,3,254987,254987,254990,0,3,0
72856,2,3,254989,254990,254993,1,4,0
72857,3,1,254992,254993,254994,1,2,0
72858,6,2,254998,254998,255000,0,2,4
72859,5,3,255003,255003,255006,0,3,3
72860,2,3,255005,255006,255009,1,4,0
72861,2,3,255007,255009,255012,2,5,0
72862,6,1,255013,255013,255014,0,1,1
72863,3,2,255016,255016,255018,0,2,2
72864,1,1,255017,255018,255019,1,2,0
72865,1,3,255018,255019,255022,1,4,0
72866,2,1,255020,255022,255023,2,3,0
72867,1,1,255021,255023,255024,2,3,0
72868,2,2,255023,255024,255026,1,3,0
72869,5,3,255028,255028,255031,0,3,2
72870,5,3,255033,255033,255036,0,3,2
72871,2,3,255035,255036,255039,1,4,0
72872,1,2,255036,255039,255041,3,5,0
72873,5,2,255041,255041,255043,0,2,0
72874,5,2,255046,255046,255048,0,2,3
72875,3,2,255049,255049,255051,0,2,1
72876,3,1,255052,255052,255053,0,1,1
72877,1,1,255053,255053,255054,0,1,0
72878,4,1,255057,255057,255058,0,1,3
72879,1,3,255058,255058,255061,0,3,0
72880,4,3,255062,255062,255065,0,3,1
72881,6,2,255068,255068,255070,0,2,3
72882,2,1,255070,255070,255071,0,1,0
72883,6,2,255076,255076,255078,0,2,5
72884,3,1,255079,255079,255080,0,1,1
72885,1,1,255080,255080,255081,0,1,0
72886,1,1,255081,255081,255082,0,1,0
72887,6,2,255087,255087,255089,0,2,5
72888,4,1,255091,255091,255092,0,1,2
72889,5,2,255096,255096,255098,0,2,4
72890,1,1,255097,255098,255099,1,2,0
72891,3,2,255100,255100,255102,0,2,1
72892,2,3,255102,255102,255105,0,3,0
72893,5,1,255107,255107,255108,0,1,2
72894,1,2,255108,255108,255110,0,2,0
72895,4,2,255112,255112,255114,0,2,2
72896,3,3,255115,255115,255118,0,3,1
72897,2,3,255117,255118,255121,1,4,0
72898,1,1,255118,255121,255122,3,4,0
72899,1,1,255119,255122,255123,3,4,0
72900,5,1,255124,255124,255125,0,1,1
72901,2,1,255126,255126,255127,0,1,1
72902,6,3,255132,255132,255135,0,3,5
72903,4,2,255136,255136,255138,0,2,1
72904,4,3,255140,255140,255143,0,3,2
72905,4,1,255144,255144,255145,0,1,1
72906,5,1,255149,255149,255150,0,1,4
72907,6,3,255155,255155,255158,0,3,5
72908,5,2,255160,255160,255162,0,2,2
72909,3,1,255163,255163,255164,0,1,1
72910,5,2,255168,255168,255170,0,2,4
72911,1,2,255169,255170,255172,1,3,0
72912,4,1,255173,255173,255174,0,1,1
72913,3,1,255176,255176,255177,0,1,2
72914,2,2,255178,255178,255180,0,2,1
72915,4,2,255182,255182,255184,0,2,2
72916,6,2,255188,255188,255190,0,2,4
72917,3,2,255191,255191,255193,0,2,1
72918,2,1,255193,255193,255194,0,1,0
72919,4,2,255197,255197,255199,0,2,3
72920,6,1,255203,255203,255204,0,1,4
72921,2,3,255205,255205,255208,0,3,1
72922,6,1,255211,255211,255212,0,1,3
72923,3,1,255214,255214,255215,0,1,2
72924,3,3,255217,255217,255220,0,3,2
72925,1,2,255218,255220,255222,2,4,0
72926,2,2,255220,255222,255224,2,4,0
72927,6,2,255226,255226,255228,0,2,2
72928,4,3,255230,255230,255233,0,3,2
72929,2,3,255232,255233,255236,1,4,0
72930,4,1,255236,255236,255237,0,1,0
72931,2,1,255238,255238,255239,0,1,1
72932,3,2,255241,255241,255243,0,2,2
72933,1,3,255242,255243,255246,1,4,0
72934,4,3,255246,255246,255249,0,3,0
72935,3,1,255249,255249,255250,0,1,0
72936,5,3,255254,255254,255257,0,3,4
72937,5,1,255259,255259,255260,0,1,2
72938,1,3,255260,255260,255263,0,3,0
72939,1,2,255261,255263,255265,2,4,0
72940,5,2,255266,255266,255268,0,2,1
72941,3,2,255269,255269,255271,0,2,1
72942,2,3,255271,255271,255274,0,3,0
72943,3,3,255274,255274,255277,0,3,0
72944,4,2,255278,255278,255280,0,2,1
72945,5,1,255283,255283,255284,0,1,3
72946,3,2,255286,255286,255288,0,2,2
72947,5,1,255291,255291,255292,0,1,3
72948,1,2,255292,255292,255294,0,2,0
72949,5,3,255297,255297,255300,0,3,3
72950,4,3,255301,255301,255304,0,3,1
72951,6,2,255307,255307,255309,0,2,3
72952,3,3,255310,255310,255313,0,3,1
72953,6,3,255316,255316,255319,0,3,3
72954,5,3,255321,255321,255324,0,3,2
72955,2,2,255323,255324,255326,1,3,0
72956,6,1,255329,255329,255330,0,1,3
72957,3,1,255332,255332,255333,0,1,2
72958,1,2,255333,255333,255335,0,2,0
72959,5,2,255338,255338,255340,0,2,3
72960,2,3,255340,255340,255343,0,3,0
72961,2,1,255342,255343,255344,1,2,0
72962,5,3,255347,255347,255350,0,3,3
72963,4,3,255351,255351,255354,0,3,1
72964,2,2,255353,255354,255356,1,3,0
72965,4,3,255357,255357,255360,0,3,1
72966,1,3,255358,255360,255363,2,5,0
72967,1,1,255359,255363,255364,4,5,0
72968,5,2,255364,255364,255366,0,2,0
72969,6,1,255370,255370,255371,0,1,4
72970,6,1,255376,255376,255377,0,1,5
72971,1,2,255377,255377,255379,0,2,0
72972,1,3,255378,255379,255382,1,4,0
72973,3,2,255381,255382,255384,1,3,0
72974,2,2,255383,255384,255386,1,3,0
72975,6,1,255389,255389,255390,0,1,3
72976,6,2,255395,255395,255397,0,2,5
72977,3,3,255398,255398,255401,0,3,1
72978,3,2,255401,255401,255403,0,2,0
72979,5,2,255406,255406,255408,0,2,3
72980,3,2,255409,255409,255411,0,2,1
72981,2,3,255411,255411,255414,0,3,0
72982,3,3,255414,255414,255417,0,3,0
72983,6,1,255420,255420,255421,0,1,3
72984,1,3,255421,255421,255424,0,3,0
72985,2,1,255423,255424,255425,1,2,0
72986,5,1,255428,255428,255429,0,1,3
72987,3,3,255431,255431,255434,0,3,2
72988,6,3,255437,255437,255440,0,3,3
72989,6,3,255443,255443,255446,0,3,3
72990,3,2,255446,255446,255448,0,2,0
72991,1,1,255447,255448,255449,1,2,0
72992,6,3,255453,255453,255456,0,3,4
72993,3,3,255456,255456,255459,0,3,0
72994,4,2,255460,255460,255462,0,2,1
72995,1,2,255461,255462,255464,1,3,0
72996,3,2,255464,255464,255466,0,2,0
72997,3,3,255467,255467,255470,0,3,1
72998,1,1,255468,255470,255471,2,3,0
72999,4,1,255472,255472,255473,0,1,1
73000,6,1,255478,255478,255479,0,1,5
73001,6,3,255484,255484,255487,0,3,5
73002,6,3,255490,255490,255493,0,3,3
73003,6,3,255496,255496,255499,0,3,3
73004,2,1,255498,255499,255500,1,2,0
73005,3,2,255501,255501,255503,0,2,1
73006,4,2,255505,255505,255507,0,2,2
73007,5,3,255510,255510,255513,0,3,3
73008,3,1,255513,255513,255514,0,1,0
73009,2,3,255515,255515,255518,0,3,1
73010,4,1,255519,255519,255520,0,1,1
73011,2,2,255521,255521,255523,0,2,1
73012,5,2,255526,255526,255528,0,2,3
73013,6,2,255532,255532,255534,0,2,4
73014,2,2,255534,255534,255536,0,2,0
73015,3,1,255537,255537,255538,0,1,1
73016,5,2,255542,255542,255544,0,2,4
73017,5,1,255547,255547,255548,0,1,3
73018,5,2,255552,255552,255554,0,2,4
73019,4,3,255556,255556,255559,0,3,2
73020,6,3,255562,255562,255565,0,3,3
73021,2,1,255564,255565,255566,1,2,0
73022,2,2,255566,255566,255568,0,2,0
73023,4,3,255570,255570,255573,0,3,2
73024,3,2,255573,255573,255575,0,2,0
73025,2,3,255575,255575,255578,0,3,0
73026,1,2,255576,255578,255580,2,4,0
73027,1,2,255577,255580,255582,3,5,0
73028,1,2,255578,255582,255584,4,6,0
73029,2,1,255580,255584,255585,4,5,0
73030,6,3,255586,255586,255589,0,3,1
73031,5,3,255591,255591,255594,0,3,2
73032,5,2,255596,255596,255598,0,2,2
73033,6,3,255602,255602,255605,0,3,4
73034,6,3,255608,255608,255611,0,3,3
73035,1,2,255609,255611,255613,2,4,0
73036,3,1,255612,255613,255614,1,2,0
73037,2,3,255614,255614,255617,0,3,0
73038,3,3,255617,255617,255620,0,3,0
73039,4,1,255621,255621,255622,0,1,1
73040,1,1,255622,255622,255623,0,1,0
73041,3,3,255625,255625,255628,0,3,2
73042,4,3,255629,255629,255632,0,3,1
73043,3,3,255632,255632,255635,0,3,0
73044,2,1,255634,255635,255636,1,2,0
73045,3,1,255637,255637,255638,0,1,1
73046,4,2,255641,255641,255643,0,2,3
73047,3,2,255644,255644,255646,0,2,1
73048,1,1,255645,255646,255647,1,2,0
73049,4,2,255649,255649,255651,0,2,2
73050,4,1,255653,255653,255654,0,1,2
73051,3,2,255656,255656,255658,0,2,2
73052,4,3,255660,255660,255663,0,3,2
73053,2,2,255662,255663,255665,1,3,0
73054,3,1,255665,255665,255666,0,1,0
73055,6,3,255671,255671,255674,0,3,5
73056,3,1,255674,255674,255675,0,1,0
73057,6,2,255680,255680,255682,0,2,5
73058,6,2,255686,255686,255688,0,2,4
73059,6,3,255692,255692,255695,0,3,4
73060,5,2,255697,255697,255699,0,2,2
73061,1,1,255698,255699,255700,1,2,0
73062,3,1,255701,255701,255702,0,1,1
73063,2,2,255703,255703,255705,0,2,1
73064,1,1,255704,255705,255706,1,2,0
73065,5,1,255709,255709,255710,0,1,3
73066,5,1,255714,255714,255715,0,1,4
73067,4,2,255718,255718,255720,0,2,3
73068,4,2,255722,255722,255724,0,2,2
73069,3,1,255725,255725,255726,0,1,1
73070,5,1,255730,255730,255731,0,1,4
73071,4,2,255734,255734,255736,0,2,3
73072,1,2,255735,255736,255738,1,3,0
73073,1,1,255736,255738,255739,2,3,0
73074,1,1,255737,255739,255740,2,3,0
73075,6,1,255743,255743,255744,0,1,3
73076,4,3,255747,255747,255750,0,3,3
73077,4,1,255751,255751,255752,0,1,1
73078,6,1,255757,255757,255758,0,1,5
73079,3,1,255760,255760,255761,0,1,2
73080,5,2,255765,255765,255767,0,2,4
73081,2,3,255767,255767,255770,0,3,0
73082,3,1,255770,255770,255771,0,1,0
73083,1,2,255771,255771,255773,0,2,0
73084,3,3,255774,255774,255777,0,3,1
73085,3,3,255777,255777,255780,0,3,0
73086,5,2,255782,255782,255784,0,2,2
73087,3,1,255785,255785,255786,0,1,1
73088,2,1,255787,255787,255788,0,1,1
73089,4,1,255791,255791,255792,0,1,3
73090,3,3,255794,255794,255797,0,3,2
73091,2,1,255796,255797,255798,1,2,0
73092,5,1,255801,255801,255802,0,1,3
73093,5,1,255806,255806,255807,0,1,4
73094,4,2,255810,255810,255812,0,2,3
73095,3,2,255813,255813,255815,0,2,1
73096,3,3,255816,255816,255819,0,3,1
73097,4,3,255820,255820,255823,0,3,1
73098,4,1,255824,255824,255825,0,1,1
73099,4,1,255828,255828,255829,0,1,3
73100,6,1,255834,255834,255835,0,1,5
73101,3,1,255837,255837,255838,0,1,2
73102,2,3,255839,255839,255842,0,3,1
73103,2,3,255841,255842,255845,1,4,0
73104,4,2,255845,255845,255847,0,2,0
73105,2,2,255847,255847,255849,0,2,0
73106,4,2,255851,255851,255853,0,2,2
73107,3,3,255854,255854,255857,0,3,1
73108,5,1,255859,255859,255860,0,1,2
73109,6,3,255865,255865,255868,0,3,5
73110,4,2,255869,255869,255871,0,2,1
73111,4,2,255873,255873,255875,0,2,2
73112,6,1,255879,255879,255880,0,1,4
73113,4,1,255883,255883,255884,0,1,3
73114,2,1,255885,255885,255886,0,1,1
73115,3,2,255888,255888,255890,0,2,2
73116,5,2,255893,255893,255895,0,2,3
73117,6,3,255899,255899,255902,0,3,4
73118,3,2,255902,255902,255904,0,2,0
73119,2,1,255904,255904,255905,0,1,0
73120,2,1,255906,255906,255907,0,1,1
73121,2,1,255908,255908,255909,0,1,1
73122,2,2,255910,255910,255912,0,2,1
73123,6,3,255916,255916,255919,0,3,4
73124,3,3,255919,255919,255922,0,3,0
73125,1,3,255920,255922,255925,2,5,0
73126,1,3,255921,255925,255928,4,7,0
73127,4,2,255925,255928,255930,3,5,0
73128,2,2,255927,255930,255932,3,5,0
73129,2,1,255929,255932,255933,3,4,0
73130,2,2,255931,255933,255935,2,4,0
73131,3,2,255934,255935,255937,1,3,0
73132,2,1,255936,255937,255938,1,2,0
73133,5,1,255941,255941,255942,0,1,3
73134,1,2,255942,255942,255944,0,2,0
73135,6,2,255948,255948,255950,0,2,4
73136,5,2,255953,255953,255955,0,2,3
73137,3,2,255956,255956,255958,0,2,1
73138,1,2,255957,255958,255960,1,3,0
73139,5,2,255962,255962,255964,0,2,2
73140,2,3,255964,255964,255967,0,3,0
73141,2,2,255966,255967,255969,1,3,0
73142,5,1,255971,255971,255972,0,1,2
73143,3,3,255974,255974,255977,0,3,2
73144,1,1,255975,255977,255978,2,3,0
73145,1,2,255976,255978,255980,2,4,0
73146,3,3,255979,255980,255983,1,4,0
73147,1,2,255980,255983,255985,3,5,0
73148,5,1,255985,255985,255986,0,1,0
73149,1,1,255986,255986,255987,0,1,0
73150,1,2,255987,255987,255989,0,2,0
73151,5,1,255992,255992,255993,0,1,3
73152,2,3,255994,255994,255997,0,3,1
73153,6,3,256000,256000,256003,0,3,3
73154,4,3,256004,256004,256007,0,3,1
73155,1,1,256005,256007,256008,2,3,0
73156,2,3,256007,256008,256011,1,4,0
73157,3,3,256010,256011,256014,1,4,0
73158,4,2,256014,256014,256016,0,2,0
73159,6,3,256020,256020,256023,0,3,4
73160,3,2,256023,256023,256025,0,2,0
73161,6,1,256029,256029,256030,0,1,4
73162,3,3,256032,256032,256035,0,3,2
73163,6,3,256038,256038,256041,0,3,3
73164,1,1,256039,256041,256042,2,3,0
73165,2,3,256041,256042,256045,1,4,0
73166,4,1,256045,256045,256046,0,1,0
73167,2,2,256047,256047,256049,0,2,1
73168,1,2,256048,256049,256051,1,3,0
73169,6,1,256054,256054,256055,0,1,3
73170,5,1,256059,256059,256060,0,1,4
73171,1,3,256060,256060,256063,0,3,0
73172,2,2,256062,256063,256065,1,3,0
73173,2,3,256064,256065,256068,1,4,0
73174,4,3,256068,256068,256071,0,3,0
73175,3,1,256071,256071,256072,0,1,0
73176,5,3,256076,256076,256079,0,3,4
73177,2,3,256078,256079,256082,1,4,0
73178,5,1,256083,256083,256084,0,1,1
73179,2,2,256085,256085,256087,0,2,1
73180,2,2,256087,256087,256089,0,2,0
73181,2,3,256089,256089,256092,0,3,0
73182,3,2,256092,256092,256094,0,2,0
73183,2,2,256094,256094,256096,0,2,0
73184,6,2,256100,256100,256102,0,2,4
73185,2,3,256102,256102,256105,0,3,0
73186,4,2,256106,256106,256108,0,2,1
73187,6,1,256112,256112,256113,0,1,4
73188,2,2,256114,256114,256116,0,2,1
73189,5,1,256119,256119,256120,0,1,3
73190,2,3,256121,256121,256124,0,3,1
73191,2,3,256123,256124,256127,1,4,0
73192,2,3,256125,256127,256130,2,5,0
73193,2,1,256127,256130,256131,3,4,0
73194,6,3,256133,256133,256136,0,3,2
73195,4,3,256137,256137,256140,0,3,1
73196,2,1,256139,256140,256141,1,2,0
73197,5,3,256144,256144,256147,0,3,3
73198,4,2,256148,256148,256150,0,2,1
73199,1,3,256149,256150,256153,1,4,0
73200,2,1,256151,256153,256154,2,3,0
73201,6,2,256157,256157,256159,0,2,3
73202,4,2,256161,256161,256163,0,2,2
73203,5,1,256166,256166,256167,0,1,3
73204,1,3,256167,256167,256170,0,3,0
73205,3,2,256170,256170,256172,0,2,0
73206,2,1,256172,256172,256173,0,1,0
73207,6,1,256178,256178,256179,0,1,5
73208,2,1,256180,256180,256181,0,1,1
73209,3,1,256183,256183,256184,0,1,2
73210,4,1,256187,256187,256188,0,1,3
73211,2,1,256189,256189,256190,0,1,1
73212,5,1,256194,256194,256195,0,1,4
73213,2,3,256196,256196,256199,0,3,1
73214,1,3,256197,256199,256202,2,5,0
73215,5,1,256202,256202,256203,0,1,0
73216,2,2,256204,256204,256206,0,2,1
73217,4,2,256208,256208,256210,0,2,2
73218,5,1,256213,256213,256214,0,1,3
73219,1,3,256214,256214,256217,0,3,0
73220,6,1,256220,256220,256221,0,1,3
73221,5,1,256225,256225,256226,0,1,4
73222,3,2,256228,256228,256230,0,2,2
73223,4,3,256232,256232,256235,0,3,2
73224,5,3,256237,256237,256240,0,3,2
73225,2,1,256239,256240,256241,1,2,0
73226,1,2,256240,256241,256243,1,3,0
73227,3,2,256243,256243,256245,0,2,0
73228,5,3,256248,256248,256251,0,3,3
73229,5,3,256253,256253,256256,0,3,2
73230,2,1,256255,256256,256257,1,2,0
73231,4,2,256259,256259,256261,0,2,2
73232,5,3,256264,256264,256267,0,3,3
73233,2,1,256266,256267,256268,1,2,0
73234,1,1,256267,256268,256269,1,2,0
73235,6,1,256273,256273,256274,0,1,4
73236,3,2,256276,256276,256278,0,2,2
73237,1,3,256277,256278,256281,1,4,0
73238,3,3,256280,256281,256284,1,4,0
73239,2,2,256282,256284,256286,2,4,0
73240,5,2,256287,256287,256289,0,2,1
73241,3,2,256290,256290,256292,0,2,1
73242,4,2,256294,256294,256296,0,2,2
73243,5,1,256299,256299,256300,0,1,3
73244,6,2,256305,256305,256307,0,2,5
73245,5,1,256310,256310,256311,0,1,3
73246,1,2,256311,256311,256313,0,2,0
73247,3,2,256314,256314,256316,0,2,1
73248,1,2,256315,256316,256318,1,3,0
73249,3,2,256318,256318,256320,0,2,0
73250,5,2,256323,256323,256325,0,2,3
73251,2,1,256325,256325,256326,0,1,0
73252,4,2,256329,256329,256331,0,2,3
73253,6,3,256335,256335,256338,0,3,4
73254,5,3,256340,256340,256343,0,3,2
73255,1,3,256341,256343,256346,2,5,0
73256,4,2,256345,256346,256348,1,3,0
73257,3,3,256348,256348,256351,0,3,0
73258,6,3,256354,256354,256357,0,3,3
73259,6,2,256360,256360,256362,0,2,3
73260,5,3,256365,256365,256368,0,3,3
73261,3,2,256368,256368,256370,0,2,0
73262,2,1,256370,256370,256371,0,1,0
73263,2,1,256372,256372,256373,0,1,1
73264,5,1,256377,256377,256378,0,1,4
73265,3,3,256380,256380,256383,0,3,2
73266,1,1,256381,256383,256384,2,3,0
73267,4,2,256385,256385,256387,0,2,1
73268,1,3,256386,256387,256390,1,4,0
73269,4,1,256390,256390,256391,0,1,0
73270,2,2,256392,256392,256394,0,2,1
73271,5,3,256397,256397,256400,0,3,3
73272,5,2,256402,256402,256404,0,2,2
73273,6,2,256408,256408,256410,0,2,4
73274,4,3,256412,256412,256415,0,3,2
73275,3,2,256415,256415,256417,0,2,0
73276,2,1,256417,256417,256418,0,1,0
73277,5,3,256422,256422,256425,0,3,4
73278,4,3,256426,256426,256429,0,3,1
73279,2,1,256428,256429,256430,1,2,0
73280,1,2,256429,256430,256432,1,3,0
73281,3,1,256432,256432,256433,0,1,0
73282,6,1,256438,256438,256439,0,1,5
73283,5,2,256443,256443,256445,0,2,4
73284,6,1,256449,256449,256450,0,1,4
73285,4,3,256453,256453,256456,0,3,3
73286,3,3,256456,256456,256459,0,3,0
73287,2,1,256458,256459,256460,1,2,0
73288,5,1,256463,256463,256464,0,1,3
73289,3,3,256466,256466,256469,0,3,2
73290,3,1,256469,256469,256470,0,1,0
73291,1,1,256470,256470,256471,0,1,0
73292,6,2,256476,256476,256478,0,2,5
73293,6,2,256482,256482,256484,0,2,4
73294,5,2,256487,256487,256489,0,2,3
73295,2,2,256489,256489,256491,0,2,0
73296,1,1,256490,256491,256492,1,2,0
73297,2,2,256492,256492,256494,0,2,0
73298,5,1,256497,256497,256498,0,1,3
73299,5,2,256502,256502,256504,0,2,4
73300,6,2,256508,256508,256510,0,2,4
73301,4,2,256512,256512,256514,0,2,2
73302,2,3,256514,256514,256517,0,3,0
73303,3,1,256517,256517,256518,0,1,0
73304,1,3,256518,256518,256521,0,3,0
73305,4,2,256522,256522,256524,0,2,1
73306,6,2,256528,256528,256530,0,2,4
73307,1,1,256529,256530,256531,1,2,0
73308,4,1,256533,256533,256534,0,1,2
73309,5,3,256538,256538,256541,0,3,4
73310,2,3,256540,256541,256544,1,4,0
73311,3,2,256543,256544,256546,1,3,0
73312,5,3,256548,256548,256551,0,3,2
73313,2,3,256550,256551,256554,1,4,0
73314,6,2,256556,256556,256558,0,2,2
73315,5,1,256561,256561,256562,0,1,3
73316,4,1,256565,256565,256566,0,1,3
73317,2,2,256567,256567,256569,0,2,1
73318,2,2,256569,256569,256571,0,2,0
73319,3,1,256572,256572,256573,0,1,1
73320,5,2,256577,256577,256579,0,2,4
73321,4,3,256581,256581,256584,0,3,2
73322,5,1,256586,256586,256587,0,1,2
73323,3,2,256589,256589,256591,0,2,2
73324,3,1,256592,256592,256593,0,1,1
73325,1,2,256593,256593,256595,0,2,0
73326,2,2,256595,256595,256597,0,2,0
73327,2,2,256597,256597,256599,0,2,0
73328,5,1,256602,256602,256603,0,1,3
73329,6,3,256608,256608,256611,0,3,5
73330,2,3,256610,256611,256614,1,4,0
73331,1,3,256611,256614,256617,3,6,0
73332,2,3,256613,256617,256620,4,7,0
73333,3,2,256616,256620,256622,4,6,0
73334,2,2,256618,256622,256624,4,6,0
73335,4,2,256622,256624,256626,2,4,0
73336,2,3,256624,256626,256629,2,5,0
73337,1,3,256625,256629,256632,4,7,0
73338,5,1,256630,256632,256633,2,3,0
73339,4,1,256634,256634,256635,0,1,1
73340,5,2,256639,256639,256641,0,2,4
73341,4,2,256643,256643,256645,0,2,2
73342,5,2,256648,256648,256650,0,2,3
73343,2,3,256650,256650,256653,0,3,0
73344,5,2,256655,256655,256657,0,2,2
73345,6,2,256661,256661,256663,0,2,4
73346,1,3,256662,256663,256666,1,4,0
73347,4,1,256666,256666,256667,0,1,0
73348,1,3,256667,256667,256670,0,3,0
73349,6,3,256673,256673,256676,0,3,3
73350,1,1,256674,256676,256677,2,3,0
73351,4,3,256678,256678,256681,0,3,1
73352,4,2,256682,256682,256684,0,2,1
73353,3,3,256685,256685,256688,0,3,1
73354,2,1,256687,256688,256689,1,2,0
73355,6,2,256693,256693,256695,0,2,4
73356,2,3,256695,256695,256698,0,3,0
73357,3,3,256698,256698,256701,0,3,0
73358,2,2,256700,256701,256703,1,3,0
73359,1,1,256701,256703,256704,2,3,0
73360,6,2,256707,256707,256709,0,2,3
73361,2,3,256709,256709,256712,0,3,0
73362,2,2,256711,256712,256714,1,3,0
73363,6,2,256717,256717,256719,0,2,3
73364,6,3,256723,256723,256726,0,3,4
73365,1,3,256724,256726,256729,2,5,0
73366,4,2,256728,256729,256731,1,3,0
73367,2,2,256730,256731,256733,1,3,0
73368,5,3,256735,256735,256738,0,3,2
73369,4,1,256739,256739,256740,0,1,1
73370,3,2,256742,256742,256744,0,2,2
73371,2,1,256744,256744,256745,0,1,0
73372,2,1,256746,256746,256747,0,1,1
73373,1,2,256747,256747,256749,0,2,0
73374,3,2,256750,256750,256752,0,2,1
73375,4,2,256754,256754,256756,0,2,2
73376,2,3,256756,256756,256759,0,3,0
73377,4,1,256760,256760,256761,0,1,1
73378,1,1,256761,256761,256762,0,1,0
73379,6,1,256767,256767,256768,0,1,5
73380,3,2,256770,256770,256772,0,2,2
73381,1,1,256771,256772,256773,1,2,0
73382,6,1,256777,256777,256778,0,1,4
73383,4,2,256781,256781,256783,0,2,3
73384,4,2,256785,256785,256787,0,2,2
73385,3,1,256788,256788,256789,0,1,1
73386,4,3,256792,256792,256795,0,3,3
73387,2,3,256794,256795,256798,1,4,0
73388,4,3,256798,256798,256801,0,3,0
73389,1,1,256799,256801,256802,2,3,0
73390,3,3,256802,256802,256805,0,3,0
73391,1,1,256803,256805,256806,2,3,0
73392,3,2,256806,256806,256808,0,2,0
73393,5,2,256811,256811,256813,0,2,3
73394,4,3,256815,256815,256818,0,3,2
73395,3,2,256818,256818,256820,0,2,0
73396,5,3,256823,256823,256826,0,3,3
73397,4,1,256827,256827,256828,0,1,1
73398,3,3,256830,256830,256833,0,3,2
73399,1,2,256831,256833,256835,2,4,0
73400,1,2,256832,256835,256837,3,5,0
73401,5,3,256837,256837,256840,0,3,0
73402,2,2,256839,256840,256842,1,3,0
73403,3,3,256842,256842,256845,0,3,0
73404,2,2,256844,256845,256847,1,3,0
73405,6,1,256850,256850,256851,0,1,3
73406,1,3,256851,256851,256854,0,3,0
73407,5,3,256856,256856,256859,0,3,2
73408,2,2,256858,256859,256861,1,3,0
73409,4,3,256862,256862,256865,0,3,1
73410,5,2,256867,256867,256869,0,2,2
73411,1,1,256868,256869,256870,1,2,0
73412,6,2,256874,256874,256876,0,2,4
73413,2,3,256876,256876,256879,0,3,0
73414,5,3,256881,256881,256884,0,3,2
73415,4,1,256885,256885,256886,0,1,1
73416,6,2,256891,256891,256893,0,2,5
73417,2,3,256893,256893,256896,0,3,0
73418,4,3,256897,256897,256900,0,3,1
73419,4,3,256901,256901,256904,0,3,1
73420,2,1,256903,256904,256905,1,2,0
73421,1,1,256904,256905,256906,1,2,0
73422,1,1,256905,256906,256907,1,2,0
73423,1,3,256906,256907,256910,1,4,0
73424,5,1,256911,256911,256912,0,1,1
73425,4,2,256915,256915,256917,0,2,3
73426,3,2,256918,256918,256920,0,2,1
73427,6,1,256924,256924,256925,0,1,4
73428,3,2,256927,256927,256929,0,2,2
73429,2,2,256929,256929,256931,0,2,0
73430,4,1,256933,256933,256934,0,1,2
73431,5,3,256938,256938,256941,0,3,4
73432,5,1,256943,256943,256944,0,1,2
73433,5,1,256948,256948,256949,0,1,4
73434,4,2,256952,256952,256954,0,2,3
73435,5,2,256957,256957,256959,0,2,3
73436,3,2,256960,256960,256962,0,2,1
73437,1,2,256961,256962,256964,1,3,0
73438,5,3,256966,256966,256969,0,3,2
73439,2,3,256968,256969,256972,1,4,0
73440,1,1,256969,256972,256973,3,4,0
73441,6,2,256975,256975,256977,0,2,2
73442,5,3,256980,256980,256983,0,3,3
73443,6,2,256986,256986,256988,0,2,3
73444,3,1,256989,256989,256990,0,1,1
73445,5,2,256994,256994,256996,0,2,4
73446,2,1,256996,256996,256997,0,1,0
73447,2,3,256998,256998,257001,0,3,1
73448,4,1,257002,257002,257003,0,1,1
73449,4,2,257006,257006,257008,0,2,3
73450,3,2,257009,257009,257011,0,2,1
73451,4,2,257013,257013,257015,0,2,2
73452,5,1,257018,257018,257019,0,1,3
73453,6,2,257024,257024,257026,0,2,5
73454,5,3,257029,257029,257032,0,3,3
73455,6,3,257035,257035,257038,0,3,3
73456,5,1,257040,257040,257041,0,1,2
73457,2,2,257042,257042,257044,0,2,1
73458,4,3,257046,257046,257049,0,3,2
73459,3,2,257049,257049,257051,0,2,0
73460,6,3,257055,257055,257058,0,3,4
73461,1,2,257056,257058,257060,2,4,0
73462,5,3,257061,257061,257064,0,3,1
73463,3,1,257064,257064,257065,0,1,0
73464,2,2,257066,257066,257068,0,2,1
73465,6,3,257072,257072,257075,0,3,4
73466,3,2,257075,257075,257077,0,2,0
73467,6,1,257081,257081,257082,0,1,4
73468,5,3,257086,257086,257089,0,3,4
73469,2,2,257088,257089,257091,1,3,0
73470,2,1,257090,257091,257092,1,2,0
73471,2,2,257092,257092,257094,0,2,0
73472,1,2,257093,257094,257096,1,3,0
73473,2,2,257095,257096,257098,1,3,0
73474,6,2,257101,257101,257103,0,2,3
73475,6,3,257107,257107,257110,0,3,4
73476,4,2,257111,257111,257113,0,2,1
73477,3,2,257114,257114,257116,0,2,1
73478,2,2,257116,257116,257118,0,2,0
73479,5,3,257121,257121,257124,0,3,3
73480,1,1,257122,257124,257125,2,3,0
73481,3,2,257125,257125,257127,0,2,0
73482,3,2,257128,257128,257130,0,2,1
73483,4,3,257132,257132,257135,0,3,2
73484,6,2,257138,257138,257140,0,2,3
73485,2,1,257140,257140,257141,0,1,0
73486,2,3,257142,257142,257145,0,3,1
73487,2,3,257144,257145,257148,1,4,0
73488,3,3,257147,257148,257151,1,4,0
73489,3,2,257150,257151,257153,1,3,0
73490,3,3,257153,257153,257156,0,3,0
73491,2,1,257155,257156,257157,1,2,0
73492,1,3,257156,257157,257160,1,4,0
73493,3,2,257159,257160,257162,1,3,0
73494,3,2,257162,257162,257164,0,2,0
73495,1,1,257163,257164,257165,1,2,0
73496,4,2,257167,257167,257169,0,2,2
73497,5,2,257172,257172,257174,0,2,3
73498,1,2,257173,257174,257176,1,3,0
73499,1,3,257174,257176,257179,2,5,0
73500,2,2,257176,257179,257181,3,5,0
73501,2,1,257178,257181,257182,3,4,0
73502,6,2,257184,257184,257186,0,2,2
73503,3,1,257187,257187,257188,0,1,1
73504,6,3,257193,257193,257196,0,3,5
73505,6,3,257199,257199,257202,0,3,3
73506,4,1,257203,257203,257204,0,1,1
73507,5,1,257208,257208,257209,0,1,4
73508,2,2,257210,257210,257212,0,2,1
73509,5,2,257215,257215,257217,0,2,3
73510,3,2,257218,257218,257220,0,2,1
73511,3,2,257221,257221,257223,0,2,1
73512,1,3,257222,257223,257226,1,4,0
73513,3,1,257225,257226,257227,1,2,0
73514,3,2,257228,257228,257230,0,2,1
73515,1,1,257229,257230,257231,1,2,0
73516,4,1,257233,257233,257234,0,1,2
73517,2,2,257235,257235,257237,0,2,1
73518,1,3,257236,257237,257240,1,4,0
73519,2,1,257238,257240,257241,2,3,0
73520,5,2,257243,257243,257245,0,2,2
73521,6,3,257249,257249,257252,0,3,4
73522,3,2,257252,257252,257254,0,2,0
73523,1,1,257253,257254,257255,1,2,0
73524,2,1,257255,257255,257256,0,1,0
73525,1,1,257256,257256,257257,0,1,0
73526,2,1,257258,257258,257259,0,1,1
73527,1,1,257259,257259,257260,0,1,0
73528,3,2,257262,257262,257264,0,2,2
73529,6,1,257268,257268,257269,0,1,4
73530,2,2,257270,257270,257272,0,2,1
73531,4,2,257274,257274,257276,0,2,2
73532,3,1,257277,257277,257278,0,1,1
73533,1,2,257278,257278,257280,0,2,0
73534,6,3,257284,257284,257287,0,3,4
73535,3,2,257287,257287,257289,0,2,0
73536,6,1,257293,257293,257294,0,1,4
73537,4,2,257297,257297,257299,0,2,3
73538,2,2,257299,257299,257301,0,2,0
73539,5,2,257304,257304,257306,0,2,3
73540,4,1,257308,257308,257309,0,1,2
73541,6,1,257314,257314,257315,0,1,5
73542,5,3,257319,257319,257322,0,3,4
73543,5,3,257324,257324,257327,0,3,2
73544,3,3,257327,257327,257330,0,3,0
73545,6,1,257333,257333,257334,0,1,3
73546,5,2,257338,257338,257340,0,2,4
73547,4,1,257342,257342,257343,0,1,2
73548,1,2,257343,257343,257345,0,2,0
73549,6,2,257349,257349,257351,0,2,4
73550,3,2,257352,257352,257354,0,2,1
73551,5,3,257357,257357,257360,0,3,3
73552,5,1,257362,257362,257363,0,1,2
73553,6,3,257368,257368,257371,0,3,5
73554,4,2,257372,257372,257374,0,2,1
73555,1,1,257373,257374,257375,1,2,0
73556,4,1,257377,257377,257378,0,1,2
73557,2,2,257379,257379,257381,0,2,1
73558,5,2,257384,257384,257386,0,2,3
73559,6,3,257390,257390,257393,0,3,4
73560,3,1,257393,257393,257394,0,1,0
73561,6,1,257399,257399,257400,0,1,5
73562,2,2,257401,257401,257403,0,2,1
73563,3,3,257404,257404,257407,0,3,1
73564,5,2,257409,257409,257411,0,2,2
73565,5,2,257414,257414,257416,0,2,3
73566,2,2,257416,257416,257418,0,2,0
73567,2,3,257418,257418,257421,0,3,0
73568,1,2,257419,257421,257423,2,4,0
73569,2,2,257421,257423,257425,2,4,0
73570,1,1,257422,257425,257426,3,4,0
73571,1,2,257423,257426,257428,3,5,0
73572,1,3,257424,257428,257431,4,7,0
73573,4,1,257428,257431,257432,3,4,0
73574,1,1,257429,257432,257433,3,4,0
73575,5,3,257434,257434,257437,0,3,1
73576,5,1,257439,257439,257440,0,1,2
73577,1,3,257440,257440,257443,0,3,0
73578,2,3,257442,257443,257446,1,4,0
73579,1,2,257443,257446,257448,3,5,0
73580,2,2,257445,257448,257450,3,5,0
73581,1,1,257446,257450,257451,4,5,0
73582,6,3,257452,257452,257455,0,3,1
73583,4,3,257456,257456,257459,0,3,1
73584,5,1,257461,257461,257462,0,1,2
73585,4,2,257465,257465,257467,0,2,3
73586,6,3,257471,257471,257474,0,3,4
73587,3,3,257474,257474,257477,0,3,0
73588,6,2,257480,257480,257482,0,2,3
73589,3,2,257483,257483,257485,0,2,1
73590,1,3,257484,257485,257488,1,4,0
73591,3,3,257487,257488,257491,1,4,0
73592,5,1,257492,257492,257493,0,1,1
73593,1,2,257493,257493,257495,0,2,0
73594,6,1,257499,257499,257500,0,1,4
73595,6,1,257505,257505,257506,0,1,5
73596,5,2,257510,257510,257512,0,2,4
73597,1,3,257511,257512,257515,1,4,0
73598,1,2,257512,257515,257517,3,5,0
73599,5,1,257517,257517,257518,0,1,0
73600,1,2,257518,257518,257520,0,2,0
73601,6,1,257524,257524,257525,0,1,4
73602,6,1,257530,257530,257531,0,1,5
73603,1,3,257531,257531,257534,0,3,0
73604,6,1,257537,257537,257538,0,1,3
73605,5,2,257542,257542,257544,0,2,4
73606,3,3,257545,257545,257548,0,3,1
73607,2,3,257547,257548,257551,1,4,0
73608,1,1,257548,257551,257552,3,4,0
73609,4,2,257552,257552,257554,0,2,0
73610,4,1,257556,257556,257557,0,1,2
73611,6,2,257562,257562,257564,0,2,5
73612,6,3,257568,257568,257571,0,3,4
73613,5,2,257573,257573,257575,0,2,2
73614,6,2,257579,257579,257581,0,2,4
73615,6,2,257585,257585,257587,0,2,4
73616,4,3,257589,257589,257592,0,3,2
73617,6,2,257595,257595,257597,0,2,3
73618,3,1,257598,257598,257599,0,1,1
73619,3,2,257601,257601,257603,0,2,2
73620,1,2,257602,257603,257605,1,3,0
73621,3,2,257605,257605,257607,0,2,0
73622,2,2,257607,257607,257609,0,2,0
73623,4,2,257611,257611,257613,0,2,2
73624,3,1,257614,257614,257615,0,1,1
73625,5,2,257619,257619,257621,0,2,4
73626,5,3,257624,257624,257627,0,3,3
73627,1,3,257625,257627,257630,2,5,0
73628,4,2,257629,257630,257632,1,3,0
73629,5,3,257634,257634,257637,0,3,2
73630,5,1,257639,257639,257640,0,1,2
73631,1,1,257640,257640,257641,0,1,0
73632,5,3,257645,257645,257648,0,3,4
73633,5,3,257650,257650,257653,0,3,2
73634,2,1,257652,257653,257654,1,2,0
73635,5,3,257657,257657,257660,0,3,3
73636,2,3,257659,257660,257663,1,4,0
73637,6,2,257665,257665,257667,0,2,2
73638,5,2,257670,257670,257672,0,2,3
73639,4,3,257674,257674,257677,0,3,2
73640,2,2,257676,257677,257679,1,3,0
73641,4,2,257680,257680,257682,0,2,1
73642,1,3,257681,257682,257685,1,4,0
73643,2,1,257683,257685,257686,2,3,0
73644,4,1,257687,257687,257688,0,1,1
73645,1,3,257688,257688,257691,0,3,0
73646,5,3,257693,257693,257696,0,3,2
73647,3,1,257696,257696,257697,0,1,0
73648,6,1,257702,257702,257703,0,1,5
73649,2,2,257704,257704,257706,0,2,1
73650,3,3,257707,257707,257710,0,3,1
73651,2,2,257709,257710,257712,1,3,0
73652,3,1,257712,257712,257713,0,1,0
73653,6,3,257718,257718,257721,0,3,5
73654,3,2,257721,257721,257723,0,2,0
73655,6,3,257727,257727,257730,0,3,4
73656,4,1,257731,257731,257732,0,1,1
73657,4,2,257735,257735,257737,0,2,3
73658,4,3,257739,257739,257742,0,3,2
73659,4,1,257743,257743,257744,0,1,1
73660,4,1,257747,257747,257748,0,1,3
73661,5,1,257752,257752,257753,0,1,4
73662,3,2,257755,257755,257757,0,2,2
73663,2,1,257757,257757,257758,0,1,0
73664,3,2,257760,257760,257762,0,2,2
73665,6,3,257766,257766,257769,0,3,4
73666,4,2,257770,257770,257772,0,2,1
73667,3,1,257773,257773,257774,0,1,1
73668,6,1,257779,257779,257780,0,1,5
73669,6,1,257785,257785,257786,0,1,5
73670,6,3,257791,257791,257794,0,3,5
73671,3,3,257794,257794,257797,0,3,0
73672,4,3,257798,257798,257801,0,3,1
73673,6,1,257804,257804,257805,0,1,3
73674,6,1,257810,257810,257811,0,1,5
73675,2,2,257812,257812,257814,0,2,1
73676,4,3,257816,257816,257819,0,3,2
73677,3,2,257819,257819,257821,0,2,0
73678,6,2,257825,257825,257827,0,2,4
73679,2,2,257827,257827,257829,0,2,0
73680,2,2,257829,257829,257831,0,2,0
73681,6,3,257835,257835,257838,0,3,4
73682,6,2,257841,257841,257843,0,2,3
73683,4,1,257845,257845,257846,0,1,2
73684,2,3,257847,257847,257850,0,3,1
73685,3,2,257850,257850,257852,0,2,0
73686,5,2,257855,257855,257857,0,2,3
73687,2,1,257857,257857,257858,0,1,0
73688,2,1,257859,257859,257860,0,1,1
73689,4,3,257863,257863,257866,0,3,3
73690,5,1,257868,257868,257869,0,1,2
73691,3,1,257871,257871,257872,0,1,2
73692,6,1,257877,257877,257878,0,1,5
73693,5,2,257882,257882,257884,0,2,4
73694,6,3,257888,257888,257891,0,3,4
73695,1,2,257889,257891,257893,2,4,0
73696,2,1,257891,257893,257894,2,3,0
73697,4,3,257895,257895,257898,0,3,1
73698,3,2,257898,257898,257900,0,2,0
73699,6,3,257904,257904,257907,0,3,4
73700,3,1,257907,257907,257908,0,1,0
73701,5,3,257912,257912,257915,0,3,4
73702,5,3,257917,257917,257920,0,3,2
73703,3,2,257920,257920,257922,0,2,0
73704,6,3,257926,257926,257929,0,3,4
73705,4,1,257930,257930,257931,0,1,1
73706,4,2,257934,257934,257936,0,2,3
73707,1,1,257935,257936,257937,1,2,0
73708,4,2,257939,257939,257941,0,2,2
73709,5,2,257944,257944,257946,0,2,3
73710,4,1,257948,257948,257949,0,1,2
73711,4,1,257952,257952,257953,0,1,3
73712,2,2,257954,257954,257956,0,2,1
73713,1,3,257955,257956,257959,1,4,0
73714,2,3,257957,257959,257962,2,5,0
73715,4,3,257961,257962,257965,1,4,0
73716,2,2,257963,257965,257967,2,4,0
73717,5,1,257968,257968,257969,0,1,1
73718,2,2,257970,257970,257972,0,2,1
73719,3,2,257973,257973,257975,0,2,1
73720,4,3,257977,257977,257980,0,3,2
73721,2,2,257979,257980,257982,1,3,0
73722,5,3,257984,257984,257987,0,3,2
73723,6,1,257990,257990,257991,0,1,3
73724,5,3,257995,257995,257998,0,3,4
73725,5,3,258000,258000,258003,0,3,2
73726,6,1,258006,258006,258007,0,1,3
73727,6,2,258012,258012,258014,0,2,5
73728,3,3,258015,258015,258018,0,3,1
73729,3,1,258018,258018,258019,0,1,0
73730,4,2,258022,258022,258024,0,2,3
73731,3,1,258025,258025,258026,0,1,1
73732,5,1,258030,258030,258031,0,1,4
73733,1,3,258031,258031,258034,0,3,0
73734,5,2,258036,258036,258038,0,2,2
73735,1,3,258037,258038,258041,1,4,0
73736,3,3,258040,258041,258044,1,4,0
73737,5,1,258045,258045,258046,0,1,1
73738,4,1,258049,258049,258050,0,1,3
73739,3,2,258052,258052,258054,0,2,2
73740,2,1,258054,258054,258055,0,1,0
73741,2,3,258056,258056,258059,0,3,1
73742,3,3,258059,258059,258062,0,3,0
73743,1,2,258060,258062,258064,2,4,0
73744,5,3,258065,258065,258068,0,3,1
73745,5,2,258070,258070,258072,0,2,2
73746,4,1,258074,258074,258075,0,1,2
73747,3,2,258077,258077,258079,0,2,2
73748,6,3,258083,258083,258086,0,3,4
73749,4,1,258087,258087,258088,0,1,1
73750,4,1,258091,258091,258092,0,1,3
73751,6,2,258097,258097,258099,0,2,5
73752,6,3,258103,258103,258106,0,3,4
73753,5,1,258108,258108,258109,0,1,2
73754,3,2,258111,258111,258113,0,2,2
73755,1,1,258112,258113,258114,1,2,0
73756,3,3,258115,258115,258118,0,3,1
73757,6,2,258121,258121,258123,0,2,3
73758,5,2,258126,258126,258128,0,2,3
73759,4,3,258130,258130,258133,0,3,2
73760,5,3,258135,258135,258138,0,3,2
73761,2,1,258137,258138,258139,1,2,0
73762,3,1,258140,258140,258141,0,1,1
73763,6,1,258146,258146,258147,0,1,5
73764,4,1,258150,258150,258151,0,1,3
73765,2,1,258152,258152,258153,0,1,1
73766,6,2,258158,258158,258160,0,2,5
73767,1,3,258159,258160,258163,1,4,0
73768,4,3,258163,258163,258166,0,3,0
73769,6,1,258169,258169,258170,0,1,3
73770,1,3,258170,258170,258173,0,3,0
73771,4,3,258174,258174,258177,0,3,1
73772,3,3,258177,258177,258180,0,3,0
73773,2,1,258179,258180,258181,1,2,0
73774,1,3,258180,258181,258184,1,4,0
73775,1,1,258181,258184,258185,3,4,0
73776,6,3,258187,258187,258190,0,3,2
73777,2,3,258189,258190,258193,1,4,0
73778,3,3,258192,258193,258196,1,4,0
73779,4,1,258196,258196,258197,0,1,0
73780,3,3,258199,258199,258202,0,3,2
73781,1,3,258200,258202,258205,2,5,0
73782,4,1,258204,258205,258206,1,2,0
73783,4,2,258208,258208,258210,0,2,2
73784,1,1,258209,258210,258211,1,2,0
73785,3,2,258212,258212,258214,0,2,1
73786,1,1,258213,258214,258215,1,2,0
73787,2,1,258215,258215,258216,0,1,0
73788,5,1,258220,258220,258221,0,1,4
73789,1,1,258221,258221,258222,0,1,0
73790,6,2,258227,258227,258229,0,2,5
73791,6,1,258233,258233,258234,0,1,4
73792,1,1,258234,258234,258235,0,1,0
73793,6,2,258240,258240,258242,0,2,5
73794,1,2,258241,258242,258244,1,3,0
73795,2,3,258243,258244,258247,1,4,0
73796,6,3,258249,258249,258252,0,3,2
73797,2,3,258251,258252,258255,1,4,0
73798,6,2,258257,258257,258259,0,2,2
73799,1,3,258258,258259,258262,1,4,0
73800,6,3,258264,258264,258267,0,3,2
73801,5,3,258269,258269,258272,0,3,2
73802,1,3,258270,258272,258275,2,5,0
73803,3,3,258273,258275,258278,2,5,0
73804,4,2,258277,258278,258280,1,3,0
73805,4,3,258281,258281,258284,0,3,1
73806,4,3,258285,258285,258288,0,3,1
73807,4,3,258289,258289,258292,0,3,1
73808,4,1,258293,258293,258294,0,1,1
73809,6,1,258299,258299,258300,0,1,5
73810,5,2,258304,258304,258306,0,2,4
73811,1,2,258305,258306,258308,1,3,0
73812,2,3,258307,258308,258311,1,4,0
73813,6,3,258313,258313,258316,0,3,2
73814,1,1,258314,258316,258317,2,3,0
73815,2,1,258316,258317,258318,1,2,0
73816,4,3,258320,258320,258323,0,3,2
73817,2,1,258322,258323,258324,1,2,0
73818,2,2,258324,258324,258326,0,2,0
73819,4,1,258328,258328,258329,0,1,2
73820,1,2,258329,258329,258331,0,2,0
73821,1,2,258330,258331,258333,1,3,0
73822,4,1,258334,258334,258335,0,1,1
73823,2,2,258336,258336,258338,0,2,1
73824,4,2,258340,258340,258342,0,2,2
73825,5,2,258345,258345,258347,0,2,3
73826,6,3,258351,258351,258354,0,3,4
73827,5,3,258356,258356,258359,0,3,2
73828,6,2,258362,258362,258364,0,2,3
73829,5,3,258367,258367,258370,0,3,3
73830,6,1,258373,258373,258374,0,1,3
73831,2,3,258375,258375,258378,0,3,1
73832,5,2,258380,258380,258382,0,2,2
73833,1,1,258381,258382,258383,1,2,0
73834,6,3,258387,258387,258390,0,3,4
73835,6,1,258393,258393,258394,0,1,3
73836,6,1,258399,258399,258400,0,1,5
73837,1,1,258400,258400,258401,0,1,0
73838,4,3,258404,258404,258407,0,3,3
73839,4,1,258408,258408,258409,0,1,1
73840,5,3,258413,258413,258416,0,3,4
73841,2,3,258415,258416,258419,1,4,0
73842,3,1,258418,258419,258420,1,2,0
73843,2,2,258420,258420,258422,0,2,0
73844,4,2,258424,258424,258426,0,2,2
73845,5,1,258429,258429,258430,0,1,3
73846,3,2,258432,258432,258434,0,2,2
73847,5,2,258437,258437,258439,0,2,3
73848,4,3,258441,258441,258444,0,3,2
73849,5,1,258446,258446,258447,0,1,2
73850,1,2,258447,258447,258449,0,2,0
73851,3,3,258450,258450,258453,0,3,1
73852,3,3,258453,258453,258456,0,3,0
73853,4,2,258457,258457,258459,0,2,1
73854,6,3,258463,258463,258466,0,3,4
73855,5,1,258468,258468,258469,0,1,2
73856,1,1,258469,258469,258470,0,1,0
73857,4,1,258473,258473,258474,0,1,3
73858,2,3,258475,258475,258478,0,3,1
73859,3,1,258478,258478,258479,0,1,0
73860,4,1,258482,258482,258483,0,1,3
73861,6,3,258488,258488,258491,0,3,5
73862,2,1,258490,258491,258492,1,2,0
73863,1,1,258491,258492,258493,1,2,0
73864,6,2,258497,258497,258499,0,2,4
73865,5,1,258502,258502,258503,0,1,3
73866,5,3,258507,258507,258510,0,3,4
73867,5,1,258512,258512,258513,0,1,2
73868,2,3,258514,258514,258517,0,3,1
73869,5,1,258519,258519,258520,0,1,2
73870,1,3,258520,258520,258523,0,3,0
73871,3,2,258523,258523,258525,0,2,0
73872,6,2,258529,258529,258531,0,2,4
73873,3,1,258532,258532,258533,0,1,1
73874,2,2,258534,258534,258536,0,2,1
73875,2,2,258536,258536,258538,0,2,0
73876,6,2,258542,258542,258544,0,2,4
73877,3,2,258545,258545,258547,0,2,1
73878,6,1,258551,258551,258552,0,1,4
73879,1,1,258552,258552,258553,0,1,0
73880,5,2,258557,258557,258559,0,2,4
73881,1,1,258558,258559,258560,1,2,0
73882,2,3,258560,258560,258563,0,3,0
73883,4,3,258564,258564,258567,0,3,1
73884,3,2,258567,258567,258569,0,2,0
73885,1,3,258568,258569,258572,1,4,0
73886,2,2,258570,258572,258574,2,4,0
73887,1,3,258571,258574,258577,3,6,0
73888,6,1,258577,258577,258578,0,1,0
73889,2,1,258579,258579,258580,0,1,1
73890,5,1,258584,258584,258585,0,1,4
73891,4,2,258588,258588,258590,0,2,3
73892,5,1,258593,258593,258594,0,1,3
73893,4,3,258597,258597,258600,0,3,3
73894,3,3,258600,258600,258603,0,3,0
73895,1,2,258601,258603,258605,2,4,0
73896,3,1,258604,258605,258606,1,2,0
73897,4,2,258608,258608,258610,0,2,2
73898,1,1,258609,258610,258611,1,2,0
73899,3,1,258612,258612,258613,0,1,1
73900,2,1,258614,258614,258615,0,1,1
73901,1,1,258615,258615,258616,0,1,0
73902,1,1,258616,258616,258617,0,1,0
73903,1,1,258617,258617,258618,0,1,0
73904,1,1,258618,258618,258619,0,1,0
73905,1,2,258619,258619,258621,0,2,0
73906,6,1,258625,258625,258626,0,1,4
73907,4,1,258629,258629,258630,0,1,3
73908,6,2,258635,258635,258637,0,2,5
73909,5,3,258640,258640,258643,0,3,3
73910,2,3,258642,258643,258646,1,4,0
73911,2,1,258644,258646,258647,2,3,0
73912,6,3,258650,258650,258653,0,3,3
73913,2,2,258652,258653,258655,1,3,0
73914,5,1,258657,258657,258658,0,1,2
73915,1,2,258658,258658,258660,0,2,0
73916,5,1,258663,258663,258664,0,1,3
73917,6,1,258669,258669,258670,0,1,5
73918,3,2,258672,258672,258674,0,2,2
73919,2,2,258674,258674,258676,0,2,0
73920,6,2,258680,258680,258682,0,2,4
73921,5,3,258685,258685,258688,0,3,3
73922,6,2,258691,258691,258693,0,2,3
73923,2,1,258693,258693,258694,0,1,0
73924,6,2,258699,258699,258701,0,2,5
73925,4,2,258703,258703,258705,0,2,2
73926,2,3,258705,258705,258708,0,3,0
73927,4,3,258709,258709,258712,0,3,1
73928,4,3,258713,258713,258716,0,3,1
73929,1,1,258714,258716,258717,2,3,0
73930,3,1,258717,258717,258718,0,1,0
73931,5,1,258722,258722,258723,0,1,4
73932,5,2,258727,258727,258729,0,2,4
73933,3,3,258730,258730,258733,0,3,1
73934,2,2,258732,258733,258735,1,3,0
73935,2,3,258734,258735,258738,1,4,0
73936,5,3,258739,258739,258742,0,3,1
73937,4,2,258743,258743,258745,0,2,1
73938,3,1,258746,258746,258747,0,1,1
73939,6,2,258752,258752,258754,0,2,5
73940,2,1,258754,258754,258755,0,1,0
73941,4,3,258758,258758,258761,0,3,3
73942,6,1,258764,258764,258765,0,1,3
73943,1,1,258765,258765,258766,0,1,0
73944,2,1,258767,258767,258768,0,1,1
73945,2,1,258769,258769,258770,0,1,1
73946,6,2,258775,258775,258777,0,2,5
73947,2,2,258777,258777,258779,0,2,0
73948,2,2,258779,258779,258781,0,2,0
73949,5,1,258784,258784,258785,0,1,3
73950,5,3,258789,258789,258792,0,3,4
73951,6,2,258795,258795,258797,0,2,3
73952,1,3,258796,258797,258800,1,4,0
73953,6,1,258802,258802,258803,0,1,2
73954,1,1,258803,258803,258804,0,1,0
73955,2,2,258805,258805,258807,0,2,1
73956,5,1,258810,258810,258811,0,1,3
73957,3,1,258813,258813,258814,0,1,2
73958,6,2,258819,258819,258821,0,2,5
73959,4,1,258823,258823,258824,0,1,2
73960,4,1,258827,258827,258828,0,1,3
73961,2,1,258829,258829,258830,0,1,1
73962,5,3,258834,258834,258837,0,3,4
73963,4,3,258838,258838,258841,0,3,1
73964,1,3,258839,258841,258844,2,5,0
73965,6,1,258845,258845,258846,0,1,1
73966,3,2,258848,258848,258850,0,2,2
73967,2,1,258850,258850,258851,0,1,0
73968,1,2,258851,258851,258853,0,2,0
73969,5,2,258856,258856,258858,0,2,3
73970,3,1,258859,258859,258860,0,1,1
73971,6,2,258865,258865,258867,0,2,5
73972,4,3,258869,258869,258872,0,3,2
73973,6,2,258875,258875,258877,0,2,3
73974,1,1,258876,258877,258878,1,2,0
73975,6,2,258882,258882,258884,0,2,4
73976,2,3,258884,258884,258887,0,3,0
73977,4,3,258888,258888,258891,0,3,1
73978,2,2,258890,258891,258893,1,3,0
73979,3,3,258893,258893,258896,0,3,0
73980,4,3,258897,258897,258900,0,3,1
73981,3,1,258900,258900,258901,0,1,0
73982,3,3,258903,258903,258906,0,3,2
73983,5,3,258908,258908,258911,0,3,2
73984,3,2,258911,258911,258913,0,2,0
73985,6,1,258917,258917,258918,0,1,4
73986,3,2,258920,258920,258922,0,2,2
73987,5,1,258925,258925,258926,0,1,3
73988,1,1,258926,258926,258927,0,1,0
73989,4,3,258930,258930,258933,0,3,3
73990,2,3,258932,258933,258936,1,4,0
73991,6,3,258938,258938,258941,0,3,2
73992,5,3,258943,258943,258946,0,3,2
73993,6,3,258949,258949,258952,0,3,3
73994,6,2,258955,258955,258957,0,2,3
73995,1,3,258956,258957,258960,1,4,0
73996,2,2,258958,258960,258962,2,4,0
73997,6,3,258964,258964,258967,0,3,2
73998,6,3,258970,258970,258973,0,3,3
73999,1,1,258971,258973,258974,2,3,0
74000,1,2,258972,258974,258976,2,4,0
74001,3,2,258975,258976,258978,1,3,0
74002,2,1,258977,258978,258979,1,2,0
74003,3,1,258980,258980,258981,0,1,1
74004,1,2,258981,258981,258983,0,2,0
74005,2,1,258983,258983,258984,0,1,0
74006,1,1,258984,258984,258985,0,1,0
74007,3,1,258987,258987,258988,0,1,2
74008,6,1,258993,258993,258994,0,1,5
74009,3,1,258996,258996,258997,0,1,2
74010,4,3,259000,259000,259003,0,3,3
74011,5,2,259005,259005,259007,0,2,2
74012,5,2,259010,259010,259012,0,2,3
74013,3,1,259013,259013,259014,0,1,1
74014,1,3,259014,259014,259017,0,3,0
74015,2,2,259016,259017,259019,1,3,0
74016,4,1,259020,259020,259021,0,1,1
74017,1,1,259021,259021,259022,0,1,0
74018,4,3,259025,259025,259028,0,3,3
74019,4,2,259029,259029,259031,0,2,1
74020,5,2,259034,259034,259036,0,2,3
74021,6,3,259040,259040,259043,0,3,4
74022,3,1,259043,259043,259044,0,1,0
74023,5,3,259048,259048,259051,0,3,4
74024,3,1,259051,259051,259052,0,1,0
74025,6,2,259057,259057,259059,0,2,5
74026,3,1,259060,259060,259061,0,1,1
74027,3,2,259063,259063,259065,0,2,2
74028,5,2,259068,259068,259070,0,2,3
74029,6,3,259074,259074,259077,0,3,4
74030,4,1,259078,259078,259079,0,1,1
74031,2,2,259080,259080,259082,0,2,1
74032,1,1,259081,259082,259083,1,2,0
74033,3,2,259084,259084,259086,0,2,1
74034,1,2,259085,259086,259088,1,3,0
74035,4,2,259089,259089,259091,0,2,1
74036,1,1,259090,259091,259092,1,2,0
74037,4,3,259094,259094,259097,0,3,2
74038,1,2,259095,259097,259099,2,4,0
74039,5,3,259100,259100,259103,0,3,1
74040,5,1,259105,259105,259106,0,1,2
74041,4,2,259109,259109,259111,0,2,3
74042,4,2,259113,259113,259115,0,2,2
74043,2,3,259115,259115,259118,0,3,0
74044,4,1,259119,259119,259120,0,1,1
74045,5,3,259124,259124,259127,0,3,4
74046,1,3,259125,259127,259130,2,5,0
74047,2,1,259127,259130,259131,3,4,0
74048,5,3,259132,259132,259135,0,3,1
74049,2,1,259134,259135,259136,1,2,0
74050,1,1,259135,259136,259137,1,2,0
74051,3,2,259138,259138,259140,0,2,1
74052,4,1,259142,259142,259143,0,1,2
74053,2,1,259144,259144,259145,0,1,1
74054,4,3,259148,259148,259151,0,3,3
74055,1,3,259149,259151,259154,2,5,0
74056,3,3,259152,259154,259157,2,5,0
74057,6,1,259158,259158,259159,0,1,1
74058,5,1,259163,259163,259164,0,1,4
74059,4,1,259167,259167,259168,0,1,3
74060,5,2,259172,259172,259174,0,2,4
74061,2,2,259174,259174,259176,0,2,0
74062,5,1,259179,259179,259180,0,1,3
74063,5,3,259184,259184,259187,0,3,4
74064,4,3,259188,259188,259191,0,3,1
74065,2,3,259190,259191,259194,1,4,0
74066,2,3,259192,259194,259197,2,5,0
74067,2,2,259194,259197,259199,3,5,0
74068,4,2,259198,259199,259201,1,3,0
74069,6,1,259204,259204,259205,0,1,3
74070,5,2,259209,259209,259211,0,2,4
74071,2,2,259211,259211,259213,0,2,0
74072,1,1,259212,259213,259214,1,2,0
74073,5,2,259217,259217,259219,0,2,3
74074,3,3,259220,259220,259223,0,3,1
74075,6,3,259226,259226,259229,0,3,3
74076,3,3,259229,259229,259232,0,3,0
74077,3,1,259232,259232,259233,0,1,0
74078,2,2,259234,259234,259236,0,2,1
74079,5,3,259239,259239,259242,0,3,3
74080,2,2,259241,259242,259244,1,3,0
74081,3,2,259244,259244,259246,0,2,0
74082,5,1,259249,259249,259250,0,1,3
74083,2,2,259251,259251,259253,0,2,1
74084,6,1,259257,259257,259258,0,1,4
74085,3,1,259260,259260,259261,0,1,2
74086,5,3,259265,259265,259268,0,3,4
74087,6,1,259271,259271,259272,0,1,3
74088,6,3,259277,259277,259280,0,3,5
74089,1,1,259278,259280,259281,2,3,0
74090,2,3,259280,259281,259284,1,4,0
74091,3,3,259283,259284,259287,1,4,0
74092,2,3,259285,259287,259290,2,5,0
74093,2,3,259287,259290,259293,3,6,0
74094,1,2,259288,259293,259295,5,7,0
74095,5,2,259293,259295,259297,2,4,0
74096,5,1,259298,259298,259299,0,1,1
74097,3,1,259301,259301,259302,0,1,2
74098,5,2,259306,259306,259308,0,2,4
74099,4,3,259310,259310,259313,0,3,2
74100,2,2,259312,259313,259315,1,3,0
74101,1,2,259313,259315,259317,2,4,0
74102,1,3,259314,259317,259320,3,6,0
74103,3,3,259317,259320,259323,3,6,0
74104,6,3,259323,259323,259326,0,3,0
74105,6,2,259329,259329,259331,0,2,3
74106,2,2,259331,259331,259333,0,2,0
74107,4,3,259335,259335,259338,0,3,2
74108,1,2,259336,259338,259340,2,4,0
74109,2,1,259338,259340,259341,2,3,0
74110,4,2,259342,259342,259344,0,2,1
74111,4,1,259346,259346,259347,0,1,2
74112,4,3,259350,259350,259353,0,3,3
74113,5,1,259355,259355,259356,0,1,2
74114,4,2,259359,259359,259361,0,2,3
74115,2,3,259361,259361,259364,0,3,0
74116,2,2,259363,259364,259366,1,3,0
74117,3,3,259366,259366,259369,0,3,0
74118,5,3,259371,259371,259374,0,3,2
74119,1,3,259372,259374,259377,2,5,0
74120,3,1,259375,259377,259378,2,3,0
74121,2,1,259377,259378,259379,1,2,0
74122,6,2,259383,259383,259385,0,2,4
74123,5,3,259388,259388,259391,0,3,3
74124,1,1,259389,259391,259392,2,3,0
74125,6,2,259395,259395,259397,0,2,3
74126,2,2,259397,259397,259399,0,2,0
74127,2,2,259399,259399,259401,0,2,0
74128,1,2,259400,259401,259403,1,3,0
74129,4,1,259404,259404,259405,0,1,1
74130,3,1,259407,259407,259408,0,1,2
74131,5,3,259412,259412,259415,0,3,4
74132,5,1,259417,259417,259418,0,1,2
74133,2,1,259419,259419,259420,0,1,1
74134,3,2,259422,259422,259424,0,2,2
74135,5,3,259427,259427,259430,0,3,3
74136,1,2,259428,259430,259432,2,4,0
74137,4,1,259432,259432,259433,0,1,0
74138,1,3,259433,259433,259436,0,3,0
74139,1,1,259434,259436,259437,2,3,0
74140,2,2,259436,259437,259439,1,3,0
74141,6,2,259442,259442,259444,0,2,3
74142,4,3,259446,259446,259449,0,3,2
74143,1,2,259447,259449,259451,2,4,0
74144,5,1,259452,259452,259453,0,1,1
74145,3,2,259455,259455,259457,0,2,2
74146,1,3,259456,259457,259460,1,4,0
74147,5,1,259461,259461,259462,0,1,1
74148,6,1,259467,259467,259468,0,1,5
74149,1,1,259468,259468,259469,0,1,0
74150,5,2,259473,259473,259475,0,2,4
74151,2,3,259475,259475,259478,0,3,0
74152,6,2,259481,259481,259483,0,2,3
74153,3,2,259484,259484,259486,0,2,1
74154,1,3,259485,259486,259489,1,4,0
74155,5,2,259490,259490,259492,0,2,1
74156,4,1,259494,259494,259495,0,1,2
74157,6,1,259500,259500,259501,0,1,5
74158,6,1,259506,259506,259507,0,1,5
74159,1,1,259507,259507,259508,0,1,0
74160,5,1,259512,259512,259513,0,1,4
74161,5,2,259517,259517,259519,0,2,4
74162,6,3,259523,259523,259526,0,3,4
74163,1,3,259524,259526,259529,2,5,0
74164,5,1,259529,259529,259530,0,1,0
74165,4,2,259533,259533,259535,0,2,3
74166,5,3,259538,259538,259541,0,3,3
74167,3,2,259541,259541,259543,0,2,0
74168,6,3,259547,259547,259550,0,3,4
74169,2,1,259549,259550,259551,1,2,0
74170,3,2,259552,259552,259554,0,2,1
74171,6,3,259558,259558,259561,0,3,4
74172,2,1,259560,259561,259562,1,2,0
74173,3,2,259563,259563,259565,0,2,1
74174,5,2,259568,259568,259570,0,2,3
74175,2,3,259570,259570,259573,0,3,0
74176,3,3,259573,259573,259576,0,3,0
74177,5,1,259578,259578,259579,0,1,2
74178,5,1,259583,259583,259584,0,1,4
74179,1,2,259584,259584,259586,0,2,0
74180,2,2,259586,259586,259588,0,2,0
74181,5,2,259591,259591,259593,0,2,3
74182,3,1,259594,259594,259595,0,1,1
74183,4,1,259598,259598,259599,0,1,3
74184,6,3,259604,259604,259607,0,3,5
74185,2,3,259606,259607,259610,1,4,0
74186,4,3,259610,259610,259613,0,3,0
74187,1,2,259611,259613,259615,2,4,0
74188,2,1,259613,259615,259616,2,3,0
74189,6,2,259619,259619,259621,0,2,3
74190,2,2,259621,259621,259623,0,2,0
74191,3,2,259624,259624,259626,0,2,1
74192,2,3,259626,259626,259629,0,3,0
74193,5,3,259631,259631,259634,0,3,2
74194,3,2,259634,259634,259636,0,2,0
74195,4,3,259638,259638,259641,0,3,2
74196,4,1,259642,259642,259643,0,1,1
74197,5,2,259647,259647,259649,0,2,4
74198,6,1,259653,259653,259654,0,1,4
74199,3,2,259656,259656,259658,0,2,2
74200,6,2,259662,259662,259664,0,2,4
74201,2,3,259664,259664,259667,0,3,0
74202,3,1,259667,259667,259668,0,1,0
74203,6,2,259673,259673,259675,0,2,5
74204,1,2,259674,259675,259677,1,3,0
74205,5,3,259679,259679,259682,0,3,2
74206,3,2,259682,259682,259684,0,2,0
74207,4,2,259686,259686,259688,0,2,2
74208,5,3,259691,259691,259694,0,3,3
74209,6,2,259697,259697,259699,0,2,3
74210,6,3,259703,259703,259706,0,3,4
74211,4,3,259707,259707,259710,0,3,1
74212,1,3,259708,259710,259713,2,5,0
74213,3,3,259711,259713,259716,2,5,0
74214,5,3,259716,259716,259719,0,3,0
74215,4,2,259720,259720,259722,0,2,1
74216,6,1,259726,259726,259727,0,1,4
74217,1,2,259727,259727,259729,0,2,0
74218,1,1,259728,259729,259730,1,2,0
74219,4,2,259732,259732,259734,0,2,2
74220,4,3,259736,259736,259739,0,3,2
74221,1,2,259737,259739,259741,2,4,0
74222,1,1,259738,259741,259742,3,4,0
74223,2,2,259740,259742,259744,2,4,0
74224,2,3,259742,259744,259747,2,5,0
74225,5,1,259747,259747,259748,0,1,0
74226,5,2,259752,259752,259754,0,2,4
74227,2,2,259754,259754,259756,0,2,0
74228,6,2,259760,259760,259762,0,2,4
74229,6,3,259766,259766,259769,0,3,4
74230,2,3,259768,259769,259772,1,4,0
74231,5,1,259773,259773,259774,0,1,1
74232,4,3,259777,259777,259780,0,3,3
74233,1,2,259778,259780,259782,2,4,0
74234,6,2,259784,259784,259786,0,2,2
74235,2,3,259786,259786,259789,0,3,0
74236,5,2,259791,259791,259793,0,2,2
74237,1,1,259792,259793,259794,1,2,0
74238,5,3,259797,259797,259800,0,3,3
74239,2,3,259799,259800,259803,1,4,0
74240,6,2,259805,259805,259807,0,2,2
74241,2,1,259807,259807,259808,0,1,0
74242,5,2,259812,259812,259814,0,2,4
74243,3,2,259815,259815,259817,0,2,1
74244,5,1,259820,259820,259821,0,1,3
74245,3,1,259823,259823,259824,0,1,2
74246,1,2,259824,259824,259826,0,2,0
74247,6,2,259830,259830,259832,0,2,4
74248,1,1,259831,259832,259833,1,2,0
74249,6,2,259837,259837,259839,0,2,4
74250,4,1,259841,259841,259842,0,1,2
74251,6,2,259847,259847,259849,0,2,5
74252,4,2,259851,259851,259853,0,2,2
74253,1,3,259852,259853,259856,1,4,0
74254,1,2,259853,259856,259858,3,5,0
74255,6,2,259859,259859,259861,0,2,1
74256,4,1,259863,259863,259864,0,1,2
74257,1,2,259864,259864,259866,0,2,0
74258,5,3,259869,259869,259872,0,3,3
74259,1,2,259870,259872,259874,2,4,0
74260,1,1,259871,259874,259875,3,4,0
74261,4,3,259875,259875,259878,0,3,0
74262,6,2,259881,259881,259883,0,2,3
74263,3,2,259884,259884,259886,0,2,1
74264,5,1,259889,259889,259890,0,1,3
74265,1,1,259890,259890,259891,0,1,0
74266,2,3,259892,259892,259895,0,3,1
74267,5,1,259897,259897,259898,0,1,2
74268,5,2,259902,259902,259904,0,2,4
74269,4,1,259906,259906,259907,0,1,2
74270,3,3,259909,259909,259912,0,3,2
74271,3,2,259912,259912,259914,0,2,0
74272,2,1,259914,259914,259915,0,1,0
74273,1,1,259915,259915,259916,0,1,0
74274,1,1,259916,259916,259917,0,1,0
74275,2,1,259918,259918,259919,0,1,1
74276,1,1,259919,259919,259920,0,1,0
74277,4,1,259923,259923,259924,0,1,3
74278,1,3,259924,259924,259927,0,3,0
74279,3,3,259927,259927,259930,0,3,0
74280,6,2,259933,259933,259935,0,2,3
74281,3,3,259936,259936,259939,0,3,1
74282,5,2,259941,259941,259943,0,2,2
74283,3,1,259944,259944,259945,0,1,1
74284,3,1,259947,259947,259948,0,1,2
74285,2,3,259949,259949,259952,0,3,1
74286,6,1,259955,259955,259956,0,1,3
74287,6,2,259961,259961,259963,0,2,5
74288,3,2,259964,259964,259966,0,2,1
74289,3,3,259967,259967,259970,0,3,1
74290,4,1,259971,259971,259972,0,1,1
74291,2,1,259973,259973,259974,0,1,1
74292,3,1,259976,259976,259977,0,1,2
74293,1,2,259977,259977,259979,0,2,0
74294,3,1,259980,259980,259981,0,1,1
74295,3,3,259983,259983,259986,0,3,2
74296,1,3,259984,259986,259989,2,5,0
74297,1,1,259985,259989,259990,4,5,0
74298,4,1,259989,259990,259991,1,2,0
74299,2,1,259991,259991,259992,0,1,0
74300,1,3,259992,259992,259995,0,3,0
74301,1,2,259993,259995,259997,2,4,0
74302,6,2,259999,259999,260001,0,2,2
74303,1,3,260000,260001,260004,1,4,0
74304,6,2,260006,260006,260008,0,2,2
74305,5,2,260011,260011,260013,0,2,3
74306,1,3,260012,260013,260016,1,4,0
74307,5,2,260017,260017,260019,0,2,1
74308,4,3,260021,260021,260024,0,3,2
74309,4,2,260025,260025,260027,0,2,1
74310,1,3,260026,260027,260030,1,4,0
74311,2,3,260028,260030,260033,2,5,0
74312,2,2,260030,260033,260035,3,5,0
74313,5,1,260035,260035,260036,0,1,0
74314,5,3,260040,260040,260043,0,3,4
74315,1,3,260041,260043,260046,2,5,0
74316,4,1,260045,260046,260047,1,2,0
74317,2,2,260047,260047,260049,0,2,0
74318,6,2,260053,260053,260055,0,2,4
74319,1,1,260054,260055,260056,1,2,0
74320,6,2,260060,260060,260062,0,2,4
74321,2,2,260062,260062,260064,0,2,0
74322,2,3,260064,260064,260067,0,3,0
74323,4,1,260068,260068,260069,0,1,1
74324,1,3,260069,260069,260072,0,3,0
74325,5,3,260074,260074,260077,0,3,2
74326,3,2,260077,260077,260079,0,2,0
74327,2,3,260079,260079,260082,0,3,0
74328,6,3,260085,260085,260088,0,3,3
74329,5,2,260090,260090,260092,0,2,2
74330,2,1,260092,260092,260093,0,1,0
74331,6,2,260098,260098,260100,0,2,5
74332,1,2,260099,260100,260102,1,3,0
74333,5,1,260104,260104,260105,0,1,2
74334,4,3,260108,260108,260111,0,3,3
74335,1,2,260109,260111,260113,2,4,0
74336,2,2,260111,260113,260115,2,4,0
74337,1,3,260112,260115,260118,3,6,0
74338,6,1,260118,260118,260119,0,1,0
74339,4,2,260122,260122,260124,0,2,3
74340,2,1,260124,260124,260125,0,1,0
74341,3,3,260127,260127,260130,0,3,2
74342,5,2,260132,260132,260134,0,2,2
74343,4,2,260136,260136,260138,0,2,2
74344,1,2,260137,260138,260140,1,3,0
74345,6,2,260143,260143,260145,0,2,3
74346,2,1,260145,260145,260146,0,1,0
74347,5,1,260150,260150,260151,0,1,4
74348,6,1,260156,260156,260157,0,1,5
74349,2,3,260158,260158,260161,0,3,1
74350,3,2,260161,260161,260163,0,2,0
74351,4,2,260165,260165,260167,0,2,2
74352,2,1,260167,260167,260168,0,1,0
74353,3,2,260170,260170,260172,0,2,2
74354,3,3,260173,260173,260176,0,3,1
74355,3,3,260176,260176,260179,0,3,0
74356,3,3,260179,260179,260182,0,3,0
74357,5,3,260184,260184,260187,0,3,2
74358,3,1,260187,260187,260188,0,1,0
74359,6,3,260193,260193,260196,0,3,5
74360,6,1,260199,260199,260200,0,1,3
74361,1,2,260200,260200,260202,0,2,0
74362,3,2,260203,260203,260205,0,2,1
74363,1,1,260204,260205,260206,1,2,0
74364,6,3,260210,260210,260213,0,3,4
74365,2,3,260212,260213,260216,1,4,0
74366,4,1,260216,260216,260217,0,1,0
74367,4,3,260220,260220,260223,0,3,3
74368,1,2,260221,260223,260225,2,4,0
74369,3,3,260224,260225,260228,1,4,0
74370,1,2,260225,260228,260230,3,5,0
74371,4,2,260229,260230,260232,1,3,0
74372,4,1,260233,260233,260234,0,1,1
74373,2,1,260235,260235,260236,0,1,1
74374,6,2,260241,260241,260243,0,2,5
74375,2,1,260243,260243,260244,0,1,0
74376,2,1,260245,260245,260246,0,1,1
74377,6,1,260251,260251,260252,0,1,5
74378,3,3,260254,260254,260257,0,3,2
74379,1,2,260255,260257,260259,2,4,0
74380,1,3,260256,260259,260262,3,6,0
74381,2,1,260258,260262,260263,4,5,0
74382,1,3,260259,260263,260266,4,7,0
74383,1,1,260260,260266,260267,6,7,0
74384,2,2,260262,260267,260269,5,7,0
74385,4,1,260266,260269,260270,3,4,0
74386,4,2,260270,260270,260272,0,2,0
74387,4,1,260274,260274,260275,0,1,2
74388,6,1,260280,260280,260281,0,1,5
74389,5,3,260285,260285,260288,0,3,4
74390,5,2,260290,260290,260292,0,2,2
74391,2,1,260292,260292,260293,0,1,0
74392,2,2,260294,260294,260296,0,2,1
74393,3,3,260297,260297,260300,0,3,1
74394,2,2,260299,260300,260302,1,3,0
74395,1,1,260300,260302,260303,2,3,0
74396,6,2,260306,260306,260308,0,2,3
74397,3,3,260309,260309,260312,0,3,1
74398,3,2,260312,260312,260314,0,2,0
74399,1,3,260313,260314,260317,1,4,0
74400,2,3,260315,260317,260320,2,5,0
74401,4,2,260319,260320,260322,1,3,0
74402,6,1,260325,260325,260326,0,1,3
74403,1,2,260326,260326,260328,0,2,0
74404,4,1,260330,260330,260331,0,1,2
74405,5,1,260335,260335,260336,0,1,4
74406,2,2,260337,260337,260339,0,2,1
74407,2,3,260339,260339,260342,0,3,0
74408,5,2,260344,260344,260346,0,2,2
74409,3,3,260347,260347,260350,0,3,1
74410,2,2,260349,260350,260352,1,3,0
74411,5,3,260354,260354,260357,0,3,2
74412,4,1,260358,260358,260359,0,1,1
74413,4,3,260362,260362,260365,0,3,3
74414,6,3,260368,260368,260371,0,3,3
74415,5,2,260373,260373,260375,0,2,2
74416,4,1,260377,260377,260378,0,1,2
74417,2,2,260379,260379,260381,0,2,1
74418,5,1,260384,260384,260385,0,1,3
74419,1,1,260385,260385,260386,0,1,0
74420,3,2,260388,260388,260390,0,2,2
74421,4,3,260392,260392,260395,0,3,2
74422,3,2,260395,260395,260397,0,2,0
74423,1,3,260396,260397,260400,1,4,0
74424,2,1,260398,260400,260401,2,3,0
74425,4,2,260402,260402,260404,0,2,1
74426,3,3,260405,260405,260408,0,3,1
74427,6,2,260411,260411,260413,0,2,3
74428,1,1,260412,260413,260414,1,2,0
74429,5,2,260417,260417,260419,0,2,3
74430,4,3,260421,260421,260424,0,3,2
74431,3,3,260424,260424,260427,0,3,0
74432,2,3,260426,260427,260430,1,4,0
74433,4,1,260430,260430,260431,0,1,0
74434,2,3,260432,260432,260435,0,3,1
74435,3,3,260435,260435,260438,0,3,0
74436,2,3,260437,260438,260441,1,4,0
74437,6,1,260443,260443,260444,0,1,2
74438,6,1,260449,260449,260450,0,1,5
74439,5,1,260454,260454,260455,0,1,4
74440,2,1,260456,260456,260457,0,1,1
74441,3,1,260459,260459,260460,0,1,2
74442,3,1,260462,260462,260463,0,1,2
74443,1,2,260463,260463,260465,0,2,0
74444,2,2,260465,260465,260467,0,2,0
74445,2,2,260467,260467,260469,0,2,0
74446,6,3,260473,260473,260476,0,3,4
74447,3,1,260476,260476,260477,0,1,0
74448,3,2,260479,260479,260481,0,2,2
74449,6,3,260485,260485,260488,0,3,4
74450,1,3,260486,260488,260491,2,5,0
74451,6,1,260492,260492,260493,0,1,1
74452,5,2,260497,260497,260499,0,2,4
74453,1,1,260498,260499,260500,1,2,0
74454,4,2,260502,260502,260504,0,2,2
74455,1,2,260503,260504,260506,1,3,0
74456,2,3,260505,260506,260509,1,4,0
74457,1,2,260506,260509,260511,3,5,0
74458,2,1,260508,260511,260512,3,4,0
74459,5,2,260513,260513,260515,0,2,1
74460,5,3,260518,260518,260521,0,3,3
74461,2,2,260520,260521,260523,1,3,0
74462,4,2,260524,260524,260526,0,2,1
74463,4,1,260528,260528,260529,0,1,2
74464,3,1,260531,260531,260532,0,1,2
74465,3,1,260534,260534,260535,0,1,2
74466,4,1,260538,260538,260539,0,1,3
74467,1,2,260539,260539,260541,0,2,0
74468,1,1,260540,260541,260542,1,2,0
74469,1,1,260541,260542,260543,1,2,0
74470,5,1,260546,260546,260547,0,1,3
74471,5,2,260551,260551,260553,0,2,4
74472,5,3,260556,260556,260559,0,3,3
74473,6,1,260562,260562,260563,0,1,3
74474,1,1,260563,260563,260564,0,1,0
74475,4,2,260567,260567,260569,0,2,3
74476,3,3,260570,260570,260573,0,3,1
74477,4,2,260574,260574,260576,0,2,1
74478,5,1,260579,260579,260580,0,1,3
74479,3,3,260582,260582,260585,0,3,2
74480,5,3,260587,260587,260590,0,3,2
74481,4,1,260591,260591,260592,0,1,1
74482,6,3,260597,260597,260600,0,3,5
74483,1,1,260598,260600,260601,2,3,0
74484,5,3,260603,260603,260606,0,3,2
74485,1,3,260604,260606,260609,2,5,0
74486,6,3,260610,260610,260613,0,3,1
74487,4,3,260614,260614,260617,0,3,1
74488,2,3,260616,260617,260620,1,4,0
74489,2,3,260618,260620,260623,2,5,0
74490,1,2,260619,260623,260625,4,6,0
74491,6,3,260625,260625,260628,0,3,0
74492,3,3,260628,260628,260631,0,3,0
74493,2,2,260630,260631,260633,1,3,0
74494,6,3,260636,260636,260639,0,3,3
74495,5,1,260641,260641,260642,0,1,2
74496,5,1,260646,260646,260647,0,1,4
74497,3,1,260649,260649,260650,0,1,2
74498,3,3,260652,260652,260655,0,3,2
74499,4,3,260656,260656,260659,0,3,1
74500,1,2,260657,260659,260661,2,4,0
74501,5,3,260662,260662,260665,0,3,1
74502,6,2,260668,260668,260670,0,2,3
74503,2,3,260670,260670,260673,0,3,0
74504,1,3,260671,260673,260676,2,5,0
74505,5,2,260676,260676,260678,0,2,0
74506,6,2,260682,260682,260684,0,2,4
74507,5,1,260687,260687,260688,0,1,3
74508,4,3,260691,260691,260694,0,3,3
74509,2,1,260693,260694,260695,1,2,0
74510,3,1,260696,260696,260697,0,1,1
74511,3,2,260699,260699,260701,0,2,2
74512,4,2,260703,260703,260705,0,2,2
74513,1,3,260704,260705,260708,1,4,0
74514,6,2,260710,260710,260712,0,2,2
74515,5,1,260715,260715,260716,0,1,3
74516,6,3,260721,260721,260724,0,3,5
74517,2,1,260723,260724,260725,1,2,0
74518,5,3,260728,260728,260731,0,3,3
74519,5,3,260733,260733,260736,0,3,2
74520,4,2,260737,260737,260739,0,2,1
74521,4,3,260741,260741,260744,0,3,2
74522,3,3,260744,260744,260747,0,3,0
74523,2,1,260746,260747,260748,1,2,0
74524,6,3,260752,260752,260755,0,3,4
74525,2,2,260754,260755,260757,1,3,0
74526,2,1,260756,260757,260758,1,2,0
74527,3,3,260759,260759,260762,0,3,1
74528,1,3,260760,260762,260765,2,5,0
74529,4,1,260764,260765,260766,1,2,0
74530,4,3,260768,260768,260771,0,3,2
74531,3,3,260771,260771,260774,0,3,0
74532,6,3,260777,260777,260780,0,3,3
74533,6,3,260783,260783,260786,0,3,3
74534,4,1,260787,260787,260788,0,1,1
74535,3,1,260790,260790,260791,0,1,2
74536,1,1,260791,260791,260792,0,1,0
74537,3,2,260794,260794,260796,0,2,2
74538,1,2,260795,260796,260798,1,3,0
74539,4,1,260799,260799,260800,0,1,1
74540,3,3,260802,260802,260805,0,3,2
74541,1,3,260803,260805,260808,2,5,0
74542,2,2,260805,260808,260810,3,5,0
74543,6,1,260811,260811,260812,0,1,1
74544,3,1,260814,260814,260815,0,1,2
74545,4,3,260818,260818,260821,0,3,3
74546,2,3,260820,260821,260824,1,4,0
74547,1,1,260821,260824,260825,3,4,0
74548,6,2,260827,260827,260829,0,2,2
74549,1,2,260828,260829,260831,1,3,0
74550,3,2,260831,260831,260833,0,2,0
74551,1,3,260832,260833,260836,1,4,0
74552,5,3,260837,260837,260840,0,3,1
74553,5,2,260842,260842,260844,0,2,2
74554,6,1,260848,260848,260849,0,1,4
74555,1,1,260849,260849,260850,0,1,0
74556,6,3,260855,260855,260858,0,3,5
74557,1,1,260856,260858,260859,2,3,0
74558,5,3,260861,260861,260864,0,3,2
74559,4,2,260865,260865,260867,0,2,1
74560,2,3,260867,260867,260870,0,3,0
74561,6,2,260873,260873,260875,0,2,3
74562,3,2,260876,260876,260878,0,2,1
74563,1,2,260877,260878,260880,1,3,0
74564,2,2,260879,260880,260882,1,3,0
74565,4,2,260883,260883,260885,0,2,1
74566,6,1,260889,260889,260890,0,1,4
74567,2,1,260891,260891,260892,0,1,1
74568,2,1,260893,260893,260894,0,1,1
74569,5,1,260898,260898,260899,0,1,4
74570,5,1,260903,260903,260904,0,1,4
74571,4,2,260907,260907,260909,0,2,3
74572,6,3,260913,260913,260916,0,3,4
74573,3,1,260916,260916,260917,0,1,0
74574,4,2,260920,260920,260922,0,2,3
74575,6,1,260926,260926,260927,0,1,4
74576,6,3,260932,260932,260935,0,3,5
74577,3,3,260935,260935,260938,0,3,0
74578,1,3,260936,260938,260941,2,5,0
74579,4,2,260940,260941,260943,1,3,0
74580,2,3,260942,260943,260946,1,4,0
74581,4,3,260946,260946,260949,0,3,0
74582,6,2,260952,260952,260954,0,2,3
74583,1,3,260953,260954,260957,1,4,0
74584,2,2,260955,260957,260959,2,4,0
74585,2,2,260957,260959,260961,2,4,0
74586,1,3,260958,260961,260964,3,6,0
74587,3,1,260961,260964,260965,3,4,0
74588,6,1,260967,260967,260968,0,1,2
74589,4,1,260971,260971,260972,0,1,3
74590,5,2,260976,260976,260978,0,2,4
74591,5,1,260981,260981,260982,0,1,3
74592,5,3,260986,260986,260989,0,3,4
74593,3,2,260989,260989,260991,0,2,0
74594,6,3,260995,260995,260998,0,3,4
74595,3,2,260998,260998,261000,0,2,0
74596,2,1,261000,261000,261001,0,1,0
74597,5,1,261005,261005,261006,0,1,4
74598,1,1,261006,261006,261007,0,1,0
74599,2,1,261008,261008,261009,0,1,1
74600,1,2,261009,261009,261011,0,2,0
74601,5,1,261014,261014,261015,0,1,3
74602,2,1,261016,261016,261017,0,1,1
74603,4,2,261020,261020,261022,0,2,3
74604,2,1,261022,261022,261023,0,1,0
74605,1,3,261023,261023,261026,0,3,0
74606,5,2,261028,261028,261030,0,2,2
74607,3,1,261031,261031,261032,0,1,1
74608,5,2,261036,261036,261038,0,2,4
74609,1,1,261037,261038,261039,1,2,0
74610,1,2,261038,261039,261041,1,3,0
74611,1,2,261039,261041,261043,2,4,0
74612,6,2,261045,261045,261047,0,2,2
74613,3,2,261048,261048,261050,0,2,1
74614,6,3,261054,261054,261057,0,3,4
74615,6,3,261060,261060,261063,0,3,3
74616,2,2,261062,261063,261065,1,3,0
74617,4,2,261066,261066,261068,0,2,1
74618,6,1,261072,261072,261073,0,1,4
74619,3,2,261075,261075,261077,0,2,2
74620,2,1,261077,261077,261078,0,1,0
74621,5,2,261082,261082,261084,0,2,4
74622,1,3,261083,261084,261087,1,4,0
74623,3,3,261086,261087,261090,1,4,0
74624,2,1,261088,261090,261091,2,3,0
74625,4,2,261092,261092,261094,0,2,1
74626,6,2,261098,261098,261100,0,2,4
74627,5,1,261103,261103,261104,0,1,3
74628,5,2,261108,261108,261110,0,2,4
74629,4,3,261112,261112,261115,0,3,2
74630,5,2,261117,261117,261119,0,2,2
74631,6,1,261123,261123,261124,0,1,4
74632,6,1,261129,261129,261130,0,1,5
74633,2,2,261131,261131,261133,0,2,1
74634,6,3,261137,261137,261140,0,3,4
74635,2,2,261139,261140,261142,1,3,0
74636,4,3,261143,261143,261146,0,3,1
74637,6,2,261149,261149,261151,0,2,3
74638,5,1,261154,261154,261155,0,1,3
74639,6,2,261160,261160,261162,0,2,5
74640,1,1,261161,261162,261163,1,2,0
74641,2,1,261163,261163,261164,0,1,0
74642,2,3,261165,261165,261168,0,3,1
74643,1,2,261166,261168,261170,2,4,0
74644,4,2,261170,261170,261172,0,2,0
74645,2,3,261172,261172,261175,0,3,0
74646,4,3,261176,261176,261179,0,3,1
74647,6,3,261182,261182,261185,0,3,3
74648,1,2,261183,261185,261187,2,4,0
74649,3,1,261186,261187,261188,1,2,0
74650,6,2,261192,261192,261194,0,2,4
74651,6,3,261198,261198,261201,0,3,4
74652,1,1,261199,261201,261202,2,3,0
74653,2,1,261201,261202,261203,1,2,0
74654,3,3,261204,261204,261207,0,3,1
74655,4,3,261208,261208,261211,0,3,1
74656,3,1,261211,261211,261212,0,1,0
74657,2,2,261213,261213,261215,0,2,1
74658,1,3,261214,261215,261218,1,4,0
74659,4,2,261218,261218,261220,0,2,0
74660,3,1,261221,261221,261222,0,1,1
74661,6,2,261227,261227,261229,0,2,5
74662,3,3,261230,261230,261233,0,3,1
74663,3,1,261233,261233,261234,0,1,0
74664,6,1,261239,261239,261240,0,1,5
74665,1,2,261240,261240,261242,0,2,0
74666,5,2,261245,261245,261247,0,2,3
74667,1,3,261246,261247,261250,1,4,0
74668,4,3,261250,261250,261253,0,3,0
74669,2,1,261252,261253,261254,1,2,0
74670,5,2,261257,261257,261259,0,2,3
74671,3,3,261260,261260,261263,0,3,1
74672,2,2,261262,261263,261265,1,3,0
74673,1,3,261263,261265,261268,2,5,0
74674,2,3,261265,261268,261271,3,6,0
74675,3,1,261268,261271,261272,3,4,0
74676,1,3,261269,261272,261275,3,6,0
74677,6,3,261275,261275,261278,0,3,0
74678,2,1,261277,261278,261279,1,2,0
74679,3,2,261280,261280,261282,0,2,1
74680,3,1,261283,261283,261284,0,1,1
74681,1,2,261284,261284,261286,0,2,0
74682,5,3,261289,261289,261292,0,3,3
74683,6,1,261295,261295,261296,0,1,3
74684,5,3,261300,261300,261303,0,3,4
74685,2,3,261302,261303,261306,1,4,0
74686,6,3,261308,261308,261311,0,3,2
74687,4,2,261312,261312,261314,0,2,1
74688,4,1,261316,261316,261317,0,1,2
74689,6,2,261322,261322,261324,0,2,5
74690,1,2,261323,261324,261326,1,3,0
74691,4,3,261327,261327,261330,0,3,1
74692,5,2,261332,261332,261334,0,2,2
74693,2,1,261334,261334,261335,0,1,0
74694,4,3,261338,261338,261341,0,3,3
74695,6,2,261344,261344,261346,0,2,3
74696,4,3,261348,261348,261351,0,3,2
74697,6,3,261354,261354,261357,0,3,3
74698,2,3,261356,261357,261360,1,4,0
74699,4,3,261360,261360,261363,0,3,0
74700,6,3,261366,261366,261369,0,3,3
74701,6,1,261372,261372,261373,0,1,3
74702,6,3,261378,261378,261381,0,3,5
74703,1,1,261379,261381,261382,2,3,0
74704,5,2,261384,261384,261386,0,2,2
74705,3,2,261387,261387,261389,0,2,1
74706,1,1,261388,261389,261390,1,2,0
74707,2,1,261390,261390,261391,0,1,0
74708,4,1,261394,261394,261395,0,1,3
74709,6,3,261400,261400,261403,0,3,5
74710,4,2,261404,261404,261406,0,2,1
74711,2,3,261406,261406,261409,0,3,0
74712,4,1,261410,261410,261411,0,1,1
74713,5,2,261415,261415,261417,0,2,4
74714,3,3,261418,261418,261421,0,3,1
74715,5,3,261423,261423,261426,0,3,2
74716,4,1,261427,261427,261428,0,1,1
74717,2,2,261429,261429,261431,0,2,1
74718,3,3,261432,261432,261435,0,3,1
74719,1,2,261433,261435,261437,2,4,0
74720,5,3,261438,261438,261441,0,3,1
74721,4,1,261442,261442,261443,0,1,1
74722,4,3,261446,261446,261449,0,3,3
74723,5,1,261451,261451,261452,0,1,2
74724,4,1,261455,261455,261456,0,1,3
74725,4,2,261459,261459,261461,0,2,3
74726,2,3,261461,261461,261464,0,3,0
74727,1,3,261462,261464,261467,2,5,0
74728,4,1,261466,261467,261468,1,2,0
74729,1,3,261467,261468,261471,1,4,0
74730,4,1,261471,261471,261472,0,1,0
74731,6,3,261477,261477,261480,0,3,5
74732,5,1,261482,261482,261483,0,1,2
74733,2,1,261484,261484,261485,0,1,1
74734,1,1,261485,261485,261486,0,1,0
74735,1,1,261486,261486,261487,0,1,0
74736,1,2,261487,261487,261489,0,2,0
74737,4,2,261491,261491,261493,0,2,2
74738,6,3,261497,261497,261500,0,3,4
74739,4,3,261501,261501,261504,0,3,1
74740,6,2,261507,261507,261509,0,2,3
74741,2,1,261509,261509,261510,0,1,0
74742,4,3,261513,261513,261516,0,3,3
74743,4,2,261517,261517,261519,0,2,1
74744,3,2,261520,261520,261522,0,2,1
74745,6,3,261526,261526,261529,0,3,4
74746,4,1,261530,261530,261531,0,1,1
74747,5,2,261535,261535,261537,0,2,4
74748,5,1,261540,261540,261541,0,1,3
74749,2,1,261542,261542,261543,0,1,1
74750,5,2,261547,261547,261549,0,2,4
74751,6,1,261553,261553,261554,0,1,4
74752,3,2,261556,261556,261558,0,2,2
74753,6,2,261562,261562,261564,0,2,4
74754,6,3,261568,261568,261571,0,3,4
74755,3,2,261571,261571,261573,0,2,0
74756,1,3,261572,261573,261576,1,4,0
74757,2,2,261574,261576,261578,2,4,0
74758,1,1,261575,261578,261579,3,4,0
74759,2,1,261577,261579,261580,2,3,0
74760,6,1,261583,261583,261584,0,1,3
74761,3,3,261586,261586,261589,0,3,2
74762,2,1,261588,261589,261590,1,2,0
74763,5,2,261593,261593,261595,0,2,3
74764,3,2,261596,261596,261598,0,2,1
74765,4,3,261600,261600,261603,0,3,2
74766,5,1,261605,261605,261606,0,1,2
74767,1,3,261606,261606,261609,0,3,0
74768,6,2,261612,261612,261614,0,2,3
74769,6,3,261618,261618,261621,0,3,4
74770,3,3,261621,261621,261624,0,3,0
74771,5,3,261626,261626,261629,0,3,2
74772,2,1,261628,261629,261630,1,2,0
74773,6,1,261634,261634,261635,0,1,4
74774,2,1,261636,261636,261637,0,1,1
74775,6,1,261642,261642,261643,0,1,5
74776,4,1,261646,261646,261647,0,1,3
74777,3,1,261649,261649,261650,0,1,2
74778,3,2,261652,261652,261654,0,2,2
74779,1,2,261653,261654,261656,1,3,0
74780,6,1,261659,261659,261660,0,1,3
74781,1,2,261660,261660,261662,0,2,0
74782,4,1,261664,261664,261665,0,1,2
74783,6,2,261670,261670,261672,0,2,5
74784,5,3,261675,261675,261678,0,3,3
74785,3,3,261678,261678,261681,0,3,0
74786,4,1,261682,261682,261683,0,1,1
74787,6,2,261688,261688,261690,0,2,5
74788,4,3,261692,261692,261695,0,3,2
74789,5,2,261697,261697,261699,0,2,2
74790,6,2,261703,261703,261705,0,2,4
74791,6,1,261709,261709,261710,0,1,4
74792,6,2,261715,261715,261717,0,2,5
74793,1,2,261716,261717,261719,1,3,0
74794,6,2,261722,261722,261724,0,2,3
74795,5,2,261727,261727,261729,0,2,3
74796,1,2,261728,261729,261731,1,3,0
74797,2,1,261730,261731,261732,1,2,0
74798,1,1,261731,261732,261733,1,2,0
74799,5,2,261736,261736,261738,0,2,3
74800,2,3,261738,261738,261741,0,3,0
74801,1,3,261739,261741,261744,2,5,0
74802,4,2,261743,261744,261746,1,3,0
74803,1,3,261744,261746,261749,2,5,0
74804,4,2,261748,261749,261751,1,3,0
74805,6,1,261754,261754,261755,0,1,3
74806,6,3,261760,261760,261763,0,3,5
74807,1,3,261761,261763,261766,2,5,0
74808,6,1,261767,261767,261768,0,1,1
74809,3,3,261770,261770,261773,0,3,2
74810,1,3,261771,261773,261776,2,5,0
74811,4,2,261775,261776,261778,1,3,0
74812,4,1,261779,261779,261780,0,1,1
74813,3,1,261782,261782,261783,0,1,2
74814,4,1,261786,261786,261787,0,1,3
74815,6,3,261792,261792,261795,0,3,5
74816,4,1,261796,261796,261797,0,1,1
74817,1,3,261797,261797,261800,0,3,0
74818,1,1,261798,261800,261801,2,3,0
74819,6,3,261804,261804,261807,0,3,3
74820,6,1,261810,261810,261811,0,1,3
74821,6,1,261816,261816,261817,0,1,5
74822,5,2,261821,261821,261823,0,2,4
74823,2,3,261823,261823,261826,0,3,0
74824,4,1,261827,261827,261828,0,1,1
74825,6,1,261833,261833,261834,0,1,5
74826,3,1,261836,261836,261837,0,1,2
74827,1,1,261837,261837,261838,0,1,0
74828,1,1,261838,261838,261839,0,1,0
74829,4,2,261842,261842,261844,0,2,3
74830,5,3,261847,261847,261850,0,3,3
74831,2,3,261849,261850,261853,1,4,0
74832,2,1,261851,261853,261854,2,3,0
74833,3,3,261854,261854,261857,0,3,0
74834,2,3,261856,261857,261860,1,4,0
74835,2,2,261858,261860,261862,2,4,0
74836,1,1,261859,261862,261863,3,4,0
74837,3,1,261862,261863,261864,1,2,0
74838,5,2,261867,261867,261869,0,2,3
74839,5,3,261872,261872,261875,0,3,3
74840,3,2,261875,261875,261877,0,2,0
74841,2,3,261877,261877,261880,0,3,0
74842,2,3,261879,261880,261883,1,4,0
74843,6,3,261885,261885,261888,0,3,2
74844,2,1,261887,261888,261889,1,2,0
74845,4,2,261891,261891,261893,0,2,2
74846,1,1,261892,261893,261894,1,2,0
74847,5,2,261897,261897,261899,0,2,3
74848,3,2,261900,261900,261902,0,2,1
74849,1,3,261901,261902,261905,1,4,0
74850,6,3,261907,261907,261910,0,3,2
74851,2,1,261909,261910,261911,1,2,0
74852,6,3,261915,261915,261918,0,3,4
74853,6,3,261921,261921,261924,0,3,3
74854,2,2,261923,261924,261926,1,3,0
74855,3,2,261926,261926,261928,0,2,0
74856,6,3,261932,261932,261935,0,3,4
74857,3,2,261935,261935,261937,0,2,0
74858,5,2,261940,261940,261942,0,2,3
74859,4,2,261944,261944,261946,0,2,2
74860,3,1,261947,261947,261948,0,1,1
74861,4,1,261951,261951,261952,0,1,3
74862,3,1,261954,261954,261955,0,1,2
74863,1,1,261955,261955,261956,0,1,0
74864,6,1,261961,261961,261962,0,1,5
74865,4,3,261965,261965,261968,0,3,3
74866,5,1,261970,261970,261971,0,1,2
74867,6,1,261976,261976,261977,0,1,5
74868,3,3,261979,261979,261982,0,3,2
74869,5,3,261984,261984,261987,0,3,2
74870,3,3,261987,261987,261990,0,3,0
74871,6,1,261993,261993,261994,0,1,3
74872,6,2,261999,261999,262001,0,2,5
74873,4,3,262003,262003,262006,0,3,2
74874,5,2,262008,262008,262010,0,2,2
74875,1,2,262009,262010,262012,1,3,0
74876,1,3,262010,262012,262015,2,5,0
74877,1,1,262011,262015,262016,4,5,0
74878,4,3,262015,262016,262019,1,4,0
74879,1,2,262016,262019,262021,3,5,0
74880,6,3,262022,262022,262025,0,3,1
74881,1,2,262023,262025,262027,2,4,0
74882,3,1,262026,262027,262028,1,2,0
74883,4,3,262030,262030,262033,0,3,2
74884,6,3,262036,262036,262039,0,3,3
74885,5,2,262041,262041,262043,0,2,2
74886,6,3,262047,262047,262050,0,3,4
74887,3,1,262050,262050,262051,0,1,0
74888,4,2,262054,262054,262056,0,2,3
74889,3,3,262057,262057,262060,0,3,1
74890,4,1,262061,262061,262062,0,1,1
74891,5,3,262066,262066,262069,0,3,4
74892,3,1,262069,262069,262070,0,1,0
74893,2,1,262071,262071,262072,0,1,1
74894,5,1,262076,262076,262077,0,1,4
74895,1,2,262077,262077,262079,0,2,0
74896,2,3,262079,262079,262082,0,3,0
74897,3,1,262082,262082,262083,0,1,0
74898,4,1,262086,262086,262087,0,1,3
74899,1,2,262087,262087,262089,0,2,0
74900,3,2,262090,262090,262092,0,2,1
74901,6,3,262096,262096,262099,0,3,4
74902,1,1,262097,262099,262100,2,3,0
74903,4,3,262101,262101,262104,0,3,1
74904,3,1,262104,262104,262105,0,1,0
74905,3,1,262107,262107,262108,0,1,2
74906,1,2,262108,262108,262110,0,2,0
74907,1,3,262109,262110,262113,1,4,0
74908,6,3,262115,262115,262118,0,3,2
74909,2,1,262117,262118,262119,1,2,0
74910,1,1,262118,262119,262120,1,2,0
74911,1,1,262119,262120,262121,1,2,0
74912,5,1,262124,262124,262125,0,1,3
74913,3,3,262127,262127,262130,0,3,2
74914,3,1,262130,262130,262131,0,1,0
74915,6,3,262136,262136,262139,0,3,5
74916,4,2,262140,262140,262142,0,2,1
74917,6,1,262146,262146,262147,0,1,4
74918,6,1,262152,262152,262153,0,1,5
74919,6,2,262158,262158,262160,0,2,5
74920,5,2,262163,262163,262165,0,2,3
74921,6,1,262169,262169,262170,0,1,4
74922,4,1,262173,262173,262174,0,1,3
74923,1,3,262174,262174,262177,0,3,0
74924,1,2,262175,262177,262179,2,4,0
74925,4,3,262179,262179,262182,0,3,0
74926,5,3,262184,262184,262187,0,3,2
74927,5,1,262189,262189,262190,0,1,2
74928,2,3,262191,262191,262194,0,3,1
74929,6,3,262197,262197,262200,0,3,3
74930,6,3,262203,262203,262206,0,3,3
74931,3,2,262206,262206,262208,0,2,0
74932,6,3,262212,262212,262215,0,3,4
74933,5,2,262217,262217,262219,0,2,2
74934,1,1,262218,262219,262220,1,2,0
74935,5,1,262223,262223,262224,0,1,3
74936,2,2,262225,262225,262227,0,2,1
74937,2,1,262227,262227,262228,0,1,0
74938,3,3,262230,262230,262233,0,3,2
74939,6,2,262236,262236,262238,0,2,3
74940,5,3,262241,262241,262244,0,3,3
74941,3,1,262244,262244,262245,0,1,0
74942,4,2,262248,262248,262250,0,2,3
74943,1,3,262249,262250,262253,1,4,0
74944,4,1,262253,262253,262254,0,1,0
74945,5,2,262258,262258,262260,0,2,4
74946,4,3,262262,262262,262265,0,3,2
74947,3,3,262265,262265,262268,0,3,0
74948,6,3,262271,262271,262274,0,3,3
74949,3,3,262274,262274,262277,0,3,0
74950,3,2,262277,262277,262279,0,2,0
74951,1,2,262278,262279,262281,1,3,0
74952,4,2,262282,262282,262284,0,2,1
74953,6,1,262288,262288,262289,0,1,4
74954,2,3,262290,262290,262293,0,3,1
74955,6,2,262296,262296,262298,0,2,3
74956,4,1,262300,262300,262301,0,1,2
74957,6,1,262306,262306,262307,0,1,5
74958,3,3,262309,262309,262312,0,3,2
74959,6,2,262315,262315,262317,0,2,3
74960,2,3,262317,262317,262320,0,3,0
74961,2,3,262319,262320,262323,1,4,0
74962,4,2,262323,262323,262325,0,2,0
74963,2,3,262325,262325,262328,0,3,0
74964,5,1,262330,262330,262331,0,1,2
74965,3,1,262333,262333,262334,0,1,2
74966,6,2,262339,262339,262341,0,2,5
74967,1,2,262340,262341,262343,1,3,0
74968,5,1,262345,262345,262346,0,1,2
74969,5,2,262350,262350,262352,0,2,4
74970,6,3,262356,262356,262359,0,3,4
74971,2,2,262358,262359,262361,1,3,0
74972,5,1,262363,262363,262364,0,1,2
74973,4,1,262367,262367,262368,0,1,3
74974,2,3,262369,262369,262372,0,3,1
74975,5,1,262374,262374,262375,0,1,2
74976,6,2,262380,262380,262382,0,2,5
74977,5,3,262385,262385,262388,0,3,3
74978,2,2,262387,262388,262390,1,3,0
74979,2,1,262389,262390,262391,1,2,0
74980,1,1,262390,262391,262392,1,2,0
74981,6,2,262396,262396,262398,0,2,4
74982,6,1,262402,262402,262403,0,1,4
74983,5,2,262407,262407,262409,0,2,4
74984,2,1,262409,262409,262410,0,1,0
74985,1,2,262410,262410,262412,0,2,0
74986,5,2,262415,262415,262417,0,2,3
74987,4,3,262419,262419,262422,0,3,2
74988,1,2,262420,262422,262424,2,4,0
74989,4,2,262424,262424,262426,0,2,0
74990,2,1,262426,262426,262427,0,1,0
74991,1,3,262427,262427,262430,0,3,0
74992,2,3,262429,262430,262433,1,4,0
74993,2,1,262431,262433,262434,2,3,0
74994,2,2,262433,262434,262436,1,3,0
74995,4,2,262437,262437,262439,0,2,1
74996,6,3,262443,262443,262446,0,3,4
74997,1,3,262444,262446,262449,2,5,0
74998,6,3,262450,262450,262453,0,3,1
74999,4,3,262454,262454,262457,0,3,1
75000,3,1,262457,262457,262458,0,1,0
75001,6,1,262463,262463,262464,0,1,5
75002,6,2,262469,262469,262471,0,2,5
75003,5,1,262474,262474,262475,0,1,3
75004,3,3,262477,262477,262480,0,3,2
75005,4,3,262481,262481,262484,0,3,1
75006,2,3,262483,262484,262487,1,4,0
75007,3,3,262486,262487,262490,1,4,0
75008,4,2,262490,262490,262492,0,2,0
75009,5,3,262495,262495,262498,0,3,3
75010,6,3,262501,262501,262504,0,3,3
75011,1,2,262502,262504,262506,2,4,0
75012,1,1,262503,262506,262507,3,4,0
75013,2,2,262505,262507,262509,2,4,0
75014,5,3,262510,262510,262513,0,3,1
75015,6,3,262516,262516,262519,0,3,3
75016,5,2,262521,262521,262523,0,2,2
75017,3,1,262524,262524,262525,0,1,1
75018,4,2,262528,262528,262530,0,2,3
75019,2,1,262530,262530,262531,0,1,0
75020,1,2,262531,262531,262533,0,2,0
75021,1,2,262532,262533,262535,1,3,0
75022,5,1,262537,262537,262538,0,1,2
75023,4,1,262541,262541,262542,0,1,3
75024,3,3,262544,262544,262547,0,3,2
75025,2,1,262546,262547,262548,1,2,0
75026,6,2,262552,262552,262554,0,2,4
75027,2,1,262554,262554,262555,0,1,0
75028,3,3,262557,262557,262560,0,3,2
75029,2,3,262559,262560,262563,1,4,0
75030,4,3,262563,262563,262566,0,3,0
75031,3,3,262566,262566,262569,0,3,0
75032,1,3,262567,262569,262572,2,5,0
75033,4,2,262571,262572,262574,1,3,0
75034,3,2,262574,262574,262576,0,2,0
75035,1,2,262575,262576,262578,1,3,0
75036,3,3,262578,262578,262581,0,3,0
75037,3,1,262581,262581,262582,0,1,0
75038,1,3,262582,262582,262585,0,3,0
75039,5,3,262587,262587,262590,0,3,2
75040,1,1,262588,262590,262591,2,3,0
75041,4,3,262592,262592,262595,0,3,1
75042,5,3,262597,262597,262600,0,3,2
75043,5,2,262602,262602,262604,0,2,2
75044,1,1,262603,262604,262605,1,2,0
75045,6,3,262609,262609,262612,0,3,4
75046,5,2,262614,262614,262616,0,2,2
75047,3,2,262617,262617,262619,0,2,1
75048,5,3,262622,262622,262625,0,3,3
75049,4,3,262626,262626,262629,0,3,1
75050,2,3,262628,262629,262632,1,4,0
75051,5,3,262633,262633,262636,0,3,1
75052,3,3,262636,262636,262639,0,3,0
75053,1,2,262637,262639,262641,2,4,0
75054,2,2,262639,262641,262643,2,4,0
75055,4,1,262643,262643,262644,0,1,0
75056,2,2,262645,262645,262647,0,2,1
75057,2,1,262647,262647,262648,0,1,0
75058,6,3,262653,262653,262656,0,3,5
75059,2,3,262655,262656,262659,1,4,0
75060,5,1,262660,262660,262661,0,1,1
75061,2,2,262662,262662,262664,0,2,1
75062,3,2,262665,262665,262667,0,2,1
75063,5,1,262670,262670,262671,0,1,3
75064,1,3,262671,262671,262674,0,3,0
75065,1,1,262672,262674,262675,2,3,0
75066,1,1,262673,262675,262676,2,3,0
75067,5,1,262678,262678,262679,0,1,2
75068,4,1,262682,262682,262683,0,1,3
75069,3,2,262685,262685,262687,0,2,2
75070,6,1,262691,262691,262692,0,1,4
75071,6,3,262697,262697,262700,0,3,5
75072,2,2,262699,262700,262702,1,3,0
75073,6,2,262705,262705,262707,0,2,3
75074,1,2,262706,262707,262709,1,3,0
75075,3,3,262709,262709,262712,0,3,0
75076,3,3,262712,262712,262715,0,3,0
75077,1,2,262713,262715,262717,2,4,0
75078,3,1,262716,262717,262718,1,2,0
75079,4,1,262720,262720,262721,0,1,2
75080,3,1,262723,262723,262724,0,1,2
75081,3,3,262726,262726,262729,0,3,2
75082,4,1,262730,262730,262731,0,1,1
75083,1,3,262731,262731,262734,0,3,0
75084,4,1,262735,262735,262736,0,1,1
75085,3,1,262738,262738,262739,0,1,2
75086,3,3,262741,262741,262744,0,3,2
75087,6,2,262747,262747,262749,0,2,3
75088,1,3,262748,262749,262752,1,4,0
75089,5,1,262753,262753,262754,0,1,1
75090,4,3,262757,262757,262760,0,3,3
75091,2,2,262759,262760,262762,1,3,0
75092,5,3,262764,262764,262767,0,3,2
75093,1,2,262765,262767,262769,2,4,0
75094,3,1,262768,262769,262770,1,2,0
75095,1,2,262769,262770,262772,1,3,0
75096,3,1,262772,262772,262773,0,1,0
75097,4,3,262776,262776,262779,0,3,3
75098,4,2,262780,262780,262782,0,2,1
75099,1,2,262781,262782,262784,1,3,0
75100,4,2,262785,262785,262787,0,2,1
75101,2,3,262787,262787,262790,0,3,0
75102,6,1,262793,262793,262794,0,1,3
75103,2,3,262795,262795,262798,0,3,1
75104,1,2,262796,262798,262800,2,4,0
75105,1,3,262797,262800,262803,3,6,0
75106,6,1,262803,262803,262804,0,1,0
75107,3,2,262806,262806,262808,0,2,2
75108,6,2,262812,262812,262814,0,2,4
75109,3,3,262815,262815,262818,0,3,1
75110,2,2,262817,262818,262820,1,3,0
75111,5,3,262822,262822,262825,0,3,2
75112,4,1,262826,262826,262827,0,1,1
75113,5,3,262831,262831,262834,0,3,4
75114,3,3,262834,262834,262837,0,3,0
75115,1,3,262835,262837,262840,2,5,0
75116,4,1,262839,262840,262841,1,2,0
75117,2,1,262841,262841,262842,0,1,0
75118,4,3,262845,262845,262848,0,3,3
75119,2,1,262847,262848,262849,1,2,0
75120,2,2,262849,262849,262851,0,2,0
75121,5,3,262854,262854,262857,0,3,3
75122,1,2,262855,262857,262859,2,4,0
75123,6,2,262861,262861,262863,0,2,2
75124,4,2,262865,262865,262867,0,2,2
75125,5,2,262870,262870,262872,0,2,3
75126,5,2,262875,262875,262877,0,2,3
75127,3,1,262878,262878,262879,0,1,1
75128,3,1,262881,262881,262882,0,1,2
75129,4,1,262885,262885,262886,0,1,3
75130,6,1,262891,262891,262892,0,1,5
75131,1,1,262892,262892,262893,0,1,0
75132,1,2,262893,262893,262895,0,2,0
75133,6,3,262899,262899,262902,0,3,4
75134,6,1,262905,262905,262906,0,1,3
75135,1,3,262906,262906,262909,0,3,0
75136,1,1,262907,262909,262910,2,3,0
75137,5,1,262912,262912,262913,0,1,2
75138,3,3,262915,262915,262918,0,3,2
75139,4,1,262919,262919,262920,0,1,1
75140,5,2,262924,262924,262926,0,2,4
75141,4,1,262928,262928,262929,0,1,2
75142,4,1,262932,262932,262933,0,1,3
75143,5,3,262937,262937,262940,0,3,4
75144,1,3,262938,262940,262943,2,5,0
75145,2,2,262940,262943,262945,3,5,0
75146,1,1,262941,262945,262946,4,5,0
75147,6,3,262947,262947,262950,0,3,1
75148,3,1,262950,262950,262951,0,1,0
75149,3,2,262953,262953,262955,0,2,2
75150,6,2,262959,262959,262961,0,2,4
75151,2,3,262961,262961,262964,0,3,0
75152,3,3,262964,262964,262967,0,3,0
75153,4,1,262968,262968,262969,0,1,1
75154,4,2,262972,262972,262974,0,2,3
75155,2,1,262974,262974,262975,0,1,0
75156,3,1,262977,262977,262978,0,1,2
75157,6,2,262983,262983,262985,0,2,5
75158,2,1,262985,262985,262986,0,1,0
75159,4,1,262989,262989,262990,0,1,3
75160,1,1,262990,262990,262991,0,1,0
75161,4,3,262994,262994,262997,0,3,3
75162,6,1,263000,263000,263001,0,1,3
75163,2,2,263002,263002,263004,0,2,1
75164,1,3,263003,263004,263007,1,4,0
75165,4,2,263007,263007,263009,0,2,0
75166,5,2,263012,263012,263014,0,2,3
75167,5,2,263017,263017,263019,0,2,3
75168,2,3,263019,263019,263022,0,3,0
75169,4,3,263023,263023,263026,0,3,1
75170,3,1,263026,263026,263027,0,1,0
75171,6,1,263032,263032,263033,0,1,5
75172,4,2,263036,263036,263038,0,2,3
75173,3,3,263039,263039,263042,0,3,1
75174,6,3,263045,263045,263048,0,3,3
75175,3,3,263048,263048,263051,0,3,0
75176,1,3,263049,263051,263054,2,5,0
75177,5,3,263054,263054,263057,0,3,0
75178,3,2,263057,263057,263059,0,2,0
75179,6,1,263063,263063,263064,0,1,4
75180,3,2,263066,263066,263068,0,2,2
75181,5,2,263071,263071,263073,0,2,3
75182,2,3,263073,263073,263076,0,3,0
75183,1,1,263074,263076,263077,2,3,0
75184,5,3,263079,263079,263082,0,3,2
75185,3,3,263082,263082,263085,0,3,0
75186,4,1,263086,263086,263087,0,1,1
75187,6,1,263092,263092,263093,0,1,5
75188,4,3,263096,263096,263099,0,3,3
75189,5,2,263101,263101,263103,0,2,2
75190,4,2,263105,263105,263107,0,2,2
75191,2,1,263107,263107,263108,0,1,0
75192,1,2,263108,263108,263110,0,2,0
75193,3,2,263111,263111,263113,0,2,1
75194,1,1,263112,263113,263114,1,2,0
75195,6,1,263118,263118,263119,0,1,4
75196,2,3,263120,263120,263123,0,3,1
75197,5,3,263125,263125,263128,0,3,2
75198,5,1,263130,263130,263131,0,1,2
75199,3,2,263133,263133,263135,0,2,2
75200,2,1,263135,263135,263136,0,1,0
75201,3,1,263138,263138,263139,0,1,2
75202,5,3,263143,263143,263146,0,3,4
75203,6,1,263149,263149,263150,0,1,3
75204,6,2,263155,263155,263157,0,2,5
75205,6,2,263161,263161,263163,0,2,4
75206,4,2,263165,263165,263167,0,2,2
75207,5,3,263170,263170,263173,0,3,3
75208,2,3,263172,263173,263176,1,4,0
75209,4,3,263176,263176,263179,0,3,0
75210,6,1,263182,263182,263183,0,1,3
75211,5,1,263187,263187,263188,0,1,4
75212,5,1,263192,263192,263193,0,1,4
75213,2,1,263194,263194,263195,0,1,1
75214,2,3,263196,263196,263199,0,3,1
75215,2,2,263198,263199,263201,1,3,0
75216,4,2,263202,263202,263204,0,2,1
75217,3,3,263205,263205,263208,0,3,1
75218,4,3,263209,263209,263212,0,3,1
75219,5,1,263214,263214,263215,0,1,2
75220,1,3,263215,263215,263218,0,3,0
75221,5,1,263220,263220,263221,0,1,2
75222,5,1,263225,263225,263226,0,1,4
75223,1,1,263226,263226,263227,0,1,0
75224,6,2,263232,263232,263234,0,2,5
75225,5,2,263237,263237,263239,0,2,3
75226,6,2,263243,263243,263245,0,2,4
75227,2,3,263245,263245,263248,0,3,0
75228,5,2,263250,263250,263252,0,2,2
75229,3,1,263253,263253,263254,0,1,1
75230,5,2,263258,263258,263260,0,2,4
75231,6,1,263264,263264,263265,0,1,4
75232,3,1,263267,263267,263268,0,1,2
75233,6,2,263273,263273,263275,0,2,5
75234,2,1,263275,263275,263276,0,1,0
75235,2,2,263277,263277,263279,0,2,1
75236,4,2,263281,263281,263283,0,2,2
75237,3,3,263284,263284,263287,0,3,1
75238,1,1,263285,263287,263288,2,3,0
75239,1,2,263286,263288,263290,2,4,0
75240,1,3,263287,263290,263293,3,6,0
75241,3,2,263290,263293,263295,3,5,0
75242,4,2,263294,263295,263297,1,3,0
75243,2,1,263296,263297,263298,1,2,0
75244,3,2,263299,263299,263301,0,2,1
75245,2,2,263301,263301,263303,0,2,0
75246,1,1,263302,263303,263304,1,2,0
75247,1,2,263303,263304,263306,1,3,0
75248,4,3,263307,263307,263310,0,3,1
75249,5,2,263312,263312,263314,0,2,2
75250,2,3,263314,263314,263317,0,3,0
75251,3,3,263317,263317,263320,0,3,0
75252,5,3,263322,263322,263325,0,3,2
75253,2,2,263324,263325,263327,1,3,0
75254,2,1,263326,263327,263328,1,2,0
75255,2,1,263328,263328,263329,0,1,0
75256,3,3,263331,263331,263334,0,3,2
75257,3,3,263334,263334,263337,0,3,0
75258,6,2,263340,263340,263342,0,2,3
75259,2,3,263342,263342,263345,0,3,0
75260,1,3,263343,263345,263348,2,5,0
75261,4,1,263347,263348,263349,1,2,0
75262,3,3,263350,263350,263353,0,3,1
75263,4,2,263354,263354,263356,0,2,1
75264,3,3,263357,263357,263360,0,3,1
75265,1,2,263358,263360,263362,2,4,0
75266,5,3,263363,263363,263366,0,3,1
75267,1,3,263364,263366,263369,2,5,0
75268,4,3,263368,263369,263372,1,4,0
75269,5,3,263373,263373,263376,0,3,1
75270,4,3,263377,263377,263380,0,3,1
75271,6,1,263383,263383,263384,0,1,3
75272,5,1,263388,263388,263389,0,1,4
75273,5,1,263393,263393,263394,0,1,4
75274,4,2,263397,263397,263399,0,2,3
75275,4,3,263401,263401,263404,0,3,2
75276,5,2,263406,263406,263408,0,2,2
75277,5,1,263411,263411,263412,0,1,3
75278,4,2,263415,263415,263417,0,2,3
75279,6,2,263421,263421,263423,0,2,4
75280,5,1,263426,263426,263427,0,1,3
75281,5,2,263431,263431,263433,0,2,4
75282,6,1,263437,263437,263438,0,1,4
75283,3,1,263440,263440,263441,0,1,2
75284,2,2,263442,263442,263444,0,2,1
75285,3,3,263445,263445,263448,0,3,1
75286,5,2,263450,263450,263452,0,2,2
75287,6,1,263456,263456,263457,0,1,4
75288,4,1,263460,263460,263461,0,1,3
75289,1,1,263461,263461,263462,0,1,0
75290,6,3,263467,263467,263470,0,3,5
75291,5,3,263472,263472,263475,0,3,2
75292,5,2,263477,263477,263479,0,2,2
75293,1,1,263478,263479,263480,1,2,0
75294,2,1,263480,263480,263481,0,1,0
75295,5,3,263485,263485,263488,0,3,4
75296,4,2,263489,263489,263491,0,2,1
75297,2,3,263491,263491,263494,0,3,0
75298,4,3,263495,263495,263498,0,3,1
75299,6,2,263501,263501,263503,0,2,3
75300,2,1,263503,263503,263504,0,1,0
75301,4,2,263507,263507,263509,0,2,3
75302,1,3,263508,263509,263512,1,4,0
75303,3,3,263511,263512,263515,1,4,0
75304,4,3,263515,263515,263518,0,3,0
75305,5,3,263520,263520,263523,0,3,2
75306,5,3,263525,263525,263528,0,3,2
75307,2,3,263527,263528,263531,1,4,0
75308,6,1,263533,263533,263534,0,1,2
75309,3,2,263536,263536,263538,0,2,2
75310,5,1,263541,263541,263542,0,1,3
75311,2,2,263543,263543,263545,0,2,1
75312,6,1,263549,263549,263550,0,1,4
75313,3,3,263552,263552,263555,0,3,2
75314,1,3,263553,263555,263558,2,5,0
75315,2,2,263555,263558,263560,3,5,0
75316,5,1,263560,263560,263561,0,1,0
75317,3,2,263563,263563,263565,0,2,2
75318,5,3,263568,263568,263571,0,3,3
75319,3,2,263571,263571,263573,0,2,0
75320,2,2,263573,263573,263575,0,2,0
75321,2,1,263575,263575,263576,0,1,0
75322,4,1,263579,263579,263580,0,1,3
75323,6,1,263585,263585,263586,0,1,5
75324,1,3,263586,263586,263589,0,3,0
75325,2,3,263588,263589,263592,1,4,0
75326,1,2,263589,263592,263594,3,5,0
75327,3,1,263592,263594,263595,2,3,0
75328,5,2,263597,263597,263599,0,2,2
75329,2,2,263599,263599,263601,0,2,0
75330,1,2,263600,263601,263603,1,3,0
75331,5,2,263605,263605,263607,0,2,2
75332,2,3,263607,263607,263610,0,3,0
75333,4,3,263611,263611,263614,0,3,1
75334,5,1,263616,263616,263617,0,1,2
75335,6,2,263622,263622,263624,0,2,5
75336,1,1,263623,263624,263625,1,2,0
75337,5,1,263628,263628,263629,0,1,3
75338,2,1,263630,263630,263631,0,1,1
75339,6,2,263636,263636,263638,0,2,5
75340,2,2,263638,263638,263640,0,2,0
75341,4,2,263642,263642,263644,0,2,2
75342,5,3,263647,263647,263650,0,3,3
75343,5,3,263652,263652,263655,0,3,2
75344,1,3,263653,263655,263658,2,5,0
75345,5,3,263658,263658,263661,0,3,0
75346,4,3,263662,263662,263665,0,3,1
75347,4,1,263666,263666,263667,0,1,1
75348,3,2,263669,263669,263671,0,2,2
75349,6,2,263675,263675,263677,0,2,4
75350,1,3,263676,263677,263680,1,4,0
75351,3,1,263679,263680,263681,1,2,0
75352,2,2,263681,263681,263683,0,2,0
75353,5,2,263686,263686,263688,0,2,3
75354,4,2,263690,263690,263692,0,2,2
75355,4,3,263694,263694,263697,0,3,2
75356,1,3,263695,263697,263700,2,5,0
75357,4,1,263699,263700,263701,1,2,0
75358,6,3,263705,263705,263708,0,3,4
75359,6,1,263711,263711,263712,0,1,3
75360,6,3,263717,263717,263720,0,3,5
75361,5,2,263722,263722,263724,0,2,2
75362,5,3,263727,263727,263730,0,3,3
75363,1,2,263728,263730,263732,2,4,0
75364,6,1,263734,263734,263735,0,1,2
75365,4,2,263738,263738,263740,0,2,3
75366,4,3,263742,263742,263745,0,3,2
75367,4,1,263746,263746,263747,0,1,1
75368,5,1,263751,263751,263752,0,1,4
75369,1,2,263752,263752,263754,0,2,0
75370,6,1,263758,263758,263759,0,1,4
75371,1,2,263759,263759,263761,0,2,0
75372,6,1,263765,263765,263766,0,1,4
75373,4,1,263769,263769,263770,0,1,3
75374,1,3,263770,263770,263773,0,3,0
75375,2,1,263772,263773,263774,1,2,0
75376,5,3,263777,263777,263780,0,3,3
75377,4,3,263781,263781,263784,0,3,1
75378,3,2,263784,263784,263786,0,2,0
75379,3,1,263787,263787,263788,0,1,1
75380,4,1,263791,263791,263792,0,1,3
75381,3,2,263794,263794,263796,0,2,2
75382,2,1,263796,263796,263797,0,1,0
75383,6,1,263802,263802,263803,0,1,5
75384,3,3,263805,263805,263808,0,3,2
75385,6,1,263811,263811,263812,0,1,3
75386,6,2,263817,263817,263819,0,2,5
75387,5,2,263822,263822,263824,0,2,3
75388,2,2,263824,263824,263826,0,2,0
75389,1,2,263825,263826,263828,1,3,0
75390,2,2,263827,263828,263830,1,3,0
75391,2,3,263829,263830,263833,1,4,0
75392,3,2,263832,263833,263835,1,3,0
75393,4,2,263836,263836,263838,0,2,1
75394,2,1,263838,263838,263839,0,1,0
75395,6,3,263844,263844,263847,0,3,5
75396,4,2,263848,263848,263850,0,2,1
75397,1,2,263849,263850,263852,1,3,0
75398,1,2,263850,263852,263854,2,4,0
75399,1,3,263851,263854,263857,3,6,0
75400,1,1,263852,263857,263858,5,6,0
75401,3,3,263855,263858,263861,3,6,0
75402,5,2,263860,263861,263863,1,3,0
75403,1,3,263861,263863,263866,2,5,0
75404,6,3,263867,263867,263870,0,3,1
75405,5,2,263872,263872,263874,0,2,2
75406,2,1,263874,263874,263875,0,1,0
75407,5,2,263879,263879,263881,0,2,4
75408,6,3,263885,263885,263888,0,3,4
75409,3,1,263888,263888,263889,0,1,0
75410,2,2,263890,263890,263892,0,2,1
75411,6,3,263896,263896,263899,0,3,4
75412,1,2,263897,263899,263901,2,4,0
75413,1,3,263898,263901,263904,3,6,0
75414,1,1,263899,263904,263905,5,6,0
75415,6,2,263905,263905,263907,0,2,0
75416,4,3,263909,263909,263912,0,3,2
75417,6,1,263915,263915,263916,0,1,3
75418,6,3,263921,263921,263924,0,3,5
75419,6,3,263927,263927,263930,0,3,3
75420,1,3,263928,263930,263933,2,5,0
75421,5,1,263933,263933,263934,0,1,0
75422,3,3,263936,263936,263939,0,3,2
75423,2,3,263938,263939,263942,1,4,0
75424,5,2,263943,263943,263945,0,2,1
75425,3,2,263946,263946,263948,0,2,1
75426,6,1,263952,263952,263953,0,1,4
75427,6,1,263958,263958,263959,0,1,5
75428,6,2,263964,263964,263966,0,2,5
75429,1,3,263965,263966,263969,1,4,0
75430,5,2,263970,263970,263972,0,2,1
75431,3,2,263973,263973,263975,0,2,1
75432,4,3,263977,263977,263980,0,3,2
75433,5,3,263982,263982,263985,0,3,2
75434,6,1,263988,263988,263989,0,1,3
75435,3,1,263991,263991,263992,0,1,2
75436,5,3,263996,263996,263999,0,3,4
75437,2,1,263998,263999,264000,1,2,0
75438,6,3,264004,264004,264007,0,3,4
75439,1,1,264005,264007,264008,2,3,0
75440,5,1,264010,264010,264011,0,1,2
75441,3,1,264013,264013,264014,0,1,2
75442,5,3,264018,264018,264021,0,3,4
75443,6,3,264024,264024,264027,0,3,3
75444,4,2,264028,264028,264030,0,2,1
75445,6,2,264034,264034,264036,0,2,4
75446,2,1,264036,264036,264037,0,1,0
75447,4,2,264040,264040,264042,0,2,3
75448,4,3,264044,264044,264047,0,3,2
75449,3,1,264047,264047,264048,0,1,0
75450,1,2,264048,264048,264050,0,2,0
75451,6,2,264054,264054,264056,0,2,4
75452,3,2,264057,264057,264059,0,2,1
75453,1,1,264058,264059,264060,1,2,0
75454,1,2,264059,264060,264062,1,3,0
75455,1,3,264060,264062,264065,2,5,0
75456,5,1,264065,264065,264066,0,1,0
75457,2,2,264067,264067,264069,0,2,1
75458,4,2,264071,264071,264073,0,2,2
75459,2,1,264073,264073,264074,0,1,0
75460,5,2,264078,264078,264080,0,2,4
75461,3,3,264081,264081,264084,0,3,1
75462,1,1,264082,264084,264085,2,3,0
75463,3,2,264085,264085,264087,0,2,0
75464,2,1,264087,264087,264088,0,1,0
75465,5,1,264092,264092,264093,0,1,4
75466,2,1,264094,264094,264095,0,1,1
75467,1,1,264095,264095,264096,0,1,0
75468,1,2,264096,264096,264098,0,2,0
75469,1,1,264097,264098,264099,1,2,0
75470,5,3,264102,264102,264105,0,3,3
75471,1,2,264103,264105,264107,2,4,0
75472,2,1,264105,264107,264108,2,3,0
75473,1,3,264106,264108,264111,2,5,0
75474,6,2,264112,264112,264114,0,2,1
75475,1,2,264113,264114,264116,1,3,0
75476,4,1,264117,264117,264118,0,1,1
75477,3,1,264120,264120,264121,0,1,2
75478,1,2,264121,264121,264123,0,2,0
75479,2,2,264123,264123,264125,0,2,0
75480,2,2,264125,264125,264127,0,2,0
75481,6,1,264131,264131,264132,0,1,4
75482,1,2,264132,264132,264134,0,2,0
75483,2,1,264134,264134,264135,0,1,0
75484,1,3,264135,264135,264138,0,3,0
75485,2,2,264137,264138,264140,1,3,0
75486,6,3,264143,264143,264146,0,3,3
75487,3,3,264146,264146,264149,0,3,0
75488,4,1,264150,264150,264151,0,1,1
75489,4,1,264154,264154,264155,0,1,3
75490,3,3,264157,264157,264160,0,3,2
75491,6,2,264163,264163,264165,0,2,3
75492,1,2,264164,264165,264167,1,3,0
75493,4,1,264168,264168,264169,0,1,1
75494,1,2,264169,264169,264171,0,2,0
75495,6,1,264175,264175,264176,0,1,4
75496,5,3,264180,264180,264183,0,3,4
75497,3,1,264183,264183,264184,0,1,0
75498,6,2,264189,264189,264191,0,2,5
75499,4,2,264193,264193,264195,0,2,2
75500,2,3,264195,264195,264198,0,3,0
75501,2,1,264197,264198,264199,1,2,0
75502,2,2,264199,264199,264201,0,2,0
75503,6,3,264205,264205,264208,0,3,4
75504,6,1,264211,264211,264212,0,1,3
75505,3,1,264214,264214,264215,0,1,2
75506,1,2,264215,264215,264217,0,2,0
75507,1,2,264216,264217,264219,1,3,0
75508,4,3,264220,264220,264223,0,3,1
75509,4,2,264224,264224,264226,0,2,1
75510,4,1,264228,264228,264229,0,1,2
75511,1,2,264229,264229,264231,0,2,0
75512,5,3,264234,264234,264237,0,3,3
75513,6,2,264240,264240,264242,0,2,3
75514,5,1,264245,264245,264246,0,1,3
75515,4,2,264249,264249,264251,0,2,3
75516,4,1,264253,264253,264254,0,1,2
75517,4,1,264257,264257,264258,0,1,3
75518,6,1,264263,264263,264264,0,1,5
75519,5,1,264268,264268,264269,0,1,4
75520,5,3,264273,264273,264276,0,3,4
75521,3,3,264276,264276,264279,0,3,0
75522,2,2,264278,264279,264281,1,3,0
75523,3,1,264281,264281,264282,0,1,0
75524,2,2,264283,264283,264285,0,2,1
75525,5,3,264288,264288,264291,0,3,3
75526,3,3,264291,264291,264294,0,3,0
75527,3,3,264294,264294,264297,0,3,0
75528,2,3,264296,264297,264300,1,4,0
75529,3,3,264299,264300,264303,1,4,0
75530,4,1,264303,264303,264304,0,1,0
75531,5,3,264308,264308,264311,0,3,4
75532,1,2,264309,264311,264313,2,4,0
75533,3,3,264312,264313,264316,1,4,0
75534,3,3,264315,264316,264319,1,4,0
75535,2,3,264317,264319,264322,2,5,0
75536,5,3,264322,264322,264325,0,3,0
75537,2,3,264324,264325,264328,1,4,0
75538,5,2,264329,264329,264331,0,2,1
75539,2,1,264331,264331,264332,0,1,0
75540,6,1,264337,264337,264338,0,1,5
75541,5,3,264342,264342,264345,0,3,4
75542,6,1,264348,264348,264349,0,1,3
75543,4,2,264352,264352,264354,0,2,3
75544,5,2,264357,264357,264359,0,2,3
75545,4,2,264361,264361,264363,0,2,2
75546,1,1,264362,264363,264364,1,2,0
75547,6,3,264368,264368,264371,0,3,4
75548,2,3,264370,264371,264374,1,4,0
75549,2,1,264372,264374,264375,2,3,0
75550,3,2,264375,264375,264377,0,2,0
75551,6,3,264381,264381,264384,0,3,4
75552,4,1,264385,264385,264386,0,1,1
75553,1,3,264386,264386,264389,0,3,0
75554,6,2,264392,264392,264394,0,2,3
75555,5,2,264397,264397,264399,0,2,3
75556,4,1,264401,264401,264402,0,1,2
75557,4,2,264405,264405,264407,0,2,3
75558,6,2,264411,264411,264413,0,2,4
75559,3,1,264414,264414,264415,0,1,1
75560,5,1,264419,264419,264420,0,1,4
75561,3,1,264422,264422,264423,0,1,2
75562,1,2,264423,264423,264425,0,2,0
75563,3,2,264426,264426,264428,0,2,1
75564,1,1,264427,264428,264429,1,2,0
75565,1,3,264428,264429,264432,1,4,0
75566,3,2,264431,264432,264434,1,3,0
75567,3,1,264434,264434,264435,0,1,0
75568,1,1,264435,264435,264436,0,1,0
75569,1,2,264436,264436,264438,0,2,0
75570,6,3,264442,264442,264445,0,3,4
75571,4,2,264446,264446,264448,0,2,1
75572,1,1,264447,264448,264449,1,2,0
75573,4,3,264451,264451,264454,0,3,2
75574,5,1,264456,264456,264457,0,1,2
75575,5,2,264461,264461,264463,0,2,4
75576,1,3,264462,264463,264466,1,4,0
75577,3,1,264465,264466,264467,1,2,0
75578,6,2,264471,264471,264473,0,2,4
75579,6,3,264477,264477,264480,0,3,4
75580,5,3,264482,264482,264485,0,3,2
75581,4,2,264486,264486,264488,0,2,1
75582,3,1,264489,264489,264490,0,1,1
75583,4,2,264493,264493,264495,0,2,3
75584,5,2,264498,264498,264500,0,2,3
75585,5,2,264503,264503,264505,0,2,3
75586,3,1,264506,264506,264507,0,1,1
75587,3,2,264509,264509,264511,0,2,2
75588,1,1,264510,264511,264512,1,2,0
75589,2,2,264512,264512,264514,0,2,0
75590,5,2,264517,264517,264519,0,2,3
75591,4,2,264521,264521,264523,0,2,2
75592,1,1,264522,264523,264524,1,2,0
75593,4,1,264526,264526,264527,0,1,2
75594,3,1,264529,264529,264530,0,1,2
75595,4,1,264533,264533,264534,0,1,3
75596,1,1,264534,264534,264535,0,1,0
75597,2,3,264536,264536,264539,0,3,1
75598,3,3,264539,264539,264542,0,3,0
75599,2,1,264541,264542,264543,1,2,0
75600,2,3,264543,264543,264546,0,3,0
75601,6,1,264549,264549,264550,0,1,3
75602,2,2,264551,264551,264553,0,2,1
75603,4,3,264555,264555,264558,0,3,2
75604,5,3,264560,264560,264563,0,3,2
75605,4,2,264564,264564,264566,0,2,1
75606,4,2,264568,264568,264570,0,2,2
75607,5,3,264573,264573,264576,0,3,3
75608,4,1,264577,264577,264578,0,1,1
75609,6,2,264583,264583,264585,0,2,5
75610,1,3,264584,264585,264588,1,4,0
75611,6,1,264590,264590,264591,0,1,2
75612,3,1,264593,264593,264594,0,1,2
75613,5,3,264598,264598,264601,0,3,4
75614,5,3,264603,264603,264606,0,3,2
75615,2,2,264605,264606,264608,1,3,0
75616,1,2,264606,264608,264610,2,4,0
75617,4,3,264610,264610,264613,0,3,0
75618,2,2,264612,264613,264615,1,3,0
75619,1,3,264613,264615,264618,2,5,0
75620,2,1,264615,264618,264619,3,4,0
75621,1,3,264616,264619,264622,3,6,0
75622,1,1,264617,264622,264623,5,6,0
75623,2,1,264619,264623,264624,4,5,0
75624,1,2,264620,264624,264626,4,6,0
75625,2,2,264622,264626,264628,4,6,0
75626,2,2,264624,264628,264630,4,6,0
75627,5,2,264629,264630,264632,1,3,0
75628,4,3,264633,264633,264636,0,3,1
75629,6,3,264639,264639,264642,0,3,3
75630,4,1,264643,264643,264644,0,1,1
75631,5,3,264648,264648,264651,0,3,4
75632,2,1,264650,264651,264652,1,2,0
75633,6,2,264656,264656,264658,0,2,4
75634,4,3,264660,264660,264663,0,3,2
75635,6,3,264666,264666,264669,0,3,3
75636,1,1,264667,264669,264670,2,3,0
75637,2,1,264669,264670,264671,1,2,0
75638,2,3,264671,264671,264674,0,3,0
75639,3,2,264674,264674,264676,0,2,0
75640,6,1,264680,264680,264681,0,1,4
75641,2,1,264682,264682,264683,0,1,1
75642,5,3,264687,264687,264690,0,3,4
75643,3,2,264690,264690,264692,0,2,0
75644,1,2,264691,264692,264694,1,3,0
75645,5,1,264696,264696,264697,0,1,2
75646,1,1,264697,264697,264698,0,1,0
75647,1,2,264698,264698,264700,0,2,0
75648,5,1,264703,264703,264704,0,1,3
75649,1,2,264704,264704,264706,0,2,0
75650,2,3,264706,264706,264709,0,3,0
75651,4,2,264710,264710,264712,0,2,1
75652,5,1,264715,264715,264716,0,1,3
75653,1,1,264716,264716,264717,0,1,0
75654,3,1,264719,264719,264720,0,1,2
75655,2,2,264721,264721,264723,0,2,1
75656,6,3,264727,264727,264730,0,3,4
75657,5,1,264732,264732,264733,0,1,2
75658,5,2,264737,264737,264739,0,2,4
75659,4,1,264741,264741,264742,0,1,2
75660,1,1,264742,264742,264743,0,1,0
75661,6,3,264748,264748,264751,0,3,5
75662,2,1,264750,264751,264752,1,2,0
75663,1,1,264751,264752,264753,1,2,0
75664,3,1,264754,264754,264755,0,1,1
75665,1,2,264755,264755,264757,0,2,0
75666,3,2,264758,264758,264760,0,2,1
75667,6,3,264764,264764,264767,0,3,4
75668,4,3,264768,264768,264771,0,3,1
75669,4,3,264772,264772,264775,0,3,1
75670,3,3,264775,264775,264778,0,3,0
75671,3,2,264778,264778,264780,0,2,0
75672,4,3,264782,264782,264785,0,3,2
75673,1,3,264783,264785,264788,2,5,0
75674,6,1,264789,264789,264790,0,1,1
75675,4,2,264793,264793,264795,0,2,3
75676,4,1,264797,264797,264798,0,1,2
75677,5,2,264802,264802,264804,0,2,4
75678,3,2,264805,264805,264807,0,2,1
75679,4,1,264809,264809,264810,0,1,2
75680,3,2,264812,264812,264814,0,2,2
75681,6,3,264818,264818,264821,0,3,4
75682,4,3,264822,264822,264825,0,3,1
75683,4,1,264826,264826,264827,0,1,1
75684,5,3,264831,264831,264834,0,3,4
75685,2,2,264833,264834,264836,1,3,0
75686,4,3,264837,264837,264840,0,3,1
75687,2,2,264839,264840,264842,1,3,0
75688,5,3,264844,264844,264847,0,3,2
75689,4,2,264848,264848,264850,0,2,1
75690,5,2,264853,264853,264855,0,2,3
75691,1,3,264854,264855,264858,1,4,0
75692,5,1,264859,264859,264860,0,1,1
75693,4,2,264863,264863,264865,0,2,3
75694,4,2,264867,264867,264869,0,2,2
75695,5,1,264872,264872,264873,0,1,3
75696,3,2,264875,264875,264877,0,2,2
75697,5,1,264880,264880,264881,0,1,3
75698,6,3,264886,264886,264889,0,3,5
75699,1,1,264887,264889,264890,2,3,0
75700,6,1,264893,264893,264894,0,1,3
75701,5,1,264898,264898,264899,0,1,4
75702,3,2,264901,264901,264903,0,2,2
75703,5,3,264906,264906,264909,0,3,3
75704,3,2,264909,264909,264911,0,2,0
75705,2,3,264911,264911,264914,0,3,0
75706,3,3,264914,264914,264917,0,3,0
75707,2,1,264916,264917,264918,1,2,0
75708,3,2,264919,264919,264921,0,2,1
75709,2,1,264921,264921,264922,0,1,0
75710,5,1,264926,264926,264927,0,1,4
75711,1,1,264927,264927,264928,0,1,0
75712,6,3,264933,264933,264936,0,3,5
75713,5,3,264938,264938,264941,0,3,2
75714,6,3,264944,264944,264947,0,3,3
75715,5,1,264949,264949,264950,0,1,2
75716,3,2,264952,264952,264954,0,2,2
75717,2,1,264954,264954,264955,0,1,0
75718,1,3,264955,264955,264958,0,3,0
75719,5,1,264960,264960,264961,0,1,2
75720,6,2,264966,264966,264968,0,2,5
75721,6,2,264972,264972,264974,0,2,4
75722,3,1,264975,264975,264976,0,1,1
75723,3,2,264978,264978,264980,0,2,2
75724,3,3,264981,264981,264984,0,3,1
75725,3,1,264984,264984,264985,0,1,0
75726,5,3,264989,264989,264992,0,3,4
75727,4,1,264993,264993,264994,0,1,1
75728,4,3,264997,264997,265000,0,3,3
75729,6,2,265003,265003,265005,0,2,3
75730,1,1,265004,265005,265006,1,2,0
75731,3,2,265007,265007,265009,0,2,1
75732,3,3,265010,265010,265013,0,3,1
75733,6,2,265016,265016,265018,0,2,3
75734,5,1,265021,265021,265022,0,1,3
75735,3,1,265024,265024,265025,0,1,2
75736,3,3,265027,265027,265030,0,3,2
75737,1,1,265028,265030,265031,2,3,0
75738,3,1,265031,265031,265032,0,1,0
75739,2,1,265033,265033,265034,0,1,1
75740,1,1,265034,265034,265035,0,1,0
75741,2,3,265036,265036,265039,0,3,1
75742,2,2,265038,265039,265041,1,3,0
75743,1,2,265039,265041,265043,2,4,0
75744,4,3,265043,265043,265046,0,3,0
75745,4,2,265047,265047,265049,0,2,1
75746,3,2,265050,265050,265052,0,2,1
75747,4,1,265054,265054,265055,0,1,2
75748,5,3,265059,265059,265062,0,3,4
75749,1,2,265060,265062,265064,2,4,0
75750,1,2,265061,265064,265066,3,5,0
75751,4,3,265065,265066,265069,1,4,0
75752,3,1,265068,265069,265070,1,2,0
75753,5,2,265073,265073,265075,0,2,3
75754,6,3,265079,265079,265082,0,3,4
75755,6,3,265085,265085,265088,0,3,3
75756,4,1,265089,265089,265090,0,1,1
75757,4,2,265093,265093,265095,0,2,3
75758,4,2,265097,265097,265099,0,2,2
75759,6,3,265103,265103,265106,0,3,4
75760,3,3,265106,265106,265109,0,3,0
75761,6,2,265112,265112,265114,0,2,3
75762,2,3,265114,265114,265117,0,3,0
75763,6,2,265120,265120,265122,0,2,3
75764,4,2,265124,265124,265126,0,2,2
75765,6,2,265130,265130,265132,0,2,4
75766,1,1,265131,265132,265133,1,2,0
75767,5,3,265136,265136,265139,0,3,3
75768,5,1,265141,265141,265142,0,1,2
75769,4,3,265145,265145,265148,0,3,3
75770,5,3,265150,265150,265153,0,3,2
75771,3,1,265153,265153,265154,0,1,0
75772,5,3,265158,265158,265161,0,3,4
75773,2,2,265160,265161,265163,1,3,0
75774,6,3,265166,265166,265169,0,3,3
75775,3,3,265169,265169,265172,0,3,0
75776,5,2,265174,265174,265176,0,2,2
75777,1,1,265175,265176,265177,1,2,0
75778,3,2,265178,265178,265180,0,2,1
75779,2,1,265180,265180,265181,0,1,0
75780,1,3,265181,265181,265184,0,3,0
75781,3,1,265184,265184,265185,0,1,0
75782,4,2,265188,265188,265190,0,2,3
75783,6,1,265194,265194,265195,0,1,4
75784,2,1,265196,265196,265197,0,1,1
75785,3,3,265199,265199,265202,0,3,2
75786,6,1,265205,265205,265206,0,1,3
75787,5,2,265210,265210,265212,0,2,4
75788,3,2,265213,265213,265215,0,2,1
75789,1,3,265214,265215,265218,1,4,0
75790,2,2,265216,265218,265220,2,4,0
75791,5,1,265221,265221,265222,0,1,1
75792,4,2,265225,265225,265227,0,2,3
75793,2,1,265227,265227,265228,0,1,0
75794,2,2,265229,265229,265231,0,2,1
75795,6,2,265235,265235,265237,0,2,4
75796,1,2,265236,265237,265239,1,3,0
75797,4,3,265240,265240,265243,0,3,1
75798,3,2,265243,265243,265245,0,2,0
75799,2,1,265245,265245,265246,0,1,0
75800,6,2,265251,265251,265253,0,2,5
75801,3,1,265254,265254,265255,0,1,1
75802,1,2,265255,265255,265257,0,2,0
75803,3,3,265258,265258,265261,0,3,1
75804,5,1,265263,265263,265264,0,1,2
75805,2,2,265265,265265,265267,0,2,1
75806,1,3,265266,265267,265270,1,4,0
75807,2,3,265268,265270,265273,2,5,0
75808,1,1,265269,265273,265274,4,5,0
75809,2,1,265271,265274,265275,3,4,0
75810,6,2,265277,265277,265279,0,2,2
75811,5,3,265282,265282,265285,0,3,3
75812,5,3,265287,265287,265290,0,3,2
75813,3,2,265290,265290,265292,0,2,0
75814,4,2,265294,265294,265296,0,2,2
75815,5,2,265299,265299,265301,0,2,3
75816,5,2,265304,265304,265306,0,2,3
75817,5,3,265309,265309,265312,0,3,3
75818,6,3,265315,265315,265318,0,3,3
75819,5,3,265320,265320,265323,0,3,2
75820,3,2,265323,265323,265325,0,2,0
75821,4,3,265327,265327,265330,0,3,2
75822,5,1,265332,265332,265333,0,1,2
75823,3,1,265335,265335,265336,0,1,2
75824,4,1,265339,265339,265340,0,1,3
75825,4,3,265343,265343,265346,0,3,3
75826,1,3,265344,265346,265349,2,5,0
75827,3,2,265347,265349,265351,2,4,0
75828,5,2,265352,265352,265354,0,2,1
75829,3,3,265355,265355,265358,0,3,1
75830,2,1,265357,265358,265359,1,2,0
75831,6,2,265363,265363,265365,0,2,4
75832,1,3,265364,265365,265368,1,4,0
75833,4,2,265368,265368,265370,0,2,0
75834,5,3,265373,265373,265376,0,3,3
75835,4,1,265377,265377,265378,0,1,1
75836,3,2,265380,265380,265382,0,2,2
75837,1,1,265381,265382,265383,1,2,0
75838,4,2,265385,265385,265387,0,2,2
75839,5,2,265390,265390,265392,0,2,3
75840,5,1,265395,265395,265396,0,1,3
75841,5,2,265400,265400,265402,0,2,4
75842,5,3,265405,265405,265408,0,3,3
75843,6,1,265411,265411,265412,0,1,3
75844,3,2,265414,265414,265416,0,2,2
75845,1,1,265415,265416,265417,1,2,0
75846,4,1,265419,265419,265420,0,1,2
75847,4,3,265423,265423,265426,0,3,3
75848,2,2,265425,265426,265428,1,3,0
75849,2,1,265427,265428,265429,1,2,0
75850,5,2,265432,265432,265434,0,2,3
75851,2,3,265434,265434,265437,0,3,0
75852,6,1,265440,265440,265441,0,1,3
75853,3,3,265443,265443,265446,0,3,2
75854,1,3,265444,265446,265449,2,5,0
75855,3,1,265447,265449,265450,2,3,0
75856,5,1,265452,265452,265453,0,1,2
75857,1,3,265453,265453,265456,0,3,0
75858,3,2,265456,265456,265458,0,2,0
75859,5,2,265461,265461,265463,0,2,3
75860,1,1,265462,265463,265464,1,2,0
75861,2,1,265464,265464,265465,0,1,0
75862,6,3,265470,265470,265473,0,3,5
75863,6,3,265476,265476,265479,0,3,3
75864,4,2,265480,265480,265482,0,2,1
75865,3,2,265483,265483,265485,0,2,1
75866,3,3,265486,265486,265489,0,3,1
75867,1,1,265487,265489,265490,2,3,0
75868,1,2,265488,265490,265492,2,4,0
75869,5,2,265493,265493,265495,0,2,1
75870,1,2,265494,265495,265497,1,3,0
75871,3,2,265497,265497,265499,0,2,0
75872,2,3,265499,265499,265502,0,3,0
75873,5,2,265504,265504,265506,0,2,2
75874,3,2,265507,265507,265509,0,2,1
75875,6,2,265513,265513,265515,0,2,4
75876,3,3,265516,265516,265519,0,3,1
75877,4,2,265520,265520,265522,0,2,1
75878,4,3,265524,265524,265527,0,3,2
75879,6,1,265530,265530,265531,0,1,3
75880,2,2,265532,265532,265534,0,2,1
75881,3,1,265535,265535,265536,0,1,1
75882,4,1,265539,265539,265540,0,1,3
75883,3,2,265542,265542,265544,0,2,2
75884,5,1,265547,265547,265548,0,1,3
75885,4,3,265551,265551,265554,0,3,3
75886,1,3,265552,265554,265557,2,5,0
75887,4,2,265556,265557,265559,1,3,0
75888,3,3,265559,265559,265562,0,3,0
75889,5,3,265564,265564,265567,0,3,2
75890,3,3,265567,265567,265570,0,3,0
75891,6,3,265573,265573,265576,0,3,3
75892,1,2,265574,265576,265578,2,4,0
75893,6,3,265580,265580,265583,0,3,2
75894,3,2,265583,265583,265585,0,2,0
75895,1,3,265584,265585,265588,1,4,0
75896,4,3,265588,265588,265591,0,3,0
75897,2,1,265590,265591,265592,1,2,0
75898,6,2,265596,265596,265598,0,2,4
75899,5,2,265601,265601,265603,0,2,3
75900,1,2,265602,265603,265605,1,3,0
75901,3,3,265605,265605,265608,0,3,0
75902,4,2,265609,265609,265611,0,2,1
75903,3,3,265612,265612,265615,0,3,1
75904,4,3,265616,265616,265619,0,3,1
75905,6,3,265622,265622,265625,0,3,3
75906,2,2,265624,265625,265627,1,3,0
75907,3,1,265627,265627,265628,0,1,0
75908,3,1,265630,265630,265631,0,1,2
75909,2,3,265632,265632,265635,0,3,1
75910,6,1,265638,265638,265639,0,1,3
75911,1,1,265639,265639,265640,0,1,0
75912,1,3,265640,265640,265643,0,3,0
75913,6,3,265646,265646,265649,0,3,3
75914,1,3,265647,265649,265652,2,5,0
75915,6,2,265653,265653,265655,0,2,1
75916,4,2,265657,265657,265659,0,2,2
75917,4,2,265661,265661,265663,0,2,2
75918,3,2,265664,265664,265666,0,2,1
75919,3,2,265667,265667,265669,0,2,1
75920,6,2,265673,265673,265675,0,2,4
75921,5,3,265678,265678,265681,0,3,3
75922,6,1,265684,265684,265685,0,1,3
75923,1,1,265685,265685,265686,0,1,0
75924,4,1,265689,265689,265690,0,1,3
75925,5,2,265694,265694,265696,0,2,4
75926,3,3,265697,265697,265700,0,3,1
75927,3,1,265700,265700,265701,0,1,0
75928,6,3,265706,265706,265709,0,3,5
75929,1,1,265707,265709,265710,2,3,0
75930,1,3,265708,265710,265713,2,5,0
75931,3,1,265711,265713,265714,2,3,0
75932,5,3,265716,265716,265719,0,3,2
75933,2,2,265718,265719,265721,1,3,0
75934,4,3,265722,265722,265725,0,3,1
75935,1,3,265723,265725,265728,2,5,0
75936,5,3,265728,265728,265731,0,3,0
75937,5,2,265733,265733,265735,0,2,2
75938,5,1,265738,265738,265739,0,1,3
75939,5,3,265743,265743,265746,0,3,4
75940,2,3,265745,265746,265749,1,4,0
75941,3,1,265748,265749,265750,1,2,0
75942,1,1,265749,265750,265751,1,2,0
75943,2,2,265751,265751,265753,0,2,0
75944,6,3,265757,265757,265760,0,3,4
75945,5,2,265762,265762,265764,0,2,2
75946,2,1,265764,265764,265765,0,1,0
75947,5,3,265769,265769,265772,0,3,4
75948,1,2,265770,265772,265774,2,4,0
75949,2,1,265772,265774,265775,2,3,0
75950,2,2,265774,265775,265777,1,3,0
75951,2,1,265776,265777,265778,1,2,0
75952,5,3,265781,265781,265784,0,3,3
75953,5,1,265786,265786,265787,0,1,2
75954,4,1,265790,265790,265791,0,1,3
75955,6,3,265796,265796,265799,0,3,5
75956,6,1,265802,265802,265803,0,1,3
75957,5,2,265807,265807,265809,0,2,4
75958,1,3,265808,265809,265812,1,4,0
75959,4,2,265812,265812,265814,0,2,0
75960,1,3,265813,265814,265817,1,4,0
75961,2,2,265815,265817,265819,2,4,0
75962,3,3,265818,265819,265822,1,4,0
75963,2,1,265820,265822,265823,2,3,0
75964,5,2,265825,265825,265827,0,2,2
75965,6,2,265831,265831,265833,0,2,4
75966,1,1,265832,265833,265834,1,2,0
75967,3,2,265835,265835,265837,0,2,1
75968,3,1,265838,265838,265839,0,1,1
75969,5,1,265843,265843,265844,0,1,4
75970,6,3,265849,265849,265852,0,3,5
75971,2,2,265851,265852,265854,1,3,0
75972,1,2,265852,265854,265856,2,4,0
75973,1,1,265853,265856,265857,3,4,0
75974,4,2,265857,265857,265859,0,2,0
75975,3,3,265860,265860,265863,0,3,1
75976,1,3,265861,265863,265866,2,5,0
75977,1,2,265862,265866,265868,4,6,0
75978,5,3,265867,265868,265871,1,4,0
75979,6,1,265873,265873,265874,0,1,2
75980,5,3,265878,265878,265881,0,3,4
75981,2,3,265880,265881,265884,1,4,0
75982,3,2,265883,265884,265886,1,3,0
75983,6,1,265889,265889,265890,0,1,3
75984,5,1,265894,265894,265895,0,1,4
75985,6,1,265900,265900,265901,0,1,5
75986,1,3,265901,265901,265904,0,3,0
75987,3,1,265904,265904,265905,0,1,0
75988,3,1,265907,265907,265908,0,1,2
75989,5,1,265912,265912,265913,0,1,4
75990,5,1,265917,265917,265918,0,1,4
75991,3,3,265920,265920,265923,0,3,2
75992,6,3,265926,265926,265929,0,3,3
75993,6,2,265932,265932,265934,0,2,3
75994,6,1,265938,265938,265939,0,1,4
75995,5,1,265943,265943,265944,0,1,4
75996,1,1,265944,265944,265945,0,1,0
75997,1,2,265945,265945,265947,0,2,0
75998,4,2,265949,265949,265951,0,2,2
75999,5,3,265954,265954,265957,0,3,3
76000,1,2,265955,265957,265959,2,4,0
76001,4,1,265959,265959,265960,0,1,0
76002,2,3,265961,265961,265964,0,3,1
76003,5,3,265966,265966,265969,0,3,2
76004,5,1,265971,265971,265972,0,1,2
76005,5,1,265976,265976,265977,0,1,4
76006,6,1,265982,265982,265983,0,1,5
76007,1,2,265983,265983,265985,0,2,0
76008,2,1,265985,265985,265986,0,1,0
76009,1,3,265986,265986,265989,0,3,0
76010,6,2,265992,265992,265994,0,2,3
76011,1,1,265993,265994,265995,1,2,0
76012,5,3,265998,265998,266001,0,3,3
76013,4,2,266002,266002,266004,0,2,1
76014,1,1,266003,266004,266005,1,2,0
76015,3,1,266006,266006,266007,0,1,1
76016,6,3,266012,266012,266015,0,3,5
76017,4,3,266016,266016,266019,0,3,1
76018,1,1,266017,266019,266020,2,3,0
76019,3,1,266020,266020,266021,0,1,0
76020,6,1,266026,266026,266027,0,1,5
76021,4,1,266030,266030,266031,0,1,3
76022,6,2,266036,266036,266038,0,2,5
76023,2,3,266038,266038,266041,0,3,0
76024,2,2,266040,266041,266043,1,3,0
76025,2,1,266042,266043,266044,1,2,0
76026,4,1,266046,266046,266047,0,1,2
76027,6,3,266052,266052,266055,0,3,5
76028,1,3,266053,266055,266058,2,5,0
76029,4,2,266057,266058,266060,1,3,0
76030,2,1,266059,266060,266061,1,2,0
76031,4,1,266063,266063,266064,0,1,2
76032,4,2,266067,266067,266069,0,2,3
76033,1,1,266068,266069,266070,1,2,0
76034,5,2,266073,266073,266075,0,2,3
76035,4,2,266077,266077,266079,0,2,2
76036,6,1,266083,266083,266084,0,1,4
76037,3,1,266086,266086,266087,0,1,2
76038,3,2,266089,266089,266091,0,2,2
76039,3,3,266092,266092,266095,0,3,1
76040,1,1,266093,266095,266096,2,3,0
76041,6,2,266099,266099,266101,0,2,3
76042,5,1,266104,266104,266105,0,1,3
76043,4,3,266108,266108,266111,0,3,3
76044,5,1,266113,266113,266114,0,1,2
76045,4,2,266117,266117,266119,0,2,3
76046,6,1,266123,266123,266124,0,1,4
76047,2,2,266125,266125,266127,0,2,1
76048,4,2,266129,266129,266131,0,2,2
76049,2,1,266131,266131,266132,0,1,0
76050,5,1,266136,266136,266137,0,1,4
76051,5,1,266141,266141,266142,0,1,4
76052,3,3,266144,266144,266147,0,3,2
76053,2,3,266146,266147,266150,1,4,0
76054,4,3,266150,266150,266153,0,3,0
76055,3,3,266153,266153,266156,0,3,0
76056,2,3,266155,266156,266159,1,4,0
76057,6,2,266161,266161,266163,0,2,2
76058,1,3,266162,266163,266166,1,4,0
76059,5,2,266167,266167,266169,0,2,1
76060,4,3,266171,266171,266174,0,3,2
76061,6,2,266177,266177,266179,0,2,3
76062,5,3,266182,266182,266185,0,3,3
76063,5,1,266187,266187,266188,0,1,2
76064,3,3,266190,266190,266193,0,3,2
76065,4,3,266194,266194,266197,0,3,1
76066,5,1,266199,266199,266200,0,1,2
76067,6,1,266205,266205,266206,0,1,5
76068,1,3,266206,266206,266209,0,3,0
76069,1,2,266207,266209,266211,2,4,0
76070,6,2,266213,266213,266215,0,2,2
76071,4,1,266217,266217,266218,0,1,2
76072,6,3,266223,266223,266226,0,3,5
76073,6,3,266229,266229,266232,0,3,3
76074,2,3,266231,266232,266235,1,4,0
76075,2,2,266233,266235,266237,2,4,0
76076,4,3,266237,266237,266240,0,3,0
76077,2,2,266239,266240,266242,1,3,0
76078,3,3,266242,266242,266245,0,3,0
76079,1,3,266243,266245,266248,2,5,0
76080,3,3,266246,266248,266251,2,5,0
76081,2,1,266248,266251,266252,3,4,0
76082,2,1,266250,266252,266253,2,3,0
76083,6,1,266256,266256,266257,0,1,3
76084,2,1,266258,266258,266259,0,1,1
76085,5,3,266263,266263,266266,0,3,4
76086,3,3,266266,266266,266269,0,3,0
76087,6,2,266272,266272,266274,0,2,3
76088,3,3,266275,266275,266278,0,3,1
76089,3,3,266278,266278,266281,0,3,0
76090,4,1,266282,266282,266283,0,1,1
76091,4,2,266286,266286,266288,0,2,3
76092,5,2,266291,266291,266293,0,2,3
76093,1,2,266292,266293,266295,1,3,0
76094,6,2,266298,266298,266300,0,2,3
76095,5,1,266303,266303,266304,0,1,3
76096,2,2,266305,266305,266307,0,2,1
76097,5,2,266310,266310,266312,0,2,3
76098,2,1,266312,266312,266313,0,1,0
76099,5,3,266317,266317,266320,0,3,4
76100,2,1,266319,266320,266321,1,2,0
76101,6,1,266325,266325,266326,0,1,4
76102,4,3,266329,266329,266332,0,3,3
76103,3,3,266332,266332,266335,0,3,0
76104,4,1,266336,266336,266337,0,1,1
76105,1,1,266337,266337,266338,0,1,0
76106,1,3,266338,266338,266341,0,3,0
76107,1,3,266339,266341,266344,2,5,0
76108,4,1,266343,266344,266345,1,2,0
76109,1,2,266344,266345,266347,1,3,0
76110,2,1,266346,266347,266348,1,2,0
76111,2,3,266348,266348,266351,0,3,0
76112,3,3,266351,266351,266354,0,3,0
76113,5,3,266356,266356,266359,0,3,2
76114,2,3,266358,266359,266362,1,4,0
76115,4,1,266362,266362,266363,0,1,0
76116,4,3,266366,266366,266369,0,3,3
76117,2,1,266368,266369,266370,1,2,0
76118,6,2,266374,266374,266376,0,2,4
76119,5,1,266379,266379,266380,0,1,3
76120,3,2,266382,266382,266384,0,2,2
76121,6,3,266388,266388,266391,0,3,4
76122,4,2,266392,266392,266394,0,2,1
76123,6,2,266398,266398,266400,0,2,4
76124,3,2,266401,266401,266403,0,2,1
76125,1,1,266402,266403,266404,1,2,0
76126,3,2,266405,266405,266407,0,2,1
76127,2,1,266407,266407,266408,0,1,0
76128,1,2,266408,266408,266410,0,2,0
76129,6,1,266414,266414,266415,0,1,4
76130,6,1,266420,266420,266421,0,1,5
76131,5,3,266425,266425,266428,0,3,4
76132,2,2,266427,266428,266430,1,3,0
76133,6,1,266433,266433,266434,0,1,3
76134,2,2,266435,266435,266437,0,2,1
76135,1,2,266436,266437,266439,1,3,0
76136,6,3,266442,266442,266445,0,3,3
76137,5,2,266447,266447,266449,0,2,2
76138,6,1,266453,266453,266454,0,1,4
76139,2,3,266455,266455,266458,0,3,1
76140,1,2,266456,266458,266460,2,4,0
76141,5,1,266461,266461,266462,0,1,1
76142,2,3,266463,266463,266466,0,3,1
76143,1,1,266464,266466,266467,2,3,0
76144,3,2,266467,266467,266469,0,2,0
76145,3,3,266470,266470,266473,0,3,1
76146,3,1,266473,266473,266474,0,1,0
76147,1,2,266474,266474,266476,0,2,0
76148,5,3,266479,266479,266482,0,3,3
76149,5,2,266484,266484,266486,0,2,2
76150,3,3,266487,266487,266490,0,3,1
76151,5,2,266492,266492,266494,0,2,2
76152,2,2,266494,266494,266496,0,2,0
76153,6,1,266500,266500,266501,0,1,4
76154,4,1,266504,266504,266505,0,1,3
76155,4,3,266508,266508,266511,0,3,3
76156,6,3,266514,266514,266517,0,3,3
76157,5,3,266519,266519,266522,0,3,2
76158,3,2,266522,266522,266524,0,2,0
76159,5,3,266527,266527,266530,0,3,3
76160,3,2,266530,266530,266532,0,2,0
76161,5,1,266535,266535,266536,0,1,3
76162,1,3,266536,266536,266539,0,3,0
76163,1,3,266537,266539,266542,2,5,0
76164,4,1,266541,266542,266543,1,2,0
76165,2,2,266543,266543,266545,0,2,0
76166,1,2,266544,266545,266547,1,3,0
76167,3,3,266547,266547,266550,0,3,0
76168,1,3,266548,266550,266553,2,5,0
76169,6,1,266554,266554,266555,0,1,1
76170,1,2,266555,266555,266557,0,2,0
76171,6,3,266561,266561,266564,0,3,4
76172,5,2,266566,266566,266568,0,2,2
76173,5,3,266571,266571,266574,0,3,3
76174,6,1,266577,266577,266578,0,1,3
76175,3,1,266580,266580,266581,0,1,2
76176,2,2,266582,266582,266584,0,2,1
76177,2,3,266584,266584,266587,0,3,0
76178,2,2,266586,266587,266589,1,3,0
76179,3,3,266589,266589,266592,0,3,0
76180,4,1,266593,266593,266594,0,1,1
76181,5,2,266598,266598,266600,0,2,4
76182,5,1,266603,266603,266604,0,1,3
76183,6,3,266609,266609,266612,0,3,5
76184,3,3,266612,266612,266615,0,3,0
76185,6,1,266618,266618,266619,0,1,3
76186,3,1,266621,266621,266622,0,1,2
76187,6,1,266627,266627,266628,0,1,5
76188,3,3,266630,266630,266633,0,3,2
76189,6,3,266636,266636,266639,0,3,3
76190,3,1,266639,266639,266640,0,1,0
76191,4,3,266643,266643,266646,0,3,3
76192,3,1,266646,266646,266647,0,1,0
76193,3,1,266649,266649,266650,0,1,2
76194,1,3,266650,266650,266653,0,3,0
76195,4,1,266654,266654,266655,0,1,1
76196,3,2,266657,266657,266659,0,2,2
76197,2,1,266659,266659,266660,0,1,0
76198,1,1,266660,266660,266661,0,1,0
76199,3,1,266663,266663,266664,0,1,2
76200,4,2,266667,266667,266669,0,2,3
76201,2,1,266669,266669,266670,0,1,0
76202,2,2,266671,266671,266673,0,2,1
76203,1,2,266672,266673,266675,1,3,0
76204,2,1,266674,266675,266676,1,2,0
76205,4,3,266678,266678,266681,0,3,2
76206,5,3,266683,266683,266686,0,3,2
76207,3,1,266686,266686,266687,0,1,0
76208,5,2,266691,266691,266693,0,2,4
76209,5,3,266696,266696,266699,0,3,3
76210,1,3,266697,266699,266702,2,5,0
76211,4,2,266701,266702,266704,1,3,0
76212,1,2,266702,266704,266706,2,4,0
76213,6,2,266708,266708,266710,0,2,2
76214,5,2,266713,266713,266715,0,2,3
76215,6,2,266719,266719,266721,0,2,4
76216,3,1,266722,266722,266723,0,1,1
76217,3,2,266725,266725,266727,0,2,2
76218,2,3,266727,266727,266730,0,3,0
76219,3,2,266730,266730,266732,0,2,0
76220,4,2,266734,266734,266736,0,2,2
76221,2,2,266736,266736,266738,0,2,0
76222,6,2,266742,266742,266744,0,2,4
76223,1,1,266743,266744,266745,1,2,0
76224,5,2,266748,266748,266750,0,2,3
76225,5,3,266753,266753,266756,0,3,3
76226,5,3,266758,266758,266761,0,3,2
76227,4,3,266762,266762,266765,0,3,1
76228,6,2,266768,266768,266770,0,2,3
76229,1,1,266769,266770,266771,1,2,0
76230,6,2,266775,266775,266777,0,2,4
76231,4,1,266779,266779,266780,0,1,2
76232,5,2,266784,266784,266786,0,2,4
76233,5,2,266789,266789,266791,0,2,3
76234,5,2,266794,266794,266796,0,2,3
76235,6,1,266800,266800,266801,0,1,4
76236,2,1,266802,266802,266803,0,1,1
76237,6,1,266808,266808,266809,0,1,5
76238,1,1,266809,266809,266810,0,1,0
76239,4,2,266813,266813,266815,0,2,3
76240,4,1,266817,266817,266818,0,1,2
76241,1,1,266818,266818,266819,0,1,0
76242,1,1,266819,266819,266820,0,1,0
76243,2,3,266821,266821,266824,0,3,1
76244,5,1,266826,266826,266827,0,1,2
76245,4,1,266830,266830,266831,0,1,3
76246,6,1,266836,266836,266837,0,1,5
76247,4,2,266840,266840,266842,0,2,3
76248,3,1,266843,266843,266844,0,1,1
76249,2,2,266845,266845,266847,0,2,1
76250,2,2,266847,266847,266849,0,2,0
76251,5,3,266852,266852,266855,0,3,3
76252,2,1,266854,266855,266856,1,2,0
76253,4,3,266858,266858,266861,0,3,2
76254,2,1,266860,266861,266862,1,2,0
76255,2,1,266862,266862,266863,0,1,0
76256,6,2,266868,266868,266870,0,2,5
76257,5,3,266873,266873,266876,0,3,3
76258,5,3,266878,266878,266881,0,3,2
76259,2,3,266880,266881,266884,1,4,0
76260,3,2,266883,266884,266886,1,3,0
76261,6,3,266889,266889,266892,0,3,3
76262,6,3,266895,266895,266898,0,3,3
76263,6,3,266901,266901,266904,0,3,3
76264,2,3,266903,266904,266907,1,4,0
76265,1,3,266904,266907,266910,3,6,0
76266,2,3,266906,266910,266913,4,7,0
76267,1,3,266907,266913,266916,6,9,0
76268,2,1,266909,266916,266917,7,8,0
76269,4,3,266913,266917,266920,4,7,0
76270,6,1,266919,266920,266921,1,2,0
76271,2,2,266921,266921,266923,0,2,0
76272,2,3,266923,266923,266926,0,3,0
76273,4,1,266927,266927,266928,0,1,1
76274,5,2,266932,266932,266934,0,2,4
76275,1,2,266933,266934,266936,1,3,0
76276,5,2,266938,266938,266940,0,2,2
76277,1,3,266939,266940,266943,1,4,0
76278,2,2,266941,266943,266945,2,4,0
76279,5,1,266946,266946,266947,0,1,1
76280,2,3,266948,266948,266951,0,3,1
76281,2,3,266950,266951,266954,1,4,0
76282,4,1,266954,266954,266955,0,1,0
76283,5,1,266959,266959,266960,0,1,4
76284,3,2,266962,266962,266964,0,2,2
76285,5,3,266967,266967,266970,0,3,3
76286,6,3,266973,266973,266976,0,3,3
76287,2,2,266975,266976,266978,1,3,0
76288,1,3,266976,266978,266981,2,5,0
76289,6,2,266982,266982,266984,0,2,1
76290,3,3,266985,266985,266988,0,3,1
76291,4,1,266989,266989,266990,0,1,1
76292,4,2,266993,266993,266995,0,2,3
76293,1,1,266994,266995,266996,1,2,0
76294,2,3,266996,266996,266999,0,3,0
76295,1,1,266997,266999,267000,2,3,0
76296,6,3,267003,267003,267006,0,3,3
76297,6,3,267009,267009,267012,0,3,3
76298,2,1,267011,267012,267013,1,2,0
76299,6,3,267017,267017,267020,0,3,4
76300,1,1,267018,267020,267021,2,3,0
76301,5,3,267023,267023,267026,0,3,2
76302,3,1,267026,267026,267027,0,1,0
76303,6,1,267032,267032,267033,0,1,5
76304,1,1,267033,267033,267034,0,1,0
76305,1,1,267034,267034,267035,0,1,0
76306,3,3,267037,267037,267040,0,3,2
76307,4,3,267041,267041,267044,0,3,1
76308,3,2,267044,267044,267046,0,2,0
76309,5,1,267049,267049,267050,0,1,3
76310,4,2,267053,267053,267055,0,2,3
76311,5,2,267058,267058,267060,0,2,3
76312,4,1,267062,267062,267063,0,1,2
76313,1,3,267063,267063,267066,0,3,0
76314,4,3,267067,267067,267070,0,3,1
76315,2,3,267069,267070,267073,1,4,0
76316,6,2,267075,267075,267077,0,2,2
76317,1,2,267076,267077,267079,1,3,0
76318,4,3,267080,267080,267083,0,3,1
76319,2,2,267082,267083,267085,1,3,0
76320,2,2,267084,267085,267087,1,3,0
76321,2,3,267086,267087,267090,1,4,0
76322,4,3,267090,267090,267093,0,3,0
76323,1,3,267091,267093,267096,2,5,0
76324,4,1,267095,267096,267097,1,2,0
76325,1,2,267096,267097,267099,1,3,0
76326,2,3,267098,267099,267102,1,4,0
76327,3,1,267101,267102,267103,1,2,0
76328,6,2,267107,267107,267109,0,2,4
76329,3,2,267110,267110,267112,0,2,1
76330,6,2,267116,267116,267118,0,2,4
76331,2,3,267118,267118,267121,0,3,0
76332,5,1,267123,267123,267124,0,1,2
76333,1,2,267124,267124,267126,0,2,0
76334,1,1,267125,267126,267127,1,2,0
76335,5,2,267130,267130,267132,0,2,3
76336,5,1,267135,267135,267136,0,1,3
76337,2,2,267137,267137,267139,0,2,1
76338,2,3,267139,267139,267142,0,3,0
76339,2,1,267141,267142,267143,1,2,0
76340,2,3,267143,267143,267146,0,3,0
76341,5,3,267148,267148,267151,0,3,2
76342,5,1,267153,267153,267154,0,1,2
76343,3,3,267156,267156,267159,0,3,2
76344,3,3,267159,267159,267162,0,3,0
76345,2,2,267161,267162,267164,1,3,0
76346,5,2,267166,267166,267168,0,2,2
76347,1,2,267167,267168,267170,1,3,0
76348,4,3,267171,267171,267174,0,3,1
76349,4,3,267175,267175,267178,0,3,1
76350,3,3,267178,267178,267181,0,3,0
76351,4,1,267182,267182,267183,0,1,1
76352,3,1,267185,267185,267186,0,1,2
76353,2,1,267187,267187,267188,0,1,1
76354,4,3,267191,267191,267194,0,3,3
76355,4,3,267195,267195,267198,0,3,1
76356,4,1,267199,267199,267200,0,1,1
76357,5,2,267204,267204,267206,0,2,4
76358,1,2,267205,267206,267208,1,3,0
76359,6,2,267211,267211,267213,0,2,3
76360,5,1,267216,267216,267217,0,1,3
76361,4,1,267220,267220,267221,0,1,3
76362,4,3,267224,267224,267227,0,3,3
76363,4,1,267228,267228,267229,0,1,1
76364,4,2,267232,267232,267234,0,2,3
76365,2,2,267234,267234,267236,0,2,0
76366,6,2,267240,267240,267242,0,2,4
76367,4,3,267244,267244,267247,0,3,2
76368,1,2,267245,267247,267249,2,4,0
76369,6,2,267251,267251,267253,0,2,2
76370,1,3,267252,267253,267256,1,4,0
76371,1,2,267253,267256,267258,3,5,0
76372,2,3,267255,267258,267261,3,6,0
76373,3,1,267258,267261,267262,3,4,0
76374,3,1,267261,267262,267263,1,2,0
76375,5,1,267266,267266,267267,0,1,3
76376,6,3,267272,267272,267275,0,3,5
76377,6,1,267278,267278,267279,0,1,3
76378,6,1,267284,267284,267285,0,1,5
76379,1,3,267285,267285,267288,0,3,0
76380,5,2,267290,267290,267292,0,2,2
76381,1,1,267291,267292,267293,1,2,0
76382,5,3,267296,267296,267299,0,3,3
76383,4,1,267300,267300,267301,0,1,1
76384,2,3,267302,267302,267305,0,3,1
76385,4,2,267306,267306,267308,0,2,1
76386,2,1,267308,267308,267309,0,1,0
76387,2,3,267310,267310,267313,0,3,1
76388,1,2,267311,267313,267315,2,4,0
76389,4,2,267315,267315,267317,0,2,0
76390,4,1,267319,267319,267320,0,1,2
76391,4,2,267323,267323,267325,0,2,3
76392,6,2,267329,267329,267331,0,2,4
76393,1,1,267330,267331,267332,1,2,0
76394,1,1,267331,267332,267333,1,2,0
76395,1,2,267332,267333,267335,1,3,0
76396,2,1,267334,267335,267336,1,2,0
76397,2,2,267336,267336,267338,0,2,0
76398,3,3,267339,267339,267342,0,3,1
76399,4,1,267343,267343,267344,0,1,1
76400,4,1,267347,267347,267348,0,1,3
76401,3,3,267350,267350,267353,0,3,2
76402,6,3,267356,267356,267359,0,3,3
76403,3,3,267359,267359,267362,0,3,0
76404,6,2,267365,267365,267367,0,2,3
76405,4,2,267369,267369,267371,0,2,2
76406,3,1,267372,267372,267373,0,1,1
76407,6,1,267378,267378,267379,0,1,5
76408,2,1,267380,267380,267381,0,1,1
76409,3,3,267383,267383,267386,0,3,2
76410,4,1,267387,267387,267388,0,1,1
76411,2,2,267389,267389,267391,0,2,1
76412,3,2,267392,267392,267394,0,2,1
76413,2,1,267394,267394,267395,0,1,0
76414,5,2,267399,267399,267401,0,2,4
76415,5,3,267404,267404,267407,0,3,3
76416,4,1,267408,267408,267409,0,1,1
76417,5,2,267413,267413,267415,0,2,4
76418,4,3,267417,267417,267420,0,3,2
76419,2,3,267419,267420,267423,1,4,0
76420,4,1,267423,267423,267424,0,1,0
76421,2,2,267425,267425,267427,0,2,1
76422,1,2,267426,267427,267429,1,3,0
76423,4,2,267430,267430,267432,0,2,1
76424,3,3,267433,267433,267436,0,3,1
76425,6,1,267439,267439,267440,0,1,3
76426,3,3,267442,267442,267445,0,3,2
76427,4,2,267446,267446,267448,0,2,1
76428,1,3,267447,267448,267451,1,4,0
76429,3,1,267450,267451,267452,1,2,0
76430,5,3,267455,267455,267458,0,3,3
76431,2,3,267457,267458,267461,1,4,0
76432,3,2,267460,267461,267463,1,3,0
76433,6,1,267466,267466,267467,0,1,3
76434,5,1,267471,267471,267472,0,1,4
76435,4,3,267475,267475,267478,0,3,3
76436,4,2,267479,267479,267481,0,2,1
76437,3,2,267482,267482,267484,0,2,1
76438,5,3,267487,267487,267490,0,3,3
76439,4,3,267491,267491,267494,0,3,1
76440,1,1,267492,267494,267495,2,3,0
76441,3,2,267495,267495,267497,0,2,0
76442,3,3,267498,267498,267501,0,3,1
76443,5,2,267503,267503,267505,0,2,2
76444,4,2,267507,267507,267509,0,2,2
76445,6,3,267513,267513,267516,0,3,4
76446,5,2,267518,267518,267520,0,2,2
76447,1,3,267519,267520,267523,1,4,0
76448,4,2,267523,267523,267525,0,2,0
76449,3,3,267526,267526,267529,0,3,1
76450,5,1,267531,267531,267532,0,1,2
76451,5,3,267536,267536,267539,0,3,4
76452,3,3,267539,267539,267542,0,3,0
76453,5,1,267544,267544,267545,0,1,2
76454,3,1,267547,267547,267548,0,1,2
76455,1,1,267548,267548,267549,0,1,0
76456,5,2,267553,267553,267555,0,2,4
76457,3,2,267556,267556,267558,0,2,1
76458,6,1,267562,267562,267563,0,1,4
76459,3,1,267565,267565,267566,0,1,2
76460,4,3,267569,267569,267572,0,3,3
76461,3,1,267572,267572,267573,0,1,0
76462,5,1,267577,267577,267578,0,1,4
76463,2,2,267579,267579,267581,0,2,1
76464,2,3,267581,267581,267584,0,3,0
76465,5,3,267586,267586,267589,0,3,2
76466,3,1,267589,267589,267590,0,1,0
76467,4,2,267593,267593,267595,0,2,3
76468,6,1,267599,267599,267600,0,1,4
76469,2,1,267601,267601,267602,0,1,1
76470,4,3,267605,267605,267608,0,3,3
76471,1,3,267606,267608,267611,2,5,0
76472,6,1,267612,267612,267613,0,1,1
76473,4,3,267616,267616,267619,0,3,3
76474,3,2,267619,267619,267621,0,2,0
76475,6,1,267625,267625,267626,0,1,4
76476,1,3,267626,267626,267629,0,3,0
76477,4,1,267630,267630,267631,0,1,1
76478,6,2,267636,267636,267638,0,2,5
76479,3,3,267639,267639,267642,0,3,1
76480,5,1,267644,267644,267645,0,1,2
76481,4,3,267648,267648,267651,0,3,3
76482,5,2,267653,267653,267655,0,2,2
76483,6,1,267659,267659,267660,0,1,4
76484,2,3,267661,267661,267664,0,3,1
76485,3,2,267664,267664,267666,0,2,0
76486,6,2,267670,267670,267672,0,2,4
76487,5,3,267675,267675,267678,0,3,3
76488,5,3,267680,267680,267683,0,3,2
76489,3,1,267683,267683,267684,0,1,0
76490,4,2,267687,267687,267689,0,2,3
76491,2,2,267689,267689,267691,0,2,0
76492,4,3,267693,267693,267696,0,3,2
76493,2,2,267695,267696,267698,1,3,0
76494,5,1,267700,267700,267701,0,1,2
76495,3,1,267703,267703,267704,0,1,2
76496,6,2,267709,267709,267711,0,2,5
76497,2,2,267711,267711,267713,0,2,0
76498,3,2,267714,267714,267716,0,2,1
76499,2,3,267716,267716,267719,0,3,0
76500,5,2,267721,267721,267723,0,2,2
76501,3,2,267724,267724,267726,0,2,1
76502,1,1,267725,267726,267727,1,2,0
76503,2,2,267727,267727,267729,0,2,0
76504,1,2,267728,267729,267731,1,3,0
76505,5,2,267733,267733,267735,0,2,2
76506,6,2,267739,267739,267741,0,2,4
76507,6,3,267745,267745,267748,0,3,4
76508,2,1,267747,267748,267749,1,2,0
76509,2,3,267749,267749,267752,0,3,0
76510,6,1,267755,267755,267756,0,1,3
76511,2,1,267757,267757,267758,0,1,1
76512,5,2,267762,267762,267764,0,2,4
76513,1,2,267763,267764,267766,1,3,0
76514,4,2,267767,267767,267769,0,2,1
76515,4,1,267771,267771,267772,0,1,2
76516,1,1,267772,267772,267773,0,1,0
76517,5,1,267777,267777,267778,0,1,4
76518,5,3,267782,267782,267785,0,3,4
76519,6,1,267788,267788,267789,0,1,3
76520,6,3,267794,267794,267797,0,3,5
76521,6,1,267800,267800,267801,0,1,3
76522,2,1,267802,267802,267803,0,1,1
76523,6,3,267808,267808,267811,0,3,5
76524,1,3,267809,267811,267814,2,5,0
76525,2,2,267811,267814,267816,3,5,0
76526,4,3,267815,267816,267819,1,4,0
76527,6,2,267821,267821,267823,0,2,2
76528,2,3,267823,267823,267826,0,3,0
76529,2,2,267825,267826,267828,1,3,0
76530,4,3,267829,267829,267832,0,3,1
76531,2,1,267831,267832,267833,1,2,0
76532,1,3,267832,267833,267836,1,4,0
76533,2,3,267834,267836,267839,2,5,0
76534,5,3,267839,267839,267842,0,3,0
76535,5,3,267844,267844,267847,0,3,2
76536,5,1,267849,267849,267850,0,1,2
76537,6,3,267855,267855,267858,0,3,5
76538,2,3,267857,267858,267861,1,4,0
76539,4,1,267861,267861,267862,0,1,0
76540,5,1,267866,267866,267867,0,1,4
76541,2,1,267868,267868,267869,0,1,1
76542,6,2,267874,267874,267876,0,2,5
76543,2,3,267876,267876,267879,0,3,0
76544,2,3,267878,267879,267882,1,4,0
76545,2,2,267880,267882,267884,2,4,0
76546,1,2,267881,267884,267886,3,5,0
76547,4,1,267885,267886,267887,1,2,0
76548,6,2,267891,267891,267893,0,2,4
76549,6,1,267897,267897,267898,0,1,4
76550,1,1,267898,267898,267899,0,1,0
76551,4,3,267902,267902,267905,0,3,3
76552,2,3,267904,267905,267908,1,4,0
76553,6,2,267910,267910,267912,0,2,2
76554,3,3,267913,267913,267916,0,3,1
76555,1,1,267914,267916,267917,2,3,0
76556,3,2,267917,267917,267919,0,2,0
76557,3,2,267920,267920,267922,0,2,1
76558,4,3,267924,267924,267927,0,3,2
76559,3,3,267927,267927,267930,0,3,0
76560,6,3,267933,267933,267936,0,3,3
76561,5,1,267938,267938,267939,0,1,2
76562,4,1,267942,267942,267943,0,1,3
76563,3,2,267945,267945,267947,0,2,2
76564,5,1,267950,267950,267951,0,1,3
76565,1,3,267951,267951,267954,0,3,0
76566,1,1,267952,267954,267955,2,3,0
76567,6,3,267958,267958,267961,0,3,3
76568,2,3,267960,267961,267964,1,4,0
76569,5,1,267965,267965,267966,0,1,1
76570,5,1,267970,267970,267971,0,1,4
76571,5,3,267975,267975,267978,0,3,4
76572,6,3,267981,267981,267984,0,3,3
76573,3,1,267984,267984,267985,0,1,0
76574,5,3,267989,267989,267992,0,3,4
76575,6,1,267995,267995,267996,0,1,3
76576,4,2,267999,267999,268001,0,2,3
76577,5,2,268004,268004,268006,0,2,3
76578,1,3,268005,268006,268009,1,4,0
76579,6,2,268011,268011,268013,0,2,2
76580,5,3,268016,268016,268019,0,3,3
76581,1,2,268017,268019,268021,2,4,0
76582,3,3,268020,268021,268024,1,4,0
76583,2,3,268022,268024,268027,2,5,0
76584,6,3,268028,268028,268031,0,3,1
76585,3,3,268031,268031,268034,0,3,0
76586,3,2,268034,268034,268036,0,2,0
76587,6,2,268040,268040,268042,0,2,4
76588,1,1,268041,268042,268043,1,2,0
76589,3,1,268044,268044,268045,0,1,1
76590,3,3,268047,268047,268050,0,3,2
76591,1,3,268048,268050,268053,2,5,0
76592,1,2,268049,268053,268055,4,6,0
76593,5,2,268054,268055,268057,1,3,0
76594,1,1,268055,268057,268058,2,3,0
76595,1,2,268056,268058,268060,2,4,0
76596,1,3,268057,268060,268063,3,6,0
76597,1,3,268058,268063,268066,5,8,0
76598,2,3,268060,268066,268069,6,9,0
76599,6,3,268066,268069,268072,3,6,0
76600,3,3,268069,268072,268075,3,6,0
76601,4,2,268073,268075,268077,2,4,0
76602,3,2,268076,268077,268079,1,3,0
76603,2,1,268078,268079,268080,1,2,0
76604,3,1,268081,268081,268082,0,1,1
76605,6,3,268087,268087,268090,0,3,5
76606,6,1,268093,268093,268094,0,1,3
76607,1,2,268094,268094,268096,0,2,0
76608,2,3,268096,268096,268099,0,3,0
76609,2,2,268098,268099,268101,1,3,0
76610,6,3,268104,268104,268107,0,3,3
76611,6,2,268110,268110,268112,0,2,3
76612,4,2,268114,268114,268116,0,2,2
76613,5,2,268119,268119,268121,0,2,3
76614,4,3,268123,268123,268126,0,3,2
76615,4,2,268127,268127,268129,0,2,1
76616,4,1,268131,268131,268132,0,1,2
76617,2,2,268133,268133,268135,0,2,1
76618,5,3,268138,268138,268141,0,3,3
76619,1,1,268139,268141,268142,2,3,0
76620,6,3,268145,268145,268148,0,3,3
76621,5,2,268150,268150,268152,0,2,2
76622,3,2,268153,268153,268155,0,2,1
76623,3,1,268156,268156,268157,0,1,1
76624,4,3,268160,268160,268163,0,3,3
76625,5,3,268165,268165,268168,0,3,2
76626,3,1,268168,268168,268169,0,1,0
76627,4,3,268172,268172,268175,0,3,3
76628,2,1,268174,268175,268176,1,2,0
76629,2,1,268176,268176,268177,0,1,0
76630,1,2,268177,268177,268179,0,2,0
76631,5,1,268182,268182,268183,0,1,3
76632,2,1,268184,268184,268185,0,1,1
76633,3,3,268187,268187,268190,0,3,2
76634,5,1,268192,268192,268193,0,1,2
76635,2,1,268194,268194,268195,0,1,1
76636,5,3,268199,268199,268202,0,3,4
76637,6,1,268205,268205,268206,0,1,3
76638,4,1,268209,268209,268210,0,1,3
76639,5,3,268214,268214,268217,0,3,4
76640,2,3,268216,268217,268220,1,4,0
76641,5,1,268221,268221,268222,0,1,1
76642,4,2,268225,268225,268227,0,2,3
76643,5,2,268230,268230,268232,0,2,3
76644,1,2,268231,268232,268234,1,3,0
76645,2,3,268233,268234,268237,1,4,0
76646,5,3,268238,268238,268241,0,3,1
76647,4,1,268242,268242,268243,0,1,1
76648,3,1,268245,268245,268246,0,1,2
76649,6,1,268251,268251,268252,0,1,5
76650,2,2,268253,268253,268255,0,2,1
76651,5,2,268258,268258,268260,0,2,3
76652,1,3,268259,268260,268263,1,4,0
76653,6,1,268265,268265,268266,0,1,2
76654,1,3,268266,268266,268269,0,3,0
76655,5,2,268271,268271,268273,0,2,2
76656,1,2,268272,268273,268275,1,3,0
76657,1,1,268273,268275,268276,2,3,0
76658,3,1,268276,268276,268277,0,1,0
76659,2,3,268278,268278,268281,0,3,1
76660,1,1,268279,268281,268282,2,3,0
76661,3,3,268282,268282,268285,0,3,0
76662,3,3,268285,268285,268288,0,3,0
76663,5,3,268290,268290,268293,0,3,2
76664,6,2,268296,268296,268298,0,2,3
76665,2,3,268298,268298,268301,0,3,0
76666,4,2,268302,268302,268304,0,2,1
76667,3,3,268305,268305,268308,0,3,1
76668,2,3,268307,268308,268311,1,4,0
76669,6,3,268313,268313,268316,0,3,2
76670,6,1,268319,268319,268320,0,1,3
76671,1,3,268320,268320,268323,0,3,0
76672,2,3,268322,268323,268326,1,4,0
76673,1,3,268323,268326,268329,3,6,0
76674,3,3,268326,268329,268332,3,6,0
76675,1,1,268327,268332,268333,5,6,0
76676,4,3,268331,268333,268336,2,5,0
76677,5,1,268336,268336,268337,0,1,0
76678,4,2,268340,268340,268342,0,2,3
76679,2,1,268342,268342,268343,0,1,0
76680,5,2,268347,268347,268349,0,2,4
76681,6,2,268353,268353,268355,0,2,4
76682,5,1,268358,268358,268359,0,1,3
76683,6,1,268364,268364,268365,0,1,5
76684,4,3,268368,268368,268371,0,3,3
76685,3,1,268371,268371,268372,0,1,0
76686,5,1,268376,268376,268377,0,1,4
76687,4,3,268380,268380,268383,0,3,3
76688,6,2,268386,268386,268388,0,2,3
76689,3,1,268389,268389,268390,0,1,1
76690,4,1,268393,268393,268394,0,1,3
76691,2,1,268395,268395,268396,0,1,1
76692,4,2,268399,268399,268401,0,2,3
76693,5,2,268404,268404,268406,0,2,3
76694,2,3,268406,268406,268409,0,3,0
76695,5,1,268411,268411,268412,0,1,2
76696,2,3,268413,268413,268416,0,3,1
76697,6,2,268419,268419,268421,0,2,3
76698,3,2,268422,268422,268424,0,2,1
76699,5,3,268427,268427,268430,0,3,3
76700,1,1,268428,268430,268431,2,3,0
76701,2,3,268430,268431,268434,1,4,0
76702,6,2,268436,268436,268438,0,2,2
76703,3,2,268439,268439,268441,0,2,1
76704,1,2,268440,268441,268443,1,3,0
76705,1,1,268441,268443,268444,2,3,0
76706,1,1,268442,268444,268445,2,3,0
76707,2,1,268444,268445,268446,1,2,0
76708,1,3,268445,268446,268449,1,4,0
76709,2,3,268447,268449,268452,2,5,0
76710,1,1,268448,268452,268453,4,5,0
76711,4,3,268452,268453,268456,1,4,0
76712,1,2,268453,268456,268458,3,5,0
76713,3,3,268456,268458,268461,2,5,0
76714,4,3,268460,268461,268464,1,4,0
76715,5,1,268465,268465,268466,0,1,1
76716,3,2,268468,268468,268470,0,2,2
76717,4,2,268472,268472,268474,0,2,2
76718,2,1,268474,268474,268475,0,1,0
76719,5,2,268479,268479,268481,0,2,4
76720,4,2,268483,268483,268485,0,2,2
76721,4,2,268487,268487,268489,0,2,2
76722,5,3,268492,268492,268495,0,3,3
76723,5,2,268497,268497,268499,0,2,2
76724,1,2,268498,268499,268501,1,3,0
76725,2,1,268500,268501,268502,1,2,0
76726,3,2,268503,268503,268505,0,2,1
76727,3,3,268506,268506,268509,0,3,1
76728,4,1,268510,268510,268511,0,1,1
76729,6,3,268516,268516,268519,0,3,5
76730,6,1,268522,268522,268523,0,1,3
76731,3,2,268525,268525,268527,0,2,2
76732,4,2,268529,268529,268531,0,2,2
76733,6,2,268535,268535,268537,0,2,4
76734,5,2,268540,268540,268542,0,2,3
76735,2,3,268542,268542,268545,0,3,0
76736,5,3,268547,268547,268550,0,3,2
76737,5,2,268552,268552,268554,0,2,2
76738,6,1,268558,268558,268559,0,1,4
76739,2,1,268560,268560,268561,0,1,1
76740,6,2,268566,268566,268568,0,2,5
76741,4,3,268570,268570,268573,0,3,2
76742,1,2,268571,268573,268575,2,4,0
76743,4,3,268575,268575,268578,0,3,0
76744,2,3,268577,268578,268581,1,4,0
76745,5,1,268582,268582,268583,0,1,1
76746,3,2,268585,268585,268587,0,2,2
76747,5,1,268590,268590,268591,0,1,3
76748,2,2,268592,268592,268594,0,2,1
76749,1,3,268593,268594,268597,1,4,0
76750,4,3,268597,268597,268600,0,3,0
76751,3,1,268600,268600,268601,0,1,0
76752,3,2,268603,268603,268605,0,2,2
76753,6,1,268609,268609,268610,0,1,4
76754,2,3,268611,268611,268614,0,3,1
76755,4,3,268615,268615,268618,0,3,1
76756,5,2,268620,268620,268622,0,2,2
76757,5,2,268625,268625,268627,0,2,3
76758,2,1,268627,268627,268628,0,1,0
76759,1,3,268628,268628,268631,0,3,0
76760,4,2,268632,268632,268634,0,2,1
76761,5,3,268637,268637,268640,0,3,3
76762,2,3,268639,268640,268643,1,4,0
76763,3,2,268642,268643,268645,1,3,0
76764,3,1,268645,268645,268646,0,1,0
76765,2,1,268647,268647,268648,0,1,1
76766,2,3,268649,268649,268652,0,3,1
76767,6,2,268655,268655,268657,0,2,3
76768,6,2,268661,268661,268663,0,2,4
76769,6,3,268667,268667,268670,0,3,4
76770,2,1,268669,268670,268671,1,2,0
76771,5,2,268674,268674,268676,0,2,3
76772,4,3,268678,268678,268681,0,3,2
76773,4,3,268682,268682,268685,0,3,1
76774,6,3,268688,268688,268691,0,3,3
76775,2,2,268690,268691,268693,1,3,0
76776,5,2,268695,268695,268697,0,2,2
76777,2,3,268697,268697,268700,0,3,0
76778,6,3,268703,268703,268706,0,3,3
76779,5,3,268708,268708,268711,0,3,2
76780,3,3,268711,268711,268714,0,3,0
76781,5,1,268716,268716,268717,0,1,2
76782,1,1,268717,268717,268718,0,1,0
76783,3,1,268720,268720,268721,0,1,2
76784,6,3,268726,268726,268729,0,3,5
76785,2,1,268728,268729,268730,1,2,0
76786,3,3,268731,268731,268734,0,3,1
76787,4,3,268735,268735,268738,0,3,1
76788,6,3,268741,268741,268744,0,3,3
76789,3,2,268744,268744,268746,0,2,0
76790,4,2,268748,268748,268750,0,2,2
76791,5,1,268753,268753,268754,0,1,3
76792,1,2,268754,268754,268756,0,2,0
76793,1,3,268755,268756,268759,1,4,0
76794,3,2,268758,268759,268761,1,3,0
76795,2,2,268760,268761,268763,1,3,0
76796,1,2,268761,268763,268765,2,4,0
76797,1,3,268762,268765,268768,3,6,0
76798,1,1,268763,268768,268769,5,6,0
76799,5,3,268768,268769,268772,1,4,0
76800,5,3,268773,268773,268776,0,3,1
76801,4,1,268777,268777,268778,0,1,1
76802,4,1,268781,268781,268782,0,1,3
76803,1,3,268782,268782,268785,0,3,0
76804,4,3,268786,268786,268789,0,3,1
76805,3,3,268789,268789,268792,0,3,0
76806,5,2,268794,268794,268796,0,2,2
76807,4,1,268798,268798,268799,0,1,2
76808,5,2,268803,268803,268805,0,2,4
76809,2,3,268805,268805,268808,0,3,0
76810,6,2,268811,268811,268813,0,2,3
76811,2,2,268813,268813,268815,0,2,0
76812,5,2,268818,268818,268820,0,2,3
76813,3,1,268821,268821,268822,0,1,1
76814,4,2,268825,268825,268827,0,2,3
76815,2,1,268827,268827,268828,0,1,0
76816,2,1,268829,268829,268830,0,1,1
76817,5,2,268834,268834,268836,0,2,4
76818,5,1,268839,268839,268840,0,1,3
76819,6,1,268845,268845,268846,0,1,5
76820,2,3,268847,268847,268850,0,3,1
76821,5,2,268852,268852,268854,0,2,2
76822,2,1,268854,268854,268855,0,1,0
76823,4,2,268858,268858,268860,0,2,3
76824,1,3,268859,268860,268863,1,4,0
76825,3,1,268862,268863,268864,1,2,0
76826,6,2,268868,268868,268870,0,2,4
76827,3,2,268871,268871,268873,0,2,1
76828,4,2,268875,268875,268877,0,2,2
76829,6,2,268881,268881,268883,0,2,4
76830,4,3,268885,268885,268888,0,3,2
76831,2,3,268887,268888,268891,1,4,0
76832,5,1,268892,268892,268893,0,1,1
76833,5,1,268897,268897,268898,0,1,4
76834,1,3,268898,268898,268901,0,3,0
76835,3,1,268901,268901,268902,0,1,0
76836,1,2,268902,268902,268904,0,2,0
76837,5,1,268907,268907,268908,0,1,3
76838,3,2,268910,268910,268912,0,2,2
76839,4,2,268914,268914,268916,0,2,2
76840,2,1,268916,268916,268917,0,1,0
76841,3,1,268919,268919,268920,0,1,2
76842,3,2,268922,268922,268924,0,2,2
76843,1,2,268923,268924,268926,1,3,0
76844,1,3,268924,268926,268929,2,5,0
76845,4,2,268928,268929,268931,1,3,0
76846,5,1,268933,268933,268934,0,1,2
76847,3,2,268936,268936,268938,0,2,2
76848,3,1,268939,268939,268940,0,1,1
76849,2,2,268941,268941,268943,0,2,1
76850,6,1,268947,268947,268948,0,1,4
76851,5,3,268952,268952,268955,0,3,4
76852,3,3,268955,268955,268958,0,3,0
76853,6,2,268961,268961,268963,0,2,3
76854,1,1,268962,268963,268964,1,2,0
76855,2,1,268964,268964,268965,0,1,0
76856,1,3,268965,268965,268968,0,3,0
76857,5,2,268970,268970,268972,0,2,2
76858,2,2,268972,268972,268974,0,2,0
76859,2,3,268974,268974,268977,0,3,0
76860,2,3,268976,268977,268980,1,4,0
76861,4,1,268980,268980,268981,0,1,0
76862,2,3,268982,268982,268985,0,3,1
76863,6,3,268988,268988,268991,0,3,3
76864,4,3,268992,268992,268995,0,3,1
76865,1,3,268993,268995,268998,2,5,0
76866,3,3,268996,268998,269001,2,5,0
76867,6,1,269002,269002,269003,0,1,1
76868,5,3,269007,269007,269010,0,3,4
76869,1,3,269008,269010,269013,2,5,0
76870,1,3,269009,269013,269016,4,7,0
76871,1,3,269010,269016,269019,6,9,0
76872,4,1,269014,269019,269020,5,6,0
76873,5,3,269019,269020,269023,1,4,0
76874,2,3,269021,269023,269026,2,5,0
76875,1,1,269022,269026,269027,4,5,0
76876,4,1,269026,269027,269028,1,2,0
76877,2,2,269028,269028,269030,0,2,0
76878,5,2,269033,269033,269035,0,2,3
76879,4,3,269037,269037,269040,0,3,2
76880,4,1,269041,269041,269042,0,1,1
76881,3,3,269044,269044,269047,0,3,2
76882,6,3,269050,269050,269053,0,3,3
76883,5,3,269055,269055,269058,0,3,2
76884,1,2,269056,269058,269060,2,4,0
76885,1,3,269057,269060,269063,3,6,0
76886,1,1,269058,269063,269064,5,6,0
76887,3,1,269061,269064,269065,3,4,0
76888,1,1,269062,269065,269066,3,4,0
76889,4,1,269066,269066,269067,0,1,0
76890,2,3,269068,269068,269071,0,3,1
76891,6,3,269074,269074,269077,0,3,3
76892,4,2,269078,269078,269080,0,2,1
76893,1,2,269079,269080,269082,1,3,0
76894,2,1,269081,269082,269083,1,2,0
76895,2,1,269083,269083,269084,0,1,0
76896,2,2,269085,269085,269087,0,2,1
76897,2,2,269087,269087,269089,0,2,0
76898,1,3,269088,269089,269092,1,4,0
76899,3,2,269091,269092,269094,1,3,0
76900,2,1,269093,269094,269095,1,2,0
76901,6,2,269099,269099,269101,0,2,4
76902,4,1,269103,269103,269104,0,1,2
76903,6,2,269109,269109,269111,0,2,5
76904,3,2,269112,269112,269114,0,2,1
76905,5,2,269117,269117,269119,0,2,3
76906,3,3,269120,269120,269123,0,3,1
76907,3,1,269123,269123,269124,0,1,0
76908,6,3,269129,269129,269132,0,3,5
76909,1,3,269130,269132,269135,2,5,0
76910,3,3,269133,269135,269138,2,5,0
76911,2,2,269135,269138,269140,3,5,0
76912,2,2,269137,269140,269142,3,5,0
76913,4,3,269141,269142,269145,1,4,0
76914,6,2,269147,269147,269149,0,2,2
76915,3,1,269150,269150,269151,0,1,1
76916,2,3,269152,269152,269155,0,3,1
76917,1,2,269153,269155,269157,2,4,0
76918,2,1,269155,269157,269158,2,3,0
76919,5,3,269160,269160,269163,0,3,2
76920,5,3,269165,269165,269168,0,3,2
76921,4,2,269169,269169,269171,0,2,1
76922,6,1,269175,269175,269176,0,1,4
76923,4,1,269179,269179,269180,0,1,3
76924,5,3,269184,269184,269187,0,3,4
76925,4,3,269188,269188,269191,0,3,1
76926,6,1,269194,269194,269195,0,1,3
76927,5,2,269199,269199,269201,0,2,4
76928,2,1,269201,269201,269202,0,1,0
76929,1,1,269202,269202,269203,0,1,0
76930,1,3,269203,269203,269206,0,3,0
76931,4,3,269207,269207,269210,0,3,1
76932,5,2,269212,269212,269214,0,2,2
76933,6,3,269218,269218,269221,0,3,4
76934,1,3,269219,269221,269224,2,5,0
76935,1,2,269220,269224,269226,4,6,0
76936,3,2,269223,269226,269228,3,5,0
76937,4,3,269227,269228,269231,1,4,0
76938,1,1,269228,269231,269232,3,4,0
76939,3,3,269231,269232,269235,1,4,0
76940,4,3,269235,269235,269238,0,3,0
76941,1,3,269236,269238,269241,2,5,0
76942,5,1,269241,269241,269242,0,1,0
76943,5,3,269246,269246,269249,0,3,4
76944,1,3,269247,269249,269252,2,5,0
76945,4,3,269251,269252,269255,1,4,0
76946,2,3,269253,269255,269258,2,5,0
76947,4,2,269257,269258,269260,1,3,0
76948,1,3,269258,269260,269263,2,5,0
76949,4,2,269262,269263,269265,1,3,0
76950,6,2,269268,269268,269270,0,2,3
76951,3,2,269271,269271,269273,0,2,1
76952,2,2,269273,269273,269275,0,2,0
76953,1,2,269274,269275,269277,1,3,0
76954,2,3,269276,269277,269280,1,4,0
76955,6,3,269282,269282,269285,0,3,2
76956,3,3,269285,269285,269288,0,3,0
76957,6,3,269291,269291,269294,0,3,3
76958,5,2,269296,269296,269298,0,2,2
76959,6,1,269302,269302,269303,0,1,4
76960,3,2,269305,269305,269307,0,2,2
76961,4,2,269309,269309,269311,0,2,2
76962,3,1,269312,269312,269313,0,1,1
76963,1,2,269313,269313,269315,0,2,0
76964,1,3,269314,269315,269318,1,4,0
76965,4,2,269318,269318,269320,0,2,0
76966,6,2,269324,269324,269326,0,2,4
76967,2,2,269326,269326,269328,0,2,0
76968,2,3,269328,269328,269331,0,3,0
76969,3,1,269331,269331,269332,0,1,0
76970,1,1,269332,269332,269333,0,1,0
76971,5,3,269337,269337,269340,0,3,4
76972,4,3,269341,269341,269344,0,3,1
76973,1,1,269342,269344,269345,2,3,0
76974,6,1,269348,269348,269349,0,1,3
76975,6,3,269354,269354,269357,0,3,5
76976,3,3,269357,269357,269360,0,3,0
76977,2,3,269359,269360,269363,1,4,0
76978,3,2,269362,269363,269365,1,3,0
76979,1,1,269363,269365,269366,2,3,0
76980,6,1,269369,269369,269370,0,1,3
76981,5,2,269374,269374,269376,0,2,4
76982,3,2,269377,269377,269379,0,2,1
76983,2,1,269379,269379,269380,0,1,0
76984,2,1,269381,269381,269382,0,1,1
76985,2,2,269383,269383,269385,0,2,1
76986,4,1,269387,269387,269388,0,1,2
76987,2,1,269389,269389,269390,0,1,1
76988,1,1,269390,269390,269391,0,1,0
76989,6,2,269396,269396,269398,0,2,5
76990,5,2,269401,269401,269403,0,2,3
76991,2,1,269403,269403,269404,0,1,0
76992,5,2,269408,269408,269410,0,2,4
76993,5,3,269413,269413,269416,0,3,3
76994,2,3,269415,269416,269419,1,4,0
76995,5,3,269420,269420,269423,0,3,1
76996,6,2,269426,269426,269428,0,2,3
76997,1,3,269427,269428,269431,1,4,0
76998,5,2,269432,269432,269434,0,2,1
76999,4,1,269436,269436,269437,0,1,2
77000,1,3,269437,269437,269440,0,3,0
77001,6,1,269443,269443,269444,0,1,3
77002,6,1,269449,269449,269450,0,1,5
77003,3,3,269452,269452,269455,0,3,2
77004,6,2,269458,269458,269460,0,2,3
77005,3,2,269461,269461,269463,0,2,1
77006,6,1,269467,269467,269468,0,1,4
77007,1,2,269468,269468,269470,0,2,0
77008,5,2,269473,269473,269475,0,2,3
77009,2,3,269475,269475,269478,0,3,0
77010,1,3,269476,269478,269481,2,5,0
77011,1,3,269477,269481,269484,4,7,0
77012,2,1,269479,269484,269485,5,6,0
77013,4,1,269483,269485,269486,2,3,0
77014,5,2,269488,269488,269490,0,2,2
77015,3,3,269491,269491,269494,0,3,1
77016,1,3,269492,269494,269497,2,5,0
77017,6,3,269498,269498,269501,0,3,1
77018,4,2,269502,269502,269504,0,2,1
77019,2,2,269504,269504,269506,0,2,0
77020,3,2,269507,269507,269509,0,2,1
77021,2,3,269509,269509,269512,0,3,0
77022,1,1,269510,269512,269513,2,3,0
77023,6,3,269516,269516,269519,0,3,3
77024,2,1,269518,269519,269520,1,2,0
77025,6,1,269524,269524,269525,0,1,4
77026,1,3,269525,269525,269528,0,3,0
77027,5,1,269530,269530,269531,0,1,2
77028,1,3,269531,269531,269534,0,3,0
77029,5,2,269536,269536,269538,0,2,2
77030,1,2,269537,269538,269540,1,3,0
77031,6,1,269543,269543,269544,0,1,3
77032,3,3,269546,269546,269549,0,3,2
77033,5,2,269551,269551,269553,0,2,2
77034,4,2,269555,269555,269557,0,2,2
77035,6,1,269561,269561,269562,0,1,4
77036,2,2,269563,269563,269565,0,2,1
77037,1,1,269564,269565,269566,1,2,0
77038,5,2,269569,269569,269571,0,2,3
77039,4,1,269573,269573,269574,0,1,2
77040,4,3,269577,269577,269580,0,3,3
77041,1,2,269578,269580,269582,2,4,0
77042,2,1,269580,269582,269583,2,3,0
77043,1,1,269581,269583,269584,2,3,0
77044,5,1,269586,269586,269587,0,1,2
77045,3,2,269589,269589,269591,0,2,2
77046,6,2,269595,269595,269597,0,2,4
77047,1,1,269596,269597,269598,1,2,0
77048,2,3,269598,269598,269601,0,3,0
77049,5,1,269603,269603,269604,0,1,2
77050,5,3,269608,269608,269611,0,3,4
77051,6,2,269614,269614,269616,0,2,3
77052,4,1,269618,269618,269619,0,1,2
77053,3,3,269621,269621,269624,0,3,2
77054,6,3,269627,269627,269630,0,3,3
77055,2,1,269629,269630,269631,1,2,0
77056,2,3,269631,269631,269634,0,3,0
77057,5,1,269636,269636,269637,0,1,2
77058,4,3,269640,269640,269643,0,3,3
77059,2,2,269642,269643,269645,1,3,0
77060,6,1,269648,269648,269649,0,1,3
77061,3,2,269651,269651,269653,0,2,2
77062,5,3,269656,269656,269659,0,3,3
77063,2,2,269658,269659,269661,1,3,0
77064,2,2,269660,269661,269663,1,3,0
77065,5,1,269665,269665,269666,0,1,2
77066,4,1,269669,269669,269670,0,1,3
77067,2,1,269671,269671,269672,0,1,1
77068,4,1,269675,269675,269676,0,1,3
77069,6,3,269681,269681,269684,0,3,5
77070,3,3,269684,269684,269687,0,3,0
77071,2,3,269686,269687,269690,1,4,0
77072,6,3,269692,269692,269695,0,3,2
77073,4,2,269696,269696,269698,0,2,1
77074,6,2,269702,269702,269704,0,2,4
77075,6,3,269708,269708,269711,0,3,4
77076,3,2,269711,269711,269713,0,2,0
77077,1,2,269712,269713,269715,1,3,0
77078,6,1,269718,269718,269719,0,1,3
77079,2,1,269720,269720,269721,0,1,1
77080,3,1,269723,269723,269724,0,1,2
77081,1,2,269724,269724,269726,0,2,0
77082,4,3,269728,269728,269731,0,3,2
77083,2,3,269730,269731,269734,1,4,0
77084,5,1,269735,269735,269736,0,1,1
77085,5,3,269740,269740,269743,0,3,4
77086,2,3,269742,269743,269746,1,4,0
77087,6,3,269748,269748,269751,0,3,2
77088,1,2,269749,269751,269753,2,4,0
77089,3,1,269752,269753,269754,1,2,0
77090,4,3,269756,269756,269759,0,3,2
77091,6,2,269762,269762,269764,0,2,3
77092,6,2,269768,269768,269770,0,2,4
77093,3,2,269771,269771,269773,0,2,1
77094,6,3,269777,269777,269780,0,3,4
77095,5,3,269782,269782,269785,0,3,2
77096,2,2,269784,269785,269787,1,3,0
77097,1,3,269785,269787,269790,2,5,0
77098,6,1,269791,269791,269792,0,1,1
77099,2,1,269793,269793,269794,0,1,1
77100,2,1,269795,269795,269796,0,1,1
77101,3,2,269798,269798,269800,0,2,2
77102,5,1,269803,269803,269804,0,1,3
77103,6,3,269809,269809,269812,0,3,5
77104,4,2,269813,269813,269815,0,2,1
77105,2,2,269815,269815,269817,0,2,0
77106,5,2,269820,269820,269822,0,2,3
77107,4,1,269824,269824,269825,0,1,2
77108,1,3,269825,269825,269828,0,3,0
77109,4,2,269829,269829,269831,0,2,1
77110,2,2,269831,269831,269833,0,2,0
77111,5,1,269836,269836,269837,0,1,3
77112,6,3,269842,269842,269845,0,3,5
77113,6,1,269848,269848,269849,0,1,3
77114,3,2,269851,269851,269853,0,2,2
77115,2,3,269853,269853,269856,0,3,0
77116,3,2,269856,269856,269858,0,2,0
77117,4,3,269860,269860,269863,0,3,2
77118,6,2,269866,269866,269868,0,2,3
77119,3,1,269869,269869,269870,0,1,1
77120,6,1,269875,269875,269876,0,1,5
77121,6,3,269881,269881,269884,0,3,5
77122,3,1,269884,269884,269885,0,1,0
77123,3,2,269887,269887,269889,0,2,2
77124,3,3,269890,269890,269893,0,3,1
77125,4,2,269894,269894,269896,0,2,1
77126,5,2,269899,269899,269901,0,2,3
77127,6,3,269905,269905,269908,0,3,4
77128,5,2,269910,269910,269912,0,2,2
77129,6,1,269916,269916,269917,0,1,4
77130,4,1,269920,269920,269921,0,1,3
77131,2,3,269922,269922,269925,0,3,1
77132,1,3,269923,269925,269928,2,5,0
77133,1,3,269924,269928,269931,4,7,0
77134,1,1,269925,269931,269932,6,7,0
77135,2,3,269927,269932,269935,5,8,0
77136,5,1,269932,269935,269936,3,4,0
77137,5,1,269937,269937,269938,0,1,1
77138,6,3,269943,269943,269946,0,3,5
77139,5,3,269948,269948,269951,0,3,2
77140,1,3,269949,269951,269954,2,5,0
77141,1,3,269950,269954,269957,4,7,0
77142,1,1,269951,269957,269958,6,7,0
77143,1,1,269952,269958,269959,6,7,0
77144,6,1,269958,269959,269960,1,2,0
77145,5,1,269963,269963,269964,0,1,3
77146,6,2,269969,269969,269971,0,2,5
77147,3,2,269972,269972,269974,0,2,1
77148,2,2,269974,269974,269976,0,2,0
77149,4,3,269978,269978,269981,0,3,2
77150,5,2,269983,269983,269985,0,2,2
77151,4,1,269987,269987,269988,0,1,2
77152,5,3,269992,269992,269995,0,3,4
77153,3,1,269995,269995,269996,0,1,0
77154,5,3,270000,270000,270003,0,3,4
77155,2,3,270002,270003,270006,1,4,0
77156,3,3,270005,270006,270009,1,4,0
77157,6,1,270011,270011,270012,0,1,2
77158,5,1,270016,270016,270017,0,1,4
77159,3,2,270019,270019,270021,0,2,2
77160,4,1,270023,270023,270024,0,1,2
77161,2,2,270025,270025,270027,0,2,1
77162,5,3,270030,270030,270033,0,3,3
77163,2,2,270032,270033,270035,1,3,0
77164,6,3,270038,270038,270041,0,3,3
77165,5,3,270043,270043,270046,0,3,2
77166,4,1,270047,270047,270048,0,1,1
77167,5,2,270052,270052,270054,0,2,4
77168,5,3,270057,270057,270060,0,3,3
77169,5,3,270062,270062,270065,0,3,2
77170,5,2,270067,270067,270069,0,2,2
77171,4,2,270071,270071,270073,0,2,2
77172,4,2,270075,270075,270077,0,2,2
77173,3,1,270078,270078,270079,0,1,1
77174,3,1,270081,270081,270082,0,1,2
77175,3,1,270084,270084,270085,0,1,2
77176,6,3,270090,270090,270093,0,3,5
77177,6,1,270096,270096,270097,0,1,3
77178,6,1,270102,270102,270103,0,1,5
77179,3,3,270105,270105,270108,0,3,2
77180,6,2,270111,270111,270113,0,2,3
77181,1,2,270112,270113,270115,1,3,0
77182,4,3,270116,270116,270119,0,3,1
77183,5,2,270121,270121,270123,0,2,2
77184,2,3,270123,270123,270126,0,3,0
77185,3,1,270126,270126,270127,0,1,0
77186,6,1,270132,270132,270133,0,1,5
77187,4,1,270136,270136,270137,0,1,3
77188,4,1,270140,270140,270141,0,1,3
77189,2,1,270142,270142,270143,0,1,1
77190,3,3,270145,270145,270148,0,3,2
77191,1,3,270146,270148,270151,2,5,0
77192,5,1,270151,270151,270152,0,1,0
77193,5,1,270156,270156,270157,0,1,4
77194,6,2,270162,270162,270164,0,2,5
77195,5,1,270167,270167,270168,0,1,3
77196,5,2,270172,270172,270174,0,2,4
77197,6,3,270178,270178,270181,0,3,4
77198,1,2,270179,270181,270183,2,4,0
77199,2,2,270181,270183,270185,2,4,0
77200,4,3,270185,270185,270188,0,3,0
77201,4,3,270189,270189,270192,0,3,1
77202,3,3,270192,270192,270195,0,3,0
77203,1,1,270193,270195,270196,2,3,0
77204,6,1,270199,270199,270200,0,1,3
77205,4,1,270203,270203,270204,0,1,3
77206,4,2,270207,270207,270209,0,2,3
77207,2,2,270209,270209,270211,0,2,0
77208,5,2,270214,270214,270216,0,2,3
77209,4,2,270218,270218,270220,0,2,2
77210,4,1,270222,270222,270223,0,1,2
77211,1,3,270223,270223,270226,0,3,0
77212,2,2,270225,270226,270228,1,3,0
77213,3,1,270228,270228,270229,0,1,0
77214,1,2,270229,270229,270231,0,2,0
77215,6,1,270235,270235,270236,0,1,4
77216,3,2,270238,270238,270240,0,2,2
77217,5,3,270243,270243,270246,0,3,3
77218,6,2,270249,270249,270251,0,2,3
77219,3,2,270252,270252,270254,0,2,1
77220,4,2,270256,270256,270258,0,2,2
77221,6,1,270262,270262,270263,0,1,4
77222,3,2,270265,270265,270267,0,2,2
77223,5,1,270270,270270,270271,0,1,3
77224,3,1,270273,270273,270274,0,1,2
77225,2,3,270275,270275,270278,0,3,1
77226,4,3,270279,270279,270282,0,3,1
77227,1,3,270280,270282,270285,2,5,0
77228,3,2,270283,270285,270287,2,4,0
77229,3,2,270286,270287,270289,1,3,0
77230,6,3,270292,270292,270295,0,3,3
77231,2,1,270294,270295,270296,1,2,0
77232,3,1,270297,270297,270298,0,1,1
77233,2,3,270299,270299,270302,0,3,1
77234,2,2,270301,270302,270304,1,3,0
77235,5,3,270306,270306,270309,0,3,2
77236,3,2,270309,270309,270311,0,2,0
77237,5,2,270314,270314,270316,0,2,3
77238,3,1,270317,270317,270318,0,1,1
77239,6,2,270323,270323,270325,0,2,5
77240,4,3,270327,270327,270330,0,3,2
77241,1,2,270328,270330,270332,2,4,0
77242,4,3,270332,270332,270335,0,3,0
77243,4,1,270336,270336,270337,0,1,1
77244,3,1,270339,270339,270340,0,1,2
77245,3,2,270342,270342,270344,0,2,2
77246,1,1,270343,270344,270345,1,2,0
77247,5,3,270348,270348,270351,0,3,3
77248,6,2,270354,270354,270356,0,2,3
77249,2,1,270356,270356,270357,0,1,0
77250,3,3,270359,270359,270362,0,3,2
77251,4,2,270363,270363,270365,0,2,1
77252,5,1,270368,270368,270369,0,1,3
77253,2,1,270370,270370,270371,0,1,1
77254,2,2,270372,270372,270374,0,2,1
77255,1,3,270373,270374,270377,1,4,0
77256,5,2,270378,270378,270380,0,2,1
77257,1,2,270379,270380,270382,1,3,0
77258,5,1,270384,270384,270385,0,1,2
77259,1,1,270385,270385,270386,0,1,0
77260,2,3,270387,270387,270390,0,3,1
77261,4,2,270391,270391,270393,0,2,1
77262,1,3,270392,270393,270396,1,4,0
77263,5,1,270397,270397,270398,0,1,1
77264,2,2,270399,270399,270401,0,2,1
77265,5,1,270404,270404,270405,0,1,3
77266,1,3,270405,270405,270408,0,3,0
77267,2,1,270407,270408,270409,1,2,0
77268,5,2,270412,270412,270414,0,2,3
77269,3,2,270415,270415,270417,0,2,1
77270,1,2,270416,270417,270419,1,3,0
77271,5,2,270421,270421,270423,0,2,2
77272,5,1,270426,270426,270427,0,1,3
77273,3,2,270429,270429,270431,0,2,2
77274,5,2,270434,270434,270436,0,2,3
77275,2,1,270436,270436,270437,0,1,0
77276,3,1,270439,270439,270440,0,1,2
77277,3,1,270442,270442,270443,0,1,2
77278,5,1,270447,270447,270448,0,1,4
77279,6,1,270453,270453,270454,0,1,5
77280,2,3,270455,270455,270458,0,3,1
77281,4,1,270459,270459,270460,0,1,1
77282,2,3,270461,270461,270464,0,3,1
77283,2,1,270463,270464,270465,1,2,0
77284,4,1,270467,270467,270468,0,1,2
77285,4,2,270471,270471,270473,0,2,3
77286,1,2,270472,270473,270475,1,3,0
77287,1,2,270473,270475,270477,2,4,0
77288,5,3,270478,270478,270481,0,3,1
77289,1,3,270479,270481,270484,2,5,0
77290,5,1,270484,270484,270485,0,1,0
77291,1,1,270485,270485,270486,0,1,0
77292,5,3,270490,270490,270493,0,3,4
77293,4,3,270494,270494,270497,0,3,1
77294,5,2,270499,270499,270501,0,2,2
77295,4,3,270503,270503,270506,0,3,2
77296,4,1,270507,270507,270508,0,1,1
77297,6,2,270513,270513,270515,0,2,5
77298,6,1,270519,270519,270520,0,1,4
77299,4,3,270523,270523,270526,0,3,3
77300,2,3,270525,270526,270529,1,4,0
77301,4,3,270529,270529,270532,0,3,0
77302,6,3,270535,270535,270538,0,3,3
77303,6,1,270541,270541,270542,0,1,3
77304,4,1,270545,270545,270546,0,1,3
77305,3,2,270548,270548,270550,0,2,2
77306,5,3,270553,270553,270556,0,3,3
77307,5,1,270558,270558,270559,0,1,2
77308,5,3,270563,270563,270566,0,3,4
77309,1,1,270564,270566,270567,2,3,0
77310,2,3,270566,270567,270570,1,4,0
77311,1,1,270567,270570,270571,3,4,0
77312,6,1,270573,270573,270574,0,1,2
77313,3,2,270576,270576,270578,0,2,2
77314,1,3,270577,270578,270581,1,4,0
77315,3,3,270580,270581,270584,1,4,0
77316,5,1,270585,270585,270586,0,1,1
77317,3,2,270588,270588,270590,0,2,2
77318,6,2,270594,270594,270596,0,2,4
77319,4,3,270598,270598,270601,0,3,2
77320,1,3,270599,270601,270604,2,5,0
77321,3,3,270602,270604,270607,2,5,0
77322,2,1,270604,270607,270608,3,4,0
77323,3,3,270607,270608,270611,1,4,0
77324,4,2,270611,270611,270613,0,2,0
77325,3,2,270614,270614,270616,0,2,1
77326,2,3,270616,270616,270619,0,3,0
77327,5,2,270621,270621,270623,0,2,2
77328,1,3,270622,270623,270626,1,4,0
77329,1,2,270623,270626,270628,3,5,0
77330,1,2,270624,270628,270630,4,6,0
77331,3,2,270627,270630,270632,3,5,0
77332,3,1,270630,270632,270633,2,3,0
77333,6,3,270636,270636,270639,0,3,3
77334,6,2,270642,270642,270644,0,2,3
77335,5,3,270647,270647,270650,0,3,3
77336,2,3,270649,270650,270653,1,4,0
77337,1,3,270650,270653,270656,3,6,0
77338,2,1,270652,270656,270657,4,5,0
77339,4,3,270656,270657,270660,1,4,0
77340,5,1,270661,270661,270662,0,1,1
77341,6,1,270667,270667,270668,0,1,5
77342,3,1,270670,270670,270671,0,1,2
77343,1,1,270671,270671,270672,0,1,0
77344,3,2,270674,270674,270676,0,2,2
77345,4,3,270678,270678,270681,0,3,2
77346,1,2,270679,270681,270683,2,4,0
77347,3,2,270682,270683,270685,1,3,0
77348,2,3,270684,270685,270688,1,4,0
77349,5,1,270689,270689,270690,0,1,1
77350,5,3,270694,270694,270697,0,3,4
77351,4,3,270698,270698,270701,0,3,1
77352,4,2,270702,270702,270704,0,2,1
77353,5,2,270707,270707,270709,0,2,3
77354,2,1,270709,270709,270710,0,1,0
77355,3,3,270712,270712,270715,0,3,2
77356,6,1,270718,270718,270719,0,1,3
77357,1,2,270719,270719,270721,0,2,0
77358,2,2,270721,270721,270723,0,2,0
77359,2,2,270723,270723,270725,0,2,0
77360,5,1,270728,270728,270729,0,1,3
77361,5,2,270733,270733,270735,0,2,4
77362,4,2,270737,270737,270739,0,2,2
77363,5,1,270742,270742,270743,0,1,3
77364,3,3,270745,270745,270748,0,3,2
77365,2,1,270747,270748,270749,1,2,0
77366,2,3,270749,270749,270752,0,3,0
77367,3,2,270752,270752,270754,0,2,0
77368,1,3,270753,270754,270757,1,4,0
77369,3,1,270756,270757,270758,1,2,0
77370,2,1,270758,270758,270759,0,1,0
77371,3,1,270761,270761,270762,0,1,2
77372,4,2,270765,270765,270767,0,2,3
77373,1,2,270766,270767,270769,1,3,0
77374,2,2,270768,270769,270771,1,3,0
77375,4,3,270772,270772,270775,0,3,1
77376,5,1,270777,270777,270778,0,1,2
77377,6,2,270783,270783,270785,0,2,5
77378,6,1,270789,270789,270790,0,1,4
77379,2,3,270791,270791,270794,0,3,1
77380,4,2,270795,270795,270797,0,2,1
77381,2,3,270797,270797,270800,0,3,0
77382,4,2,270801,270801,270803,0,2,1
77383,4,2,270805,270805,270807,0,2,2
77384,1,2,270806,270807,270809,1,3,0
77385,2,2,270808,270809,270811,1,3,0
77386,1,3,270809,270811,270814,2,5,0
77387,4,2,270813,270814,270816,1,3,0
77388,6,3,270819,270819,270822,0,3,3
77389,2,1,270821,270822,270823,1,2,0
77390,4,2,270825,270825,270827,0,2,2
77391,1,3,270826,270827,270830,1,4,0
77392,4,2,270830,270830,270832,0,2,0
77393,6,1,270836,270836,270837,0,1,4
77394,4,2,270840,270840,270842,0,2,3
77395,1,1,270841,270842,270843,1,2,0
77396,4,1,270845,270845,270846,0,1,2
77397,2,1,270847,270847,270848,0,1,1
77398,5,1,270852,270852,270853,0,1,4
77399,1,2,270853,270853,270855,0,2,0
77400,1,1,270854,270855,270856,1,2,0
77401,4,1,270858,270858,270859,0,1,2
77402,2,3,270860,270860,270863,0,3,1
77403,5,2,270865,270865,270867,0,2,2
77404,2,2,270867,270867,270869,0,2,0
77405,5,1,270872,270872,270873,0,1,3
77406,2,3,270874,270874,270877,0,3,1
77407,2,3,270876,270877,270880,1,4,0
77408,3,2,270879,270880,270882,1,3,0
77409,1,2,270880,270882,270884,2,4,0
77410,4,3,270884,270884,270887,0,3,0
77411,3,2,270887,270887,270889,0,2,0
77412,6,3,270893,270893,270896,0,3,4
77413,6,2,270899,270899,270901,0,2,3
77414,3,1,270902,270902,270903,0,1,1
77415,3,2,270905,270905,270907,0,2,2
77416,6,1,270911,270911,270912,0,1,4
77417,3,2,270914,270914,270916,0,2,2
77418,6,2,270920,270920,270922,0,2,4
77419,4,2,270924,270924,270926,0,2,2
77420,5,1,270929,270929,270930,0,1,3
77421,4,1,270933,270933,270934,0,1,3
77422,2,3,270935,270935,270938,0,3,1
77423,2,3,270937,270938,270941,1,4,0
77424,5,3,270942,270942,270945,0,3,1
77425,3,3,270945,270945,270948,0,3,0
77426,2,3,270947,270948,270951,1,4,0
77427,3,3,270950,270951,270954,1,4,0
77428,6,2,270956,270956,270958,0,2,2
77429,6,1,270962,270962,270963,0,1,4
77430,1,3,270963,270963,270966,0,3,0
77431,5,3,270968,270968,270971,0,3,2
77432,5,3,270973,270973,270976,0,3,2
77433,5,3,270978,270978,270981,0,3,2
77434,2,2,270980,270981,270983,1,3,0
77435,3,3,270983,270983,270986,0,3,0
77436,5,1,270988,270988,270989,0,1,2
77437,2,2,270990,270990,270992,0,2,1
77438,5,1,270995,270995,270996,0,1,3
77439,4,3,270999,270999,271002,0,3,3
77440,3,3,271002,271002,271005,0,3,0
77441,2,3,271004,271005,271008,1,4,0
77442,1,2,271005,271008,271010,3,5,0
77443,3,3,271008,271010,271013,2,5,0
77444,1,3,271009,271013,271016,4,7,0
77445,5,1,271014,271016,271017,2,3,0
77446,6,3,271020,271020,271023,0,3,3
77447,1,3,271021,271023,271026,2,5,0
77448,5,3,271026,271026,271029,0,3,0
77449,4,2,271030,271030,271032,0,2,1
77450,6,2,271036,271036,271038,0,2,4
77451,3,3,271039,271039,271042,0,3,1
77452,4,3,271043,271043,271046,0,3,1
77453,4,1,271047,271047,271048,0,1,1
77454,1,2,271048,271048,271050,0,2,0
77455,5,3,271053,271053,271056,0,3,3
77456,2,2,271055,271056,271058,1,3,0
77457,2,3,271057,271058,271061,1,4,0
77458,2,2,271059,271061,271063,2,4,0
77459,5,1,271064,271064,271065,0,1,1
77460,1,2,271065,271065,271067,0,2,0
77461,2,1,271067,271067,271068,0,1,0
77462,3,2,271070,271070,271072,0,2,2
77463,5,3,271075,271075,271078,0,3,3
77464,6,1,271081,271081,271082,0,1,3
77465,1,3,271082,271082,271085,0,3,0
77466,3,2,271085,271085,271087,0,2,0
77467,5,1,271090,271090,271091,0,1,3
77468,1,1,271091,271091,271092,0,1,0
77469,2,1,271093,271093,271094,0,1,1
77470,3,2,271096,271096,271098,0,2,2
77471,3,1,271099,271099,271100,0,1,1
77472,5,3,271104,271104,271107,0,3,4
77473,3,2,271107,271107,271109,0,2,0
77474,3,2,271110,271110,271112,0,2,1
77475,4,2,271114,271114,271116,0,2,2
77476,3,3,271117,271117,271120,0,3,1
77477,1,3,271118,271120,271123,2,5,0
77478,1,3,271119,271123,271126,4,7,0
77479,1,1,271120,271126,271127,6,7,0
77480,5,3,271125,271127,271130,2,5,0
77481,3,3,271128,271130,271133,2,5,0
77482,6,1,271134,271134,271135,0,1,1
77483,2,1,271136,271136,271137,0,1,1
77484,6,3,271142,271142,271145,0,3,5
77485,1,3,271143,271145,271148,2,5,0
77486,2,2,271145,271148,271150,3,5,0
77487,1,2,271146,271150,271152,4,6,0
77488,5,3,271151,271152,271155,1,4,0
77489,1,1,271152,271155,271156,3,4,0
77490,1,1,271153,271156,271157,3,4,0
77491,5,3,271158,271158,271161,0,3,1
77492,4,3,271162,271162,271165,0,3,1
77493,6,3,271168,271168,271171,0,3,3
77494,5,3,271173,271173,271176,0,3,2
77495,1,2,271174,271176,271178,2,4,0
77496,2,3,271176,271178,271181,2,5,0
77497,6,1,271182,271182,271183,0,1,1
77498,1,2,271183,271183,271185,0,2,0
77499,2,1,271185,271185,271186,0,1,0
77500,4,3,271189,271189,271192,0,3,3
77501,3,3,271192,271192,271195,0,3,0
77502,5,1,271197,271197,271198,0,1,2
77503,3,3,271200,271200,271203,0,3,2
77504,3,3,271203,271203,271206,0,3,0
77505,1,1,271204,271206,271207,2,3,0
77506,5,3,271209,271209,271212,0,3,2
77507,1,3,271210,271212,271215,2,5,0
77508,6,2,271216,271216,271218,0,2,1
77509,3,2,271219,271219,271221,0,2,1
77510,1,1,271220,271221,271222,1,2,0
77511,1,3,271221,271222,271225,1,4,0
77512,1,3,271222,271225,271228,3,6,0
77513,2,2,271224,271228,271230,4,6,0
77514,6,3,271230,271230,271233,0,3,0
77515,6,1,271236,271236,271237,0,1,3
77516,3,3,271239,271239,271242,0,3,2
77517,1,3,271240,271242,271245,2,5,0
77518,3,2,271243,271245,271247,2,4,0
77519,4,3,271247,271247,271250,0,3,0
77520,6,2,271253,271253,271255,0,2,3
77521,3,3,271256,271256,271259,0,3,1
77522,5,3,271261,271261,271264,0,3,2
77523,4,2,271265,271265,271267,0,2,1
77524,4,2,271269,271269,271271,0,2,2
77525,4,1,271273,271273,271274,0,1,2
77526,5,3,271278,271278,271281,0,3,4
77527,2,1,271280,271281,271282,1,2,0
77528,2,2,271282,271282,271284,0,2,0
77529,4,1,271286,271286,271287,0,1,2
77530,2,1,271288,271288,271289,0,1,1
77531,4,2,271292,271292,271294,0,2,3
77532,4,2,271296,271296,271298,0,2,2
77533,6,1,271302,271302,271303,0,1,4
77534,5,1,271307,271307,271308,0,1,4
77535,1,2,271308,271308,271310,0,2,0
77536,6,1,271314,271314,271315,0,1,4
77537,6,3,271320,271320,271323,0,3,5
77538,4,2,271324,271324,271326,0,2,1
77539,5,3,271329,271329,271332,0,3,3
77540,3,3,271332,271332,271335,0,3,0
77541,4,1,271336,271336,271337,0,1,1
77542,4,1,271340,271340,271341,0,1,3
77543,5,3,271345,271345,271348,0,3,4
77544,3,1,271348,271348,271349,0,1,0
77545,4,1,271352,271352,271353,0,1,3
77546,2,1,271354,271354,271355,0,1,1
77547,1,3,271355,271355,271358,0,3,0
77548,5,2,271360,271360,271362,0,2,2
77549,1,3,271361,271362,271365,1,4,0
77550,1,3,271362,271365,271368,3,6,0
77551,1,2,271363,271368,271370,5,7,0
77552,5,1,271368,271370,271371,2,3,0
77553,5,1,271373,271373,271374,0,1,2
77554,5,1,271378,271378,271379,0,1,4
77555,2,3,271380,271380,271383,0,3,1
77556,5,1,271385,271385,271386,0,1,2
77557,1,1,271386,271386,271387,0,1,0
77558,2,3,271388,271388,271391,0,3,1
77559,4,1,271392,271392,271393,0,1,1
77560,2,2,271394,271394,271396,0,2,1
77561,3,3,271397,271397,271400,0,3,1
77562,5,2,271402,271402,271404,0,2,2
77563,4,1,271406,271406,271407,0,1,2
77564,2,2,271408,271408,271410,0,2,1
77565,4,2,271412,271412,271414,0,2,2
77566,2,2,271414,271414,271416,0,2,0
77567,4,1,271418,271418,271419,0,1,2
77568,4,3,271422,271422,271425,0,3,3
77569,5,1,271427,271427,271428,0,1,2
77570,5,2,271432,271432,271434,0,2,4
77571,6,1,271438,271438,271439,0,1,4
77572,4,2,271442,271442,271444,0,2,3
77573,1,2,271443,271444,271446,1,3,0
77574,4,3,271447,271447,271450,0,3,1
77575,4,2,271451,271451,271453,0,2,1
77576,5,2,271456,271456,271458,0,2,3
77577,5,2,271461,271461,271463,0,2,3
77578,5,1,271466,271466,271467,0,1,3
77579,6,3,271472,271472,271475,0,3,5
77580,2,2,271474,271475,271477,1,3,0
77581,6,1,271480,271480,271481,0,1,3
77582,5,1,271485,271485,271486,0,1,4
77583,6,1,271491,271491,271492,0,1,5
77584,6,1,271497,271497,271498,0,1,5
77585,6,1,271503,271503,271504,0,1,5
77586,1,3,271504,271504,271507,0,3,0
77587,1,1,271505,271507,271508,2,3,0
77588,2,1,271507,271508,271509,1,2,0
77589,3,1,271510,271510,271511,0,1,1
77590,3,2,271513,271513,271515,0,2,2
77591,1,1,271514,271515,271516,1,2,0
77592,4,2,271518,271518,271520,0,2,2
77593,4,1,271522,271522,271523,0,1,2
77594,4,3,271526,271526,271529,0,3,3
77595,4,1,271530,271530,271531,0,1,1
77596,2,3,271532,271532,271535,0,3,1
77597,4,3,271536,271536,271539,0,3,1
77598,5,2,271541,271541,271543,0,2,2
77599,6,1,271547,271547,271548,0,1,4
77600,3,2,271550,271550,271552,0,2,2
77601,4,1,271554,271554,271555,0,1,2
77602,4,2,271558,271558,271560,0,2,3
77603,2,2,271560,271560,271562,0,2,0
77604,4,1,271564,271564,271565,0,1,2
77605,2,3,271566,271566,271569,0,3,1
77606,5,2,271571,271571,271573,0,2,2
77607,4,2,271575,271575,271577,0,2,2
77608,4,1,271579,271579,271580,0,1,2
77609,6,3,271585,271585,271588,0,3,5
77610,6,2,271591,271591,271593,0,2,3
77611,2,3,271593,271593,271596,0,3,0
77612,3,3,271596,271596,271599,0,3,0
77613,5,2,271601,271601,271603,0,2,2
77614,5,1,271606,271606,271607,0,1,3
77615,3,3,271609,271609,271612,0,3,2
77616,1,3,271610,271612,271615,2,5,0
77617,6,1,271616,271616,271617,0,1,1
77618,4,2,271620,271620,271622,0,2,3
77619,1,3,271621,271622,271625,1,4,0
77620,1,3,271622,271625,271628,3,6,0
77621,1,3,271623,271628,271631,5,8,0
77622,6,3,271629,271631,271634,2,5,0
77623,2,3,271631,271634,271637,3,6,0
77624,1,3,271632,271637,271640,5,8,0
77625,4,3,271636,271640,271643,4,7,0
77626,4,2,271640,271643,271645,3,5,0
77627,5,2,271645,271645,271647,0,2,0
77628,4,3,271649,271649,271652,0,3,2
77629,2,2,271651,271652,271654,1,3,0
77630,4,3,271655,271655,271658,0,3,1
77631,5,1,271660,271660,271661,0,1,2
77632,2,1,271662,271662,271663,0,1,1
77633,2,3,271664,271664,271667,0,3,1
77634,3,2,271667,271667,271669,0,2,0
77635,3,1,271670,271670,271671,0,1,1
77636,1,3,271671,271671,271674,0,3,0
77637,5,3,271676,271676,271679,0,3,2
77638,2,3,271678,271679,271682,1,4,0
77639,5,3,271683,271683,271686,0,3,1
77640,5,3,271688,271688,271691,0,3,2
77641,3,1,271691,271691,271692,0,1,0
77642,4,2,271695,271695,271697,0,2,3
77643,1,2,271696,271697,271699,1,3,0
77644,2,3,271698,271699,271702,1,4,0
77645,4,1,271702,271702,271703,0,1,0
77646,2,3,271704,271704,271707,0,3,1
77647,2,1,271706,271707,271708,1,2,0
77648,3,3,271709,271709,271712,0,3,1
77649,4,1,271713,271713,271714,0,1,1
77650,2,1,271715,271715,271716,0,1,1
77651,5,1,271720,271720,271721,0,1,4
77652,5,2,271725,271725,271727,0,2,4
77653,4,1,271729,271729,271730,0,1,2
77654,1,1,271730,271730,271731,0,1,0
77655,4,2,271734,271734,271736,0,2,3
77656,3,1,271737,271737,271738,0,1,1
77657,3,1,271740,271740,271741,0,1,2
77658,3,2,271743,271743,271745,0,2,2
77659,5,2,271748,271748,271750,0,2,3
77660,5,2,271753,271753,271755,0,2,3
77661,6,3,271759,271759,271762,0,3,4
77662,3,2,271762,271762,271764,0,2,0
77663,2,1,271764,271764,271765,0,1,0
77664,4,3,271768,271768,271771,0,3,3
77665,3,2,271771,271771,271773,0,2,0
77666,6,1,271777,271777,271778,0,1,4
77667,4,3,271781,271781,271784,0,3,3
77668,3,2,271784,271784,271786,0,2,0
77669,1,1,271785,271786,271787,1,2,0
77670,3,3,271788,271788,271791,0,3,1
77671,4,3,271792,271792,271795,0,3,1
77672,4,1,271796,271796,271797,0,1,1
77673,1,3,271797,271797,271800,0,3,0
77674,3,1,271800,271800,271801,0,1,0
77675,2,1,271802,271802,271803,0,1,1
77676,6,3,271808,271808,271811,0,3,5
77677,4,2,271812,271812,271814,0,2,1
77678,5,1,271817,271817,271818,0,1,3
77679,5,2,271822,271822,271824,0,2,4
77680,1,2,271823,271824,271826,1,3,0
77681,4,3,271827,271827,271830,0,3,1
77682,4,2,271831,271831,271833,0,2,1
77683,1,2,271832,271833,271835,1,3,0
77684,6,2,271838,271838,271840,0,2,3
77685,1,2,271839,271840,271842,1,3,0
77686,6,2,271845,271845,271847,0,2,3
77687,6,2,271851,271851,271853,0,2,4
77688,1,1,271852,271853,271854,1,2,0
77689,6,3,271858,271858,271861,0,3,4
77690,1,2,271859,271861,271863,2,4,0
77691,2,1,271861,271863,271864,2,3,0
77692,4,1,271865,271865,271866,0,1,1
77693,2,2,271867,271867,271869,0,2,1
77694,5,3,271872,271872,271875,0,3,3
77695,6,1,271878,271878,271879,0,1,3
77696,4,1,271882,271882,271883,0,1,3
77697,3,1,271885,271885,271886,0,1,2
77698,3,1,271888,271888,271889,0,1,2
77699,6,2,271894,271894,271896,0,2,5
77700,4,2,271898,271898,271900,0,2,2
77701,2,1,271900,271900,271901,0,1,0
77702,2,2,271902,271902,271904,0,2,1
77703,6,1,271908,271908,271909,0,1,4
77704,1,1,271909,271909,271910,0,1,0
77705,3,2,271912,271912,271914,0,2,2
77706,4,2,271916,271916,271918,0,2,2
77707,6,3,271922,271922,271925,0,3,4
77708,6,3,271928,271928,271931,0,3,3
77709,3,3,271931,271931,271934,0,3,0
77710,2,2,271933,271934,271936,1,3,0
77711,1,1,271934,271936,271937,2,3,0
77712,1,3,271935,271937,271940,2,5,0
77713,3,2,271938,271940,271942,2,4,0
77714,3,1,271941,271942,271943,1,2,0
77715,6,3,271947,271947,271950,0,3,4
77716,6,3,271953,271953,271956,0,3,3
77717,6,2,271959,271959,271961,0,2,3
77718,1,3,271960,271961,271964,1,4,0
77719,3,2,271963,271964,271966,1,3,0
77720,4,2,271967,271967,271969,0,2,1
77721,6,2,271973,271973,271975,0,2,4
77722,1,3,271974,271975,271978,1,4,0
77723,3,2,271977,271978,271980,1,3,0
77724,2,1,271979,271980,271981,1,2,0
77725,1,1,271980,271981,271982,1,2,0
77726,5,3,271985,271985,271988,0,3,3
77727,5,2,271990,271990,271992,0,2,2
77728,4,3,271994,271994,271997,0,3,2
77729,2,3,271996,271997,272000,1,4,0
77730,3,2,271999,272000,272002,1,3,0
77731,3,1,272002,272002,272003,0,1,0
77732,6,2,272008,272008,272010,0,2,5
77733,4,3,272012,272012,272015,0,3,2
77734,2,2,272014,272015,272017,1,3,0
77735,3,3,272017,272017,272020,0,3,0
77736,6,1,272023,272023,272024,0,1,3
77737,4,1,272027,272027,272028,0,1,3
77738,4,3,272031,272031,272034,0,3,3
77739,4,2,272035,272035,272037,0,2,1
77740,5,1,272040,272040,272041,0,1,3
77741,3,2,272043,272043,272045,0,2,2
77742,1,2,272044,272045,272047,1,3,0
77743,5,3,272049,272049,272052,0,3,2
77744,4,2,272053,272053,272055,0,2,1
77745,6,2,272059,272059,272061,0,2,4
77746,2,3,272061,272061,272064,0,3,0
77747,1,1,272062,272064,272065,2,3,0
77748,3,1,272065,272065,272066,0,1,0
77749,4,2,272069,272069,272071,0,2,3
77750,5,2,272074,272074,272076,0,2,3
77751,4,3,272078,272078,272081,0,3,2
77752,3,1,272081,272081,272082,0,1,0
77753,5,1,272086,272086,272087,0,1,4
77754,2,1,272088,272088,272089,0,1,1
77755,6,2,272094,272094,272096,0,2,5
77756,6,1,272100,272100,272101,0,1,4
77757,3,3,272103,272103,272106,0,3,2
77758,1,1,272104,272106,272107,2,3,0
77759,2,2,272106,272107,272109,1,3,0
77760,6,3,272112,272112,272115,0,3,3
77761,2,1,272114,272115,272116,1,2,0
77762,2,2,272116,272116,272118,0,2,0
77763,6,1,272122,272122,272123,0,1,4
77764,5,3,272127,272127,272130,0,3,4
77765,4,1,272131,272131,272132,0,1,1
77766,4,3,272135,272135,272138,0,3,3
77767,2,2,272137,272138,272140,1,3,0
77768,2,1,272139,272140,272141,1,2,0
77769,1,1,272140,272141,272142,1,2,0
77770,2,3,272142,272142,272145,0,3,0
77771,5,2,272147,272147,272149,0,2,2
77772,2,2,272149,272149,272151,0,2,0
77773,2,3,272151,272151,272154,0,3,0
77774,2,1,272153,272154,272155,1,2,0
77775,3,2,272156,272156,272158,0,2,1
77776,4,3,272160,272160,272163,0,3,2
77777,5,1,272165,272165,272166,0,1,2
77778,6,1,272171,272171,272172,0,1,5
77779,2,1,272173,272173,272174,0,1,1
77780,6,2,272179,272179,272181,0,2,5
77781,1,1,272180,272181,272182,1,2,0
77782,5,1,272185,272185,272186,0,1,3
77783,6,1,272191,272191,272192,0,1,5
77784,1,2,272192,272192,272194,0,2,0
77785,2,3,272194,272194,272197,0,3,0
77786,4,1,272198,272198,272199,0,1,1
77787,3,1,272201,272201,272202,0,1,2
77788,3,1,272204,272204,272205,0,1,2
77789,1,2,272205,272205,272207,0,2,0
77790,5,1,272210,272210,272211,0,1,3
77791,5,3,272215,272215,272218,0,3,4
77792,6,2,272221,272221,272223,0,2,3
77793,5,2,272226,272226,272228,0,2,3
77794,2,3,272228,272228,272231,0,3,0
77795,6,2,272234,272234,272236,0,2,3
77796,5,1,272239,272239,272240,0,1,3
77797,3,3,272242,272242,272245,0,3,2
77798,3,1,272245,272245,272246,0,1,0
77799,2,1,272247,272247,272248,0,1,1
77800,1,1,272248,272248,272249,0,1,0
77801,5,3,272253,272253,272256,0,3,4
77802,2,1,272255,272256,272257,1,2,0
77803,1,1,272256,272257,272258,1,2,0
77804,5,2,272261,272261,272263,0,2,3
77805,2,1,272263,272263,272264,0,1,0
77806,6,3,272269,272269,272272,0,3,5
77807,4,3,272273,272273,272276,0,3,1
77808,4,1,272277,272277,272278,0,1,1
77809,2,1,272279,272279,272280,0,1,1
77810,3,2,272282,272282,272284,0,2,2
77811,6,3,272288,272288,272291,0,3,4
77812,4,1,272292,272292,272293,0,1,1
77813,2,1,272294,272294,272295,0,1,1
77814,5,3,272299,272299,272302,0,3,4
77815,5,2,272304,272304,272306,0,2,2
77816,2,1,272306,272306,272307,0,1,0
77817,2,2,272308,272308,272310,0,2,1
77818,2,2,272310,272310,272312,0,2,0
77819,2,3,272312,272312,272315,0,3,0
77820,4,3,272316,272316,272319,0,3,1
77821,1,2,272317,272319,272321,2,4,0
77822,4,1,272321,272321,272322,0,1,0
77823,3,1,272324,272324,272325,0,1,2
77824,2,2,272326,272326,272328,0,2,1
77825,3,3,272329,272329,272332,0,3,1
77826,4,3,272333,272333,272336,0,3,1
77827,6,1,272339,272339,272340,0,1,3
77828,1,1,272340,272340,272341,0,1,0
77829,3,3,272343,272343,272346,0,3,2
77830,5,3,272348,272348,272351,0,3,2
77831,6,1,272354,272354,272355,0,1,3
77832,3,3,272357,272357,272360,0,3,2
77833,5,2,272362,272362,272364,0,2,2
77834,3,3,272365,272365,272368,0,3,1
77835,4,2,272369,272369,272371,0,2,1
77836,6,2,272375,272375,272377,0,2,4
77837,4,1,272379,272379,272380,0,1,2
77838,4,2,272383,272383,272385,0,2,3
77839,6,3,272389,272389,272392,0,3,4
77840,1,2,272390,272392,272394,2,4,0
77841,2,3,272392,272394,272397,2,5,0
77842,4,3,272396,272397,272400,1,4,0
77843,1,3,272397,272400,272403,3,6,0
77844,1,3,272398,272403,272406,5,8,0
77845,6,3,272404,272406,272409,2,5,0
77846,2,2,272406,272409,272411,3,5,0
77847,5,1,272411,272411,272412,0,1,0
77848,6,3,272417,272417,272420,0,3,5
77849,6,1,272423,272423,272424,0,1,3
77850,5,2,272428,272428,272430,0,2,4
77851,2,2,272430,272430,272432,0,2,0
77852,5,1,272435,272435,272436,0,1,3
77853,6,1,272441,272441,272442,0,1,5
77854,6,2,272447,272447,272449,0,2,5
77855,3,3,272450,272450,272453,0,3,1
77856,4,1,272454,272454,272455,0,1,1
77857,4,2,272458,272458,272460,0,2,3
77858,2,3,272460,272460,272463,0,3,0
77859,1,1,272461,272463,272464,2,3,0
77860,2,1,272463,272464,272465,1,2,0
77861,2,2,272465,272465,272467,0,2,0
77862,6,1,272471,272471,272472,0,1,4
77863,2,1,272473,272473,272474,0,1,1
77864,5,2,272478,272478,272480,0,2,4
77865,3,1,272481,272481,272482,0,1,1
77866,6,3,272487,272487,272490,0,3,5
77867,4,1,272491,272491,272492,0,1,1
77868,5,3,272496,272496,272499,0,3,4
77869,6,2,272502,272502,272504,0,2,3
77870,5,2,272507,272507,272509,0,2,3
77871,3,3,272510,272510,272513,0,3,1
77872,3,3,272513,272513,272516,0,3,0
77873,6,2,272519,272519,272521,0,2,3
77874,1,2,272520,272521,272523,1,3,0
77875,1,2,272521,272523,272525,2,4,0
77876,6,1,272527,272527,272528,0,1,2
77877,1,3,272528,272528,272531,0,3,0
77878,2,2,272530,272531,272533,1,3,0
77879,5,2,272535,272535,272537,0,2,2
77880,5,1,272540,272540,272541,0,1,3
77881,4,1,272544,272544,272545,0,1,3
77882,6,2,272550,272550,272552,0,2,5
77883,6,3,272556,272556,272559,0,3,4
77884,1,3,272557,272559,272562,2,5,0
77885,1,1,272558,272562,272563,4,5,0
77886,5,2,272563,272563,272565,0,2,0
77887,3,3,272566,272566,272569,0,3,1
77888,6,1,272572,272572,272573,0,1,3
77889,4,3,272576,272576,272579,0,3,3
77890,4,1,272580,272580,272581,0,1,1
77891,6,2,272586,272586,272588,0,2,5
77892,3,2,272589,272589,272591,0,2,1
77893,4,3,272593,272593,272596,0,3,2
77894,1,2,272594,272596,272598,2,4,0
77895,1,1,272595,272598,272599,3,4,0
77896,2,2,272597,272599,272601,2,4,0
77897,2,3,272599,272601,272604,2,5,0
77898,2,1,272601,272604,272605,3,4,0
77899,4,2,272605,272605,272607,0,2,0
77900,6,1,272611,272611,272612,0,1,4
77901,6,1,272617,272617,272618,0,1,5
77902,6,2,272623,272623,272625,0,2,5
77903,2,3,272625,272625,272628,0,3,0
77904,1,3,272626,272628,272631,2,5,0
77905,5,2,272631,272631,272633,0,2,0
77906,2,2,272633,272633,272635,0,2,0
77907,2,2,272635,272635,272637,0,2,0
77908,3,1,272638,272638,272639,0,1,1
77909,2,1,272640,272640,272641,0,1,1
77910,2,2,272642,272642,272644,0,2,1
77911,6,1,272648,272648,272649,0,1,4
77912,1,1,272649,272649,272650,0,1,0
77913,1,1,272650,272650,272651,0,1,0
77914,3,2,272653,272653,272655,0,2,2
77915,5,1,272658,272658,272659,0,1,3
77916,6,1,272664,272664,272665,0,1,5
77917,1,3,272665,272665,272668,0,3,0
77918,3,3,272668,272668,272671,0,3,0
77919,5,3,272673,272673,272676,0,3,2
77920,5,3,272678,272678,272681,0,3,2
77921,5,2,272683,272683,272685,0,2,2
77922,2,2,272685,272685,272687,0,2,0
77923,1,2,272686,272687,272689,1,3,0
77924,4,2,272690,272690,272692,0,2,1
77925,5,1,272695,272695,272696,0,1,3
77926,4,1,272699,272699,272700,0,1,3
77927,6,2,272705,272705,272707,0,2,5
77928,2,3,272707,272707,272710,0,3,0
77929,6,2,272713,272713,272715,0,2,3
77930,5,1,272718,272718,272719,0,1,3
77931,2,1,272720,272720,272721,0,1,1
77932,6,1,272726,272726,272727,0,1,5
77933,2,1,272728,272728,272729,0,1,1
77934,4,2,272732,272732,272734,0,2,3
77935,5,2,272737,272737,272739,0,2,3
77936,5,2,272742,272742,272744,0,2,3
77937,4,1,272746,272746,272747,0,1,2
77938,5,3,272751,272751,272754,0,3,4
77939,5,1,272756,272756,272757,0,1,2
77940,5,3,272761,272761,272764,0,3,4
77941,4,3,272765,272765,272768,0,3,1
77942,2,1,272767,272768,272769,1,2,0
77943,3,1,272770,272770,272771,0,1,1
77944,5,2,272775,272775,272777,0,2,4
77945,5,2,272780,272780,272782,0,2,3
77946,2,2,272782,272782,272784,0,2,0
77947,3,2,272785,272785,272787,0,2,1
77948,4,1,272789,272789,272790,0,1,2
77949,5,2,272794,272794,272796,0,2,4
77950,4,2,272798,272798,272800,0,2,2
77951,1,2,272799,272800,272802,1,3,0
77952,2,1,272801,272802,272803,1,2,0
77953,5,2,272806,272806,272808,0,2,3
77954,4,1,272810,272810,272811,0,1,2
77955,2,3,272812,272812,272815,0,3,1
77956,2,1,272814,272815,272816,1,2,0
77957,1,3,272815,272816,272819,1,4,0
77958,6,3,272821,272821,272824,0,3,2
77959,4,1,272825,272825,272826,0,1,1
77960,3,3,272828,272828,272831,0,3,2
77961,1,3,272829,272831,272834,2,5,0
77962,6,2,272835,272835,272837,0,2,1
77963,2,2,272837,272837,272839,0,2,0
77964,4,3,272841,272841,272844,0,3,2
77965,3,2,272844,272844,272846,0,2,0
77966,2,1,272846,272846,272847,0,1,0
77967,2,2,272848,272848,272850,0,2,1
77968,1,3,272849,272850,272853,1,4,0
77969,5,1,272854,272854,272855,0,1,1
77970,5,2,272859,272859,272861,0,2,4
77971,1,2,272860,272861,272863,1,3,0
77972,3,3,272863,272863,272866,0,3,0
77973,4,2,272867,272867,272869,0,2,1
77974,5,2,272872,272872,272874,0,2,3
77975,3,1,272875,272875,272876,0,1,1
77976,4,3,272879,272879,272882,0,3,3
77977,6,3,272885,272885,272888,0,3,3
77978,6,2,272891,272891,272893,0,2,3
77979,1,3,272892,272893,272896,1,4,0
77980,5,1,272897,272897,272898,0,1,1
77981,2,1,272899,272899,272900,0,1,1
77982,3,1,272902,272902,272903,0,1,2
77983,1,3,272903,272903,272906,0,3,0
77984,1,3,272904,272906,272909,2,5,0
77985,2,1,272906,272909,272910,3,4,0
77986,3,3,272909,272910,272913,1,4,0
77987,3,2,272912,272913,272915,1,3,0
77988,5,2,272917,272917,272919,0,2,2
77989,1,1,272918,272919,272920,1,2,0
77990,3,1,272921,272921,272922,0,1,1
77991,5,1,272926,272926,272927,0,1,4
77992,5,1,272931,272931,272932,0,1,4
77993,2,3,272933,272933,272936,0,3,1
77994,2,3,272935,272936,272939,1,4,0
77995,5,1,272940,272940,272941,0,1,1
77996,3,3,272943,272943,272946,0,3,2
77997,3,2,272946,272946,272948,0,2,0
77998,3,2,272949,272949,272951,0,2,1
77999,5,2,272954,272954,272956,0,2,3
78000,1,2,272955,272956,272958,1,3,0
78001,1,3,272956,272958,272961,2,5,0
78002,6,3,272962,272962,272965,0,3,1
78003,2,3,272964,272965,272968,1,4,0
78004,2,3,272966,272968,272971,2,5,0
78005,5,1,272971,272971,272972,0,1,0
78006,4,2,272975,272975,272977,0,2,3
78007,3,3,272978,272978,272981,0,3,1
78008,5,1,272983,272983,272984,0,1,2
78009,6,3,272989,272989,272992,0,3,5
78010,1,1,272990,272992,272993,2,3,0
78011,5,2,272995,272995,272997,0,2,2
78012,3,1,272998,272998,272999,0,1,1
78013,3,2,273001,273001,273003,0,2,2
78014,5,2,273006,273006,273008,0,2,3
78015,1,3,273007,273008,273011,1,4,0
78016,4,3,273011,273011,273014,0,3,0
78017,5,1,273016,273016,273017,0,1,2
78018,6,1,273022,273022,273023,0,1,5
78019,2,3,273024,273024,273027,0,3,1
78020,3,3,273027,273027,273030,0,3,0
78021,6,2,273033,273033,273035,0,2,3
78022,4,3,273037,273037,273040,0,3,2
78023,2,2,273039,273040,273042,1,3,0
78024,1,2,273040,273042,273044,2,4,0
78025,5,2,273045,273045,273047,0,2,1
78026,5,3,273050,273050,273053,0,3,3
78027,1,3,273051,273053,273056,2,5,0
78028,3,3,273054,273056,273059,2,5,0
78029,2,3,273056,273059,273062,3,6,0
78030,3,3,273059,273062,273065,3,6,0
78031,6,2,273065,273065,273067,0,2,0
78032,1,3,273066,273067,273070,1,4,0
78033,4,2,273070,273070,273072,0,2,0
78034,1,3,273071,273072,273075,1,4,0
78035,6,2,273077,273077,273079,0,2,2
78036,4,3,273081,273081,273084,0,3,2
78037,3,3,273084,273084,273087,0,3,0
78038,2,2,273086,273087,273089,1,3,0
78039,2,1,273088,273089,273090,1,2,0
78040,2,1,273090,273090,273091,0,1,0
78041,3,3,273093,273093,273096,0,3,2
78042,5,2,273098,273098,273100,0,2,2
78043,4,3,273102,273102,273105,0,3,2
78044,4,2,273106,273106,273108,0,2,1
78045,2,3,273108,273108,273111,0,3,0
78046,2,1,273110,273111,273112,1,2,0
78047,6,3,273116,273116,273119,0,3,4
78048,2,2,273118,273119,273121,1,3,0
78049,3,3,273121,273121,273124,0,3,0
78050,3,1,273124,273124,273125,0,1,0
78051,4,3,273128,273128,273131,0,3,3
78052,2,1,273130,273131,273132,1,2,0
78053,6,3,273136,273136,273139,0,3,4
78054,3,3,273139,273139,273142,0,3,0
78055,5,1,273144,273144,273145,0,1,2
78056,1,3,273145,273145,273148,0,3,0
78057,3,3,273148,273148,273151,0,3,0
78058,2,3,273150,273151,273154,1,4,0
78059,4,2,273154,273154,273156,0,2,0
78060,1,1,273155,273156,273157,1,2,0
78061,6,2,273161,273161,273163,0,2,4
78062,6,1,273167,273167,273168,0,1,4
78063,6,3,273173,273173,273176,0,3,5
78064,3,3,273176,273176,273179,0,3,0
78065,6,1,273182,273182,273183,0,1,3
78066,4,1,273186,273186,273187,0,1,3
78067,6,3,273192,273192,273195,0,3,5
78068,2,3,273194,273195,273198,1,4,0
78069,3,1,273197,273198,273199,1,2,0
78070,4,3,273201,273201,273204,0,3,2
78071,5,1,273206,273206,273207,0,1,2
78072,3,2,273209,273209,273211,0,2,2
78073,2,2,273211,273211,273213,0,2,0
78074,2,1,273213,273213,273214,0,1,0
78075,1,3,273214,273214,273217,0,3,0
78076,1,3,273215,273217,273220,2,5,0
78077,4,2,273219,273220,273222,1,3,0
78078,1,2,273220,273222,273224,2,4,0
78079,3,2,273223,273224,273226,1,3,0
78080,6,1,273229,273229,273230,0,1,3
78081,6,1,273235,273235,273236,0,1,5
78082,1,3,273236,273236,273239,0,3,0
78083,2,1,273238,273239,273240,1,2,0
78084,2,2,273240,273240,273242,0,2,0
78085,2,2,273242,273242,273244,0,2,0
78086,6,1,273248,273248,273249,0,1,4
78087,5,2,273253,273253,273255,0,2,4
78088,3,2,273256,273256,273258,0,2,1
78089,5,3,273261,273261,273264,0,3,3
78090,1,1,273262,273264,273265,2,3,0
78091,4,2,273266,273266,273268,0,2,1
78092,4,1,273270,273270,273271,0,1,2
78093,1,3,273271,273271,273274,0,3,0
78094,5,3,273276,273276,273279,0,3,2
78095,4,3,273280,273280,273283,0,3,1
78096,3,1,273283,273283,273284,0,1,0
78097,1,1,273284,273284,273285,0,1,0
78098,6,2,273290,273290,273292,0,2,5
78099,5,1,273295,273295,273296,0,1,3
78100,4,3,273299,273299,273302,0,3,3
78101,4,2,273303,273303,273305,0,2,1
78102,6,1,273309,273309,273310,0,1,4
78103,3,1,273312,273312,273313,0,1,2
78104,5,3,273317,273317,273320,0,3,4
78105,3,1,273320,273320,273321,0,1,0
78106,5,2,273325,273325,273327,0,2,4
78107,3,3,273328,273328,273331,0,3,1
78108,2,1,273330,273331,273332,1,2,0
78109,1,1,273331,273332,273333,1,2,0
78110,4,1,273335,273335,273336,0,1,2
78111,5,1,273340,273340,273341,0,1,4
78112,6,1,273346,273346,273347,0,1,5
78113,6,3,273352,273352,273355,0,3,5
78114,3,1,273355,273355,273356,0,1,0
78115,5,2,273360,273360,273362,0,2,4
78116,3,1,273363,273363,273364,0,1,1
78117,4,2,273367,273367,273369,0,2,3
78118,2,3,273369,273369,273372,0,3,0
78119,2,1,273371,273372,273373,1,2,0
78120,3,2,273374,273374,273376,0,2,1
78121,2,1,273376,273376,273377,0,1,0
78122,3,1,273379,273379,273380,0,1,2
78123,1,3,273380,273380,273383,0,3,0
78124,5,3,273385,273385,273388,0,3,2
78125,6,1,273391,273391,273392,0,1,3
78126,3,3,273394,273394,273397,0,3,2
78127,4,2,273398,273398,273400,0,2,1
78128,6,3,273404,273404,273407,0,3,4
78129,3,3,273407,273407,273410,0,3,0
78130,2,1,273409,273410,273411,1,2,0
78131,5,1,273414,273414,273415,0,1,3
78132,1,1,273415,273415,273416,0,1,0
78133,1,3,273416,273416,273419,0,3,0
78134,3,3,273419,273419,273422,0,3,0
78135,4,1,273423,273423,273424,0,1,1
78136,3,1,273426,273426,273427,0,1,2
78137,3,1,273429,273429,273430,0,1,2
78138,2,3,273431,273431,273434,0,3,1
78139,6,3,273437,273437,273440,0,3,3
78140,4,2,273441,273441,273443,0,2,1
78141,4,3,273445,273445,273448,0,3,2
78142,4,2,273449,273449,273451,0,2,1
78143,5,3,273454,273454,273457,0,3,3
78144,2,2,273456,273457,273459,1,3,0
78145,6,1,273462,273462,273463,0,1,3
78146,2,3,273464,273464,273467,0,3,1
78147,6,1,273470,273470,273471,0,1,3
78148,1,3,273471,273471,273474,0,3,0
78149,2,2,273473,273474,273476,1,3,0
78150,5,1,273478,273478,273479,0,1,2
78151,6,2,273484,273484,273486,0,2,5
78152,3,1,273487,273487,273488,0,1,1
78153,1,3,273488,273488,273491,0,3,0
78154,4,3,273492,273492,273495,0,3,1
78155,4,3,273496,273496,273499,0,3,1
78156,1,3,273497,273499,273502,2,5,0
78157,1,2,273498,273502,273504,4,6,0
78158,2,1,273500,273504,273505,4,5,0
78159,2,1,273502,273505,273506,3,4,0
78160,6,2,273508,273508,273510,0,2,2
78161,6,3,273514,273514,273517,0,3,4
78162,6,2,273520,273520,273522,0,2,3
78163,4,1,273524,273524,273525,0,1,2
78164,3,2,273527,273527,273529,0,2,2
78165,5,1,273532,273532,273533,0,1,3
78166,4,1,273536,273536,273537,0,1,3
78167,1,2,273537,273537,273539,0,2,0
78168,4,2,273541,273541,273543,0,2,2
78169,6,1,273547,273547,273548,0,1,4
78170,6,1,273553,273553,273554,0,1,5
78171,3,2,273556,273556,273558,0,2,2
78172,1,3,273557,273558,273561,1,4,0
78173,3,1,273560,273561,273562,1,2,0
78174,3,2,273563,273563,273565,0,2,1
78175,6,1,273569,273569,273570,0,1,4
78176,3,3,273572,273572,273575,0,3,2
78177,6,1,273578,273578,273579,0,1,3
78178,2,3,273580,273580,273583,0,3,1
78179,4,1,273584,273584,273585,0,1,1
78180,2,1,273586,273586,273587,0,1,1
78181,4,1,273590,273590,273591,0,1,3
78182,2,3,273592,273592,273595,0,3,1
78183,2,3,273594,273595,273598,1,4,0
78184,3,1,273597,273598,273599,1,2,0
78185,3,1,273600,273600,273601,0,1,1
78186,3,2,273603,273603,273605,0,2,2
78187,6,1,273609,273609,273610,0,1,4
78188,6,2,273615,273615,273617,0,2,5
78189,5,2,273620,273620,273622,0,2,3
78190,5,3,273625,273625,273628,0,3,3
78191,3,1,273628,273628,273629,0,1,0
78192,1,1,273629,273629,273630,0,1,0
78193,1,2,273630,273630,273632,0,2,0
78194,1,3,273631,273632,273635,1,4,0
78195,4,3,273635,273635,273638,0,3,0
78196,1,1,273636,273638,273639,2,3,0
78197,3,3,273639,273639,273642,0,3,0
78198,1,1,273640,273642,273643,2,3,0
78199,5,1,273645,273645,273646,0,1,2
78200,4,1,273649,273649,273650,0,1,3
78201,3,2,273652,273652,273654,0,2,2
78202,5,3,273657,273657,273660,0,3,3
78203,2,1,273659,273660,273661,1,2,0
78204,5,2,273664,273664,273666,0,2,3
78205,1,2,273665,273666,273668,1,3,0
78206,2,2,273667,273668,273670,1,3,0
78207,3,3,273670,273670,273673,0,3,0
78208,4,3,273674,273674,273677,0,3,1
78209,5,1,273679,273679,273680,0,1,2
78210,5,3,273684,273684,273687,0,3,4
78211,6,3,273690,273690,273693,0,3,3
78212,1,1,273691,273693,273694,2,3,0
78213,3,2,273694,273694,273696,0,2,0
78214,3,1,273697,273697,273698,0,1,1
78215,2,3,273699,273699,273702,0,3,1
78216,4,2,273703,273703,273705,0,2,1
78217,5,1,273708,273708,273709,0,1,3
78218,3,3,273711,273711,273714,0,3,2
78219,5,1,273716,273716,273717,0,1,2
78220,4,3,273720,273720,273723,0,3,3
78221,4,3,273724,273724,273727,0,3,1
78222,2,2,273726,273727,273729,1,3,0
78223,1,3,273727,273729,273732,2,5,0
78224,3,2,273730,273732,273734,2,4,0
78225,2,2,273732,273734,273736,2,4,0
78226,2,2,273734,273736,273738,2,4,0
78227,5,2,273739,273739,273741,0,2,1
78228,5,1,273744,273744,273745,0,1,3
78229,3,1,273747,273747,273748,0,1,2
78230,6,3,273753,273753,273756,0,3,5
78231,5,1,273758,273758,273759,0,1,2
78232,6,1,273764,273764,273765,0,1,5
78233,1,1,273765,273765,273766,0,1,0
78234,4,3,273769,273769,273772,0,3,3
78235,6,1,273775,273775,273776,0,1,3
78236,4,3,273779,273779,273782,0,3,3
78237,3,3,273782,273782,273785,0,3,0
78238,6,2,273788,273788,273790,0,2,3
78239,6,2,273794,273794,273796,0,2,4
78240,4,1,273798,273798,273799,0,1,2
78241,3,1,273801,273801,273802,0,1,2
78242,2,1,273803,273803,273804,0,1,1
78243,3,1,273806,273806,273807,0,1,2
78244,6,2,273812,273812,273814,0,2,5
78245,6,1,273818,273818,273819,0,1,4
78246,3,2,273821,273821,273823,0,2,2
78247,3,2,273824,273824,273826,0,2,1
78248,3,1,273827,273827,273828,0,1,1
78249,5,1,273832,273832,273833,0,1,4
78250,5,2,273837,273837,273839,0,2,4
78251,5,1,273842,273842,273843,0,1,3
78252,4,1,273846,273846,273847,0,1,3
78253,2,1,273848,273848,273849,0,1,1
78254,5,3,273853,273853,273856,0,3,4
78255,2,3,273855,273856,273859,1,4,0
78256,3,3,273858,273859,273862,1,4,0
78257,2,2,273860,273862,273864,2,4,0
78258,5,3,273865,273865,273868,0,3,1
78259,2,1,273867,273868,273869,1,2,0
78260,5,1,273872,273872,273873,0,1,3
78261,4,3,273876,273876,273879,0,3,3
78262,3,1,273879,273879,273880,0,1,0
78263,3,1,273882,273882,273883,0,1,2
78264,1,3,273883,273883,273886,0,3,0
78265,1,2,273884,273886,273888,2,4,0
78266,1,1,273885,273888,273889,3,4,0
78267,1,1,273886,273889,273890,3,4,0
78268,4,1,273890,273890,273891,0,1,0
78269,1,1,273891,273891,273892,0,1,0
78270,4,2,273895,273895,273897,0,2,3
78271,1,3,273896,273897,273900,1,4,0
78272,5,3,273901,273901,273904,0,3,1
78273,3,2,273904,273904,273906,0,2,0
78274,4,3,273908,273908,273911,0,3,2
78275,3,2,273911,273911,273913,0,2,0
78276,2,1,273913,273913,273914,0,1,0
78277,4,1,273917,273917,273918,0,1,3
78278,6,2,273923,273923,273925,0,2,5
78279,6,1,273929,273929,273930,0,1,4
78280,1,3,273930,273930,273933,0,3,0
78281,4,1,273934,273934,273935,0,1,1
78282,5,3,273939,273939,273942,0,3,4
78283,1,3,273940,273942,273945,2,5,0
78284,3,1,273943,273945,273946,2,3,0
78285,6,3,273949,273949,273952,0,3,3
78286,6,3,273955,273955,273958,0,3,3
78287,2,2,273957,273958,273960,1,3,0
78288,4,2,273961,273961,273963,0,2,1
78289,2,3,273963,273963,273966,0,3,0
78290,4,2,273967,273967,273969,0,2,1
78291,4,3,273971,273971,273974,0,3,2
78292,2,2,273973,273974,273976,1,3,0
78293,5,3,273978,273978,273981,0,3,2
78294,2,2,273980,273981,273983,1,3,0
78295,6,3,273986,273986,273989,0,3,3
78296,6,2,273992,273992,273994,0,2,3
78297,4,3,273996,273996,273999,0,3,2
78298,2,3,273998,273999,274002,1,4,0
78299,3,3,274001,274002,274005,1,4,0
78300,6,2,274007,274007,274009,0,2,2
78301,4,3,274011,274011,274014,0,3,2
78302,2,2,274013,274014,274016,1,3,0
78303,3,3,274016,274016,274019,0,3,0
78304,2,2,274018,274019,274021,1,3,0
78305,5,1,274023,274023,274024,0,1,2
78306,2,3,274025,274025,274028,0,3,1
78307,4,2,274029,274029,274031,0,2,1
78308,4,3,274033,274033,274036,0,3,2
78309,2,3,274035,274036,274039,1,4,0
78310,4,1,274039,274039,274040,0,1,0
78311,1,3,274040,274040,274043,0,3,0
78312,4,2,274044,274044,274046,0,2,1
78313,4,3,274048,274048,274051,0,3,2
78314,5,3,274053,274053,274056,0,3,2
78315,1,2,274054,274056,274058,2,4,0
78316,4,1,274058,274058,274059,0,1,0
78317,1,1,274059,274059,274060,0,1,0
78318,2,2,274061,274061,274063,0,2,1
78319,5,3,274066,274066,274069,0,3,3
78320,3,1,274069,274069,274070,0,1,0
78321,1,3,274070,274070,274073,0,3,0
78322,5,3,274075,274075,274078,0,3,2
78323,2,2,274077,274078,274080,1,3,0
78324,3,1,274080,274080,274081,0,1,0
78325,3,1,274083,274083,274084,0,1,2
78326,6,1,274089,274089,274090,0,1,5
78327,2,2,274091,274091,274093,0,2,1
78328,6,3,274097,274097,274100,0,3,4
78329,1,1,274098,274100,274101,2,3,0
78330,2,2,274100,274101,274103,1,3,0
78331,5,3,274105,274105,274108,0,3,2
78332,4,1,274109,274109,274110,0,1,1
78333,5,2,274114,274114,274116,0,2,4
78334,6,3,274120,274120,274123,0,3,4
78335,1,3,274121,274123,274126,2,5,0
78336,4,3,274125,274126,274129,1,4,0
78337,1,2,274126,274129,274131,3,5,0
78338,3,1,274129,274131,274132,2,3,0
78339,1,1,274130,274132,274133,2,3,0
78340,3,3,274133,274133,274136,0,3,0
78341,3,1,274136,274136,274137,0,1,0
78342,5,3,274141,274141,274144,0,3,4
78343,6,2,274147,274147,274149,0,2,3
78344,4,2,274151,274151,274153,0,2,2
78345,1,3,274152,274153,274156,1,4,0
78346,4,1,274156,274156,274157,0,1,0
78347,6,1,274162,274162,274163,0,1,5
78348,5,3,274167,274167,274170,0,3,4
78349,4,2,274171,274171,274173,0,2,1
78350,4,1,274175,274175,274176,0,1,2
78351,6,3,274181,274181,274184,0,3,5
78352,3,3,274184,274184,274187,0,3,0
78353,6,1,274190,274190,274191,0,1,3
78354,6,2,274196,274196,274198,0,2,5
78355,5,3,274201,274201,274204,0,3,3
78356,3,1,274204,274204,274205,0,1,0
78357,6,1,274210,274210,274211,0,1,5
78358,1,2,274211,274211,274213,0,2,0
78359,3,2,274214,274214,274216,0,2,1
78360,2,2,274216,274216,274218,0,2,0
78361,4,1,274220,274220,274221,0,1,2
78362,1,2,274221,274221,274223,0,2,0
78363,2,1,274223,274223,274224,0,1,0
78364,4,3,274227,274227,274230,0,3,3
78365,6,3,274233,274233,274236,0,3,3
78366,6,3,274239,274239,274242,0,3,3
78367,6,2,274245,274245,274247,0,2,3
78368,2,1,274247,274247,274248,0,1,0
78369,1,3,274248,274248,274251,0,3,0
78370,2,2,274250,274251,274253,1,3,0
78371,6,1,274256,274256,274257,0,1,3
78372,4,2,274260,274260,274262,0,2,3
78373,2,1,274262,274262,274263,0,1,0
78374,4,1,274266,274266,274267,0,1,3
78375,1,1,274267,274267,274268,0,1,0
78376,6,1,274273,274273,274274,0,1,5
78377,5,1,274278,274278,274279,0,1,4
78378,4,2,274282,274282,274284,0,2,3
78379,2,3,274284,274284,274287,0,3,0
78380,5,2,274289,274289,274291,0,2,2
78381,4,1,274293,274293,274294,0,1,2
78382,3,1,274296,274296,274297,0,1,2
78383,1,2,274297,274297,274299,0,2,0
78384,5,1,274302,274302,274303,0,1,3
78385,5,1,274307,274307,274308,0,1,4
78386,4,1,274311,274311,274312,0,1,3
78387,1,2,274312,274312,274314,0,2,0
78388,4,1,274316,274316,274317,0,1,2
78389,1,1,274317,274317,274318,0,1,0
78390,1,1,274318,274318,274319,0,1,0
78391,6,2,274324,274324,274326,0,2,5
78392,5,3,274329,274329,274332,0,3,3
78393,3,2,274332,274332,274334,0,2,0
78394,4,3,274336,274336,274339,0,3,2
78395,6,2,274342,274342,274344,0,2,3
78396,5,2,274347,274347,274349,0,2,3
78397,1,2,274348,274349,274351,1,3,0
78398,6,3,274354,274354,274357,0,3,3
78399,6,3,274360,274360,274363,0,3,3
78400,3,2,274363,274363,274365,0,2,0
78401,2,1,274365,274365,274366,0,1,0
78402,1,3,274366,274366,274369,0,3,0
78403,4,2,274370,274370,274372,0,2,1
78404,4,3,274374,274374,274377,0,3,2
78405,1,3,274375,274377,274380,2,5,0
78406,3,2,274378,274380,274382,2,4,0
78407,2,2,274380,274382,274384,2,4,0
78408,3,3,274383,274384,274387,1,4,0
78409,5,1,274388,274388,274389,0,1,1
78410,6,1,274394,274394,274395,0,1,5
78411,2,3,274396,274396,274399,0,3,1
78412,1,2,274397,274399,274401,2,4,0
78413,2,2,274399,274401,274403,2,4,0
78414,5,3,274404,274404,274407,0,3,1
78415,6,1,274410,274410,274411,0,1,3
78416,4,2,274414,274414,274416,0,2,3
78417,1,2,274415,274416,274418,1,3,0
78418,6,1,274421,274421,274422,0,1,3
78419,5,1,274426,274426,274427,0,1,4
78420,4,1,274430,274430,274431,0,1,3
78421,1,2,274431,274431,274433,0,2,0
78422,4,1,274435,274435,274436,0,1,2
78423,2,2,274437,274437,274439,0,2,1
78424,3,2,274440,274440,274442,0,2,1
78425,3,2,274443,274443,274445,0,2,1
78426,4,1,274447,274447,274448,0,1,2
78427,5,2,274452,274452,274454,0,2,4
78428,4,3,274456,274456,274459,0,3,2
78429,6,1,274462,274462,274463,0,1,3
78430,2,1,274464,274464,274465,0,1,1
78431,5,1,274469,274469,274470,0,1,4
78432,2,2,274471,274471,274473,0,2,1
78433,3,1,274474,274474,274475,0,1,1
78434,5,2,274479,274479,274481,0,2,4
78435,2,2,274481,274481,274483,0,2,0
78436,3,3,274484,274484,274487,0,3,1
78437,1,2,274485,274487,274489,2,4,0
78438,4,1,274489,274489,274490,0,1,0
78439,2,1,274491,274491,274492,0,1,1
78440,1,3,274492,274492,274495,0,3,0
78441,5,2,274497,274497,274499,0,2,2
78442,5,2,274502,274502,274504,0,2,3
78443,1,1,274503,274504,274505,1,2,0
78444,2,1,274505,274505,274506,0,1,0
78445,5,2,274510,274510,274512,0,2,4
78446,3,1,274513,274513,274514,0,1,1
78447,4,1,274517,274517,274518,0,1,3
78448,2,2,274519,274519,274521,0,2,1
78449,4,2,274523,274523,274525,0,2,2
78450,5,2,274528,274528,274530,0,2,3
78451,3,1,274531,274531,274532,0,1,1
78452,4,3,274535,274535,274538,0,3,3
78453,4,2,274539,274539,274541,0,2,1
78454,5,2,274544,274544,274546,0,2,3
78455,6,3,274550,274550,274553,0,3,4
78456,4,1,274554,274554,274555,0,1,1
78457,5,2,274559,274559,274561,0,2,4
78458,5,3,274564,274564,274567,0,3,3
78459,6,2,274570,274570,274572,0,2,3
78460,3,1,274573,274573,274574,0,1,1
78461,5,2,274578,274578,274580,0,2,4
78462,4,3,274582,274582,274585,0,3,2
78463,2,1,274584,274585,274586,1,2,0
78464,4,1,274588,274588,274589,0,1,2
78465,6,3,274594,274594,274597,0,3,5
78466,6,1,274600,274600,274601,0,1,3
78467,2,3,274602,274602,274605,0,3,1
78468,2,2,274604,274605,274607,1,3,0
78469,4,2,274608,274608,274610,0,2,1
78470,5,1,274613,274613,274614,0,1,3
78471,6,2,274619,274619,274621,0,2,5
78472,5,3,274624,274624,274627,0,3,3
78473,1,1,274625,274627,274628,2,3,0
78474,5,3,274630,274630,274633,0,3,2
78475,6,1,274636,274636,274637,0,1,3
78476,1,1,274637,274637,274638,0,1,0
78477,4,1,274641,274641,274642,0,1,3
78478,2,3,274643,274643,274646,0,3,1
78479,1,1,274644,274646,274647,2,3,0
78480,3,1,274647,274647,274648,0,1,0
78481,4,2,274651,274651,274653,0,2,3
78482,2,1,274653,274653,274654,0,1,0
78483,1,3,274654,274654,274657,0,3,0
78484,2,1,274656,274657,274658,1,2,0
78485,6,3,274662,274662,274665,0,3,4
78486,5,3,274667,274667,274670,0,3,2
78487,1,2,274668,274670,274672,2,4,0
78488,5,1,274673,274673,274674,0,1,1
78489,5,3,274678,274678,274681,0,3,4
78490,5,1,274683,274683,274684,0,1,2
78491,2,1,274685,274685,274686,0,1,1
78492,2,3,274687,274687,274690,0,3,1
78493,1,2,274688,274690,274692,2,4,0
78494,6,3,274694,274694,274697,0,3,2
78495,5,2,274699,274699,274701,0,2,2
78496,3,1,274702,274702,274703,0,1,1
78497,1,1,274703,274703,274704,0,1,0
78498,4,1,274707,274707,274708,0,1,3
78499,4,1,274711,274711,274712,0,1,3
78500,5,1,274716,274716,274717,0,1,4
78501,4,1,274720,274720,274721,0,1,3
78502,3,1,274723,274723,274724,0,1,2
78503,4,1,274727,274727,274728,0,1,3
78504,2,3,274729,274729,274732,0,3,1
78505,1,3,274730,274732,274735,2,5,0
78506,5,1,274735,274735,274736,0,1,0
78507,3,3,274738,274738,274741,0,3,2
78508,5,3,274743,274743,274746,0,3,2
78509,4,1,274747,274747,274748,0,1,1
78510,2,2,274749,274749,274751,0,2,1
78511,2,2,274751,274751,274753,0,2,0
78512,5,1,274756,274756,274757,0,1,3
78513,3,2,274759,274759,274761,0,2,2
78514,1,1,274760,274761,274762,1,2,0
78515,5,3,274765,274765,274768,0,3,3
78516,4,2,274769,274769,274771,0,2,1
78517,1,3,274770,274771,274774,1,4,0
78518,1,2,274771,274774,274776,3,5,0
78519,2,1,274773,274776,274777,3,4,0
78520,4,2,274777,274777,274779,0,2,0
78521,2,3,274779,274779,274782,0,3,0
78522,2,1,274781,274782,274783,1,2,0
78523,2,2,274783,274783,274785,0,2,0
78524,4,3,274787,274787,274790,0,3,2
78525,3,2,274790,274790,274792,0,2,0
78526,3,1,274793,274793,274794,0,1,1
78527,6,1,274799,274799,274800,0,1,5
78528,2,3,274801,274801,274804,0,3,1
78529,2,1,274803,274804,274805,1,2,0
78530,4,2,274807,274807,274809,0,2,2
78531,6,3,274813,274813,274816,0,3,4
78532,1,2,274814,274816,274818,2,4,0
78533,5,1,274819,274819,274820,0,1,1
78534,2,2,274821,274821,274823,0,2,1
78535,2,3,274823,274823,274826,0,3,0
78536,3,1,274826,274826,274827,0,1,0
78537,2,1,274828,274828,274829,0,1,1
78538,3,1,274831,274831,274832,0,1,2
78539,4,1,274835,274835,274836,0,1,3
78540,5,3,274840,274840,274843,0,3,4
78541,3,2,274843,274843,274845,0,2,0
78542,1,2,274844,274845,274847,1,3,0
78543,6,2,274850,274850,274852,0,2,3
78544,3,2,274853,274853,274855,0,2,1
78545,2,2,274855,274855,274857,0,2,0
78546,3,3,274858,274858,274861,0,3,1
78547,3,2,274861,274861,274863,0,2,0
78548,1,2,274862,274863,274865,1,3,0
78549,1,3,274863,274865,274868,2,5,0
78550,3,2,274866,274868,274870,2,4,0
78551,5,1,274871,274871,274872,0,1,1
78552,6,1,274877,274877,274878,0,1,5
78553,1,1,274878,274878,274879,0,1,0
78554,5,3,274883,274883,274886,0,3,4
78555,6,2,274889,274889,274891,0,2,3
78556,5,1,274894,274894,274895,0,1,3
78557,3,1,274897,274897,274898,0,1,2
78558,2,1,274899,274899,274900,0,1,1
78559,6,2,274905,274905,274907,0,2,5
78560,5,3,274910,274910,274913,0,3,3
78561,3,3,274913,274913,274916,0,3,0
78562,1,3,274914,274916,274919,2,5,0
78563,3,2,274917,274919,274921,2,4,0
78564,1,1,274918,274921,274922,3,4,0
78565,1,1,274919,274922,274923,3,4,0
78566,1,3,274920,274923,274926,3,6,0
78567,3,1,274923,274926,274927,3,4,0
78568,1,1,274924,274927,274928,3,4,0
78569,6,3,274930,274930,274933,0,3,2
78570,1,2,274931,274933,274935,2,4,0
78571,5,2,274936,274936,274938,0,2,1
78572,2,2,274938,274938,274940,0,2,0
78573,6,1,274944,274944,274945,0,1,4
78574,6,2,274950,274950,274952,0,2,5
78575,3,1,274953,274953,274954,0,1,1
78576,2,2,274955,274955,274957,0,2,1
78577,4,1,274959,274959,274960,0,1,2
78578,3,1,274962,274962,274963,0,1,2
78579,3,3,274965,274965,274968,0,3,2
78580,3,2,274968,274968,274970,0,2,0
78581,5,1,274973,274973,274974,0,1,3
78582,5,2,274978,274978,274980,0,2,4
78583,4,2,274982,274982,274984,0,2,2
78584,1,2,274983,274984,274986,1,3,0
78585,2,2,274985,274986,274988,1,3,0
78586,5,2,274990,274990,274992,0,2,2
78587,2,2,274992,274992,274994,0,2,0
78588,4,3,274996,274996,274999,0,3,2
78589,3,1,274999,274999,275000,0,1,0
78590,1,1,275000,275000,275001,0,1,0
78591,2,3,275002,275002,275005,0,3,1
78592,4,2,275006,275006,275008,0,2,1
78593,2,3,275008,275008,275011,0,3,0
78594,4,1,275012,275012,275013,0,1,1
78595,2,1,275014,275014,275015,0,1,1
78596,6,3,275020,275020,275023,0,3,5
78597,4,2,275024,275024,275026,0,2,1
78598,4,2,275028,275028,275030,0,2,2
78599,1,3,275029,275030,275033,1,4,0
78600,6,2,275035,275035,275037,0,2,2
78601,6,3,275041,275041,275044,0,3,4
78602,6,2,275047,275047,275049,0,2,3
78603,6,1,275053,275053,275054,0,1,4
78604,6,3,275059,275059,275062,0,3,5
78605,5,1,275064,275064,275065,0,1,2
78606,4,1,275068,275068,275069,0,1,3
78607,5,1,275073,275073,275074,0,1,4
78608,2,3,275075,275075,275078,0,3,1
78609,5,2,275080,275080,275082,0,2,2
78610,4,1,275084,275084,275085,0,1,2
78611,4,3,275088,275088,275091,0,3,3
78612,1,3,275089,275091,275094,2,5,0
78613,5,2,275094,275094,275096,0,2,0
78614,4,3,275098,275098,275101,0,3,2
78615,6,1,275104,275104,275105,0,1,3
78616,6,1,275110,275110,275111,0,1,5
78617,4,2,275114,275114,275116,0,2,3
78618,4,2,275118,275118,275120,0,2,2
78619,3,3,275121,275121,275124,0,3,1
78620,1,1,275122,275124,275125,2,3,0
78621,6,3,275128,275128,275131,0,3,3
78622,6,2,275134,275134,275136,0,2,3
78623,4,3,275138,275138,275141,0,3,2
78624,2,1,275140,275141,275142,1,2,0
78625,1,3,275141,275142,275145,1,4,0
78626,1,2,275142,275145,275147,3,5,0
78627,6,1,275148,275148,275149,0,1,1
78628,1,2,275149,275149,275151,0,2,0
78629,1,1,275150,275151,275152,1,2,0
78630,1,2,275151,275152,275154,1,3,0
78631,5,3,275156,275156,275159,0,3,2
78632,3,3,275159,275159,275162,0,3,0
78633,3,2,275162,275162,275164,0,2,0
78634,2,1,275164,275164,275165,0,1,0
78635,5,3,275169,275169,275172,0,3,4
78636,1,1,275170,275172,275173,2,3,0
78637,3,1,275173,275173,275174,0,1,0
78638,4,3,275177,275177,275180,0,3,3
78639,2,1,275179,275180,275181,1,2,0
78640,3,3,275182,275182,275185,0,3,1
78641,6,2,275188,275188,275190,0,2,3
78642,5,1,275193,275193,275194,0,1,3
78643,1,1,275194,275194,275195,0,1,0
78644,4,3,275198,275198,275201,0,3,3
78645,5,2,275203,275203,275205,0,2,2
78646,3,1,275206,275206,275207,0,1,1
78647,3,2,275209,275209,275211,0,2,2
78648,4,2,275213,275213,275215,0,2,2
78649,1,2,275214,275215,275217,1,3,0
78650,6,1,275220,275220,275221,0,1,3
78651,6,2,275226,275226,275228,0,2,5
78652,6,3,275232,275232,275235,0,3,4
78653,3,2,275235,275235,275237,0,2,0
78654,1,1,275236,275237,275238,1,2,0
78655,5,1,275241,275241,275242,0,1,3
78656,4,2,275245,275245,275247,0,2,3
78657,5,2,275250,275250,275252,0,2,3
78658,5,1,275255,275255,275256,0,1,3
78659,2,2,275257,275257,275259,0,2,1
78660,6,3,275263,275263,275266,0,3,4
78661,6,1,275269,275269,275270,0,1,3
78662,3,1,275272,275272,275273,0,1,2
78663,1,1,275273,275273,275274,0,1,0
78664,2,2,275275,275275,275277,0,2,1
78665,4,3,275279,275279,275282,0,3,2
78666,5,3,275284,275284,275287,0,3,2
78667,5,1,275289,275289,275290,0,1,2
78668,6,3,275295,275295,275298,0,3,5
78669,1,1,275296,275298,275299,2,3,0
78670,2,3,275298,275299,275302,1,4,0
78671,5,3,275303,275303,275306,0,3,1
78672,6,3,275309,275309,275312,0,3,3
78673,1,3,275310,275312,275315,2,5,0
78674,3,2,275313,275315,275317,2,4,0
78675,4,3,275317,275317,275320,0,3,0
78676,5,2,275322,275322,275324,0,2,2
78677,6,2,275328,275328,275330,0,2,4
78678,1,3,275329,275330,275333,1,4,0
78679,1,1,275330,275333,275334,3,4,0
78680,4,3,275334,275334,275337,0,3,0
78681,4,1,275338,275338,275339,0,1,1
78682,3,3,275341,275341,275344,0,3,2
78683,5,2,275346,275346,275348,0,2,2
78684,4,2,275350,275350,275352,0,2,2
78685,3,3,275353,275353,275356,0,3,1
78686,1,3,275354,275356,275359,2,5,0
78687,6,3,275360,275360,275363,0,3,1
78688,2,3,275362,275363,275366,1,4,0
78689,5,3,275367,275367,275370,0,3,1
78690,6,3,275373,275373,275376,0,3,3
78691,4,1,275377,275377,275378,0,1,1
78692,3,3,275380,275380,275383,0,3,2
78693,2,3,275382,275383,275386,1,4,0
78694,2,3,275384,275386,275389,2,5,0
78695,2,3,275386,275389,275392,3,6,0
78696,6,3,275392,275392,275395,0,3,0
78697,5,3,275397,275397,275400,0,3,2
78698,1,1,275398,275400,275401,2,3,0
78699,2,2,275400,275401,275403,1,3,0
78700,6,3,275406,275406,275409,0,3,3
78701,3,2,275409,275409,275411,0,2,0
78702,4,2,275413,275413,275415,0,2,2
78703,6,1,275419,275419,275420,0,1,4
78704,6,1,275425,275425,275426,0,1,5
78705,1,3,275426,275426,275429,0,3,0
78706,1,3,275427,275429,275432,2,5,0
78707,1,2,275428,275432,275434,4,6,0
78708,4,1,275432,275434,275435,2,3,0
78709,1,2,275433,275435,275437,2,4,0
78710,2,2,275435,275437,275439,2,4,0
78711,5,3,275440,275440,275443,0,3,1
78712,4,1,275444,275444,275445,0,1,1
78713,4,2,275448,275448,275450,0,2,3
78714,2,2,275450,275450,275452,0,2,0
78715,3,2,275453,275453,275455,0,2,1
78716,1,3,275454,275455,275458,1,4,0
78717,2,2,275456,275458,275460,2,4,0
78718,4,3,275460,275460,275463,0,3,0
78719,3,3,275463,275463,275466,0,3,0
78720,6,2,275469,275469,275471,0,2,3
78721,6,1,275475,275475,275476,0,1,4
78722,4,3,275479,275479,275482,0,3,3
78723,2,2,275481,275482,275484,1,3,0
78724,1,3,275482,275484,275487,2,5,0
78725,3,1,275485,275487,275488,2,3,0
78726,5,1,275490,275490,275491,0,1,2
78727,2,2,275492,275492,275494,0,2,1
78728,2,2,275494,275494,275496,0,2,0
78729,3,3,275497,275497,275500,0,3,1
78730,1,2,275498,275500,275502,2,4,0
78731,4,2,275502,275502,275504,0,2,0
78732,4,2,275506,275506,275508,0,2,2
78733,2,1,275508,275508,275509,0,1,0
78734,2,3,275510,275510,275513,0,3,1
78735,1,2,275511,275513,275515,2,4,0
78736,2,1,275513,275515,275516,2,3,0
78737,2,2,275515,275516,275518,1,3,0
78738,5,2,275520,275520,275522,0,2,2
78739,2,2,275522,275522,275524,0,2,0
78740,1,2,275523,275524,275526,1,3,0
78741,3,1,275526,275526,275527,0,1,0
78742,4,1,275530,275530,275531,0,1,3
78743,5,2,275535,275535,275537,0,2,4
78744,6,3,275541,275541,275544,0,3,4
78745,1,1,275542,275544,275545,2,3,0
78746,3,2,275545,275545,275547,0,2,0
78747,2,3,275547,275547,275550,0,3,0
78748,6,2,275553,275553,275555,0,2,3
78749,1,2,275554,275555,275557,1,3,0
78750,3,3,275557,275557,275560,0,3,0
78751,6,2,275563,275563,275565,0,2,3
78752,3,2,275566,275566,275568,0,2,1
78753,5,2,275571,275571,275573,0,2,3
78754,2,1,275573,275573,275574,0,1,0
78755,6,1,275579,275579,275580,0,1,5
78756,4,2,275583,275583,275585,0,2,3
78757,5,1,275588,275588,275589,0,1,3
78758,1,3,275589,275589,275592,0,3,0
78759,4,3,275593,275593,275596,0,3,1
78760,2,1,275595,275596,275597,1,2,0
78761,5,3,275600,275600,275603,0,3,3
78762,5,2,275605,275605,275607,0,2,2
78763,4,3,275609,275609,275612,0,3,2
78764,1,1,275610,275612,275613,2,3,0
78765,4,3,275614,275614,275617,0,3,1
78766,3,3,275617,275617,275620,0,3,0
78767,3,3,275620,275620,275623,0,3,0
78768,5,2,275625,275625,275627,0,2,2
78769,4,1,275629,275629,275630,0,1,2
78770,1,2,275630,275630,275632,0,2,0
78771,2,2,275632,275632,275634,0,2,0
78772,2,1,275634,275634,275635,0,1,0
78773,4,3,275638,275638,275641,0,3,3
78774,3,2,275641,275641,275643,0,2,0
78775,2,3,275643,275643,275646,0,3,0
78776,3,3,275646,275646,275649,0,3,0
78777,4,1,275650,275650,275651,0,1,1
78778,1,3,275651,275651,275654,0,3,0
78779,3,2,275654,275654,275656,0,2,0
78780,5,2,275659,275659,275661,0,2,3
78781,4,2,275663,275663,275665,0,2,2
78782,5,3,275668,275668,275671,0,3,3
78783,4,3,275672,275672,275675,0,3,1
78784,3,1,275675,275675,275676,0,1,0
78785,3,3,275678,275678,275681,0,3,2
78786,6,2,275684,275684,275686,0,2,3
78787,1,1,275685,275686,275687,1,2,0
78788,2,2,275687,275687,275689,0,2,0
78789,4,2,275691,275691,275693,0,2,2
78790,2,1,275693,275693,275694,0,1,0
78791,4,3,275697,275697,275700,0,3,3
78792,5,2,275702,275702,275704,0,2,2
78793,3,2,275705,275705,275707,0,2,1
78794,2,1,275707,275707,275708,0,1,0
78795,2,2,275709,275709,275711,0,2,1
78796,2,2,275711,275711,275713,0,2,0
78797,5,1,275716,275716,275717,0,1,3
78798,1,3,275717,275717,275720,0,3,0
78799,4,2,275721,275721,275723,0,2,1
78800,5,1,275726,275726,275727,0,1,3
78801,5,3,275731,275731,275734,0,3,4
78802,2,1,275733,275734,275735,1,2,0
78803,2,1,275735,275735,275736,0,1,0
78804,2,3,275737,275737,275740,0,3,1
78805,2,3,275739,275740,275743,1,4,0
78806,2,2,275741,275743,275745,2,4,0
78807,5,3,275746,275746,275749,0,3,1
78808,6,1,275752,275752,275753,0,1,3
78809,2,2,275754,275754,275756,0,2,1
78810,5,1,275759,275759,275760,0,1,3
78811,2,1,275761,275761,275762,0,1,1
78812,2,2,275763,275763,275765,0,2,1
78813,3,3,275766,275766,275769,0,3,1
78814,1,1,275767,275769,275770,2,3,0
78815,1,3,275768,275770,275773,2,5,0
78816,6,3,275774,275774,275777,0,3,1
78817,4,1,275778,275778,275779,0,1,1
78818,3,2,275781,275781,275783,0,2,2
78819,1,3,275782,275783,275786,1,4,0
78820,2,1,275784,275786,275787,2,3,0
78821,3,2,275787,275787,275789,0,2,0
78822,4,1,275791,275791,275792,0,1,2
78823,2,3,275793,275793,275796,0,3,1
78824,5,1,275798,275798,275799,0,1,2
78825,6,3,275804,275804,275807,0,3,5
78826,3,1,275807,275807,275808,0,1,0
78827,6,1,275813,275813,275814,0,1,5
78828,2,2,275815,275815,275817,0,2,1
78829,1,1,275816,275817,275818,1,2,0
78830,6,3,275822,275822,275825,0,3,4
78831,2,2,275824,275825,275827,1,3,0
78832,3,1,275827,275827,275828,0,1,0
78833,6,3,275833,275833,275836,0,3,5
78834,3,2,275836,275836,275838,0,2,0
78835,3,2,275839,275839,275841,0,2,1
78836,6,2,275845,275845,275847,0,2,4
78837,3,2,275848,275848,275850,0,2,1
78838,6,2,275854,275854,275856,0,2,4
78839,6,2,275860,275860,275862,0,2,4
78840,3,1,275863,275863,275864,0,1,1
78841,6,3,275869,275869,275872,0,3,5
78842,1,3,275870,275872,275875,2,5,0
78843,6,3,275876,275876,275879,0,3,1
78844,4,1,275880,275880,275881,0,1,1
78845,2,3,275882,275882,275885,0,3,1
78846,2,3,275884,275885,275888,1,4,0
78847,5,1,275889,275889,275890,0,1,1
78848,4,1,275893,275893,275894,0,1,3
78849,2,2,275895,275895,275897,0,2,1
78850,1,3,275896,275897,275900,1,4,0
78851,3,1,275899,275900,275901,1,2,0
78852,1,2,275900,275901,275903,1,3,0
78853,6,2,275906,275906,275908,0,2,3
78854,5,1,275911,275911,275912,0,1,3
78855,1,3,275912,275912,275915,0,3,0
78856,1,2,275913,275915,275917,2,4,0
78857,1,2,275914,275917,275919,3,5,0
78858,1,1,275915,275919,275920,4,5,0
78859,2,3,275917,275920,275923,3,6,0
78860,3,1,275920,275923,275924,3,4,0
78861,1,3,275921,275924,275927,3,6,0
78862,4,2,275925,275927,275929,2,4,0
78863,1,2,275926,275929,275931,3,5,0
78864,4,3,275930,275931,275934,1,4,0
78865,1,2,275931,275934,275936,3,5,0
78866,1,2,275932,275936,275938,4,6,0
78867,4,1,275936,275938,275939,2,3,0
78868,1,1,275937,275939,275940,2,3,0
78869,3,1,275940,275940,275941,0,1,0
78870,1,2,275941,275941,275943,0,2,0
78871,5,1,275946,275946,275947,0,1,3
78872,6,1,275952,275952,275953,0,1,5
78873,2,1,275954,275954,275955,0,1,1
78874,5,2,275959,275959,275961,0,2,4
78875,3,3,275962,275962,275965,0,3,1
78876,5,2,275967,275967,275969,0,2,2
78877,5,1,275972,275972,275973,0,1,3
78878,5,3,275977,275977,275980,0,3,4
78879,5,1,275982,275982,275983,0,1,2
78880,4,2,275986,275986,275988,0,2,3
78881,6,2,275992,275992,275994,0,2,4
78882,4,2,275996,275996,275998,0,2,2
78883,2,1,275998,275998,275999,0,1,0
78884,4,1,276002,276002,276003,0,1,3
78885,4,2,276006,276006,276008,0,2,3
78886,3,1,276009,276009,276010,0,1,1
78887,4,2,276013,276013,276015,0,2,3
78888,1,1,276014,276015,276016,1,2,0
78889,4,2,276018,276018,276020,0,2,2
78890,5,1,276023,276023,276024,0,1,3
78891,6,1,276029,276029,276030,0,1,5
78892,5,1,276034,276034,276035,0,1,4
78893,4,3,276038,276038,276041,0,3,3
78894,4,1,276042,276042,276043,0,1,1
78895,5,1,276047,276047,276048,0,1,4
78896,3,1,276050,276050,276051,0,1,2
78897,4,3,276054,276054,276057,0,3,3
78898,3,3,276057,276057,276060,0,3,0
78899,5,3,276062,276062,276065,0,3,2
78900,3,2,276065,276065,276067,0,2,0
78901,4,2,276069,276069,276071,0,2,2
78902,4,1,276073,276073,276074,0,1,2
78903,6,2,276079,276079,276081,0,2,5
78904,3,3,276082,276082,276085,0,3,1
78905,5,2,276087,276087,276089,0,2,2
78906,3,2,276090,276090,276092,0,2,1
78907,2,3,276092,276092,276095,0,3,0
78908,3,1,276095,276095,276096,0,1,0
78909,2,1,276097,276097,276098,0,1,1
78910,2,1,276099,276099,276100,0,1,1
78911,5,3,276104,276104,276107,0,3,4
78912,4,1,276108,276108,276109,0,1,1
78913,3,1,276111,276111,276112,0,1,2
78914,5,1,276116,276116,276117,0,1,4
78915,2,1,276118,276118,276119,0,1,1
78916,3,3,276121,276121,276124,0,3,2
78917,6,2,276127,276127,276129,0,2,3
78918,2,3,276129,276129,276132,0,3,0
78919,3,1,276132,276132,276133,0,1,0
78920,1,3,276133,276133,276136,0,3,0
78921,5,3,276138,276138,276141,0,3,2
78922,4,2,276142,276142,276144,0,2,1
78923,5,1,276147,276147,276148,0,1,3
78924,3,2,276150,276150,276152,0,2,2
78925,2,3,276152,276152,276155,0,3,0
78926,3,1,276155,276155,276156,0,1,0
78927,6,2,276161,276161,276163,0,2,5
78928,3,1,276164,276164,276165,0,1,1
78929,6,1,276170,276170,276171,0,1,5
78930,5,3,276175,276175,276178,0,3,4
78931,2,2,276177,276178,276180,1,3,0
78932,5,2,276182,276182,276184,0,2,2
78933,3,2,276185,276185,276187,0,2,1
78934,3,2,276188,276188,276190,0,2,1
78935,4,1,276192,276192,276193,0,1,2
78936,3,1,276195,276195,276196,0,1,2
78937,3,2,276198,276198,276200,0,2,2
78938,5,2,276203,276203,276205,0,2,3
78939,2,3,276205,276205,276208,0,3,0
78940,5,3,276210,276210,276213,0,3,2
78941,4,2,276214,276214,276216,0,2,1
78942,3,3,276217,276217,276220,0,3,1
78943,4,2,276221,276221,276223,0,2,1
78944,4,2,276225,276225,276227,0,2,2
78945,4,2,276229,276229,276231,0,2,2
78946,1,2,276230,276231,276233,1,3,0
78947,3,3,276233,276233,276236,0,3,0
78948,6,2,276239,276239,276241,0,2,3
78949,3,3,276242,276242,276245,0,3,1
78950,4,2,276246,276246,276248,0,2,1
78951,5,3,276251,276251,276254,0,3,3
78952,1,3,276252,276254,276257,2,5,0
78953,4,1,276256,276257,276258,1,2,0
78954,1,1,276257,276258,276259,1,2,0
78955,4,3,276261,276261,276264,0,3,2
78956,5,3,276266,276266,276269,0,3,2
78957,2,1,276268,276269,276270,1,2,0
78958,2,3,276270,276270,276273,0,3,0
78959,2,1,276272,276273,276274,1,2,0
78960,3,2,276275,276275,276277,0,2,1
78961,6,3,276281,276281,276284,0,3,4
78962,1,1,276282,276284,276285,2,3,0
78963,3,2,276285,276285,276287,0,2,0
78964,2,3,276287,276287,276290,0,3,0
78965,5,2,276292,276292,276294,0,2,2
78966,3,3,276295,276295,276298,0,3,1
78967,3,3,276298,276298,276301,0,3,0
78968,4,2,276302,276302,276304,0,2,1
78969,2,1,276304,276304,276305,0,1,0
78970,1,2,276305,276305,276307,0,2,0
78971,1,2,276306,276307,276309,1,3,0
78972,1,2,276307,276309,276311,2,4,0
78973,2,1,276309,276311,276312,2,3,0
78974,5,2,276314,276314,276316,0,2,2
78975,1,3,276315,276316,276319,1,4,0
78976,3,2,276318,276319,276321,1,3,0
78977,2,1,276320,276321,276322,1,2,0
78978,6,3,276326,276326,276329,0,3,4
78979,5,2,276331,276331,276333,0,2,2
78980,6,1,276337,276337,276338,0,1,4
78981,3,3,276340,276340,276343,0,3,2
78982,3,2,276343,276343,276345,0,2,0
78983,2,1,276345,276345,276346,0,1,0
78984,3,1,276348,276348,276349,0,1,2
78985,5,1,276353,276353,276354,0,1,4
78986,1,1,276354,276354,276355,0,1,0
78987,3,2,276357,276357,276359,0,2,2
78988,1,1,276358,276359,276360,1,2,0
78989,3,1,276361,276361,276362,0,1,1
78990,1,3,276362,276362,276365,0,3,0
78991,4,3,276366,276366,276369,0,3,1
78992,4,2,276370,276370,276372,0,2,1
78993,4,3,276374,276374,276377,0,3,2
78994,2,2,276376,276377,276379,1,3,0
78995,2,3,276378,276379,276382,1,4,0
78996,1,2,276379,276382,276384,3,5,0
78997,3,1,276382,276384,276385,2,3,0
78998,6,2,276388,276388,276390,0,2,3
78999,2,1,276390,276390,276391,0,1,0
79000,4,3,276394,276394,276397,0,3,3
79001,3,1,276397,276397,276398,0,1,0
79002,5,3,276402,276402,276405,0,3,4
79003,6,3,276408,276408,276411,0,3,3
79004,2,2,276410,276411,276413,1,3,0
79005,1,3,276411,276413,276416,2,5,0
79006,4,3,276415,276416,276419,1,4,0
79007,2,2,276417,276419,276421,2,4,0
79008,3,1,276420,276421,276422,1,2,0
79009,1,3,276421,276422,276425,1,4,0
79010,3,1,276424,276425,276426,1,2,0
79011,2,2,276426,276426,276428,0,2,0
79012,5,2,276431,276431,276433,0,2,3
79013,3,3,276434,276434,276437,0,3,1
79014,2,2,276436,276437,276439,1,3,0
79015,2,1,276438,276439,276440,1,2,0
79016,3,2,276441,276441,276443,0,2,1
79017,2,1,276443,276443,276444,0,1,0
79018,5,2,276448,276448,276450,0,2,4
79019,1,2,276449,276450,276452,1,3,0
79020,6,3,276455,276455,276458,0,3,3
79021,1,3,276456,276458,276461,2,5,0
79022,2,1,276458,276461,276462,3,4,0
79023,1,1,276459,276462,276463,3,4,0
79024,2,1,276461,276463,276464,2,3,0
79025,3,1,276464,276464,276465,0,1,0
79026,2,2,276466,276466,276468,0,2,1
79027,4,2,276470,276470,276472,0,2,2
79028,4,2,276474,276474,276476,0,2,2
79029,4,1,276478,276478,276479,0,1,2
79030,6,1,276484,276484,276485,0,1,5
79031,1,3,276485,276485,276488,0,3,0
79032,1,2,276486,276488,276490,2,4,0
79033,2,1,276488,276490,276491,2,3,0
79034,2,3,276490,276491,276494,1,4,0
79035,1,3,276491,276494,276497,3,6,0
79036,4,2,276495,276497,276499,2,4,0
79037,3,2,276498,276499,276501,1,3,0
79038,4,2,276502,276502,276504,0,2,1
79039,2,2,276504,276504,276506,0,2,0
79040,3,2,276507,276507,276509,0,2,1
79041,3,2,276510,276510,276512,0,2,1
79042,6,1,276516,276516,276517,0,1,4
79043,3,2,276519,276519,276521,0,2,2
79044,1,2,276520,276521,276523,1,3,0
79045,3,1,276523,276523,276524,0,1,0
79046,3,1,276526,276526,276527,0,1,2
79047,3,3,276529,276529,276532,0,3,2
79048,5,3,276534,276534,276537,0,3,2
79049,3,2,276537,276537,276539,0,2,0
79050,3,3,276540,276540,276543,0,3,1
79051,6,3,276546,276546,276549,0,3,3
79052,6,3,276552,276552,276555,0,3,3
79053,4,3,276556,276556,276559,0,3,1
79054,2,3,276558,276559,276562,1,4,0
79055,5,2,276563,276563,276565,0,2,1
79056,4,3,276567,276567,276570,0,3,2
79057,5,2,276572,276572,276574,0,2,2
79058,3,3,276575,276575,276578,0,3,1
79059,4,1,276579,276579,276580,0,1,1
79060,5,2,276584,276584,276586,0,2,4
79061,2,3,276586,276586,276589,0,3,0
79062,3,2,276589,276589,276591,0,2,0
79063,2,2,276591,276591,276593,0,2,0
79064,1,1,276592,276593,276594,1,2,0
79065,6,1,276598,276598,276599,0,1,4
79066,6,2,276604,276604,276606,0,2,5
79067,2,3,276606,276606,276609,0,3,0
79068,4,3,276610,276610,276613,0,3,1
79069,6,3,276616,276616,276619,0,3,3
79070,3,1,276619,276619,276620,0,1,0
79071,6,1,276625,276625,276626,0,1,5
79072,5,2,276630,276630,276632,0,2,4
79073,3,2,276633,276633,276635,0,2,1
79074,2,1,276635,276635,276636,0,1,0
79075,2,1,276637,276637,276638,0,1,1
79076,2,2,276639,276639,276641,0,2,1
79077,2,3,276641,276641,276644,0,3,0
79078,3,2,276644,276644,276646,0,2,0
79079,1,2,276645,276646,276648,1,3,0
79080,5,1,276650,276650,276651,0,1,2
79081,2,2,276652,276652,276654,0,2,1
79082,3,3,276655,276655,276658,0,3,1
79083,2,3,276657,276658,276661,1,4,0
79084,5,1,276662,276662,276663,0,1,1
79085,4,2,276666,276666,276668,0,2,3
79086,5,1,276671,276671,276672,0,1,3
79087,6,3,276677,276677,276680,0,3,5
79088,2,3,276679,276680,276683,1,4,0
79089,5,3,276684,276684,276687,0,3,1
79090,6,3,276690,276690,276693,0,3,3
79091,2,1,276692,276693,276694,1,2,0
79092,4,2,276696,276696,276698,0,2,2
79093,2,3,276698,276698,276701,0,3,0
79094,1,2,276699,276701,276703,2,4,0
79095,4,2,276703,276703,276705,0,2,0
79096,1,3,276704,276705,276708,1,4,0
79097,5,3,276709,276709,276712,0,3,1
79098,5,3,276714,276714,276717,0,3,2
79099,5,1,276719,276719,276720,0,1,2
79100,3,2,276722,276722,276724,0,2,2
79101,4,1,276726,276726,276727,0,1,2
79102,1,3,276727,276727,276730,0,3,0
79103,6,1,276733,276733,276734,0,1,3
79104,3,3,276736,276736,276739,0,3,2
79105,4,3,276740,276740,276743,0,3,1
79106,5,3,276745,276745,276748,0,3,2
79107,4,1,276749,276749,276750,0,1,1
79108,5,1,276754,276754,276755,0,1,4
79109,5,3,276759,276759,276762,0,3,4
79110,5,1,276764,276764,276765,0,1,2
79111,1,1,276765,276765,276766,0,1,0
79112,3,3,276768,276768,276771,0,3,2
79113,1,3,276769,276771,276774,2,5,0
79114,5,2,276774,276774,276776,0,2,0
79115,6,3,276780,276780,276783,0,3,4
79116,6,2,276786,276786,276788,0,2,3
79117,2,1,276788,276788,276789,0,1,0
79118,4,1,276792,276792,276793,0,1,3
79119,3,2,276795,276795,276797,0,2,2
79120,6,3,276801,276801,276804,0,3,4
79121,3,2,276804,276804,276806,0,2,0
79122,2,2,276806,276806,276808,0,2,0
79123,3,3,276809,276809,276812,0,3,1
79124,1,2,276810,276812,276814,2,4,0
79125,4,2,276814,276814,276816,0,2,0
79126,6,1,276820,276820,276821,0,1,4
79127,6,3,276826,276826,276829,0,3,5
79128,2,2,276828,276829,276831,1,3,0
79129,4,2,276832,276832,276834,0,2,1
79130,1,1,276833,276834,276835,1,2,0
79131,5,3,276838,276838,276841,0,3,3
79132,5,3,276843,276843,276846,0,3,2
79133,5,2,276848,276848,276850,0,2,2
79134,6,1,276854,276854,276855,0,1,4
79135,5,1,276859,276859,276860,0,1,4
79136,4,1,276863,276863,276864,0,1,3
79137,2,2,276865,276865,276867,0,2,1
79138,6,2,276871,276871,276873,0,2,4
79139,6,1,276877,276877,276878,0,1,4
79140,3,2,276880,276880,276882,0,2,2
79141,4,2,276884,276884,276886,0,2,2
79142,4,3,276888,276888,276891,0,3,2
79143,1,3,276889,276891,276894,2,5,0
79144,1,3,276890,276894,276897,4,7,0
79145,3,1,276893,276897,276898,4,5,0
79146,2,1,276895,276898,276899,3,4,0
79147,6,2,276901,276901,276903,0,2,2
79148,3,2,276904,276904,276906,0,2,1
79149,5,2,276909,276909,276911,0,2,3
79150,3,1,276912,276912,276913,0,1,1
79151,2,3,276914,276914,276917,0,3,1
79152,2,2,276916,276917,276919,1,3,0
79153,6,1,276922,276922,276923,0,1,3
79154,1,3,276923,276923,276926,0,3,0
79155,3,1,276926,276926,276927,0,1,0
79156,3,1,276929,276929,276930,0,1,2
79157,3,3,276932,276932,276935,0,3,2
79158,5,3,276937,276937,276940,0,3,2
79159,6,3,276943,276943,276946,0,3,3
79160,6,2,276949,276949,276951,0,2,3
79161,4,2,276953,276953,276955,0,2,2
79162,6,3,276959,276959,276962,0,3,4
79163,5,3,276964,276964,276967,0,3,2
79164,2,1,276966,276967,276968,1,2,0
79165,3,3,276969,276969,276972,0,3,1
79166,1,3,276970,276972,276975,2,5,0
79167,3,2,276973,276975,276977,2,4,0
79168,2,1,276975,276977,276978,2,3,0
79169,2,1,276977,276978,276979,1,2,0
79170,1,3,276978,276979,276982,1,4,0
79171,1,1,276979,276982,276983,3,4,0
79172,4,3,276983,276983,276986,0,3,0
79173,4,3,276987,276987,276990,0,3,1
79174,4,3,276991,276991,276994,0,3,1
79175,5,3,276996,276996,276999,0,3,2
79176,5,2,277001,277001,277003,0,2,2
79177,4,2,277005,277005,277007,0,2,2
79178,6,2,277011,277011,277013,0,2,4
79179,3,3,277014,277014,277017,0,3,1
79180,3,2,277017,277017,277019,0,2,0
79181,4,3,277021,277021,277024,0,3,2
79182,5,1,277026,277026,277027,0,1,2
79183,1,1,277027,277027,277028,0,1,0
79184,6,3,277033,277033,277036,0,3,5
79185,3,3,277036,277036,277039,0,3,0
79186,4,2,277040,277040,277042,0,2,1
79187,5,2,277045,277045,277047,0,2,3
79188,4,2,277049,277049,277051,0,2,2
79189,2,3,277051,277051,277054,0,3,0
79190,3,3,277054,277054,277057,0,3,0
79191,4,3,277058,277058,277061,0,3,1
79192,3,1,277061,277061,277062,0,1,0
79193,5,1,277066,277066,277067,0,1,4
79194,6,3,277072,277072,277075,0,3,5
79195,6,1,277078,277078,277079,0,1,3
79196,1,3,277079,277079,277082,0,3,0
79197,6,3,277085,277085,277088,0,3,3
79198,4,1,277089,277089,277090,0,1,1
79199,6,2,277095,277095,277097,0,2,5
79200,3,1,277098,277098,277099,0,1,1
79201,5,2,277103,277103,277105,0,2,4
79202,2,2,277105,277105,277107,0,2,0
79203,4,3,277109,277109,277112,0,3,2
79204,2,1,277111,277112,277113,1,2,0
79205,5,3,277116,277116,277119,0,3,3
79206,4,2,277120,277120,277122,0,2,1
79207,2,3,277122,277122,277125,0,3,0
79208,3,1,277125,277125,277126,0,1,0
79209,4,2,277129,277129,277131,0,2,3
79210,4,3,277133,277133,277136,0,3,2
79211,4,3,277137,277137,277140,0,3,1
79212,1,1,277138,277140,277141,2,3,0
79213,4,1,277142,277142,277143,0,1,1
79214,2,2,277144,277144,277146,0,2,1
79215,3,2,277147,277147,277149,0,2,1
79216,5,3,277152,277152,277155,0,3,3
79217,2,3,277154,277155,277158,1,4,0
79218,4,3,277158,277158,277161,0,3,0
79219,5,3,277163,277163,277166,0,3,2
79220,4,2,277167,277167,277169,0,2,1
79221,5,3,277172,277172,277175,0,3,3
79222,4,2,277176,277176,277178,0,2,1
79223,5,3,277181,277181,277184,0,3,3
79224,6,2,277187,277187,277189,0,2,3
79225,3,2,277190,277190,277192,0,2,1
79226,1,1,277191,277192,277193,1,2,0
79227,3,2,277194,277194,277196,0,2,1
79228,1,2,277195,277196,277198,1,3,0
79229,1,2,277196,277198,277200,2,4,0
79230,3,3,277199,277200,277203,1,4,0
79231,6,2,277205,277205,277207,0,2,2
79232,5,2,277210,277210,277212,0,2,3
79233,1,3,277211,277212,277215,1,4,0
79234,5,2,277216,277216,277218,0,2,1
79235,5,1,277221,277221,277222,0,1,3
79236,4,3,277225,277225,277228,0,3,3
79237,3,2,277228,277228,277230,0,2,0
79238,5,2,277233,277233,277235,0,2,3
79239,4,3,277237,277237,277240,0,3,2
79240,1,2,277238,277240,277242,2,4,0
79241,4,1,277242,277242,277243,0,1,0
79242,2,2,277244,277244,277246,0,2,1
79243,6,1,277250,277250,277251,0,1,4
79244,4,3,277254,277254,277257,0,3,3
79245,2,3,277256,277257,277260,1,4,0
79246,3,1,277259,277260,277261,1,2,0
79247,6,3,277265,277265,277268,0,3,4
79248,5,3,277270,277270,277273,0,3,2
79249,1,2,277271,277273,277275,2,4,0
79250,2,3,277273,277275,277278,2,5,0
79251,6,3,277279,277279,277282,0,3,1
79252,4,1,277283,277283,277284,0,1,1
79253,4,1,277287,277287,277288,0,1,3
79254,5,3,277292,277292,277295,0,3,4
79255,4,1,277296,277296,277297,0,1,1
79256,3,2,277299,277299,277301,0,2,2
79257,6,1,277305,277305,277306,0,1,4
79258,3,3,277308,277308,277311,0,3,2
79259,2,1,277310,277311,277312,1,2,0
79260,5,1,277315,277315,277316,0,1,3
79261,2,1,277317,277317,277318,0,1,1
79262,2,3,277319,277319,277322,0,3,1
79263,4,1,277323,277323,277324,0,1,1
79264,1,2,277324,277324,277326,0,2,0
79265,1,3,277325,277326,277329,1,4,0
79266,1,2,277326,277329,277331,3,5,0
79267,3,3,277329,277331,277334,2,5,0
79268,6,1,277335,277335,277336,0,1,1
79269,2,3,277337,277337,277340,0,3,1
79270,5,3,277342,277342,277345,0,3,2
79271,1,1,277343,277345,277346,2,3,0
79272,4,2,277347,277347,277349,0,2,1
79273,6,2,277353,277353,277355,0,2,4
79274,5,3,277358,277358,277361,0,3,3
79275,2,3,277360,277361,277364,1,4,0
79276,1,3,277361,277364,277367,3,6,0
79277,6,3,277367,277367,277370,0,3,0
79278,1,3,277368,277370,277373,2,5,0
79279,6,1,277374,277374,277375,0,1,1
79280,6,2,277380,277380,277382,0,2,5
79281,1,2,277381,277382,277384,1,3,0
79282,4,2,277385,277385,277387,0,2,1
79283,6,3,277391,277391,277394,0,3,4
79284,3,1,277394,277394,277395,0,1,0
79285,4,1,277398,277398,277399,0,1,3
79286,6,2,277404,277404,277406,0,2,5
79287,3,2,277407,277407,277409,0,2,1
79288,6,3,277413,277413,277416,0,3,4
79289,3,3,277416,277416,277419,0,3,0
79290,3,3,277419,277419,277422,0,3,0
79291,5,3,277424,277424,277427,0,3,2
79292,2,1,277426,277427,277428,1,2,0
79293,2,2,277428,277428,277430,0,2,0
79294,5,2,277433,277433,277435,0,2,3
79295,4,3,277437,277437,277440,0,3,2
79296,2,1,277439,277440,277441,1,2,0
79297,1,3,277440,277441,277444,1,4,0
79298,4,1,277444,277444,277445,0,1,0
79299,3,3,277447,277447,277450,0,3,2
79300,5,2,277452,277452,277454,0,2,2
79301,6,2,277458,277458,277460,0,2,4
79302,6,3,277464,277464,277467,0,3,4
79303,5,2,277469,277469,277471,0,2,2
79304,4,3,277473,277473,277476,0,3,2
79305,5,2,277478,277478,277480,0,2,2
79306,1,2,277479,277480,277482,1,3,0
79307,6,1,277485,277485,277486,0,1,3
79308,6,1,277491,277491,277492,0,1,5
79309,5,2,277496,277496,277498,0,2,4
79310,3,2,277499,277499,277501,0,2,1
79311,2,2,277501,277501,277503,0,2,0
79312,3,2,277504,277504,277506,0,2,1
79313,1,1,277505,277506,277507,1,2,0
79314,6,1,277511,277511,277512,0,1,4
79315,2,3,277513,277513,277516,0,3,1
79316,5,2,277518,277518,277520,0,2,2
79317,3,1,277521,277521,277522,0,1,1
79318,1,2,277522,277522,277524,0,2,0
79319,2,2,277524,277524,277526,0,2,0
79320,6,3,277530,277530,277533,0,3,4
79321,2,1,277532,277533,277534,1,2,0
79322,2,2,277534,277534,277536,0,2,0
79323,2,2,277536,277536,277538,0,2,0
79324,1,3,277537,277538,277541,1,4,0
79325,4,2,277541,277541,277543,0,2,0
79326,1,1,277542,277543,277544,1,2,0
79327,1,2,277543,277544,277546,1,3,0
79328,4,2,277547,277547,277549,0,2,1
79329,5,1,277552,277552,277553,0,1,3
79330,1,2,277553,277553,277555,0,2,0
79331,2,2,277555,277555,277557,0,2,0
79332,3,2,277558,277558,277560,0,2,1
79333,6,1,277564,277564,277565,0,1,4
79334,4,2,277568,277568,277570,0,2,3
79335,2,1,277570,277570,277571,0,1,0
79336,3,2,277573,277573,277575,0,2,2
79337,2,3,277575,277575,277578,0,3,0
79338,6,1,277581,277581,277582,0,1,3
79339,6,3,277587,277587,277590,0,3,5
79340,3,1,277590,277590,277591,0,1,0
79341,6,2,277596,277596,277598,0,2,5
79342,1,3,277597,277598,277601,1,4,0
79343,5,2,277602,277602,277604,0,2,1
79344,2,3,277604,277604,277607,0,3,0
79345,6,3,277610,277610,277613,0,3,3
79346,5,2,277615,277615,277617,0,2,2
79347,1,1,277616,277617,277618,1,2,0
79348,2,1,277618,277618,277619,0,1,0
79349,3,2,277621,277621,277623,0,2,2
79350,1,1,277622,277623,277624,1,2,0
79351,6,3,277628,277628,277631,0,3,4
79352,6,1,277634,277634,277635,0,1,3
79353,2,1,277636,277636,277637,0,1,1
79354,5,3,277641,277641,277644,0,3,4
79355,6,3,277647,277647,277650,0,3,3
79356,6,1,277653,277653,277654,0,1,3
79357,1,2,277654,277654,277656,0,2,0
79358,1,3,277655,277656,277659,1,4,0
79359,3,2,277658,277659,277661,1,3,0
79360,2,3,277660,277661,277664,1,4,0
79361,1,1,277661,277664,277665,3,4,0
79362,1,3,277662,277665,277668,3,6,0
79363,2,3,277664,277668,277671,4,7,0
79364,6,2,277670,277671,277673,1,3,0
79365,3,1,277673,277673,277674,0,1,0
79366,5,2,277678,277678,277680,0,2,4
79367,6,3,277684,277684,277687,0,3,4
79368,1,3,277685,277687,277690,2,5,0
79369,3,3,277688,277690,277693,2,5,0
79370,5,2,277693,277693,277695,0,2,0
79371,6,1,277699,277699,277700,0,1,4
79372,6,1,277705,277705,277706,0,1,5
79373,6,1,277711,277711,277712,0,1,5
79374,3,2,277714,277714,277716,0,2,2
79375,4,2,277718,277718,277720,0,2,2
79376,5,2,277723,277723,277725,0,2,3
79377,6,2,277729,277729,277731,0,2,4
79378,2,1,277731,277731,277732,0,1,0
79379,5,1,277736,277736,277737,0,1,4
79380,4,3,277740,277740,277743,0,3,3
79381,1,3,277741,277743,277746,2,5,0
79382,2,3,277743,277746,277749,3,6,0
79383,1,2,277744,277749,277751,5,7,0
79384,6,2,277750,277751,277753,1,3,0
79385,5,1,277755,277755,277756,0,1,2
79386,4,2,277759,277759,277761,0,2,3
79387,2,3,277761,277761,277764,0,3,0
79388,4,3,277765,277765,277768,0,3,1
79389,1,3,277766,277768,277771,2,5,0
79390,5,2,277771,277771,277773,0,2,0
79391,6,3,277777,277777,277780,0,3,4
79392,2,2,277779,277780,277782,1,3,0
79393,2,3,277781,277782,277785,1,4,0
79394,6,2,277787,277787,277789,0,2,2
79395,1,2,277788,277789,277791,1,3,0
79396,4,2,277792,277792,277794,0,2,1
79397,5,1,277797,277797,277798,0,1,3
79398,3,2,277800,277800,277802,0,2,2
79399,6,1,277806,277806,277807,0,1,4
79400,4,2,277810,277810,277812,0,2,3
79401,6,1,277816,277816,277817,0,1,4
79402,1,3,277817,277817,277820,0,3,0
79403,5,2,277822,277822,277824,0,2,2
79404,4,1,277826,277826,277827,0,1,2
79405,2,3,277828,277828,277831,0,3,1
79406,4,3,277832,277832,277835,0,3,1
79407,2,1,277834,277835,277836,1,2,0
79408,3,3,277837,277837,277840,0,3,1
79409,3,3,277840,277840,277843,0,3,0
79410,6,1,277846,277846,277847,0,1,3
79411,4,3,277850,277850,277853,0,3,3
79412,6,1,277856,277856,277857,0,1,3
79413,6,2,277862,277862,277864,0,2,5
79414,1,1,277863,277864,277865,1,2,0
79415,5,3,277868,277868,277871,0,3,3
79416,6,2,277874,277874,277876,0,2,3
79417,5,2,277879,277879,277881,0,2,3
79418,5,2,277884,277884,277886,0,2,3
79419,3,3,277887,277887,277890,0,3,1
79420,2,2,277889,277890,277892,1,3,0
79421,3,3,277892,277892,277895,0,3,0
79422,2,3,277894,277895,277898,1,4,0
79423,3,1,277897,277898,277899,1,2,0
79424,6,2,277903,277903,277905,0,2,4
79425,1,1,277904,277905,277906,1,2,0
79426,3,1,277907,277907,277908,0,1,1
79427,1,1,277908,277908,277909,0,1,0
79428,3,2,277911,277911,277913,0,2,2
79429,4,1,277915,277915,277916,0,1,2
79430,4,3,277919,277919,277922,0,3,3
79431,4,1,277923,277923,277924,0,1,1
79432,6,3,277929,277929,277932,0,3,5
79433,4,2,277933,277933,277935,0,2,1
79434,4,1,277937,277937,277938,0,1,2
79435,5,2,277942,277942,277944,0,2,4
79436,5,2,277947,277947,277949,0,2,3
79437,5,2,277952,277952,277954,0,2,3
79438,4,3,277956,277956,277959,0,3,2
79439,1,3,277957,277959,277962,2,5,0
79440,5,1,277962,277962,277963,0,1,0
79441,4,1,277966,277966,277967,0,1,3
79442,2,2,277968,277968,277970,0,2,1
79443,2,2,277970,277970,277972,0,2,0
79444,3,1,277973,277973,277974,0,1,1
79445,3,2,277976,277976,277978,0,2,2
79446,6,2,277982,277982,277984,0,2,4
79447,5,2,277987,277987,277989,0,2,3
79448,4,3,277991,277991,277994,0,3,2
79449,3,1,277994,277994,277995,0,1,0
79450,6,1,278000,278000,278001,0,1,5
79451,4,1,278004,278004,278005,0,1,3
79452,5,2,278009,278009,278011,0,2,4
79453,4,2,278013,278013,278015,0,2,2
79454,4,3,278017,278017,278020,0,3,2
79455,4,2,278021,278021,278023,0,2,1
79456,6,1,278027,278027,278028,0,1,4
79457,3,2,278030,278030,278032,0,2,2
79458,6,2,278036,278036,278038,0,2,4
79459,1,3,278037,278038,278041,1,4,0
79460,1,3,278038,278041,278044,3,6,0
79461,5,1,278043,278044,278045,1,2,0
79462,3,2,278046,278046,278048,0,2,1
79463,1,2,278047,278048,278050,1,3,0
79464,4,1,278051,278051,278052,0,1,1
79465,2,3,278053,278053,278056,0,3,1
79466,5,1,278058,278058,278059,0,1,2
79467,2,1,278060,278060,278061,0,1,1
79468,5,3,278065,278065,278068,0,3,4
79469,4,3,278069,278069,278072,0,3,1
79470,1,3,278070,278072,278075,2,5,0
79471,6,1,278076,278076,278077,0,1,1
79472,5,1,278081,278081,278082,0,1,4
79473,2,2,278083,278083,278085,0,2,1
79474,5,3,278088,278088,278091,0,3,3
79475,3,3,278091,278091,278094,0,3,0
79476,4,2,278095,278095,278097,0,2,1
79477,1,1,278096,278097,278098,1,2,0
79478,3,2,278099,278099,278101,0,2,1
79479,4,3,278103,278103,278106,0,3,2
79480,4,2,278107,278107,278109,0,2,1
79481,1,2,278108,278109,278111,1,3,0
79482,3,3,278111,278111,278114,0,3,0
79483,1,3,278112,278114,278117,2,5,0
79484,6,2,278118,278118,278120,0,2,1
79485,6,2,278124,278124,278126,0,2,4
79486,6,3,278130,278130,278133,0,3,4
79487,4,3,278134,278134,278137,0,3,1
79488,3,1,278137,278137,278138,0,1,0
79489,1,1,278138,278138,278139,0,1,0
79490,1,1,278139,278139,278140,0,1,0
79491,5,3,278144,278144,278147,0,3,4
79492,1,1,278145,278147,278148,2,3,0
79493,5,2,278150,278150,278152,0,2,2
79494,3,3,278153,278153,278156,0,3,1
79495,6,2,278159,278159,278161,0,2,3
79496,2,2,278161,278161,278163,0,2,0
79497,3,1,278164,278164,278165,0,1,1
79498,3,2,278167,278167,278169,0,2,2
79499,6,1,278173,278173,278174,0,1,4
79500,3,2,278176,278176,278178,0,2,2
79501,5,2,278181,278181,278183,0,2,3
79502,1,2,278182,278183,278185,1,3,0
79503,1,2,278183,278185,278187,2,4,0
79504,4,2,278187,278187,278189,0,2,0
79505,4,1,278191,278191,278192,0,1,2
79506,3,2,278194,278194,278196,0,2,2
79507,3,3,278197,278197,278200,0,3,1
79508,6,2,278203,278203,278205,0,2,3
79509,2,3,278205,278205,278208,0,3,0
79510,6,3,278211,278211,278214,0,3,3
79511,4,3,278215,278215,278218,0,3,1
79512,4,3,278219,278219,278222,0,3,1
79513,6,3,278225,278225,278228,0,3,3
79514,5,3,278230,278230,278233,0,3,2
79515,3,3,278233,278233,278236,0,3,0
79516,3,1,278236,278236,278237,0,1,0
79517,4,2,278240,278240,278242,0,2,3
79518,4,1,278244,278244,278245,0,1,2
79519,2,3,278246,278246,278249,0,3,1
79520,1,2,278247,278249,278251,2,4,0
79521,1,3,278248,278251,278254,3,6,0
79522,3,3,278251,278254,278257,3,6,0
79523,6,2,278257,278257,278259,0,2,0
79524,1,1,278258,278259,278260,1,2,0
79525,5,3,278263,278263,278266,0,3,3
79526,6,1,278269,278269,278270,0,1,3
79527,5,3,278274,278274,278277,0,3,4
79528,2,2,278276,278277,278279,1,3,0
79529,1,2,278277,278279,278281,2,4,0
79530,6,1,278283,278283,278284,0,1,2
79531,1,3,278284,278284,278287,0,3,0
79532,1,2,278285,278287,278289,2,4,0
79533,1,3,278286,278289,278292,3,6,0
79534,6,2,278292,278292,278294,0,2,0
79535,5,3,278297,278297,278300,0,3,3
79536,3,2,278300,278300,278302,0,2,0
79537,1,3,278301,278302,278305,1,4,0
79538,4,3,278305,278305,278308,0,3,0
79539,4,1,278309,278309,278310,0,1,1
79540,5,1,278314,278314,278315,0,1,4
79541,4,3,278318,278318,278321,0,3,3
79542,2,3,278320,278321,278324,1,4,0
79543,2,3,278322,278324,278327,2,5,0
79544,3,3,278325,278327,278330,2,5,0
79545,2,3,278327,278330,278333,3,6,0
79546,5,2,278332,278333,278335,1,3,0
79547,3,3,278335,278335,278338,0,3,0
79548,5,3,278340,278340,278343,0,3,2
79549,1,2,278341,278343,278345,2,4,0
79550,4,3,278345,278345,278348,0,3,0
79551,2,3,278347,278348,278351,1,4,0
79552,4,3,278351,278351,278354,0,3,0
79553,6,3,278357,278357,278360,0,3,3
79554,4,2,278361,278361,278363,0,2,1
79555,6,1,278367,278367,278368,0,1,4
79556,6,2,278373,278373,278375,0,2,5
79557,1,2,278374,278375,278377,1,3,0
79558,3,3,278377,278377,278380,0,3,0
79559,4,3,278381,278381,278384,0,3,1
79560,4,3,278385,278385,278388,0,3,1
79561,2,2,278387,278388,278390,1,3,0
79562,6,2,278393,278393,278395,0,2,3
79563,3,3,278396,278396,278399,0,3,1
79564,3,2,278399,278399,278401,0,2,0
79565,5,3,278404,278404,278407,0,3,3
79566,1,3,278405,278407,278410,2,5,0
79567,5,1,278410,278410,278411,0,1,0
79568,4,2,278414,278414,278416,0,2,3
79569,5,2,278419,278419,278421,0,2,3
79570,2,2,278421,278421,278423,0,2,0
79571,6,2,278427,278427,278429,0,2,4
79572,6,3,278433,278433,278436,0,3,4
79573,1,3,278434,278436,278439,2,5,0
79574,5,1,278439,278439,278440,0,1,0
79575,1,1,278440,278440,278441,0,1,0
79576,6,2,278446,278446,278448,0,2,5
79577,6,1,278452,278452,278453,0,1,4
79578,5,2,278457,278457,278459,0,2,4
79579,3,3,278460,278460,278463,0,3,1
79580,3,3,278463,278463,278466,0,3,0
79581,3,1,278466,278466,278467,0,1,0
79582,1,1,278467,278467,278468,0,1,0
79583,6,1,278473,278473,278474,0,1,5
79584,6,3,278479,278479,278482,0,3,5
79585,1,1,278480,278482,278483,2,3,0
79586,2,1,278482,278483,278484,1,2,0
79587,4,1,278486,278486,278487,0,1,2
79588,1,2,278487,278487,278489,0,2,0
79589,5,3,278492,278492,278495,0,3,3
79590,6,2,278498,278498,278500,0,2,3
79591,5,2,278503,278503,278505,0,2,3
79592,1,3,278504,278505,278508,1,4,0
79593,6,2,278510,278510,278512,0,2,2
79594,2,1,278512,278512,278513,0,1,0
79595,4,3,278516,278516,278519,0,3,3
79596,4,3,278520,278520,278523,0,3,1
79597,4,1,278524,278524,278525,0,1,1
79598,6,1,278530,278530,278531,0,1,5
79599,2,3,278532,278532,278535,0,3,1
79600,2,2,278534,278535,278537,1,3,0
79601,3,3,278537,278537,278540,0,3,0
79602,3,3,278540,278540,278543,0,3,0
79603,5,3,278545,278545,278548,0,3,2
79604,6,3,278551,278551,278554,0,3,3
79605,2,2,278553,278554,278556,1,3,0
79606,1,3,278554,278556,278559,2,5,0
79607,1,3,278555,278559,278562,4,7,0
79608,1,2,278556,278562,278564,6,8,0
79609,3,1,278559,278564,278565,5,6,0
79610,6,2,278565,278565,278567,0,2,0
79611,5,1,278570,278570,278571,0,1,3
79612,2,1,278572,278572,278573,0,1,1
79613,1,1,278573,278573,278574,0,1,0
79614,5,3,278578,278578,278581,0,3,4
79615,2,1,278580,278581,278582,1,2,0
79616,2,3,278582,278582,278585,0,3,0
79617,6,3,278588,278588,278591,0,3,3
79618,6,2,278594,278594,278596,0,2,3
79619,2,1,278596,278596,278597,0,1,0
79620,6,3,278602,278602,278605,0,3,5
79621,2,1,278604,278605,278606,1,2,0
79622,1,1,278605,278606,278607,1,2,0
79623,3,3,278608,278608,278611,0,3,1
79624,6,2,278614,278614,278616,0,2,3
79625,3,2,278617,278617,278619,0,2,1
79626,1,3,278618,278619,278622,1,4,0
79627,2,3,278620,278622,278625,2,5,0
79628,1,1,278621,278625,278626,4,5,0
79629,2,1,278623,278626,278627,3,4,0
79630,4,1,278627,278627,278628,0,1,0
79631,3,1,278630,278630,278631,0,1,2
79632,1,1,278631,278631,278632,0,1,0
79633,3,1,278634,278634,278635,0,1,2
79634,1,3,278635,278635,278638,0,3,0
79635,6,2,278641,278641,278643,0,2,3
79636,2,3,278643,278643,278646,0,3,0
79637,3,2,278646,278646,278648,0,2,0
79638,2,2,278648,278648,278650,0,2,0
79639,5,1,278653,278653,278654,0,1,3
79640,5,2,278658,278658,278660,0,2,4
79641,4,1,278662,278662,278663,0,1,2
79642,4,2,278666,278666,278668,0,2,3
79643,6,1,278672,278672,278673,0,1,4
79644,2,3,278674,278674,278677,0,3,1
79645,3,3,278677,278677,278680,0,3,0
79646,4,3,278681,278681,278684,0,3,1
79647,5,2,278686,278686,278688,0,2,2
79648,5,2,278691,278691,278693,0,2,3
79649,4,2,278695,278695,278697,0,2,2
79650,5,3,278700,278700,278703,0,3,3
79651,1,2,278701,278703,278705,2,4,0
79652,5,2,278706,278706,278708,0,2,1
79653,2,1,278708,278708,278709,0,1,0
79654,4,3,278712,278712,278715,0,3,3
79655,3,2,278715,278715,278717,0,2,0
79656,3,3,278718,278718,278721,0,3,1
79657,4,2,278722,278722,278724,0,2,1
79658,4,3,278726,278726,278729,0,3,2
79659,5,1,278731,278731,278732,0,1,2
79660,2,1,278733,278733,278734,0,1,1
79661,3,2,278736,278736,278738,0,2,2
79662,6,1,278742,278742,278743,0,1,4
79663,4,3,278746,278746,278749,0,3,3
79664,3,2,278749,278749,278751,0,2,0
79665,4,2,278753,278753,278755,0,2,2
79666,5,1,278758,278758,278759,0,1,3
79667,4,2,278762,278762,278764,0,2,3
79668,3,1,278765,278765,278766,0,1,1
79669,4,2,278769,278769,278771,0,2,3
79670,5,2,278774,278774,278776,0,2,3
79671,3,1,278777,278777,278778,0,1,1
79672,2,3,278779,278779,278782,0,3,1
79673,1,3,278780,278782,278785,2,5,0
79674,6,2,278786,278786,278788,0,2,1
79675,5,3,278791,278791,278794,0,3,3
79676,5,3,278796,278796,278799,0,3,2
79677,6,3,278802,278802,278805,0,3,3
79678,1,3,278803,278805,278808,2,5,0
79679,1,3,278804,278808,278811,4,7,0
79680,4,1,278808,278811,278812,3,4,0
79681,3,2,278811,278812,278814,1,3,0
79682,4,3,278815,278815,278818,0,3,1
79683,4,2,278819,278819,278821,0,2,1
79684,3,1,278822,278822,278823,0,1,1
79685,1,2,278823,278823,278825,0,2,0
79686,6,3,278829,278829,278832,0,3,4
79687,6,2,278835,278835,278837,0,2,3
79688,1,2,278836,278837,278839,1,3,0
79689,4,3,278840,278840,278843,0,3,1
79690,6,3,278846,278846,278849,0,3,3
79691,6,2,278852,278852,278854,0,2,3
79692,2,3,278854,278854,278857,0,3,0
79693,6,1,278860,278860,278861,0,1,3
79694,5,1,278865,278865,278866,0,1,4
79695,4,3,278869,278869,278872,0,3,3
79696,4,3,278873,278873,278876,0,3,1
79697,2,1,278875,278876,278877,1,2,0
79698,1,3,278876,278877,278880,1,4,0
79699,1,2,278877,278880,278882,3,5,0
79700,4,3,278881,278882,278885,1,4,0
79701,4,1,278885,278885,278886,0,1,0
79702,6,2,278891,278891,278893,0,2,5
79703,6,1,278897,278897,278898,0,1,4
79704,5,3,278902,278902,278905,0,3,4
79705,6,1,278908,278908,278909,0,1,3
79706,1,3,278909,278909,278912,0,3,0
79707,5,1,278914,278914,278915,0,1,2
79708,2,2,278916,278916,278918,0,2,1
79709,5,1,278921,278921,278922,0,1,3
79710,3,2,278924,278924,278926,0,2,2
79711,1,1,278925,278926,278927,1,2,0
79712,3,2,278928,278928,278930,0,2,1
79713,3,3,278931,278931,278934,0,3,1
79714,4,3,278935,278935,278938,0,3,1
79715,1,1,278936,278938,278939,2,3,0
79716,6,2,278942,278942,278944,0,2,3
79717,1,2,278943,278944,278946,1,3,0
79718,6,2,278949,278949,278951,0,2,3
79719,4,1,278953,278953,278954,0,1,2
79720,5,1,278958,278958,278959,0,1,4
79721,6,3,278964,278964,278967,0,3,5
79722,2,2,278966,278967,278969,1,3,0
79723,4,3,278970,278970,278973,0,3,1
79724,3,1,278973,278973,278974,0,1,0
79725,4,2,278977,278977,278979,0,2,3
79726,5,1,278982,278982,278983,0,1,3
79727,5,2,278987,278987,278989,0,2,4
79728,3,3,278990,278990,278993,0,3,1
79729,6,2,278996,278996,278998,0,2,3
79730,3,2,278999,278999,279001,0,2,1
79731,4,2,279003,279003,279005,0,2,2
79732,4,3,279007,279007,279010,0,3,2
79733,1,3,279008,279010,279013,2,5,0
79734,2,1,279010,279013,279014,3,4,0
79735,4,2,279014,279014,279016,0,2,0
79736,6,1,279020,279020,279021,0,1,4
79737,3,3,279023,279023,279026,0,3,2
79738,1,1,279024,279026,279027,2,3,0
79739,4,2,279028,279028,279030,0,2,1
79740,2,1,279030,279030,279031,0,1,0
79741,3,1,279033,279033,279034,0,1,2
79742,1,2,279034,279034,279036,0,2,0
79743,4,2,279038,279038,279040,0,2,2
79744,2,3,279040,279040,279043,0,3,0
79745,2,2,279042,279043,279045,1,3,0
79746,4,2,279046,279046,279048,0,2,1
79747,6,1,279052,279052,279053,0,1,4
79748,6,2,279058,279058,279060,0,2,5
79749,6,1,279064,279064,279065,0,1,4
79750,4,2,279068,279068,279070,0,2,3
79751,3,3,279071,279071,279074,0,3,1
79752,5,2,279076,279076,279078,0,2,2
79753,4,2,279080,279080,279082,0,2,2
79754,5,3,279085,279085,279088,0,3,3
79755,3,3,279088,279088,279091,0,3,0
79756,6,3,279094,279094,279097,0,3,3
79757,6,3,279100,279100,279103,0,3,3
79758,6,1,279106,279106,279107,0,1,3
79759,4,3,279110,279110,279113,0,3,3
79760,4,3,279114,279114,279117,0,3,1
79761,3,1,279117,279117,279118,0,1,0
79762,6,2,279123,279123,279125,0,2,5
79763,1,1,279124,279125,279126,1,2,0
79764,4,3,279128,279128,279131,0,3,2
79765,4,2,279132,279132,279134,0,2,1
79766,1,2,279133,279134,279136,1,3,0
79767,6,1,279139,279139,279140,0,1,3
79768,1,2,279140,279140,279142,0,2,0
79769,2,2,279142,279142,279144,0,2,0
79770,3,3,279145,279145,279148,0,3,1
79771,1,3,279146,279148,279151,2,5,0
79772,1,3,279147,279151,279154,4,7,0
79773,3,3,279150,279154,279157,4,7,0
79774,1,2,279151,279157,279159,6,8,0
79775,2,1,279153,279159,279160,6,7,0
79776,3,2,279156,279160,279162,4,6,0
79777,6,2,279162,279162,279164,0,2,0
79778,1,2,279163,279164,279166,1,3,0
79779,5,1,279168,279168,279169,0,1,2
79780,2,3,279170,279170,279173,0,3,1
79781,3,2,279173,279173,279175,0,2,0
79782,5,1,279178,279178,279179,0,1,3
79783,3,3,279181,279181,279184,0,3,2
79784,1,2,279182,279184,279186,2,4,0
79785,4,1,279186,279186,279187,0,1,0
79786,5,1,279191,279191,279192,0,1,4
79787,6,1,279197,279197,279198,0,1,5
79788,6,3,279203,279203,279206,0,3,5
79789,4,2,279207,279207,279209,0,2,1
79790,6,2,279213,279213,279215,0,2,4
79791,1,2,279214,279215,279217,1,3,0
79792,5,1,279219,279219,279220,0,1,2
79793,6,1,279225,279225,279226,0,1,5
79794,1,1,279226,279226,279227,0,1,0
79795,5,2,279231,279231,279233,0,2,4
79796,2,3,279233,279233,279236,0,3,0
79797,4,3,279237,279237,279240,0,3,1
79798,5,1,279242,279242,279243,0,1,2
79799,6,3,279248,279248,279251,0,3,5
79800,4,2,279252,279252,279254,0,2,1
79801,4,2,279256,279256,279258,0,2,2
79802,2,2,279258,279258,279260,0,2,0
79803,5,3,279263,279263,279266,0,3,3
79804,1,3,279264,279266,279269,2,5,0
79805,2,3,279266,279269,279272,3,6,0
79806,6,1,279272,279272,279273,0,1,0
79807,1,3,279273,279273,279276,0,3,0
79808,2,2,279275,279276,279278,1,3,0
79809,5,2,279280,279280,279282,0,2,2
79810,4,2,279284,279284,279286,0,2,2
79811,4,3,279288,279288,279291,0,3,2
79812,5,1,279293,279293,279294,0,1,2
79813,5,1,279298,279298,279299,0,1,4
79814,1,2,279299,279299,279301,0,2,0
79815,6,1,279305,279305,279306,0,1,4
79816,5,2,279310,279310,279312,0,2,4
79817,6,2,279316,279316,279318,0,2,4
79818,4,2,279320,279320,279322,0,2,2
79819,5,3,279325,279325,279328,0,3,3
79820,3,2,279328,279328,279330,0,2,0
79821,3,1,279331,279331,279332,0,1,1
79822,4,1,279335,279335,279336,0,1,3
79823,6,1,279341,279341,279342,0,1,5
79824,3,1,279344,279344,279345,0,1,2
79825,4,3,279348,279348,279351,0,3,3
79826,4,2,279352,279352,279354,0,2,1
79827,4,3,279356,279356,279359,0,3,2
79828,2,2,279358,279359,279361,1,3,0
79829,3,1,279361,279361,279362,0,1,0
79830,2,2,279363,279363,279365,0,2,1
79831,2,3,279365,279365,279368,0,3,0
79832,4,2,279369,279369,279371,0,2,1
79833,4,2,279373,279373,279375,0,2,2
79834,5,1,279378,279378,279379,0,1,3
79835,3,1,279381,279381,279382,0,1,2
79836,4,1,279385,279385,279386,0,1,3
79837,5,1,279390,279390,279391,0,1,4
79838,6,2,279396,279396,279398,0,2,5
79839,5,2,279401,279401,279403,0,2,3
79840,3,1,279404,279404,279405,0,1,1
79841,5,3,279409,279409,279412,0,3,4
79842,3,1,279412,279412,279413,0,1,0
79843,2,2,279414,279414,279416,0,2,1
79844,1,1,279415,279416,279417,1,2,0
79845,6,2,279421,279421,279423,0,2,4
79846,4,1,279425,279425,279426,0,1,2
79847,4,1,279429,279429,279430,0,1,3
79848,6,1,279435,279435,279436,0,1,5
79849,1,3,279436,279436,279439,0,3,0
79850,1,3,279437,279439,279442,2,5,0
79851,4,2,279441,279442,279444,1,3,0
79852,6,3,279447,279447,279450,0,3,3
79853,4,3,279451,279451,279454,0,3,1
79854,3,1,279454,279454,279455,0,1,0
79855,3,3,279457,279457,279460,0,3,2
79856,3,3,279460,279460,279463,0,3,0
79857,5,3,279465,279465,279468,0,3,2
79858,4,1,279469,279469,279470,0,1,1
79859,2,1,279471,279471,279472,0,1,1
79860,2,3,279473,279473,279476,0,3,1
79861,3,1,279476,279476,279477,0,1,0
79862,4,1,279480,279480,279481,0,1,3
79863,5,1,279485,279485,279486,0,1,4
79864,1,1,279486,279486,279487,0,1,0
79865,5,3,279491,279491,279494,0,3,4
79866,4,3,279495,279495,279498,0,3,1
79867,1,1,279496,279498,279499,2,3,0
79868,6,1,279502,279502,279503,0,1,3
79869,5,2,279507,279507,279509,0,2,4
79870,2,3,279509,279509,279512,0,3,0
79871,2,3,279511,279512,279515,1,4,0
79872,5,3,279516,279516,279519,0,3,1
79873,5,2,279521,279521,279523,0,2,2
79874,4,2,279525,279525,279527,0,2,2
79875,2,2,279527,279527,279529,0,2,0
79876,1,2,279528,279529,279531,1,3,0
79877,3,1,279531,279531,279532,0,1,0
79878,1,1,279532,279532,279533,0,1,0
79879,6,1,279538,279538,279539,0,1,5
79880,5,3,279543,279543,279546,0,3,4
79881,4,1,279547,279547,279548,0,1,1
79882,3,3,279550,279550,279553,0,3,2
79883,5,1,279555,279555,279556,0,1,2
79884,2,1,279557,279557,279558,0,1,1
79885,5,3,279562,279562,279565,0,3,4
79886,4,1,279566,279566,279567,0,1,1
79887,2,2,279568,279568,279570,0,2,1
79888,5,3,279573,279573,279576,0,3,3
79889,1,2,279574,279576,279578,2,4,0
79890,4,1,279578,279578,279579,0,1,0
79891,6,3,279584,279584,279587,0,3,5
79892,1,3,279585,279587,279590,2,5,0
79893,1,1,279586,279590,279591,4,5,0
79894,5,2,279591,279591,279593,0,2,0
79895,6,3,279597,279597,279600,0,3,4
79896,5,1,279602,279602,279603,0,1,2
79897,3,1,279605,279605,279606,0,1,2
79898,5,2,279610,279610,279612,0,2,4
79899,6,3,279616,279616,279619,0,3,4
79900,5,3,279621,279621,279624,0,3,2
79901,5,1,279626,279626,279627,0,1,2
79902,3,1,279629,279629,279630,0,1,2
79903,5,3,279634,279634,279637,0,3,4
79904,6,1,279640,279640,279641,0,1,3
79905,5,2,279645,279645,279647,0,2,4
79906,3,3,279648,279648,279651,0,3,1
79907,1,3,279649,279651,279654,2,5,0
79908,4,1,279653,279654,279655,1,2,0
79909,5,3,279658,279658,279661,0,3,3
79910,2,3,279660,279661,279664,1,4,0
79911,6,1,279666,279666,279667,0,1,2
79912,3,1,279669,279669,279670,0,1,2
79913,3,3,279672,279672,279675,0,3,2
79914,1,2,279673,279675,279677,2,4,0
79915,5,1,279678,279678,279679,0,1,1
79916,6,1,279684,279684,279685,0,1,5
79917,1,1,279685,279685,279686,0,1,0
79918,4,3,279689,279689,279692,0,3,3
79919,1,1,279690,279692,279693,2,3,0
79920,4,2,279694,279694,279696,0,2,1
79921,2,2,279696,279696,279698,0,2,0
79922,5,3,279701,279701,279704,0,3,3
79923,4,3,279705,279705,279708,0,3,1
79924,6,2,279711,279711,279713,0,2,3
79925,6,1,279717,279717,279718,0,1,4
79926,4,3,279721,279721,279724,0,3,3
79927,5,3,279726,279726,279729,0,3,2
79928,5,1,279731,279731,279732,0,1,2
79929,1,2,279732,279732,279734,0,2,0
79930,4,1,279736,279736,279737,0,1,2
79931,3,2,279739,279739,279741,0,2,2
79932,3,3,279742,279742,279745,0,3,1
79933,6,1,279748,279748,279749,0,1,3
79934,3,1,279751,279751,279752,0,1,2
79935,6,3,279757,279757,279760,0,3,5
79936,4,2,279761,279761,279763,0,2,1
79937,5,3,279766,279766,279769,0,3,3
79938,6,3,279772,279772,279775,0,3,3
79939,3,2,279775,279775,279777,0,2,0
79940,1,2,279776,279777,279779,1,3,0
79941,5,1,279781,279781,279782,0,1,2
79942,6,1,279787,279787,279788,0,1,5
79943,2,2,279789,279789,279791,0,2,1
79944,5,3,279794,279794,279797,0,3,3
79945,2,1,279796,279797,279798,1,2,0
79946,2,3,279798,279798,279801,0,3,0
79947,6,3,279804,279804,279807,0,3,3
79948,3,2,279807,279807,279809,0,2,0
79949,2,3,279809,279809,279812,0,3,0
79950,3,1,279812,279812,279813,0,1,0
79951,4,3,279816,279816,279819,0,3,3
79952,2,3,279818,279819,279822,1,4,0
79953,4,1,279822,279822,279823,0,1,0
79954,6,3,279828,279828,279831,0,3,5
79955,4,3,279832,279832,279835,0,3,1
79956,6,3,279838,279838,279841,0,3,3
79957,3,2,279841,279841,279843,0,2,0
79958,2,3,279843,279843,279846,0,3,0
79959,6,3,279849,279849,279852,0,3,3
79960,6,3,279855,279855,279858,0,3,3
79961,5,1,279860,279860,279861,0,1,2
79962,1,3,279861,279861,279864,0,3,0
79963,4,3,279865,279865,279868,0,3,1
79964,4,3,279869,279869,279872,0,3,1
79965,2,2,279871,279872,279874,1,3,0
79966,2,3,279873,279874,279877,1,4,0
79967,4,3,279877,279877,279880,0,3,0
79968,2,3,279879,279880,279883,1,4,0
79969,6,2,279885,279885,279887,0,2,2
79970,5,1,279890,279890,279891,0,1,3
79971,2,3,279892,279892,279895,0,3,1
79972,4,2,279896,279896,279898,0,2,1
79973,4,3,279900,279900,279903,0,3,2
79974,4,2,279904,279904,279906,0,2,1
79975,5,1,279909,279909,279910,0,1,3
79976,5,3,279914,279914,279917,0,3,4
79977,5,3,279919,279919,279922,0,3,2
79978,5,1,279924,279924,279925,0,1,2
79979,5,1,279929,279929,279930,0,1,4
79980,6,2,279935,279935,279937,0,2,5
79981,3,1,279938,279938,279939,0,1,1
79982,6,3,279944,279944,279947,0,3,5
79983,6,3,279950,279950,279953,0,3,3
79984,4,2,279954,279954,279956,0,2,1
79985,1,3,279955,279956,279959,1,4,0
79986,3,3,279958,279959,279962,1,4,0
79987,3,1,279961,279962,279963,1,2,0
79988,4,1,279965,279965,279966,0,1,2
79989,2,1,279967,279967,279968,0,1,1
79990,3,3,279970,279970,279973,0,3,2
79991,4,2,279974,279974,279976,0,2,1
79992,5,3,279979,279979,279982,0,3,3
79993,4,3,279983,279983,279986,0,3,1
79994,4,1,279987,279987,279988,0,1,1
79995,2,1,279989,279989,279990,0,1,1
79996,4,3,279993,279993,279996,0,3,3
79997,6,1,279999,279999,280000,0,1,3
79998,2,1,280001,280001,280002,0,1,1
79999,6,2,280007,280007,280009,0,2,5
80000,5,1,280012,280012,280013,0,1,3
80001,2,1,280014,280014,280015,0,1,1
80002,4,2,280018,280018,280020,0,2,3
80003,1,1,280019,280020,280021,1,2,0
80004,1,2,280020,280021,280023,1,3,0
80005,5,2,280025,280025,280027,0,2,2
80006,4,1,280029,280029,280030,0,1,2
80007,5,3,280034,280034,280037,0,3,4
80008,6,2,280040,280040,280042,0,2,3
80009,5,3,280045,280045,280048,0,3,3
80010,6,1,280051,280051,280052,0,1,3
80011,4,1,280055,280055,280056,0,1,3
80012,1,1,280056,280056,280057,0,1,0
80013,3,2,280059,280059,280061,0,2,2
80014,2,2,280061,280061,280063,0,2,0
80015,1,1,280062,280063,280064,1,2,0
80016,6,2,280068,280068,280070,0,2,4
80017,5,2,280073,280073,280075,0,2,3
80018,4,2,280077,280077,280079,0,2,2
80019,3,1,280080,280080,280081,0,1,1
80020,3,2,280083,280083,280085,0,2,2
80021,2,2,280085,280085,280087,0,2,0
80022,2,2,280087,280087,280089,0,2,0
80023,4,2,280091,280091,280093,0,2,2
80024,2,1,280093,280093,280094,0,1,0
80025,3,3,280096,280096,280099,0,3,2
80026,1,2,280097,280099,280101,2,4,0
80027,6,3,280103,280103,280106,0,3,2
80028,2,1,280105,280106,280107,1,2,0
80029,2,3,280107,280107,280110,0,3,0
80030,1,2,280108,280110,280112,2,4,0
80031,4,1,280112,280112,280113,0,1,0
80032,6,3,280118,280118,280121,0,3,5
80033,6,3,280124,280124,280127,0,3,3
80034,4,3,280128,280128,280131,0,3,1
80035,5,1,280133,280133,280134,0,1,2
80036,3,1,280136,280136,280137,0,1,2
80037,6,3,280142,280142,280145,0,3,5
80038,6,1,280148,280148,280149,0,1,3
80039,6,1,280154,280154,280155,0,1,5
80040,4,2,280158,280158,280160,0,2,3
80041,4,2,280162,280162,280164,0,2,2
80042,1,2,280163,280164,280166,1,3,0
80043,2,3,280165,280166,280169,1,4,0
80044,6,3,280171,280171,280174,0,3,2
80045,2,1,280173,280174,280175,1,2,0
80046,4,1,280177,280177,280178,0,1,2
80047,5,1,280182,280182,280183,0,1,4
80048,4,2,280186,280186,280188,0,2,3
80049,4,3,280190,280190,280193,0,3,2
80050,5,1,280195,280195,280196,0,1,2
80051,4,1,280199,280199,280200,0,1,3
80052,4,1,280203,280203,280204,0,1,3
80053,1,1,280204,280204,280205,0,1,0
80054,3,2,280207,280207,280209,0,2,2
80055,5,2,280212,280212,280214,0,2,3
80056,5,1,280217,280217,280218,0,1,3
80057,4,2,280221,280221,280223,0,2,3
80058,4,2,280225,280225,280227,0,2,2
80059,2,2,280227,280227,280229,0,2,0
80060,2,2,280229,280229,280231,0,2,0
80061,1,3,280230,280231,280234,1,4,0
80062,4,2,280234,280234,280236,0,2,0
80063,6,1,280240,280240,280241,0,1,4
80064,3,1,280243,280243,280244,0,1,2
80065,1,2,280244,280244,280246,0,2,0
80066,6,1,280250,280250,280251,0,1,4
80067,3,2,280253,280253,280255,0,2,2
80068,3,3,280256,280256,280259,0,3,1
80069,2,1,280258,280259,280260,1,2,0
80070,3,3,280261,280261,280264,0,3,1
80071,1,2,280262,280264,280266,2,4,0
80072,5,2,280267,280267,280269,0,2,1
80073,1,3,280268,280269,280272,1,4,0
80074,4,1,280272,280272,280273,0,1,0
80075,3,3,280275,280275,280278,0,3,2
80076,3,2,280278,280278,280280,0,2,0
80077,3,2,280281,280281,280283,0,2,1
80078,3,1,280284,280284,280285,0,1,1
80079,1,3,280285,280285,280288,0,3,0
80080,6,3,280291,280291,280294,0,3,3
80081,6,3,280297,280297,280300,0,3,3
80082,1,2,280298,280300,280302,2,4,0
80083,1,1,280299,280302,280303,3,4,0
80084,5,2,280304,280304,280306,0,2,1
80085,2,3,280306,280306,280309,0,3,0
80086,4,3,280310,280310,280313,0,3,1
80087,4,2,280314,280314,280316,0,2,1
80088,5,3,280319,280319,280322,0,3,3
80089,6,2,280325,280325,280327,0,2,3
80090,4,3,280329,280329,280332,0,3,2
80091,5,3,280334,280334,280337,0,3,2
80092,3,3,280337,280337,280340,0,3,0
80093,5,2,280342,280342,280344,0,2,2
80094,3,3,280345,280345,280348,0,3,1
80095,1,2,280346,280348,280350,2,4,0
80096,6,2,280352,280352,280354,0,2,2
80097,1,1,280353,280354,280355,1,2,0
80098,3,1,280356,280356,280357,0,1,1
80099,3,1,280359,280359,280360,0,1,2
80100,5,1,280364,280364,280365,0,1,4
80101,5,1,280369,280369,280370,0,1,4
80102,5,1,280374,280374,280375,0,1,4
80103,1,2,280375,280375,280377,0,2,0
80104,2,2,280377,280377,280379,0,2,0
80105,1,3,280378,280379,280382,1,4,0
80106,3,1,280381,280382,280383,1,2,0
80107,4,1,280385,280385,280386,0,1,2
80108,4,3,280389,280389,280392,0,3,3
80109,2,3,280391,280392,280395,1,4,0
80110,4,1,280395,280395,280396,0,1,0
80111,6,2,280401,280401,280403,0,2,5
80112,6,1,280407,280407,280408,0,1,4
80113,5,2,280412,280412,280414,0,2,4
80114,5,2,280417,280417,280419,0,2,3
80115,2,2,280419,280419,280421,0,2,0
80116,6,1,280425,280425,280426,0,1,4
80117,5,2,280430,280430,280432,0,2,4
80118,1,2,280431,280432,280434,1,3,0
80119,3,2,280434,280434,280436,0,2,0
80120,5,3,280439,280439,280442,0,3,3
80121,6,1,280445,280445,280446,0,1,3
80122,5,1,280450,280450,280451,0,1,4
80123,6,3,280456,280456,280459,0,3,5
80124,1,2,280457,280459,280461,2,4,0
80125,4,3,280461,280461,280464,0,3,0
80126,3,3,280464,280464,280467,0,3,0
80127,3,2,280467,280467,280469,0,2,0
80128,5,1,280472,280472,280473,0,1,3
80129,1,2,280473,280473,280475,0,2,0
80130,2,3,280475,280475,280478,0,3,0
80131,3,2,280478,280478,280480,0,2,0
80132,6,2,280484,280484,280486,0,2,4
80133,3,1,280487,280487,280488,0,1,1
80134,4,2,280491,280491,280493,0,2,3
80135,2,3,280493,280493,280496,0,3,0
80136,3,2,280496,280496,280498,0,2,0
80137,5,1,280501,280501,280502,0,1,3
80138,2,1,280503,280503,280504,0,1,1
80139,3,2,280506,280506,280508,0,2,2
80140,4,1,280510,280510,280511,0,1,2
80141,4,3,280514,280514,280517,0,3,3
80142,5,1,280519,280519,280520,0,1,2
80143,3,3,280522,280522,280525,0,3,2
80144,4,1,280526,280526,280527,0,1,1
80145,1,2,280527,280527,280529,0,2,0
80146,4,3,280531,280531,280534,0,3,2
80147,4,1,280535,280535,280536,0,1,1
80148,2,3,280537,280537,280540,0,3,1
80149,4,3,280541,280541,280544,0,3,1
80150,4,1,280545,280545,280546,0,1,1
80151,4,2,280549,280549,280551,0,2,3
80152,5,3,280554,280554,280557,0,3,3
80153,2,2,280556,280557,280559,1,3,0
80154,3,3,280559,280559,280562,0,3,0
80155,3,1,280562,280562,280563,0,1,0
80156,4,1,280566,280566,280567,0,1,3
80157,1,2,280567,280567,280569,0,2,0
80158,2,1,280569,280569,280570,0,1,0
80159,5,1,280574,280574,280575,0,1,4
80160,4,3,280578,280578,280581,0,3,3
80161,6,1,280584,280584,280585,0,1,3
80162,6,1,280590,280590,280591,0,1,5
80163,2,2,280592,280592,280594,0,2,1
80164,3,2,280595,280595,280597,0,2,1
80165,3,3,280598,280598,280601,0,3,1
80166,5,3,280603,280603,280606,0,3,2
80167,2,2,280605,280606,280608,1,3,0
80168,3,3,280608,280608,280611,0,3,0
80169,3,1,280611,280611,280612,0,1,0
80170,6,1,280617,280617,280618,0,1,5
80171,2,3,280619,280619,280622,0,3,1
80172,1,3,280620,280622,280625,2,5,0
80173,5,3,280625,280625,280628,0,3,0
80174,5,3,280630,280630,280633,0,3,2
80175,4,1,280634,280634,280635,0,1,1
80176,1,1,280635,280635,280636,0,1,0
80177,6,1,280641,280641,280642,0,1,5
80178,5,1,280646,280646,280647,0,1,4
80179,3,1,280649,280649,280650,0,1,2
80180,5,3,280654,280654,280657,0,3,4
80181,4,1,280658,280658,280659,0,1,1
80182,5,3,280663,280663,280666,0,3,4
80183,4,3,280667,280667,280670,0,3,1
80184,2,2,280669,280670,280672,1,3,0
80185,2,1,280671,280672,280673,1,2,0
80186,2,1,280673,280673,280674,0,1,0
80187,6,3,280679,280679,280682,0,3,5
80188,6,2,280685,280685,280687,0,2,3
80189,4,1,280689,280689,280690,0,1,2
80190,2,1,280691,280691,280692,0,1,1
80191,5,2,280696,280696,280698,0,2,4
80192,3,1,280699,280699,280700,0,1,1
80193,2,1,280701,280701,280702,0,1,1
80194,1,3,280702,280702,280705,0,3,0
80195,3,3,280705,280705,280708,0,3,0
80196,5,1,280710,280710,280711,0,1,2
80197,3,2,280713,280713,280715,0,2,2
80198,5,1,280718,280718,280719,0,1,3
80199,2,1,280720,280720,280721,0,1,1
80200,2,1,280722,280722,280723,0,1,1
80201,4,2,280726,280726,280728,0,2,3
80202,4,1,280730,280730,280731,0,1,2
80203,4,2,280734,280734,280736,0,2,3
80204,4,3,280738,280738,280741,0,3,2
80205,5,3,280743,280743,280746,0,3,2
80206,4,2,280747,280747,280749,0,2,1
80207,2,3,280749,280749,280752,0,3,0
80208,6,1,280755,280755,280756,0,1,3
80209,5,2,280760,280760,280762,0,2,4
80210,5,2,280765,280765,280767,0,2,3
80211,4,2,280769,280769,280771,0,2,2
80212,1,1,280770,280771,280772,1,2,0
80213,2,3,280772,280772,280775,0,3,0
80214,2,3,280774,280775,280778,1,4,0
80215,4,1,280778,280778,280779,0,1,0
80216,6,3,280784,280784,280787,0,3,5
80217,5,1,280789,280789,280790,0,1,2
80218,2,3,280791,280791,280794,0,3,1
80219,4,1,280795,280795,280796,0,1,1
80220,5,2,280800,280800,280802,0,2,4
80221,4,3,280804,280804,280807,0,3,2
80222,4,1,280808,280808,280809,0,1,1
80223,3,3,280811,280811,280814,0,3,2
80224,2,2,280813,280814,280816,1,3,0
80225,5,3,280818,280818,280821,0,3,2
80226,6,3,280824,280824,280827,0,3,3
80227,2,1,280826,280827,280828,1,2,0
80228,3,3,280829,280829,280832,0,3,1
80229,4,1,280833,280833,280834,0,1,1
80230,4,2,280837,280837,280839,0,2,3
80231,5,3,280842,280842,280845,0,3,3
80232,6,2,280848,280848,280850,0,2,3
80233,5,2,280853,280853,280855,0,2,3
80234,3,2,280856,280856,280858,0,2,1
80235,5,3,280861,280861,280864,0,3,3
80236,6,1,280867,280867,280868,0,1,3
80237,1,1,280868,280868,280869,0,1,0
80238,2,2,280870,280870,280872,0,2,1
80239,6,2,280876,280876,280878,0,2,4
80240,5,2,280881,280881,280883,0,2,3
80241,4,3,280885,280885,280888,0,3,2
80242,4,2,280889,280889,280891,0,2,1
80243,3,1,280892,280892,280893,0,1,1
80244,6,3,280898,280898,280901,0,3,5
80245,2,2,280900,280901,280903,1,3,0
80246,5,3,280905,280905,280908,0,3,2
80247,1,3,280906,280908,280911,2,5,0
80248,4,2,280910,280911,280913,1,3,0
80249,6,3,280916,280916,280919,0,3,3
80250,4,2,280920,280920,280922,0,2,1
80251,3,2,280923,280923,280925,0,2,1
80252,6,3,280929,280929,280932,0,3,4
80253,1,2,280930,280932,280934,2,4,0
80254,1,2,280931,280934,280936,3,5,0
80255,4,2,280935,280936,280938,1,3,0
80256,6,3,280941,280941,280944,0,3,3
80257,2,1,280943,280944,280945,1,2,0
80258,2,3,280945,280945,280948,0,3,0
80259,3,1,280948,280948,280949,0,1,0
80260,2,2,280950,280950,280952,0,2,1
80261,1,1,280951,280952,280953,1,2,0
80262,4,1,280955,280955,280956,0,1,2
80263,3,3,280958,280958,280961,0,3,2
80264,5,2,280963,280963,280965,0,2,2
80265,6,2,280969,280969,280971,0,2,4
80266,5,2,280974,280974,280976,0,2,3
80267,6,2,280980,280980,280982,0,2,4
80268,2,2,280982,280982,280984,0,2,0
80269,4,1,280986,280986,280987,0,1,2
80270,5,2,280991,280991,280993,0,2,4
80271,1,1,280992,280993,280994,1,2,0
80272,5,1,280997,280997,280998,0,1,3
80273,2,3,280999,280999,281002,0,3,1
80274,3,3,281002,281002,281005,0,3,0
80275,2,2,281004,281005,281007,1,3,0
80276,2,2,281006,281007,281009,1,3,0
80277,3,1,281009,281009,281010,0,1,0
80278,1,3,281010,281010,281013,0,3,0
80279,2,2,281012,281013,281015,1,3,0
80280,1,2,281013,281015,281017,2,4,0
80281,5,1,281018,281018,281019,0,1,1
80282,4,2,281022,281022,281024,0,2,3
80283,2,2,281024,281024,281026,0,2,0
80284,4,3,281028,281028,281031,0,3,2
80285,6,1,281034,281034,281035,0,1,3
80286,3,3,281037,281037,281040,0,3,2
80287,2,1,281039,281040,281041,1,2,0
80288,5,2,281044,281044,281046,0,2,3
80289,1,3,281045,281046,281049,1,4,0
80290,1,1,281046,281049,281050,3,4,0
80291,1,3,281047,281050,281053,3,6,0
80292,6,2,281053,281053,281055,0,2,0
80293,2,1,281055,281055,281056,0,1,0
80294,6,3,281061,281061,281064,0,3,5
80295,5,3,281066,281066,281069,0,3,2
80296,3,1,281069,281069,281070,0,1,0
80297,4,2,281073,281073,281075,0,2,3
80298,1,3,281074,281075,281078,1,4,0
80299,3,2,281077,281078,281080,1,3,0
80300,2,3,281079,281080,281083,1,4,0
80301,1,3,281080,281083,281086,3,6,0
80302,3,3,281083,281086,281089,3,6,0
80303,6,2,281089,281089,281091,0,2,0
80304,2,2,281091,281091,281093,0,2,0
80305,6,3,281097,281097,281100,0,3,4
80306,2,2,281099,281100,281102,1,3,0
80307,4,1,281103,281103,281104,0,1,1
80308,5,1,281108,281108,281109,0,1,4
80309,5,1,281113,281113,281114,0,1,4
80310,4,3,281117,281117,281120,0,3,3
80311,5,1,281122,281122,281123,0,1,2
80312,6,1,281128,281128,281129,0,1,5
80313,5,1,281133,281133,281134,0,1,4
80314,2,1,281135,281135,281136,0,1,1
80315,3,2,281138,281138,281140,0,2,2
80316,1,2,281139,281140,281142,1,3,0
80317,3,2,281142,281142,281144,0,2,0
80318,1,2,281143,281144,281146,1,3,0
80319,6,3,281149,281149,281152,0,3,3
80320,3,3,281152,281152,281155,0,3,0
80321,2,3,281154,281155,281158,1,4,0
80322,4,3,281158,281158,281161,0,3,0
80323,1,3,281159,281161,281164,2,5,0
80324,6,2,281165,281165,281167,0,2,1
80325,4,3,281169,281169,281172,0,3,2
80326,5,3,281174,281174,281177,0,3,2
80327,4,2,281178,281178,281180,0,2,1
80328,3,2,281181,281181,281183,0,2,1
80329,4,2,281185,281185,281187,0,2,2
80330,5,2,281190,281190,281192,0,2,3
80331,4,2,281194,281194,281196,0,2,2
80332,5,2,281199,281199,281201,0,2,3
80333,5,1,281204,281204,281205,0,1,3
80334,6,2,281210,281210,281212,0,2,5
80335,3,3,281213,281213,281216,0,3,1
80336,1,2,281214,281216,281218,2,4,0
80337,3,1,281217,281218,281219,1,2,0
80338,3,1,281220,281220,281221,0,1,1
80339,5,3,281225,281225,281228,0,3,4
80340,5,1,281230,281230,281231,0,1,2
80341,5,2,281235,281235,281237,0,2,4
80342,1,2,281236,281237,281239,1,3,0
80343,3,1,281239,281239,281240,0,1,0
80344,6,2,281245,281245,281247,0,2,5
80345,4,1,281249,281249,281250,0,1,2
80346,3,1,281252,281252,281253,0,1,2
80347,2,3,281254,281254,281257,0,3,1
80348,1,3,281255,281257,281260,2,5,0
80349,3,2,281258,281260,281262,2,4,0
80350,4,3,281262,281262,281265,0,3,0
80351,2,3,281264,281265,281268,1,4,0
80352,6,3,281270,281270,281273,0,3,2
80353,2,1,281272,281273,281274,1,2,0
80354,4,3,281276,281276,281279,0,3,2
80355,5,1,281281,281281,281282,0,1,2
80356,4,1,281285,281285,281286,0,1,3
80357,5,1,281290,281290,281291,0,1,4
80358,2,2,281292,281292,281294,0,2,1
80359,1,3,281293,281294,281297,1,4,0
80360,6,3,281299,281299,281302,0,3,2
80361,3,1,281302,281302,281303,0,1,0
80362,2,1,281304,281304,281305,0,1,1
80363,5,3,281309,281309,281312,0,3,4
80364,3,3,281312,281312,281315,0,3,0
80365,6,3,281318,281318,281321,0,3,3
80366,4,2,281322,281322,281324,0,2,1
80367,5,2,281327,281327,281329,0,2,3
80368,1,1,281328,281329,281330,1,2,0
80369,4,2,281332,281332,281334,0,2,2
80370,2,2,281334,281334,281336,0,2,0
80371,2,3,281336,281336,281339,0,3,0
80372,5,1,281341,281341,281342,0,1,2
80373,5,2,281346,281346,281348,0,2,4
80374,2,2,281348,281348,281350,0,2,0
80375,6,1,281354,281354,281355,0,1,4
80376,3,1,281357,281357,281358,0,1,2
80377,5,1,281362,281362,281363,0,1,4
80378,4,1,281366,281366,281367,0,1,3
80379,1,2,281367,281367,281369,0,2,0
80380,1,2,281368,281369,281371,1,3,0
80381,2,2,281370,281371,281373,1,3,0
80382,2,2,281372,281373,281375,1,3,0
80383,5,1,281377,281377,281378,0,1,2
80384,6,2,281383,281383,281385,0,2,5
80385,4,1,281387,281387,281388,0,1,2
80386,3,3,281390,281390,281393,0,3,2
80387,5,2,281395,281395,281397,0,2,2
80388,2,2,281397,281397,281399,0,2,0
80389,3,1,281400,281400,281401,0,1,1
80390,5,3,281405,281405,281408,0,3,4
80391,5,3,281410,281410,281413,0,3,2
80392,1,2,281411,281413,281415,2,4,0
80393,5,3,281416,281416,281419,0,3,1
80394,4,3,281420,281420,281423,0,3,1
80395,3,3,281423,281423,281426,0,3,0
80396,2,2,281425,281426,281428,1,3,0
80397,3,3,281428,281428,281431,0,3,0
80398,5,2,281433,281433,281435,0,2,2
80399,4,1,281437,281437,281438,0,1,2
80400,6,3,281443,281443,281446,0,3,5
80401,4,2,281447,281447,281449,0,2,1
80402,2,2,281449,281449,281451,0,2,0
80403,6,3,281455,281455,281458,0,3,4
80404,6,1,281461,281461,281462,0,1,3
80405,6,1,281467,281467,281468,0,1,5
80406,1,3,281468,281468,281471,0,3,0
80407,3,3,281471,281471,281474,0,3,0
80408,1,2,281472,281474,281476,2,4,0
80409,3,1,281475,281476,281477,1,2,0
80410,4,2,281479,281479,281481,0,2,2
80411,2,2,281481,281481,281483,0,2,0
80412,6,2,281487,281487,281489,0,2,4
80413,6,1,281493,281493,281494,0,1,4
80414,2,2,281495,281495,281497,0,2,1
80415,6,2,281501,281501,281503,0,2,4
80416,4,3,281505,281505,281508,0,3,2
80417,1,1,281506,281508,281509,2,3,0
80418,3,2,281509,281509,281511,0,2,0
80419,3,2,281512,281512,281514,0,2,1
80420,5,3,281517,281517,281520,0,3,3
80421,2,3,281519,281520,281523,1,4,0
80422,1,3,281520,281523,281526,3,6,0
80423,1,1,281521,281526,281527,5,6,0
80424,6,2,281527,281527,281529,0,2,0
80425,5,2,281532,281532,281534,0,2,3
80426,6,3,281538,281538,281541,0,3,4
80427,3,1,281541,281541,281542,0,1,0
80428,4,2,281545,281545,281547,0,2,3
80429,2,1,281547,281547,281548,0,1,0
80430,1,1,281548,281548,281549,0,1,0
80431,2,1,281550,281550,281551,0,1,1
80432,3,3,281553,281553,281556,0,3,2
80433,4,1,281557,281557,281558,0,1,1
80434,5,2,281562,281562,281564,0,2,4
80435,4,3,281566,281566,281569,0,3,2
80436,2,1,281568,281569,281570,1,2,0
80437,5,3,281573,281573,281576,0,3,3
80438,5,2,281578,281578,281580,0,2,2
80439,1,2,281579,281580,281582,1,3,0
80440,3,2,281582,281582,281584,0,2,0
80441,5,3,281587,281587,281590,0,3,3
80442,6,2,281593,281593,281595,0,2,3
80443,5,1,281598,281598,281599,0,1,3
80444,2,3,281600,281600,281603,0,3,1
80445,5,2,281605,281605,281607,0,2,2
80446,2,3,281607,281607,281610,0,3,0
80447,1,2,281608,281610,281612,2,4,0
80448,1,3,281609,281612,281615,3,6,0
80449,4,1,281613,281615,281616,2,3,0
80450,5,2,281618,281618,281620,0,2,2
80451,6,3,281624,281624,281627,0,3,4
80452,5,1,281629,281629,281630,0,1,2
80453,2,1,281631,281631,281632,0,1,1
80454,3,3,281634,281634,281637,0,3,2
80455,3,3,281637,281637,281640,0,3,0
80456,2,2,281639,281640,281642,1,3,0
80457,6,1,281645,281645,281646,0,1,3
80458,4,2,281649,281649,281651,0,2,3
80459,4,1,281653,281653,281654,0,1,2
80460,3,2,281656,281656,281658,0,2,2
80461,5,3,281661,281661,281664,0,3,3
80462,5,3,281666,281666,281669,0,3,2
80463,1,2,281667,281669,281671,2,4,0
80464,3,1,281670,281671,281672,1,2,0
80465,4,3,281674,281674,281677,0,3,2
80466,3,3,281677,281677,281680,0,3,0
80467,3,3,281680,281680,281683,0,3,0
80468,5,2,281685,281685,281687,0,2,2
80469,1,2,281686,281687,281689,1,3,0
80470,3,2,281689,281689,281691,0,2,0
80471,3,3,281692,281692,281695,0,3,1
80472,3,1,281695,281695,281696,0,1,0
80473,5,2,281700,281700,281702,0,2,4
80474,2,1,281702,281702,281703,0,1,0
80475,4,2,281706,281706,281708,0,2,3
80476,5,3,281711,281711,281714,0,3,3
80477,3,2,281714,281714,281716,0,2,0
80478,1,2,281715,281716,281718,1,3,0
80479,3,2,281718,281718,281720,0,2,0
80480,1,3,281719,281720,281723,1,4,0
80481,6,3,281725,281725,281728,0,3,2
80482,4,1,281729,281729,281730,0,1,1
80483,5,2,281734,281734,281736,0,2,4
80484,6,3,281740,281740,281743,0,3,4
80485,5,2,281745,281745,281747,0,2,2
80486,6,1,281751,281751,281752,0,1,4
80487,3,3,281754,281754,281757,0,3,2
80488,2,3,281756,281757,281760,1,4,0
80489,6,3,281762,281762,281765,0,3,2
80490,4,2,281766,281766,281768,0,2,1
80491,2,2,281768,281768,281770,0,2,0
80492,4,1,281772,281772,281773,0,1,2
80493,3,1,281775,281775,281776,0,1,2
80494,2,3,281777,281777,281780,0,3,1
80495,6,2,281783,281783,281785,0,2,3
80496,3,1,281786,281786,281787,0,1,1
80497,6,1,281792,281792,281793,0,1,5
80498,4,1,281796,281796,281797,0,1,3
80499,4,2,281800,281800,281802,0,2,3
80500,4,3,281804,281804,281807,0,3,2
80501,3,1,281807,281807,281808,0,1,0
80502,2,1,281809,281809,281810,0,1,1
80503,3,1,281812,281812,281813,0,1,2
80504,1,2,281813,281813,281815,0,2,0
80505,6,2,281819,281819,281821,0,2,4
80506,3,1,281822,281822,281823,0,1,1
80507,3,1,281825,281825,281826,0,1,2
80508,1,2,281826,281826,281828,0,2,0
80509,2,3,281828,281828,281831,0,3,0
80510,1,1,281829,281831,281832,2,3,0
80511,6,2,281835,281835,281837,0,2,3
80512,2,3,281837,281837,281840,0,3,0
80513,6,3,281843,281843,281846,0,3,3
80514,1,3,281844,281846,281849,2,5,0
80515,1,2,281845,281849,281851,4,6,0
80516,2,3,281847,281851,281854,4,7,0
80517,6,1,281853,281854,281855,1,2,0
80518,3,1,281856,281856,281857,0,1,1
80519,4,1,281860,281860,281861,0,1,3
80520,4,3,281864,281864,281867,0,3,3
80521,6,1,281870,281870,281871,0,1,3
80522,5,1,281875,281875,281876,0,1,4
80523,1,2,281876,281876,281878,0,2,0
80524,1,3,281877,281878,281881,1,4,0
80525,5,2,281882,281882,281884,0,2,1
80526,3,1,281885,281885,281886,0,1,1
80527,2,1,281887,281887,281888,0,1,1
80528,5,2,281892,281892,281894,0,2,4
80529,6,3,281898,281898,281901,0,3,4
80530,1,2,281899,281901,281903,2,4,0
80531,2,2,281901,281903,281905,2,4,0
80532,1,2,281902,281905,281907,3,5,0
80533,1,3,281903,281907,281910,4,7,0
80534,2,2,281905,281910,281912,5,7,0
80535,6,1,281911,281912,281913,1,2,0
80536,4,2,281915,281915,281917,0,2,2
80537,2,1,281917,281917,281918,0,1,0
80538,5,2,281922,281922,281924,0,2,4
80539,3,2,281925,281925,281927,0,2,1
80540,6,2,281931,281931,281933,0,2,4
80541,3,1,281934,281934,281935,0,1,1
80542,2,2,281936,281936,281938,0,2,1
80543,4,3,281940,281940,281943,0,3,2
80544,1,1,281941,281943,281944,2,3,0
80545,4,1,281945,281945,281946,0,1,1
80546,3,2,281948,281948,281950,0,2,2
80547,3,2,281951,281951,281953,0,2,1
80548,2,3,281953,281953,281956,0,3,0
80549,3,2,281956,281956,281958,0,2,0
80550,6,3,281962,281962,281965,0,3,4
80551,2,3,281964,281965,281968,1,4,0
80552,2,3,281966,281968,281971,2,5,0
80553,4,2,281970,281971,281973,1,3,0
80554,5,3,281975,281975,281978,0,3,2
80555,5,2,281980,281980,281982,0,2,2
80556,3,3,281983,281983,281986,0,3,1
80557,1,1,281984,281986,281987,2,3,0
80558,4,1,281988,281988,281989,0,1,1
80559,5,1,281993,281993,281994,0,1,4
80560,2,3,281995,281995,281998,0,3,1
80561,6,2,282001,282001,282003,0,2,3
80562,1,1,282002,282003,282004,1,2,0
80563,3,3,282005,282005,282008,0,3,1
80564,1,2,282006,282008,282010,2,4,0
80565,1,2,282007,282010,282012,3,5,0
80566,6,2,282013,282013,282015,0,2,1
80567,1,1,282014,282015,282016,1,2,0
80568,5,3,282019,282019,282022,0,3,3
80569,3,2,282022,282022,282024,0,2,0
80570,1,1,282023,282024,282025,1,2,0
80571,1,1,282024,282025,282026,1,2,0
80572,6,1,282030,282030,282031,0,1,4
80573,1,1,282031,282031,282032,0,1,0
80574,5,3,282036,282036,282039,0,3,4
80575,4,1,282040,282040,282041,0,1,1
80576,5,1,282045,282045,282046,0,1,4
80577,2,1,282047,282047,282048,0,1,1
80578,6,2,282053,282053,282055,0,2,5
80579,5,1,282058,282058,282059,0,1,3
80580,3,2,282061,282061,282063,0,2,2
80581,4,1,282065,282065,282066,0,1,2
80582,3,2,282068,282068,282070,0,2,2
80583,3,3,282071,282071,282074,0,3,1
80584,2,3,282073,282074,282077,1,4,0
80585,2,2,282075,282077,282079,2,4,0
80586,4,2,282079,282079,282081,0,2,0
80587,4,3,282083,282083,282086,0,3,2
80588,6,1,282089,282089,282090,0,1,3
80589,2,1,282091,282091,282092,0,1,1
80590,1,3,282092,282092,282095,0,3,0
80591,1,3,282093,282095,282098,2,5,0
80592,4,2,282097,282098,282100,1,3,0
80593,6,3,282103,282103,282106,0,3,3
80594,5,1,282108,282108,282109,0,1,2
80595,3,3,282111,282111,282114,0,3,2
80596,6,2,282117,282117,282119,0,2,3
80597,6,2,282123,282123,282125,0,2,4
80598,6,3,282129,282129,282132,0,3,4
80599,4,3,282133,282133,282136,0,3,1
80600,3,1,282136,282136,282137,0,1,0
80601,4,2,282140,282140,282142,0,2,3
80602,4,1,282144,282144,282145,0,1,2
80603,1,3,282145,282145,282148,0,3,0
80604,3,3,282148,282148,282151,0,3,0
80605,1,2,282149,282151,282153,2,4,0
80606,6,3,282155,282155,282158,0,3,2
80607,6,1,282161,282161,282162,0,1,3
80608,3,2,282164,282164,282166,0,2,2
80609,6,1,282170,282170,282171,0,1,4
80610,1,1,282171,282171,282172,0,1,0
80611,5,1,282176,282176,282177,0,1,4
80612,3,2,282179,282179,282181,0,2,2
80613,6,2,282185,282185,282187,0,2,4
80614,2,2,282187,282187,282189,0,2,0
80615,5,1,282192,282192,282193,0,1,3
80616,5,3,282197,282197,282200,0,3,4
80617,2,1,282199,282200,282201,1,2,0
80618,3,2,282202,282202,282204,0,2,1
80619,4,3,282206,282206,282209,0,3,2
80620,6,3,282212,282212,282215,0,3,3
80621,5,2,282217,282217,282219,0,2,2
80622,4,2,282221,282221,282223,0,2,2
80623,1,1,282222,282223,282224,1,2,0
80624,1,2,282223,282224,282226,1,3,0
80625,5,2,282228,282228,282230,0,2,2
80626,4,3,282232,282232,282235,0,3,2
80627,3,3,282235,282235,282238,0,3,0
80628,4,1,282239,282239,282240,0,1,1
80629,3,2,282242,282242,282244,0,2,2
80630,6,1,282248,282248,282249,0,1,4
80631,1,3,282249,282249,282252,0,3,0
80632,4,3,282253,282253,282256,0,3,1
80633,4,2,282257,282257,282259,0,2,1
80634,2,1,282259,282259,282260,0,1,0
80635,2,1,282261,282261,282262,0,1,1
80636,3,2,282264,282264,282266,0,2,2
80637,6,3,282270,282270,282273,0,3,4
80638,2,1,282272,282273,282274,1,2,0
80639,1,2,282273,282274,282276,1,3,0
80640,6,2,282279,282279,282281,0,2,3
80641,5,2,282284,282284,282286,0,2,3
80642,2,3,282286,282286,282289,0,3,0
80643,2,1,282288,282289,282290,1,2,0
80644,2,3,282290,282290,282293,0,3,0
80645,3,1,282293,282293,282294,0,1,0
80646,6,3,282299,282299,282302,0,3,5
80647,4,1,282303,282303,282304,0,1,1
80648,2,1,282305,282305,282306,0,1,1
80649,3,2,282308,282308,282310,0,2,2
80650,2,2,282310,282310,282312,0,2,0
80651,5,2,282315,282315,282317,0,2,3
80652,2,3,282317,282317,282320,0,3,0
80653,1,2,282318,282320,282322,2,4,0
80654,2,1,282320,282322,282323,2,3,0
80655,6,2,282326,282326,282328,0,2,3
80656,3,2,282329,282329,282331,0,2,1
80657,3,2,282332,282332,282334,0,2,1
80658,6,1,282338,282338,282339,0,1,4
80659,6,3,282344,282344,282347,0,3,5
80660,6,2,282350,282350,282352,0,2,3
80661,6,3,282356,282356,282359,0,3,4
80662,5,2,282361,282361,282363,0,2,2
80663,5,3,282366,282366,282369,0,3,3
80664,3,2,282369,282369,282371,0,2,0
80665,3,2,282372,282372,282374,0,2,1
80666,2,2,282374,282374,282376,0,2,0
80667,5,2,282379,282379,282381,0,2,3
80668,1,2,282380,282381,282383,1,3,0
80669,5,3,282385,282385,282388,0,3,2
80670,3,3,282388,282388,282391,0,3,0
80671,3,3,282391,282391,282394,0,3,0
80672,3,3,282394,282394,282397,0,3,0
80673,4,1,282398,282398,282399,0,1,1
80674,5,1,282403,282403,282404,0,1,4
80675,5,1,282408,282408,282409,0,1,4
80676,5,1,282413,282413,282414,0,1,4
80677,6,3,282419,282419,282422,0,3,5
80678,1,2,282420,282422,282424,2,4,0
80679,4,1,282424,282424,282425,0,1,0
80680,6,2,282430,282430,282432,0,2,5
80681,3,2,282433,282433,282435,0,2,1
80682,1,3,282434,282435,282438,1,4,0
80683,4,1,282438,282438,282439,0,1,0
80684,6,1,282444,282444,282445,0,1,5
80685,6,3,282450,282450,282453,0,3,5
80686,4,2,282454,282454,282456,0,2,1
80687,5,1,282459,282459,282460,0,1,3
80688,3,3,282462,282462,282465,0,3,2
80689,5,2,282467,282467,282469,0,2,2
80690,1,2,282468,282469,282471,1,3,0
80691,4,3,282472,282472,282475,0,3,1
80692,4,3,282476,282476,282479,0,3,1
80693,6,3,282482,282482,282485,0,3,3
80694,5,2,282487,282487,282489,0,2,2
80695,6,1,282493,282493,282494,0,1,4
80696,3,3,282496,282496,282499,0,3,2
80697,3,1,282499,282499,282500,0,1,0
80698,4,2,282503,282503,282505,0,2,3
80699,4,3,282507,282507,282510,0,3,2
80700,1,1,282508,282510,282511,2,3,0
80701,1,3,282509,282511,282514,2,5,0
80702,6,3,282515,282515,282518,0,3,1
80703,3,3,282518,282518,282521,0,3,0
80704,4,2,282522,282522,282524,0,2,1
80705,2,2,282524,282524,282526,0,2,0
80706,3,3,282527,282527,282530,0,3,1
80707,6,3,282533,282533,282536,0,3,3
80708,6,1,282539,282539,282540,0,1,3
80709,6,3,282545,282545,282548,0,3,5
80710,3,2,282548,282548,282550,0,2,0
80711,4,1,282552,282552,282553,0,1,2
80712,3,1,282555,282555,282556,0,1,2
80713,1,1,282556,282556,282557,0,1,0
80714,2,2,282558,282558,282560,0,2,1
80715,6,3,282564,282564,282567,0,3,4
80716,1,1,282565,282567,282568,2,3,0
80717,5,3,282570,282570,282573,0,3,2
80718,5,3,282575,282575,282578,0,3,2
80719,3,3,282578,282578,282581,0,3,0
80720,5,3,282583,282583,282586,0,3,2
80721,3,2,282586,282586,282588,0,2,0
80722,4,3,282590,282590,282593,0,3,2
80723,6,3,282596,282596,282599,0,3,3
80724,4,2,282600,282600,282602,0,2,1
80725,2,1,282602,282602,282603,0,1,0
80726,4,3,282606,282606,282609,0,3,3
80727,1,3,282607,282609,282612,2,5,0
80728,2,3,282609,282612,282615,3,6,0
80729,6,3,282615,282615,282618,0,3,0
80730,3,2,282618,282618,282620,0,2,0
80731,2,3,282620,282620,282623,0,3,0
80732,2,1,282622,282623,282624,1,2,0
80733,2,3,282624,282624,282627,0,3,0
80734,3,1,282627,282627,282628,0,1,0
80735,3,3,282630,282630,282633,0,3,2
80736,4,2,282634,282634,282636,0,2,1
80737,2,1,282636,282636,282637,0,1,0
80738,4,3,282640,282640,282643,0,3,3
80739,3,3,282643,282643,282646,0,3,0
80740,4,3,282647,282647,282650,0,3,1
80741,5,3,282652,282652,282655,0,3,2
80742,4,2,282656,282656,282658,0,2,1
80743,6,2,282662,282662,282664,0,2,4
80744,1,2,282663,282664,282666,1,3,0
80745,6,2,282669,282669,282671,0,2,3
80746,6,2,282675,282675,282677,0,2,4
80747,2,2,282677,282677,282679,0,2,0
80748,5,3,282682,282682,282685,0,3,3
80749,3,2,282685,282685,282687,0,2,0
80750,2,1,282687,282687,282688,0,1,0
80751,6,2,282693,282693,282695,0,2,5
80752,1,1,282694,282695,282696,1,2,0
80753,4,1,282698,282698,282699,0,1,2
80754,6,3,282704,282704,282707,0,3,5
80755,3,2,282707,282707,282709,0,2,0
80756,6,2,282713,282713,282715,0,2,4
80757,6,1,282719,282719,282720,0,1,4
80758,2,1,282721,282721,282722,0,1,1
80759,4,1,282725,282725,282726,0,1,3
80760,5,1,282730,282730,282731,0,1,4
80761,2,2,282732,282732,282734,0,2,1
80762,6,1,282738,282738,282739,0,1,4
80763,3,3,282741,282741,282744,0,3,2
80764,6,2,282747,282747,282749,0,2,3
80765,6,2,282753,282753,282755,0,2,4
80766,3,1,282756,282756,282757,0,1,1
80767,1,3,282757,282757,282760,0,3,0
80768,6,3,282763,282763,282766,0,3,3
80769,3,1,282766,282766,282767,0,1,0
80770,5,1,282771,282771,282772,0,1,4
80771,6,1,282777,282777,282778,0,1,5
80772,4,1,282781,282781,282782,0,1,3
80773,4,3,282785,282785,282788,0,3,3
80774,5,3,282790,282790,282793,0,3,2
80775,4,3,282794,282794,282797,0,3,1
80776,6,3,282800,282800,282803,0,3,3
80777,3,2,282803,282803,282805,0,2,0
80778,5,3,282808,282808,282811,0,3,3
80779,5,3,282813,282813,282816,0,3,2
80780,2,2,282815,282816,282818,1,3,0
80781,4,1,282819,282819,282820,0,1,1
80782,5,1,282824,282824,282825,0,1,4
80783,3,3,282827,282827,282830,0,3,2
80784,2,2,282829,282830,282832,1,3,0
80785,2,1,282831,282832,282833,1,2,0
80786,4,1,282835,282835,282836,0,1,2
80787,5,1,282840,282840,282841,0,1,4
80788,6,1,282846,282846,282847,0,1,5
80789,6,1,282852,282852,282853,0,1,5
80790,4,1,282856,282856,282857,0,1,3
80791,6,3,282862,282862,282865,0,3,5
80792,3,2,282865,282865,282867,0,2,0
80793,2,2,282867,282867,282869,0,2,0
80794,2,1,282869,282869,282870,0,1,0
80795,3,2,282872,282872,282874,0,2,2
80796,2,3,282874,282874,282877,0,3,0
80797,3,2,282877,282877,282879,0,2,0
80798,5,3,282882,282882,282885,0,3,3
80799,3,3,282885,282885,282888,0,3,0
80800,4,2,282889,282889,282891,0,2,1
80801,4,2,282893,282893,282895,0,2,2
80802,1,3,282894,282895,282898,1,4,0
80803,5,3,282899,282899,282902,0,3,1
80804,1,2,282900,282902,282904,2,4,0
80805,3,1,282903,282904,282905,1,2,0
80806,2,1,282905,282905,282906,0,1,0
80807,3,3,282908,282908,282911,0,3,2
80808,3,3,282911,282911,282914,0,3,0
80809,4,3,282915,282915,282918,0,3,1
80810,2,3,282917,282918,282921,1,4,0
80811,4,2,282921,282921,282923,0,2,0
80812,4,3,282925,282925,282928,0,3,2
80813,2,1,282927,282928,282929,1,2,0
80814,3,1,282930,282930,282931,0,1,1
80815,3,3,282933,282933,282936,0,3,2
80816,1,2,282934,282936,282938,2,4,0
80817,2,1,282936,282938,282939,2,3,0
80818,2,3,282938,282939,282942,1,4,0
80819,2,3,282940,282942,282945,2,5,0
80820,4,3,282944,282945,282948,1,4,0
80821,1,3,282945,282948,282951,3,6,0
80822,4,3,282949,282951,282954,2,5,0
80823,6,3,282955,282955,282958,0,3,1
80824,1,1,282956,282958,282959,2,3,0
80825,2,2,282958,282959,282961,1,3,0
80826,3,3,282961,282961,282964,0,3,0
80827,1,3,282962,282964,282967,2,5,0
80828,5,1,282967,282967,282968,0,1,0
80829,1,2,282968,282968,282970,0,2,0
80830,1,3,282969,282970,282973,1,4,0
80831,2,2,282971,282973,282975,2,4,0
80832,1,3,282972,282975,282978,3,6,0
80833,1,2,282973,282978,282980,5,7,0
80834,1,3,282974,282980,282983,6,9,0
80835,5,2,282979,282983,282985,4,6,0
80836,3,1,282982,282985,282986,3,4,0
80837,3,3,282985,282986,282989,1,4,0
80838,6,3,282991,282991,282994,0,3,2
80839,2,1,282993,282994,282995,1,2,0
80840,5,1,282998,282998,282999,0,1,3
80841,6,1,283004,283004,283005,0,1,5
80842,5,2,283009,283009,283011,0,2,4
80843,5,1,283014,283014,283015,0,1,3
80844,6,1,283020,283020,283021,0,1,5
80845,4,1,283024,283024,283025,0,1,3
80846,3,2,283027,283027,283029,0,2,2
80847,2,1,283029,283029,283030,0,1,0
80848,6,2,283035,283035,283037,0,2,5
80849,6,2,283041,283041,283043,0,2,4
80850,2,1,283043,283043,283044,0,1,0
80851,3,2,283046,283046,283048,0,2,2
80852,3,1,283049,283049,283050,0,1,1
80853,5,2,283054,283054,283056,0,2,4
80854,3,2,283057,283057,283059,0,2,1
80855,5,2,283062,283062,283064,0,2,3
80856,1,1,283063,283064,283065,1,2,0
80857,5,3,283068,283068,283071,0,3,3
80858,6,3,283074,283074,283077,0,3,3
80859,2,1,283076,283077,283078,1,2,0
80860,2,2,283078,283078,283080,0,2,0
80861,3,2,283081,283081,283083,0,2,1
80862,1,1,283082,283083,283084,1,2,0
80863,3,1,283085,283085,283086,0,1,1
80864,5,2,283090,283090,283092,0,2,4
80865,3,1,283093,283093,283094,0,1,1
80866,6,3,283099,283099,283102,0,3,5
80867,5,2,283104,283104,283106,0,2,2
80868,3,2,283107,283107,283109,0,2,1
80869,6,2,283113,283113,283115,0,2,4
80870,6,2,283119,283119,283121,0,2,4
80871,2,2,283121,283121,283123,0,2,0
80872,1,1,283122,283123,283124,1,2,0
80873,3,3,283125,283125,283128,0,3,1
80874,6,3,283131,283131,283134,0,3,3
80875,6,2,283137,283137,283139,0,2,3
80876,3,1,283140,283140,283141,0,1,1
80877,1,2,283141,283141,283143,0,2,0
80878,1,3,283142,283143,283146,1,4,0
80879,1,2,283143,283146,283148,3,5,0
80880,1,3,283144,283148,283151,4,7,0
80881,6,2,283150,283151,283153,1,3,0
80882,2,1,283152,283153,283154,1,2,0
80883,6,2,283158,283158,283160,0,2,4
80884,6,2,283164,283164,283166,0,2,4
80885,5,2,283169,283169,283171,0,2,3
80886,3,3,283172,283172,283175,0,3,1
80887,6,2,283178,283178,283180,0,2,3
80888,1,3,283179,283180,283183,1,4,0
80889,3,3,283182,283183,283186,1,4,0
80890,3,3,283185,283186,283189,1,4,0
80891,1,3,283186,283189,283192,3,6,0
80892,6,1,283192,283192,283193,0,1,0
80893,6,2,283198,283198,283200,0,2,5
80894,6,3,283204,283204,283207,0,3,4
80895,6,2,283210,283210,283212,0,2,3
80896,6,1,283216,283216,283217,0,1,4
80897,5,1,283221,283221,283222,0,1,4
80898,3,3,283224,283224,283227,0,3,2
80899,3,3,283227,283227,283230,0,3,0
80900,1,2,283228,283230,283232,2,4,0
80901,3,2,283231,283232,283234,1,3,0
80902,4,1,283235,283235,283236,0,1,1
80903,6,3,283241,283241,283244,0,3,5
80904,4,1,283245,283245,283246,0,1,1
80905,1,1,283246,283246,283247,0,1,0
80906,6,2,283252,283252,283254,0,2,5
80907,3,3,283255,283255,283258,0,3,1
80908,6,2,283261,283261,283263,0,2,3
80909,4,1,283265,283265,283266,0,1,2
80910,3,1,283268,283268,283269,0,1,2
80911,5,1,283273,283273,283274,0,1,4
80912,2,1,283275,283275,283276,0,1,1
80913,1,2,283276,283276,283278,0,2,0
80914,3,3,283279,283279,283282,0,3,1
80915,5,1,283284,283284,283285,0,1,2
80916,5,2,283289,283289,283291,0,2,4
80917,3,1,283292,283292,283293,0,1,1
80918,4,2,283296,283296,283298,0,2,3
80919,6,3,283302,283302,283305,0,3,4
80920,6,1,283308,283308,283309,0,1,3
80921,1,3,283309,283309,283312,0,3,0
80922,6,1,283315,283315,283316,0,1,3
80923,5,3,283320,283320,283323,0,3,4
80924,1,3,283321,283323,283326,2,5,0
80925,4,2,283325,283326,283328,1,3,0
80926,2,1,283327,283328,283329,1,2,0
80927,3,2,283330,283330,283332,0,2,1
80928,3,1,283333,283333,283334,0,1,1
80929,3,3,283336,283336,283339,0,3,2
80930,3,1,283339,283339,283340,0,1,0
80931,2,1,283341,283341,283342,0,1,1
80932,4,1,283345,283345,283346,0,1,3
80933,2,2,283347,283347,283349,0,2,1
80934,6,1,283353,283353,283354,0,1,4
80935,4,2,283357,283357,283359,0,2,3
80936,1,3,283358,283359,283362,1,4,0
80937,3,2,283361,283362,283364,1,3,0
80938,1,1,283362,283364,283365,2,3,0
80939,4,2,283366,283366,283368,0,2,1
80940,1,2,283367,283368,283370,1,3,0
80941,5,3,283372,283372,283375,0,3,2
80942,3,2,283375,283375,283377,0,2,0
80943,3,2,283378,283378,283380,0,2,1
80944,5,2,283383,283383,283385,0,2,3
80945,1,3,283384,283385,283388,1,4,0
80946,6,3,283390,283390,283393,0,3,2
80947,4,2,283394,283394,283396,0,2,1
80948,1,2,283395,283396,283398,1,3,0
80949,3,1,283398,283398,283399,0,1,0
80950,6,3,283404,283404,283407,0,3,5
80951,6,3,283410,283410,283413,0,3,3
80952,5,1,283415,283415,283416,0,1,2
80953,2,2,283417,283417,283419,0,2,1
80954,2,1,283419,283419,283420,0,1,0
80955,3,3,283422,283422,283425,0,3,2
80956,6,2,283428,283428,283430,0,2,3
80957,3,3,283431,283431,283434,0,3,1
80958,1,2,283432,283434,283436,2,4,0
80959,4,1,283436,283436,283437,0,1,0
80960,4,2,283440,283440,283442,0,2,3
80961,3,2,283443,283443,283445,0,2,1
80962,4,2,283447,283447,283449,0,2,2
80963,6,2,283453,283453,283455,0,2,4
80964,3,1,283456,283456,283457,0,1,1
80965,3,2,283459,283459,283461,0,2,2
80966,3,1,283462,283462,283463,0,1,1
80967,1,2,283463,283463,283465,0,2,0
80968,5,3,283468,283468,283471,0,3,3
80969,4,1,283472,283472,283473,0,1,1
80970,6,2,283478,283478,283480,0,2,5
80971,3,3,283481,283481,283484,0,3,1
80972,5,3,283486,283486,283489,0,3,2
80973,5,3,283491,283491,283494,0,3,2
80974,3,1,283494,283494,283495,0,1,0
80975,3,1,283497,283497,283498,0,1,2
80976,4,3,283501,283501,283504,0,3,3
80977,3,2,283504,283504,283506,0,2,0
80978,4,3,283508,283508,283511,0,3,2
80979,4,1,283512,283512,283513,0,1,1
80980,1,2,283513,283513,283515,0,2,0
80981,3,3,283516,283516,283519,0,3,1
80982,6,3,283522,283522,283525,0,3,3
80983,2,3,283524,283525,283528,1,4,0
80984,2,1,283526,283528,283529,2,3,0
80985,5,3,283531,283531,283534,0,3,2
80986,6,2,283537,283537,283539,0,2,3
80987,5,2,283542,283542,283544,0,2,3
80988,4,3,283546,283546,283549,0,3,2
80989,6,2,283552,283552,283554,0,2,3
80990,6,1,283558,283558,283559,0,1,4
80991,4,1,283562,283562,283563,0,1,3
80992,1,2,283563,283563,283565,0,2,0
80993,4,2,283567,283567,283569,0,2,2
80994,2,3,283569,283569,283572,0,3,0
80995,6,1,283575,283575,283576,0,1,3
80996,5,3,283580,283580,283583,0,3,4
80997,3,3,283583,283583,283586,0,3,0
80998,4,1,283587,283587,283588,0,1,1
80999,4,2,283591,283591,283593,0,2,3
81000,1,2,283592,283593,283595,1,3,0
81001,2,3,283594,283595,283598,1,4,0
81002,6,3,283600,283600,283603,0,3,2
81003,3,2,283603,283603,283605,0,2,0
81004,6,2,283609,283609,283611,0,2,4
81005,4,3,283613,283613,283616,0,3,2
81006,5,2,283618,283618,283620,0,2,2
81007,6,1,283624,283624,283625,0,1,4
81008,5,1,283629,283629,283630,0,1,4
81009,6,2,283635,283635,283637,0,2,5
81010,5,1,283640,283640,283641,0,1,3
81011,5,1,283645,283645,283646,0,1,4
81012,2,1,283647,283647,283648,0,1,1
81013,3,3,283650,283650,283653,0,3,2
81014,6,3,283656,283656,283659,0,3,3
81015,5,2,283661,283661,283663,0,2,2
81016,1,1,283662,283663,283664,1,2,0
81017,1,2,283663,283664,283666,1,3,0
81018,6,2,283669,283669,283671,0,2,3
81019,6,2,283675,283675,283677,0,2,4
81020,2,2,283677,283677,283679,0,2,0
81021,5,2,283682,283682,283684,0,2,3
81022,1,3,283683,283684,283687,1,4,0
81023,2,1,283685,283687,283688,2,3,0
81024,2,1,283687,283688,283689,1,2,0
81025,2,2,283689,283689,283691,0,2,0
81026,1,3,283690,283691,283694,1,4,0
81027,1,2,283691,283694,283696,3,5,0
81028,4,3,283695,283696,283699,1,4,0
81029,6,1,283701,283701,283702,0,1,2
81030,2,3,283703,283703,283706,0,3,1
81031,1,1,283704,283706,283707,2,3,0
81032,1,3,283705,283707,283710,2,5,0
81033,1,3,283706,283710,283713,4,7,0
81034,3,3,283709,283713,283716,4,7,0
81035,2,3,283711,283716,283719,5,8,0
81036,5,2,283716,283719,283721,3,5,0
81037,6,2,283722,283722,283724,0,2,1
81038,2,3,283724,283724,283727,0,3,0
81039,2,2,283726,283727,283729,1,3,0
81040,4,2,283730,283730,283732,0,2,1
81041,6,2,283736,283736,283738,0,2,4
81042,5,3,283741,283741,283744,0,3,3
81043,4,3,283745,283745,283748,0,3,1
81044,5,2,283750,283750,283752,0,2,2
81045,5,1,283755,283755,283756,0,1,3
81046,1,2,283756,283756,283758,0,2,0
81047,2,3,283758,283758,283761,0,3,0
81048,1,3,283759,283761,283764,2,5,0
81049,2,1,283761,283764,283765,3,4,0
81050,3,1,283764,283765,283766,1,2,0
81051,6,3,283770,283770,283773,0,3,4
81052,1,3,283771,283773,283776,2,5,0
81053,1,3,283772,283776,283779,4,7,0
81054,4,2,283776,283779,283781,3,5,0
81055,2,2,283778,283781,283783,3,5,0
81056,4,2,283782,283783,283785,1,3,0
81057,4,1,283786,283786,283787,0,1,1
81058,4,1,283790,283790,283791,0,1,3
81059,1,3,283791,283791,283794,0,3,0
81060,3,1,283794,283794,283795,0,1,0
81061,2,3,283796,283796,283799,0,3,1
81062,6,1,283802,283802,283803,0,1,3
81063,6,3,283808,283808,283811,0,3,5
81064,3,3,283811,283811,283814,0,3,0
81065,6,1,283817,283817,283818,0,1,3
81066,2,3,283819,283819,283822,0,3,1
81067,5,2,283824,283824,283826,0,2,2
81068,6,3,283830,283830,283833,0,3,4
81069,5,2,283835,283835,283837,0,2,2
81070,5,3,283840,283840,283843,0,3,3
81071,6,1,283846,283846,283847,0,1,3
81072,2,2,283848,283848,283850,0,2,1
81073,5,1,283853,283853,283854,0,1,3
81074,2,1,283855,283855,283856,0,1,1
81075,1,1,283856,283856,283857,0,1,0
81076,1,1,283857,283857,283858,0,1,0
81077,2,3,283859,283859,283862,0,3,1
81078,6,3,283865,283865,283868,0,3,3
81079,3,1,283868,283868,283869,0,1,0
81080,1,3,283869,283869,283872,0,3,0
81081,5,2,283874,283874,283876,0,2,2
81082,4,1,283878,283878,283879,0,1,2
81083,5,1,283883,283883,283884,0,1,4
81084,3,3,283886,283886,283889,0,3,2
81085,2,2,283888,283889,283891,1,3,0
81086,5,2,283893,283893,283895,0,2,2
81087,2,3,283895,283895,283898,0,3,0
81088,4,3,283899,283899,283902,0,3,1
81089,5,2,283904,283904,283906,0,2,2
81090,2,2,283906,283906,283908,0,2,0
81091,2,1,283908,283908,283909,0,1,0
81092,5,2,283913,283913,283915,0,2,4
81093,4,2,283917,283917,283919,0,2,2
81094,1,1,283918,283919,283920,1,2,0
81095,5,1,283923,283923,283924,0,1,3
81096,1,2,283924,283924,283926,0,2,0
81097,2,1,283926,283926,283927,0,1,0
81098,1,2,283927,283927,283929,0,2,0
81099,5,2,283932,283932,283934,0,2,3
81100,4,2,283936,283936,283938,0,2,2
81101,1,2,283937,283938,283940,1,3,0
81102,3,2,283940,283940,283942,0,2,0
81103,3,3,283943,283943,283946,0,3,1
81104,2,1,283945,283946,283947,1,2,0
81105,4,1,283949,283949,283950,0,1,2
81106,6,2,283955,283955,283957,0,2,5
81107,6,3,283961,283961,283964,0,3,4
81108,6,3,283967,283967,283970,0,3,3
81109,3,1,283970,283970,283971,0,1,0
81110,5,1,283975,283975,283976,0,1,4
81111,2,1,283977,283977,283978,0,1,1
81112,3,3,283980,283980,283983,0,3,2
81113,6,1,283986,283986,283987,0,1,3
81114,2,1,283988,283988,283989,0,1,1
81115,3,2,283991,283991,283993,0,2,2
81116,4,1,283995,283995,283996,0,1,2
81117,4,2,283999,283999,284001,0,2,3
81118,1,1,284000,284001,284002,1,2,0
81119,2,3,284002,284002,284005,0,3,0
81120,3,1,284005,284005,284006,0,1,0
81121,4,2,284009,284009,284011,0,2,3
81122,6,3,284015,284015,284018,0,3,4
81123,4,2,284019,284019,284021,0,2,1
81124,1,3,284020,284021,284024,1,4,0
81125,2,3,284022,284024,284027,2,5,0
81126,3,1,284025,284027,284028,2,3,0
81127,4,1,284029,284029,284030,0,1,1
81128,3,3,284032,284032,284035,0,3,2
81129,3,2,284035,284035,284037,0,2,0
81130,6,2,284041,284041,284043,0,2,4
81131,3,3,284044,284044,284047,0,3,1
81132,6,3,284050,284050,284053,0,3,3
81133,5,2,284055,284055,284057,0,2,2
81134,4,3,284059,284059,284062,0,3,2
81135,3,3,284062,284062,284065,0,3,0
81136,2,3,284064,284065,284068,1,4,0
81137,4,3,284068,284068,284071,0,3,0
81138,2,1,284070,284071,284072,1,2,0
81139,4,1,284074,284074,284075,0,1,2
81140,4,2,284078,284078,284080,0,2,3
81141,2,2,284080,284080,284082,0,2,0
81142,4,1,284084,284084,284085,0,1,2
81143,3,3,284087,284087,284090,0,3,2
81144,6,3,284093,284093,284096,0,3,3
81145,6,2,284099,284099,284101,0,2,3
81146,5,1,284104,284104,284105,0,1,3
81147,2,3,284106,284106,284109,0,3,1
81148,6,3,284112,284112,284115,0,3,3
81149,2,2,284114,284115,284117,1,3,0
81150,1,2,284115,284117,284119,2,4,0
81151,5,2,284120,284120,284122,0,2,1
81152,6,3,284126,284126,284129,0,3,4
81153,5,1,284131,284131,284132,0,1,2
81154,6,3,284137,284137,284140,0,3,5
81155,6,2,284143,284143,284145,0,2,3
81156,6,3,284149,284149,284152,0,3,4
81157,2,1,284151,284152,284153,1,2,0
81158,2,1,284153,284153,284154,0,1,0
81159,6,3,284159,284159,284162,0,3,5
81160,4,2,284163,284163,284165,0,2,1
81161,5,3,284168,284168,284171,0,3,3
81162,4,1,284172,284172,284173,0,1,1
81163,6,1,284178,284178,284179,0,1,5
81164,4,2,284182,284182,284184,0,2,3
81165,3,1,284185,284185,284186,0,1,1
81166,2,3,284187,284187,284190,0,3,1
81167,5,1,284192,284192,284193,0,1,2
81168,4,1,284196,284196,284197,0,1,3
81169,6,1,284202,284202,284203,0,1,5
81170,6,1,284208,284208,284209,0,1,5
81171,6,1,284214,284214,284215,0,1,5
81172,3,1,284217,284217,284218,0,1,2
81173,3,3,284220,284220,284223,0,3,2
81174,1,2,284221,284223,284225,2,4,0
81175,4,3,284225,284225,284228,0,3,0
81176,2,1,284227,284228,284229,1,2,0
81177,2,1,284229,284229,284230,0,1,0
81178,2,2,284231,284231,284233,0,2,1
81179,6,1,284237,284237,284238,0,1,4
81180,5,2,284242,284242,284244,0,2,4
81181,6,2,284248,284248,284250,0,2,4
81182,2,2,284250,284250,284252,0,2,0
81183,2,3,284252,284252,284255,0,3,0
81184,5,3,284257,284257,284260,0,3,2
81185,6,2,284263,284263,284265,0,2,3
81186,3,3,284266,284266,284269,0,3,1
81187,4,1,284270,284270,284271,0,1,1
81188,1,2,284271,284271,284273,0,2,0
81189,4,3,284275,284275,284278,0,3,2
81190,3,1,284278,284278,284279,0,1,0
81191,4,1,284282,284282,284283,0,1,3
81192,1,1,284283,284283,284284,0,1,0
81193,6,2,284289,284289,284291,0,2,5
81194,6,2,284295,284295,284297,0,2,4
81195,4,3,284299,284299,284302,0,3,2
81196,1,2,284300,284302,284304,2,4,0
81197,1,3,284301,284304,284307,3,6,0
81198,3,3,284304,284307,284310,3,6,0
81199,5,1,284309,284310,284311,1,2,0
81200,4,1,284313,284313,284314,0,1,2
81201,2,3,284315,284315,284318,0,3,1
81202,4,3,284319,284319,284322,0,3,1
81203,3,1,284322,284322,284323,0,1,0
81204,3,3,284325,284325,284328,0,3,2
81205,4,1,284329,284329,284330,0,1,1
81206,4,3,284333,284333,284336,0,3,3
81207,6,1,284339,284339,284340,0,1,3
81208,1,3,284340,284340,284343,0,3,0
81209,1,1,284341,284343,284344,2,3,0
81210,6,3,284347,284347,284350,0,3,3
81211,4,2,284351,284351,284353,0,2,1
81212,1,3,284352,284353,284356,1,4,0
81213,4,1,284356,284356,284357,0,1,0
81214,2,2,284358,284358,284360,0,2,1
81215,4,2,284362,284362,284364,0,2,2
81216,2,1,284364,284364,284365,0,1,0
81217,4,3,284368,284368,284371,0,3,3
81218,2,1,284370,284371,284372,1,2,0
81219,3,2,284373,284373,284375,0,2,1
81220,3,1,284376,284376,284377,0,1,1
81221,5,3,284381,284381,284384,0,3,4
81222,2,3,284383,284384,284387,1,4,0
81223,6,1,284389,284389,284390,0,1,2
81224,6,3,284395,284395,284398,0,3,5
81225,6,1,284401,284401,284402,0,1,3
81226,2,2,284403,284403,284405,0,2,1
81227,4,1,284407,284407,284408,0,1,2
81228,6,1,284413,284413,284414,0,1,5
81229,6,2,284419,284419,284421,0,2,5
81230,5,3,284424,284424,284427,0,3,3
81231,4,1,284428,284428,284429,0,1,1
81232,1,1,284429,284429,284430,0,1,0
81233,1,2,284430,284430,284432,0,2,0
81234,1,2,284431,284432,284434,1,3,0
81235,3,2,284434,284434,284436,0,2,0
81236,5,2,284439,284439,284441,0,2,3
81237,4,3,284443,284443,284446,0,3,2
81238,4,1,284447,284447,284448,0,1,1
81239,6,1,284453,284453,284454,0,1,5
81240,4,1,284457,284457,284458,0,1,3
81241,3,3,284460,284460,284463,0,3,2
81242,6,1,284466,284466,284467,0,1,3
81243,4,3,284470,284470,284473,0,3,3
81244,3,2,284473,284473,284475,0,2,0
81245,1,3,284474,284475,284478,1,4,0
81246,2,2,284476,284478,284480,2,4,0
81247,2,1,284478,284480,284481,2,3,0
81248,5,1,284483,284483,284484,0,1,2
81249,4,1,284487,284487,284488,0,1,3
81250,6,1,284493,284493,284494,0,1,5
81251,4,1,284497,284497,284498,0,1,3
81252,5,2,284502,284502,284504,0,2,4
81253,5,2,284507,284507,284509,0,2,3
81254,1,2,284508,284509,284511,1,3,0
81255,6,3,284514,284514,284517,0,3,3
81256,6,3,284520,284520,284523,0,3,3
81257,3,3,284523,284523,284526,0,3,0
81258,4,2,284527,284527,284529,0,2,1
81259,2,1,284529,284529,284530,0,1,0
81260,6,3,284535,284535,284538,0,3,5
81261,6,1,284541,284541,284542,0,1,3
81262,1,1,284542,284542,284543,0,1,0
81263,6,2,284548,284548,284550,0,2,5
81264,1,2,284549,284550,284552,1,3,0
81265,3,2,284552,284552,284554,0,2,0
81266,3,2,284555,284555,284557,0,2,1
81267,2,3,284557,284557,284560,0,3,0
81268,2,3,284559,284560,284563,1,4,0
81269,2,2,284561,284563,284565,2,4,0
81270,5,2,284566,284566,284568,0,2,1
81271,5,2,284571,284571,284573,0,2,3
81272,2,1,284573,284573,284574,0,1,0
81273,3,3,284576,284576,284579,0,3,2
81274,6,3,284582,284582,284585,0,3,3
81275,2,1,284584,284585,284586,1,2,0
81276,2,1,284586,284586,284587,0,1,0
81277,1,3,284587,284587,284590,0,3,0
81278,3,3,284590,284590,284593,0,3,0
81279,6,3,284596,284596,284599,0,3,3
81280,3,2,284599,284599,284601,0,2,0
81281,1,1,284600,284601,284602,1,2,0
81282,6,1,284606,284606,284607,0,1,4
81283,3,1,284609,284609,284610,0,1,2
81284,4,2,284613,284613,284615,0,2,3
81285,2,3,284615,284615,284618,0,3,0
81286,4,2,284619,284619,284621,0,2,1
81287,4,2,284623,284623,284625,0,2,2
81288,2,1,284625,284625,284626,0,1,0
81289,1,3,284626,284626,284629,0,3,0
81290,6,2,284632,284632,284634,0,2,3
81291,6,3,284638,284638,284641,0,3,4
81292,2,3,284640,284641,284644,1,4,0
81293,3,2,284643,284644,284646,1,3,0
81294,4,1,284647,284647,284648,0,1,1
81295,3,3,284650,284650,284653,0,3,2
81296,6,3,284656,284656,284659,0,3,3
81297,6,2,284662,284662,284664,0,2,3
81298,2,3,284664,284664,284667,0,3,0
81299,2,3,284666,284667,284670,1,4,0
81300,2,3,284668,284670,284673,2,5,0
81301,3,2,284671,284673,284675,2,4,0
81302,3,2,284674,284675,284677,1,3,0
81303,6,3,284680,284680,284683,0,3,3
81304,3,1,284683,284683,284684,0,1,0
81305,6,2,284689,284689,284691,0,2,5
81306,1,1,284690,284691,284692,1,2,0
81307,4,1,284694,284694,284695,0,1,2
81308,3,1,284697,284697,284698,0,1,2
81309,5,3,284702,284702,284705,0,3,4
81310,5,2,284707,284707,284709,0,2,2
81311,6,3,284713,284713,284716,0,3,4
81312,3,1,284716,284716,284717,0,1,0
81313,3,1,284719,284719,284720,0,1,2
81314,2,3,284721,284721,284724,0,3,1
81315,6,1,284727,284727,284728,0,1,3
81316,5,3,284732,284732,284735,0,3,4
81317,1,3,284733,284735,284738,2,5,0
81318,5,1,284738,284738,284739,0,1,0
81319,3,3,284741,284741,284744,0,3,2
81320,1,2,284742,284744,284746,2,4,0
81321,4,3,284746,284746,284749,0,3,0
81322,5,3,284751,284751,284754,0,3,2
81323,3,3,284754,284754,284757,0,3,0
81324,5,1,284759,284759,284760,0,1,2
81325,4,2,284763,284763,284765,0,2,3
81326,2,2,284765,284765,284767,0,2,0
81327,6,1,284771,284771,284772,0,1,4
81328,3,1,284774,284774,284775,0,1,2
81329,6,3,284780,284780,284783,0,3,5
81330,5,2,284785,284785,284787,0,2,2
81331,4,3,284789,284789,284792,0,3,2
81332,1,1,284790,284792,284793,2,3,0
81333,6,1,284796,284796,284797,0,1,3
81334,4,2,284800,284800,284802,0,2,3
81335,4,2,284804,284804,284806,0,2,2
81336,6,1,284810,284810,284811,0,1,4
81337,1,1,284811,284811,284812,0,1,0
81338,4,2,284815,284815,284817,0,2,3
81339,3,2,284818,284818,284820,0,2,1
81340,4,1,284822,284822,284823,0,1,2
81341,6,1,284828,284828,284829,0,1,5
81342,4,1,284832,284832,284833,0,1,3
81343,5,3,284837,284837,284840,0,3,4
81344,6,1,284843,284843,284844,0,1,3
81345,4,3,284847,284847,284850,0,3,3
81346,6,2,284853,284853,284855,0,2,3
81347,2,1,284855,284855,284856,0,1,0
81348,5,1,284860,284860,284861,0,1,4
81349,1,3,284861,284861,284864,0,3,0
81350,3,1,284864,284864,284865,0,1,0
81351,1,1,284865,284865,284866,0,1,0
81352,4,1,284869,284869,284870,0,1,3
81353,2,2,284871,284871,284873,0,2,1
81354,5,3,284876,284876,284879,0,3,3
81355,2,2,284878,284879,284881,1,3,0
81356,6,1,284884,284884,284885,0,1,3
81357,5,1,284889,284889,284890,0,1,4
81358,1,3,284890,284890,284893,0,3,0
81359,3,2,284893,284893,284895,0,2,0
81360,4,1,284897,284897,284898,0,1,2
81361,1,2,284898,284898,284900,0,2,0
81362,4,3,284902,284902,284905,0,3,2
81363,3,1,284905,284905,284906,0,1,0
81364,6,1,284911,284911,284912,0,1,5
81365,6,2,284917,284917,284919,0,2,5
81366,3,3,284920,284920,284923,0,3,1
81367,4,2,284924,284924,284926,0,2,1
81368,1,3,284925,284926,284929,1,4,0
81369,2,1,284927,284929,284930,2,3,0
81370,4,3,284931,284931,284934,0,3,1
81371,4,1,284935,284935,284936,0,1,1
81372,2,2,284937,284937,284939,0,2,1
81373,1,2,284938,284939,284941,1,3,0
81374,1,1,284939,284941,284942,2,3,0
81375,3,2,284942,284942,284944,0,2,0
81376,2,2,284944,284944,284946,0,2,0
81377,5,3,284949,284949,284952,0,3,3
81378,2,1,284951,284952,284953,1,2,0
81379,5,3,284956,284956,284959,0,3,3
81380,5,1,284961,284961,284962,0,1,2
81381,1,2,284962,284962,284964,0,2,0
81382,4,2,284966,284966,284968,0,2,2
81383,2,1,284968,284968,284969,0,1,0
81384,5,1,284973,284973,284974,0,1,4
81385,6,3,284979,284979,284982,0,3,5
81386,3,1,284982,284982,284983,0,1,0
81387,4,1,284986,284986,284987,0,1,3
81388,2,1,284988,284988,284989,0,1,1
81389,2,2,284990,284990,284992,0,2,1
81390,1,2,284991,284992,284994,1,3,0
81391,3,2,284994,284994,284996,0,2,0
81392,3,2,284997,284997,284999,0,2,1
81393,4,2,285001,285001,285003,0,2,2
81394,5,2,285006,285006,285008,0,2,3
81395,1,3,285007,285008,285011,1,4,0
81396,2,3,285009,285011,285014,2,5,0
81397,3,3,285012,285014,285017,2,5,0
81398,4,1,285016,285017,285018,1,2,0
81399,2,2,285018,285018,285020,0,2,0
81400,3,1,285021,285021,285022,0,1,1
81401,3,3,285024,285024,285027,0,3,2
81402,3,3,285027,285027,285030,0,3,0
81403,4,2,285031,285031,285033,0,2,1
81404,4,1,285035,285035,285036,0,1,2
81405,6,3,285041,285041,285044,0,3,5
81406,3,1,285044,285044,285045,0,1,0
81407,6,3,285050,285050,285053,0,3,5
81408,3,1,285053,285053,285054,0,1,0
81409,4,1,285057,285057,285058,0,1,3
81410,2,1,285059,285059,285060,0,1,1
81411,4,1,285063,285063,285064,0,1,3
81412,5,2,285068,285068,285070,0,2,4
81413,1,3,285069,285070,285073,1,4,0
81414,5,1,285074,285074,285075,0,1,1
81415,6,3,285080,285080,285083,0,3,5
81416,6,3,285086,285086,285089,0,3,3
81417,3,3,285089,285089,285092,0,3,0
81418,1,2,285090,285092,285094,2,4,0
81419,3,3,285093,285094,285097,1,4,0
81420,2,1,285095,285097,285098,2,3,0
81421,6,2,285101,285101,285103,0,2,3
81422,1,3,285102,285103,285106,1,4,0
81423,4,2,285106,285106,285108,0,2,0
81424,4,2,285110,285110,285112,0,2,2
81425,3,2,285113,285113,285115,0,2,1
81426,4,3,285117,285117,285120,0,3,2
81427,5,3,285122,285122,285125,0,3,2
81428,2,2,285124,285125,285127,1,3,0
81429,5,3,285129,285129,285132,0,3,2
81430,5,3,285134,285134,285137,0,3,2
81431,2,3,285136,285137,285140,1,4,0
81432,6,2,285142,285142,285144,0,2,2
81433,3,2,285145,285145,285147,0,2,1
81434,2,3,285147,285147,285150,0,3,0
81435,1,2,285148,285150,285152,2,4,0
81436,3,3,285151,285152,285155,1,4,0
81437,5,1,285156,285156,285157,0,1,1
81438,4,1,285160,285160,285161,0,1,3
81439,4,2,285164,285164,285166,0,2,3
81440,4,3,285168,285168,285171,0,3,2
81441,5,2,285173,285173,285175,0,2,2
81442,6,1,285179,285179,285180,0,1,4
81443,2,1,285181,285181,285182,0,1,1
81444,4,3,285185,285185,285188,0,3,3
81445,2,1,285187,285188,285189,1,2,0
81446,2,1,285189,285189,285190,0,1,0
81447,3,3,285192,285192,285195,0,3,2
81448,6,3,285198,285198,285201,0,3,3
81449,2,3,285200,285201,285204,1,4,0
81450,1,3,285201,285204,285207,3,6,0
81451,4,2,285205,285207,285209,2,4,0
81452,5,3,285210,285210,285213,0,3,1
81453,3,2,285213,285213,285215,0,2,0
81454,4,3,285217,285217,285220,0,3,2
81455,2,3,285219,285220,285223,1,4,0
81456,5,1,285224,285224,285225,0,1,1
81457,1,1,285225,285225,285226,0,1,0
81458,4,3,285229,285229,285232,0,3,3
81459,4,2,285233,285233,285235,0,2,1
81460,1,2,285234,285235,285237,1,3,0
81461,2,2,285236,285237,285239,1,3,0
81462,5,3,285241,285241,285244,0,3,2
81463,6,3,285247,285247,285250,0,3,3
81464,5,2,285252,285252,285254,0,2,2
81465,4,2,285256,285256,285258,0,2,2
81466,4,3,285260,285260,285263,0,3,2
81467,1,1,285261,285263,285264,2,3,0
81468,6,2,285267,285267,285269,0,2,3
81469,3,3,285270,285270,285273,0,3,1
81470,5,1,285275,285275,285276,0,1,2
81471,5,1,285280,285280,285281,0,1,4
81472,2,1,285282,285282,285283,0,1,1
81473,6,1,285288,285288,285289,0,1,5
81474,3,1,285291,285291,285292,0,1,2
81475,5,1,285296,285296,285297,0,1,4
81476,5,3,285301,285301,285304,0,3,4
81477,3,3,285304,285304,285307,0,3,0
81478,5,2,285309,285309,285311,0,2,2
81479,2,1,285311,285311,285312,0,1,0
81480,4,1,285315,285315,285316,0,1,3
81481,5,3,285320,285320,285323,0,3,4
81482,4,2,285324,285324,285326,0,2,1
81483,2,3,285326,285326,285329,0,3,0
81484,1,2,285327,285329,285331,2,4,0
81485,3,2,285330,285331,285333,1,3,0
81486,4,1,285334,285334,285335,0,1,1
81487,2,2,285336,285336,285338,0,2,1
81488,3,3,285339,285339,285342,0,3,1
81489,6,3,285345,285345,285348,0,3,3
81490,4,3,285349,285349,285352,0,3,1
81491,5,2,285354,285354,285356,0,2,2
81492,5,2,285359,285359,285361,0,2,3
81493,3,2,285362,285362,285364,0,2,1
81494,5,3,285367,285367,285370,0,3,3
81495,5,1,285372,285372,285373,0,1,2
81496,1,2,285373,285373,285375,0,2,0
81497,5,3,285378,285378,285381,0,3,3
81498,3,1,285381,285381,285382,0,1,0
81499,4,2,285385,285385,285387,0,2,3
81500,4,1,285389,285389,285390,0,1,2
81501,1,1,285390,285390,285391,0,1,0
81502,4,3,285394,285394,285397,0,3,3
81503,3,2,285397,285397,285399,0,2,0
81504,2,3,285399,285399,285402,0,3,0
81505,6,1,285405,285405,285406,0,1,3
81506,1,3,285406,285406,285409,0,3,0
81507,1,3,285407,285409,285412,2,5,0
81508,2,3,285409,285412,285415,3,6,0
81509,2,3,285411,285415,285418,4,7,0
81510,2,2,285413,285418,285420,5,7,0
81511,3,3,285416,285420,285423,4,7,0
81512,4,1,285420,285423,285424,3,4,0
81513,5,2,285425,285425,285427,0,2,1
81514,3,3,285428,285428,285431,0,3,1
81515,3,2,285431,285431,285433,0,2,0
81516,1,1,285432,285433,285434,1,2,0
81517,1,1,285433,285434,285435,1,2,0
81518,6,3,285439,285439,285442,0,3,4
81519,6,3,285445,285445,285448,0,3,3
81520,1,3,285446,285448,285451,2,5,0
81521,1,2,285447,285451,285453,4,6,0
81522,2,3,285449,285453,285456,4,7,0
81523,2,2,285451,285456,285458,5,7,0
81524,5,1,285456,285458,285459,2,3,0
81525,6,3,285462,285462,285465,0,3,3
81526,4,1,285466,285466,285467,0,1,1
81527,4,1,285470,285470,285471,0,1,3
81528,6,1,285476,285476,285477,0,1,5
81529,3,1,285479,285479,285480,0,1,2
81530,4,1,285483,285483,285484,0,1,3
81531,5,3,285488,285488,285491,0,3,4
81532,6,3,285494,285494,285497,0,3,3
81533,6,1,285500,285500,285501,0,1,3
81534,4,2,285504,285504,285506,0,2,3
81535,5,3,285509,285509,285512,0,3,3
81536,3,2,285512,285512,285514,0,2,0
81537,2,1,285514,285514,285515,0,1,0
81538,5,2,285519,285519,285521,0,2,4
81539,4,2,285523,285523,285525,0,2,2
81540,3,3,285526,285526,285529,0,3,1
81541,4,1,285530,285530,285531,0,1,1
81542,5,1,285535,285535,285536,0,1,4
81543,5,1,285540,285540,285541,0,1,4
81544,5,1,285545,285545,285546,0,1,4
81545,3,3,285548,285548,285551,0,3,2
81546,6,3,285554,285554,285557,0,3,3
81547,2,1,285556,285557,285558,1,2,0
81548,1,1,285557,285558,285559,1,2,0
81549,5,2,285562,285562,285564,0,2,3
81550,3,2,285565,285565,285567,0,2,1
81551,6,3,285571,285571,285574,0,3,4
81552,3,1,285574,285574,285575,0,1,0
81553,5,2,285579,285579,285581,0,2,4
81554,5,2,285584,285584,285586,0,2,3
81555,2,2,285586,285586,285588,0,2,0
81556,4,1,285590,285590,285591,0,1,2
81557,1,2,285591,285591,285593,0,2,0
81558,6,3,285597,285597,285600,0,3,4
81559,2,3,285599,285600,285603,1,4,0
81560,1,2,285600,285603,285605,3,5,0
81561,6,2,285606,285606,285608,0,2,1
81562,5,2,285611,285611,285613,0,2,3
81563,5,3,285616,285616,285619,0,3,3
81564,5,2,285621,285621,285623,0,2,2
81565,1,2,285622,285623,285625,1,3,0
81566,3,3,285625,285625,285628,0,3,0
81567,2,2,285627,285628,285630,1,3,0
81568,3,3,285630,285630,285633,0,3,0
81569,3,1,285633,285633,285634,0,1,0
81570,3,3,285636,285636,285639,0,3,2
81571,2,1,285638,285639,285640,1,2,0
81572,1,2,285639,285640,285642,1,3,0
81573,2,2,285641,285642,285644,1,3,0
81574,5,2,285646,285646,285648,0,2,2
81575,6,1,285652,285652,285653,0,1,4
81576,2,1,285654,285654,285655,0,1,1
81577,4,3,285658,285658,285661,0,3,3
81578,1,3,285659,285661,285664,2,5,0
81579,2,1,285661,285664,285665,3,4,0
81580,5,2,285666,285666,285668,0,2,1
81581,6,3,285672,285672,285675,0,3,4
81582,3,2,285675,285675,285677,0,2,0
81583,5,2,285680,285680,285682,0,2,3
81584,4,2,285684,285684,285686,0,2,2
81585,5,1,285689,285689,285690,0,1,3
81586,1,1,285690,285690,285691,0,1,0
81587,3,2,285693,285693,285695,0,2,2
81588,5,2,285698,285698,285700,0,2,3
81589,6,3,285704,285704,285707,0,3,4
81590,3,3,285707,285707,285710,0,3,0
81591,3,1,285710,285710,285711,0,1,0
81592,5,1,285715,285715,285716,0,1,4
81593,2,1,285717,285717,285718,0,1,1
81594,4,3,285721,285721,285724,0,3,3
81595,6,3,285727,285727,285730,0,3,3
81596,3,1,285730,285730,285731,0,1,0
81597,3,1,285733,285733,285734,0,1,2
81598,1,2,285734,285734,285736,0,2,0
81599,1,1,285735,285736,285737,1,2,0
81600,5,2,285740,285740,285742,0,2,3
81601,3,3,285743,285743,285746,0,3,1
81602,3,1,285746,285746,285747,0,1,0
81603,6,1,285752,285752,285753,0,1,5
81604,4,2,285756,285756,285758,0,2,3
81605,5,1,285761,285761,285762,0,1,3
81606,1,1,285762,285762,285763,0,1,0
81607,4,2,285766,285766,285768,0,2,3
81608,6,1,285772,285772,285773,0,1,4
81609,1,2,285773,285773,285775,0,2,0
81610,5,3,285778,285778,285781,0,3,3
81611,1,3,285779,285781,285784,2,5,0
81612,2,2,285781,285784,285786,3,5,0
81613,3,3,285784,285786,285789,2,5,0
81614,2,2,285786,285789,285791,3,5,0
81615,4,1,285790,285791,285792,1,2,0
81616,2,1,285792,285792,285793,0,1,0
81617,6,3,285798,285798,285801,0,3,5
81618,1,3,285799,285801,285804,2,5,0
81619,1,2,285800,285804,285806,4,6,0
81620,6,1,285806,285806,285807,0,1,0
81621,5,2,285811,285811,285813,0,2,4
81622,1,2,285812,285813,285815,1,3,0
81623,1,3,285813,285815,285818,2,5,0
81624,3,1,285816,285818,285819,2,3,0
81625,2,1,285818,285819,285820,1,2,0
81626,3,1,285821,285821,285822,0,1,1
81627,6,1,285827,285827,285828,0,1,5
81628,2,1,285829,285829,285830,0,1,1
81629,5,1,285834,285834,285835,0,1,4
81630,4,2,285838,285838,285840,0,2,3
81631,5,1,285843,285843,285844,0,1,3
81632,6,2,285849,285849,285851,0,2,5
81633,1,1,285850,285851,285852,1,2,0
81634,5,2,285855,285855,285857,0,2,3
81635,2,2,285857,285857,285859,0,2,0
81636,4,2,285861,285861,285863,0,2,2
81637,3,2,285864,285864,285866,0,2,1
81638,1,2,285865,285866,285868,1,3,0
81639,4,1,285869,285869,285870,0,1,1
81640,3,2,285872,285872,285874,0,2,2
81641,1,2,285873,285874,285876,1,3,0
81642,6,3,285879,285879,285882,0,3,3
81643,1,2,285880,285882,285884,2,4,0
81644,4,2,285884,285884,285886,0,2,0
81645,1,2,285885,285886,285888,1,3,0
81646,5,2,285890,285890,285892,0,2,2
81647,3,1,285893,285893,285894,0,1,1
81648,2,1,285895,285895,285896,0,1,1
81649,1,1,285896,285896,285897,0,1,0
81650,5,1,285901,285901,285902,0,1,4
81651,2,3,285903,285903,285906,0,3,1
81652,6,3,285909,285909,285912,0,3,3
81653,6,1,285915,285915,285916,0,1,3
81654,1,1,285916,285916,285917,0,1,0
81655,4,1,285920,285920,285921,0,1,3
81656,4,2,285924,285924,285926,0,2,3
81657,4,2,285928,285928,285930,0,2,2
81658,6,3,285934,285934,285937,0,3,4
81659,1,1,285935,285937,285938,2,3,0
81660,4,1,285939,285939,285940,0,1,1
81661,5,3,285944,285944,285947,0,3,4
81662,4,3,285948,285948,285951,0,3,1
81663,5,2,285953,285953,285955,0,2,2
81664,4,3,285957,285957,285960,0,3,2
81665,3,2,285960,285960,285962,0,2,0
81666,5,1,285965,285965,285966,0,1,3
81667,6,1,285971,285971,285972,0,1,5
81668,6,1,285977,285977,285978,0,1,5
81669,3,2,285980,285980,285982,0,2,2
81670,4,3,285984,285984,285987,0,3,2
81671,2,3,285986,285987,285990,1,4,0
81672,1,1,285987,285990,285991,3,4,0
81673,1,2,285988,285991,285993,3,5,0
81674,1,2,285989,285993,285995,4,6,0
81675,3,2,285992,285995,285997,3,5,0
81676,3,2,285995,285997,285999,2,4,0
81677,5,1,286000,286000,286001,0,1,1
81678,5,3,286005,286005,286008,0,3,4
81679,6,2,286011,286011,286013,0,2,3
81680,1,2,286012,286013,286015,1,3,0
81681,1,1,286013,286015,286016,2,3,0
81682,3,1,286016,286016,286017,0,1,0
81683,3,1,286019,286019,286020,0,1,2
81684,4,2,286023,286023,286025,0,2,3
81685,4,2,286027,286027,286029,0,2,2
81686,3,1,286030,286030,286031,0,1,1
81687,4,1,286034,286034,286035,0,1,3
81688,5,2,286039,286039,286041,0,2,4
81689,1,1,286040,286041,286042,1,2,0
81690,4,2,286044,286044,286046,0,2,2
81691,1,3,286045,286046,286049,1,4,0
81692,2,1,286047,286049,286050,2,3,0
81693,2,3,286049,286050,286053,1,4,0
81694,2,3,286051,286053,286056,2,5,0
81695,6,2,286057,286057,286059,0,2,1
81696,4,3,286061,286061,286064,0,3,2
81697,6,2,286067,286067,286069,0,2,3
81698,2,3,286069,286069,286072,0,3,0
81699,6,1,286075,286075,286076,0,1,3
81700,6,1,286081,286081,286082,0,1,5
81701,4,2,286085,286085,286087,0,2,3
81702,1,1,286086,286087,286088,1,2,0
81703,2,3,286088,286088,286091,0,3,0
81704,5,1,286093,286093,286094,0,1,2
81705,2,2,286095,286095,286097,0,2,1
81706,3,1,286098,286098,286099,0,1,1
81707,1,2,286099,286099,286101,0,2,0
81708,6,2,286105,286105,286107,0,2,4
81709,5,1,286110,286110,286111,0,1,3
81710,3,3,286113,286113,286116,0,3,2
81711,6,2,286119,286119,286121,0,2,3
81712,5,1,286124,286124,286125,0,1,3
81713,5,3,286129,286129,286132,0,3,4
81714,4,3,286133,286133,286136,0,3,1
81715,2,3,286135,286136,286139,1,4,0
81716,5,1,286140,286140,286141,0,1,1
81717,6,3,286146,286146,286149,0,3,5
81718,4,2,286150,286150,286152,0,2,1
81719,1,1,286151,286152,286153,1,2,0
81720,3,1,286154,286154,286155,0,1,1
81721,1,3,286155,286155,286158,0,3,0
81722,2,1,286157,286158,286159,1,2,0
81723,3,2,286160,286160,286162,0,2,1
81724,2,3,286162,286162,286165,0,3,0
81725,4,1,286166,286166,286167,0,1,1
81726,6,2,286172,286172,286174,0,2,5
81727,5,3,286177,286177,286180,0,3,3
81728,6,1,286183,286183,286184,0,1,3
81729,4,3,286187,286187,286190,0,3,3
81730,2,3,286189,286190,286193,1,4,0
81731,4,1,286193,286193,286194,0,1,0
81732,4,2,286197,286197,286199,0,2,3
81733,5,3,286202,286202,286205,0,3,3
81734,6,2,286208,286208,286210,0,2,3
81735,2,3,286210,286210,286213,0,3,0
81736,2,2,286212,286213,286215,1,3,0
81737,1,3,286213,286215,286218,2,5,0
81738,4,2,286217,286218,286220,1,3,0
81739,2,2,286219,286220,286222,1,3,0
81740,2,1,286221,286222,286223,1,2,0
81741,4,1,286225,286225,286226,0,1,2
81742,6,2,286231,286231,286233,0,2,5
81743,6,1,286237,286237,286238,0,1,4
81744,1,1,286238,286238,286239,0,1,0
81745,5,2,286243,286243,286245,0,2,4
81746,2,1,286245,286245,286246,0,1,0
81747,4,3,286249,286249,286252,0,3,3
81748,4,3,286253,286253,286256,0,3,1
81749,5,1,286258,286258,286259,0,1,2
81750,3,1,286261,286261,286262,0,1,2
81751,1,1,286262,286262,286263,0,1,0
81752,1,2,286263,286263,286265,0,2,0
81753,2,1,286265,286265,286266,0,1,0
81754,5,1,286270,286270,286271,0,1,4
81755,5,2,286275,286275,286277,0,2,4
81756,6,2,286281,286281,286283,0,2,4
81757,5,2,286286,286286,286288,0,2,3
81758,3,3,286289,286289,286292,0,3,1
81759,2,1,286291,286292,286293,1,2,0
81760,5,2,286296,286296,286298,0,2,3
81761,6,3,286302,286302,286305,0,3,4
81762,1,1,286303,286305,286306,2,3,0
81763,3,3,286306,286306,286309,0,3,0
81764,2,2,286308,286309,286311,1,3,0
81765,2,2,286310,286311,286313,1,3,0
81766,4,3,286314,286314,286317,0,3,1
81767,1,2,286315,286317,286319,2,4,0
81768,5,3,286320,286320,286323,0,3,1
81769,6,2,286326,286326,286328,0,2,3
81770,4,1,286330,286330,286331,0,1,2
81771,5,3,286335,286335,286338,0,3,4
81772,2,1,286337,286338,286339,1,2,0
81773,5,1,286342,286342,286343,0,1,3
81774,4,3,286346,286346,286349,0,3,3
81775,2,3,286348,286349,286352,1,4,0
81776,2,1,286350,286352,286353,2,3,0
81777,3,1,286353,286353,286354,0,1,0
81778,1,2,286354,286354,286356,0,2,0
81779,1,2,286355,286356,286358,1,3,0
81780,5,3,286360,286360,286363,0,3,2
81781,2,3,286362,286363,286366,1,4,0
81782,5,2,286367,286367,286369,0,2,1
81783,2,3,286369,286369,286372,0,3,0
81784,4,2,286373,286373,286375,0,2,1
81785,1,1,286374,286375,286376,1,2,0
81786,2,1,286376,286376,286377,0,1,0
81787,4,2,286380,286380,286382,0,2,3
81788,1,1,286381,286382,286383,1,2,0
81789,2,2,286383,286383,286385,0,2,0
81790,3,2,286386,286386,286388,0,2,1
81791,1,1,286387,286388,286389,1,2,0
81792,6,1,286393,286393,286394,0,1,4
81793,1,1,286394,286394,286395,0,1,0
81794,3,1,286397,286397,286398,0,1,2
81795,2,2,286399,286399,286401,0,2,1
81796,6,2,286405,286405,286407,0,2,4
81797,2,2,286407,286407,286409,0,2,0
81798,5,3,286412,286412,286415,0,3,3
81799,5,3,286417,286417,286420,0,3,2
81800,6,2,286423,286423,286425,0,2,3
81801,5,1,286428,286428,286429,0,1,3
81802,5,2,286433,286433,286435,0,2,4
81803,2,2,286435,286435,286437,0,2,0
81804,4,3,286439,286439,286442,0,3,2
81805,4,3,286443,286443,286446,0,3,1
81806,1,2,286444,286446,286448,2,4,0
81807,2,2,286446,286448,286450,2,4,0
81808,2,3,286448,286450,286453,2,5,0
81809,3,2,286451,286453,286455,2,4,0
81810,6,3,286457,286457,286460,0,3,2
81811,5,3,286462,286462,286465,0,3,2
81812,5,1,286467,286467,286468,0,1,2
81813,3,2,286470,286470,286472,0,2,2
81814,5,1,286475,286475,286476,0,1,3
81815,5,1,286480,286480,286481,0,1,4
81816,3,1,286483,286483,286484,0,1,2
81817,5,3,286488,286488,286491,0,3,4
81818,2,2,286490,286491,286493,1,3,0
81819,6,1,286496,286496,286497,0,1,3
81820,5,1,286501,286501,286502,0,1,4
81821,1,2,286502,286502,286504,0,2,0
81822,4,1,286506,286506,286507,0,1,2
81823,5,3,286511,286511,286514,0,3,4
81824,6,1,286517,286517,286518,0,1,3
81825,4,3,286521,286521,286524,0,3,3
81826,5,2,286526,286526,286528,0,2,2
81827,3,2,286529,286529,286531,0,2,1
81828,5,3,286534,286534,286537,0,3,3
81829,2,3,286536,286537,286540,1,4,0
81830,4,2,286540,286540,286542,0,2,0
81831,5,2,286545,286545,286547,0,2,3
81832,4,1,286549,286549,286550,0,1,2
81833,3,3,286552,286552,286555,0,3,2
81834,3,3,286555,286555,286558,0,3,0
81835,3,3,286558,286558,286561,0,3,0
81836,3,2,286561,286561,286563,0,2,0
81837,6,1,286567,286567,286568,0,1,4
81838,1,1,286568,286568,286569,0,1,0
81839,3,1,286571,286571,286572,0,1,2
81840,2,1,286573,286573,286574,0,1,1
81841,6,1,286579,286579,286580,0,1,5
81842,1,3,286580,286580,286583,0,3,0
81843,3,3,286583,286583,286586,0,3,0
81844,3,3,286586,286586,286589,0,3,0
81845,3,1,286589,286589,286590,0,1,0
81846,3,1,286592,286592,286593,0,1,2
81847,1,1,286593,286593,286594,0,1,0
81848,5,1,286598,286598,286599,0,1,4
81849,6,2,286604,286604,286606,0,2,5
81850,4,1,286608,286608,286609,0,1,2
81851,6,1,286614,286614,286615,0,1,5
81852,3,2,286617,286617,286619,0,2,2
81853,3,3,286620,286620,286623,0,3,1
81854,1,2,286621,286623,286625,2,4,0
81855,4,1,286625,286625,286626,0,1,0
81856,5,2,286630,286630,286632,0,2,4
81857,6,2,286636,286636,286638,0,2,4
81858,1,1,286637,286638,286639,1,2,0
81859,5,1,286642,286642,286643,0,1,3
81860,3,1,286645,286645,286646,0,1,2
81861,2,1,286647,286647,286648,0,1,1
81862,2,2,286649,286649,286651,0,2,1
81863,3,2,286652,286652,286654,0,2,1
81864,3,2,286655,286655,286657,0,2,1
81865,2,3,286657,286657,286660,0,3,0
81866,6,2,286663,286663,286665,0,2,3
81867,4,3,286667,286667,286670,0,3,2
81868,4,2,286671,286671,286673,0,2,1
81869,2,2,286673,286673,286675,0,2,0
81870,6,3,286679,286679,286682,0,3,4
81871,1,1,286680,286682,286683,2,3,0
81872,3,3,286683,286683,286686,0,3,0
81873,1,3,286684,286686,286689,2,5,0
81874,3,3,286687,286689,286692,2,5,0
81875,5,1,286692,286692,286693,0,1,0
81876,2,1,286694,286694,286695,0,1,1
81877,1,1,286695,286695,286696,0,1,0
81878,1,2,286696,286696,286698,0,2,0
81879,2,2,286698,286698,286700,0,2,0
81880,2,3,286700,286700,286703,0,3,0
81881,4,3,286704,286704,286707,0,3,1
81882,6,2,286710,286710,286712,0,2,3
81883,4,3,286714,286714,286717,0,3,2
81884,4,1,286718,286718,286719,0,1,1
81885,1,3,286719,286719,286722,0,3,0
81886,6,2,286725,286725,286727,0,2,3
81887,1,2,286726,286727,286729,1,3,0
81888,2,2,286728,286729,286731,1,3,0
81889,5,1,286733,286733,286734,0,1,2
81890,4,1,286737,286737,286738,0,1,3
81891,2,3,286739,286739,286742,0,3,1
81892,2,1,286741,286742,286743,1,2,0
81893,2,1,286743,286743,286744,0,1,0
81894,2,2,286745,286745,286747,0,2,1
81895,2,2,286747,286747,286749,0,2,0
81896,2,3,286749,286749,286752,0,3,0
81897,4,1,286753,286753,286754,0,1,1
81898,1,1,286754,286754,286755,0,1,0
81899,1,2,286755,286755,286757,0,2,0
81900,4,1,286759,286759,286760,0,1,2
81901,3,1,286762,286762,286763,0,1,2
81902,2,2,286764,286764,286766,0,2,1
81903,5,1,286769,286769,286770,0,1,3
81904,2,2,286771,286771,286773,0,2,1
81905,3,1,286774,286774,286775,0,1,1
81906,1,2,286775,286775,286777,0,2,0
81907,3,3,286778,286778,286781,0,3,1
81908,3,2,286781,286781,286783,0,2,0
81909,1,3,286782,286783,286786,1,4,0
81910,2,2,286784,286786,286788,2,4,0
81911,5,2,286789,286789,286791,0,2,1
81912,2,3,286791,286791,286794,0,3,0
81913,6,2,286797,286797,286799,0,2,3
81914,2,1,286799,286799,286800,0,1,0
81915,6,2,286805,286805,286807,0,2,5
81916,3,1,286808,286808,286809,0,1,1
81917,5,2,286813,286813,286815,0,2,4
81918,4,1,286817,286817,286818,0,1,2
81919,2,2,286819,286819,286821,0,2,1
81920,6,1,286825,286825,286826,0,1,4
81921,6,1,286831,286831,286832,0,1,5
81922,4,1,286835,286835,286836,0,1,3
81923,5,1,286840,286840,286841,0,1,4
81924,2,3,286842,286842,286845,0,3,1
81925,3,2,286845,286845,286847,0,2,0
81926,2,2,286847,286847,286849,0,2,0
81927,4,2,286851,286851,286853,0,2,2
81928,5,3,286856,286856,286859,0,3,3
81929,4,2,286860,286860,286862,0,2,1
81930,5,3,286865,286865,286868,0,3,3
81931,1,1,286866,286868,286869,2,3,0
81932,3,1,286869,286869,286870,0,1,0
81933,4,3,286873,286873,286876,0,3,3
81934,6,3,286879,286879,286882,0,3,3
81935,3,1,286882,286882,286883,0,1,0
81936,4,3,286886,286886,286889,0,3,3
81937,5,3,286891,286891,286894,0,3,2
81938,6,2,286897,286897,286899,0,2,3
81939,6,3,286903,286903,286906,0,3,4
81940,3,2,286906,286906,286908,0,2,0
81941,3,3,286909,286909,286912,0,3,1
81942,6,2,286915,286915,286917,0,2,3
81943,5,3,286920,286920,286923,0,3,3
81944,2,2,286922,286923,286925,1,3,0
81945,1,1,286923,286925,286926,2,3,0
81946,3,1,286926,286926,286927,0,1,0
81947,3,3,286929,286929,286932,0,3,2
81948,2,2,286931,286932,286934,1,3,0
81949,1,2,286932,286934,286936,2,4,0
81950,4,1,286936,286936,286937,0,1,0
81951,2,1,286938,286938,286939,0,1,1
81952,3,2,286941,286941,286943,0,2,2
81953,4,3,286945,286945,286948,0,3,2
81954,4,1,286949,286949,286950,0,1,1
81955,3,3,286952,286952,286955,0,3,2
81956,4,2,286956,286956,286958,0,2,1
81957,5,2,286961,286961,286963,0,2,3
81958,3,3,286964,286964,286967,0,3,1
81959,3,1,286967,286967,286968,0,1,0
81960,2,1,286969,286969,286970,0,1,1
81961,2,2,286971,286971,286973,0,2,1
81962,3,3,286974,286974,286977,0,3,1
81963,3,3,286977,286977,286980,0,3,0
81964,6,2,286983,286983,286985,0,2,3
81965,6,2,286989,286989,286991,0,2,4
81966,1,2,286990,286991,286993,1,3,0
81967,6,3,286996,286996,286999,0,3,3
81968,1,1,286997,286999,287000,2,3,0
81969,2,2,286999,287000,287002,1,3,0
81970,6,1,287005,287005,287006,0,1,3
81971,6,3,287011,287011,287014,0,3,5
81972,3,3,287014,287014,287017,0,3,0
81973,2,1,287016,287017,287018,1,2,0
81974,4,1,287020,287020,287021,0,1,2
81975,5,1,287025,287025,287026,0,1,4
81976,2,2,287027,287027,287029,0,2,1
81977,3,1,287030,287030,287031,0,1,1
81978,6,3,287036,287036,287039,0,3,5
81979,1,3,287037,287039,287042,2,5,0
81980,4,3,287041,287042,287045,1,4,0
81981,3,2,287044,287045,287047,1,3,0
81982,1,3,287045,287047,287050,2,5,0
81983,4,2,287049,287050,287052,1,3,0
81984,3,3,287052,287052,287055,0,3,0
81985,6,1,287058,287058,287059,0,1,3
81986,3,1,287061,287061,287062,0,1,2
81987,1,2,287062,287062,287064,0,2,0
81988,3,1,287065,287065,287066,0,1,1
81989,2,3,287067,287067,287070,0,3,1
81990,3,1,287070,287070,287071,0,1,0
81991,4,2,287074,287074,287076,0,2,3
81992,1,1,287075,287076,287077,1,2,0
81993,6,3,287081,287081,287084,0,3,4
81994,5,1,287086,287086,287087,0,1,2
81995,6,1,287092,287092,287093,0,1,5
81996,6,2,287098,287098,287100,0,2,5
81997,1,1,287099,287100,287101,1,2,0
81998,3,2,287102,287102,287104,0,2,1
81999,1,3,287103,287104,287107,1,4,0
82000,2,3,287105,287107,287110,2,5,0
82001,4,2,287109,287110,287112,1,3,0
82002,1,3,287110,287112,287115,2,5,0
82003,2,2,287112,287115,287117,3,5,0
82004,5,2,287117,287117,287119,0,2,0
82005,4,2,287121,287121,287123,0,2,2
82006,2,3,287123,287123,287126,0,3,0
82007,1,3,287124,287126,287129,2,5,0
82008,5,3,287129,287129,287132,0,3,0
82009,2,2,287131,287132,287134,1,3,0
82010,1,3,287132,287134,287137,2,5,0
82011,3,3,287135,287137,287140,2,5,0
82012,2,3,287137,287140,287143,3,6,0
82013,1,3,287138,287143,287146,5,8,0
82014,1,2,287139,287146,287148,7,9,0
82015,2,2,287141,287148,287150,7,9,0
82016,6,3,287147,287150,287153,3,6,0
82017,6,1,287153,287153,287154,0,1,0
82018,1,3,287154,287154,287157,0,3,0
82019,2,2,287156,287157,287159,1,3,0
82020,4,1,287160,287160,287161,0,1,1
82021,1,1,287161,287161,287162,0,1,0
82022,2,3,287163,287163,287166,0,3,1
82023,3,1,287166,287166,287167,0,1,0
82024,4,1,287170,287170,287171,0,1,3
82025,3,3,287173,287173,287176,0,3,2
82026,4,2,287177,287177,287179,0,2,1
82027,4,3,287181,287181,287184,0,3,2
82028,1,3,287182,287184,287187,2,5,0
82029,6,3,287188,287188,287191,0,3,1
82030,1,2,287189,287191,287193,2,4,0
82031,5,2,287194,287194,287196,0,2,1
82032,1,1,287195,287196,287197,1,2,0
82033,1,3,287196,287197,287200,1,4,0
82034,1,2,287197,287200,287202,3,5,0
82035,3,2,287200,287202,287204,2,4,0
82036,4,2,287204,287204,287206,0,2,0
82037,6,3,287210,287210,287213,0,3,4
82038,3,1,287213,287213,287214,0,1,0
82039,6,2,287219,287219,287221,0,2,5
82040,5,3,287224,287224,287227,0,3,3
82041,1,3,287225,287227,287230,2,5,0
82042,2,3,287227,287230,287233,3,6,0
82043,5,3,287232,287233,287236,1,4,0
82044,3,2,287235,287236,287238,1,3,0
82045,1,3,287236,287238,287241,2,5,0
82046,5,1,287241,287241,287242,0,1,0
82047,5,2,287246,287246,287248,0,2,4
82048,3,3,287249,287249,287252,0,3,1
82049,2,3,287251,287252,287255,1,4,0
82050,4,2,287255,287255,287257,0,2,0
82051,5,1,287260,287260,287261,0,1,3
82052,6,1,287266,287266,287267,0,1,5
82053,2,2,287268,287268,287270,0,2,1
82054,4,1,287272,287272,287273,0,1,2
82055,3,3,287275,287275,287278,0,3,2
82056,2,3,287277,287278,287281,1,4,0
82057,3,3,287280,287281,287284,1,4,0
82058,4,2,287284,287284,287286,0,2,0
82059,4,1,287288,287288,287289,0,1,2
82060,4,3,287292,287292,287295,0,3,3
82061,5,3,287297,287297,287300,0,3,2
82062,3,1,287300,287300,287301,0,1,0
82063,5,3,287305,287305,287308,0,3,4
82064,6,1,287311,287311,287312,0,1,3
82065,6,3,287317,287317,287320,0,3,5
82066,4,3,287321,287321,287324,0,3,1
82067,5,2,287326,287326,287328,0,2,2
82068,3,3,287329,287329,287332,0,3,1
82069,5,2,287334,287334,287336,0,2,2
82070,1,1,287335,287336,287337,1,2,0
82071,1,3,287336,287337,287340,1,4,0
82072,1,2,287337,287340,287342,3,5,0
82073,6,3,287343,287343,287346,0,3,1
82074,1,3,287344,287346,287349,2,5,0
82075,4,2,287348,287349,287351,1,3,0
82076,4,3,287352,287352,287355,0,3,1
82077,1,2,287353,287355,287357,2,4,0
82078,4,1,287357,287357,287358,0,1,0
82079,3,1,287360,287360,287361,0,1,2
82080,2,1,287362,287362,287363,0,1,1
82081,2,3,287364,287364,287367,0,3,1
82082,4,3,287368,287368,287371,0,3,1
82083,6,2,287374,287374,287376,0,2,3
82084,1,1,287375,287376,287377,1,2,0
82085,1,2,287376,287377,287379,1,3,0
82086,2,2,287378,287379,287381,1,3,0
82087,3,3,287381,287381,287384,0,3,0
82088,1,2,287382,287384,287386,2,4,0
82089,5,1,287387,287387,287388,0,1,1
82090,6,3,287393,287393,287396,0,3,5
82091,4,3,287397,287397,287400,0,3,1
82092,2,1,287399,287400,287401,1,2,0
82093,2,3,287401,287401,287404,0,3,0
82094,1,3,287402,287404,287407,2,5,0
82095,1,1,287403,287407,287408,4,5,0
82096,5,3,287408,287408,287411,0,3,0
82097,6,2,287414,287414,287416,0,2,3
82098,3,2,287417,287417,287419,0,2,1
82099,3,1,287420,287420,287421,0,1,1
82100,6,3,287426,287426,287429,0,3,5
82101,4,3,287430,287430,287433,0,3,1
82102,4,2,287434,287434,287436,0,2,1
82103,6,3,287440,287440,287443,0,3,4
82104,3,3,287443,287443,287446,0,3,0
82105,1,3,287444,287446,287449,2,5,0
82106,2,3,287446,287449,287452,3,6,0
82107,3,1,287449,287452,287453,3,4,0
82108,2,3,287451,287453,287456,2,5,0
82109,4,3,287455,287456,287459,1,4,0
82110,2,2,287457,287459,287461,2,4,0
82111,5,1,287462,287462,287463,0,1,1
82112,1,1,287463,287463,287464,0,1,0
82113,3,1,287466,287466,287467,0,1,2
82114,6,1,287472,287472,287473,0,1,5
82115,4,1,287476,287476,287477,0,1,3
82116,4,2,287480,287480,287482,0,2,3
82117,2,2,287482,287482,287484,0,2,0
82118,4,1,287486,287486,287487,0,1,2
82119,1,1,287487,287487,287488,0,1,0
82120,5,2,287492,287492,287494,0,2,4
82121,3,3,287495,287495,287498,0,3,1
82122,6,3,287501,287501,287504,0,3,3
82123,2,3,287503,287504,287507,1,4,0
82124,2,2,287505,287507,287509,2,4,0
82125,5,1,287510,287510,287511,0,1,1
82126,6,1,287516,287516,287517,0,1,5
82127,6,1,287522,287522,287523,0,1,5
82128,4,3,287526,287526,287529,0,3,3
82129,1,1,287527,287529,287530,2,3,0
82130,4,2,287531,287531,287533,0,2,1
82131,6,1,287537,287537,287538,0,1,4
82132,3,2,287540,287540,287542,0,2,2
82133,2,3,287542,287542,287545,0,3,0
82134,5,1,287547,287547,287548,0,1,2
82135,1,1,287548,287548,287549,0,1,0
82136,3,1,287551,287551,287552,0,1,2
82137,5,2,287556,287556,287558,0,2,4
82138,3,1,287559,287559,287560,0,1,1
82139,3,3,287562,287562,287565,0,3,2
82140,4,1,287566,287566,287567,0,1,1
82141,3,2,287569,287569,287571,0,2,2
82142,3,2,287572,287572,287574,0,2,1
82143,5,2,287577,287577,287579,0,2,3
82144,3,3,287580,287580,287583,0,3,1
82145,3,1,287583,287583,287584,0,1,0
82146,3,2,287586,287586,287588,0,2,2
82147,4,1,287590,287590,287591,0,1,2
82148,3,1,287593,287593,287594,0,1,2
82149,4,3,287597,287597,287600,0,3,3
82150,3,3,287600,287600,287603,0,3,0
82151,2,2,287602,287603,287605,1,3,0
82152,2,1,287604,287605,287606,1,2,0
82153,6,2,287610,287610,287612,0,2,4
82154,4,3,287614,287614,287617,0,3,2
82155,1,1,287615,287617,287618,2,3,0
82156,6,1,287621,287621,287622,0,1,3
82157,1,1,287622,287622,287623,0,1,0
82158,5,3,287627,287627,287630,0,3,4
82159,5,1,287632,287632,287633,0,1,2
82160,3,1,287635,287635,287636,0,1,2
82161,5,3,287640,287640,287643,0,3,4
82162,5,3,287645,287645,287648,0,3,2
82163,2,1,287647,287648,287649,1,2,0
82164,2,2,287649,287649,287651,0,2,0
82165,5,2,287654,287654,287656,0,2,3
82166,5,3,287659,287659,287662,0,3,3
82167,4,3,287663,287663,287666,0,3,1
82168,1,3,287664,287666,287669,2,5,0
82169,3,1,287667,287669,287670,2,3,0
82170,5,1,287672,287672,287673,0,1,2
82171,4,1,287676,287676,287677,0,1,3
82172,5,3,287681,287681,287684,0,3,4
82173,2,2,287683,287684,287686,1,3,0
82174,6,3,287689,287689,287692,0,3,3
82175,6,2,287695,287695,287697,0,2,3
82176,3,2,287698,287698,287700,0,2,1
82177,6,3,287704,287704,287707,0,3,4
82178,6,1,287710,287710,287711,0,1,3
82179,2,3,287712,287712,287715,0,3,1
82180,4,1,287716,287716,287717,0,1,1
82181,3,1,287719,287719,287720,0,1,2
82182,1,2,287720,287720,287722,0,2,0
82183,5,3,287725,287725,287728,0,3,3
82184,1,2,287726,287728,287730,2,4,0
82185,6,3,287732,287732,287735,0,3,2
82186,6,3,287738,287738,287741,0,3,3
82187,1,2,287739,287741,287743,2,4,0
82188,6,3,287745,287745,287748,0,3,2
82189,4,3,287749,287749,287752,0,3,1
82190,6,3,287755,287755,287758,0,3,3
82191,2,2,287757,287758,287760,1,3,0
82192,3,3,287760,287760,287763,0,3,0
82193,2,2,287762,287763,287765,1,3,0
82194,1,2,287763,287765,287767,2,4,0
82195,6,2,287769,287769,287771,0,2,2
82196,6,2,287775,287775,287777,0,2,4
82197,2,2,287777,287777,287779,0,2,0
82198,2,2,287779,287779,287781,0,2,0
82199,5,1,287784,287784,287785,0,1,3
82200,6,1,287790,287790,287791,0,1,5
82201,6,1,287796,287796,287797,0,1,5
82202,4,1,287800,287800,287801,0,1,3
82203,2,1,287802,287802,287803,0,1,1
82204,4,3,287806,287806,287809,0,3,3
82205,4,1,287810,287810,287811,0,1,1
82206,1,2,287811,287811,287813,0,2,0
82207,5,3,287816,287816,287819,0,3,3
82208,2,2,287818,287819,287821,1,3,0
82209,1,3,287819,287821,287824,2,5,0
82210,5,3,287824,287824,287827,0,3,0
82211,4,3,287828,287828,287831,0,3,1
82212,3,3,287831,287831,287834,0,3,0
82213,2,2,287833,287834,287836,1,3,0
82214,3,2,287836,287836,287838,0,2,0
82215,6,2,287842,287842,287844,0,2,4
82216,1,1,287843,287844,287845,1,2,0
82217,3,3,287846,287846,287849,0,3,1
82218,1,2,287847,287849,287851,2,4,0
82219,6,1,287853,287853,287854,0,1,2
82220,3,3,287856,287856,287859,0,3,2
82221,6,3,287862,287862,287865,0,3,3
82222,5,3,287867,287867,287870,0,3,2
82223,4,1,287871,287871,287872,0,1,1
82224,3,2,287874,287874,287876,0,2,2
82225,4,1,287878,287878,287879,0,1,2
82226,5,1,287883,287883,287884,0,1,4
82227,1,1,287884,287884,287885,0,1,0
82228,6,3,287890,287890,287893,0,3,5
82229,4,3,287894,287894,287897,0,3,1
82230,4,1,287898,287898,287899,0,1,1
82231,2,2,287900,287900,287902,0,2,1
82232,5,2,287905,287905,287907,0,2,3
82233,3,3,287908,287908,287911,0,3,1
82234,1,2,287909,287911,287913,2,4,0
82235,2,1,287911,287913,287914,2,3,0
82236,4,3,287915,287915,287918,0,3,1
82237,4,1,287919,287919,287920,0,1,1
82238,3,3,287922,287922,287925,0,3,2
82239,3,3,287925,287925,287928,0,3,0
82240,6,3,287931,287931,287934,0,3,3
82241,2,1,287933,287934,287935,1,2,0
82242,1,2,287934,287935,287937,1,3,0
82243,6,3,287940,287940,287943,0,3,3
82244,2,3,287942,287943,287946,1,4,0
82245,2,2,287944,287946,287948,2,4,0
82246,3,3,287947,287948,287951,1,4,0
82247,1,3,287948,287951,287954,3,6,0
82248,2,1,287950,287954,287955,4,5,0
82249,4,1,287954,287955,287956,1,2,0
82250,1,1,287955,287956,287957,1,2,0
82251,5,1,287960,287960,287961,0,1,3
82252,4,3,287964,287964,287967,0,3,3
82253,2,3,287966,287967,287970,1,4,0
82254,5,1,287971,287971,287972,0,1,1
82255,4,1,287975,287975,287976,0,1,3
82256,4,3,287979,287979,287982,0,3,3
82257,6,2,287985,287985,287987,0,2,3
82258,3,3,287988,287988,287991,0,3,1
82259,4,1,287992,287992,287993,0,1,1
82260,2,3,287994,287994,287997,0,3,1
82261,4,3,287998,287998,288001,0,3,1
82262,2,2,288000,288001,288003,1,3,0
82263,2,3,288002,288003,288006,1,4,0
82264,3,1,288005,288006,288007,1,2,0
82265,5,1,288010,288010,288011,0,1,3
82266,1,1,288011,288011,288012,0,1,0
82267,3,1,288014,288014,288015,0,1,2
82268,4,2,288018,288018,288020,0,2,3
82269,4,2,288022,288022,288024,0,2,2
82270,4,2,288026,288026,288028,0,2,2
82271,5,3,288031,288031,288034,0,3,3
82272,1,3,288032,288034,288037,2,5,0
82273,2,2,288034,288037,288039,3,5,0
82274,2,3,288036,288039,288042,3,6,0
82275,3,2,288039,288042,288044,3,5,0
82276,3,1,288042,288044,288045,2,3,0
82277,6,3,288048,288048,288051,0,3,3
82278,2,1,288050,288051,288052,1,2,0
82279,2,2,288052,288052,288054,0,2,0
82280,2,3,288054,288054,288057,0,3,0
82281,3,2,288057,288057,288059,0,2,0
82282,5,1,288062,288062,288063,0,1,3
82283,6,3,288068,288068,288071,0,3,5
82284,6,2,288074,288074,288076,0,2,3
82285,1,2,288075,288076,288078,1,3,0
82286,6,1,288081,288081,288082,0,1,3
82287,1,2,288082,288082,288084,0,2,0
82288,6,3,288088,288088,288091,0,3,4
82289,3,1,288091,288091,288092,0,1,0
82290,1,3,288092,288092,288095,0,3,0
82291,4,2,288096,288096,288098,0,2,1
82292,5,2,288101,288101,288103,0,2,3
82293,6,2,288107,288107,288109,0,2,4
82294,6,3,288113,288113,288116,0,3,4
82295,1,2,288114,288116,288118,2,4,0
82296,4,2,288118,288118,288120,0,2,0
82297,5,3,288123,288123,288126,0,3,3
82298,2,1,288125,288126,288127,1,2,0
82299,1,3,288126,288127,288130,1,4,0
82300,5,1,288131,288131,288132,0,1,1
82301,3,3,288134,288134,288137,0,3,2
82302,3,1,288137,288137,288138,0,1,0
82303,2,2,288139,288139,288141,0,2,1
82304,1,3,288140,288141,288144,1,4,0
82305,1,2,288141,288144,288146,3,5,0
82306,2,1,288143,288146,288147,3,4,0
82307,6,3,288149,288149,288152,0,3,2
82308,2,3,288151,288152,288155,1,4,0
82309,3,3,288154,288155,288158,1,4,0
82310,1,3,288155,288158,288161,3,6,0
82311,4,3,288159,288161,288164,2,5,0
82312,4,3,288163,288164,288167,1,4,0
82313,5,2,288168,288168,288170,0,2,1
82314,1,3,288169,288170,288173,1,4,0
82315,2,3,288171,288173,288176,2,5,0
82316,5,2,288176,288176,288178,0,2,0
82317,5,1,288181,288181,288182,0,1,3
82318,3,3,288184,288184,288187,0,3,2
82319,3,2,288187,288187,288189,0,2,0
82320,1,3,288188,288189,288192,1,4,0
82321,5,1,288193,288193,288194,0,1,1
82322,2,1,288195,288195,288196,0,1,1
82323,1,1,288196,288196,288197,0,1,0
82324,3,2,288199,288199,288201,0,2,2
82325,2,1,288201,288201,288202,0,1,0
82326,5,1,288206,288206,288207,0,1,4
82327,1,2,288207,288207,288209,0,2,0
82328,3,2,288210,288210,288212,0,2,1
82329,4,1,288214,288214,288215,0,1,2
82330,4,1,288218,288218,288219,0,1,3
82331,1,2,288219,288219,288221,0,2,0
82332,4,3,288223,288223,288226,0,3,2
82333,3,2,288226,288226,288228,0,2,0
82334,4,3,288230,288230,288233,0,3,2
82335,3,1,288233,288233,288234,0,1,0
82336,3,1,288236,288236,288237,0,1,2
82337,4,2,288240,288240,288242,0,2,3
82338,6,3,288246,288246,288249,0,3,4
82339,3,2,288249,288249,288251,0,2,0
82340,1,2,288250,288251,288253,1,3,0
82341,3,2,288253,288253,288255,0,2,0
82342,5,3,288258,288258,288261,0,3,3
82343,1,1,288259,288261,288262,2,3,0
82344,2,3,288261,288262,288265,1,4,0
82345,5,3,288266,288266,288269,0,3,1
82346,2,2,288268,288269,288271,1,3,0
82347,4,3,288272,288272,288275,0,3,1
82348,2,1,288274,288275,288276,1,2,0
82349,4,2,288278,288278,288280,0,2,2
82350,4,1,288282,288282,288283,0,1,2
82351,2,1,288284,288284,288285,0,1,1
82352,6,3,288290,288290,288293,0,3,5
82353,6,2,288296,288296,288298,0,2,3
82354,5,1,288301,288301,288302,0,1,3
82355,6,2,288307,288307,288309,0,2,5
82356,5,1,288312,288312,288313,0,1,3
82357,3,2,288315,288315,288317,0,2,2
82358,1,2,288316,288317,288319,1,3,0
82359,5,1,288321,288321,288322,0,1,2
82360,3,3,288324,288324,288327,0,3,2
82361,3,2,288327,288327,288329,0,2,0
82362,2,2,288329,288329,288331,0,2,0
82363,4,3,288333,288333,288336,0,3,2
82364,6,2,288339,288339,288341,0,2,3
82365,1,3,288340,288341,288344,1,4,0
82366,4,1,288344,288344,288345,0,1,0
82367,1,3,288345,288345,288348,0,3,0
82368,6,3,288351,288351,288354,0,3,3
82369,6,3,288357,288357,288360,0,3,3
82370,6,3,288363,288363,288366,0,3,3
82371,2,2,288365,288366,288368,1,3,0
82372,4,3,288369,288369,288372,0,3,1
82373,6,3,288375,288375,288378,0,3,3
82374,1,2,288376,288378,288380,2,4,0
82375,2,2,288378,288380,288382,2,4,0
82376,6,1,288384,288384,288385,0,1,2
82377,6,2,288390,288390,288392,0,2,5
82378,4,2,288394,288394,288396,0,2,2
82379,1,3,288395,288396,288399,1,4,0
82380,4,2,288399,288399,288401,0,2,0
82381,5,2,288404,288404,288406,0,2,3
82382,4,1,288408,288408,288409,0,1,2
82383,5,2,288413,288413,288415,0,2,4
82384,6,1,288419,288419,288420,0,1,4
82385,4,1,288423,288423,288424,0,1,3
82386,1,1,288424,288424,288425,0,1,0
82387,6,3,288430,288430,288433,0,3,5
82388,6,3,288436,288436,288439,0,3,3
82389,5,1,288441,288441,288442,0,1,2
82390,1,3,288442,288442,288445,0,3,0
82391,2,3,288444,288445,288448,1,4,0
82392,1,3,288445,288448,288451,3,6,0
82393,2,1,288447,288451,288452,4,5,0
82394,4,1,288451,288452,288453,1,2,0
82395,2,3,288453,288453,288456,0,3,0
82396,1,1,288454,288456,288457,2,3,0
82397,3,3,288457,288457,288460,0,3,0
82398,4,3,288461,288461,288464,0,3,1
82399,4,1,288465,288465,288466,0,1,1
82400,5,3,288470,288470,288473,0,3,4
82401,6,1,288476,288476,288477,0,1,3
82402,6,3,288482,288482,288485,0,3,5
82403,1,1,288483,288485,288486,2,3,0
82404,4,2,288487,288487,288489,0,2,1
82405,3,1,288490,288490,288491,0,1,1
82406,3,1,288493,288493,288494,0,1,2
82407,6,1,288499,288499,288500,0,1,5
82408,5,1,288504,288504,288505,0,1,4
82409,6,1,288510,288510,288511,0,1,5
82410,6,2,288516,288516,288518,0,2,5
82411,6,3,288522,288522,288525,0,3,4
82412,1,1,288523,288525,288526,2,3,0
82413,6,2,288529,288529,288531,0,2,3
82414,6,3,288535,288535,288538,0,3,4
82415,3,1,288538,288538,288539,0,1,0
82416,5,2,288543,288543,288545,0,2,4
82417,2,3,288545,288545,288548,0,3,0
82418,1,2,288546,288548,288550,2,4,0
82419,3,3,288549,288550,288553,1,4,0
82420,2,3,288551,288553,288556,2,5,0
82421,6,1,288557,288557,288558,0,1,1
82422,2,1,288559,288559,288560,0,1,1
82423,4,3,288563,288563,288566,0,3,3
82424,5,2,288568,288568,288570,0,2,2
82425,5,2,288573,288573,288575,0,2,3
82426,5,1,288578,288578,288579,0,1,3
82427,2,3,288580,288580,288583,0,3,1
82428,2,3,288582,288583,288586,1,4,0
82429,4,2,288586,288586,288588,0,2,0
82430,4,2,288590,288590,288592,0,2,2
82431,1,1,288591,288592,288593,1,2,0
82432,1,1,288592,288593,288594,1,2,0
82433,6,2,288598,288598,288600,0,2,4
82434,6,2,288604,288604,288606,0,2,4
82435,1,3,288605,288606,288609,1,4,0
82436,5,2,288610,288610,288612,0,2,1
82437,4,3,288614,288614,288617,0,3,2
82438,4,1,288618,288618,288619,0,1,1
82439,5,2,288623,288623,288625,0,2,4
82440,3,1,288626,288626,288627,0,1,1
82441,2,1,288628,288628,288629,0,1,1
82442,1,2,288629,288629,288631,0,2,0
82443,1,3,288630,288631,288634,1,4,0
82444,2,2,288632,288634,288636,2,4,0
82445,6,2,288638,288638,288640,0,2,2
82446,2,1,288640,288640,288641,0,1,0
82447,6,2,288646,288646,288648,0,2,5
82448,3,1,288649,288649,288650,0,1,1
82449,2,2,288651,288651,288653,0,2,1
82450,3,3,288654,288654,288657,0,3,1
82451,2,2,288656,288657,288659,1,3,0
82452,6,3,288662,288662,288665,0,3,3
82453,1,2,288663,288665,288667,2,4,0
82454,6,2,288669,288669,288671,0,2,2
82455,3,1,288672,288672,288673,0,1,1
82456,2,2,288674,288674,288676,0,2,1
82457,2,2,288676,288676,288678,0,2,0
82458,4,2,288680,288680,288682,0,2,2
82459,4,2,288684,288684,288686,0,2,2
82460,5,1,288689,288689,288690,0,1,3
82461,4,3,288693,288693,288696,0,3,3
82462,1,2,288694,288696,288698,2,4,0
82463,4,1,288698,288698,288699,0,1,0
82464,2,2,288700,288700,288702,0,2,1
82465,3,2,288703,288703,288705,0,2,1
82466,1,3,288704,288705,288708,1,4,0
82467,1,1,288705,288708,288709,3,4,0
82468,6,3,288711,288711,288714,0,3,2
82469,6,1,288717,288717,288718,0,1,3
82470,3,3,288720,288720,288723,0,3,2
82471,4,1,288724,288724,288725,0,1,1
82472,3,2,288727,288727,288729,0,2,2
82473,4,2,288731,288731,288733,0,2,2
82474,6,3,288737,288737,288740,0,3,4
82475,5,2,288742,288742,288744,0,2,2
82476,3,1,288745,288745,288746,0,1,1
82477,4,3,288749,288749,288752,0,3,3
82478,5,1,288754,288754,288755,0,1,2
82479,5,3,288759,288759,288762,0,3,4
82480,6,1,288765,288765,288766,0,1,3
82481,2,2,288767,288767,288769,0,2,1
82482,3,3,288770,288770,288773,0,3,1
82483,3,1,288773,288773,288774,0,1,0
82484,2,1,288775,288775,288776,0,1,1
82485,6,1,288781,288781,288782,0,1,5
82486,3,2,288784,288784,288786,0,2,2
82487,5,2,288789,288789,288791,0,2,3
82488,6,1,288795,288795,288796,0,1,4
82489,1,2,288796,288796,288798,0,2,0
82490,2,1,288798,288798,288799,0,1,0
82491,3,1,288801,288801,288802,0,1,2
82492,1,1,288802,288802,288803,0,1,0
82493,1,2,288803,288803,288805,0,2,0
82494,1,2,288804,288805,288807,1,3,0
82495,5,3,288809,288809,288812,0,3,2
82496,4,1,288813,288813,288814,0,1,1
82497,5,3,288818,288818,288821,0,3,4
82498,5,1,288823,288823,288824,0,1,2
82499,5,3,288828,288828,288831,0,3,4
82500,1,1,288829,288831,288832,2,3,0
82501,5,1,288834,288834,288835,0,1,2
82502,4,3,288838,288838,288841,0,3,3
82503,3,3,288841,288841,288844,0,3,0
82504,3,1,288844,288844,288845,0,1,0
82505,6,2,288850,288850,288852,0,2,5
82506,2,3,288852,288852,288855,0,3,0
82507,4,1,288856,288856,288857,0,1,1
82508,4,1,288860,288860,288861,0,1,3
82509,1,1,288861,288861,288862,0,1,0
82510,1,1,288862,288862,288863,0,1,0
82511,5,3,288867,288867,288870,0,3,4
82512,5,1,288872,288872,288873,0,1,2
82513,3,2,288875,288875,288877,0,2,2
82514,1,1,288876,288877,288878,1,2,0
82515,4,2,288880,288880,288882,0,2,2
82516,4,3,288884,288884,288887,0,3,2
82517,1,2,288885,288887,288889,2,4,0
82518,4,3,288889,288889,288892,0,3,0
82519,1,3,288890,288892,288895,2,5,0
82520,6,3,288896,288896,288899,0,3,1
82521,3,3,288899,288899,288902,0,3,0
82522,2,1,288901,288902,288903,1,2,0
82523,2,1,288903,288903,288904,0,1,0
82524,6,1,288909,288909,288910,0,1,5
82525,4,1,288913,288913,288914,0,1,3
82526,5,3,288918,288918,288921,0,3,4
82527,3,2,288921,288921,288923,0,2,0
82528,4,1,288925,288925,288926,0,1,2
82529,5,2,288930,288930,288932,0,2,4
82530,1,3,288931,288932,288935,1,4,0
82531,3,3,288934,288935,288938,1,4,0
82532,6,3,288940,288940,288943,0,3,2
82533,3,2,288943,288943,288945,0,2,0
82534,3,1,288946,288946,288947,0,1,1
82535,4,1,288950,288950,288951,0,1,3
82536,2,3,288952,288952,288955,0,3,1
82537,3,3,288955,288955,288958,0,3,0
82538,2,3,288957,288958,288961,1,4,0
82539,4,2,288961,288961,288963,0,2,0
82540,3,2,288964,288964,288966,0,2,1
82541,2,1,288966,288966,288967,0,1,0
82542,1,2,288967,288967,288969,0,2,0
82543,4,1,288971,288971,288972,0,1,2
82544,1,3,288972,288972,288975,0,3,0
82545,5,1,288977,288977,288978,0,1,2
82546,5,1,288982,288982,288983,0,1,4
82547,5,1,288987,288987,288988,0,1,4
82548,5,1,288992,288992,288993,0,1,4
82549,2,3,288994,288994,288997,0,3,1
82550,4,1,288998,288998,288999,0,1,1
82551,3,2,289001,289001,289003,0,2,2
82552,6,2,289007,289007,289009,0,2,4
82553,3,2,289010,289010,289012,0,2,1
82554,3,2,289013,289013,289015,0,2,1
82555,2,3,289015,289015,289018,0,3,0
82556,4,3,289019,289019,289022,0,3,1
82557,5,1,289024,289024,289025,0,1,2
82558,2,1,289026,289026,289027,0,1,1
82559,2,3,289028,289028,289031,0,3,1
82560,4,1,289032,289032,289033,0,1,1
82561,5,3,289037,289037,289040,0,3,4
82562,3,3,289040,289040,289043,0,3,0
82563,2,2,289042,289043,289045,1,3,0
82564,1,3,289043,289045,289048,2,5,0
82565,3,3,289046,289048,289051,2,5,0
82566,5,2,289051,289051,289053,0,2,0
82567,2,1,289053,289053,289054,0,1,0
82568,5,3,289058,289058,289061,0,3,4
82569,5,3,289063,289063,289066,0,3,2
82570,1,3,289064,289066,289069,2,5,0
82571,4,3,289068,289069,289072,1,4,0
82572,6,1,289074,289074,289075,0,1,2
82573,6,3,289080,289080,289083,0,3,5
82574,4,1,289084,289084,289085,0,1,1
82575,6,1,289090,289090,289091,0,1,5
82576,6,1,289096,289096,289097,0,1,5
82577,2,2,289098,289098,289100,0,2,1
82578,6,2,289104,289104,289106,0,2,4
82579,5,1,289109,289109,289110,0,1,3
82580,6,2,289115,289115,289117,0,2,5
82581,5,1,289120,289120,289121,0,1,3
82582,2,2,289122,289122,289124,0,2,1
82583,4,3,289126,289126,289129,0,3,2
82584,5,3,289131,289131,289134,0,3,2
82585,3,2,289134,289134,289136,0,2,0
82586,5,1,289139,289139,289140,0,1,3
82587,6,2,289145,289145,289147,0,2,5
82588,4,2,289149,289149,289151,0,2,2
82589,6,1,289155,289155,289156,0,1,4
82590,6,1,289161,289161,289162,0,1,5
82591,6,2,289167,289167,289169,0,2,5
82592,6,1,289173,289173,289174,0,1,4
82593,1,3,289174,289174,289177,0,3,0
82594,6,2,289180,289180,289182,0,2,3
82595,3,3,289183,289183,289186,0,3,1
82596,1,3,289184,289186,289189,2,5,0
82597,3,1,289187,289189,289190,2,3,0
82598,2,3,289189,289190,289193,1,4,0
82599,6,3,289195,289195,289198,0,3,2
82600,5,3,289200,289200,289203,0,3,2
82601,2,1,289202,289203,289204,1,2,0
82602,1,2,289203,289204,289206,1,3,0
82603,6,2,289209,289209,289211,0,2,3
82604,1,3,289210,289211,289214,1,4,0
82605,6,1,289216,289216,289217,0,1,2
82606,1,2,289217,289217,289219,0,2,0
82607,5,1,289222,289222,289223,0,1,3
82608,5,3,289227,289227,289230,0,3,4
82609,4,3,289231,289231,289234,0,3,1
82610,3,1,289234,289234,289235,0,1,0
82611,2,1,289236,289236,289237,0,1,1
82612,1,1,289237,289237,289238,0,1,0
82613,4,1,289241,289241,289242,0,1,3
82614,5,2,289246,289246,289248,0,2,4
82615,4,2,289250,289250,289252,0,2,2
82616,4,2,289254,289254,289256,0,2,2
82617,1,3,289255,289256,289259,1,4,0
82618,2,2,289257,289259,289261,2,4,0
82619,4,1,289261,289261,289262,0,1,0
82620,1,1,289262,289262,289263,0,1,0
82621,1,1,289263,289263,289264,0,1,0
82622,5,2,289268,289268,289270,0,2,4
82623,5,2,289273,289273,289275,0,2,3
82624,5,1,289278,289278,289279,0,1,3
82625,6,2,289284,289284,289286,0,2,5
82626,2,2,289286,289286,289288,0,2,0
82627,3,2,289289,289289,289291,0,2,1
82628,3,3,289292,289292,289295,0,3,1
82629,5,2,289297,289297,289299,0,2,2
82630,3,2,289300,289300,289302,0,2,1
82631,2,3,289302,289302,289305,0,3,0
82632,6,2,289308,289308,289310,0,2,3
82633,3,1,289311,289311,289312,0,1,1
82634,5,2,289316,289316,289318,0,2,4
82635,5,3,289321,289321,289324,0,3,3
82636,6,2,289327,289327,289329,0,2,3
82637,3,2,289330,289330,289332,0,2,1
82638,6,2,289336,289336,289338,0,2,4
82639,1,1,289337,289338,289339,1,2,0
82640,5,3,289342,289342,289345,0,3,3
82641,1,2,289343,289345,289347,2,4,0
82642,1,2,289344,289347,289349,3,5,0
82643,1,2,289345,289349,289351,4,6,0
82644,6,1,289351,289351,289352,0,1,0
82645,5,1,289356,289356,289357,0,1,4
82646,1,1,289357,289357,289358,0,1,0
82647,5,1,289362,289362,289363,0,1,4
82648,5,3,289367,289367,289370,0,3,4
82649,6,1,289373,289373,289374,0,1,3
82650,4,2,289377,289377,289379,0,2,3
82651,3,1,289380,289380,289381,0,1,1
82652,2,2,289382,289382,289384,0,2,1
82653,3,3,289385,289385,289388,0,3,1
82654,2,3,289387,289388,289391,1,4,0
82655,6,2,289393,289393,289395,0,2,2
82656,5,2,289398,289398,289400,0,2,3
82657,5,2,289403,289403,289405,0,2,3
82658,3,3,289406,289406,289409,0,3,1
82659,3,3,289409,289409,289412,0,3,0
82660,3,2,289412,289412,289414,0,2,0
82661,2,1,289414,289414,289415,0,1,0
82662,3,1,289417,289417,289418,0,1,2
82663,2,3,289419,289419,289422,0,3,1
82664,5,3,289424,289424,289427,0,3,2
82665,6,1,289430,289430,289431,0,1,3
82666,1,3,289431,289431,289434,0,3,0
82667,5,2,289436,289436,289438,0,2,2
82668,2,1,289438,289438,289439,0,1,0
82669,3,2,289441,289441,289443,0,2,2
82670,2,2,289443,289443,289445,0,2,0
82671,2,2,289445,289445,289447,0,2,0
82672,4,2,289449,289449,289451,0,2,2
82673,2,2,289451,289451,289453,0,2,0
82674,1,3,289452,289453,289456,1,4,0
82675,5,1,289457,289457,289458,0,1,1
82676,3,3,289460,289460,289463,0,3,2
82677,4,3,289464,289464,289467,0,3,1
82678,2,3,289466,289467,289470,1,4,0
82679,6,2,289472,289472,289474,0,2,2
82680,1,3,289473,289474,289477,1,4,0
82681,5,3,289478,289478,289481,0,3,1
82682,5,3,289483,289483,289486,0,3,2
82683,4,3,289487,289487,289490,0,3,1
82684,4,3,289491,289491,289494,0,3,1
82685,3,3,289494,289494,289497,0,3,0
82686,2,2,289496,289497,289499,1,3,0
82687,5,3,289501,289501,289504,0,3,2
82688,6,3,289507,289507,289510,0,3,3
82689,4,1,289511,289511,289512,0,1,1
82690,4,3,289515,289515,289518,0,3,3
82691,6,2,289521,289521,289523,0,2,3
82692,3,1,289524,289524,289525,0,1,1
82693,6,1,289530,289530,289531,0,1,5
82694,5,3,289535,289535,289538,0,3,4
82695,1,2,289536,289538,289540,2,4,0
82696,3,1,289539,289540,289541,1,2,0
82697,6,1,289545,289545,289546,0,1,4
82698,5,1,289550,289550,289551,0,1,4
82699,4,2,289554,289554,289556,0,2,3
82700,1,2,289555,289556,289558,1,3,0
82701,4,1,289559,289559,289560,0,1,1
82702,1,1,289560,289560,289561,0,1,0
82703,4,1,289564,289564,289565,0,1,3
82704,1,3,289565,289565,289568,0,3,0
82705,6,2,289571,289571,289573,0,2,3
82706,4,2,289575,289575,289577,0,2,2
82707,4,3,289579,289579,289582,0,3,2
82708,2,1,289581,289582,289583,1,2,0
82709,2,3,289583,289583,289586,0,3,0
82710,2,1,289585,289586,289587,1,2,0
82711,2,1,289587,289587,289588,0,1,0
82712,5,3,289592,289592,289595,0,3,4
82713,1,1,289593,289595,289596,2,3,0
82714,1,1,289594,289596,289597,2,3,0
82715,3,2,289597,289597,289599,0,2,0
82716,1,2,289598,289599,289601,1,3,0
82717,2,1,289600,289601,289602,1,2,0
82718,2,2,289602,289602,289604,0,2,0
82719,6,3,289608,289608,289611,0,3,4
82720,1,3,289609,289611,289614,2,5,0
82721,4,1,289613,289614,289615,1,2,0
82722,2,2,289615,289615,289617,0,2,0
82723,3,1,289618,289618,289619,0,1,1
82724,1,1,289619,289619,289620,0,1,0
82725,6,3,289625,289625,289628,0,3,5
82726,5,1,289630,289630,289631,0,1,2
82727,6,2,289636,289636,289638,0,2,5
82728,1,1,289637,289638,289639,1,2,0
82729,6,2,289643,289643,289645,0,2,4
82730,5,2,289648,289648,289650,0,2,3
82731,6,1,289654,289654,289655,0,1,4
82732,5,1,289659,289659,289660,0,1,4
82733,5,1,289664,289664,289665,0,1,4
82734,1,2,289665,289665,289667,0,2,0
82735,3,2,289668,289668,289670,0,2,1
82736,5,1,289673,289673,289674,0,1,3
82737,6,2,289679,289679,289681,0,2,5
82738,6,3,289685,289685,289688,0,3,4
82739,1,2,289686,289688,289690,2,4,0
82740,3,1,289689,289690,289691,1,2,0
82741,3,3,289692,289692,289695,0,3,1
82742,5,1,289697,289697,289698,0,1,2
82743,5,2,289702,289702,289704,0,2,4
82744,2,1,289704,289704,289705,0,1,0
82745,4,2,289708,289708,289710,0,2,3
82746,4,2,289712,289712,289714,0,2,2
82747,1,3,289713,289714,289717,1,4,0
82748,5,2,289718,289718,289720,0,2,1
82749,2,1,289720,289720,289721,0,1,0
82750,6,2,289726,289726,289728,0,2,5
82751,6,3,289732,289732,289735,0,3,4
82752,2,2,289734,289735,289737,1,3,0
82753,6,3,289740,289740,289743,0,3,3
82754,1,3,289741,289743,289746,2,5,0
82755,3,2,289744,289746,289748,2,4,0
82756,4,3,289748,289748,289751,0,3,0
82757,6,2,289754,289754,289756,0,2,3
82758,5,2,289759,289759,289761,0,2,3
82759,2,1,289761,289761,289762,0,1,0
82760,6,1,289767,289767,289768,0,1,5
82761,4,1,289771,289771,289772,0,1,3
82762,3,1,289774,289774,289775,0,1,2
82763,3,3,289777,289777,289780,0,3,2
82764,5,3,289782,289782,289785,0,3,2
82765,2,3,289784,289785,289788,1,4,0
82766,2,1,289786,289788,289789,2,3,0
82767,6,3,289792,289792,289795,0,3,3
82768,5,2,289797,289797,289799,0,2,2
82769,6,3,289803,289803,289806,0,3,4
82770,1,1,289804,289806,289807,2,3,0
82771,2,2,289806,289807,289809,1,3,0
82772,3,1,289809,289809,289810,0,1,0
82773,4,2,289813,289813,289815,0,2,3
82774,1,1,289814,289815,289816,1,2,0
82775,2,1,289816,289816,289817,0,1,0
82776,6,3,289822,289822,289825,0,3,5
82777,4,2,289826,289826,289828,0,2,1
82778,4,1,289830,289830,289831,0,1,2
82779,4,2,289834,289834,289836,0,2,3
82780,6,2,289840,289840,289842,0,2,4
82781,4,1,289844,289844,289845,0,1,2
82782,6,2,289850,289850,289852,0,2,5
82783,2,3,289852,289852,289855,0,3,0
82784,4,2,289856,289856,289858,0,2,1
82785,4,1,289860,289860,289861,0,1,2
82786,1,2,289861,289861,289863,0,2,0
82787,2,3,289863,289863,289866,0,3,0
82788,2,1,289865,289866,289867,1,2,0
82789,5,3,289870,289870,289873,0,3,3
82790,5,1,289875,289875,289876,0,1,2
82791,4,2,289879,289879,289881,0,2,3
82792,3,3,289882,289882,289885,0,3,1
82793,3,3,289885,289885,289888,0,3,0
82794,4,2,289889,289889,289891,0,2,1
82795,4,2,289893,289893,289895,0,2,2
82796,3,1,289896,289896,289897,0,1,1
82797,4,1,289900,289900,289901,0,1,3
82798,3,3,289903,289903,289906,0,3,2
82799,4,1,289907,289907,289908,0,1,1
82800,6,3,289913,289913,289916,0,3,5
82801,5,3,289918,289918,289921,0,3,2
82802,5,1,289923,289923,289924,0,1,2
82803,5,1,289928,289928,289929,0,1,4
82804,3,3,289931,289931,289934,0,3,2
82805,3,1,289934,289934,289935,0,1,0
82806,2,3,289936,289936,289939,0,3,1
82807,6,1,289942,289942,289943,0,1,3
82808,5,2,289947,289947,289949,0,2,4
82809,5,2,289952,289952,289954,0,2,3
82810,2,3,289954,289954,289957,0,3,0
82811,1,1,289955,289957,289958,2,3,0
82812,5,2,289960,289960,289962,0,2,2
82813,1,3,289961,289962,289965,1,4,0
82814,5,1,289966,289966,289967,0,1,1
82815,2,3,289968,289968,289971,0,3,1
82816,5,2,289973,289973,289975,0,2,2
82817,5,3,289978,289978,289981,0,3,3
82818,2,3,289980,289981,289984,1,4,0
82819,2,1,289982,289984,289985,2,3,0
82820,4,2,289986,289986,289988,0,2,1
82821,1,1,289987,289988,289989,1,2,0
82822,5,1,289992,289992,289993,0,1,3
82823,4,1,289996,289996,289997,0,1,3
82824,4,3,290000,290000,290003,0,3,3
82825,2,2,290002,290003,290005,1,3,0
82826,5,2,290007,290007,290009,0,2,2
82827,5,1,290012,290012,290013,0,1,3
82828,2,1,290014,290014,290015,0,1,1
82829,2,3,290016,290016,290019,0,3,1
82830,1,2,290017,290019,290021,2,4,0
82831,4,2,290021,290021,290023,0,2,0
82832,2,1,290023,290023,290024,0,1,0
82833,4,1,290027,290027,290028,0,1,3
82834,3,2,290030,290030,290032,0,2,2
82835,2,3,290032,290032,290035,0,3,0
82836,5,3,290037,290037,290040,0,3,2
82837,6,1,290043,290043,290044,0,1,3
82838,4,2,290047,290047,290049,0,2,3
82839,3,1,290050,290050,290051,0,1,1
82840,6,1,290056,290056,290057,0,1,5
82841,5,3,290061,290061,290064,0,3,4
82842,4,1,290065,290065,290066,0,1,1
82843,6,3,290071,290071,290074,0,3,5
82844,2,3,290073,290074,290077,1,4,0
82845,2,1,290075,290077,290078,2,3,0
82846,5,3,290080,290080,290083,0,3,2
82847,1,1,290081,290083,290084,2,3,0
82848,5,1,290086,290086,290087,0,1,2
82849,4,1,290090,290090,290091,0,1,3
82850,4,1,290094,290094,290095,0,1,3
82851,6,2,290100,290100,290102,0,2,5
82852,2,3,290102,290102,290105,0,3,0
82853,5,1,290107,290107,290108,0,1,2
82854,3,1,290110,290110,290111,0,1,2
82855,4,1,290114,290114,290115,0,1,3
82856,2,2,290116,290116,290118,0,2,1
82857,1,3,290117,290118,290121,1,4,0
82858,5,2,290122,290122,290124,0,2,1
82859,6,1,290128,290128,290129,0,1,4
82860,2,2,290130,290130,290132,0,2,1
82861,1,1,290131,290132,290133,1,2,0
82862,1,2,290132,290133,290135,1,3,0
82863,4,3,290136,290136,290139,0,3,1
82864,4,1,290140,290140,290141,0,1,1
82865,4,2,290144,290144,290146,0,2,3
82866,6,2,290150,290150,290152,0,2,4
82867,2,1,290152,290152,290153,0,1,0
82868,2,3,290154,290154,290157,0,3,1
82869,5,2,290159,290159,290161,0,2,2
82870,1,2,290160,290161,290163,1,3,0
82871,5,3,290165,290165,290168,0,3,2
82872,5,2,290170,290170,290172,0,2,2
82873,5,3,290175,290175,290178,0,3,3
82874,1,1,290176,290178,290179,2,3,0
82875,5,3,290181,290181,290184,0,3,2
82876,1,1,290182,290184,290185,2,3,0
82877,3,2,290185,290185,290187,0,2,0
82878,5,2,290190,290190,290192,0,2,3
82879,2,2,290192,290192,290194,0,2,0
82880,2,2,290194,290194,290196,0,2,0
82881,5,2,290199,290199,290201,0,2,3
82882,5,1,290204,290204,290205,0,1,3
82883,3,1,290207,290207,290208,0,1,2
82884,6,1,290213,290213,290214,0,1,5
82885,4,1,290217,290217,290218,0,1,3
82886,3,1,290220,290220,290221,0,1,2
82887,2,3,290222,290222,290225,0,3,1
82888,6,1,290228,290228,290229,0,1,3
82889,3,1,290231,290231,290232,0,1,2
82890,4,2,290235,290235,290237,0,2,3
82891,2,2,290237,290237,290239,0,2,0
82892,1,2,290238,290239,290241,1,3,0
82893,4,3,290242,290242,290245,0,3,1
82894,3,3,290245,290245,290248,0,3,0
82895,4,2,290249,290249,290251,0,2,1
82896,3,3,290252,290252,290255,0,3,1
82897,6,1,290258,290258,290259,0,1,3
82898,5,1,290263,290263,290264,0,1,4
82899,4,1,290267,290267,290268,0,1,3
82900,3,2,290270,290270,290272,0,2,2
82901,4,3,290274,290274,290277,0,3,2
82902,4,2,290278,290278,290280,0,2,1
82903,2,1,290280,290280,290281,0,1,0
82904,3,3,290283,290283,290286,0,3,2
82905,3,3,290286,290286,290289,0,3,0
82906,1,1,290287,290289,290290,2,3,0
82907,3,2,290290,290290,290292,0,2,0
82908,6,2,290296,290296,290298,0,2,4
82909,3,1,290299,290299,290300,0,1,1
82910,1,1,290300,290300,290301,0,1,0
82911,6,2,290306,290306,290308,0,2,5
82912,4,1,290310,290310,290311,0,1,2
82913,2,1,290312,290312,290313,0,1,1
82914,4,1,290316,290316,290317,0,1,3
82915,3,1,290319,290319,290320,0,1,2
82916,4,1,290323,290323,290324,0,1,3
82917,5,3,290328,290328,290331,0,3,4
82918,5,3,290333,290333,290336,0,3,2
82919,4,1,290337,290337,290338,0,1,1
82920,3,3,290340,290340,290343,0,3,2
82921,4,2,290344,290344,290346,0,2,1
82922,6,2,290350,290350,290352,0,2,4
82923,6,1,290356,290356,290357,0,1,4
82924,5,2,290361,290361,290363,0,2,4
82925,5,3,290366,290366,290369,0,3,3
82926,5,1,290371,290371,290372,0,1,2
82927,5,1,290376,290376,290377,0,1,4
82928,2,2,290378,290378,290380,0,2,1
82929,2,3,290380,290380,290383,0,3,0
82930,2,3,290382,290383,290386,1,4,0
82931,6,1,290388,290388,290389,0,1,2
82932,2,3,290390,290390,290393,0,3,1
82933,6,1,290396,290396,290397,0,1,3
82934,4,2,290400,290400,290402,0,2,3
82935,4,3,290404,290404,290407,0,3,2
82936,3,3,290407,290407,290410,0,3,0
82937,5,3,290412,290412,290415,0,3,2
82938,5,2,290417,290417,290419,0,2,2
82939,5,3,290422,290422,290425,0,3,3
82940,1,3,290423,290425,290428,2,5,0
82941,3,3,290426,290428,290431,2,5,0
82942,3,3,290429,290431,290434,2,5,0
82943,5,1,290434,290434,290435,0,1,0
82944,2,2,290436,290436,290438,0,2,1
82945,5,1,290441,290441,290442,0,1,3
82946,6,1,290447,290447,290448,0,1,5
82947,4,1,290451,290451,290452,0,1,3
82948,3,2,290454,290454,290456,0,2,2
82949,5,3,290459,290459,290462,0,3,3
82950,2,1,290461,290462,290463,1,2,0
82951,6,3,290467,290467,290470,0,3,4
82952,3,2,290470,290470,290472,0,2,0
82953,2,3,290472,290472,290475,0,3,0
82954,5,3,290477,290477,290480,0,3,2
82955,5,2,290482,290482,290484,0,2,2
82956,2,2,290484,290484,290486,0,2,0
82957,6,1,290490,290490,290491,0,1,4
82958,3,1,290493,290493,290494,0,1,2
82959,5,2,290498,290498,290500,0,2,4
82960,2,1,290500,290500,290501,0,1,0
82961,1,1,290501,290501,290502,0,1,0
82962,4,1,290505,290505,290506,0,1,3
82963,6,1,290511,290511,290512,0,1,5
82964,3,1,290514,290514,290515,0,1,2
82965,3,1,290517,290517,290518,0,1,2
82966,6,2,290523,290523,290525,0,2,5
82967,1,2,290524,290525,290527,1,3,0
82968,5,2,290529,290529,290531,0,2,2
82969,1,1,290530,290531,290532,1,2,0
82970,6,2,290536,290536,290538,0,2,4
82971,1,1,290537,290538,290539,1,2,0
82972,3,2,290540,290540,290542,0,2,1
82973,4,2,290544,290544,290546,0,2,2
82974,1,2,290545,290546,290548,1,3,0
82975,2,2,290547,290548,290550,1,3,0
82976,2,1,290549,290550,290551,1,2,0
82977,6,3,290555,290555,290558,0,3,4
82978,6,2,290561,290561,290563,0,2,3
82979,4,2,290565,290565,290567,0,2,2
82980,3,3,290568,290568,290571,0,3,1
82981,5,1,290573,290573,290574,0,1,2
82982,3,2,290576,290576,290578,0,2,2
82983,5,2,290581,290581,290583,0,2,3
82984,1,1,290582,290583,290584,1,2,0
82985,6,1,290588,290588,290589,0,1,4
82986,4,1,290592,290592,290593,0,1,3
82987,5,1,290597,290597,290598,0,1,4
82988,5,1,290602,290602,290603,0,1,4
82989,6,3,290608,290608,290611,0,3,5
82990,3,1,290611,290611,290612,0,1,0
82991,2,2,290613,290613,290615,0,2,1
82992,6,2,290619,290619,290621,0,2,4
82993,4,1,290623,290623,290624,0,1,2
82994,1,3,290624,290624,290627,0,3,0
82995,2,2,290626,290627,290629,1,3,0
82996,3,3,290629,290629,290632,0,3,0
82997,1,3,290630,290632,290635,2,5,0
82998,2,3,290632,290635,290638,3,6,0
82999,3,1,290635,290638,290639,3,4,0
83000,5,1,290640,290640,290641,0,1,1
83001,5,1,290645,290645,290646,0,1,4
83002,1,2,290646,290646,290648,0,2,0
83003,6,2,290652,290652,290654,0,2,4
83004,3,1,290655,290655,290656,0,1,1
83005,3,2,290658,290658,290660,0,2,2
83006,5,3,290663,290663,290666,0,3,3
83007,4,3,290667,290667,290670,0,3,1
83008,5,3,290672,290672,290675,0,3,2
83009,4,1,290676,290676,290677,0,1,1
83010,5,3,290681,290681,290684,0,3,4
83011,2,2,290683,290684,290686,1,3,0
83012,1,3,290684,290686,290689,2,5,0
83013,4,2,290688,290689,290691,1,3,0
83014,6,1,290694,290694,290695,0,1,3
83015,5,3,290699,290699,290702,0,3,4
83016,6,2,290705,290705,290707,0,2,3
83017,4,2,290709,290709,290711,0,2,2
83018,5,2,290714,290714,290716,0,2,3
83019,3,1,290717,290717,290718,0,1,1
83020,1,1,290718,290718,290719,0,1,0
83021,2,2,290720,290720,290722,0,2,1
83022,5,2,290725,290725,290727,0,2,3
83023,1,1,290726,290727,290728,1,2,0
83024,2,3,290728,290728,290731,0,3,0
83025,2,1,290730,290731,290732,1,2,0
83026,1,1,290731,290732,290733,1,2,0
83027,5,3,290736,290736,290739,0,3,3
83028,3,1,290739,290739,290740,0,1,0
83029,6,3,290745,290745,290748,0,3,5
83030,5,2,290750,290750,290752,0,2,2
83031,2,2,290752,290752,290754,0,2,0
83032,3,1,290755,290755,290756,0,1,1
83033,5,1,290760,290760,290761,0,1,4
83034,3,3,290763,290763,290766,0,3,2
83035,5,3,290768,290768,290771,0,3,2
83036,1,1,290769,290771,290772,2,3,0
83037,5,3,290774,290774,290777,0,3,2
83038,6,2,290780,290780,290782,0,2,3
83039,1,3,290781,290782,290785,1,4,0
83040,4,3,290785,290785,290788,0,3,0
83041,3,3,290788,290788,290791,0,3,0
83042,4,1,290792,290792,290793,0,1,1
83043,4,3,290796,290796,290799,0,3,3
83044,1,2,290797,290799,290801,2,4,0
83045,3,2,290800,290801,290803,1,3,0
83046,3,1,290803,290803,290804,0,1,0
83047,1,2,290804,290804,290806,0,2,0
83048,2,3,290806,290806,290809,0,3,0
83049,3,3,290809,290809,290812,0,3,0
83050,5,3,290814,290814,290817,0,3,2
83051,1,2,290815,290817,290819,2,4,0
83052,2,2,290817,290819,290821,2,4,0
83053,3,3,290820,290821,290824,1,4,0
83054,2,2,290822,290824,290826,2,4,0
83055,4,1,290826,290826,290827,0,1,0
83056,5,2,290831,290831,290833,0,2,4
83057,2,2,290833,290833,290835,0,2,0
83058,3,2,290836,290836,290838,0,2,1
83059,1,1,290837,290838,290839,1,2,0
83060,5,1,290842,290842,290843,0,1,3
83061,4,3,290846,290846,290849,0,3,3
83062,6,2,290852,290852,290854,0,2,3
83063,4,1,290856,290856,290857,0,1,2
83064,2,2,290858,290858,290860,0,2,1
83065,6,2,290864,290864,290866,0,2,4
83066,3,1,290867,290867,290868,0,1,1
83067,1,2,290868,290868,290870,0,2,0
83068,2,1,290870,290870,290871,0,1,0
83069,4,3,290874,290874,290877,0,3,3
83070,3,1,290877,290877,290878,0,1,0
83071,2,1,290879,290879,290880,0,1,1
83072,5,1,290884,290884,290885,0,1,4
83073,3,1,290887,290887,290888,0,1,2
83074,5,2,290892,290892,290894,0,2,4
83075,1,2,290893,290894,290896,1,3,0
83076,5,2,290898,290898,290900,0,2,2
83077,3,3,290901,290901,290904,0,3,1
83078,2,3,290903,290904,290907,1,4,0
83079,3,1,290906,290907,290908,1,2,0
83080,5,2,290911,290911,290913,0,2,3
83081,4,1,290915,290915,290916,0,1,2
83082,1,1,290916,290916,290917,0,1,0
83083,6,3,290922,290922,290925,0,3,5
83084,2,2,290924,290925,290927,1,3,0
83085,1,3,290925,290927,290930,2,5,0
83086,6,2,290931,290931,290933,0,2,1
83087,5,2,290936,290936,290938,0,2,3
83088,5,1,290941,290941,290942,0,1,3
83089,5,3,290946,290946,290949,0,3,4
83090,5,3,290951,290951,290954,0,3,2
83091,1,3,290952,290954,290957,2,5,0
83092,3,3,290955,290957,290960,2,5,0
83093,5,3,290960,290960,290963,0,3,0
83094,1,1,290961,290963,290964,2,3,0
83095,4,3,290965,290965,290968,0,3,1
83096,6,3,290971,290971,290974,0,3,3
83097,2,3,290973,290974,290977,1,4,0
83098,5,1,290978,290978,290979,0,1,1
83099,4,3,290982,290982,290985,0,3,3
83100,3,1,290985,290985,290986,0,1,0
83101,3,3,290988,290988,290991,0,3,2
83102,3,2,290991,290991,290993,0,2,0
83103,2,1,290993,290993,290994,0,1,0
83104,6,2,290999,290999,291001,0,2,5
83105,1,1,291000,291001,291002,1,2,0
83106,2,1,291002,291002,291003,0,1,0
83107,3,3,291005,291005,291008,0,3,2
83108,4,2,291009,291009,291011,0,2,1
83109,3,2,291012,291012,291014,0,2,1
83110,2,1,291014,291014,291015,0,1,0
83111,2,1,291016,291016,291017,0,1,1
83112,3,1,291019,291019,291020,0,1,2
83113,2,2,291021,291021,291023,0,2,1
83114,4,3,291025,291025,291028,0,3,2
83115,2,3,291027,291028,291031,1,4,0
83116,2,2,291029,291031,291033,2,4,0
83117,6,1,291035,291035,291036,0,1,2
83118,1,1,291036,291036,291037,0,1,0
83119,5,2,291041,291041,291043,0,2,4
83120,2,2,291043,291043,291045,0,2,0
83121,2,3,291045,291045,291048,0,3,0
83122,1,2,291046,291048,291050,2,4,0
83123,6,2,291052,291052,291054,0,2,2
83124,4,1,291056,291056,291057,0,1,2
83125,3,1,291059,291059,291060,0,1,2
83126,2,1,291061,291061,291062,0,1,1
83127,6,1,291067,291067,291068,0,1,5
83128,4,3,291071,291071,291074,0,3,3
83129,6,2,291077,291077,291079,0,2,3
83130,5,2,291082,291082,291084,0,2,3
83131,4,2,291086,291086,291088,0,2,2
83132,4,3,291090,291090,291093,0,3,2
83133,5,2,291095,291095,291097,0,2,2
83134,1,3,291096,291097,291100,1,4,0
83135,5,2,291101,291101,291103,0,2,1
83136,5,2,291106,291106,291108,0,2,3
83137,1,2,291107,291108,291110,1,3,0
83138,1,1,291108,291110,291111,2,3,0
83139,2,1,291110,291111,291112,1,2,0
83140,4,2,291114,291114,291116,0,2,2
83141,3,1,291117,291117,291118,0,1,1
83142,4,3,291121,291121,291124,0,3,3
83143,4,3,291125,291125,291128,0,3,1
83144,6,2,291131,291131,291133,0,2,3
83145,4,1,291135,291135,291136,0,1,2
83146,6,2,291141,291141,291143,0,2,5
83147,5,2,291146,291146,291148,0,2,3
83148,4,3,291150,291150,291153,0,3,2
83149,5,2,291155,291155,291157,0,2,2
83150,3,3,291158,291158,291161,0,3,1
83151,2,3,291160,291161,291164,1,4,0
83152,6,3,291166,291166,291169,0,3,2
83153,4,3,291170,291170,291173,0,3,1
83154,2,1,291172,291173,291174,1,2,0
83155,3,2,291175,291175,291177,0,2,1
83156,4,3,291179,291179,291182,0,3,2
83157,1,1,291180,291182,291183,2,3,0
83158,4,1,291184,291184,291185,0,1,1
83159,5,1,291189,291189,291190,0,1,4
83160,1,2,291190,291190,291192,0,2,0
83161,4,1,291194,291194,291195,0,1,2
83162,4,2,291198,291198,291200,0,2,3
83163,5,2,291203,291203,291205,0,2,3
83164,5,1,291208,291208,291209,0,1,3
83165,5,1,291213,291213,291214,0,1,4
83166,1,2,291214,291214,291216,0,2,0
83167,5,3,291219,291219,291222,0,3,3
83168,2,3,291221,291222,291225,1,4,0
83169,1,2,291222,291225,291227,3,5,0
83170,3,3,291225,291227,291230,2,5,0
83171,6,1,291231,291231,291232,0,1,1
83172,4,2,291235,291235,291237,0,2,3
83173,4,3,291239,291239,291242,0,3,2
83174,5,2,291244,291244,291246,0,2,2
83175,5,3,291249,291249,291252,0,3,3
83176,5,3,291254,291254,291257,0,3,2
83177,4,2,291258,291258,291260,0,2,1
83178,2,2,291260,291260,291262,0,2,0
83179,3,1,291263,291263,291264,0,1,1
83180,4,3,291267,291267,291270,0,3,3
83181,5,2,291272,291272,291274,0,2,2
83182,1,1,291273,291274,291275,1,2,0
83183,6,2,291279,291279,291281,0,2,4
83184,1,2,291280,291281,291283,1,3,0
83185,1,2,291281,291283,291285,2,4,0
83186,3,2,291284,291285,291287,1,3,0
83187,2,3,291286,291287,291290,1,4,0
83188,1,2,291287,291290,291292,3,5,0
83189,6,2,291293,291293,291295,0,2,1
83190,1,3,291294,291295,291298,1,4,0
83191,2,3,291296,291298,291301,2,5,0
83192,5,1,291301,291301,291302,0,1,0
83193,2,1,291303,291303,291304,0,1,1
83194,6,3,291309,291309,291312,0,3,5
83195,6,1,291315,291315,291316,0,1,3
83196,5,2,291320,291320,291322,0,2,4
83197,5,2,291325,291325,291327,0,2,3
83198,1,3,291326,291327,291330,1,4,0
83199,3,3,291329,291330,291333,1,4,0
83200,2,1,291331,291333,291334,2,3,0
83201,3,2,291334,291334,291336,0,2,0
83202,2,2,291336,291336,291338,0,2,0
83203,5,1,291341,291341,291342,0,1,3
83204,2,3,291343,291343,291346,0,3,1
83205,5,2,291348,291348,291350,0,2,2
83206,3,3,291351,291351,291354,0,3,1
83207,3,1,291354,291354,291355,0,1,0
83208,2,1,291356,291356,291357,0,1,1
83209,6,3,291362,291362,291365,0,3,5
83210,6,2,291368,291368,291370,0,2,3
83211,5,1,291373,291373,291374,0,1,3
83212,5,1,291378,291378,291379,0,1,4
83213,3,3,291381,291381,291384,0,3,2
83214,2,1,291383,291384,291385,1,2,0
83215,2,3,291385,291385,291388,0,3,0
83216,4,2,291389,291389,291391,0,2,1
83217,4,3,291393,291393,291396,0,3,2
83218,3,1,291396,291396,291397,0,1,0
83219,3,2,291399,291399,291401,0,2,2
83220,6,1,291405,291405,291406,0,1,4
83221,2,3,291407,291407,291410,0,3,1
83222,2,1,291409,291410,291411,1,2,0
83223,3,1,291412,291412,291413,0,1,1
83224,3,1,291415,291415,291416,0,1,2
83225,3,1,291418,291418,291419,0,1,2
83226,2,1,291420,291420,291421,0,1,1
83227,5,2,291425,291425,291427,0,2,4
83228,3,1,291428,291428,291429,0,1,1
83229,5,2,291433,291433,291435,0,2,4
83230,3,3,291436,291436,291439,0,3,1
83231,3,2,291439,291439,291441,0,2,0
83232,2,3,291441,291441,291444,0,3,0
83233,4,2,291445,291445,291447,0,2,1
83234,1,1,291446,291447,291448,1,2,0
83235,1,2,291447,291448,291450,1,3,0
83236,1,3,291448,291450,291453,2,5,0
83237,2,3,291450,291453,291456,3,6,0
83238,2,1,291452,291456,291457,4,5,0
83239,5,3,291457,291457,291460,0,3,0
83240,1,2,291458,291460,291462,2,4,0
83241,5,1,291463,291463,291464,0,1,1
83242,5,1,291468,291468,291469,0,1,4
83243,5,3,291473,291473,291476,0,3,4
83244,3,1,291476,291476,291477,0,1,0
83245,3,2,291479,291479,291481,0,2,2
83246,5,3,291484,291484,291487,0,3,3
83247,3,1,291487,291487,291488,0,1,0
83248,2,1,291489,291489,291490,0,1,1
83249,1,2,291490,291490,291492,0,2,0
83250,2,2,291492,291492,291494,0,2,0
83251,4,1,291496,291496,291497,0,1,2
83252,6,2,291502,291502,291504,0,2,5
83253,5,3,291507,291507,291510,0,3,3
83254,6,3,291513,291513,291516,0,3,3
83255,6,1,291519,291519,291520,0,1,3
83256,4,3,291523,291523,291526,0,3,3
83257,4,3,291527,291527,291530,0,3,1
83258,2,1,291529,291530,291531,1,2,0
83259,4,2,291533,291533,291535,0,2,2
83260,5,3,291538,291538,291541,0,3,3
83261,1,2,291539,291541,291543,2,4,0
83262,6,3,291545,291545,291548,0,3,2
83263,4,3,291549,291549,291552,0,3,1
83264,6,1,291555,291555,291556,0,1,3
83265,5,2,291560,291560,291562,0,2,4
83266,3,2,291563,291563,291565,0,2,1
83267,6,3,291569,291569,291572,0,3,4
83268,5,2,291574,291574,291576,0,2,2
83269,1,1,291575,291576,291577,1,2,0
83270,1,1,291576,291577,291578,1,2,0
83271,6,3,291582,291582,291585,0,3,4
83272,4,3,291586,291586,291589,0,3,1
83273,5,1,291591,291591,291592,0,1,2
83274,2,1,291593,291593,291594,0,1,1
83275,3,1,291596,291596,291597,0,1,2
83276,3,3,291599,291599,291602,0,3,2
83277,6,3,291605,291605,291608,0,3,3
83278,5,3,291610,291610,291613,0,3,2
83279,5,2,291615,291615,291617,0,2,2
83280,3,2,291618,291618,291620,0,2,1
83281,3,2,291621,291621,291623,0,2,1
83282,6,1,291627,291627,291628,0,1,4
83283,5,3,291632,291632,291635,0,3,4
83284,5,1,291637,291637,291638,0,1,2
83285,2,3,291639,291639,291642,0,3,1
83286,4,1,291643,291643,291644,0,1,1
83287,4,2,291647,291647,291649,0,2,3
83288,4,3,291651,291651,291654,0,3,2
83289,5,1,291656,291656,291657,0,1,2
83290,1,1,291657,291657,291658,0,1,0
83291,3,3,291660,291660,291663,0,3,2
83292,3,2,291663,291663,291665,0,2,0
83293,4,2,291667,291667,291669,0,2,2
83294,2,3,291669,291669,291672,0,3,0
83295,5,3,291674,291674,291677,0,3,2
83296,6,3,291680,291680,291683,0,3,3
83297,5,2,291685,291685,291687,0,2,2
83298,1,2,291686,291687,291689,1,3,0
83299,6,1,291692,291692,291693,0,1,3
83300,3,2,291695,291695,291697,0,2,2
83301,2,1,291697,291697,291698,0,1,0
83302,5,2,291702,291702,291704,0,2,4
83303,5,1,291707,291707,291708,0,1,3
83304,2,3,291709,291709,291712,0,3,1
83305,2,3,291711,291712,291715,1,4,0
83306,3,3,291714,291715,291718,1,4,0
83307,5,1,291719,291719,291720,0,1,1
83308,2,3,291721,291721,291724,0,3,1
83309,6,2,291727,291727,291729,0,2,3
83310,1,3,291728,291729,291732,1,4,0
83311,4,3,291732,291732,291735,0,3,0
83312,5,2,291737,291737,291739,0,2,2
83313,2,1,291739,291739,291740,0,1,0
83314,5,2,291744,291744,291746,0,2,4
83315,5,2,291749,291749,291751,0,2,3
83316,2,2,291751,291751,291753,0,2,0
83317,1,2,291752,291753,291755,1,3,0
83318,6,2,291758,291758,291760,0,2,3
83319,4,2,291762,291762,291764,0,2,2
83320,4,1,291766,291766,291767,0,1,2
83321,4,2,291770,291770,291772,0,2,3
83322,3,2,291773,291773,291775,0,2,1
83323,3,3,291776,291776,291779,0,3,1
83324,2,1,291778,291779,291780,1,2,0
83325,1,1,291779,291780,291781,1,2,0
83326,5,1,291784,291784,291785,0,1,3
83327,6,3,291790,291790,291793,0,3,5
83328,4,1,291794,291794,291795,0,1,1
83329,1,2,291795,291795,291797,0,2,0
83330,3,1,291798,291798,291799,0,1,1
83331,2,3,291800,291800,291803,0,3,1
83332,6,1,291806,291806,291807,0,1,3
83333,3,2,291809,291809,291811,0,2,2
83334,6,2,291815,291815,291817,0,2,4
83335,6,3,291821,291821,291824,0,3,4
83336,1,1,291822,291824,291825,2,3,0
83337,2,1,291824,291825,291826,1,2,0
83338,4,3,291828,291828,291831,0,3,2
83339,2,2,291830,291831,291833,1,3,0
83340,3,3,291833,291833,291836,0,3,0
83341,1,3,291834,291836,291839,2,5,0
83342,1,1,291835,291839,291840,4,5,0
83343,5,2,291840,291840,291842,0,2,0
83344,5,1,291845,291845,291846,0,1,3
83345,3,2,291848,291848,291850,0,2,2
83346,5,3,291853,291853,291856,0,3,3
83347,4,2,291857,291857,291859,0,2,1
83348,2,2,291859,291859,291861,0,2,0
83349,5,2,291864,291864,291866,0,2,3
83350,1,1,291865,291866,291867,1,2,0
83351,6,3,291871,291871,291874,0,3,4
83352,5,1,291876,291876,291877,0,1,2
83353,4,1,291880,291880,291881,0,1,3
83354,5,3,291885,291885,291888,0,3,4
83355,5,3,291890,291890,291893,0,3,2
83356,2,2,291892,291893,291895,1,3,0
83357,3,1,291895,291895,291896,0,1,0
83358,3,3,291898,291898,291901,0,3,2
83359,1,2,291899,291901,291903,2,4,0
83360,2,2,291901,291903,291905,2,4,0
83361,1,3,291902,291905,291908,3,6,0
83362,6,1,291908,291908,291909,0,1,0
83363,5,1,291913,291913,291914,0,1,4
83364,5,2,291918,291918,291920,0,2,4
83365,1,2,291919,291920,291922,1,3,0
83366,6,2,291925,291925,291927,0,2,3
83367,4,1,291929,291929,291930,0,1,2
83368,6,1,291935,291935,291936,0,1,5
83369,5,2,291940,291940,291942,0,2,4
83370,4,3,291944,291944,291947,0,3,2
83371,4,3,291948,291948,291951,0,3,1
83372,3,2,291951,291951,291953,0,2,0
83373,4,2,291955,291955,291957,0,2,2
83374,3,1,291958,291958,291959,0,1,1
83375,6,3,291964,291964,291967,0,3,5
83376,2,3,291966,291967,291970,1,4,0
83377,6,1,291972,291972,291973,0,1,2
83378,2,3,291974,291974,291977,0,3,1
83379,4,1,291978,291978,291979,0,1,1
83380,2,3,291980,291980,291983,0,3,1
83381,2,2,291982,291983,291985,1,3,0
83382,5,2,291987,291987,291989,0,2,2
83383,4,2,291991,291991,291993,0,2,2
83384,1,1,291992,291993,291994,1,2,0
83385,6,3,291998,291998,292001,0,3,4
83386,1,2,291999,292001,292003,2,4,0
83387,3,1,292002,292003,292004,1,2,0
83388,6,2,292008,292008,292010,0,2,4
83389,3,1,292011,292011,292012,0,1,1
83390,5,3,292016,292016,292019,0,3,4
83391,5,2,292021,292021,292023,0,2,2
83392,5,1,292026,292026,292027,0,1,3
83393,2,1,292028,292028,292029,0,1,1
83394,4,1,292032,292032,292033,0,1,3
83395,4,2,292036,292036,292038,0,2,3
83396,3,1,292039,292039,292040,0,1,1
83397,6,1,292045,292045,292046,0,1,5
83398,6,2,292051,292051,292053,0,2,5
83399,4,1,292055,292055,292056,0,1,2
83400,2,1,292057,292057,292058,0,1,1
83401,2,3,292059,292059,292062,0,3,1
83402,1,2,292060,292062,292064,2,4,0
83403,1,1,292061,292064,292065,3,4,0
83404,2,3,292063,292065,292068,2,5,0
83405,4,3,292067,292068,292071,1,4,0
83406,3,1,292070,292071,292072,1,2,0
83407,2,2,292072,292072,292074,0,2,0
83408,3,1,292075,292075,292076,0,1,1
83409,1,2,292076,292076,292078,0,2,0
83410,4,1,292080,292080,292081,0,1,2
83411,2,3,292082,292082,292085,0,3,1
83412,6,3,292088,292088,292091,0,3,3
83413,5,1,292093,292093,292094,0,1,2
83414,2,2,292095,292095,292097,0,2,1
83415,3,2,292098,292098,292100,0,2,1
83416,1,2,292099,292100,292102,1,3,0
83417,5,1,292104,292104,292105,0,1,2
83418,2,2,292106,292106,292108,0,2,1
83419,2,1,292108,292108,292109,0,1,0
83420,3,3,292111,292111,292114,0,3,2
83421,1,3,292112,292114,292117,2,5,0
83422,5,1,292117,292117,292118,0,1,0
83423,3,2,292120,292120,292122,0,2,2
83424,3,1,292123,292123,292124,0,1,1
83425,4,1,292127,292127,292128,0,1,3
83426,4,3,292131,292131,292134,0,3,3
83427,6,3,292137,292137,292140,0,3,3
83428,1,1,292138,292140,292141,2,3,0
83429,5,2,292143,292143,292145,0,2,2
83430,1,1,292144,292145,292146,1,2,0
83431,6,1,292150,292150,292151,0,1,4
83432,1,2,292151,292151,292153,0,2,0
83433,5,2,292156,292156,292158,0,2,3
83434,1,3,292157,292158,292161,1,4,0
83435,1,1,292158,292161,292162,3,4,0
83436,1,2,292159,292162,292164,3,5,0
83437,5,1,292164,292164,292165,0,1,0
83438,1,3,292165,292165,292168,0,3,0
83439,1,2,292166,292168,292170,2,4,0
83440,1,3,292167,292170,292173,3,6,0
83441,6,2,292173,292173,292175,0,2,0
83442,1,2,292174,292175,292177,1,3,0
83443,1,3,292175,292177,292180,2,5,0
83444,6,3,292181,292181,292184,0,3,1
83445,1,1,292182,292184,292185,2,3,0
83446,4,1,292186,292186,292187,0,1,1
83447,2,1,292188,292188,292189,0,1,1
83448,6,3,292194,292194,292197,0,3,5
83449,5,3,292199,292199,292202,0,3,2
83450,4,2,292203,292203,292205,0,2,1
83451,2,3,292205,292205,292208,0,3,0
83452,3,1,292208,292208,292209,0,1,0
83453,4,2,292212,292212,292214,0,2,3
83454,5,2,292217,292217,292219,0,2,3
83455,1,2,292218,292219,292221,1,3,0
83456,3,1,292221,292221,292222,0,1,0
83457,4,2,292225,292225,292227,0,2,3
83458,5,2,292230,292230,292232,0,2,3
83459,1,1,292231,292232,292233,1,2,0
83460,2,3,292233,292233,292236,0,3,0
83461,2,2,292235,292236,292238,1,3,0
83462,4,3,292239,292239,292242,0,3,1
83463,2,3,292241,292242,292245,1,4,0
83464,2,2,292243,292245,292247,2,4,0
83465,3,3,292246,292247,292250,1,4,0
83466,4,1,292250,292250,292251,0,1,0
83467,6,3,292256,292256,292259,0,3,5
83468,3,2,292259,292259,292261,0,2,0
83469,5,3,292264,292264,292267,0,3,3
83470,4,1,292268,292268,292269,0,1,1
83471,4,1,292272,292272,292273,0,1,3
83472,6,3,292278,292278,292281,0,3,5
83473,3,3,292281,292281,292284,0,3,0
83474,3,3,292284,292284,292287,0,3,0
83475,4,2,292288,292288,292290,0,2,1
83476,1,2,292289,292290,292292,1,3,0
83477,5,1,292294,292294,292295,0,1,2
83478,2,2,292296,292296,292298,0,2,1
83479,1,2,292297,292298,292300,1,3,0
83480,2,2,292299,292300,292302,1,3,0
83481,1,2,292300,292302,292304,2,4,0
83482,4,1,292304,292304,292305,0,1,0
83483,4,1,292308,292308,292309,0,1,3
83484,2,2,292310,292310,292312,0,2,1
83485,6,2,292316,292316,292318,0,2,4
83486,1,2,292317,292318,292320,1,3,0
83487,2,1,292319,292320,292321,1,2,0
83488,2,2,292321,292321,292323,0,2,0
83489,5,2,292326,292326,292328,0,2,3
83490,6,3,292332,292332,292335,0,3,4
83491,3,2,292335,292335,292337,0,2,0
83492,5,3,292340,292340,292343,0,3,3
83493,3,1,292343,292343,292344,0,1,0
83494,2,1,292345,292345,292346,0,1,1
83495,6,3,292351,292351,292354,0,3,5
83496,3,3,292354,292354,292357,0,3,0
83497,5,1,292359,292359,292360,0,1,2
83498,6,2,292365,292365,292367,0,2,5
83499,4,2,292369,292369,292371,0,2,2
83500,5,2,292374,292374,292376,0,2,3
83501,1,2,292375,292376,292378,1,3,0
83502,6,1,292381,292381,292382,0,1,3
83503,5,3,292386,292386,292389,0,3,4
83504,1,2,292387,292389,292391,2,4,0
83505,3,1,292390,292391,292392,1,2,0
83506,1,2,292391,292392,292394,1,3,0
83507,1,1,292392,292394,292395,2,3,0
83508,1,3,292393,292395,292398,2,5,0
83509,3,2,292396,292398,292400,2,4,0
83510,1,1,292397,292400,292401,3,4,0
83511,2,1,292399,292401,292402,2,3,0
83512,3,1,292402,292402,292403,0,1,0
83513,4,2,292406,292406,292408,0,2,3
83514,5,3,292411,292411,292414,0,3,3
83515,4,3,292415,292415,292418,0,3,1
83516,6,2,292421,292421,292423,0,2,3
83517,3,1,292424,292424,292425,0,1,1
83518,4,1,292428,292428,292429,0,1,3
83519,5,3,292433,292433,292436,0,3,4
83520,6,3,292439,292439,292442,0,3,3
83521,4,1,292443,292443,292444,0,1,1
83522,6,2,292449,292449,292451,0,2,5
83523,6,1,292455,292455,292456,0,1,4
83524,1,1,292456,292456,292457,0,1,0
83525,5,1,292461,292461,292462,0,1,4
83526,1,2,292462,292462,292464,0,2,0
83527,1,3,292463,292464,292467,1,4,0
83528,2,1,292465,292467,292468,2,3,0
83529,4,3,292469,292469,292472,0,3,1
83530,4,3,292473,292473,292476,0,3,1
83531,4,2,292477,292477,292479,0,2,1
83532,5,3,292482,292482,292485,0,3,3
83533,6,3,292488,292488,292491,0,3,3
83534,5,1,292493,292493,292494,0,1,2
83535,6,3,292499,292499,292502,0,3,5
83536,4,3,292503,292503,292506,0,3,1
83537,1,3,292504,292506,292509,2,5,0
83538,6,3,292510,292510,292513,0,3,1
83539,1,2,292511,292513,292515,2,4,0
83540,5,2,292516,292516,292518,0,2,1
83541,6,3,292522,292522,292525,0,3,4
83542,1,1,292523,292525,292526,2,3,0
83543,4,1,292527,292527,292528,0,1,1
83544,6,2,292533,292533,292535,0,2,5
83545,3,3,292536,292536,292539,0,3,1
83546,2,2,292538,292539,292541,1,3,0
83547,2,3,292540,292541,292544,1,4,0
83548,4,1,292544,292544,292545,0,1,0
83549,6,3,292550,292550,292553,0,3,5
83550,2,2,292552,292553,292555,1,3,0
83551,4,2,292556,292556,292558,0,2,1
83552,1,2,292557,292558,292560,1,3,0
83553,2,3,292559,292560,292563,1,4,0
83554,3,3,292562,292563,292566,1,4,0
83555,5,3,292567,292567,292570,0,3,1
83556,3,1,292570,292570,292571,0,1,0
83557,4,2,292574,292574,292576,0,2,3
83558,6,3,292580,292580,292583,0,3,4
83559,4,2,292584,292584,292586,0,2,1
83560,4,1,292588,292588,292589,0,1,2
83561,3,3,292591,292591,292594,0,3,2
83562,2,3,292593,292594,292597,1,4,0
83563,2,2,292595,292597,292599,2,4,0
83564,1,2,292596,292599,292601,3,5,0
83565,1,3,292597,292601,292604,4,7,0
83566,3,3,292600,292604,292607,4,7,0
83567,6,1,292606,292607,292608,1,2,0
83568,2,1,292608,292608,292609,0,1,0
83569,2,1,292610,292610,292611,0,1,1
83570,2,1,292612,292612,292613,0,1,1
83571,6,1,292618,292618,292619,0,1,5
83572,3,1,292621,292621,292622,0,1,2
83573,1,2,292622,292622,292624,0,2,0
83574,1,3,292623,292624,292627,1,4,0
83575,1,3,292624,292627,292630,3,6,0
83576,3,3,292627,292630,292633,3,6,0
83577,2,1,292629,292633,292634,4,5,0
83578,3,3,292632,292634,292637,2,5,0
83579,3,3,292635,292637,292640,2,5,0
83580,1,2,292636,292640,292642,4,6,0
83581,4,3,292640,292642,292645,2,5,0
83582,3,1,292643,292645,292646,2,3,0
83583,3,1,292646,292646,292647,0,1,0
83584,2,2,292648,292648,292650,0,2,1
83585,2,1,292650,292650,292651,0,1,0
83586,4,2,292654,292654,292656,0,2,3
83587,4,2,292658,292658,292660,0,2,2
83588,3,1,292661,292661,292662,0,1,1
83589,6,3,292667,292667,292670,0,3,5
83590,5,3,292672,292672,292675,0,3,2
83591,3,1,292675,292675,292676,0,1,0
83592,2,3,292677,292677,292680,0,3,1
83593,4,1,292681,292681,292682,0,1,1
83594,1,2,292682,292682,292684,0,2,0
83595,2,2,292684,292684,292686,0,2,0
83596,6,2,292690,292690,292692,0,2,4
83597,5,3,292695,292695,292698,0,3,3
83598,3,3,292698,292698,292701,0,3,0
83599,3,3,292701,292701,292704,0,3,0
83600,3,2,292704,292704,292706,0,2,0
83601,5,2,292709,292709,292711,0,2,3
83602,2,1,292711,292711,292712,0,1,0
83603,1,2,292712,292712,292714,0,2,0
83604,4,1,292716,292716,292717,0,1,2
83605,5,3,292721,292721,292724,0,3,4
83606,5,3,292726,292726,292729,0,3,2
83607,6,3,292732,292732,292735,0,3,3
83608,3,3,292735,292735,292738,0,3,0
83609,5,1,292740,292740,292741,0,1,2
83610,2,2,292742,292742,292744,0,2,1
83611,2,2,292744,292744,292746,0,2,0
83612,3,3,292747,292747,292750,0,3,1
83613,5,2,292752,292752,292754,0,2,2
83614,5,2,292757,292757,292759,0,2,3
83615,4,2,292761,292761,292763,0,2,2
83616,4,1,292765,292765,292766,0,1,2
83617,1,3,292766,292766,292769,0,3,0
83618,6,2,292772,292772,292774,0,2,3
83619,4,3,292776,292776,292779,0,3,2
83620,6,2,292782,292782,292784,0,2,3
83621,6,3,292788,292788,292791,0,3,4
83622,6,1,292794,292794,292795,0,1,3
83623,3,2,292797,292797,292799,0,2,2
83624,3,2,292800,292800,292802,0,2,1
83625,4,1,292804,292804,292805,0,1,2
83626,5,1,292809,292809,292810,0,1,4
83627,1,1,292810,292810,292811,0,1,0
83628,6,2,292816,292816,292818,0,2,5
83629,5,1,292821,292821,292822,0,1,3
83630,1,1,292822,292822,292823,0,1,0
83631,2,2,292824,292824,292826,0,2,1
83632,1,3,292825,292826,292829,1,4,0
83633,5,2,292830,292830,292832,0,2,1
83634,3,3,292833,292833,292836,0,3,1
83635,2,1,292835,292836,292837,1,2,0
83636,1,2,292836,292837,292839,1,3,0
83637,6,2,292842,292842,292844,0,2,3
83638,2,2,292844,292844,292846,0,2,0
83639,1,3,292845,292846,292849,1,4,0
83640,4,2,292849,292849,292851,0,2,0
83641,5,2,292854,292854,292856,0,2,3
83642,2,1,292856,292856,292857,0,1,0
83643,4,2,292860,292860,292862,0,2,3
83644,4,3,292864,292864,292867,0,3,2
83645,3,1,292867,292867,292868,0,1,0
83646,2,1,292869,292869,292870,0,1,1
83647,2,2,292871,292871,292873,0,2,1
83648,2,3,292873,292873,292876,0,3,0
83649,2,3,292875,292876,292879,1,4,0
83650,4,2,292879,292879,292881,0,2,0
83651,3,2,292882,292882,292884,0,2,1
83652,6,2,292888,292888,292890,0,2,4
83653,2,3,292890,292890,292893,0,3,0
83654,5,3,292895,292895,292898,0,3,2
83655,1,1,292896,292898,292899,2,3,0
83656,3,1,292899,292899,292900,0,1,0
83657,2,2,292901,292901,292903,0,2,1
83658,5,1,292906,292906,292907,0,1,3
83659,4,2,292910,292910,292912,0,2,3
83660,1,1,292911,292912,292913,1,2,0
83661,3,2,292914,292914,292916,0,2,1
83662,3,1,292917,292917,292918,0,1,1
83663,6,3,292923,292923,292926,0,3,5
83664,5,1,292928,292928,292929,0,1,2
83665,3,1,292931,292931,292932,0,1,2
83666,4,3,292935,292935,292938,0,3,3
83667,2,2,292937,292938,292940,1,3,0
83668,2,3,292939,292940,292943,1,4,0
83669,5,3,292944,292944,292947,0,3,1
83670,2,1,292946,292947,292948,1,2,0
83671,6,1,292952,292952,292953,0,1,4
83672,3,3,292955,292955,292958,0,3,2
83673,3,2,292958,292958,292960,0,2,0
83674,6,3,292964,292964,292967,0,3,4
83675,1,3,292965,292967,292970,2,5,0
83676,3,1,292968,292970,292971,2,3,0
83677,3,1,292971,292971,292972,0,1,0
83678,6,2,292977,292977,292979,0,2,5
83679,6,1,292983,292983,292984,0,1,4
83680,1,3,292984,292984,292987,0,3,0
83681,3,2,292987,292987,292989,0,2,0
83682,1,1,292988,292989,292990,1,2,0
83683,1,1,292989,292990,292991,1,2,0
83684,5,1,292994,292994,292995,0,1,3
83685,2,2,292996,292996,292998,0,2,1
83686,5,2,293001,293001,293003,0,2,3
83687,3,1,293004,293004,293005,0,1,1
83688,1,2,293005,293005,293007,0,2,0
83689,4,2,293009,293009,293011,0,2,2
83690,2,2,293011,293011,293013,0,2,0
83691,5,3,293016,293016,293019,0,3,3
83692,2,2,293018,293019,293021,1,3,0
83693,3,2,293021,293021,293023,0,2,0
83694,3,1,293024,293024,293025,0,1,1
83695,2,3,293026,293026,293029,0,3,1
83696,1,1,293027,293029,293030,2,3,0
83697,5,3,293032,293032,293035,0,3,2
83698,3,1,293035,293035,293036,0,1,0
83699,1,3,293036,293036,293039,0,3,0
83700,5,1,293041,293041,293042,0,1,2
83701,2,1,293043,293043,293044,0,1,1
83702,2,2,293045,293045,293047,0,2,1
83703,5,2,293050,293050,293052,0,2,3
83704,2,1,293052,293052,293053,0,1,0
83705,3,3,293055,293055,293058,0,3,2
83706,1,2,293056,293058,293060,2,4,0
83707,1,3,293057,293060,293063,3,6,0
83708,6,3,293063,293063,293066,0,3,0
83709,1,1,293064,293066,293067,2,3,0
83710,4,2,293068,293068,293070,0,2,1
83711,1,3,293069,293070,293073,1,4,0
83712,3,1,293072,293073,293074,1,2,0
83713,2,3,293074,293074,293077,0,3,0
83714,2,2,293076,293077,293079,1,3,0
83715,2,3,293078,293079,293082,1,4,0
83716,5,3,293083,293083,293086,0,3,1
83717,4,2,293087,293087,293089,0,2,1
83718,1,3,293088,293089,293092,1,4,0
83719,2,2,293090,293092,293094,2,4,0
83720,6,2,293096,293096,293098,0,2,2
83721,5,1,293101,293101,293102,0,1,3
83722,1,3,293102,293102,293105,0,3,0
83723,2,2,293104,293105,293107,1,3,0
83724,4,3,293108,293108,293111,0,3,1
83725,3,2,293111,293111,293113,0,2,0
83726,6,1,293117,293117,293118,0,1,4
83727,1,1,293118,293118,293119,0,1,0
83728,5,2,293123,293123,293125,0,2,4
83729,1,2,293124,293125,293127,1,3,0
83730,2,1,293126,293127,293128,1,2,0
83731,5,2,293131,293131,293133,0,2,3
83732,2,2,293133,293133,293135,0,2,0
83733,1,1,293134,293135,293136,1,2,0
83734,6,3,293140,293140,293143,0,3,4
83735,2,1,293142,293143,293144,1,2,0
83736,1,2,293143,293144,293146,1,3,0
83737,5,2,293148,293148,293150,0,2,2
83738,6,3,293154,293154,293157,0,3,4
83739,4,1,293158,293158,293159,0,1,1
83740,3,3,293161,293161,293164,0,3,2
83741,4,1,293165,293165,293166,0,1,1
83742,1,2,293166,293166,293168,0,2,0
83743,2,2,293168,293168,293170,0,2,0
83744,2,2,293170,293170,293172,0,2,0
83745,4,1,293174,293174,293175,0,1,2
83746,5,3,293179,293179,293182,0,3,4
83747,3,1,293182,293182,293183,0,1,0
83748,1,2,293183,293183,293185,0,2,0
83749,1,3,293184,293185,293188,1,4,0
83750,2,2,293186,293188,293190,2,4,0
83751,1,3,293187,293190,293193,3,6,0
83752,4,3,293191,293193,293196,2,5,0
83753,2,2,293193,293196,293198,3,5,0
83754,3,1,293196,293198,293199,2,3,0
83755,1,2,293197,293199,293201,2,4,0
83756,6,1,293203,293203,293204,0,1,2
83757,2,1,293205,293205,293206,0,1,1
83758,4,1,293209,293209,293210,0,1,3
83759,5,2,293214,293214,293216,0,2,4
83760,5,1,293219,293219,293220,0,1,3
83761,3,3,293222,293222,293225,0,3,2
83762,3,1,293225,293225,293226,0,1,0
83763,3,1,293228,293228,293229,0,1,2
83764,2,1,293230,293230,293231,0,1,1
83765,2,3,293232,293232,293235,0,3,1
83766,4,1,293236,293236,293237,0,1,1
83767,2,3,293238,293238,293241,0,3,1
83768,6,1,293244,293244,293245,0,1,3
83769,2,3,293246,293246,293249,0,3,1
83770,2,3,293248,293249,293252,1,4,0
83771,3,3,293251,293252,293255,1,4,0
83772,2,3,293253,293255,293258,2,5,0
83773,4,1,293257,293258,293259,1,2,0
83774,3,3,293260,293260,293263,0,3,1
83775,1,2,293261,293263,293265,2,4,0
83776,4,1,293265,293265,293266,0,1,0
83777,4,1,293269,293269,293270,0,1,3
83778,3,1,293272,293272,293273,0,1,2
83779,3,1,293275,293275,293276,0,1,2
83780,4,3,293279,293279,293282,0,3,3
83781,5,3,293284,293284,293287,0,3,2
83782,2,2,293286,293287,293289,1,3,0
83783,6,2,293292,293292,293294,0,2,3
83784,6,2,293298,293298,293300,0,2,4
83785,4,1,293302,293302,293303,0,1,2
83786,2,2,293304,293304,293306,0,2,1
83787,1,3,293305,293306,293309,1,4,0
83788,3,2,293308,293309,293311,1,3,0
83789,6,3,293314,293314,293317,0,3,3
83790,4,2,293318,293318,293320,0,2,1
83791,1,1,293319,293320,293321,1,2,0
83792,5,2,293324,293324,293326,0,2,3
83793,6,3,293330,293330,293333,0,3,4
83794,5,3,293335,293335,293338,0,3,2
83795,3,2,293338,293338,293340,0,2,0
83796,4,1,293342,293342,293343,0,1,2
83797,3,3,293345,293345,293348,0,3,2
83798,2,3,293347,293348,293351,1,4,0
83799,5,1,293352,293352,293353,0,1,1
83800,2,3,293354,293354,293357,0,3,1
83801,3,3,293357,293357,293360,0,3,0
83802,3,3,293360,293360,293363,0,3,0
83803,6,3,293366,293366,293369,0,3,3
83804,6,1,293372,293372,293373,0,1,3
83805,2,2,293374,293374,293376,0,2,1
83806,3,3,293377,293377,293380,0,3,1
83807,4,2,293381,293381,293383,0,2,1
83808,6,1,293387,293387,293388,0,1,4
83809,3,1,293390,293390,293391,0,1,2
83810,5,1,293395,293395,293396,0,1,4
83811,6,3,293401,293401,293404,0,3,5
83812,5,3,293406,293406,293409,0,3,2
83813,1,1,293407,293409,293410,2,3,0
83814,3,2,293410,293410,293412,0,2,0
83815,6,1,293416,293416,293417,0,1,4
83816,3,3,293419,293419,293422,0,3,2
83817,5,3,293424,293424,293427,0,3,2
83818,3,2,293427,293427,293429,0,2,0
83819,1,2,293428,293429,293431,1,3,0
83820,2,3,293430,293431,293434,1,4,0
83821,2,3,293432,293434,293437,2,5,0
83822,3,1,293435,293437,293438,2,3,0
83823,3,1,293438,293438,293439,0,1,0
83824,2,2,293440,293440,293442,0,2,1
83825,4,2,293444,293444,293446,0,2,2
83826,3,1,293447,293447,293448,0,1,1
83827,2,1,293449,293449,293450,0,1,1
83828,5,2,293454,293454,293456,0,2,4
83829,5,1,293459,293459,293460,0,1,3
83830,5,1,293464,293464,293465,0,1,4
83831,1,3,293465,293465,293468,0,3,0
83832,6,1,293471,293471,293472,0,1,3
83833,5,3,293476,293476,293479,0,3,4
83834,3,1,293479,293479,293480,0,1,0
83835,6,2,293485,293485,293487,0,2,5
83836,3,3,293488,293488,293491,0,3,1
83837,6,3,293494,293494,293497,0,3,3
83838,6,3,293500,293500,293503,0,3,3
83839,1,1,293501,293503,293504,2,3,0
83840,1,1,293502,293504,293505,2,3,0
83841,1,3,293503,293505,293508,2,5,0
83842,3,1,293506,293508,293509,2,3,0
83843,3,2,293509,293509,293511,0,2,0
83844,1,1,293510,293511,293512,1,2,0
83845,1,3,293511,293512,293515,1,4,0
83846,6,2,293517,293517,293519,0,2,2
83847,4,1,293521,293521,293522,0,1,2
83848,2,3,293523,293523,293526,0,3,1
83849,6,1,293529,293529,293530,0,1,3
83850,5,3,293534,293534,293537,0,3,4
83851,1,1,293535,293537,293538,2,3,0
83852,1,3,293536,293538,293541,2,5,0
83853,1,2,293537,293541,293543,4,6,0
83854,3,3,293540,293543,293546,3,6,0
83855,3,2,293543,293546,293548,3,5,0
83856,1,2,293544,293548,293550,4,6,0
83857,5,2,293549,293550,293552,1,3,0
83858,5,2,293554,293554,293556,0,2,2
83859,6,3,293560,293560,293563,0,3,4
83860,1,2,293561,293563,293565,2,4,0
83861,6,3,293567,293567,293570,0,3,2
83862,6,2,293573,293573,293575,0,2,3
83863,5,3,293578,293578,293581,0,3,3
83864,4,2,293582,293582,293584,0,2,1
83865,2,2,293584,293584,293586,0,2,0
83866,2,1,293586,293586,293587,0,1,0
83867,6,3,293592,293592,293595,0,3,5
83868,6,1,293598,293598,293599,0,1,3
83869,1,1,293599,293599,293600,0,1,0
83870,3,3,293602,293602,293605,0,3,2
83871,1,3,293603,293605,293608,2,5,0
83872,6,3,293609,293609,293612,0,3,1
83873,5,2,293614,293614,293616,0,2,2
83874,5,3,293619,293619,293622,0,3,3
83875,4,2,293623,293623,293625,0,2,1
83876,2,3,293625,293625,293628,0,3,0
83877,2,1,293627,293628,293629,1,2,0
83878,3,3,293630,293630,293633,0,3,1
83879,5,2,293635,293635,293637,0,2,2
83880,2,1,293637,293637,293638,0,1,0
83881,2,1,293639,293639,293640,0,1,1
83882,4,2,293643,293643,293645,0,2,3
83883,6,1,293649,293649,293650,0,1,4
83884,6,1,293655,293655,293656,0,1,5
83885,2,1,293657,293657,293658,0,1,1
83886,1,2,293658,293658,293660,0,2,0
83887,5,1,293663,293663,293664,0,1,3
83888,5,3,293668,293668,293671,0,3,4
83889,6,3,293674,293674,293677,0,3,3
83890,3,3,293677,293677,293680,0,3,0
83891,5,3,293682,293682,293685,0,3,2
83892,3,3,293685,293685,293688,0,3,0
83893,2,1,293687,293688,293689,1,2,0
83894,2,3,293689,293689,293692,0,3,0
83895,4,1,293693,293693,293694,0,1,1
83896,5,3,293698,293698,293701,0,3,4
83897,2,3,293700,293701,293704,1,4,0
83898,4,1,293704,293704,293705,0,1,0
83899,3,3,293707,293707,293710,0,3,2
83900,5,3,293712,293712,293715,0,3,2
83901,3,2,293715,293715,293717,0,2,0
83902,5,2,293720,293720,293722,0,2,3
83903,4,2,293724,293724,293726,0,2,2
83904,5,3,293729,293729,293732,0,3,3
83905,1,2,293730,293732,293734,2,4,0
83906,3,3,293733,293734,293737,1,4,0
83907,5,3,293738,293738,293741,0,3,1
83908,5,1,293743,293743,293744,0,1,2
83909,5,2,293748,293748,293750,0,2,4
83910,3,2,293751,293751,293753,0,2,1
83911,1,2,293752,293753,293755,1,3,0
83912,2,1,293754,293755,293756,1,2,0
83913,4,3,293758,293758,293761,0,3,2
83914,1,2,293759,293761,293763,2,4,0
83915,3,2,293762,293763,293765,1,3,0
83916,1,2,293763,293765,293767,2,4,0
83917,6,3,293769,293769,293772,0,3,2
83918,3,2,293772,293772,293774,0,2,0
83919,4,2,293776,293776,293778,0,2,2
83920,2,1,293778,293778,293779,0,1,0
83921,6,1,293784,293784,293785,0,1,5
83922,4,3,293788,293788,293791,0,3,3
83923,1,3,293789,293791,293794,2,5,0
83924,6,1,293795,293795,293796,0,1,1
83925,4,3,293799,293799,293802,0,3,3
83926,6,3,293805,293805,293808,0,3,3
83927,2,3,293807,293808,293811,1,4,0
83928,1,2,293808,293811,293813,3,5,0
83929,2,2,293810,293813,293815,3,5,0
83930,2,2,293812,293815,293817,3,5,0
83931,1,2,293813,293817,293819,4,6,0
83932,6,1,293819,293819,293820,0,1,0
83933,5,1,293824,293824,293825,0,1,4
83934,3,3,293827,293827,293830,0,3,2
83935,4,2,293831,293831,293833,0,2,1
83936,5,3,293836,293836,293839,0,3,3
83937,5,1,293841,293841,293842,0,1,2
83938,4,3,293845,293845,293848,0,3,3
83939,1,2,293846,293848,293850,2,4,0
83940,3,2,293849,293850,293852,1,3,0
83941,4,3,293853,293853,293856,0,3,1
83942,1,3,293854,293856,293859,2,5,0
83943,2,2,293856,293859,293861,3,5,0
83944,5,2,293861,293861,293863,0,2,0
83945,6,1,293867,293867,293868,0,1,4
83946,3,1,293870,293870,293871,0,1,2
83947,3,1,293873,293873,293874,0,1,2
83948,6,3,293879,293879,293882,0,3,5
83949,6,3,293885,293885,293888,0,3,3
83950,4,1,293889,293889,293890,0,1,1
83951,1,1,293890,293890,293891,0,1,0
83952,6,1,293896,293896,293897,0,1,5
83953,3,2,293899,293899,293901,0,2,2
83954,4,2,293903,293903,293905,0,2,2
83955,4,3,293907,293907,293910,0,3,2
83956,3,3,293910,293910,293913,0,3,0
83957,6,3,293916,293916,293919,0,3,3
83958,2,3,293918,293919,293922,1,4,0
83959,4,2,293922,293922,293924,0,2,0
83960,5,2,293927,293927,293929,0,2,3
83961,4,2,293931,293931,293933,0,2,2
83962,4,1,293935,293935,293936,0,1,2
83963,6,3,293941,293941,293944,0,3,5
83964,4,1,293945,293945,293946,0,1,1
83965,2,1,293947,293947,293948,0,1,1
83966,5,1,293952,293952,293953,0,1,4
83967,3,1,293955,293955,293956,0,1,2
83968,1,1,293956,293956,293957,0,1,0
83969,6,2,293962,293962,293964,0,2,5
83970,6,2,293968,293968,293970,0,2,4
83971,1,1,293969,293970,293971,1,2,0
83972,6,3,293975,293975,293978,0,3,4
83973,3,1,293978,293978,293979,0,1,0
83974,4,1,293982,293982,293983,0,1,3
83975,2,2,293984,293984,293986,0,2,1
83976,1,2,293985,293986,293988,1,3,0
83977,1,1,293986,293988,293989,2,3,0
83978,5,1,293991,293991,293992,0,1,2
83979,2,2,293993,293993,293995,0,2,1
83980,5,2,293998,293998,294000,0,2,3
83981,5,2,294003,294003,294005,0,2,3
83982,6,2,294009,294009,294011,0,2,4
83983,4,2,294013,294013,294015,0,2,2
83984,1,1,294014,294015,294016,1,2,0
83985,3,3,294017,294017,294020,0,3,1
83986,6,3,294023,294023,294026,0,3,3
83987,4,1,294027,294027,294028,0,1,1
83988,6,1,294033,294033,294034,0,1,5
83989,2,3,294035,294035,294038,0,3,1
83990,2,1,294037,294038,294039,1,2,0
83991,1,3,294038,294039,294042,1,4,0
83992,1,1,294039,294042,294043,3,4,0
83993,4,3,294043,294043,294046,0,3,0
83994,2,1,294045,294046,294047,1,2,0
83995,2,1,294047,294047,294048,0,1,0
83996,6,1,294053,294053,294054,0,1,5
83997,1,3,294054,294054,294057,0,3,0
83998,2,3,294056,294057,294060,1,4,0
83999,1,2,294057,294060,294062,3,5,0
84000,4,3,294061,294062,294065,1,4,0
84001,2,3,294063,294065,294068,2,5,0
84002,5,2,294068,294068,294070,0,2,0
84003,1,2,294069,294070,294072,1,3,0
84004,1,3,294070,294072,294075,2,5,0
84005,2,3,294072,294075,294078,3,6,0
84006,6,3,294078,294078,294081,0,3,0
84007,6,3,294084,294084,294087,0,3,3
84008,4,2,294088,294088,294090,0,2,1
84009,5,3,294093,294093,294096,0,3,3
84010,2,3,294095,294096,294099,1,4,0
84011,1,3,294096,294099,294102,3,6,0
84012,3,3,294099,294102,294105,3,6,0
84013,2,1,294101,294105,294106,4,5,0
84014,1,1,294102,294106,294107,4,5,0
84015,3,1,294105,294107,294108,2,3,0
84016,5,1,294110,294110,294111,0,1,2
84017,2,3,294112,294112,294115,0,3,1
84018,2,1,294114,294115,294116,1,2,0
84019,4,1,294118,294118,294119,0,1,2
84020,5,1,294123,294123,294124,0,1,4
84021,6,2,294129,294129,294131,0,2,5
84022,5,3,294134,294134,294137,0,3,3
84023,1,3,294135,294137,294140,2,5,0
84024,3,1,294138,294140,294141,2,3,0
84025,5,3,294143,294143,294146,0,3,2
84026,1,1,294144,294146,294147,2,3,0
84027,4,2,294148,294148,294150,0,2,1
84028,5,3,294153,294153,294156,0,3,3
84029,3,2,294156,294156,294158,0,2,0
84030,2,1,294158,294158,294159,0,1,0
84031,6,3,294164,294164,294167,0,3,5
84032,2,2,294166,294167,294169,1,3,0
84033,6,3,294172,294172,294175,0,3,3
84034,5,3,294177,294177,294180,0,3,2
84035,5,1,294182,294182,294183,0,1,2
84036,5,2,294187,294187,294189,0,2,4
84037,2,3,294189,294189,294192,0,3,0
84038,4,3,294193,294193,294196,0,3,1
84039,3,3,294196,294196,294199,0,3,0
84040,5,3,294201,294201,294204,0,3,2
84041,5,2,294206,294206,294208,0,2,2
84042,5,3,294211,294211,294214,0,3,3
84043,5,1,294216,294216,294217,0,1,2
84044,6,3,294222,294222,294225,0,3,5
84045,6,2,294228,294228,294230,0,2,3
84046,2,2,294230,294230,294232,0,2,0
84047,3,2,294233,294233,294235,0,2,1
84048,4,1,294237,294237,294238,0,1,2
84049,3,1,294240,294240,294241,0,1,2
84050,4,1,294244,294244,294245,0,1,3
84051,6,2,294250,294250,294252,0,2,5
84052,3,2,294253,294253,294255,0,2,1
84053,1,2,294254,294255,294257,1,3,0
84054,2,1,294256,294257,294258,1,2,0
84055,3,2,294259,294259,294261,0,2,1
84056,3,2,294262,294262,294264,0,2,1
84057,2,1,294264,294264,294265,0,1,0
84058,3,2,294267,294267,294269,0,2,2
84059,5,1,294272,294272,294273,0,1,3
84060,2,2,294274,294274,294276,0,2,1
84061,4,3,294278,294278,294281,0,3,2
84062,2,1,294280,294281,294282,1,2,0
84063,4,3,294284,294284,294287,0,3,2
84064,5,1,294289,294289,294290,0,1,2
84065,3,3,294292,294292,294295,0,3,2
84066,4,2,294296,294296,294298,0,2,1
84067,5,1,294301,294301,294302,0,1,3
84068,5,3,294306,294306,294309,0,3,4
84069,2,2,294308,294309,294311,1,3,0
84070,4,1,294312,294312,294313,0,1,1
84071,4,1,294316,294316,294317,0,1,3
84072,6,3,294322,294322,294325,0,3,5
84073,6,1,294328,294328,294329,0,1,3
84074,4,1,294332,294332,294333,0,1,3
84075,3,2,294335,294335,294337,0,2,2
84076,4,1,294339,294339,294340,0,1,2
84077,5,3,294344,294344,294347,0,3,4
84078,6,1,294350,294350,294351,0,1,3
84079,4,3,294354,294354,294357,0,3,3
84080,5,2,294359,294359,294361,0,2,2
84081,2,2,294361,294361,294363,0,2,0
84082,4,2,294365,294365,294367,0,2,2
84083,1,2,294366,294367,294369,1,3,0
84084,5,3,294371,294371,294374,0,3,2
84085,3,1,294374,294374,294375,0,1,0
84086,1,1,294375,294375,294376,0,1,0
84087,4,3,294379,294379,294382,0,3,3
84088,1,3,294380,294382,294385,2,5,0
84089,2,3,294382,294385,294388,3,6,0
84090,2,3,294384,294388,294391,4,7,0
84091,5,1,294389,294391,294392,2,3,0
84092,3,2,294392,294392,294394,0,2,0
84093,6,1,294398,294398,294399,0,1,4
84094,4,3,294402,294402,294405,0,3,3
84095,3,3,294405,294405,294408,0,3,0
84096,6,1,294411,294411,294412,0,1,3
84097,1,2,294412,294412,294414,0,2,0
84098,2,2,294414,294414,294416,0,2,0
84099,2,1,294416,294416,294417,0,1,0
84100,6,3,294422,294422,294425,0,3,5
84101,1,1,294423,294425,294426,2,3,0
84102,6,1,294429,294429,294430,0,1,3
84103,6,3,294435,294435,294438,0,3,5
84104,2,2,294437,294438,294440,1,3,0
84105,4,1,294441,294441,294442,0,1,1
84106,6,1,294447,294447,294448,0,1,5
84107,1,3,294448,294448,294451,0,3,0
84108,4,3,294452,294452,294455,0,3,1
84109,2,1,294454,294455,294456,1,2,0
84110,5,1,294459,294459,294460,0,1,3
84111,4,2,294463,294463,294465,0,2,3
84112,5,2,294468,294468,294470,0,2,3
84113,6,1,294474,294474,294475,0,1,4
84114,1,2,294475,294475,294477,0,2,0
84115,2,3,294477,294477,294480,0,3,0
84116,2,2,294479,294480,294482,1,3,0
84117,2,2,294481,294482,294484,1,3,0
84118,3,3,294484,294484,294487,0,3,0
84119,4,1,294488,294488,294489,0,1,1
84120,5,2,294493,294493,294495,0,2,4
84121,5,2,294498,294498,294500,0,2,3
84122,1,2,294499,294500,294502,1,3,0
84123,3,2,294502,294502,294504,0,2,0
84124,1,2,294503,294504,294506,1,3,0
84125,1,3,294504,294506,294509,2,5,0
84126,5,3,294509,294509,294512,0,3,0
84127,6,3,294515,294515,294518,0,3,3
84128,6,3,294521,294521,294524,0,3,3
84129,2,3,294523,294524,294527,1,4,0
84130,2,1,294525,294527,294528,2,3,0
84131,3,2,294528,294528,294530,0,2,0
84132,5,3,294533,294533,294536,0,3,3
84133,2,2,294535,294536,294538,1,3,0
84134,3,2,294538,294538,294540,0,2,0
84135,1,3,294539,294540,294543,1,4,0
84136,4,1,294543,294543,294544,0,1,0
84137,5,1,294548,294548,294549,0,1,4
84138,2,3,294550,294550,294553,0,3,1
84139,6,3,294556,294556,294559,0,3,3
84140,4,3,294560,294560,294563,0,3,1
84141,6,1,294566,294566,294567,0,1,3
84142,5,2,294571,294571,294573,0,2,4
84143,5,1,294576,294576,294577,0,1,3
84144,2,2,294578,294578,294580,0,2,1
84145,6,3,294584,294584,294587,0,3,4
84146,4,1,294588,294588,294589,0,1,1
84147,6,2,294594,294594,294596,0,2,5
84148,6,2,294600,294600,294602,0,2,4
84149,6,1,294606,294606,294607,0,1,4
84150,2,3,294608,294608,294611,0,3,1
84151,3,3,294611,294611,294614,0,3,0
84152,1,3,294612,294614,294617,2,5,0
84153,5,3,294617,294617,294620,0,3,0
84154,1,1,294618,294620,294621,2,3,0
84155,3,2,294621,294621,294623,0,2,0
84156,4,1,294625,294625,294626,0,1,2
84157,2,3,294627,294627,294630,0,3,1
84158,5,2,294632,294632,294634,0,2,2
84159,1,3,294633,294634,294637,1,4,0
84160,3,1,294636,294637,294638,1,2,0
84161,4,1,294640,294640,294641,0,1,2
84162,3,1,294643,294643,294644,0,1,2
84163,3,3,294646,294646,294649,0,3,2
84164,1,1,294647,294649,294650,2,3,0
84165,2,3,294649,294650,294653,1,4,0
84166,6,1,294655,294655,294656,0,1,2
84167,2,2,294657,294657,294659,0,2,1
84168,2,2,294659,294659,294661,0,2,0
84169,1,3,294660,294661,294664,1,4,0
84170,6,3,294666,294666,294669,0,3,2
84171,1,1,294667,294669,294670,2,3,0
84172,2,1,294669,294670,294671,1,2,0
84173,1,3,294670,294671,294674,1,4,0
84174,1,2,294671,294674,294676,3,5,0
84175,4,2,294675,294676,294678,1,3,0
84176,4,3,294679,294679,294682,0,3,1
84177,1,2,294680,294682,294684,2,4,0
84178,6,1,294686,294686,294687,0,1,2
84179,4,3,294690,294690,294693,0,3,3
84180,3,2,294693,294693,294695,0,2,0
84181,3,1,294696,294696,294697,0,1,1
84182,1,2,294697,294697,294699,0,2,0
84183,6,3,294703,294703,294706,0,3,4
84184,4,2,294707,294707,294709,0,2,1
84185,1,2,294708,294709,294711,1,3,0
84186,6,3,294714,294714,294717,0,3,3
84187,4,3,294718,294718,294721,0,3,1
84188,5,3,294723,294723,294726,0,3,2
84189,4,2,294727,294727,294729,0,2,1
84190,5,1,294732,294732,294733,0,1,3
84191,4,1,294736,294736,294737,0,1,3
84192,6,2,294742,294742,294744,0,2,5
84193,4,2,294746,294746,294748,0,2,2
84194,2,2,294748,294748,294750,0,2,0
84195,4,3,294752,294752,294755,0,3,2
84196,1,2,294753,294755,294757,2,4,0
84197,4,3,294757,294757,294760,0,3,0
84198,6,3,294763,294763,294766,0,3,3
84199,5,1,294768,294768,294769,0,1,2
84200,4,1,294772,294772,294773,0,1,3
84201,2,2,294774,294774,294776,0,2,1
84202,1,2,294775,294776,294778,1,3,0
84203,4,1,294779,294779,294780,0,1,1
84204,5,2,294784,294784,294786,0,2,4
84205,6,1,294790,294790,294791,0,1,4
84206,5,3,294795,294795,294798,0,3,4
84207,5,3,294800,294800,294803,0,3,2
84208,2,1,294802,294803,294804,1,2,0
84209,5,2,294807,294807,294809,0,2,3
84210,1,3,294808,294809,294812,1,4,0
84211,6,2,294814,294814,294816,0,2,2
84212,4,3,294818,294818,294821,0,3,2
84213,1,2,294819,294821,294823,2,4,0
84214,6,1,294825,294825,294826,0,1,2
84215,5,3,294830,294830,294833,0,3,4
84216,6,3,294836,294836,294839,0,3,3
84217,4,2,294840,294840,294842,0,2,1
84218,3,3,294843,294843,294846,0,3,1
84219,2,2,294845,294846,294848,1,3,0
84220,2,3,294847,294848,294851,1,4,0
84221,2,2,294849,294851,294853,2,4,0
84222,6,3,294855,294855,294858,0,3,2
84223,4,3,294859,294859,294862,0,3,1
84224,3,3,294862,294862,294865,0,3,0
84225,6,3,294868,294868,294871,0,3,3
84226,3,2,294871,294871,294873,0,2,0
84227,5,1,294876,294876,294877,0,1,3
84228,2,3,294878,294878,294881,0,3,1
84229,5,1,294883,294883,294884,0,1,2
84230,1,1,294884,294884,294885,0,1,0
84231,2,2,294886,294886,294888,0,2,1
84232,4,2,294890,294890,294892,0,2,2
84233,5,1,294895,294895,294896,0,1,3
84234,1,2,294896,294896,294898,0,2,0
84235,2,1,294898,294898,294899,0,1,0
84236,5,2,294903,294903,294905,0,2,4
84237,4,2,294907,294907,294909,0,2,2
84238,1,1,294908,294909,294910,1,2,0
84239,4,2,294912,294912,294914,0,2,2
84240,2,1,294914,294914,294915,0,1,0
84241,1,1,294915,294915,294916,0,1,0
84242,4,1,294919,294919,294920,0,1,3
84243,1,1,294920,294920,294921,0,1,0
84244,5,3,294925,294925,294928,0,3,4
84245,6,3,294931,294931,294934,0,3,3
84246,2,2,294933,294934,294936,1,3,0
84247,3,1,294936,294936,294937,0,1,0
84248,5,2,294941,294941,294943,0,2,4
84249,5,3,294946,294946,294949,0,3,3
84250,4,2,294950,294950,294952,0,2,1
84251,6,1,294956,294956,294957,0,1,4
84252,3,3,294959,294959,294962,0,3,2
84253,3,3,294962,294962,294965,0,3,0
84254,1,2,294963,294965,294967,2,4,0
84255,5,1,294968,294968,294969,0,1,1
84256,2,2,294970,294970,294972,0,2,1
84257,4,2,294974,294974,294976,0,2,2
84258,1,2,294975,294976,294978,1,3,0
84259,6,2,294981,294981,294983,0,2,3
84260,2,3,294983,294983,294986,0,3,0
84261,6,1,294989,294989,294990,0,1,3
84262,3,3,294992,294992,294995,0,3,2
84263,3,3,294995,294995,294998,0,3,0
84264,4,2,294999,294999,295001,0,2,1
84265,6,1,295005,295005,295006,0,1,4
84266,3,3,295008,295008,295011,0,3,2
84267,1,2,295009,295011,295013,2,4,0
84268,3,1,295012,295013,295014,1,2,0
84269,2,1,295014,295014,295015,0,1,0
84270,6,3,295020,295020,295023,0,3,5
84271,3,3,295023,295023,295026,0,3,0
84272,3,1,295026,295026,295027,0,1,0
84273,4,3,295030,295030,295033,0,3,3
84274,4,2,295034,295034,295036,0,2,1
84275,6,1,295040,295040,295041,0,1,4
84276,4,1,295044,295044,295045,0,1,3
84277,3,2,295047,295047,295049,0,2,2
84278,6,2,295053,295053,295055,0,2,4
84279,6,3,295059,295059,295062,0,3,4
84280,6,3,295065,295065,295068,0,3,3
84281,2,3,295067,295068,295071,1,4,0
84282,5,2,295072,295072,295074,0,2,1
84283,5,3,295077,295077,295080,0,3,3
84284,6,3,295083,295083,295086,0,3,3
84285,3,3,295086,295086,295089,0,3,0
84286,1,1,295087,295089,295090,2,3,0
84287,2,1,295089,295090,295091,1,2,0
84288,4,3,295093,295093,295096,0,3,2
84289,6,2,295099,295099,295101,0,2,3
84290,5,2,295104,295104,295106,0,2,3
84291,2,2,295106,295106,295108,0,2,0
84292,1,2,295107,295108,295110,1,3,0
84293,6,3,295113,295113,295116,0,3,3
84294,1,2,295114,295116,295118,2,4,0
84295,6,2,295120,295120,295122,0,2,2
84296,6,1,295126,295126,295127,0,1,4
84297,2,1,295128,295128,295129,0,1,1
84298,4,1,295132,295132,295133,0,1,3
84299,5,2,295137,295137,295139,0,2,4
84300,3,1,295140,295140,295141,0,1,1
84301,6,2,295146,295146,295148,0,2,5
84302,1,2,295147,295148,295150,1,3,0
84303,6,1,295153,295153,295154,0,1,3
84304,3,1,295156,295156,295157,0,1,2
84305,4,3,295160,295160,295163,0,3,3
84306,4,3,295164,295164,295167,0,3,1
84307,3,2,295167,295167,295169,0,2,0
84308,6,1,295173,295173,295174,0,1,4
84309,4,3,295177,295177,295180,0,3,3
84310,1,2,295178,295180,295182,2,4,0
84311,2,2,295180,295182,295184,2,4,0
84312,2,2,295182,295184,295186,2,4,0
84313,2,3,295184,295186,295189,2,5,0
84314,3,2,295187,295189,295191,2,4,0
84315,5,3,295192,295192,295195,0,3,1
84316,5,1,295197,295197,295198,0,1,2
84317,2,2,295199,295199,295201,0,2,1
84318,4,3,295203,295203,295206,0,3,2
84319,2,2,295205,295206,295208,1,3,0
84320,3,3,295208,295208,295211,0,3,0
84321,3,2,295211,295211,295213,0,2,0
84322,3,1,295214,295214,295215,0,1,1
84323,6,3,295220,295220,295223,0,3,5
84324,6,1,295226,295226,295227,0,1,3
84325,6,2,295232,295232,295234,0,2,5
84326,2,1,295234,295234,295235,0,1,0
84327,5,1,295239,295239,295240,0,1,4
84328,4,3,295243,295243,295246,0,3,3
84329,3,3,295246,295246,295249,0,3,0
84330,6,1,295252,295252,295253,0,1,3
84331,2,3,295254,295254,295257,0,3,1
84332,3,3,295257,295257,295260,0,3,0
84333,4,2,295261,295261,295263,0,2,1
84334,6,2,295267,295267,295269,0,2,4
84335,5,3,295272,295272,295275,0,3,3
84336,5,2,295277,295277,295279,0,2,2
84337,5,3,295282,295282,295285,0,3,3
84338,4,3,295286,295286,295289,0,3,1
84339,4,3,295290,295290,295293,0,3,1
84340,5,1,295295,295295,295296,0,1,2
84341,2,1,295297,295297,295298,0,1,1
84342,6,2,295303,295303,295305,0,2,5
84343,4,3,295307,295307,295310,0,3,2
84344,6,3,295313,295313,295316,0,3,3
84345,2,1,295315,295316,295317,1,2,0
84346,5,1,295320,295320,295321,0,1,3
84347,4,3,295324,295324,295327,0,3,3
84348,3,2,295327,295327,295329,0,2,0
84349,5,1,295332,295332,295333,0,1,3
84350,3,2,295335,295335,295337,0,2,2
84351,3,2,295338,295338,295340,0,2,1
84352,6,1,295344,295344,295345,0,1,4
84353,6,2,295350,295350,295352,0,2,5
84354,6,2,295356,295356,295358,0,2,4
84355,5,3,295361,295361,295364,0,3,3
84356,4,1,295365,295365,295366,0,1,1
84357,2,2,295367,295367,295369,0,2,1
84358,1,1,295368,295369,295370,1,2,0
84359,3,2,295371,295371,295373,0,2,1
84360,4,3,295375,295375,295378,0,3,2
84361,2,1,295377,295378,295379,1,2,0
84362,6,2,295383,295383,295385,0,2,4
84363,3,2,295386,295386,295388,0,2,1
84364,4,2,295390,295390,295392,0,2,2
84365,3,3,295393,295393,295396,0,3,1
84366,6,3,295399,295399,295402,0,3,3
84367,1,2,295400,295402,295404,2,4,0
84368,5,2,295405,295405,295407,0,2,1
84369,1,1,295406,295407,295408,1,2,0
84370,6,1,295412,295412,295413,0,1,4
84371,1,3,295413,295413,295416,0,3,0
84372,1,1,295414,295416,295417,2,3,0
84373,3,3,295417,295417,295420,0,3,0
84374,3,3,295420,295420,295423,0,3,0
84375,1,1,295421,295423,295424,2,3,0
84376,5,2,295426,295426,295428,0,2,2
84377,5,1,295431,295431,295432,0,1,3
84378,6,2,295437,295437,295439,0,2,5
84379,2,1,295439,295439,295440,0,1,0
84380,6,2,295445,295445,295447,0,2,5
84381,5,3,295450,295450,295453,0,3,3
84382,3,1,295453,295453,295454,0,1,0
84383,4,1,295457,295457,295458,0,1,3
84384,3,3,295460,295460,295463,0,3,2
84385,3,3,295463,295463,295466,0,3,0
84386,1,3,295464,295466,295469,2,5,0
84387,6,3,295470,295470,295473,0,3,1
84388,3,3,295473,295473,295476,0,3,0
84389,4,1,295477,295477,295478,0,1,1
84390,5,3,295482,295482,295485,0,3,4
84391,4,3,295486,295486,295489,0,3,1
84392,3,1,295489,295489,295490,0,1,0
84393,5,3,295494,295494,295497,0,3,4
84394,1,3,295495,295497,295500,2,5,0
84395,2,3,295497,295500,295503,3,6,0
84396,1,2,295498,295503,295505,5,7,0
84397,6,2,295504,295505,295507,1,3,0
84398,4,3,295508,295508,295511,0,3,1
84399,1,2,295509,295511,295513,2,4,0
84400,2,2,295511,295513,295515,2,4,0
84401,6,2,295517,295517,295519,0,2,2
84402,6,1,295523,295523,295524,0,1,4
84403,4,2,295527,295527,295529,0,2,3
84404,1,1,295528,295529,295530,1,2,0
84405,4,1,295532,295532,295533,0,1,2
84406,6,2,295538,295538,295540,0,2,5
84407,1,1,295539,295540,295541,1,2,0
84408,4,3,295543,295543,295546,0,3,2
84409,4,1,295547,295547,295548,0,1,1
84410,4,2,295551,295551,295553,0,2,3
84411,5,1,295556,295556,295557,0,1,3
84412,2,3,295558,295558,295561,0,3,1
84413,5,3,295563,295563,295566,0,3,2
84414,1,3,295564,295566,295569,2,5,0
84415,4,1,295568,295569,295570,1,2,0
84416,5,3,295573,295573,295576,0,3,3
84417,5,1,295578,295578,295579,0,1,2
84418,2,1,295580,295580,295581,0,1,1
84419,2,3,295582,295582,295585,0,3,1
84420,5,1,295587,295587,295588,0,1,2
84421,5,2,295592,295592,295594,0,2,4
84422,6,1,295598,295598,295599,0,1,4
84423,6,1,295604,295604,295605,0,1,5
84424,2,1,295606,295606,295607,0,1,1
84425,6,3,295612,295612,295615,0,3,5
84426,2,1,295614,295615,295616,1,2,0
84427,4,1,295618,295618,295619,0,1,2
84428,1,2,295619,295619,295621,0,2,0
84429,6,1,295625,295625,295626,0,1,4
84430,1,2,295626,295626,295628,0,2,0
84431,4,1,295630,295630,295631,0,1,2
84432,2,1,295632,295632,295633,0,1,1
84433,2,3,295634,295634,295637,0,3,1
84434,5,2,295639,295639,295641,0,2,2
84435,1,3,295640,295641,295644,1,4,0
84436,1,1,295641,295644,295645,3,4,0
84437,1,3,295642,295645,295648,3,6,0
84438,5,3,295647,295648,295651,1,4,0
84439,3,1,295650,295651,295652,1,2,0
84440,3,1,295653,295653,295654,0,1,1
84441,5,2,295658,295658,295660,0,2,4
84442,4,2,295662,295662,295664,0,2,2
84443,4,1,295666,295666,295667,0,1,2
84444,2,2,295668,295668,295670,0,2,1
84445,3,3,295671,295671,295674,0,3,1
84446,6,1,295677,295677,295678,0,1,3
84447,4,2,295681,295681,295683,0,2,3
84448,1,3,295682,295683,295686,1,4,0
84449,2,1,295684,295686,295687,2,3,0
84450,2,1,295686,295687,295688,1,2,0
84451,5,3,295691,295691,295694,0,3,3
84452,5,3,295696,295696,295699,0,3,2
84453,1,2,295697,295699,295701,2,4,0
84454,3,3,295700,295701,295704,1,4,0
84455,3,2,295703,295704,295706,1,3,0
84456,2,3,295705,295706,295709,1,4,0
84457,6,3,295711,295711,295714,0,3,2
84458,6,1,295717,295717,295718,0,1,3
84459,6,1,295723,295723,295724,0,1,5
84460,5,1,295728,295728,295729,0,1,4
84461,6,1,295734,295734,295735,0,1,5
84462,3,3,295737,295737,295740,0,3,2
84463,5,1,295742,295742,295743,0,1,2
84464,6,1,295748,295748,295749,0,1,5
84465,5,2,295753,295753,295755,0,2,4
84466,6,1,295759,295759,295760,0,1,4
84467,5,2,295764,295764,295766,0,2,4
84468,6,1,295770,295770,295771,0,1,4
84469,4,2,295774,295774,295776,0,2,3
84470,1,1,295775,295776,295777,1,2,0
84471,3,3,295778,295778,295781,0,3,1
84472,6,2,295784,295784,295786,0,2,3
84473,5,3,295789,295789,295792,0,3,3
84474,4,3,295793,295793,295796,0,3,1
84475,3,3,295796,295796,295799,0,3,0
84476,2,2,295798,295799,295801,1,3,0
84477,4,3,295802,295802,295805,0,3,1
84478,5,3,295807,295807,295810,0,3,2
84479,6,1,295813,295813,295814,0,1,3
84480,3,3,295816,295816,295819,0,3,2
84481,3,1,295819,295819,295820,0,1,0
84482,5,1,295824,295824,295825,0,1,4
84483,6,1,295830,295830,295831,0,1,5
84484,4,3,295834,295834,295837,0,3,3
84485,2,3,295836,295837,295840,1,4,0
84486,4,3,295840,295840,295843,0,3,0
84487,3,3,295843,295843,295846,0,3,0
84488,4,2,295847,295847,295849,0,2,1
84489,5,1,295852,295852,295853,0,1,3
84490,3,3,295855,295855,295858,0,3,2
84491,4,3,295859,295859,295862,0,3,1
84492,2,1,295861,295862,295863,1,2,0
84493,3,2,295864,295864,295866,0,2,1
84494,2,1,295866,295866,295867,0,1,0
84495,2,2,295868,295868,295870,0,2,1
84496,4,1,295872,295872,295873,0,1,2
84497,6,3,295878,295878,295881,0,3,5
84498,4,3,295882,295882,295885,0,3,1
84499,6,1,295888,295888,295889,0,1,3
84500,2,3,295890,295890,295893,0,3,1
84501,6,1,295896,295896,295897,0,1,3
84502,6,3,295902,295902,295905,0,3,5
84503,3,3,295905,295905,295908,0,3,0
84504,5,1,295910,295910,295911,0,1,2
84505,2,1,295912,295912,295913,0,1,1
84506,1,1,295913,295913,295914,0,1,0
84507,5,3,295918,295918,295921,0,3,4
84508,4,2,295922,295922,295924,0,2,1
84509,1,2,295923,295924,295926,1,3,0
84510,5,1,295928,295928,295929,0,1,2
84511,5,2,295933,295933,295935,0,2,4
84512,1,2,295934,295935,295937,1,3,0
84513,3,1,295937,295937,295938,0,1,0
84514,6,3,295943,295943,295946,0,3,5
84515,5,2,295948,295948,295950,0,2,2
84516,5,2,295953,295953,295955,0,2,3
84517,1,3,295954,295955,295958,1,4,0
84518,5,1,295959,295959,295960,0,1,1
84519,2,3,295961,295961,295964,0,3,1
84520,1,1,295962,295964,295965,2,3,0
84521,3,1,295965,295965,295966,0,1,0
84522,5,2,295970,295970,295972,0,2,4
84523,3,2,295973,295973,295975,0,2,1
84524,4,2,295977,295977,295979,0,2,2
84525,4,1,295981,295981,295982,0,1,2
84526,6,1,295987,295987,295988,0,1,5
84527,4,2,295991,295991,295993,0,2,3
84528,1,1,295992,295993,295994,1,2,0
84529,6,2,295998,295998,296000,0,2,4
84530,4,3,296002,296002,296005,0,3,2
84531,1,1,296003,296005,296006,2,3,0
84532,1,3,296004,296006,296009,2,5,0
84533,1,1,296005,296009,296010,4,5,0
84534,1,2,296006,296010,296012,4,6,0
84535,2,3,296008,296012,296015,4,7,0
84536,5,1,296013,296015,296016,2,3,0
84537,6,1,296019,296019,296020,0,1,3
84538,4,3,296023,296023,296026,0,3,3
84539,4,1,296027,296027,296028,0,1,1
84540,3,2,296030,296030,296032,0,2,2
84541,5,3,296035,296035,296038,0,3,3
84542,5,1,296040,296040,296041,0,1,2
84543,2,1,296042,296042,296043,0,1,1
84544,3,2,296045,296045,296047,0,2,2
84545,1,3,296046,296047,296050,1,4,0
84546,2,3,296048,296050,296053,2,5,0
84547,3,2,296051,296053,296055,2,4,0
84548,5,3,296056,296056,296059,0,3,1
84549,2,1,296058,296059,296060,1,2,0
84550,6,1,296064,296064,296065,0,1,4
84551,2,2,296066,296066,296068,0,2,1
84552,5,2,296071,296071,296073,0,2,3
84553,5,1,296076,296076,296077,0,1,3
84554,1,3,296077,296077,296080,0,3,0
84555,3,3,296080,296080,296083,0,3,0
84556,4,2,296084,296084,296086,0,2,1
84557,2,3,296086,296086,296089,0,3,0
84558,5,3,296091,296091,296094,0,3,2
84559,1,3,296092,296094,296097,2,5,0
84560,1,1,296093,296097,296098,4,5,0
84561,6,1,296099,296099,296100,0,1,1
84562,5,2,296104,296104,296106,0,2,4
84563,4,2,296108,296108,296110,0,2,2
84564,4,1,296112,296112,296113,0,1,2
84565,2,1,296114,296114,296115,0,1,1
84566,6,2,296120,296120,296122,0,2,5
84567,2,1,296122,296122,296123,0,1,0
84568,2,3,296124,296124,296127,0,3,1
84569,2,2,296126,296127,296129,1,3,0
84570,4,3,296130,296130,296133,0,3,1
84571,3,2,296133,296133,296135,0,2,0
84572,2,1,296135,296135,296136,0,1,0
84573,4,3,296139,296139,296142,0,3,3
84574,2,1,296141,296142,296143,1,2,0
84575,4,2,296145,296145,296147,0,2,2
84576,3,1,296148,296148,296149,0,1,1
84577,2,3,296150,296150,296153,0,3,1
84578,4,1,296154,296154,296155,0,1,1
84579,2,3,296156,296156,296159,0,3,1
84580,4,3,296160,296160,296163,0,3,1
84581,4,1,296164,296164,296165,0,1,1
84582,5,1,296169,296169,296170,0,1,4
84583,1,3,296170,296170,296173,0,3,0
84584,2,3,296172,296173,296176,1,4,0
84585,1,1,296173,296176,296177,3,4,0
84586,6,1,296179,296179,296180,0,1,2
84587,1,2,296180,296180,296182,0,2,0
84588,5,3,296185,296185,296188,0,3,3
84589,1,2,296186,296188,296190,2,4,0
84590,3,3,296189,296190,296193,1,4,0
84591,2,1,296191,296193,296194,2,3,0
84592,4,1,296195,296195,296196,0,1,1
84593,3,1,296198,296198,296199,0,1,2
84594,1,2,296199,296199,296201,0,2,0
84595,5,3,296204,296204,296207,0,3,3
84596,2,1,296206,296207,296208,1,2,0
84597,5,3,296211,296211,296214,0,3,3
84598,3,2,296214,296214,296216,0,2,0
84599,1,1,296215,296216,296217,1,2,0
84600,4,1,296219,296219,296220,0,1,2
84601,1,1,296220,296220,296221,0,1,0
84602,2,1,296222,296222,296223,0,1,1
84603,3,1,296225,296225,296226,0,1,2
84604,5,3,296230,296230,296233,0,3,4
84605,4,2,296234,296234,296236,0,2,1
84606,5,3,296239,296239,296242,0,3,3
84607,2,1,296241,296242,296243,1,2,0
84608,5,3,296246,296246,296249,0,3,3
84609,2,2,296248,296249,296251,1,3,0
84610,5,2,296253,296253,296255,0,2,2
84611,6,2,296259,296259,296261,0,2,4
84612,2,1,296261,296261,296262,0,1,0
84613,2,1,296263,296263,296264,0,1,1
84614,5,3,296268,296268,296271,0,3,4
84615,4,2,296272,296272,296274,0,2,1
84616,1,1,296273,296274,296275,1,2,0
84617,2,1,296275,296275,296276,0,1,0
84618,6,1,296281,296281,296282,0,1,5
84619,2,3,296283,296283,296286,0,3,1
84620,1,3,296284,296286,296289,2,5,0
84621,6,3,296290,296290,296293,0,3,1
84622,3,3,296293,296293,296296,0,3,0
84623,1,2,296294,296296,296298,2,4,0
84624,1,1,296295,296298,296299,3,4,0
84625,6,1,296301,296301,296302,0,1,2
84626,2,1,296303,296303,296304,0,1,1
84627,3,1,296306,296306,296307,0,1,2
84628,2,3,296308,296308,296311,0,3,1
84629,3,2,296311,296311,296313,0,2,0
84630,1,2,296312,296313,296315,1,3,0
84631,6,2,296318,296318,296320,0,2,3
84632,1,3,296319,296320,296323,1,4,0
84633,3,2,296322,296323,296325,1,3,0
84634,1,1,296323,296325,296326,2,3,0
84635,3,1,296326,296326,296327,0,1,0
84636,1,2,296327,296327,296329,0,2,0
84637,3,2,296330,296330,296332,0,2,1
84638,1,2,296331,296332,296334,1,3,0
84639,3,2,296334,296334,296336,0,2,0
84640,1,2,296335,296336,296338,1,3,0
84641,5,1,296340,296340,296341,0,1,2
84642,1,1,296341,296341,296342,0,1,0
84643,5,1,296346,296346,296347,0,1,4
84644,2,1,296348,296348,296349,0,1,1
84645,5,3,296353,296353,296356,0,3,4
84646,1,1,296354,296356,296357,2,3,0
84647,3,3,296357,296357,296360,0,3,0
84648,6,1,296363,296363,296364,0,1,3
84649,6,3,296369,296369,296372,0,3,5
84650,6,2,296375,296375,296377,0,2,3
84651,1,1,296376,296377,296378,1,2,0
84652,1,2,296377,296378,296380,1,3,0
84653,4,2,296381,296381,296383,0,2,1
84654,1,3,296382,296383,296386,1,4,0
84655,1,1,296383,296386,296387,3,4,0
84656,6,2,296389,296389,296391,0,2,2
84657,2,3,296391,296391,296394,0,3,0
84658,2,2,296393,296394,296396,1,3,0
84659,6,2,296399,296399,296401,0,2,3
84660,6,3,296405,296405,296408,0,3,4
84661,1,3,296406,296408,296411,2,5,0
84662,6,1,296412,296412,296413,0,1,1
84663,5,1,296417,296417,296418,0,1,4
84664,2,3,296419,296419,296422,0,3,1
84665,4,2,296423,296423,296425,0,2,1
84666,6,3,296429,296429,296432,0,3,4
84667,1,2,296430,296432,296434,2,4,0
84668,5,1,296435,296435,296436,0,1,1
84669,3,2,296438,296438,296440,0,2,2
84670,1,3,296439,296440,296443,1,4,0
84671,6,3,296445,296445,296448,0,3,2
84672,5,1,296450,296450,296451,0,1,2
84673,4,3,296454,296454,296457,0,3,3
84674,1,1,296455,296457,296458,2,3,0
84675,3,3,296458,296458,296461,0,3,0
84676,5,1,296463,296463,296464,0,1,2
84677,1,3,296464,296464,296467,0,3,0
84678,5,3,296469,296469,296472,0,3,2
84679,5,1,296474,296474,296475,0,1,2
84680,1,3,296475,296475,296478,0,3,0
84681,2,1,296477,296478,296479,1,2,0
84682,4,2,296481,296481,296483,0,2,2
84683,3,2,296484,296484,296486,0,2,1
84684,6,2,296490,296490,296492,0,2,4
84685,6,3,296496,296496,296499,0,3,4
84686,6,3,296502,296502,296505,0,3,3
84687,2,3,296504,296505,296508,1,4,0
84688,6,1,296510,296510,296511,0,1,2
84689,2,2,296512,296512,296514,0,2,1
84690,3,1,296515,296515,296516,0,1,1
84691,5,1,296520,296520,296521,0,1,4
84692,2,1,296522,296522,296523,0,1,1
84693,5,3,296527,296527,296530,0,3,4
84694,3,1,296530,296530,296531,0,1,0
84695,4,1,296534,296534,296535,0,1,3
84696,2,2,296536,296536,296538,0,2,1
84697,4,2,296540,296540,296542,0,2,2
84698,1,3,296541,296542,296545,1,4,0
84699,6,3,296547,296547,296550,0,3,2
84700,5,3,296552,296552,296555,0,3,2
84701,4,1,296556,296556,296557,0,1,1
84702,3,1,296559,296559,296560,0,1,2
84703,6,1,296565,296565,296566,0,1,5
84704,5,2,296570,296570,296572,0,2,4
84705,2,2,296572,296572,296574,0,2,0
84706,6,2,296578,296578,296580,0,2,4
84707,1,2,296579,296580,296582,1,3,0
84708,4,2,296583,296583,296585,0,2,1
84709,5,2,296588,296588,296590,0,2,3
84710,4,2,296592,296592,296594,0,2,2
84711,5,1,296597,296597,296598,0,1,3
84712,5,3,296602,296602,296605,0,3,4
84713,3,2,296605,296605,296607,0,2,0
84714,2,3,296607,296607,296610,0,3,0
84715,6,2,296613,296613,296615,0,2,3
84716,5,3,296618,296618,296621,0,3,3
84717,3,2,296621,296621,296623,0,2,0
84718,3,3,296624,296624,296627,0,3,1
84719,6,2,296630,296630,296632,0,2,3
84720,4,3,296634,296634,296637,0,3,2
84721,3,2,296637,296637,296639,0,2,0
84722,1,1,296638,296639,296640,1,2,0
84723,4,2,296642,296642,296644,0,2,2
84724,3,3,296645,296645,296648,0,3,1
84725,4,1,296649,296649,296650,0,1,1
84726,6,2,296655,296655,296657,0,2,5
84727,5,1,296660,296660,296661,0,1,3
84728,1,2,296661,296661,296663,0,2,0
84729,2,1,296663,296663,296664,0,1,0
84730,3,2,296666,296666,296668,0,2,2
84731,5,1,296671,296671,296672,0,1,3
84732,3,1,296674,296674,296675,0,1,2
84733,3,1,296677,296677,296678,0,1,2
84734,3,1,296680,296680,296681,0,1,2
84735,1,1,296681,296681,296682,0,1,0
84736,3,3,296684,296684,296687,0,3,2
84737,1,3,296685,296687,296690,2,5,0
84738,6,3,296691,296691,296694,0,3,1
84739,1,1,296692,296694,296695,2,3,0
84740,6,1,296698,296698,296699,0,1,3
84741,4,2,296702,296702,296704,0,2,3
84742,5,3,296707,296707,296710,0,3,3
84743,3,3,296710,296710,296713,0,3,0
84744,5,1,296715,296715,296716,0,1,2
84745,4,3,296719,296719,296722,0,3,3
84746,2,3,296721,296722,296725,1,4,0
84747,1,1,296722,296725,296726,3,4,0
84748,1,1,296723,296726,296727,3,4,0
84749,6,3,296729,296729,296732,0,3,2
84750,4,2,296733,296733,296735,0,2,1
84751,6,2,296739,296739,296741,0,2,4
84752,6,1,296745,296745,296746,0,1,4
84753,6,2,296751,296751,296753,0,2,5
84754,2,3,296753,296753,296756,0,3,0
84755,4,3,296757,296757,296760,0,3,1
84756,3,2,296760,296760,296762,0,2,0
84757,6,2,296766,296766,296768,0,2,4
84758,4,3,296770,296770,296773,0,3,2
84759,1,1,296771,296773,296774,2,3,0
84760,2,2,296773,296774,296776,1,3,0
84761,3,2,296776,296776,296778,0,2,0
84762,4,3,296780,296780,296783,0,3,2
84763,4,2,296784,296784,296786,0,2,1
84764,1,3,296785,296786,296789,1,4,0
84765,2,1,296787,296789,296790,2,3,0
84766,5,1,296792,296792,296793,0,1,2
84767,3,1,296795,296795,296796,0,1,2
84768,5,1,296800,296800,296801,0,1,4
84769,6,2,296806,296806,296808,0,2,5
84770,5,2,296811,296811,296813,0,2,3
84771,6,2,296817,296817,296819,0,2,4
84772,2,3,296819,296819,296822,0,3,0
84773,2,3,296821,296822,296825,1,4,0
84774,4,1,296825,296825,296826,0,1,0
84775,3,3,296828,296828,296831,0,3,2
84776,2,1,296830,296831,296832,1,2,0
84777,1,1,296831,296832,296833,1,2,0
84778,2,2,296833,296833,296835,0,2,0
84779,6,1,296839,296839,296840,0,1,4
84780,6,1,296845,296845,296846,0,1,5
84781,1,1,296846,296846,296847,0,1,0
84782,5,1,296851,296851,296852,0,1,4
84783,2,2,296853,296853,296855,0,2,1
84784,4,2,296857,296857,296859,0,2,2
84785,3,3,296860,296860,296863,0,3,1
84786,6,2,296866,296866,296868,0,2,3
84787,2,3,296868,296868,296871,0,3,0
84788,4,3,296872,296872,296875,0,3,1
84789,4,2,296876,296876,296878,0,2,1
84790,1,3,296877,296878,296881,1,4,0
84791,5,3,296882,296882,296885,0,3,1
84792,3,1,296885,296885,296886,0,1,0
84793,4,2,296889,296889,296891,0,2,3
84794,6,2,296895,296895,296897,0,2,4
84795,5,1,296900,296900,296901,0,1,3
84796,2,1,296902,296902,296903,0,1,1
84797,3,2,296905,296905,296907,0,2,2
84798,6,1,296911,296911,296912,0,1,4
84799,2,2,296913,296913,296915,0,2,1
84800,6,3,296919,296919,296922,0,3,4
84801,5,1,296924,296924,296925,0,1,2
84802,1,3,296925,296925,296928,0,3,0
84803,6,1,296931,296931,296932,0,1,3
84804,2,1,296933,296933,296934,0,1,1
84805,6,2,296939,296939,296941,0,2,5
84806,4,3,296943,296943,296946,0,3,2
84807,5,2,296948,296948,296950,0,2,2
84808,6,3,296954,296954,296957,0,3,4
84809,5,1,296959,296959,296960,0,1,2
84810,3,2,296962,296962,296964,0,2,2
84811,5,2,296967,296967,296969,0,2,3
84812,2,2,296969,296969,296971,0,2,0
84813,5,1,296974,296974,296975,0,1,3
84814,5,1,296979,296979,296980,0,1,4
84815,2,3,296981,296981,296984,0,3,1
84816,1,3,296982,296984,296987,2,5,0
84817,3,2,296985,296987,296989,2,4,0
84818,2,2,296987,296989,296991,2,4,0
84819,4,1,296991,296991,296992,0,1,0
84820,2,3,296993,296993,296996,0,3,1
84821,5,1,296998,296998,296999,0,1,2
84822,2,3,297000,297000,297003,0,3,1
84823,2,3,297002,297003,297006,1,4,0
84824,2,1,297004,297006,297007,2,3,0
84825,4,1,297008,297008,297009,0,1,1
84826,1,2,297009,297009,297011,0,2,0
84827,5,2,297014,297014,297016,0,2,3
84828,1,1,297015,297016,297017,1,2,0
84829,6,1,297021,297021,297022,0,1,4
84830,5,2,297026,297026,297028,0,2,4
84831,3,3,297029,297029,297032,0,3,1
84832,3,1,297032,297032,297033,0,1,0
84833,1,3,297033,297033,297036,0,3,0
84834,3,2,297036,297036,297038,0,2,0
84835,1,1,297037,297038,297039,1,2,0
84836,3,2,297040,297040,297042,0,2,1
84837,3,1,297043,297043,297044,0,1,1
84838,2,1,297045,297045,297046,0,1,1
84839,5,3,297050,297050,297053,0,3,4
84840,3,3,297053,297053,297056,0,3,0
84841,6,3,297059,297059,297062,0,3,3
84842,1,3,297060,297062,297065,2,5,0
84843,5,3,297065,297065,297068,0,3,0
84844,5,2,297070,297070,297072,0,2,2
84845,6,1,297076,297076,297077,0,1,4
84846,5,3,297081,297081,297084,0,3,4
84847,6,1,297087,297087,297088,0,1,3
84848,3,3,297090,297090,297093,0,3,2
84849,4,2,297094,297094,297096,0,2,1
84850,5,2,297099,297099,297101,0,2,3
84851,2,2,297101,297101,297103,0,2,0
84852,4,1,297105,297105,297106,0,1,2
84853,5,2,297110,297110,297112,0,2,4
84854,6,1,297116,297116,297117,0,1,4
84855,3,1,297119,297119,297120,0,1,2
84856,1,3,297120,297120,297123,0,3,0
84857,5,1,297125,297125,297126,0,1,2
84858,5,3,297130,297130,297133,0,3,4
84859,5,2,297135,297135,297137,0,2,2
84860,2,2,297137,297137,297139,0,2,0
84861,4,2,297141,297141,297143,0,2,2
84862,1,3,297142,297143,297146,1,4,0
84863,4,3,297146,297146,297149,0,3,0
84864,4,1,297150,297150,297151,0,1,1
84865,6,3,297156,297156,297159,0,3,5
84866,2,1,297158,297159,297160,1,2,0
84867,1,2,297159,297160,297162,1,3,0
84868,2,2,297161,297162,297164,1,3,0
84869,5,3,297166,297166,297169,0,3,2
84870,1,1,297167,297169,297170,2,3,0
84871,2,3,297169,297170,297173,1,4,0
84872,4,2,297173,297173,297175,0,2,0
84873,2,2,297175,297175,297177,0,2,0
84874,3,3,297178,297178,297181,0,3,1
84875,6,1,297184,297184,297185,0,1,3
84876,3,3,297187,297187,297190,0,3,2
84877,6,1,297193,297193,297194,0,1,3
84878,1,2,297194,297194,297196,0,2,0
84879,6,1,297200,297200,297201,0,1,4
84880,4,1,297204,297204,297205,0,1,3
84881,6,3,297210,297210,297213,0,3,5
84882,6,3,297216,297216,297219,0,3,3
84883,6,2,297222,297222,297224,0,2,3
84884,4,1,297226,297226,297227,0,1,2
84885,4,2,297230,297230,297232,0,2,3
84886,6,3,297236,297236,297239,0,3,4
84887,1,1,297237,297239,297240,2,3,0
84888,2,1,297239,297240,297241,1,2,0
84889,5,1,297244,297244,297245,0,1,3
84890,5,3,297249,297249,297252,0,3,4
84891,4,3,297253,297253,297256,0,3,1
84892,3,3,297256,297256,297259,0,3,0
84893,6,3,297262,297262,297265,0,3,3
84894,6,3,297268,297268,297271,0,3,3
84895,2,1,297270,297271,297272,1,2,0
84896,6,2,297276,297276,297278,0,2,4
84897,4,2,297280,297280,297282,0,2,2
84898,5,2,297285,297285,297287,0,2,3
84899,4,3,297289,297289,297292,0,3,2
84900,5,2,297294,297294,297296,0,2,2
84901,1,1,297295,297296,297297,1,2,0
84902,3,2,297298,297298,297300,0,2,1
84903,5,1,297303,297303,297304,0,1,3
84904,2,2,297305,297305,297307,0,2,1
84905,5,2,297310,297310,297312,0,2,3
84906,3,1,297313,297313,297314,0,1,1
84907,3,1,297316,297316,297317,0,1,2
84908,3,2,297319,297319,297321,0,2,2
84909,3,1,297322,297322,297323,0,1,1
84910,1,1,297323,297323,297324,0,1,0
84911,2,1,297325,297325,297326,0,1,1
84912,6,3,297331,297331,297334,0,3,5
84913,5,2,297336,297336,297338,0,2,2
84914,5,2,297341,297341,297343,0,2,3
84915,2,2,297343,297343,297345,0,2,0
84916,3,2,297346,297346,297348,0,2,1
84917,3,1,297349,297349,297350,0,1,1
84918,1,1,297350,297350,297351,0,1,0
84919,6,1,297356,297356,297357,0,1,5
84920,5,3,297361,297361,297364,0,3,4
84921,4,3,297365,297365,297368,0,3,1
84922,6,3,297371,297371,297374,0,3,3
84923,2,1,297373,297374,297375,1,2,0
84924,4,2,297377,297377,297379,0,2,2
84925,6,2,297383,297383,297385,0,2,4
84926,5,1,297388,297388,297389,0,1,3
84927,2,2,297390,297390,297392,0,2,1
84928,4,3,297394,297394,297397,0,3,2
84929,1,3,297395,297397,297400,2,5,0
84930,2,1,297397,297400,297401,3,4,0
84931,1,1,297398,297401,297402,3,4,0
84932,5,3,297403,297403,297406,0,3,1
84933,3,2,297406,297406,297408,0,2,0
84934,4,1,297410,297410,297411,0,1,2
84935,4,2,297414,297414,297416,0,2,3
84936,2,3,297416,297416,297419,0,3,0
84937,6,3,297422,297422,297425,0,3,3
84938,4,1,297426,297426,297427,0,1,1
84939,4,3,297430,297430,297433,0,3,3
84940,6,3,297436,297436,297439,0,3,3
84941,3,3,297439,297439,297442,0,3,0
84942,2,2,297441,297442,297444,1,3,0
84943,1,3,297442,297444,297447,2,5,0
84944,3,1,297445,297447,297448,2,3,0
84945,5,1,297450,297450,297451,0,1,2
84946,2,2,297452,297452,297454,0,2,1
84947,3,2,297455,297455,297457,0,2,1
84948,1,1,297456,297457,297458,1,2,0
84949,3,3,297459,297459,297462,0,3,1
84950,4,1,297463,297463,297464,0,1,1
84951,1,1,297464,297464,297465,0,1,0
84952,1,1,297465,297465,297466,0,1,0
84953,5,3,297470,297470,297473,0,3,4
84954,6,3,297476,297476,297479,0,3,3
84955,4,3,297480,297480,297483,0,3,1
84956,6,3,297486,297486,297489,0,3,3
84957,1,3,297487,297489,297492,2,5,0
84958,4,2,297491,297492,297494,1,3,0
84959,2,2,297493,297494,297496,1,3,0
84960,3,2,297496,297496,297498,0,2,0
84961,2,2,297498,297498,297500,0,2,0
84962,5,2,297503,297503,297505,0,2,3
84963,2,3,297505,297505,297508,0,3,0
84964,2,1,297507,297508,297509,1,2,0
84965,6,1,297513,297513,297514,0,1,4
84966,3,3,297516,297516,297519,0,3,2
84967,2,2,297518,297519,297521,1,3,0
84968,6,1,297524,297524,297525,0,1,3
84969,5,1,297529,297529,297530,0,1,4
84970,1,2,297530,297530,297532,0,2,0
84971,6,1,297536,297536,297537,0,1,4
84972,4,3,297540,297540,297543,0,3,3
84973,4,2,297544,297544,297546,0,2,1
84974,5,1,297549,297549,297550,0,1,3
84975,3,3,297552,297552,297555,0,3,2
84976,6,3,297558,297558,297561,0,3,3
84977,2,3,297560,297561,297564,1,4,0
84978,4,2,297564,297564,297566,0,2,0
84979,2,1,297566,297566,297567,0,1,0
84980,5,1,297571,297571,297572,0,1,4
84981,1,3,297572,297572,297575,0,3,0
84982,1,3,297573,297575,297578,2,5,0
84983,4,2,297577,297578,297580,1,3,0
84984,1,3,297578,297580,297583,2,5,0
84985,4,2,297582,297583,297585,1,3,0
84986,1,1,297583,297585,297586,2,3,0
84987,1,3,297584,297586,297589,2,5,0
84988,1,2,297585,297589,297591,4,6,0
84989,2,1,297587,297591,297592,4,5,0
84990,1,3,297588,297592,297595,4,7,0
84991,1,2,297589,297595,297597,6,8,0
84992,2,1,297591,297597,297598,6,7,0
84993,2,1,297593,297598,297599,5,6,0
84994,3,1,297596,297599,297600,3,4,0
84995,5,3,297601,297601,297604,0,3,1
84996,5,2,297606,297606,297608,0,2,2
84997,4,2,297610,297610,297612,0,2,2
84998,2,2,297612,297612,297614,0,2,0
84999,5,2,297617,297617,297619,0,2,3
85000,4,2,297621,297621,297623,0,2,2
85001,3,1,297624,297624,297625,0,1,1
85002,2,3,297626,297626,297629,0,3,1
85003,3,1,297629,297629,297630,0,1,0
85004,6,3,297635,297635,297638,0,3,5
85005,4,3,297639,297639,297642,0,3,1
85006,2,2,297641,297642,297644,1,3,0
85007,4,2,297645,297645,297647,0,2,1
85008,5,2,297650,297650,297652,0,2,3
85009,3,1,297653,297653,297654,0,1,1
85010,6,1,297659,297659,297660,0,1,5
85011,2,3,297661,297661,297664,0,3,1
85012,2,3,297663,297664,297667,1,4,0
85013,2,1,297665,297667,297668,2,3,0
85014,2,2,297667,297668,297670,1,3,0
85015,5,1,297672,297672,297673,0,1,2
85016,1,3,297673,297673,297676,0,3,0
85017,4,2,297677,297677,297679,0,2,1
85018,1,2,297678,297679,297681,1,3,0
85019,3,1,297681,297681,297682,0,1,0
85020,4,3,297685,297685,297688,0,3,3
85021,6,2,297691,297691,297693,0,2,3
85022,4,3,297695,297695,297698,0,3,2
85023,1,2,297696,297698,297700,2,4,0
85024,4,1,297700,297700,297701,0,1,0
85025,4,3,297704,297704,297707,0,3,3
85026,3,3,297707,297707,297710,0,3,0
85027,3,2,297710,297710,297712,0,2,0
85028,2,2,297712,297712,297714,0,2,0
85029,2,2,297714,297714,297716,0,2,0
85030,3,2,297717,297717,297719,0,2,1
85031,6,2,297723,297723,297725,0,2,4
85032,4,2,297727,297727,297729,0,2,2
85033,5,1,297732,297732,297733,0,1,3
85034,5,1,297737,297737,297738,0,1,4
85035,6,3,297743,297743,297746,0,3,5
85036,5,1,297748,297748,297749,0,1,2
85037,1,1,297749,297749,297750,0,1,0
85038,5,1,297754,297754,297755,0,1,4
85039,6,2,297760,297760,297762,0,2,5
85040,1,3,297761,297762,297765,1,4,0
85041,2,2,297763,297765,297767,2,4,0
85042,1,2,297764,297767,297769,3,5,0
85043,3,1,297767,297769,297770,2,3,0
85044,5,2,297772,297772,297774,0,2,2
85045,4,2,297776,297776,297778,0,2,2
85046,2,3,297778,297778,297781,0,3,0
85047,4,2,297782,297782,297784,0,2,1
85048,3,2,297785,297785,297787,0,2,1
85049,1,2,297786,297787,297789,1,3,0
85050,3,3,297789,297789,297792,0,3,0
85051,2,1,297791,297792,297793,1,2,0
85052,1,1,297792,297793,297794,1,2,0
85053,4,1,297796,297796,297797,0,1,2
85054,3,1,297799,297799,297800,0,1,2
85055,1,2,297800,297800,297802,0,2,0
85056,1,3,297801,297802,297805,1,4,0
85057,2,2,297803,297805,297807,2,4,0
85058,3,1,297806,297807,297808,1,2,0
85059,2,3,297808,297808,297811,0,3,0
85060,5,1,297813,297813,297814,0,1,2
85061,1,1,297814,297814,297815,0,1,0
85062,3,2,297817,297817,297819,0,2,2
85063,3,3,297820,297820,297823,0,3,1
85064,3,1,297823,297823,297824,0,1,0
85065,3,3,297826,297826,297829,0,3,2
85066,5,1,297831,297831,297832,0,1,2
85067,1,1,297832,297832,297833,0,1,0
85068,6,2,297838,297838,297840,0,2,5
85069,2,3,297840,297840,297843,0,3,0
85070,6,2,297846,297846,297848,0,2,3
85071,6,1,297852,297852,297853,0,1,4
85072,4,3,297856,297856,297859,0,3,3
85073,3,2,297859,297859,297861,0,2,0
85074,2,1,297861,297861,297862,0,1,0
85075,1,1,297862,297862,297863,0,1,0
85076,4,2,297866,297866,297868,0,2,3
85077,2,1,297868,297868,297869,0,1,0
85078,2,1,297870,297870,297871,0,1,1
85079,2,1,297872,297872,297873,0,1,1
85080,5,1,297877,297877,297878,0,1,4
85081,3,3,297880,297880,297883,0,3,2
85082,2,1,297882,297883,297884,1,2,0
85083,3,3,297885,297885,297888,0,3,1
85084,3,1,297888,297888,297889,0,1,0
85085,2,2,297890,297890,297892,0,2,1
85086,2,1,297892,297892,297893,0,1,0
85087,5,1,297897,297897,297898,0,1,4
85088,1,1,297898,297898,297899,0,1,0
85089,3,3,297901,297901,297904,0,3,2
85090,4,3,297905,297905,297908,0,3,1
85091,2,1,297907,297908,297909,1,2,0
85092,3,2,297910,297910,297912,0,2,1
85093,3,2,297913,297913,297915,0,2,1
85094,2,2,297915,297915,297917,0,2,0
85095,6,2,297921,297921,297923,0,2,4
85096,5,1,297926,297926,297927,0,1,3
85097,1,2,297927,297927,297929,0,2,0
85098,2,3,297929,297929,297932,0,3,0
85099,6,3,297935,297935,297938,0,3,3
85100,6,2,297941,297941,297943,0,2,3
85101,5,1,297946,297946,297947,0,1,3
85102,5,3,297951,297951,297954,0,3,4
85103,3,2,297954,297954,297956,0,2,0
85104,2,1,297956,297956,297957,0,1,0
85105,4,1,297960,297960,297961,0,1,3
85106,4,2,297964,297964,297966,0,2,3
85107,5,2,297969,297969,297971,0,2,3
85108,5,3,297974,297974,297977,0,3,3
85109,2,1,297976,297977,297978,1,2,0
85110,2,2,297978,297978,297980,0,2,0
85111,3,3,297981,297981,297984,0,3,1
85112,4,3,297985,297985,297988,0,3,1
85113,4,2,297989,297989,297991,0,2,1
85114,3,2,297992,297992,297994,0,2,1
85115,3,1,297995,297995,297996,0,1,1
85116,4,3,297999,297999,298002,0,3,3
85117,6,1,298005,298005,298006,0,1,3
85118,5,1,298010,298010,298011,0,1,4
85119,4,3,298014,298014,298017,0,3,3
85120,6,1,298020,298020,298021,0,1,3
85121,6,2,298026,298026,298028,0,2,5
85122,4,2,298030,298030,298032,0,2,2
85123,6,2,298036,298036,298038,0,2,4
85124,1,3,298037,298038,298041,1,4,0
85125,3,3,298040,298041,298044,1,4,0
85126,3,1,298043,298044,298045,1,2,0
85127,5,1,298048,298048,298049,0,1,3
85128,5,1,298053,298053,298054,0,1,4
85129,1,1,298054,298054,298055,0,1,0
85130,6,1,298060,298060,298061,0,1,5
85131,1,3,298061,298061,298064,0,3,0
85132,2,1,298063,298064,298065,1,2,0
85133,2,2,298065,298065,298067,0,2,0
85134,3,1,298068,298068,298069,0,1,1
85135,1,1,298069,298069,298070,0,1,0
85136,1,1,298070,298070,298071,0,1,0
85137,6,3,298076,298076,298079,0,3,5
85138,5,1,298081,298081,298082,0,1,2
85139,6,3,298087,298087,298090,0,3,5
85140,5,3,298092,298092,298095,0,3,2
85141,6,1,298098,298098,298099,0,1,3
85142,5,2,298103,298103,298105,0,2,4
85143,2,2,298105,298105,298107,0,2,0
85144,1,1,298106,298107,298108,1,2,0
85145,5,1,298111,298111,298112,0,1,3
85146,5,1,298116,298116,298117,0,1,4
85147,1,3,298117,298117,298120,0,3,0
85148,5,1,298122,298122,298123,0,1,2
85149,2,1,298124,298124,298125,0,1,1
85150,1,3,298125,298125,298128,0,3,0
85151,4,3,298129,298129,298132,0,3,1
85152,6,3,298135,298135,298138,0,3,3
85153,5,2,298140,298140,298142,0,2,2
85154,6,3,298146,298146,298149,0,3,4
85155,6,3,298152,298152,298155,0,3,3
85156,4,1,298156,298156,298157,0,1,1
85157,3,2,298159,298159,298161,0,2,2
85158,6,2,298165,298165,298167,0,2,4
85159,3,3,298168,298168,298171,0,3,1
85160,4,2,298172,298172,298174,0,2,1
85161,6,2,298178,298178,298180,0,2,4
85162,3,3,298181,298181,298184,0,3,1
85163,2,1,298183,298184,298185,1,2,0
85164,3,1,298186,298186,298187,0,1,1
85165,4,1,298190,298190,298191,0,1,3
85166,5,1,298195,298195,298196,0,1,4
85167,4,2,298199,298199,298201,0,2,3
85168,1,2,298200,298201,298203,1,3,0
85169,6,3,298206,298206,298209,0,3,3
85170,4,1,298210,298210,298211,0,1,1
85171,6,1,298216,298216,298217,0,1,5
85172,4,1,298220,298220,298221,0,1,3
85173,2,1,298222,298222,298223,0,1,1
85174,4,3,298226,298226,298229,0,3,3
85175,4,1,298230,298230,298231,0,1,1
85176,2,2,298232,298232,298234,0,2,1
85177,6,1,298238,298238,298239,0,1,4
85178,5,1,298243,298243,298244,0,1,4
85179,3,2,298246,298246,298248,0,2,2
85180,3,3,298249,298249,298252,0,3,1
85181,4,1,298253,298253,298254,0,1,1
85182,3,1,298256,298256,298257,0,1,2
85183,3,2,298259,298259,298261,0,2,2
85184,5,3,298264,298264,298267,0,3,3
85185,3,2,298267,298267,298269,0,2,0
85186,2,1,298269,298269,298270,0,1,0
85187,6,1,298275,298275,298276,0,1,5
85188,2,2,298277,298277,298279,0,2,1
85189,5,2,298282,298282,298284,0,2,3
85190,5,3,298287,298287,298290,0,3,3
85191,2,2,298289,298290,298292,1,3,0
85192,3,1,298292,298292,298293,0,1,0
85193,6,3,298298,298298,298301,0,3,5
85194,4,1,298302,298302,298303,0,1,1
85195,3,3,298305,298305,298308,0,3,2
85196,2,1,298307,298308,298309,1,2,0
85197,2,3,298309,298309,298312,0,3,0
85198,6,1,298315,298315,298316,0,1,3
85199,5,3,298320,298320,298323,0,3,4
85200,5,3,298325,298325,298328,0,3,2
85201,1,2,298326,298328,298330,2,4,0
85202,2,2,298328,298330,298332,2,4,0
85203,5,1,298333,298333,298334,0,1,1
85204,4,2,298337,298337,298339,0,2,3
85205,4,1,298341,298341,298342,0,1,2
85206,4,1,298345,298345,298346,0,1,3
85207,1,2,298346,298346,298348,0,2,0
85208,4,1,298350,298350,298351,0,1,2
85209,3,3,298353,298353,298356,0,3,2
85210,2,3,298355,298356,298359,1,4,0
85211,2,1,298357,298359,298360,2,3,0
85212,5,1,298362,298362,298363,0,1,2
85213,1,2,298363,298363,298365,0,2,0
85214,4,2,298367,298367,298369,0,2,2
85215,1,3,298368,298369,298372,1,4,0
85216,2,1,298370,298372,298373,2,3,0
85217,5,3,298375,298375,298378,0,3,2
85218,1,3,298376,298378,298381,2,5,0
85219,6,1,298382,298382,298383,0,1,1
85220,6,3,298388,298388,298391,0,3,5
85221,5,1,298393,298393,298394,0,1,2
85222,4,2,298397,298397,298399,0,2,3
85223,4,2,298401,298401,298403,0,2,2
85224,5,1,298406,298406,298407,0,1,3
85225,3,2,298409,298409,298411,0,2,2
85226,4,2,298413,298413,298415,0,2,2
85227,5,1,298418,298418,298419,0,1,3
85228,2,1,298420,298420,298421,0,1,1
85229,4,1,298424,298424,298425,0,1,3
85230,3,3,298427,298427,298430,0,3,2
85231,1,3,298428,298430,298433,2,5,0
85232,5,2,298433,298433,298435,0,2,0
85233,2,1,298435,298435,298436,0,1,0
85234,3,1,298438,298438,298439,0,1,2
85235,5,3,298443,298443,298446,0,3,4
85236,5,3,298448,298448,298451,0,3,2
85237,1,3,298449,298451,298454,2,5,0
85238,1,2,298450,298454,298456,4,6,0
85239,1,2,298451,298456,298458,5,7,0
85240,5,1,298456,298458,298459,2,3,0
85241,4,3,298460,298460,298463,0,3,1
85242,6,3,298466,298466,298469,0,3,3
85243,3,1,298469,298469,298470,0,1,0
85244,6,1,298475,298475,298476,0,1,5
85245,2,3,298477,298477,298480,0,3,1
85246,3,1,298480,298480,298481,0,1,0
85247,1,1,298481,298481,298482,0,1,0
85248,3,2,298484,298484,298486,0,2,2
85249,3,1,298487,298487,298488,0,1,1
85250,3,1,298490,298490,298491,0,1,2
85251,2,2,298492,298492,298494,0,2,1
85252,5,2,298497,298497,298499,0,2,3
85253,2,1,298499,298499,298500,0,1,0
85254,6,3,298505,298505,298508,0,3,5
85255,5,1,298510,298510,298511,0,1,2
85256,3,1,298513,298513,298514,0,1,2
85257,1,3,298514,298514,298517,0,3,0
85258,3,3,298517,298517,298520,0,3,0
85259,5,3,298522,298522,298525,0,3,2
85260,1,3,298523,298525,298528,2,5,0
85261,3,3,298526,298528,298531,2,5,0
85262,6,1,298532,298532,298533,0,1,1
85263,3,3,298535,298535,298538,0,3,2
85264,2,3,298537,298538,298541,1,4,0
85265,3,1,298540,298541,298542,1,2,0
85266,6,1,298546,298546,298547,0,1,4
85267,3,3,298549,298549,298552,0,3,2
85268,5,3,298554,298554,298557,0,3,2
85269,3,2,298557,298557,298559,0,2,0
85270,1,3,298558,298559,298562,1,4,0
85271,2,3,298560,298562,298565,2,5,0
85272,6,2,298566,298566,298568,0,2,1
85273,3,2,298569,298569,298571,0,2,1
85274,4,1,298573,298573,298574,0,1,2
85275,1,1,298574,298574,298575,0,1,0
85276,2,1,298576,298576,298577,0,1,1
85277,1,3,298577,298577,298580,0,3,0
85278,3,1,298580,298580,298581,0,1,0
85279,4,1,298584,298584,298585,0,1,3
85280,3,3,298587,298587,298590,0,3,2
85281,3,2,298590,298590,298592,0,2,0
85282,3,1,298593,298593,298594,0,1,1
85283,2,2,298595,298595,298597,0,2,1
85284,1,1,298596,298597,298598,1,2,0
85285,5,2,298601,298601,298603,0,2,3
85286,6,1,298607,298607,298608,0,1,4
85287,5,2,298612,298612,298614,0,2,4
85288,4,3,298616,298616,298619,0,3,2
85289,1,3,298617,298619,298622,2,5,0
85290,4,1,298621,298622,298623,1,2,0
85291,2,1,298623,298623,298624,0,1,0
85292,5,2,298628,298628,298630,0,2,4
85293,6,3,298634,298634,298637,0,3,4
85294,5,2,298639,298639,298641,0,2,2
85295,2,1,298641,298641,298642,0,1,0
85296,2,2,298643,298643,298645,0,2,1
85297,2,3,298645,298645,298648,0,3,0
85298,1,2,298646,298648,298650,2,4,0
85299,5,2,298651,298651,298653,0,2,1
85300,6,2,298657,298657,298659,0,2,4
85301,6,1,298663,298663,298664,0,1,4
85302,2,3,298665,298665,298668,0,3,1
85303,4,3,298669,298669,298672,0,3,1
85304,5,1,298674,298674,298675,0,1,2
85305,3,1,298677,298677,298678,0,1,2
85306,5,1,298682,298682,298683,0,1,4
85307,3,3,298685,298685,298688,0,3,2
85308,1,2,298686,298688,298690,2,4,0
85309,1,3,298687,298690,298693,3,6,0
85310,6,1,298693,298693,298694,0,1,0
85311,6,1,298699,298699,298700,0,1,5
85312,5,2,298704,298704,298706,0,2,4
85313,3,2,298707,298707,298709,0,2,1
85314,2,2,298709,298709,298711,0,2,0
85315,4,2,298713,298713,298715,0,2,2
85316,2,3,298715,298715,298718,0,3,0
85317,4,2,298719,298719,298721,0,2,1
85318,2,1,298721,298721,298722,0,1,0
85319,5,2,298726,298726,298728,0,2,4
85320,2,1,298728,298728,298729,0,1,0
85321,6,3,298734,298734,298737,0,3,5
85322,2,2,298736,298737,298739,1,3,0
85323,6,1,298742,298742,298743,0,1,3
85324,6,2,298748,298748,298750,0,2,5
85325,2,2,298750,298750,298752,0,2,0
85326,5,2,298755,298755,298757,0,2,3
85327,5,1,298760,298760,298761,0,1,3
85328,2,1,298762,298762,298763,0,1,1
85329,3,1,298765,298765,298766,0,1,2
85330,4,1,298769,298769,298770,0,1,3
85331,2,2,298771,298771,298773,0,2,1
85332,5,2,298776,298776,298778,0,2,3
85333,1,2,298777,298778,298780,1,3,0
85334,2,2,298779,298780,298782,1,3,0
85335,2,2,298781,298782,298784,1,3,0
85336,6,1,298787,298787,298788,0,1,3
85337,1,3,298788,298788,298791,0,3,0
85338,2,3,298790,298791,298794,1,4,0
85339,3,1,298793,298794,298795,1,2,0
85340,6,3,298799,298799,298802,0,3,4
85341,5,2,298804,298804,298806,0,2,2
85342,3,2,298807,298807,298809,0,2,1
85343,1,2,298808,298809,298811,1,3,0
85344,4,2,298812,298812,298814,0,2,1
85345,5,3,298817,298817,298820,0,3,3
85346,3,2,298820,298820,298822,0,2,0
85347,4,2,298824,298824,298826,0,2,2
85348,5,3,298829,298829,298832,0,3,3
85349,6,3,298835,298835,298838,0,3,3
85350,6,2,298841,298841,298843,0,2,3
85351,2,3,298843,298843,298846,0,3,0
85352,4,3,298847,298847,298850,0,3,1
85353,3,1,298850,298850,298851,0,1,0
85354,6,2,298856,298856,298858,0,2,5
85355,6,3,298862,298862,298865,0,3,4
85356,1,1,298863,298865,298866,2,3,0
85357,6,3,298869,298869,298872,0,3,3
85358,2,1,298871,298872,298873,1,2,0
85359,2,3,298873,298873,298876,0,3,0
85360,1,3,298874,298876,298879,2,5,0
85361,2,3,298876,298879,298882,3,6,0
85362,5,2,298881,298882,298884,1,3,0
85363,3,3,298884,298884,298887,0,3,0
85364,3,3,298887,298887,298890,0,3,0
85365,3,2,298890,298890,298892,0,2,0
85366,5,1,298895,298895,298896,0,1,3
85367,1,2,298896,298896,298898,0,2,0
85368,4,2,298900,298900,298902,0,2,2
85369,3,3,298903,298903,298906,0,3,1
85370,3,2,298906,298906,298908,0,2,0
85371,1,1,298907,298908,298909,1,2,0
85372,2,2,298909,298909,298911,0,2,0
85373,3,2,298912,298912,298914,0,2,1
85374,1,3,298913,298914,298917,1,4,0
85375,4,1,298917,298917,298918,0,1,0
85376,2,1,298919,298919,298920,0,1,1
85377,3,3,298922,298922,298925,0,3,2
85378,4,2,298926,298926,298928,0,2,1
85379,2,1,298928,298928,298929,0,1,0
85380,3,3,298931,298931,298934,0,3,2
85381,5,1,298936,298936,298937,0,1,2
85382,2,1,298938,298938,298939,0,1,1
85383,2,2,298940,298940,298942,0,2,1
85384,3,3,298943,298943,298946,0,3,1
85385,5,2,298948,298948,298950,0,2,2
85386,5,1,298953,298953,298954,0,1,3
85387,4,2,298957,298957,298959,0,2,3
85388,6,3,298963,298963,298966,0,3,4
85389,2,1,298965,298966,298967,1,2,0
85390,1,1,298966,298967,298968,1,2,0
85391,2,2,298968,298968,298970,0,2,0
85392,1,3,298969,298970,298973,1,4,0
85393,2,1,298971,298973,298974,2,3,0
85394,3,3,298974,298974,298977,0,3,0
85395,2,2,298976,298977,298979,1,3,0
85396,2,2,298978,298979,298981,1,3,0
85397,4,2,298982,298982,298984,0,2,1
85398,4,2,298986,298986,298988,0,2,2
85399,3,3,298989,298989,298992,0,3,1
85400,6,2,298995,298995,298997,0,2,3
85401,4,3,298999,298999,299002,0,3,2
85402,1,3,299000,299002,299005,2,5,0
85403,2,3,299002,299005,299008,3,6,0
85404,2,2,299004,299008,299010,4,6,0
85405,6,2,299010,299010,299012,0,2,0
85406,3,3,299013,299013,299016,0,3,1
85407,5,3,299018,299018,299021,0,3,2
85408,5,1,299023,299023,299024,0,1,2
85409,3,3,299026,299026,299029,0,3,2
85410,3,1,299029,299029,299030,0,1,0
85411,5,3,299034,299034,299037,0,3,4
85412,5,3,299039,299039,299042,0,3,2
85413,3,3,299042,299042,299045,0,3,0
85414,4,3,299046,299046,299049,0,3,1
85415,2,1,299048,299049,299050,1,2,0
85416,2,3,299050,299050,299053,0,3,0
85417,2,2,299052,299053,299055,1,3,0
85418,2,2,299054,299055,299057,1,3,0
85419,1,2,299055,299057,299059,2,4,0
85420,6,1,299061,299061,299062,0,1,2
85421,1,3,299062,299062,299065,0,3,0
85422,3,2,299065,299065,299067,0,2,0
85423,2,3,299067,299067,299070,0,3,0
85424,3,3,299070,299070,299073,0,3,0
85425,5,1,299075,299075,299076,0,1,2
85426,3,3,299078,299078,299081,0,3,2
85427,2,2,299080,299081,299083,1,3,0
85428,2,1,299082,299083,299084,1,2,0
85429,1,3,299083,299084,299087,1,4,0
85430,5,1,299088,299088,299089,0,1,1
85431,3,3,299091,299091,299094,0,3,2
85432,5,1,299096,299096,299097,0,1,2
85433,1,3,299097,299097,299100,0,3,0
85434,3,1,299100,299100,299101,0,1,0
85435,1,2,299101,299101,299103,0,2,0
85436,5,3,299106,299106,299109,0,3,3
85437,6,1,299112,299112,299113,0,1,3
85438,3,1,299115,299115,299116,0,1,2
85439,6,2,299121,299121,299123,0,2,5
85440,5,2,299126,299126,299128,0,2,3
85441,1,2,299127,299128,299130,1,3,0
85442,5,3,299132,299132,299135,0,3,2
85443,4,3,299136,299136,299139,0,3,1
85444,6,2,299142,299142,299144,0,2,3
85445,2,3,299144,299144,299147,0,3,0
85446,2,3,299146,299147,299150,1,4,0
85447,6,3,299152,299152,299155,0,3,2
85448,4,2,299156,299156,299158,0,2,1
85449,3,1,299159,299159,299160,0,1,1
85450,6,2,299165,299165,299167,0,2,5
85451,4,2,299169,299169,299171,0,2,2
85452,2,3,299171,299171,299174,0,3,0
85453,5,2,299176,299176,299178,0,2,2
85454,5,1,299181,299181,299182,0,1,3
85455,4,3,299185,299185,299188,0,3,3
85456,3,3,299188,299188,299191,0,3,0
85457,6,2,299194,299194,299196,0,2,3
85458,5,2,299199,299199,299201,0,2,3
85459,2,3,299201,299201,299204,0,3,0
85460,1,3,299202,299204,299207,2,5,0
85461,2,3,299204,299207,299210,3,6,0
85462,4,2,299208,299210,299212,2,4,0
85463,2,2,299210,299212,299214,2,4,0
85464,2,3,299212,299214,299217,2,5,0
85465,2,3,299214,299217,299220,3,6,0
85466,2,1,299216,299220,299221,4,5,0
85467,5,2,299221,299221,299223,0,2,0
85468,1,1,299222,299223,299224,1,2,0
85469,2,3,299224,299224,299227,0,3,0
85470,5,3,299229,299229,299232,0,3,2
85471,5,1,299234,299234,299235,0,1,2
85472,3,2,299237,299237,299239,0,2,2
85473,4,3,299241,299241,299244,0,3,2
85474,1,1,299242,299244,299245,2,3,0
85475,4,1,299246,299246,299247,0,1,1
85476,2,2,299248,299248,299250,0,2,1
85477,4,3,299252,299252,299255,0,3,2
85478,5,2,299257,299257,299259,0,2,2
85479,2,1,299259,299259,299260,0,1,0
85480,2,3,299261,299261,299264,0,3,1
85481,4,3,299265,299265,299268,0,3,1
85482,6,2,299271,299271,299273,0,2,3
85483,3,2,299274,299274,299276,0,2,1
85484,1,1,299275,299276,299277,1,2,0
85485,5,2,299280,299280,299282,0,2,3
85486,4,2,299284,299284,299286,0,2,2
85487,5,2,299289,299289,299291,0,2,3
85488,3,3,299292,299292,299295,0,3,1
85489,2,1,299294,299295,299296,1,2,0
85490,6,2,299300,299300,299302,0,2,4
85491,5,3,299305,299305,299308,0,3,3
85492,6,1,299311,299311,299312,0,1,3
85493,2,3,299313,299313,299316,0,3,1
85494,5,1,299318,299318,299319,0,1,2
85495,2,3,299320,299320,299323,0,3,1
85496,6,1,299326,299326,299327,0,1,3
85497,1,1,299327,299327,299328,0,1,0
85498,2,2,299329,299329,299331,0,2,1
85499,2,2,299331,299331,299333,0,2,0
85500,1,3,299332,299333,299336,1,4,0
85501,3,1,299335,299336,299337,1,2,0
85502,4,2,299339,299339,299341,0,2,2
85503,2,1,299341,299341,299342,0,1,0
85504,1,2,299342,299342,299344,0,2,0
85505,4,1,299346,299346,299347,0,1,2
85506,1,2,299347,299347,299349,0,2,0
85507,2,3,299349,299349,299352,0,3,0
85508,1,3,299350,299352,299355,2,5,0
85509,3,2,299353,299355,299357,2,4,0
85510,1,1,299354,299357,299358,3,4,0
85511,4,3,299358,299358,299361,0,3,0
85512,1,2,299359,299361,299363,2,4,0
85513,5,3,299364,299364,299367,0,3,1
85514,6,2,299370,299370,299372,0,2,3
85515,1,2,299371,299372,299374,1,3,0
85516,5,2,299376,299376,299378,0,2,2
85517,4,2,299380,299380,299382,0,2,2
85518,4,2,299384,299384,299386,0,2,2
85519,5,1,299389,299389,299390,0,1,3
85520,2,1,299391,299391,299392,0,1,1
85521,1,2,299392,299392,299394,0,2,0
85522,3,1,299395,299395,299396,0,1,1
85523,3,1,299398,299398,299399,0,1,2
85524,6,1,299404,299404,299405,0,1,5
85525,5,3,299409,299409,299412,0,3,4
85526,1,2,299410,299412,299414,2,4,0
85527,5,1,299415,299415,299416,0,1,1
85528,4,2,299419,299419,299421,0,2,3
85529,3,3,299422,299422,299425,0,3,1
85530,2,1,299424,299425,299426,1,2,0
85531,3,3,299427,299427,299430,0,3,1
85532,4,1,299431,299431,299432,0,1,1
85533,1,2,299432,299432,299434,0,2,0
85534,6,2,299438,299438,299440,0,2,4
85535,3,1,299441,299441,299442,0,1,1
85536,4,2,299445,299445,299447,0,2,3
85537,3,3,299448,299448,299451,0,3,1
85538,5,3,299453,299453,299456,0,3,2
85539,3,2,299456,299456,299458,0,2,0
85540,5,3,299461,299461,299464,0,3,3
85541,5,2,299466,299466,299468,0,2,2
85542,5,1,299471,299471,299472,0,1,3
85543,1,1,299472,299472,299473,0,1,0
85544,3,3,299475,299475,299478,0,3,2
85545,2,3,299477,299478,299481,1,4,0
85546,3,1,299480,299481,299482,1,2,0
85547,5,2,299485,299485,299487,0,2,3
85548,4,1,299489,299489,299490,0,1,2
85549,2,1,299491,299491,299492,0,1,1
85550,1,1,299492,299492,299493,0,1,0
85551,4,1,299496,299496,299497,0,1,3
85552,4,1,299500,299500,299501,0,1,3
85553,3,2,299503,299503,299505,0,2,2
85554,1,1,299504,299505,299506,1,2,0
85555,4,1,299508,299508,299509,0,1,2
85556,5,2,299513,299513,299515,0,2,4
85557,4,1,299517,299517,299518,0,1,2
85558,6,3,299523,299523,299526,0,3,5
85559,2,2,299525,299526,299528,1,3,0
85560,1,3,299526,299528,299531,2,5,0
85561,3,1,299529,299531,299532,2,3,0
85562,5,1,299534,299534,299535,0,1,2
85563,4,1,299538,299538,299539,0,1,3
85564,2,3,299540,299540,299543,0,3,1
85565,1,2,299541,299543,299545,2,4,0
85566,6,3,299547,299547,299550,0,3,2
85567,4,1,299551,299551,299552,0,1,1
85568,1,1,299552,299552,299553,0,1,0
85569,2,1,299554,299554,299555,0,1,1
85570,5,2,299559,299559,299561,0,2,4
85571,2,3,299561,299561,299564,0,3,0
85572,4,1,299565,299565,299566,0,1,1
85573,5,1,299570,299570,299571,0,1,4
85574,2,3,299572,299572,299575,0,3,1
85575,6,2,299578,299578,299580,0,2,3
85576,1,2,299579,299580,299582,1,3,0
85577,3,1,299582,299582,299583,0,1,0
85578,3,1,299585,299585,299586,0,1,2
85579,3,1,299588,299588,299589,0,1,2
85580,5,2,299593,299593,299595,0,2,4
85581,1,1,299594,299595,299596,1,2,0
85582,3,1,299597,299597,299598,0,1,1
85583,4,1,299601,299601,299602,0,1,3
85584,5,2,299606,299606,299608,0,2,4
85585,2,2,299608,299608,299610,0,2,0
85586,5,3,299613,299613,299616,0,3,3
85587,6,3,299619,299619,299622,0,3,3
85588,2,3,299621,299622,299625,1,4,0
85589,5,2,299626,299626,299628,0,2,1
85590,2,2,299628,299628,299630,0,2,0
85591,4,3,299632,299632,299635,0,3,2
85592,5,1,299637,299637,299638,0,1,2
85593,2,2,299639,299639,299641,0,2,1
85594,3,1,299642,299642,299643,0,1,1
85595,1,1,299643,299643,299644,0,1,0
85596,6,1,299649,299649,299650,0,1,5
85597,3,1,299652,299652,299653,0,1,2
85598,1,1,299653,299653,299654,0,1,0
85599,1,1,299654,299654,299655,0,1,0
85600,2,3,299656,299656,299659,0,3,1
85601,2,2,299658,299659,299661,1,3,0
85602,1,2,299659,299661,299663,2,4,0
85603,2,1,299661,299663,299664,2,3,0
85604,4,3,299665,299665,299668,0,3,1
85605,4,1,299669,299669,299670,0,1,1
85606,5,3,299674,299674,299677,0,3,4
85607,2,1,299676,299677,299678,1,2,0
85608,1,2,299677,299678,299680,1,3,0
85609,1,2,299678,299680,299682,2,4,0
85610,2,1,299680,299682,299683,2,3,0
85611,4,3,299684,299684,299687,0,3,1
85612,2,1,299686,299687,299688,1,2,0
85613,3,2,299689,299689,299691,0,2,1
85614,1,1,299690,299691,299692,1,2,0
85615,4,2,299694,299694,299696,0,2,2
85616,6,2,299700,299700,299702,0,2,4
85617,2,2,299702,299702,299704,0,2,0
85618,1,1,299703,299704,299705,1,2,0
85619,5,1,299708,299708,299709,0,1,3
85620,6,2,299714,299714,299716,0,2,5
85621,1,2,299715,299716,299718,1,3,0
85622,3,2,299718,299718,299720,0,2,0
85623,5,1,299723,299723,299724,0,1,3
85624,5,3,299728,299728,299731,0,3,4
85625,6,3,299734,299734,299737,0,3,3
85626,4,3,299738,299738,299741,0,3,1
85627,4,2,299742,299742,299744,0,2,1
85628,6,2,299748,299748,299750,0,2,4
85629,2,2,299750,299750,299752,0,2,0
85630,5,2,299755,299755,299757,0,2,3
85631,3,2,299758,299758,299760,0,2,1
85632,1,2,299759,299760,299762,1,3,0
85633,6,3,299765,299765,299768,0,3,3
85634,1,2,299766,299768,299770,2,4,0
85635,5,1,299771,299771,299772,0,1,1
85636,4,1,299775,299775,299776,0,1,3
85637,2,3,299777,299777,299780,0,3,1
85638,5,3,299782,299782,299785,0,3,2
85639,3,1,299785,299785,299786,0,1,0
85640,4,2,299789,299789,299791,0,2,3
85641,2,1,299791,299791,299792,0,1,0
85642,6,1,299797,299797,299798,0,1,5
85643,3,2,299800,299800,299802,0,2,2
85644,5,3,299805,299805,299808,0,3,3
85645,1,1,299806,299808,299809,2,3,0
85646,1,3,299807,299809,299812,2,5,0
85647,3,3,299810,299812,299815,2,5,0
85648,3,1,299813,299815,299816,2,3,0
85649,3,2,299816,299816,299818,0,2,0
85650,4,2,299820,299820,299822,0,2,2
85651,4,3,299824,299824,299827,0,3,2
85652,3,1,299827,299827,299828,0,1,0
85653,6,1,299833,299833,299834,0,1,5
85654,4,1,299837,299837,299838,0,1,3
85655,5,1,299842,299842,299843,0,1,4
85656,3,3,299845,299845,299848,0,3,2
85657,5,2,299850,299850,299852,0,2,2
85658,2,3,299852,299852,299855,0,3,0
85659,2,2,299854,299855,299857,1,3,0
85660,6,2,299860,299860,299862,0,2,3
85661,1,3,299861,299862,299865,1,4,0
85662,4,1,299865,299865,299866,0,1,0
85663,1,2,299866,299866,299868,0,2,0
85664,6,1,299872,299872,299873,0,1,4
85665,4,3,299876,299876,299879,0,3,3
85666,1,1,299877,299879,299880,2,3,0
85667,2,1,299879,299880,299881,1,2,0
85668,2,3,299881,299881,299884,0,3,0
85669,6,2,299887,299887,299889,0,2,3
85670,2,1,299889,299889,299890,0,1,0
85671,3,3,299892,299892,299895,0,3,2
85672,6,1,299898,299898,299899,0,1,3
85673,2,3,299900,299900,299903,0,3,1
85674,6,1,299906,299906,299907,0,1,3
85675,5,2,299911,299911,299913,0,2,4
85676,3,2,299914,299914,299916,0,2,1
85677,1,2,299915,299916,299918,1,3,0
85678,6,1,299921,299921,299922,0,1,3
85679,2,1,299923,299923,299924,0,1,1
85680,4,3,299927,299927,299930,0,3,3
85681,1,2,299928,299930,299932,2,4,0
85682,6,3,299934,299934,299937,0,3,2
85683,4,1,299938,299938,299939,0,1,1
85684,4,2,299942,299942,299944,0,2,3
85685,3,3,299945,299945,299948,0,3,1
85686,4,2,299949,299949,299951,0,2,1
85687,4,2,299953,299953,299955,0,2,2
85688,5,2,299958,299958,299960,0,2,3
85689,5,3,299963,299963,299966,0,3,3
85690,1,3,299964,299966,299969,2,5,0
85691,2,3,299966,299969,299972,3,6,0
85692,6,2,299972,299972,299974,0,2,0
85693,5,1,299977,299977,299978,0,1,3
85694,5,2,299982,299982,299984,0,2,4
85695,4,2,299986,299986,299988,0,2,2
85696,6,2,299992,299992,299994,0,2,4
85697,3,3,299995,299995,299998,0,3,1
85698,2,1,299997,299998,299999,1,2,0
85699,3,3,300000,300000,300003,0,3,1
85700,4,3,300004,300004,300007,0,3,1
85701,2,1,300006,300007,300008,1,2,0
85702,5,1,300011,300011,300012,0,1,3
85703,4,3,300015,300015,300018,0,3,3
85704,2,3,300017,300018,300021,1,4,0
85705,2,1,300019,300021,300022,2,3,0
85706,3,1,300022,300022,300023,0,1,0
85707,6,2,300028,300028,300030,0,2,5
85708,2,1,300030,300030,300031,0,1,0
85709,6,2,300036,300036,300038,0,2,5
85710,3,1,300039,300039,300040,0,1,1
85711,4,2,300043,300043,300045,0,2,3
85712,3,3,300046,300046,300049,0,3,1
85713,2,2,300048,300049,300051,1,3,0
85714,2,2,300050,300051,300053,1,3,0
85715,3,2,300053,300053,300055,0,2,0
85716,1,1,300054,300055,300056,1,2,0
85717,3,1,300057,300057,300058,0,1,1
85718,6,1,300063,300063,300064,0,1,5
85719,4,3,300067,300067,300070,0,3,3
85720,6,3,300073,300073,300076,0,3,3
85721,6,2,300079,300079,300081,0,2,3
85722,5,3,300084,300084,300087,0,3,3
85723,2,3,300086,300087,300090,1,4,0
85724,2,1,300088,300090,300091,2,3,0
85725,6,1,300094,300094,300095,0,1,3
85726,5,3,300099,300099,300102,0,3,4
85727,5,2,300104,300104,300106,0,2,2
85728,1,3,300105,300106,300109,1,4,0
85729,3,2,300108,300109,300111,1,3,0
85730,3,3,300111,300111,300114,0,3,0
85731,1,2,300112,300114,300116,2,4,0
85732,5,1,300117,300117,300118,0,1,1
85733,2,2,300119,300119,300121,0,2,1
85734,2,2,300121,300121,300123,0,2,0
85735,1,1,300122,300123,300124,1,2,0
85736,1,2,300123,300124,300126,1,3,0
85737,2,3,300125,300126,300129,1,4,0
85738,2,1,300127,300129,300130,2,3,0
85739,1,1,300128,300130,300131,2,3,0
85740,6,1,300134,300134,300135,0,1,3
85741,3,1,300137,300137,300138,0,1,2
85742,5,1,300142,300142,300143,0,1,4
85743,6,2,300148,300148,300150,0,2,5
85744,6,3,300154,300154,300157,0,3,4
85745,3,1,300157,300157,300158,0,1,0
85746,5,1,300162,300162,300163,0,1,4
85747,4,3,300166,300166,300169,0,3,3
85748,6,2,300172,300172,300174,0,2,3
85749,6,1,300178,300178,300179,0,1,4
85750,2,2,300180,300180,300182,0,2,1
85751,3,2,300183,300183,300185,0,2,1
85752,6,3,300189,300189,300192,0,3,4
85753,4,2,300193,300193,300195,0,2,1
85754,5,1,300198,300198,300199,0,1,3
85755,5,2,300203,300203,300205,0,2,4
85756,3,3,300206,300206,300209,0,3,1
85757,1,2,300207,300209,300211,2,4,0
85758,5,2,300212,300212,300214,0,2,1
85759,1,2,300213,300214,300216,1,3,0
85760,6,1,300219,300219,300220,0,1,3
85761,5,1,300224,300224,300225,0,1,4
85762,5,3,300229,300229,300232,0,3,4
85763,2,2,300231,300232,300234,1,3,0
85764,3,2,300234,300234,300236,0,2,0
85765,3,2,300237,300237,300239,0,2,1
85766,4,2,300241,300241,300243,0,2,2
85767,6,2,300247,300247,300249,0,2,4
85768,4,2,300251,300251,300253,0,2,2
85769,3,3,300254,300254,300257,0,3,1
85770,5,2,300259,300259,300261,0,2,2
85771,3,1,300262,300262,300263,0,1,1
85772,4,1,300266,300266,300267,0,1,3
85773,3,3,300269,300269,300272,0,3,2
85774,6,2,300275,300275,300277,0,2,3
85775,2,3,300277,300277,300280,0,3,0
85776,6,3,300283,300283,300286,0,3,3
85777,5,2,300288,300288,300290,0,2,2
85778,4,3,300292,300292,300295,0,3,2
85779,1,3,300293,300295,300298,2,5,0
85780,3,1,300296,300298,300299,2,3,0
85781,4,3,300300,300300,300303,0,3,1
85782,3,2,300303,300303,300305,0,2,0
85783,6,3,300309,300309,300312,0,3,4
85784,5,3,300314,300314,300317,0,3,2
85785,6,1,300320,300320,300321,0,1,3
85786,1,2,300321,300321,300323,0,2,0
85787,6,3,300327,300327,300330,0,3,4
85788,6,1,300333,300333,300334,0,1,3
85789,1,2,300334,300334,300336,0,2,0
85790,4,2,300338,300338,300340,0,2,2
85791,6,2,300344,300344,300346,0,2,4
85792,5,2,300349,300349,300351,0,2,3
85793,5,1,300354,300354,300355,0,1,3
85794,5,3,300359,300359,300362,0,3,4
85795,2,3,300361,300362,300365,1,4,0
85796,2,2,300363,300365,300367,2,4,0
85797,5,3,300368,300368,300371,0,3,1
85798,5,1,300373,300373,300374,0,1,2
85799,2,3,300375,300375,300378,0,3,1
85800,3,1,300378,300378,300379,0,1,0
85801,5,1,300383,300383,300384,0,1,4
85802,2,3,300385,300385,300388,0,3,1
85803,6,1,300391,300391,300392,0,1,3
85804,4,1,300395,300395,300396,0,1,3
85805,4,3,300399,300399,300402,0,3,3
85806,6,3,300405,300405,300408,0,3,3
85807,5,3,300410,300410,300413,0,3,2
85808,2,1,300412,300413,300414,1,2,0
85809,3,3,300415,300415,300418,0,3,1
85810,3,3,300418,300418,300421,0,3,0
85811,2,2,300420,300421,300423,1,3,0
85812,2,2,300422,300423,300425,1,3,0
85813,3,2,300425,300425,300427,0,2,0
85814,6,3,300431,300431,300434,0,3,4
85815,1,2,300432,300434,300436,2,4,0
85816,4,3,300436,300436,300439,0,3,0
85817,2,2,300438,300439,300441,1,3,0
85818,1,1,300439,300441,300442,2,3,0
85819,1,2,300440,300442,300444,2,4,0
85820,3,2,300443,300444,300446,1,3,0
85821,4,3,300447,300447,300450,0,3,1
85822,6,2,300453,300453,300455,0,2,3
85823,3,2,300456,300456,300458,0,2,1
85824,4,3,300460,300460,300463,0,3,2
85825,3,2,300463,300463,300465,0,2,0
85826,2,2,300465,300465,300467,0,2,0
85827,2,2,300467,300467,300469,0,2,0
85828,5,2,300472,300472,300474,0,2,3
85829,4,3,300476,300476,300479,0,3,2
85830,3,3,300479,300479,300482,0,3,0
85831,6,3,300485,300485,300488,0,3,3
85832,2,2,300487,300488,300490,1,3,0
85833,2,3,300489,300490,300493,1,4,0
85834,5,2,300494,300494,300496,0,2,1
85835,5,1,300499,300499,300500,0,1,3
85836,4,1,300503,300503,300504,0,1,3
85837,5,2,300508,300508,300510,0,2,4
85838,3,1,300511,300511,300512,0,1,1
85839,2,1,300513,300513,300514,0,1,1
85840,2,1,300515,300515,300516,0,1,1
85841,1,1,300516,300516,300517,0,1,0
85842,5,3,300521,300521,300524,0,3,4
85843,2,1,300523,300524,300525,1,2,0
85844,3,3,300526,300526,300529,0,3,1
85845,4,2,300530,300530,300532,0,2,1
85846,5,2,300535,300535,300537,0,2,3
85847,1,2,300536,300537,300539,1,3,0
85848,6,3,300542,300542,300545,0,3,3
85849,5,1,300547,300547,300548,0,1,2
85850,2,2,300549,300549,300551,0,2,1
85851,6,1,300555,300555,300556,0,1,4
85852,1,2,300556,300556,300558,0,2,0
85853,5,2,300561,300561,300563,0,2,3
85854,2,2,300563,300563,300565,0,2,0
85855,2,1,300565,300565,300566,0,1,0
85856,2,1,300567,300567,300568,0,1,1
85857,5,3,300572,300572,300575,0,3,4
85858,1,2,300573,300575,300577,2,4,0
85859,1,2,300574,300577,300579,3,5,0
85860,4,2,300578,300579,300581,1,3,0
85861,6,1,300584,300584,300585,0,1,3
85862,4,2,300588,300588,300590,0,2,3
85863,4,2,300592,300592,300594,0,2,2
85864,3,3,300595,300595,300598,0,3,1
85865,6,2,300601,300601,300603,0,2,3
85866,6,3,300607,300607,300610,0,3,4
85867,5,3,300612,300612,300615,0,3,2
85868,6,3,300618,300618,300621,0,3,3
85869,4,1,300622,300622,300623,0,1,1
85870,6,2,300628,300628,300630,0,2,5
85871,6,2,300634,300634,300636,0,2,4
85872,6,3,300640,300640,300643,0,3,4
85873,1,2,300641,300643,300645,2,4,0
85874,6,2,300647,300647,300649,0,2,2
85875,5,3,300652,300652,300655,0,3,3
85876,5,1,300657,300657,300658,0,1,2
85877,6,3,300663,300663,300666,0,3,5
85878,5,2,300668,300668,300670,0,2,2
85879,3,3,300671,300671,300674,0,3,1
85880,6,2,300677,300677,300679,0,2,3
85881,5,3,300682,300682,300685,0,3,3
85882,6,2,300688,300688,300690,0,2,3
85883,1,2,300689,300690,300692,1,3,0
85884,3,1,300692,300692,300693,0,1,0
85885,6,3,300698,300698,300701,0,3,5
85886,4,1,300702,300702,300703,0,1,1
85887,4,2,300706,300706,300708,0,2,3
85888,4,2,300710,300710,300712,0,2,2
85889,2,1,300712,300712,300713,0,1,0
85890,5,3,300717,300717,300720,0,3,4
85891,5,2,300722,300722,300724,0,2,2
85892,2,2,300724,300724,300726,0,2,0
85893,5,2,300729,300729,300731,0,2,3
85894,4,3,300733,300733,300736,0,3,2
85895,1,2,300734,300736,300738,2,4,0
85896,6,3,300740,300740,300743,0,3,2
85897,5,3,300745,300745,300748,0,3,2
85898,5,3,300750,300750,300753,0,3,2
85899,5,2,300755,300755,300757,0,2,2
85900,2,1,300757,300757,300758,0,1,0
85901,6,2,300763,300763,300765,0,2,5
85902,2,2,300765,300765,300767,0,2,0
85903,2,1,300767,300767,300768,0,1,0
85904,5,3,300772,300772,300775,0,3,4
85905,1,2,300773,300775,300777,2,4,0
85906,3,1,300776,300777,300778,1,2,0
85907,4,1,300780,300780,300781,0,1,2
85908,5,2,300785,300785,300787,0,2,4
85909,3,2,300788,300788,300790,0,2,1
85910,3,3,300791,300791,300794,0,3,1
85911,5,3,300796,300796,300799,0,3,2
85912,5,1,300801,300801,300802,0,1,2
85913,1,2,300802,300802,300804,0,2,0
85914,1,2,300803,300804,300806,1,3,0
85915,2,3,300805,300806,300809,1,4,0
85916,1,2,300806,300809,300811,3,5,0
85917,5,2,300811,300811,300813,0,2,0
85918,2,3,300813,300813,300816,0,3,0
85919,3,1,300816,300816,300817,0,1,0
85920,4,1,300820,300820,300821,0,1,3
85921,6,1,300826,300826,300827,0,1,5
85922,5,1,300831,300831,300832,0,1,4
85923,1,1,300832,300832,300833,0,1,0
85924,5,1,300837,300837,300838,0,1,4
85925,1,3,300838,300838,300841,0,3,0
85926,4,1,300842,300842,300843,0,1,1
85927,4,1,300846,300846,300847,0,1,3
85928,6,2,300852,300852,300854,0,2,5
85929,1,1,300853,300854,300855,1,2,0
85930,2,1,300855,300855,300856,0,1,0
85931,4,1,300859,300859,300860,0,1,3
85932,4,2,300863,300863,300865,0,2,3
85933,6,2,300869,300869,300871,0,2,4
85934,5,2,300874,300874,300876,0,2,3
85935,3,1,300877,300877,300878,0,1,1
85936,4,2,300881,300881,300883,0,2,3
85937,4,2,300885,300885,300887,0,2,2
85938,3,1,300888,300888,300889,0,1,1
85939,5,1,300893,300893,300894,0,1,4
85940,4,3,300897,300897,300900,0,3,3
85941,4,2,300901,300901,300903,0,2,1
85942,3,1,300904,300904,300905,0,1,1
85943,4,2,300908,300908,300910,0,2,3
85944,2,3,300910,300910,300913,0,3,0
85945,4,2,300914,300914,300916,0,2,1
85946,6,2,300920,300920,300922,0,2,4
85947,5,1,300925,300925,300926,0,1,3
85948,4,1,300929,300929,300930,0,1,3
85949,3,1,300932,300932,300933,0,1,2
85950,1,3,300933,300933,300936,0,3,0
85951,4,3,300937,300937,300940,0,3,1
85952,4,2,300941,300941,300943,0,2,1
85953,3,2,300944,300944,300946,0,2,1
85954,3,3,300947,300947,300950,0,3,1
85955,2,2,300949,300950,300952,1,3,0
85956,3,2,300952,300952,300954,0,2,0
85957,5,3,300957,300957,300960,0,3,3
85958,2,3,300959,300960,300963,1,4,0
85959,3,3,300962,300963,300966,1,4,0
85960,4,3,300966,300966,300969,0,3,0
85961,4,2,300970,300970,300972,0,2,1
85962,5,2,300975,300975,300977,0,2,3
85963,2,3,300977,300977,300980,0,3,0
85964,5,2,300982,300982,300984,0,2,2
85965,3,3,300985,300985,300988,0,3,1
85966,1,3,300986,300988,300991,2,5,0
85967,2,1,300988,300991,300992,3,4,0
85968,6,3,300994,300994,300997,0,3,2
85969,2,2,300996,300997,300999,1,3,0
85970,6,2,301002,301002,301004,0,2,3
85971,5,3,301007,301007,301010,0,3,3
85972,5,3,301012,301012,301015,0,3,2
85973,3,1,301015,301015,301016,0,1,0
85974,3,1,301018,301018,301019,0,1,2
85975,6,2,301024,301024,301026,0,2,5
85976,2,2,301026,301026,301028,0,2,0
85977,1,3,301027,301028,301031,1,4,0
85978,6,2,301033,301033,301035,0,2,2
85979,6,2,301039,301039,301041,0,2,4
85980,5,2,301044,301044,301046,0,2,3
85981,4,3,301048,301048,301051,0,3,2
85982,4,3,301052,301052,301055,0,3,1
85983,4,1,301056,301056,301057,0,1,1
85984,4,1,301060,301060,301061,0,1,3
85985,5,2,301065,301065,301067,0,2,4
85986,5,2,301070,301070,301072,0,2,3
85987,3,3,301073,301073,301076,0,3,1
85988,6,2,301079,301079,301081,0,2,3
85989,5,2,301084,301084,301086,0,2,3
85990,2,2,301086,301086,301088,0,2,0
85991,6,2,301092,301092,301094,0,2,4
85992,6,1,301098,301098,301099,0,1,4
85993,4,1,301102,301102,301103,0,1,3
85994,3,1,301105,301105,301106,0,1,2
85995,2,3,301107,301107,301110,0,3,1
85996,6,2,301113,301113,301115,0,2,3
85997,6,1,301119,301119,301120,0,1,4
85998,1,3,301120,301120,301123,0,3,0
85999,6,3,301126,301126,301129,0,3,3
86000,3,1,301129,301129,301130,0,1,0
86001,2,1,301131,301131,301132,0,1,1
86002,6,3,301137,301137,301140,0,3,5
86003,6,2,301143,301143,301145,0,2,3
86004,2,1,301145,301145,301146,0,1,0
86005,2,3,301147,301147,301150,0,3,1
86006,2,2,301149,301150,301152,1,3,0
86007,6,1,301155,301155,301156,0,1,3
86008,3,2,301158,301158,301160,0,2,2
86009,4,3,301162,301162,301165,0,3,2
86010,6,1,301168,301168,301169,0,1,3
86011,4,3,301172,301172,301175,0,3,3
86012,3,3,301175,301175,301178,0,3,0
86013,4,3,301179,301179,301182,0,3,1
86014,5,3,301184,301184,301187,0,3,2
86015,4,1,301188,301188,301189,0,1,1
86016,3,3,301191,301191,301194,0,3,2
86017,3,1,301194,301194,301195,0,1,0
86018,5,2,301199,301199,301201,0,2,4
86019,1,2,301200,301201,301203,1,3,0
86020,1,1,301201,301203,301204,2,3,0
86021,3,3,301204,301204,301207,0,3,0
86022,6,3,301210,301210,301213,0,3,3
86023,5,1,301215,301215,301216,0,1,2
86024,2,1,301217,301217,301218,0,1,1
86025,4,1,301221,301221,301222,0,1,3
86026,2,2,301223,301223,301225,0,2,1
86027,6,1,301229,301229,301230,0,1,4
86028,4,1,301233,301233,301234,0,1,3
86029,2,2,301235,301235,301237,0,2,1
86030,1,3,301236,301237,301240,1,4,0
86031,2,1,301238,301240,301241,2,3,0
86032,3,1,301241,301241,301242,0,1,0
86033,6,3,301247,301247,301250,0,3,5
86034,1,2,301248,301250,301252,2,4,0
86035,3,2,301251,301252,301254,1,3,0
86036,2,3,301253,301254,301257,1,4,0
86037,6,3,301259,301259,301262,0,3,2
86038,5,3,301264,301264,301267,0,3,2
86039,5,2,301269,301269,301271,0,2,2
86040,6,2,301275,301275,301277,0,2,4
86041,5,1,301280,301280,301281,0,1,3
86042,5,2,301285,301285,301287,0,2,4
86043,1,1,301286,301287,301288,1,2,0
86044,1,3,301287,301288,301291,1,4,0
86045,4,3,301291,301291,301294,0,3,0
86046,1,1,301292,301294,301295,2,3,0
86047,1,2,301293,301295,301297,2,4,0
86048,4,2,301297,301297,301299,0,2,0
86049,6,3,301303,301303,301306,0,3,4
86050,6,1,301309,301309,301310,0,1,3
86051,5,2,301314,301314,301316,0,2,4
86052,2,3,301316,301316,301319,0,3,0
86053,5,3,301321,301321,301324,0,3,2
86054,2,3,301323,301324,301327,1,4,0
86055,5,3,301328,301328,301331,0,3,1
86056,1,1,301329,301331,301332,2,3,0
86057,3,1,301332,301332,301333,0,1,0
86058,3,1,301335,301335,301336,0,1,2
86059,1,3,301336,301336,301339,0,3,0
86060,3,2,301339,301339,301341,0,2,0
86061,3,3,301342,301342,301345,0,3,1
86062,5,2,301347,301347,301349,0,2,2
86063,4,1,301351,301351,301352,0,1,2
86064,2,3,301353,301353,301356,0,3,1
86065,4,1,301357,301357,301358,0,1,1
86066,4,3,301361,301361,301364,0,3,3
86067,1,3,301362,301364,301367,2,5,0
86068,1,2,301363,301367,301369,4,6,0
86069,5,1,301368,301369,301370,1,2,0
86070,5,1,301373,301373,301374,0,1,3
86071,2,3,301375,301375,301378,0,3,1
86072,3,2,301378,301378,301380,0,2,0
86073,2,1,301380,301380,301381,0,1,0
86074,2,1,301382,301382,301383,0,1,1
86075,3,1,301385,301385,301386,0,1,2
86076,1,3,301386,301386,301389,0,3,0
86077,1,1,301387,301389,301390,2,3,0
86078,1,1,301388,301390,301391,2,3,0
86079,5,3,301393,301393,301396,0,3,2
86080,5,3,301398,301398,301401,0,3,2
86081,2,2,301400,301401,301403,1,3,0
86082,1,1,301401,301403,301404,2,3,0
86083,1,2,301402,301404,301406,2,4,0
86084,2,2,301404,301406,301408,2,4,0
86085,5,3,301409,301409,301412,0,3,1
86086,5,3,301414,301414,301417,0,3,2
86087,6,2,301420,301420,301422,0,2,3
86088,1,3,301421,301422,301425,1,4,0
86089,2,1,301423,301425,301426,2,3,0
86090,6,3,301429,301429,301432,0,3,3
86091,5,1,301434,301434,301435,0,1,2
86092,6,1,301440,301440,301441,0,1,5
86093,5,2,301445,301445,301447,0,2,4
86094,5,1,301450,301450,301451,0,1,3
86095,6,3,301456,301456,301459,0,3,5
86096,2,3,301458,301459,301462,1,4,0
86097,5,2,301463,301463,301465,0,2,1
86098,2,1,301465,301465,301466,0,1,0
86099,4,1,301469,301469,301470,0,1,3
86100,1,1,301470,301470,301471,0,1,0
86101,4,3,301474,301474,301477,0,3,3
86102,6,3,301480,301480,301483,0,3,3
86103,4,2,301484,301484,301486,0,2,1
86104,2,2,301486,301486,301488,0,2,0
86105,5,2,301491,301491,301493,0,2,3
86106,5,2,301496,301496,301498,0,2,3
86107,3,2,301499,301499,301501,0,2,1
86108,1,2,301500,301501,301503,1,3,0
86109,4,2,301504,301504,301506,0,2,1
86110,5,1,301509,301509,301510,0,1,3
86111,6,1,301515,301515,301516,0,1,5
86112,3,3,301518,301518,301521,0,3,2
86113,5,2,301523,301523,301525,0,2,2
86114,3,3,301526,301526,301529,0,3,1
86115,4,2,301530,301530,301532,0,2,1
86116,1,3,301531,301532,301535,1,4,0
86117,1,1,301532,301535,301536,3,4,0
86118,3,1,301535,301536,301537,1,2,0
86119,5,3,301540,301540,301543,0,3,3
86120,3,2,301543,301543,301545,0,2,0
86121,4,1,301547,301547,301548,0,1,2
86122,1,2,301548,301548,301550,0,2,0
86123,6,3,301554,301554,301557,0,3,4
86124,5,2,301559,301559,301561,0,2,2
86125,4,3,301563,301563,301566,0,3,2
86126,5,3,301568,301568,301571,0,3,2
86127,6,2,301574,301574,301576,0,2,3
86128,6,3,301580,301580,301583,0,3,4
86129,4,1,301584,301584,301585,0,1,1
86130,3,1,301587,301587,301588,0,1,2
86131,3,3,301590,301590,301593,0,3,2
86132,4,1,301594,301594,301595,0,1,1
86133,6,2,301600,301600,301602,0,2,5
86134,5,1,301605,301605,301606,0,1,3
86135,2,3,301607,301607,301610,0,3,1
86136,2,1,301609,301610,301611,1,2,0
86137,5,1,301614,301614,301615,0,1,3
86138,3,1,301617,301617,301618,0,1,2
86139,5,2,301622,301622,301624,0,2,4
86140,1,1,301623,301624,301625,1,2,0
86141,3,1,301626,301626,301627,0,1,1
86142,2,2,301628,301628,301630,0,2,1
86143,6,3,301634,301634,301637,0,3,4
86144,3,3,301637,301637,301640,0,3,0
86145,4,1,301641,301641,301642,0,1,1
86146,4,1,301645,301645,301646,0,1,3
86147,5,2,301650,301650,301652,0,2,4
86148,1,3,301651,301652,301655,1,4,0
86149,1,2,301652,301655,301657,3,5,0
86150,4,2,301656,301657,301659,1,3,0
86151,1,3,301657,301659,301662,2,5,0
86152,1,2,301658,301662,301664,4,6,0
86153,2,2,301660,301664,301666,4,6,0
86154,5,2,301665,301666,301668,1,3,0
86155,2,3,301667,301668,301671,1,4,0
86156,6,2,301673,301673,301675,0,2,2
86157,1,2,301674,301675,301677,1,3,0
86158,5,2,301679,301679,301681,0,2,2
86159,6,1,301685,301685,301686,0,1,4
86160,1,1,301686,301686,301687,0,1,0
86161,5,2,301691,301691,301693,0,2,4
86162,1,2,301692,301693,301695,1,3,0
86163,3,3,301695,301695,301698,0,3,0
86164,1,1,301696,301698,301699,2,3,0
86165,5,1,301701,301701,301702,0,1,2
86166,3,1,301704,301704,301705,0,1,2
86167,3,3,301707,301707,301710,0,3,2
86168,4,3,301711,301711,301714,0,3,1
86169,5,3,301716,301716,301719,0,3,2
86170,4,3,301720,301720,301723,0,3,1
86171,6,3,301726,301726,301729,0,3,3
86172,1,1,301727,301729,301730,2,3,0
86173,6,1,301733,301733,301734,0,1,3
86174,2,3,301735,301735,301738,0,3,1
86175,4,3,301739,301739,301742,0,3,1
86176,6,2,301745,301745,301747,0,2,3
86177,2,3,301747,301747,301750,0,3,0
86178,5,3,301752,301752,301755,0,3,2
86179,6,3,301758,301758,301761,0,3,3
86180,1,1,301759,301761,301762,2,3,0
86181,6,3,301765,301765,301768,0,3,3
86182,1,3,301766,301768,301771,2,5,0
86183,2,1,301768,301771,301772,3,4,0
86184,5,2,301773,301773,301775,0,2,1
86185,4,1,301777,301777,301778,0,1,2
86186,6,2,301783,301783,301785,0,2,5
86187,3,1,301786,301786,301787,0,1,1
86188,5,3,301791,301791,301794,0,3,4
86189,5,2,301796,301796,301798,0,2,2
86190,1,1,301797,301798,301799,1,2,0
86191,2,2,301799,301799,301801,0,2,0
86192,6,1,301805,301805,301806,0,1,4
86193,1,2,301806,301806,301808,0,2,0
86194,6,1,301812,301812,301813,0,1,4
86195,5,1,301817,301817,301818,0,1,4
86196,5,2,301822,301822,301824,0,2,4
86197,6,3,301828,301828,301831,0,3,4
86198,1,1,301829,301831,301832,2,3,0
86199,2,3,301831,301832,301835,1,4,0
86200,3,1,301834,301835,301836,1,2,0
86201,6,1,301840,301840,301841,0,1,4
86202,5,1,301845,301845,301846,0,1,4
86203,1,1,301846,301846,301847,0,1,0
86204,1,1,301847,301847,301848,0,1,0
86205,5,1,301852,301852,301853,0,1,4
86206,3,2,301855,301855,301857,0,2,2
86207,2,3,301857,301857,301860,0,3,0
86208,5,3,301862,301862,301865,0,3,2
86209,4,2,301866,301866,301868,0,2,1
86210,3,2,301869,301869,301871,0,2,1
86211,5,3,301874,301874,301877,0,3,3
86212,2,3,301876,301877,301880,1,4,0
86213,1,1,301877,301880,301881,3,4,0
86214,1,2,301878,301881,301883,3,5,0
86215,4,2,301882,301883,301885,1,3,0
86216,3,1,301885,301885,301886,0,1,0
86217,5,3,301890,301890,301893,0,3,4
86218,5,2,301895,301895,301897,0,2,2
86219,1,3,301896,301897,301900,1,4,0
86220,2,1,301898,301900,301901,2,3,0
86221,4,3,301902,301902,301905,0,3,1
86222,2,3,301904,301905,301908,1,4,0
86223,2,1,301906,301908,301909,2,3,0
86224,3,1,301909,301909,301910,0,1,0
86225,2,1,301911,301911,301912,0,1,1
86226,6,3,301917,301917,301920,0,3,5
86227,6,3,301923,301923,301926,0,3,3
86228,5,1,301928,301928,301929,0,1,2
86229,6,3,301934,301934,301937,0,3,5
86230,4,2,301938,301938,301940,0,2,1
86231,1,3,301939,301940,301943,1,4,0
86232,6,3,301945,301945,301948,0,3,2
86233,3,2,301948,301948,301950,0,2,0
86234,5,2,301953,301953,301955,0,2,3
86235,3,1,301956,301956,301957,0,1,1
86236,6,3,301962,301962,301965,0,3,5
86237,6,1,301968,301968,301969,0,1,3
86238,4,3,301972,301972,301975,0,3,3
86239,5,2,301977,301977,301979,0,2,2
86240,3,3,301980,301980,301983,0,3,1
86241,6,2,301986,301986,301988,0,2,3
86242,2,3,301988,301988,301991,0,3,0
86243,5,2,301993,301993,301995,0,2,2
86244,1,3,301994,301995,301998,1,4,0
86245,4,2,301998,301998,302000,0,2,0
86246,6,2,302004,302004,302006,0,2,4
86247,1,3,302005,302006,302009,1,4,0
86248,1,3,302006,302009,302012,3,6,0
86249,1,1,302007,302012,302013,5,6,0
86250,3,3,302010,302013,302016,3,6,0
86251,1,2,302011,302016,302018,5,7,0
86252,4,1,302015,302018,302019,3,4,0
86253,4,1,302019,302019,302020,0,1,0
86254,2,2,302021,302021,302023,0,2,1
86255,3,2,302024,302024,302026,0,2,1
86256,3,2,302027,302027,302029,0,2,1
86257,1,1,302028,302029,302030,1,2,0
86258,1,1,302029,302030,302031,1,2,0
86259,1,1,302030,302031,302032,1,2,0
86260,3,3,302033,302033,302036,0,3,1
86261,3,3,302036,302036,302039,0,3,0
86262,1,2,302037,302039,302041,2,4,0
86263,4,1,302041,302041,302042,0,1,0
86264,3,3,302044,302044,302047,0,3,2
86265,3,1,302047,302047,302048,0,1,0
86266,5,1,302052,302052,302053,0,1,4
86267,2,1,302054,302054,302055,0,1,1
86268,3,1,302057,302057,302058,0,1,2
86269,4,2,302061,302061,302063,0,2,3
86270,1,3,302062,302063,302066,1,4,0
86271,1,1,302063,302066,302067,3,4,0
86272,3,3,302066,302067,302070,1,4,0
86273,6,2,302072,302072,302074,0,2,2
86274,5,2,302077,302077,302079,0,2,3
86275,1,1,302078,302079,302080,1,2,0
86276,5,1,302083,302083,302084,0,1,3
86277,4,1,302087,302087,302088,0,1,3
86278,1,2,302088,302088,302090,0,2,0
86279,2,1,302090,302090,302091,0,1,0
86280,4,3,302094,302094,302097,0,3,3
86281,4,3,302098,302098,302101,0,3,1
86282,1,1,302099,302101,302102,2,3,0
86283,1,1,302100,302102,302103,2,3,0
86284,4,2,302104,302104,302106,0,2,1
86285,5,1,302109,302109,302110,0,1,3
86286,2,2,302111,302111,302113,0,2,1
86287,1,3,302112,302113,302116,1,4,0
86288,1,3,302113,302116,302119,3,6,0
86289,4,3,302117,302119,302122,2,5,0
86290,6,1,302123,302123,302124,0,1,1
86291,3,3,302126,302126,302129,0,3,2
86292,1,2,302127,302129,302131,2,4,0
86293,1,2,302128,302131,302133,3,5,0
86294,5,1,302133,302133,302134,0,1,0
86295,6,2,302139,302139,302141,0,2,5
86296,5,3,302144,302144,302147,0,3,3
86297,1,3,302145,302147,302150,2,5,0
86298,2,3,302147,302150,302153,3,6,0
86299,4,1,302151,302153,302154,2,3,0
86300,4,2,302155,302155,302157,0,2,1
86301,6,3,302161,302161,302164,0,3,4
86302,2,2,302163,302164,302166,1,3,0
86303,1,3,302164,302166,302169,2,5,0
86304,1,1,302165,302169,302170,4,5,0
86305,6,3,302171,302171,302174,0,3,1
86306,1,1,302172,302174,302175,2,3,0
86307,5,1,302177,302177,302178,0,1,2
86308,2,2,302179,302179,302181,0,2,1
86309,3,2,302182,302182,302184,0,2,1
86310,4,2,302186,302186,302188,0,2,2
86311,5,3,302191,302191,302194,0,3,3
86312,5,1,302196,302196,302197,0,1,2
86313,5,2,302201,302201,302203,0,2,4
86314,5,2,302206,302206,302208,0,2,3
86315,6,2,302212,302212,302214,0,2,4
86316,3,2,302215,302215,302217,0,2,1
86317,2,1,302217,302217,302218,0,1,0
86318,6,1,302223,302223,302224,0,1,5
86319,2,2,302225,302225,302227,0,2,1
86320,2,1,302227,302227,302228,0,1,0
86321,1,3,302228,302228,302231,0,3,0
86322,2,1,302230,302231,302232,1,2,0
86323,2,1,302232,302232,302233,0,1,0
86324,5,1,302237,302237,302238,0,1,4
86325,3,3,302240,302240,302243,0,3,2
86326,2,2,302242,302243,302245,1,3,0
86327,6,2,302248,302248,302250,0,2,3
86328,2,1,302250,302250,302251,0,1,0
86329,1,1,302251,302251,302252,0,1,0
86330,1,1,302252,302252,302253,0,1,0
86331,1,3,302253,302253,302256,0,3,0
86332,2,2,302255,302256,302258,1,3,0
86333,4,1,302259,302259,302260,0,1,1
86334,4,3,302263,302263,302266,0,3,3
86335,4,1,302267,302267,302268,0,1,1
86336,6,3,302273,302273,302276,0,3,5
86337,3,2,302276,302276,302278,0,2,0
86338,1,1,302277,302278,302279,1,2,0
86339,6,3,302283,302283,302286,0,3,4
86340,6,1,302289,302289,302290,0,1,3
86341,5,1,302294,302294,302295,0,1,4
86342,6,1,302300,302300,302301,0,1,5
86343,5,1,302305,302305,302306,0,1,4
86344,4,1,302309,302309,302310,0,1,3
86345,2,1,302311,302311,302312,0,1,1
86346,5,3,302316,302316,302319,0,3,4
86347,1,2,302317,302319,302321,2,4,0
86348,2,3,302319,302321,302324,2,5,0
86349,4,1,302323,302324,302325,1,2,0
86350,1,1,302324,302325,302326,1,2,0
86351,4,2,302328,302328,302330,0,2,2
86352,2,2,302330,302330,302332,0,2,0
86353,3,1,302333,302333,302334,0,1,1
86354,5,1,302338,302338,302339,0,1,4
86355,5,2,302343,302343,302345,0,2,4
86356,5,3,302348,302348,302351,0,3,3
86357,6,2,302354,302354,302356,0,2,3
86358,6,3,302360,302360,302363,0,3,4
86359,1,3,302361,302363,302366,2,5,0
86360,2,1,302363,302366,302367,3,4,0
86361,2,1,302365,302367,302368,2,3,0
86362,5,1,302370,302370,302371,0,1,2
86363,5,1,302375,302375,302376,0,1,4
86364,5,3,302380,302380,302383,0,3,4
86365,6,2,302386,302386,302388,0,2,3
86366,6,2,302392,302392,302394,0,2,4
86367,3,1,302395,302395,302396,0,1,1
86368,5,1,302400,302400,302401,0,1,4
86369,6,1,302406,302406,302407,0,1,5
86370,5,3,302411,302411,302414,0,3,4
86371,6,2,302417,302417,302419,0,2,3
86372,1,3,302418,302419,302422,1,4,0
86373,5,2,302423,302423,302425,0,2,1
86374,2,3,302425,302425,302428,0,3,0
86375,3,3,302428,302428,302431,0,3,0
86376,6,3,302434,302434,302437,0,3,3
86377,6,3,302440,302440,302443,0,3,3
86378,4,2,302444,302444,302446,0,2,1
86379,2,1,302446,302446,302447,0,1,0
86380,6,1,302452,302452,302453,0,1,5
86381,6,1,302458,302458,302459,0,1,5
86382,6,1,302464,302464,302465,0,1,5
86383,5,3,302469,302469,302472,0,3,4
86384,5,3,302474,302474,302477,0,3,2
86385,4,3,302478,302478,302481,0,3,1
86386,2,2,302480,302481,302483,1,3,0
86387,6,2,302486,302486,302488,0,2,3
86388,6,1,302492,302492,302493,0,1,4
86389,3,3,302495,302495,302498,0,3,2
86390,5,2,302500,302500,302502,0,2,2
86391,5,2,302505,302505,302507,0,2,3
86392,3,2,302508,302508,302510,0,2,1
86393,2,1,302510,302510,302511,0,1,0
86394,6,2,302516,302516,302518,0,2,5
86395,1,2,302517,302518,302520,1,3,0
86396,4,2,302521,302521,302523,0,2,1
86397,1,1,302522,302523,302524,1,2,0
86398,1,2,302523,302524,302526,1,3,0
86399,5,1,302528,302528,302529,0,1,2
86400,2,1,302530,302530,302531,0,1,1
86401,4,1,302534,302534,302535,0,1,3
86402,4,2,302538,302538,302540,0,2,3
86403,2,1,302540,302540,302541,0,1,0
86404,4,2,302544,302544,302546,0,2,3
86405,5,1,302549,302549,302550,0,1,3
86406,4,1,302553,302553,302554,0,1,3
86407,4,2,302557,302557,302559,0,2,3
86408,3,1,302560,302560,302561,0,1,1
86409,3,1,302563,302563,302564,0,1,2
86410,4,3,302567,302567,302570,0,3,3
86411,3,3,302570,302570,302573,0,3,0
86412,3,3,302573,302573,302576,0,3,0
86413,2,3,302575,302576,302579,1,4,0
86414,2,2,302577,302579,302581,2,4,0
86415,2,3,302579,302581,302584,2,5,0
86416,5,3,302584,302584,302587,0,3,0
86417,2,3,302586,302587,302590,1,4,0
86418,2,2,302588,302590,302592,2,4,0
86419,2,1,302590,302592,302593,2,3,0
86420,1,2,302591,302593,302595,2,4,0
86421,6,3,302597,302597,302600,0,3,2
86422,1,3,302598,302600,302603,2,5,0
86423,5,3,302603,302603,302606,0,3,0
86424,6,3,302609,302609,302612,0,3,3
86425,2,2,302611,302612,302614,1,3,0
86426,1,2,302612,302614,302616,2,4,0
86427,1,2,302613,302616,302618,3,5,0
86428,6,3,302619,302619,302622,0,3,1
86429,1,1,302620,302622,302623,2,3,0
86430,5,3,302625,302625,302628,0,3,2
86431,1,1,302626,302628,302629,2,3,0
86432,3,1,302629,302629,302630,0,1,0
86433,2,1,302631,302631,302632,0,1,1
86434,4,3,302635,302635,302638,0,3,3
86435,2,3,302637,302638,302641,1,4,0
86436,5,2,302642,302642,302644,0,2,1
86437,4,3,302646,302646,302649,0,3,2
86438,6,2,302652,302652,302654,0,2,3
86439,4,3,302656,302656,302659,0,3,2
86440,3,3,302659,302659,302662,0,3,0
86441,4,2,302663,302663,302665,0,2,1
86442,5,3,302668,302668,302671,0,3,3
86443,4,1,302672,302672,302673,0,1,1
86444,1,2,302673,302673,302675,0,2,0
86445,3,2,302676,302676,302678,0,2,1
86446,3,3,302679,302679,302682,0,3,1
86447,6,2,302685,302685,302687,0,2,3
86448,1,3,302686,302687,302690,1,4,0
86449,2,3,302688,302690,302693,2,5,0
86450,3,1,302691,302693,302694,2,3,0
86451,1,1,302692,302694,302695,2,3,0
86452,5,1,302697,302697,302698,0,1,2
86453,5,2,302702,302702,302704,0,2,4
86454,4,2,302706,302706,302708,0,2,2
86455,1,2,302707,302708,302710,1,3,0
86456,3,2,302710,302710,302712,0,2,0
86457,1,2,302711,302712,302714,1,3,0
86458,6,2,302717,302717,302719,0,2,3
86459,4,2,302721,302721,302723,0,2,2
86460,5,3,302726,302726,302729,0,3,3
86461,6,3,302732,302732,302735,0,3,3
86462,3,2,302735,302735,302737,0,2,0
86463,6,3,302741,302741,302744,0,3,4
86464,4,1,302745,302745,302746,0,1,1
86465,5,2,302750,302750,302752,0,2,4
86466,4,2,302754,302754,302756,0,2,2
86467,5,1,302759,302759,302760,0,1,3
86468,2,1,302761,302761,302762,0,1,1
86469,4,3,302765,302765,302768,0,3,3
86470,2,1,302767,302768,302769,1,2,0
86471,2,1,302769,302769,302770,0,1,0
86472,3,2,302772,302772,302774,0,2,2
86473,6,3,302778,302778,302781,0,3,4
86474,2,2,302780,302781,302783,1,3,0
86475,2,3,302782,302783,302786,1,4,0
86476,2,3,302784,302786,302789,2,5,0
86477,1,3,302785,302789,302792,4,7,0
86478,2,1,302787,302792,302793,5,6,0
86479,2,2,302789,302793,302795,4,6,0
86480,1,1,302790,302795,302796,5,6,0
86481,3,3,302793,302796,302799,3,6,0
86482,6,2,302799,302799,302801,0,2,0
86483,4,3,302803,302803,302806,0,3,2
86484,1,1,302804,302806,302807,2,3,0
86485,2,1,302806,302807,302808,1,2,0
86486,4,1,302810,302810,302811,0,1,2
86487,3,2,302813,302813,302815,0,2,2
86488,4,3,302817,302817,302820,0,3,2
86489,5,3,302822,302822,302825,0,3,2
86490,3,2,302825,302825,302827,0,2,0
86491,3,2,302828,302828,302830,0,2,1
86492,3,2,302831,302831,302833,0,2,1
86493,1,1,302832,302833,302834,1,2,0
86494,4,3,302836,302836,302839,0,3,2
86495,5,3,302841,302841,302844,0,3,2
86496,1,3,302842,302844,302847,2,5,0
86497,1,1,302843,302847,302848,4,5,0
86498,6,2,302849,302849,302851,0,2,1
86499,4,2,302853,302853,302855,0,2,2
86500,4,1,302857,302857,302858,0,1,2
86501,3,2,302860,302860,302862,0,2,2
86502,3,3,302863,302863,302866,0,3,1
86503,1,3,302864,302866,302869,2,5,0
86504,4,1,302868,302869,302870,1,2,0
86505,6,1,302874,302874,302875,0,1,4
86506,6,2,302880,302880,302882,0,2,5
86507,5,1,302885,302885,302886,0,1,3
86508,6,1,302891,302891,302892,0,1,5
86509,6,3,302897,302897,302900,0,3,5
86510,5,2,302902,302902,302904,0,2,2
86511,5,2,302907,302907,302909,0,2,3
86512,3,3,302910,302910,302913,0,3,1
86513,4,2,302914,302914,302916,0,2,1
86514,4,2,302918,302918,302920,0,2,2
86515,5,3,302923,302923,302926,0,3,3
86516,2,3,302925,302926,302929,1,4,0
86517,5,1,302930,302930,302931,0,1,1
86518,5,2,302935,302935,302937,0,2,4
86519,5,1,302940,302940,302941,0,1,3
86520,2,1,302942,302942,302943,0,1,1
86521,5,1,302947,302947,302948,0,1,4
86522,3,1,302950,302950,302951,0,1,2
86523,1,2,302951,302951,302953,0,2,0
86524,6,2,302957,302957,302959,0,2,4
86525,6,2,302963,302963,302965,0,2,4
86526,4,3,302967,302967,302970,0,3,2
86527,6,2,302973,302973,302975,0,2,3
86528,3,2,302976,302976,302978,0,2,1
86529,4,3,302980,302980,302983,0,3,2
86530,2,3,302982,302983,302986,1,4,0
86531,4,1,302986,302986,302987,0,1,0
86532,5,1,302991,302991,302992,0,1,4
86533,1,2,302992,302992,302994,0,2,0
86534,3,2,302995,302995,302997,0,2,1
86535,5,3,303000,303000,303003,0,3,3
86536,1,2,303001,303003,303005,2,4,0
86537,6,2,303007,303007,303009,0,2,2
86538,4,2,303011,303011,303013,0,2,2
86539,6,1,303017,303017,303018,0,1,4
86540,5,1,303022,303022,303023,0,1,4
86541,4,2,303026,303026,303028,0,2,3
86542,3,2,303029,303029,303031,0,2,1
86543,3,1,303032,303032,303033,0,1,1
86544,6,2,303038,303038,303040,0,2,5
86545,3,3,303041,303041,303044,0,3,1
86546,4,1,303045,303045,303046,0,1,1
86547,3,3,303048,303048,303051,0,3,2
86548,1,1,303049,303051,303052,2,3,0
86549,6,1,303055,303055,303056,0,1,3
86550,4,2,303059,303059,303061,0,2,3
86551,4,2,303063,303063,303065,0,2,2
86552,1,2,303064,303065,303067,1,3,0
86553,1,3,303065,303067,303070,2,5,0
86554,6,2,303071,303071,303073,0,2,1
86555,1,3,303072,303073,303076,1,4,0
86556,6,3,303078,303078,303081,0,3,2
86557,6,2,303084,303084,303086,0,2,3
86558,3,3,303087,303087,303090,0,3,1
86559,6,1,303093,303093,303094,0,1,3
86560,6,1,303099,303099,303100,0,1,5
86561,4,1,303103,303103,303104,0,1,3
86562,6,2,303109,303109,303111,0,2,5
86563,1,3,303110,303111,303114,1,4,0
86564,1,1,303111,303114,303115,3,4,0
86565,4,3,303115,303115,303118,0,3,0
86566,4,2,303119,303119,303121,0,2,1
86567,2,2,303121,303121,303123,0,2,0
86568,3,3,303124,303124,303127,0,3,1
86569,6,3,303130,303130,303133,0,3,3
86570,1,3,303131,303133,303136,2,5,0
86571,6,2,303137,303137,303139,0,2,1
86572,6,1,303143,303143,303144,0,1,4
86573,4,3,303147,303147,303150,0,3,3
86574,5,2,303152,303152,303154,0,2,2
86575,5,3,303157,303157,303160,0,3,3
86576,1,1,303158,303160,303161,2,3,0
86577,2,1,303160,303161,303162,1,2,0
86578,1,3,303161,303162,303165,1,4,0
86579,6,1,303167,303167,303168,0,1,2
86580,1,3,303168,303168,303171,0,3,0
86581,1,2,303169,303171,303173,2,4,0
86582,3,3,303172,303173,303176,1,4,0
86583,5,2,303177,303177,303179,0,2,1
86584,1,3,303178,303179,303182,1,4,0
86585,2,2,303180,303182,303184,2,4,0
86586,3,3,303183,303184,303187,1,4,0
86587,1,2,303184,303187,303189,3,5,0
86588,1,1,303185,303189,303190,4,5,0
86589,3,1,303188,303190,303191,2,3,0
86590,4,1,303192,303192,303193,0,1,1
86591,4,1,303196,303196,303197,0,1,3
86592,6,1,303202,303202,303203,0,1,5
86593,3,2,303205,303205,303207,0,2,2
86594,3,3,303208,303208,303211,0,3,1
86595,3,3,303211,303211,303214,0,3,0
86596,1,1,303212,303214,303215,2,3,0
86597,1,2,303213,303215,303217,2,4,0
86598,3,3,303216,303217,303220,1,4,0
86599,3,1,303219,303220,303221,1,2,0
86600,6,2,303225,303225,303227,0,2,4
86601,6,3,303231,303231,303234,0,3,4
86602,5,1,303236,303236,303237,0,1,2
86603,3,1,303239,303239,303240,0,1,2
86604,1,2,303240,303240,303242,0,2,0
86605,4,2,303244,303244,303246,0,2,2
86606,4,1,303248,303248,303249,0,1,2
86607,1,1,303249,303249,303250,0,1,0
86608,6,2,303255,303255,303257,0,2,5
86609,6,3,303261,303261,303264,0,3,4
86610,4,1,303265,303265,303266,0,1,1
86611,2,3,303267,303267,303270,0,3,1
86612,4,3,303271,303271,303274,0,3,1
86613,2,3,303273,303274,303277,1,4,0
86614,3,1,303276,303277,303278,1,2,0
86615,1,2,303277,303278,303280,1,3,0
86616,2,1,303279,303280,303281,1,2,0
86617,2,2,303281,303281,303283,0,2,0
86618,1,1,303282,303283,303284,1,2,0
86619,4,3,303286,303286,303289,0,3,2
86620,1,2,303287,303289,303291,2,4,0
86621,2,3,303289,303291,303294,2,5,0
86622,2,3,303291,303294,303297,3,6,0
86623,4,3,303295,303297,303300,2,5,0
86624,4,1,303299,303300,303301,1,2,0
86625,6,1,303305,303305,303306,0,1,4
86626,1,2,303306,303306,303308,0,2,0
86627,3,3,303309,303309,303312,0,3,1
86628,5,3,303314,303314,303317,0,3,2
86629,4,1,303318,303318,303319,0,1,1
86630,3,1,303321,303321,303322,0,1,2
86631,6,2,303327,303327,303329,0,2,5
86632,3,1,303330,303330,303331,0,1,1
86633,5,2,303335,303335,303337,0,2,4
86634,3,3,303338,303338,303341,0,3,1
86635,2,1,303340,303341,303342,1,2,0
86636,4,1,303344,303344,303345,0,1,2
86637,2,3,303346,303346,303349,0,3,1
86638,3,2,303349,303349,303351,0,2,0
86639,4,2,303353,303353,303355,0,2,2
86640,1,3,303354,303355,303358,1,4,0
86641,2,1,303356,303358,303359,2,3,0
86642,6,1,303362,303362,303363,0,1,3
86643,1,2,303363,303363,303365,0,2,0
86644,5,1,303368,303368,303369,0,1,3
86645,4,2,303372,303372,303374,0,2,3
86646,1,3,303373,303374,303377,1,4,0
86647,5,2,303378,303378,303380,0,2,1
86648,4,1,303382,303382,303383,0,1,2
86649,1,1,303383,303383,303384,0,1,0
86650,6,3,303389,303389,303392,0,3,5
86651,5,3,303394,303394,303397,0,3,2
86652,3,3,303397,303397,303400,0,3,0
86653,4,1,303401,303401,303402,0,1,1
86654,6,1,303407,303407,303408,0,1,5
86655,3,3,303410,303410,303413,0,3,2
86656,3,3,303413,303413,303416,0,3,0
86657,4,3,303417,303417,303420,0,3,1
86658,6,3,303423,303423,303426,0,3,3
86659,4,2,303427,303427,303429,0,2,1
86660,5,1,303432,303432,303433,0,1,3
86661,2,2,303434,303434,303436,0,2,1
86662,1,1,303435,303436,303437,1,2,0
86663,5,3,303440,303440,303443,0,3,3
86664,2,1,303442,303443,303444,1,2,0
86665,1,1,303443,303444,303445,1,2,0
86666,5,1,303448,303448,303449,0,1,3
86667,4,2,303452,303452,303454,0,2,3
86668,3,1,303455,303455,303456,0,1,1
86669,3,3,303458,303458,303461,0,3,2
86670,2,3,303460,303461,303464,1,4,0
86671,2,3,303462,303464,303467,2,5,0
86672,4,3,303466,303467,303470,1,4,0
86673,2,3,303468,303470,303473,2,5,0
86674,2,3,303470,303473,303476,3,6,0
86675,4,2,303474,303476,303478,2,4,0
86676,4,2,303478,303478,303480,0,2,0
86677,4,1,303482,303482,303483,0,1,2
86678,5,2,303487,303487,303489,0,2,4
86679,1,3,303488,303489,303492,1,4,0
86680,6,1,303494,303494,303495,0,1,2
86681,1,3,303495,303495,303498,0,3,0
86682,2,2,303497,303498,303500,1,3,0
86683,6,2,303503,303503,303505,0,2,3
86684,3,1,303506,303506,303507,0,1,1
86685,4,2,303510,303510,303512,0,2,3
86686,3,1,303513,303513,303514,0,1,1
86687,1,1,303514,303514,303515,0,1,0
86688,4,3,303518,303518,303521,0,3,3
86689,5,3,303523,303523,303526,0,3,2
86690,6,3,303529,303529,303532,0,3,3
86691,1,3,303530,303532,303535,2,5,0
86692,5,2,303535,303535,303537,0,2,0
86693,5,3,303540,303540,303543,0,3,3
86694,2,3,303542,303543,303546,1,4,0
86695,4,1,303546,303546,303547,0,1,0
86696,6,1,303552,303552,303553,0,1,5
86697,4,1,303556,303556,303557,0,1,3
86698,1,1,303557,303557,303558,0,1,0
86699,3,1,303560,303560,303561,0,1,2
86700,5,3,303565,303565,303568,0,3,4
86701,2,1,303567,303568,303569,1,2,0
86702,5,1,303572,303572,303573,0,1,3
86703,4,3,303576,303576,303579,0,3,3
86704,6,2,303582,303582,303584,0,2,3
86705,5,2,303587,303587,303589,0,2,3
86706,1,1,303588,303589,303590,1,2,0
86707,4,1,303592,303592,303593,0,1,2
86708,6,3,303598,303598,303601,0,3,5
86709,4,3,303602,303602,303605,0,3,1
86710,2,1,303604,303605,303606,1,2,0
86711,5,2,303609,303609,303611,0,2,3
86712,3,1,303612,303612,303613,0,1,1
86713,6,1,303618,303618,303619,0,1,5
86714,4,3,303622,303622,303625,0,3,3
86715,1,1,303623,303625,303626,2,3,0
86716,5,1,303628,303628,303629,0,1,2
86717,6,1,303634,303634,303635,0,1,5
86718,2,2,303636,303636,303638,0,2,1
86719,4,1,303640,303640,303641,0,1,2
86720,5,1,303645,303645,303646,0,1,4
86721,1,2,303646,303646,303648,0,2,0
86722,4,2,303650,303650,303652,0,2,2
86723,6,3,303656,303656,303659,0,3,4
86724,3,2,303659,303659,303661,0,2,0
86725,2,2,303661,303661,303663,0,2,0
86726,2,1,303663,303663,303664,0,1,0
86727,3,3,303666,303666,303669,0,3,2
86728,6,3,303672,303672,303675,0,3,3
86729,5,2,303677,303677,303679,0,2,2
86730,2,1,303679,303679,303680,0,1,0
86731,3,1,303682,303682,303683,0,1,2
86732,2,3,303684,303684,303687,0,3,1
86733,1,1,303685,303687,303688,2,3,0
86734,5,2,303690,303690,303692,0,2,2
86735,3,1,303693,303693,303694,0,1,1
86736,2,1,303695,303695,303696,0,1,1
86737,5,1,303700,303700,303701,0,1,4
86738,3,1,303703,303703,303704,0,1,2
86739,3,3,303706,303706,303709,0,3,2
86740,3,2,303709,303709,303711,0,2,0
86741,6,2,303715,303715,303717,0,2,4
86742,2,2,303717,303717,303719,0,2,0
86743,6,1,303723,303723,303724,0,1,4
86744,1,2,303724,303724,303726,0,2,0
86745,3,2,303727,303727,303729,0,2,1
86746,2,1,303729,303729,303730,0,1,0
86747,1,1,303730,303730,303731,0,1,0
86748,3,1,303733,303733,303734,0,1,2
86749,3,1,303736,303736,303737,0,1,2
86750,3,1,303739,303739,303740,0,1,2
86751,5,1,303744,303744,303745,0,1,4
86752,5,1,303749,303749,303750,0,1,4
86753,6,2,303755,303755,303757,0,2,5
86754,1,2,303756,303757,303759,1,3,0
86755,6,3,303762,303762,303765,0,3,3
86756,1,3,303763,303765,303768,2,5,0
86757,2,2,303765,303768,303770,3,5,0
86758,6,2,303771,303771,303773,0,2,1
86759,5,2,303776,303776,303778,0,2,3
86760,4,3,303780,303780,303783,0,3,2
86761,2,2,303782,303783,303785,1,3,0
86762,1,2,303783,303785,303787,2,4,0
86763,5,1,303788,303788,303789,0,1,1
86764,1,1,303789,303789,303790,0,1,0
86765,3,2,303792,303792,303794,0,2,2
86766,4,1,303796,303796,303797,0,1,2
86767,4,1,303800,303800,303801,0,1,3
86768,2,3,303802,303802,303805,0,3,1
86769,4,1,303806,303806,303807,0,1,1
86770,2,2,303808,303808,303810,0,2,1
86771,4,2,303812,303812,303814,0,2,2
86772,5,3,303817,303817,303820,0,3,3
86773,6,1,303823,303823,303824,0,1,3
86774,1,3,303824,303824,303827,0,3,0
86775,1,2,303825,303827,303829,2,4,0
86776,5,3,303830,303830,303833,0,3,1
86777,4,2,303834,303834,303836,0,2,1
86778,4,3,303838,303838,303841,0,3,2
86779,6,3,303844,303844,303847,0,3,3
86780,3,2,303847,303847,303849,0,2,0
86781,5,2,303852,303852,303854,0,2,3
86782,4,3,303856,303856,303859,0,3,2
86783,2,2,303858,303859,303861,1,3,0
86784,4,2,303862,303862,303864,0,2,1
86785,2,2,303864,303864,303866,0,2,0
86786,1,3,303865,303866,303869,1,4,0
86787,6,2,303871,303871,303873,0,2,2
86788,2,2,303873,303873,303875,0,2,0
86789,2,1,303875,303875,303876,0,1,0
86790,1,3,303876,303876,303879,0,3,0
86791,5,3,303881,303881,303884,0,3,2
86792,3,1,303884,303884,303885,0,1,0
86793,1,3,303885,303885,303888,0,3,0
86794,1,2,303886,303888,303890,2,4,0
86795,4,3,303890,303890,303893,0,3,0
86796,3,3,303893,303893,303896,0,3,0
86797,5,1,303898,303898,303899,0,1,2
86798,1,3,303899,303899,303902,0,3,0
86799,5,3,303904,303904,303907,0,3,2
86800,4,3,303908,303908,303911,0,3,1
86801,2,2,303910,303911,303913,1,3,0
86802,6,1,303916,303916,303917,0,1,3
86803,6,1,303922,303922,303923,0,1,5
86804,2,3,303924,303924,303927,0,3,1
86805,3,3,303927,303927,303930,0,3,0
86806,4,2,303931,303931,303933,0,2,1
86807,1,3,303932,303933,303936,1,4,0
86808,4,1,303936,303936,303937,0,1,0
86809,5,1,303941,303941,303942,0,1,4
86810,3,1,303944,303944,303945,0,1,2
86811,4,1,303948,303948,303949,0,1,3
86812,4,1,303952,303952,303953,0,1,3
86813,6,3,303958,303958,303961,0,3,5
86814,5,3,303963,303963,303966,0,3,2
86815,6,3,303969,303969,303972,0,3,3
86816,6,3,303975,303975,303978,0,3,3
86817,2,1,303977,303978,303979,1,2,0
86818,6,1,303983,303983,303984,0,1,4
86819,5,2,303988,303988,303990,0,2,4
86820,3,3,303991,303991,303994,0,3,1
86821,4,2,303995,303995,303997,0,2,1
86822,5,2,304000,304000,304002,0,2,3
86823,3,1,304003,304003,304004,0,1,1
86824,2,2,304005,304005,304007,0,2,1
86825,5,1,304010,304010,304011,0,1,3
86826,2,3,304012,304012,304015,0,3,1
86827,3,3,304015,304015,304018,0,3,0
86828,2,3,304017,304018,304021,1,4,0
86829,2,2,304019,304021,304023,2,4,0
86830,2,1,304021,304023,304024,2,3,0
86831,3,2,304024,304024,304026,0,2,0
86832,3,2,304027,304027,304029,0,2,1
86833,3,1,304030,304030,304031,0,1,1
86834,2,1,304032,304032,304033,0,1,1
86835,2,1,304034,304034,304035,0,1,1
86836,6,3,304040,304040,304043,0,3,5
86837,6,1,304046,304046,304047,0,1,3
86838,5,3,304051,304051,304054,0,3,4
86839,5,2,304056,304056,304058,0,2,2
86840,1,2,304057,304058,304060,1,3,0
86841,4,1,304061,304061,304062,0,1,1
86842,6,3,304067,304067,304070,0,3,5
86843,5,2,304072,304072,304074,0,2,2
86844,5,1,304077,304077,304078,0,1,3
86845,5,2,304082,304082,304084,0,2,4
86846,3,2,304085,304085,304087,0,2,1
86847,2,3,304087,304087,304090,0,3,0
86848,1,3,304088,304090,304093,2,5,0
86849,5,1,304093,304093,304094,0,1,0
86850,6,1,304099,304099,304100,0,1,5
86851,1,1,304100,304100,304101,0,1,0
86852,5,2,304105,304105,304107,0,2,4
86853,3,1,304108,304108,304109,0,1,1
86854,4,1,304112,304112,304113,0,1,3
86855,3,3,304115,304115,304118,0,3,2
86856,3,1,304118,304118,304119,0,1,0
86857,5,3,304123,304123,304126,0,3,4
86858,3,2,304126,304126,304128,0,2,0
86859,3,2,304129,304129,304131,0,2,1
86860,4,3,304133,304133,304136,0,3,2
86861,1,2,304134,304136,304138,2,4,0
86862,2,1,304136,304138,304139,2,3,0
86863,1,1,304137,304139,304140,2,3,0
86864,1,1,304138,304140,304141,2,3,0
86865,6,1,304144,304144,304145,0,1,3
86866,3,3,304147,304147,304150,0,3,2
86867,6,1,304153,304153,304154,0,1,3
86868,5,3,304158,304158,304161,0,3,4
86869,4,1,304162,304162,304163,0,1,1
86870,4,1,304166,304166,304167,0,1,3
86871,4,1,304170,304170,304171,0,1,3
86872,4,3,304174,304174,304177,0,3,3
86873,2,3,304176,304177,304180,1,4,0
86874,6,2,304182,304182,304184,0,2,2
86875,4,1,304186,304186,304187,0,1,2
86876,4,3,304190,304190,304193,0,3,3
86877,1,3,304191,304193,304196,2,5,0
86878,2,2,304193,304196,304198,3,5,0
86879,4,2,304197,304198,304200,1,3,0
86880,1,1,304198,304200,304201,2,3,0
86881,3,1,304201,304201,304202,0,1,0
86882,1,1,304202,304202,304203,0,1,0
86883,1,1,304203,304203,304204,0,1,0
86884,3,1,304206,304206,304207,0,1,2
86885,1,1,304207,304207,304208,0,1,0
86886,3,1,304210,304210,304211,0,1,2
86887,6,1,304216,304216,304217,0,1,5
86888,6,2,304222,304222,304224,0,2,5
86889,3,3,304225,304225,304228,0,3,1
86890,2,1,304227,304228,304229,1,2,0
86891,6,1,304233,304233,304234,0,1,4
86892,4,2,304237,304237,304239,0,2,3
86893,4,3,304241,304241,304244,0,3,2
86894,6,1,304247,304247,304248,0,1,3
86895,5,2,304252,304252,304254,0,2,4
86896,5,1,304257,304257,304258,0,1,3
86897,1,2,304258,304258,304260,0,2,0
86898,2,3,304260,304260,304263,0,3,0
86899,3,3,304263,304263,304266,0,3,0
86900,5,2,304268,304268,304270,0,2,2
86901,1,1,304269,304270,304271,1,2,0
86902,5,1,304274,304274,304275,0,1,3
86903,6,2,304280,304280,304282,0,2,5
86904,2,1,304282,304282,304283,0,1,0
86905,6,3,304288,304288,304291,0,3,5
86906,3,3,304291,304291,304294,0,3,0
86907,1,1,304292,304294,304295,2,3,0
86908,3,3,304295,304295,304298,0,3,0
86909,2,1,304297,304298,304299,1,2,0
86910,5,3,304302,304302,304305,0,3,3
86911,3,3,304305,304305,304308,0,3,0
86912,4,3,304309,304309,304312,0,3,1
86913,4,1,304313,304313,304314,0,1,1
86914,3,1,304316,304316,304317,0,1,2
86915,6,3,304322,304322,304325,0,3,5
86916,2,2,304324,304325,304327,1,3,0
86917,2,2,304326,304327,304329,1,3,0
86918,5,3,304331,304331,304334,0,3,2
86919,4,2,304335,304335,304337,0,2,1
86920,1,1,304336,304337,304338,1,2,0
86921,5,1,304341,304341,304342,0,1,3
86922,3,2,304344,304344,304346,0,2,2
86923,4,2,304348,304348,304350,0,2,2
86924,3,2,304351,304351,304353,0,2,1
86925,5,3,304356,304356,304359,0,3,3
86926,5,2,304361,304361,304363,0,2,2
86927,5,2,304366,304366,304368,0,2,3
86928,2,2,304368,304368,304370,0,2,0
86929,5,1,304373,304373,304374,0,1,3
86930,3,1,304376,304376,304377,0,1,2
86931,6,3,304382,304382,304385,0,3,5
86932,3,2,304385,304385,304387,0,2,0
86933,2,2,304387,304387,304389,0,2,0
86934,3,1,304390,304390,304391,0,1,1
86935,1,1,304391,304391,304392,0,1,0
86936,5,1,304396,304396,304397,0,1,4
86937,6,1,304402,304402,304403,0,1,5
86938,5,3,304407,304407,304410,0,3,4
86939,2,3,304409,304410,304413,1,4,0
86940,4,3,304413,304413,304416,0,3,0
86941,6,2,304419,304419,304421,0,2,3
86942,2,2,304421,304421,304423,0,2,0
86943,4,1,304425,304425,304426,0,1,2
86944,3,1,304428,304428,304429,0,1,2
86945,6,3,304434,304434,304437,0,3,5
86946,3,3,304437,304437,304440,0,3,0
86947,1,1,304438,304440,304441,2,3,0
86948,3,3,304441,304441,304444,0,3,0
86949,1,2,304442,304444,304446,2,4,0
86950,5,2,304447,304447,304449,0,2,1
86951,3,2,304450,304450,304452,0,2,1
86952,2,2,304452,304452,304454,0,2,0
86953,4,3,304456,304456,304459,0,3,2
86954,3,2,304459,304459,304461,0,2,0
86955,3,2,304462,304462,304464,0,2,1
86956,4,1,304466,304466,304467,0,1,2
86957,1,2,304467,304467,304469,0,2,0
86958,1,3,304468,304469,304472,1,4,0
86959,3,3,304471,304472,304475,1,4,0
86960,3,2,304474,304475,304477,1,3,0
86961,1,2,304475,304477,304479,2,4,0
86962,3,3,304478,304479,304482,1,4,0
86963,6,1,304484,304484,304485,0,1,2
86964,5,2,304489,304489,304491,0,2,4
86965,1,2,304490,304491,304493,1,3,0
86966,3,3,304493,304493,304496,0,3,0
86967,3,3,304496,304496,304499,0,3,0
86968,2,3,304498,304499,304502,1,4,0
86969,5,2,304503,304503,304505,0,2,1
86970,6,2,304509,304509,304511,0,2,4
86971,4,3,304513,304513,304516,0,3,2
86972,1,3,304514,304516,304519,2,5,0
86973,5,1,304519,304519,304520,0,1,0
86974,6,2,304525,304525,304527,0,2,5
86975,2,1,304527,304527,304528,0,1,0
86976,1,3,304528,304528,304531,0,3,0
86977,4,3,304532,304532,304535,0,3,1
86978,6,3,304538,304538,304541,0,3,3
86979,3,1,304541,304541,304542,0,1,0
86980,2,2,304543,304543,304545,0,2,1
86981,6,3,304549,304549,304552,0,3,4
86982,1,3,304550,304552,304555,2,5,0
86983,5,1,304555,304555,304556,0,1,0
86984,2,3,304557,304557,304560,0,3,1
86985,4,3,304561,304561,304564,0,3,1
86986,3,3,304564,304564,304567,0,3,0
86987,6,3,304570,304570,304573,0,3,3
86988,6,1,304576,304576,304577,0,1,3
86989,5,2,304581,304581,304583,0,2,4
86990,5,1,304586,304586,304587,0,1,3
86991,2,3,304588,304588,304591,0,3,1
86992,3,1,304591,304591,304592,0,1,0
86993,4,2,304595,304595,304597,0,2,3
86994,4,1,304599,304599,304600,0,1,2
86995,5,2,304604,304604,304606,0,2,4
86996,1,2,304605,304606,304608,1,3,0
86997,5,1,304610,304610,304611,0,1,2
86998,5,2,304615,304615,304617,0,2,4
86999,5,1,304620,304620,304621,0,1,3
87000,4,1,304624,304624,304625,0,1,3
87001,3,2,304627,304627,304629,0,2,2
87002,1,3,304628,304629,304632,1,4,0
87003,6,2,304634,304634,304636,0,2,2
87004,1,3,304635,304636,304639,1,4,0
87005,6,2,304641,304641,304643,0,2,2
87006,3,1,304644,304644,304645,0,1,1
87007,3,1,304647,304647,304648,0,1,2
87008,2,2,304649,304649,304651,0,2,1
87009,6,1,304655,304655,304656,0,1,4
87010,6,3,304661,304661,304664,0,3,5
87011,5,1,304666,304666,304667,0,1,2
87012,6,2,304672,304672,304674,0,2,5
87013,6,3,304678,304678,304681,0,3,4
87014,4,3,304682,304682,304685,0,3,1
87015,5,1,304687,304687,304688,0,1,2
87016,4,1,304691,304691,304692,0,1,3
87017,2,2,304693,304693,304695,0,2,1
87018,2,3,304695,304695,304698,0,3,0
87019,6,2,304701,304701,304703,0,2,3
87020,3,2,304704,304704,304706,0,2,1
87021,5,1,304709,304709,304710,0,1,3
87022,3,3,304712,304712,304715,0,3,2
87023,3,2,304715,304715,304717,0,2,0
87024,6,3,304721,304721,304724,0,3,4
87025,6,3,304727,304727,304730,0,3,3
87026,1,3,304728,304730,304733,2,5,0
87027,1,1,304729,304733,304734,4,5,0
87028,2,2,304731,304734,304736,3,5,0
87029,1,3,304732,304736,304739,4,7,0
87030,3,3,304735,304739,304742,4,7,0
87031,1,2,304736,304742,304744,6,8,0
87032,3,1,304739,304744,304745,5,6,0
87033,3,2,304742,304745,304747,3,5,0
87034,3,1,304745,304747,304748,2,3,0
87035,4,3,304749,304749,304752,0,3,1
87036,2,3,304751,304752,304755,1,4,0
87037,6,1,304757,304757,304758,0,1,2
87038,4,3,304761,304761,304764,0,3,3
87039,3,3,304764,304764,304767,0,3,0
87040,5,3,304769,304769,304772,0,3,2
87041,6,1,304775,304775,304776,0,1,3
87042,5,3,304780,304780,304783,0,3,4
87043,2,1,304782,304783,304784,1,2,0
87044,5,2,304787,304787,304789,0,2,3
87045,1,2,304788,304789,304791,1,3,0
87046,3,3,304791,304791,304794,0,3,0
87047,1,3,304792,304794,304797,2,5,0
87048,6,2,304798,304798,304800,0,2,1
87049,2,3,304800,304800,304803,0,3,0
87050,2,2,304802,304803,304805,1,3,0
87051,3,1,304805,304805,304806,0,1,0
87052,2,2,304807,304807,304809,0,2,1
87053,2,3,304809,304809,304812,0,3,0
87054,2,2,304811,304812,304814,1,3,0
87055,6,1,304817,304817,304818,0,1,3
87056,4,3,304821,304821,304824,0,3,3
87057,5,2,304826,304826,304828,0,2,2
87058,2,2,304828,304828,304830,0,2,0
87059,2,2,304830,304830,304832,0,2,0
87060,3,1,304833,304833,304834,0,1,1
87061,5,1,304838,304838,304839,0,1,4
87062,1,1,304839,304839,304840,0,1,0
87063,4,2,304843,304843,304845,0,2,3
87064,2,1,304845,304845,304846,0,1,0
87065,3,1,304848,304848,304849,0,1,2
87066,5,2,304853,304853,304855,0,2,4
87067,6,2,304859,304859,304861,0,2,4
87068,4,3,304863,304863,304866,0,3,2
87069,4,2,304867,304867,304869,0,2,1
87070,2,1,304869,304869,304870,0,1,0
87071,6,1,304875,304875,304876,0,1,5
87072,3,2,304878,304878,304880,0,2,2
87073,5,2,304883,304883,304885,0,2,3
87074,2,2,304885,304885,304887,0,2,0
87075,1,3,304886,304887,304890,1,4,0
87076,5,1,304891,304891,304892,0,1,1
87077,2,2,304893,304893,304895,0,2,1
87078,4,2,304897,304897,304899,0,2,2
87079,4,1,304901,304901,304902,0,1,2
87080,2,2,304903,304903,304905,0,2,1
87081,1,3,304904,304905,304908,1,4,0
87082,4,2,304908,304908,304910,0,2,0
87083,3,3,304911,304911,304914,0,3,1
87084,3,1,304914,304914,304915,0,1,0
87085,4,1,304918,304918,304919,0,1,3
87086,5,3,304923,304923,304926,0,3,4
87087,1,1,304924,304926,304927,2,3,0
87088,2,2,304926,304927,304929,1,3,0
87089,1,1,304927,304929,304930,2,3,0
87090,5,1,304932,304932,304933,0,1,2
87091,1,1,304933,304933,304934,0,1,0
87092,2,2,304935,304935,304937,0,2,1
87093,6,2,304941,304941,304943,0,2,4
87094,4,1,304945,304945,304946,0,1,2
87095,2,3,304947,304947,304950,0,3,1
87096,6,3,304953,304953,304956,0,3,3
87097,2,1,304955,304956,304957,1,2,0
87098,4,3,304959,304959,304962,0,3,2
87099,3,1,304962,304962,304963,0,1,0
87100,5,1,304967,304967,304968,0,1,4
87101,1,2,304968,304968,304970,0,2,0
87102,1,1,304969,304970,304971,1,2,0
87103,3,2,304972,304972,304974,0,2,1
87104,1,2,304973,304974,304976,1,3,0
87105,5,2,304978,304978,304980,0,2,2
87106,4,3,304982,304982,304985,0,3,2
87107,2,2,304984,304985,304987,1,3,0
87108,1,1,304985,304987,304988,2,3,0
87109,5,3,304990,304990,304993,0,3,2
87110,5,2,304995,304995,304997,0,2,2
87111,1,1,304996,304997,304998,1,2,0
87112,1,3,304997,304998,305001,1,4,0
87113,4,3,305001,305001,305004,0,3,0
87114,5,1,305006,305006,305007,0,1,2
87115,4,1,305010,305010,305011,0,1,3
87116,4,1,305014,305014,305015,0,1,3
87117,2,3,305016,305016,305019,0,3,1
87118,4,2,305020,305020,305022,0,2,1
87119,3,1,305023,305023,305024,0,1,1
87120,2,2,305025,305025,305027,0,2,1
87121,2,1,305027,305027,305028,0,1,0
87122,6,3,305033,305033,305036,0,3,5
87123,6,1,305039,305039,305040,0,1,3
87124,5,3,305044,305044,305047,0,3,4
87125,2,1,305046,305047,305048,1,2,0
87126,2,3,305048,305048,305051,0,3,0
87127,1,2,305049,305051,305053,2,4,0
87128,1,1,305050,305053,305054,3,4,0
87129,3,2,305053,305054,305056,1,3,0
87130,5,3,305058,305058,305061,0,3,2
87131,1,1,305059,305061,305062,2,3,0
87132,5,2,305064,305064,305066,0,2,2
87133,4,2,305068,305068,305070,0,2,2
87134,2,2,305070,305070,305072,0,2,0
87135,3,3,305073,305073,305076,0,3,1
87136,3,1,305076,305076,305077,0,1,0
87137,3,1,305079,305079,305080,0,1,2
87138,3,2,305082,305082,305084,0,2,2
87139,2,1,305084,305084,305085,0,1,0
87140,2,2,305086,305086,305088,0,2,1
87141,2,1,305088,305088,305089,0,1,0
87142,5,2,305093,305093,305095,0,2,4
87143,1,2,305094,305095,305097,1,3,0
87144,5,2,305099,305099,305101,0,2,2
87145,6,2,305105,305105,305107,0,2,4
87146,4,1,305109,305109,305110,0,1,2
87147,5,1,305114,305114,305115,0,1,4
87148,3,3,305117,305117,305120,0,3,2
87149,1,2,305118,305120,305122,2,4,0
87150,6,2,305124,305124,305126,0,2,2
87151,3,2,305127,305127,305129,0,2,1
87152,3,3,305130,305130,305133,0,3,1
87153,2,1,305132,305133,305134,1,2,0
87154,1,2,305133,305134,305136,1,3,0
87155,4,1,305137,305137,305138,0,1,1
87156,6,1,305143,305143,305144,0,1,5
87157,4,3,305147,305147,305150,0,3,3
87158,1,2,305148,305150,305152,2,4,0
87159,5,1,305153,305153,305154,0,1,1
87160,1,3,305154,305154,305157,0,3,0
87161,6,2,305160,305160,305162,0,2,3
87162,6,2,305166,305166,305168,0,2,4
87163,5,1,305171,305171,305172,0,1,3
87164,5,2,305176,305176,305178,0,2,4
87165,6,2,305182,305182,305184,0,2,4
87166,5,1,305187,305187,305188,0,1,3
87167,5,3,305192,305192,305195,0,3,4
87168,1,3,305193,305195,305198,2,5,0
87169,1,1,305194,305198,305199,4,5,0
87170,4,1,305198,305199,305200,1,2,0
87171,4,1,305202,305202,305203,0,1,2
87172,2,2,305204,305204,305206,0,2,1
87173,4,2,305208,305208,305210,0,2,2
87174,5,2,305213,305213,305215,0,2,3
87175,4,1,305217,305217,305218,0,1,2
87176,6,2,305223,305223,305225,0,2,5
87177,1,2,305224,305225,305227,1,3,0
87178,1,2,305225,305227,305229,2,4,0
87179,1,1,305226,305229,305230,3,4,0
87180,1,1,305227,305230,305231,3,4,0
87181,3,2,305230,305231,305233,1,3,0
87182,6,2,305236,305236,305238,0,2,3
87183,2,2,305238,305238,305240,0,2,0
87184,2,2,305240,305240,305242,0,2,0
87185,5,1,305245,305245,305246,0,1,3
87186,4,3,305249,305249,305252,0,3,3
87187,6,1,305255,305255,305256,0,1,3
87188,6,3,305261,305261,305264,0,3,5
87189,1,3,305262,305264,305267,2,5,0
87190,6,2,305268,305268,305270,0,2,1
87191,6,2,305274,305274,305276,0,2,4
87192,6,1,305280,305280,305281,0,1,4
87193,1,1,305281,305281,305282,0,1,0
87194,1,3,305282,305282,305285,0,3,0
87195,1,3,305283,305285,305288,2,5,0
87196,6,3,305289,305289,305292,0,3,1
87197,6,1,305295,305295,305296,0,1,3
87198,5,1,305300,305300,305301,0,1,4
87199,4,2,305304,305304,305306,0,2,3
87200,3,2,305307,305307,305309,0,2,1
87201,2,1,305309,305309,305310,0,1,0
87202,5,3,305314,305314,305317,0,3,4
87203,5,2,305319,305319,305321,0,2,2
87204,4,1,305323,305323,305324,0,1,2
87205,6,2,305329,305329,305331,0,2,5
87206,2,1,305331,305331,305332,0,1,0
87207,2,2,305333,305333,305335,0,2,1
87208,5,3,305338,305338,305341,0,3,3
87209,2,3,305340,305341,305344,1,4,0
87210,3,2,305343,305344,305346,1,3,0
87211,5,2,305348,305348,305350,0,2,2
87212,2,1,305350,305350,305351,0,1,0
87213,2,2,305352,305352,305354,0,2,1
87214,6,1,305358,305358,305359,0,1,4
87215,5,2,305363,305363,305365,0,2,4
87216,4,3,305367,305367,305370,0,3,2
87217,5,1,305372,305372,305373,0,1,2
87218,2,1,305374,305374,305375,0,1,1
87219,4,3,305378,305378,305381,0,3,3
87220,1,2,305379,305381,305383,2,4,0
87221,3,1,305382,305383,305384,1,2,0
87222,6,1,305388,305388,305389,0,1,4
87223,6,1,305394,305394,305395,0,1,5
87224,4,3,305398,305398,305401,0,3,3
87225,5,1,305403,305403,305404,0,1,2
87226,5,1,305408,305408,305409,0,1,4
87227,4,2,305412,305412,305414,0,2,3
87228,1,1,305413,305414,305415,1,2,0
87229,6,2,305419,305419,305421,0,2,4
87230,4,2,305423,305423,305425,0,2,2
87231,2,2,305425,305425,305427,0,2,0
87232,5,3,305430,305430,305433,0,3,3
87233,6,2,305436,305436,305438,0,2,3
87234,4,3,305440,305440,305443,0,3,2
87235,4,1,305444,305444,305445,0,1,1
87236,1,2,305445,305445,305447,0,2,0
87237,2,1,305447,305447,305448,0,1,0
87238,3,1,305450,305450,305451,0,1,2
87239,3,3,305453,305453,305456,0,3,2
87240,2,2,305455,305456,305458,1,3,0
87241,4,1,305459,305459,305460,0,1,1
87242,5,1,305464,305464,305465,0,1,4
87243,4,2,305468,305468,305470,0,2,3
87244,1,1,305469,305470,305471,1,2,0
87245,2,1,305471,305471,305472,0,1,0
87246,2,2,305473,305473,305475,0,2,1
87247,3,1,305476,305476,305477,0,1,1
87248,1,2,305477,305477,305479,0,2,0
87249,6,3,305483,305483,305486,0,3,4
87250,1,1,305484,305486,305487,2,3,0
87251,2,2,305486,305487,305489,1,3,0
87252,5,1,305491,305491,305492,0,1,2
87253,6,1,305497,305497,305498,0,1,5
87254,2,2,305499,305499,305501,0,2,1
87255,3,3,305502,305502,305505,0,3,1
87256,2,2,305504,305505,305507,1,3,0
87257,5,1,305509,305509,305510,0,1,2
87258,3,1,305512,305512,305513,0,1,2
87259,2,2,305514,305514,305516,0,2,1
87260,1,2,305515,305516,305518,1,3,0
87261,3,1,305518,305518,305519,0,1,0
87262,4,1,305522,305522,305523,0,1,3
87263,2,2,305524,305524,305526,0,2,1
87264,2,2,305526,305526,305528,0,2,0
87265,5,2,305531,305531,305533,0,2,3
87266,2,2,305533,305533,305535,0,2,0
87267,4,3,305537,305537,305540,0,3,2
87268,6,1,305543,305543,305544,0,1,3
87269,2,1,305545,305545,305546,0,1,1
87270,5,3,305550,305550,305553,0,3,4
87271,4,1,305554,305554,305555,0,1,1
87272,4,2,305558,305558,305560,0,2,3
87273,5,1,305563,305563,305564,0,1,3
87274,4,1,305567,305567,305568,0,1,3
87275,2,3,305569,305569,305572,0,3,1
87276,2,3,305571,305572,305575,1,4,0
87277,2,1,305573,305575,305576,2,3,0
87278,4,1,305577,305577,305578,0,1,1
87279,5,3,305582,305582,305585,0,3,4
87280,1,1,305583,305585,305586,2,3,0
87281,1,2,305584,305586,305588,2,4,0
87282,2,3,305586,305588,305591,2,5,0
87283,2,2,305588,305591,305593,3,5,0
87284,2,2,305590,305593,305595,3,5,0
87285,6,3,305596,305596,305599,0,3,1
87286,5,3,305601,305601,305604,0,3,2
87287,4,2,305605,305605,305607,0,2,1
87288,6,1,305611,305611,305612,0,1,4
87289,1,3,305612,305612,305615,0,3,0
87290,3,3,305615,305615,305618,0,3,0
87291,4,3,305619,305619,305622,0,3,1
87292,2,1,305621,305622,305623,1,2,0
87293,5,1,305626,305626,305627,0,1,3
87294,3,1,305629,305629,305630,0,1,2
87295,6,3,305635,305635,305638,0,3,5
87296,1,3,305636,305638,305641,2,5,0
87297,1,3,305637,305641,305644,4,7,0
87298,6,3,305643,305644,305647,1,4,0
87299,1,1,305644,305647,305648,3,4,0
87300,6,3,305650,305650,305653,0,3,2
87301,1,2,305651,305653,305655,2,4,0
87302,1,1,305652,305655,305656,3,4,0
87303,3,3,305655,305656,305659,1,4,0
87304,4,3,305659,305659,305662,0,3,0
87305,5,3,305664,305664,305667,0,3,2
87306,4,3,305668,305668,305671,0,3,1
87307,1,2,305669,305671,305673,2,4,0
87308,3,2,305672,305673,305675,1,3,0
87309,4,2,305676,305676,305678,0,2,1
87310,6,1,305682,305682,305683,0,1,4
87311,3,2,305685,305685,305687,0,2,2
87312,4,1,305689,305689,305690,0,1,2
87313,2,3,305691,305691,305694,0,3,1
87314,6,1,305697,305697,305698,0,1,3
87315,6,2,305703,305703,305705,0,2,5
87316,1,3,305704,305705,305708,1,4,0
87317,3,1,305707,305708,305709,1,2,0
87318,6,1,305713,305713,305714,0,1,4
87319,5,1,305718,305718,305719,0,1,4
87320,5,3,305723,305723,305726,0,3,4
87321,4,2,305727,305727,305729,0,2,1
87322,3,1,305730,305730,305731,0,1,1
87323,5,2,305735,305735,305737,0,2,4
87324,6,2,305741,305741,305743,0,2,4
87325,2,2,305743,305743,305745,0,2,0
87326,5,3,305748,305748,305751,0,3,3
87327,6,2,305754,305754,305756,0,2,3
87328,6,3,305760,305760,305763,0,3,4
87329,5,1,305765,305765,305766,0,1,2
87330,4,3,305769,305769,305772,0,3,3
87331,2,3,305771,305772,305775,1,4,0
87332,6,2,305777,305777,305779,0,2,2
87333,4,1,305781,305781,305782,0,1,2
87334,2,3,305783,305783,305786,0,3,1
87335,6,3,305789,305789,305792,0,3,3
87336,5,3,305794,305794,305797,0,3,2
87337,5,2,305799,305799,305801,0,2,2
87338,3,3,305802,305802,305805,0,3,1
87339,6,3,305808,305808,305811,0,3,3
87340,6,2,305814,305814,305816,0,2,3
87341,1,2,305815,305816,305818,1,3,0
87342,2,3,305817,305818,305821,1,4,0
87343,1,3,305818,305821,305824,3,6,0
87344,1,1,305819,305824,305825,5,6,0
87345,3,2,305822,305825,305827,3,5,0
87346,2,2,305824,305827,305829,3,5,0
87347,2,2,305826,305829,305831,3,5,0
87348,2,1,305828,305831,305832,3,4,0
87349,5,2,305833,305833,305835,0,2,1
87350,3,2,305836,305836,305838,0,2,1
87351,3,3,305839,305839,305842,0,3,1
87352,6,3,305845,305845,305848,0,3,3
87353,6,1,305851,305851,305852,0,1,3
87354,5,3,305856,305856,305859,0,3,4
87355,2,1,305858,305859,305860,1,2,0
87356,4,1,305862,305862,305863,0,1,2
87357,1,1,305863,305863,305864,0,1,0
87358,2,1,305865,305865,305866,0,1,1
87359,4,1,305869,305869,305870,0,1,3
87360,3,3,305872,305872,305875,0,3,2
87361,4,1,305876,305876,305877,0,1,1
87362,5,1,305881,305881,305882,0,1,4
87363,4,1,305885,305885,305886,0,1,3
87364,2,1,305887,305887,305888,0,1,1
87365,2,1,305889,305889,305890,0,1,1
87366,2,2,305891,305891,305893,0,2,1
87367,1,1,305892,305893,305894,1,2,0
87368,3,3,305895,305895,305898,0,3,1
87369,5,1,305900,305900,305901,0,1,2
87370,4,3,305904,305904,305907,0,3,3
87371,5,2,305909,305909,305911,0,2,2
87372,5,3,305914,305914,305917,0,3,3
87373,1,3,305915,305917,305920,2,5,0
87374,4,1,305919,305920,305921,1,2,0
87375,1,3,305920,305921,305924,1,4,0
87376,6,1,305926,305926,305927,0,1,2
87377,6,1,305932,305932,305933,0,1,5
87378,2,1,305934,305934,305935,0,1,1
87379,6,2,305940,305940,305942,0,2,5
87380,2,1,305942,305942,305943,0,1,0
87381,6,1,305948,305948,305949,0,1,5
87382,5,2,305953,305953,305955,0,2,4
87383,3,1,305956,305956,305957,0,1,1
87384,6,2,305962,305962,305964,0,2,5
87385,1,3,305963,305964,305967,1,4,0
87386,6,2,305969,305969,305971,0,2,2
87387,3,2,305972,305972,305974,0,2,1
87388,5,3,305977,305977,305980,0,3,3
87389,1,1,305978,305980,305981,2,3,0
87390,5,3,305983,305983,305986,0,3,2
87391,6,2,305989,305989,305991,0,2,3
87392,5,1,305994,305994,305995,0,1,3
87393,2,1,305996,305996,305997,0,1,1
87394,5,3,306001,306001,306004,0,3,4
87395,2,2,306003,306004,306006,1,3,0
87396,2,3,306005,306006,306009,1,4,0
87397,1,2,306006,306009,306011,3,5,0
87398,3,3,306009,306011,306014,2,5,0
87399,6,1,306015,306015,306016,0,1,1
87400,1,3,306016,306016,306019,0,3,0
87401,1,1,306017,306019,306020,2,3,0
87402,5,1,306022,306022,306023,0,1,2
87403,5,2,306027,306027,306029,0,2,4
87404,5,2,306032,306032,306034,0,2,3
87405,6,2,306038,306038,306040,0,2,4
87406,6,3,306044,306044,306047,0,3,4
87407,2,2,306046,306047,306049,1,3,0
87408,2,2,306048,306049,306051,1,3,0
87409,3,1,306051,306051,306052,0,1,0
87410,2,3,306053,306053,306056,0,3,1
87411,3,3,306056,306056,306059,0,3,0
87412,5,3,306061,306061,306064,0,3,2
87413,3,1,306064,306064,306065,0,1,0
87414,5,3,306069,306069,306072,0,3,4
87415,4,3,306073,306073,306076,0,3,1
87416,4,2,306077,306077,306079,0,2,1
87417,6,3,306083,306083,306086,0,3,4
87418,4,1,306087,306087,306088,0,1,1
87419,5,2,306092,306092,306094,0,2,4
87420,4,2,306096,306096,306098,0,2,2
87421,5,1,306101,306101,306102,0,1,3
87422,4,2,306105,306105,306107,0,2,3
87423,1,1,306106,306107,306108,1,2,0
87424,5,2,306111,306111,306113,0,2,3
87425,2,1,306113,306113,306114,0,1,0
87426,5,1,306118,306118,306119,0,1,4
87427,5,3,306123,306123,306126,0,3,4
87428,3,3,306126,306126,306129,0,3,0
87429,2,2,306128,306129,306131,1,3,0
87430,1,2,306129,306131,306133,2,4,0
87431,6,3,306135,306135,306138,0,3,2
87432,4,1,306139,306139,306140,0,1,1
87433,6,3,306145,306145,306148,0,3,5
87434,3,3,306148,306148,306151,0,3,0
87435,2,3,306150,306151,306154,1,4,0
87436,6,3,306156,306156,306159,0,3,2
87437,3,2,306159,306159,306161,0,2,0
87438,1,3,306160,306161,306164,1,4,0
87439,5,1,306165,306165,306166,0,1,1
87440,4,2,306169,306169,306171,0,2,3
87441,1,1,306170,306171,306172,1,2,0
87442,1,2,306171,306172,306174,1,3,0
87443,2,1,306173,306174,306175,1,2,0
87444,3,1,306176,306176,306177,0,1,1
87445,1,2,306177,306177,306179,0,2,0
87446,6,1,306183,306183,306184,0,1,4
87447,6,2,306189,306189,306191,0,2,5
87448,6,3,306195,306195,306198,0,3,4
87449,4,3,306199,306199,306202,0,3,1
87450,1,3,306200,306202,306205,2,5,0
87451,1,3,306201,306205,306208,4,7,0
87452,5,2,306206,306208,306210,2,4,0
87453,4,2,306210,306210,306212,0,2,0
87454,4,3,306214,306214,306217,0,3,2
87455,3,1,306217,306217,306218,0,1,0
87456,2,1,306219,306219,306220,0,1,1
87457,1,1,306220,306220,306221,0,1,0
87458,4,3,306224,306224,306227,0,3,3
87459,4,1,306228,306228,306229,0,1,1
87460,5,1,306233,306233,306234,0,1,4
87461,2,1,306235,306235,306236,0,1,1
87462,5,3,306240,306240,306243,0,3,4
87463,3,1,306243,306243,306244,0,1,0
87464,2,3,306245,306245,306248,0,3,1
87465,5,1,306250,306250,306251,0,1,2
87466,5,1,306255,306255,306256,0,1,4
87467,1,1,306256,306256,306257,0,1,0
87468,1,1,306257,306257,306258,0,1,0
87469,2,1,306259,306259,306260,0,1,1
87470,2,2,306261,306261,306263,0,2,1
87471,5,2,306266,306266,306268,0,2,3
87472,4,2,306270,306270,306272,0,2,2
87473,2,1,306272,306272,306273,0,1,0
87474,6,3,306278,306278,306281,0,3,5
87475,5,2,306283,306283,306285,0,2,2
87476,3,2,306286,306286,306288,0,2,1
87477,2,2,306288,306288,306290,0,2,0
87478,6,1,306294,306294,306295,0,1,4
87479,6,1,306300,306300,306301,0,1,5
87480,3,3,306303,306303,306306,0,3,2
87481,5,3,306308,306308,306311,0,3,2
87482,6,2,306314,306314,306316,0,2,3
87483,3,1,306317,306317,306318,0,1,1
87484,4,3,306321,306321,306324,0,3,3
87485,6,1,306327,306327,306328,0,1,3
87486,2,3,306329,306329,306332,0,3,1
87487,5,3,306334,306334,306337,0,3,2
87488,1,1,306335,306337,306338,2,3,0
87489,2,1,306337,306338,306339,1,2,0
87490,4,3,306341,306341,306344,0,3,2
87491,1,1,306342,306344,306345,2,3,0
87492,6,3,306348,306348,306351,0,3,3
87493,4,2,306352,306352,306354,0,2,1
87494,2,3,306354,306354,306357,0,3,0
87495,6,3,306360,306360,306363,0,3,3
87496,6,1,306366,306366,306367,0,1,3
87497,2,2,306368,306368,306370,0,2,1
87498,5,1,306373,306373,306374,0,1,3
87499,6,1,306379,306379,306380,0,1,5
87500,1,1,306380,306380,306381,0,1,0
87501,5,1,306385,306385,306386,0,1,4
87502,6,3,306391,306391,306394,0,3,5
87503,1,1,306392,306394,306395,2,3,0
87504,6,1,306398,306398,306399,0,1,3
87505,3,3,306401,306401,306404,0,3,2
87506,1,3,306402,306404,306407,2,5,0
87507,6,2,306408,306408,306410,0,2,1
87508,4,1,306412,306412,306413,0,1,2
87509,2,1,306414,306414,306415,0,1,1
87510,2,3,306416,306416,306419,0,3,1
87511,6,2,306422,306422,306424,0,2,3
87512,5,1,306427,306427,306428,0,1,3
87513,3,1,306430,306430,306431,0,1,2
87514,3,3,306433,306433,306436,0,3,2
87515,1,1,306434,306436,306437,2,3,0
87516,2,3,306436,306437,306440,1,4,0
87517,2,3,306438,306440,306443,2,5,0
87518,1,1,306439,306443,306444,4,5,0
87519,2,2,306441,306444,306446,3,5,0
87520,6,3,306447,306447,306450,0,3,1
87521,4,2,306451,306451,306453,0,2,1
87522,4,3,306455,306455,306458,0,3,2
87523,6,1,306461,306461,306462,0,1,3
87524,3,1,306464,306464,306465,0,1,2
87525,2,3,306466,306466,306469,0,3,1
87526,1,2,306467,306469,306471,2,4,0
87527,3,3,306470,306471,306474,1,4,0
87528,2,3,306472,306474,306477,2,5,0
87529,1,2,306473,306477,306479,4,6,0
87530,5,3,306478,306479,306482,1,4,0
87531,5,1,306483,306483,306484,0,1,1
87532,6,1,306489,306489,306490,0,1,5
87533,2,3,306491,306491,306494,0,3,1
87534,1,3,306492,306494,306497,2,5,0
87535,2,3,306494,306497,306500,3,6,0
87536,2,2,306496,306500,306502,4,6,0
87537,3,1,306499,306502,306503,3,4,0
87538,3,1,306502,306503,306504,1,2,0
87539,2,1,306504,306504,306505,0,1,0
87540,6,3,306510,306510,306513,0,3,5
87541,4,2,306514,306514,306516,0,2,1
87542,5,3,306519,306519,306522,0,3,3
87543,3,2,306522,306522,306524,0,2,0
87544,3,1,306525,306525,306526,0,1,1
87545,5,2,306530,306530,306532,0,2,4
87546,3,1,306533,306533,306534,0,1,1
87547,6,2,306539,306539,306541,0,2,5
87548,6,1,306545,306545,306546,0,1,4
87549,5,3,306550,306550,306553,0,3,4
87550,5,3,306555,306555,306558,0,3,2
87551,2,1,306557,306558,306559,1,2,0
87552,3,1,306560,306560,306561,0,1,1
87553,1,3,306561,306561,306564,0,3,0
87554,5,2,306566,306566,306568,0,2,2
87555,4,3,306570,306570,306573,0,3,2
87556,5,3,306575,306575,306578,0,3,2
87557,1,2,306576,306578,306580,2,4,0
87558,5,1,306581,306581,306582,0,1,1
87559,5,3,306586,306586,306589,0,3,4
87560,4,3,306590,306590,306593,0,3,1
87561,4,3,306594,306594,306597,0,3,1
87562,4,2,306598,306598,306600,0,2,1
87563,1,3,306599,306600,306603,1,4,0
87564,6,1,306605,306605,306606,0,1,2
87565,1,3,306606,306606,306609,0,3,0
87566,1,2,306607,306609,306611,2,4,0
87567,4,3,306611,306611,306614,0,3,0
87568,3,3,306614,306614,306617,0,3,0
87569,1,1,306615,306617,306618,2,3,0
87570,6,1,306621,306621,306622,0,1,3
87571,3,2,306624,306624,306626,0,2,2
87572,2,1,306626,306626,306627,0,1,0
87573,6,2,306632,306632,306634,0,2,5
87574,2,2,306634,306634,306636,0,2,0
87575,5,2,306639,306639,306641,0,2,3
87576,4,3,306643,306643,306646,0,3,2
87577,1,3,306644,306646,306649,2,5,0
87578,1,1,306645,306649,306650,4,5,0
87579,6,1,306651,306651,306652,0,1,1
87580,6,2,306657,306657,306659,0,2,5
87581,2,3,306659,306659,306662,0,3,0
87582,1,2,306660,306662,306664,2,4,0
87583,4,2,306664,306664,306666,0,2,0
87584,6,1,306670,306670,306671,0,1,4
87585,6,2,306676,306676,306678,0,2,5
87586,1,1,306677,306678,306679,1,2,0
87587,5,1,306682,306682,306683,0,1,3
87588,1,1,306683,306683,306684,0,1,0
87589,6,2,306689,306689,306691,0,2,5
87590,2,3,306691,306691,306694,0,3,0
87591,2,2,306693,306694,306696,1,3,0
87592,1,1,306694,306696,306697,2,3,0
87593,2,1,306696,306697,306698,1,2,0
87594,2,1,306698,306698,306699,0,1,0
87595,4,2,306702,306702,306704,0,2,3
87596,6,1,306708,306708,306709,0,1,4
87597,2,3,306710,306710,306713,0,3,1
87598,6,2,306716,306716,306718,0,2,3
87599,5,3,306721,306721,306724,0,3,3
87600,1,3,306722,306724,306727,2,5,0
87601,3,1,306725,306727,306728,2,3,0
87602,1,1,306726,306728,306729,2,3,0
87603,3,3,306729,306729,306732,0,3,0
87604,2,2,306731,306732,306734,1,3,0
87605,1,1,306732,306734,306735,2,3,0
87606,4,2,306736,306736,306738,0,2,1
87607,6,3,306742,306742,306745,0,3,4
87608,4,1,306746,306746,306747,0,1,1
87609,2,1,306748,306748,306749,0,1,1
87610,3,2,306751,306751,306753,0,2,2
87611,2,2,306753,306753,306755,0,2,0
87612,4,2,306757,306757,306759,0,2,2
87613,5,2,306762,306762,306764,0,2,3
87614,2,1,306764,306764,306765,0,1,0
87615,2,2,306766,306766,306768,0,2,1
87616,3,3,306769,306769,306772,0,3,1
87617,4,2,306773,306773,306775,0,2,1
87618,1,1,306774,306775,306776,1,2,0
87619,4,3,306778,306778,306781,0,3,2
87620,4,2,306782,306782,306784,0,2,1
87621,3,3,306785,306785,306788,0,3,1
87622,2,1,306787,306788,306789,1,2,0
87623,1,3,306788,306789,306792,1,4,0
87624,2,1,306790,306792,306793,2,3,0
87625,1,1,306791,306793,306794,2,3,0
87626,5,2,306796,306796,306798,0,2,2
87627,2,2,306798,306798,306800,0,2,0
87628,6,2,306804,306804,306806,0,2,4
87629,4,3,306808,306808,306811,0,3,2
87630,1,3,306809,306811,306814,2,5,0
87631,3,1,306812,306814,306815,2,3,0
87632,1,2,306813,306815,306817,2,4,0
87633,5,2,306818,306818,306820,0,2,1
87634,6,3,306824,306824,306827,0,3,4
87635,4,2,306828,306828,306830,0,2,1
87636,1,1,306829,306830,306831,1,2,0
87637,3,3,306832,306832,306835,0,3,1
87638,1,3,306833,306835,306838,2,5,0
87639,3,2,306836,306838,306840,2,4,0
87640,6,1,306842,306842,306843,0,1,2
87641,4,1,306846,306846,306847,0,1,3
87642,3,1,306849,306849,306850,0,1,2
87643,6,3,306855,306855,306858,0,3,5
87644,6,3,306861,306861,306864,0,3,3
87645,6,1,306867,306867,306868,0,1,3
87646,5,3,306872,306872,306875,0,3,4
87647,4,3,306876,306876,306879,0,3,1
87648,4,2,306880,306880,306882,0,2,1
87649,5,3,306885,306885,306888,0,3,3
87650,5,3,306890,306890,306893,0,3,2
87651,3,1,306893,306893,306894,0,1,0
87652,4,3,306897,306897,306900,0,3,3
87653,5,1,306902,306902,306903,0,1,2
87654,4,2,306906,306906,306908,0,2,3
87655,2,2,306908,306908,306910,0,2,0
87656,1,1,306909,306910,306911,1,2,0
87657,2,3,306911,306911,306914,0,3,0
87658,3,2,306914,306914,306916,0,2,0
87659,3,3,306917,306917,306920,0,3,1
87660,1,2,306918,306920,306922,2,4,0
87661,1,2,306919,306922,306924,3,5,0
87662,2,3,306921,306924,306927,3,6,0
87663,4,1,306925,306927,306928,2,3,0
87664,4,1,306929,306929,306930,0,1,1
87665,3,1,306932,306932,306933,0,1,2
87666,2,1,306934,306934,306935,0,1,1
87667,2,3,306936,306936,306939,0,3,1
87668,1,1,306937,306939,306940,2,3,0
87669,2,1,306939,306940,306941,1,2,0
87670,5,1,306944,306944,306945,0,1,3
87671,5,3,306949,306949,306952,0,3,4
87672,4,2,306953,306953,306955,0,2,1
87673,3,3,306956,306956,306959,0,3,1
87674,5,2,306961,306961,306963,0,2,2
87675,1,1,306962,306963,306964,1,2,0
87676,2,3,306964,306964,306967,0,3,0
87677,5,1,306969,306969,306970,0,1,2
87678,3,3,306972,306972,306975,0,3,2
87679,5,3,306977,306977,306980,0,3,2
87680,3,3,306980,306980,306983,0,3,0
87681,4,2,306984,306984,306986,0,2,1
87682,2,1,306986,306986,306987,0,1,0
87683,1,2,306987,306987,306989,0,2,0
87684,6,3,306993,306993,306996,0,3,4
87685,4,1,306997,306997,306998,0,1,1
87686,1,3,306998,306998,307001,0,3,0
87687,2,2,307000,307001,307003,1,3,0
87688,5,3,307005,307005,307008,0,3,2
87689,3,1,307008,307008,307009,0,1,0
87690,3,2,307011,307011,307013,0,2,2
87691,3,2,307014,307014,307016,0,2,1
87692,4,1,307018,307018,307019,0,1,2
87693,4,2,307022,307022,307024,0,2,3
87694,3,2,307025,307025,307027,0,2,1
87695,6,1,307031,307031,307032,0,1,4
87696,1,3,307032,307032,307035,0,3,0
87697,6,1,307038,307038,307039,0,1,3
87698,3,2,307041,307041,307043,0,2,2
87699,4,1,307045,307045,307046,0,1,2
87700,3,1,307048,307048,307049,0,1,2
87701,5,2,307053,307053,307055,0,2,4
87702,4,2,307057,307057,307059,0,2,2
87703,3,1,307060,307060,307061,0,1,1
87704,6,2,307066,307066,307068,0,2,5
87705,6,3,307072,307072,307075,0,3,4
87706,5,3,307077,307077,307080,0,3,2
87707,2,3,307079,307080,307083,1,4,0
87708,1,3,307080,307083,307086,3,6,0
87709,1,1,307081,307086,307087,5,6,0
87710,6,2,307087,307087,307089,0,2,0
87711,6,3,307093,307093,307096,0,3,4
87712,2,3,307095,307096,307099,1,4,0
87713,2,2,307097,307099,307101,2,4,0
87714,4,1,307101,307101,307102,0,1,0
87715,6,1,307107,307107,307108,0,1,5
87716,1,2,307108,307108,307110,0,2,0
87717,2,3,307110,307110,307113,0,3,0
87718,4,1,307114,307114,307115,0,1,1
87719,6,2,307120,307120,307122,0,2,5
87720,1,2,307121,307122,307124,1,3,0
87721,1,1,307122,307124,307125,2,3,0
87722,1,1,307123,307125,307126,2,3,0
87723,6,3,307129,307129,307132,0,3,3
87724,3,3,307132,307132,307135,0,3,0
87725,2,2,307134,307135,307137,1,3,0
87726,4,2,307138,307138,307140,0,2,1
87727,2,1,307140,307140,307141,0,1,0
87728,4,3,307144,307144,307147,0,3,3
87729,6,3,307150,307150,307153,0,3,3
87730,2,3,307152,307153,307156,1,4,0
87731,1,3,307153,307156,307159,3,6,0
87732,5,1,307158,307159,307160,1,2,0
87733,2,3,307160,307160,307163,0,3,0
87734,5,1,307165,307165,307166,0,1,2
87735,1,1,307166,307166,307167,0,1,0
87736,3,2,307169,307169,307171,0,2,2
87737,1,1,307170,307171,307172,1,2,0
87738,5,2,307175,307175,307177,0,2,3
87739,1,3,307176,307177,307180,1,4,0
87740,2,2,307178,307180,307182,2,4,0
87741,4,3,307182,307182,307185,0,3,0
87742,5,1,307187,307187,307188,0,1,2
87743,1,1,307188,307188,307189,0,1,0
87744,1,1,307189,307189,307190,0,1,0
87745,6,3,307195,307195,307198,0,3,5
87746,4,3,307199,307199,307202,0,3,1
87747,5,2,307204,307204,307206,0,2,2
87748,6,3,307210,307210,307213,0,3,4
87749,4,2,307214,307214,307216,0,2,1
87750,1,2,307215,307216,307218,1,3,0
87751,4,1,307219,307219,307220,0,1,1
87752,3,1,307222,307222,307223,0,1,2
87753,5,3,307227,307227,307230,0,3,4
87754,6,1,307233,307233,307234,0,1,3
87755,4,3,307237,307237,307240,0,3,3
87756,4,1,307241,307241,307242,0,1,1
87757,1,2,307242,307242,307244,0,2,0
87758,1,1,307243,307244,307245,1,2,0
87759,5,3,307248,307248,307251,0,3,3
87760,4,3,307252,307252,307255,0,3,1
87761,4,3,307256,307256,307259,0,3,1
87762,4,2,307260,307260,307262,0,2,1
87763,4,2,307264,307264,307266,0,2,2
87764,5,1,307269,307269,307270,0,1,3
87765,3,3,307272,307272,307275,0,3,2
87766,6,3,307278,307278,307281,0,3,3
87767,2,3,307280,307281,307284,1,4,0
87768,5,2,307285,307285,307287,0,2,1
87769,5,1,307290,307290,307291,0,1,3
87770,6,3,307296,307296,307299,0,3,5
87771,4,1,307300,307300,307301,0,1,1
87772,1,2,307301,307301,307303,0,2,0
87773,2,3,307303,307303,307306,0,3,0
87774,3,3,307306,307306,307309,0,3,0
87775,3,2,307309,307309,307311,0,2,0
87776,2,1,307311,307311,307312,0,1,0
87777,3,2,307314,307314,307316,0,2,2
87778,1,2,307315,307316,307318,1,3,0
87779,3,2,307318,307318,307320,0,2,0
87780,5,3,307323,307323,307326,0,3,3
87781,3,1,307326,307326,307327,0,1,0
87782,4,3,307330,307330,307333,0,3,3
87783,6,1,307336,307336,307337,0,1,3
87784,3,3,307339,307339,307342,0,3,2
87785,2,3,307341,307342,307345,1,4,0
87786,1,2,307342,307345,307347,3,5,0
87787,1,2,307343,307347,307349,4,6,0
87788,2,3,307345,307349,307352,4,7,0
87789,3,3,307348,307352,307355,4,7,0
87790,6,1,307354,307355,307356,1,2,0
87791,2,3,307356,307356,307359,0,3,0
87792,5,2,307361,307361,307363,0,2,2
87793,5,1,307366,307366,307367,0,1,3
87794,1,2,307367,307367,307369,0,2,0
87795,3,1,307370,307370,307371,0,1,1
87796,2,3,307372,307372,307375,0,3,1
87797,6,2,307378,307378,307380,0,2,3
87798,4,1,307382,307382,307383,0,1,2
87799,3,2,307385,307385,307387,0,2,2
87800,5,2,307390,307390,307392,0,2,3
87801,4,2,307394,307394,307396,0,2,2
87802,4,2,307398,307398,307400,0,2,2
87803,4,3,307402,307402,307405,0,3,2
87804,4,3,307406,307406,307409,0,3,1
87805,6,1,307412,307412,307413,0,1,3
87806,6,1,307418,307418,307419,0,1,5
87807,1,1,307419,307419,307420,0,1,0
87808,5,2,307424,307424,307426,0,2,4
87809,6,2,307430,307430,307432,0,2,4
87810,2,1,307432,307432,307433,0,1,0
87811,3,3,307435,307435,307438,0,3,2
87812,1,1,307436,307438,307439,2,3,0
87813,3,2,307439,307439,307441,0,2,0
87814,6,3,307445,307445,307448,0,3,4
87815,1,2,307446,307448,307450,2,4,0
87816,4,2,307450,307450,307452,0,2,0
87817,5,2,307455,307455,307457,0,2,3
87818,4,2,307459,307459,307461,0,2,2
87819,2,2,307461,307461,307463,0,2,0
87820,6,2,307467,307467,307469,0,2,4
87821,5,2,307472,307472,307474,0,2,3
87822,5,2,307477,307477,307479,0,2,3
87823,2,2,307479,307479,307481,0,2,0
87824,6,2,307485,307485,307487,0,2,4
87825,2,3,307487,307487,307490,0,3,0
87826,4,1,307491,307491,307492,0,1,1
87827,6,1,307497,307497,307498,0,1,5
87828,2,3,307499,307499,307502,0,3,1
87829,3,1,307502,307502,307503,0,1,0
87830,3,3,307505,307505,307508,0,3,2
87831,2,1,307507,307508,307509,1,2,0
87832,2,3,307509,307509,307512,0,3,0
87833,3,3,307512,307512,307515,0,3,0
87834,6,3,307518,307518,307521,0,3,3
87835,1,3,307519,307521,307524,2,5,0
87836,1,1,307520,307524,307525,4,5,0
87837,5,2,307525,307525,307527,0,2,0
87838,3,1,307528,307528,307529,0,1,1
87839,3,3,307531,307531,307534,0,3,2
87840,6,3,307537,307537,307540,0,3,3
87841,4,1,307541,307541,307542,0,1,1
87842,5,2,307546,307546,307548,0,2,4
87843,4,3,307550,307550,307553,0,3,2
87844,4,1,307554,307554,307555,0,1,1
87845,3,2,307557,307557,307559,0,2,2
87846,4,3,307561,307561,307564,0,3,2
87847,5,2,307566,307566,307568,0,2,2
87848,4,2,307570,307570,307572,0,2,2
87849,5,2,307575,307575,307577,0,2,3
87850,4,1,307579,307579,307580,0,1,2
87851,1,1,307580,307580,307581,0,1,0
87852,1,1,307581,307581,307582,0,1,0
87853,6,1,307587,307587,307588,0,1,5
87854,5,1,307592,307592,307593,0,1,4
87855,3,3,307595,307595,307598,0,3,2
87856,6,1,307601,307601,307602,0,1,3
87857,1,1,307602,307602,307603,0,1,0
87858,2,3,307604,307604,307607,0,3,1
87859,5,2,307609,307609,307611,0,2,2
87860,1,3,307610,307611,307614,1,4,0
87861,6,3,307616,307616,307619,0,3,2
87862,5,1,307621,307621,307622,0,1,2
87863,1,3,307622,307622,307625,0,3,0
87864,2,3,307624,307625,307628,1,4,0
87865,4,1,307628,307628,307629,0,1,0
87866,2,3,307630,307630,307633,0,3,1
87867,4,1,307634,307634,307635,0,1,1
87868,3,3,307637,307637,307640,0,3,2
87869,4,2,307641,307641,307643,0,2,1
87870,6,3,307647,307647,307650,0,3,4
87871,6,3,307653,307653,307656,0,3,3
87872,3,2,307656,307656,307658,0,2,0
87873,4,2,307660,307660,307662,0,2,2
87874,6,2,307666,307666,307668,0,2,4
87875,6,2,307672,307672,307674,0,2,4
87876,1,3,307673,307674,307677,1,4,0
87877,4,2,307677,307677,307679,0,2,0
87878,6,1,307683,307683,307684,0,1,4
87879,5,3,307688,307688,307691,0,3,4
87880,2,3,307690,307691,307694,1,4,0
87881,3,2,307693,307694,307696,1,3,0
87882,4,3,307697,307697,307700,0,3,1
87883,6,3,307703,307703,307706,0,3,3
87884,5,2,307708,307708,307710,0,2,2
87885,5,3,307713,307713,307716,0,3,3
87886,6,2,307719,307719,307721,0,2,3
87887,3,2,307722,307722,307724,0,2,1
87888,2,1,307724,307724,307725,0,1,0
87889,6,2,307730,307730,307732,0,2,5
87890,4,3,307734,307734,307737,0,3,2
87891,1,1,307735,307737,307738,2,3,0
87892,4,1,307739,307739,307740,0,1,1
87893,1,1,307740,307740,307741,0,1,0
87894,4,1,307744,307744,307745,0,1,3
87895,2,2,307746,307746,307748,0,2,1
87896,3,3,307749,307749,307752,0,3,1
87897,6,2,307755,307755,307757,0,2,3
87898,5,1,307760,307760,307761,0,1,3
87899,4,3,307764,307764,307767,0,3,3
87900,5,3,307769,307769,307772,0,3,2
87901,5,2,307774,307774,307776,0,2,2
87902,1,2,307775,307776,307778,1,3,0
87903,1,1,307776,307778,307779,2,3,0
87904,5,1,307781,307781,307782,0,1,2
87905,4,2,307785,307785,307787,0,2,3
87906,3,3,307788,307788,307791,0,3,1
87907,1,2,307789,307791,307793,2,4,0
87908,6,2,307795,307795,307797,0,2,2
87909,2,1,307797,307797,307798,0,1,0
87910,2,2,307799,307799,307801,0,2,1
87911,4,2,307803,307803,307805,0,2,2
87912,5,1,307808,307808,307809,0,1,3
87913,4,2,307812,307812,307814,0,2,3
87914,2,2,307814,307814,307816,0,2,0
87915,5,2,307819,307819,307821,0,2,3
87916,6,1,307825,307825,307826,0,1,4
87917,3,3,307828,307828,307831,0,3,2
87918,1,3,307829,307831,307834,2,5,0
87919,6,2,307835,307835,307837,0,2,1
87920,4,1,307839,307839,307840,0,1,2
87921,5,1,307844,307844,307845,0,1,4
87922,3,1,307847,307847,307848,0,1,2
87923,6,2,307853,307853,307855,0,2,5
87924,5,2,307858,307858,307860,0,2,3
87925,6,1,307864,307864,307865,0,1,4
87926,3,1,307867,307867,307868,0,1,2
87927,6,2,307873,307873,307875,0,2,5
87928,5,3,307878,307878,307881,0,3,3
87929,4,3,307882,307882,307885,0,3,1
87930,2,1,307884,307885,307886,1,2,0
87931,3,2,307887,307887,307889,0,2,1
87932,2,3,307889,307889,307892,0,3,0
87933,5,2,307894,307894,307896,0,2,2
87934,4,2,307898,307898,307900,0,2,2
87935,6,2,307904,307904,307906,0,2,4
87936,5,1,307909,307909,307910,0,1,3
87937,4,3,307913,307913,307916,0,3,3
87938,1,1,307914,307916,307917,2,3,0
87939,5,3,307919,307919,307922,0,3,2
87940,3,3,307922,307922,307925,0,3,0
87941,6,2,307928,307928,307930,0,2,3
87942,2,2,307930,307930,307932,0,2,0
87943,2,2,307932,307932,307934,0,2,0
87944,2,1,307934,307934,307935,0,1,0
87945,2,1,307936,307936,307937,0,1,1
87946,3,2,307939,307939,307941,0,2,2
87947,2,3,307941,307941,307944,0,3,0
87948,6,2,307947,307947,307949,0,2,3
87949,4,1,307951,307951,307952,0,1,2
87950,6,3,307957,307957,307960,0,3,5
87951,5,2,307962,307962,307964,0,2,2
87952,6,2,307968,307968,307970,0,2,4
87953,5,3,307973,307973,307976,0,3,3
87954,3,2,307976,307976,307978,0,2,0
87955,1,3,307977,307978,307981,1,4,0
87956,3,3,307980,307981,307984,1,4,0
87957,5,1,307985,307985,307986,0,1,1
87958,2,3,307987,307987,307990,0,3,1
87959,6,2,307993,307993,307995,0,2,3
87960,2,2,307995,307995,307997,0,2,0
87961,1,2,307996,307997,307999,1,3,0
87962,6,1,308002,308002,308003,0,1,3
87963,5,2,308007,308007,308009,0,2,4
87964,5,3,308012,308012,308015,0,3,3
87965,5,2,308017,308017,308019,0,2,2
87966,1,1,308018,308019,308020,1,2,0
87967,6,3,308024,308024,308027,0,3,4
87968,6,1,308030,308030,308031,0,1,3
87969,3,2,308033,308033,308035,0,2,2
87970,1,2,308034,308035,308037,1,3,0
87971,3,1,308037,308037,308038,0,1,0
87972,1,3,308038,308038,308041,0,3,0
87973,5,3,308043,308043,308046,0,3,2
87974,6,1,308049,308049,308050,0,1,3
87975,1,1,308050,308050,308051,0,1,0
87976,5,3,308055,308055,308058,0,3,4
87977,5,3,308060,308060,308063,0,3,2
87978,6,2,308066,308066,308068,0,2,3
87979,5,1,308071,308071,308072,0,1,3
87980,4,1,308075,308075,308076,0,1,3
87981,1,2,308076,308076,308078,0,2,0
87982,4,2,308080,308080,308082,0,2,2
87983,4,3,308084,308084,308087,0,3,2
87984,5,1,308089,308089,308090,0,1,2
87985,2,1,308091,308091,308092,0,1,1
87986,1,2,308092,308092,308094,0,2,0
87987,5,3,308097,308097,308100,0,3,3
87988,6,1,308103,308103,308104,0,1,3
87989,5,1,308108,308108,308109,0,1,4
87990,2,3,308110,308110,308113,0,3,1
87991,2,1,308112,308113,308114,1,2,0
87992,1,2,308113,308114,308116,1,3,0
87993,1,2,308114,308116,308118,2,4,0
87994,5,1,308119,308119,308120,0,1,1
87995,4,1,308123,308123,308124,0,1,3
87996,6,2,308129,308129,308131,0,2,5
87997,2,2,308131,308131,308133,0,2,0
87998,6,2,308137,308137,308139,0,2,4
87999,3,3,308140,308140,308143,0,3,1
88000,1,2,308141,308143,308145,2,4,0
88001,1,3,308142,308145,308148,3,6,0
88002,4,2,308146,308148,308150,2,4,0
88003,2,3,308148,308150,308153,2,5,0
88004,3,1,308151,308153,308154,2,3,0
88005,4,2,308155,308155,308157,0,2,1
88006,5,2,308160,308160,308162,0,2,3
88007,6,1,308166,308166,308167,0,1,4
88008,1,1,308167,308167,308168,0,1,0
88009,4,2,308171,308171,308173,0,2,3
88010,4,3,308175,308175,308178,0,3,2
88011,5,1,308180,308180,308181,0,1,2
88012,1,3,308181,308181,308184,0,3,0
88013,5,3,308186,308186,308189,0,3,2
88014,5,3,308191,308191,308194,0,3,2
88015,3,1,308194,308194,308195,0,1,0
88016,1,1,308195,308195,308196,0,1,0
88017,4,1,308199,308199,308200,0,1,3
88018,4,1,308203,308203,308204,0,1,3
88019,2,2,308205,308205,308207,0,2,1
88020,4,1,308209,308209,308210,0,1,2
88021,5,1,308214,308214,308215,0,1,4
88022,2,1,308216,308216,308217,0,1,1
88023,1,2,308217,308217,308219,0,2,0
88024,5,1,308222,308222,308223,0,1,3
88025,5,3,308227,308227,308230,0,3,4
88026,3,2,308230,308230,308232,0,2,0
88027,5,3,308235,308235,308238,0,3,3
88028,2,1,308237,308238,308239,1,2,0
88029,3,1,308240,308240,308241,0,1,1
88030,4,3,308244,308244,308247,0,3,3
88031,2,1,308246,308247,308248,1,2,0
88032,2,1,308248,308248,308249,0,1,0
88033,4,2,308252,308252,308254,0,2,3
88034,4,1,308256,308256,308257,0,1,2
88035,6,1,308262,308262,308263,0,1,5
88036,4,1,308266,308266,308267,0,1,3
88037,3,2,308269,308269,308271,0,2,2
88038,6,3,308275,308275,308278,0,3,4
88039,3,3,308278,308278,308281,0,3,0
88040,2,1,308280,308281,308282,1,2,0
88041,2,3,308282,308282,308285,0,3,0
88042,1,2,308283,308285,308287,2,4,0
88043,6,2,308289,308289,308291,0,2,2
88044,1,1,308290,308291,308292,1,2,0
88045,2,1,308292,308292,308293,0,1,0
88046,4,3,308296,308296,308299,0,3,3
88047,1,2,308297,308299,308301,2,4,0
88048,4,3,308301,308301,308304,0,3,0
88049,3,1,308304,308304,308305,0,1,0
88050,6,1,308310,308310,308311,0,1,5
88051,3,3,308313,308313,308316,0,3,2
88052,5,2,308318,308318,308320,0,2,2
88053,4,3,308322,308322,308325,0,3,2
88054,3,3,308325,308325,308328,0,3,0
88055,4,3,308329,308329,308332,0,3,1
88056,5,2,308334,308334,308336,0,2,2
88057,6,2,308340,308340,308342,0,2,4
88058,5,3,308345,308345,308348,0,3,3
88059,6,2,308351,308351,308353,0,2,3
88060,6,2,308357,308357,308359,0,2,4
88061,4,2,308361,308361,308363,0,2,2
88062,1,2,308362,308363,308365,1,3,0
88063,5,2,308367,308367,308369,0,2,2
88064,1,1,308368,308369,308370,1,2,0
88065,4,2,308372,308372,308374,0,2,2
88066,4,3,308376,308376,308379,0,3,2
88067,5,2,308381,308381,308383,0,2,2
88068,1,1,308382,308383,308384,1,2,0
88069,4,2,308386,308386,308388,0,2,2
88070,4,1,308390,308390,308391,0,1,2
88071,3,2,308393,308393,308395,0,2,2
88072,3,1,308396,308396,308397,0,1,1
88073,3,3,308399,308399,308402,0,3,2
88074,4,3,308403,308403,308406,0,3,1
88075,2,3,308405,308406,308409,1,4,0
88076,3,1,308408,308409,308410,1,2,0
88077,5,2,308413,308413,308415,0,2,3
88078,6,2,308419,308419,308421,0,2,4
88079,4,3,308423,308423,308426,0,3,2
88080,3,2,308426,308426,308428,0,2,0
88081,5,3,308431,308431,308434,0,3,3
88082,2,2,308433,308434,308436,1,3,0
88083,6,3,308439,308439,308442,0,3,3
88084,3,2,308442,308442,308444,0,2,0
88085,6,1,308448,308448,308449,0,1,4
88086,2,3,308450,308450,308453,0,3,1
88087,4,2,308454,308454,308456,0,2,1
88088,1,2,308455,308456,308458,1,3,0
88089,6,1,308461,308461,308462,0,1,3
88090,4,1,308465,308465,308466,0,1,3
88091,2,3,308467,308467,308470,0,3,1
88092,4,2,308471,308471,308473,0,2,1
88093,2,3,308473,308473,308476,0,3,0
88094,4,2,308477,308477,308479,0,2,1
88095,6,2,308483,308483,308485,0,2,4
88096,5,3,308488,308488,308491,0,3,3
88097,3,3,308491,308491,308494,0,3,0
88098,1,1,308492,308494,308495,2,3,0
88099,4,1,308496,308496,308497,0,1,1
88100,3,3,308499,308499,308502,0,3,2
88101,2,3,308501,308502,308505,1,4,0
88102,2,1,308503,308505,308506,2,3,0
88103,4,1,308507,308507,308508,0,1,1
88104,6,2,308513,308513,308515,0,2,5
88105,1,3,308514,308515,308518,1,4,0
88106,6,1,308520,308520,308521,0,1,2
88107,4,1,308524,308524,308525,0,1,3
88108,2,2,308526,308526,308528,0,2,1
88109,5,2,308531,308531,308533,0,2,3
88110,1,3,308532,308533,308536,1,4,0
88111,5,3,308537,308537,308540,0,3,1
88112,6,2,308543,308543,308545,0,2,3
88113,4,3,308547,308547,308550,0,3,2
88114,4,2,308551,308551,308553,0,2,1
88115,6,3,308557,308557,308560,0,3,4
88116,6,3,308563,308563,308566,0,3,3
88117,3,1,308566,308566,308567,0,1,0
88118,2,1,308568,308568,308569,0,1,1
88119,4,2,308572,308572,308574,0,2,3
88120,4,3,308576,308576,308579,0,3,2
88121,1,1,308577,308579,308580,2,3,0
88122,6,2,308583,308583,308585,0,2,3
88123,6,2,308589,308589,308591,0,2,4
88124,4,1,308593,308593,308594,0,1,2
88125,1,2,308594,308594,308596,0,2,0
88126,3,1,308597,308597,308598,0,1,1
88127,5,1,308602,308602,308603,0,1,4
88128,6,3,308608,308608,308611,0,3,5
88129,3,2,308611,308611,308613,0,2,0
88130,4,3,308615,308615,308618,0,3,2
88131,2,3,308617,308618,308621,1,4,0
88132,1,1,308618,308621,308622,3,4,0
88133,5,3,308623,308623,308626,0,3,1
88134,1,3,308624,308626,308629,2,5,0
88135,1,2,308625,308629,308631,4,6,0
88136,6,2,308631,308631,308633,0,2,0
88137,4,3,308635,308635,308638,0,3,2
88138,6,3,308641,308641,308644,0,3,3
88139,5,3,308646,308646,308649,0,3,2
88140,6,1,308652,308652,308653,0,1,3
88141,2,2,308654,308654,308656,0,2,1
88142,2,3,308656,308656,308659,0,3,0
88143,2,1,308658,308659,308660,1,2,0
88144,4,3,308662,308662,308665,0,3,2
88145,5,3,308667,308667,308670,0,3,2
88146,3,3,308670,308670,308673,0,3,0
88147,5,3,308675,308675,308678,0,3,2
88148,6,3,308681,308681,308684,0,3,3
88149,3,3,308684,308684,308687,0,3,0
88150,1,3,308685,308687,308690,2,5,0
88151,1,3,308686,308690,308693,4,7,0
88152,6,2,308692,308693,308695,1,3,0
88153,6,2,308698,308698,308700,0,2,3
88154,6,1,308704,308704,308705,0,1,4
88155,1,1,308705,308705,308706,0,1,0
88156,2,3,308707,308707,308710,0,3,1
88157,2,2,308709,308710,308712,1,3,0
88158,6,3,308715,308715,308718,0,3,3
88159,3,1,308718,308718,308719,0,1,0
88160,4,3,308722,308722,308725,0,3,3
88161,2,3,308724,308725,308728,1,4,0
88162,2,3,308726,308728,308731,2,5,0
88163,6,1,308732,308732,308733,0,1,1
88164,1,2,308733,308733,308735,0,2,0
88165,6,3,308739,308739,308742,0,3,4
88166,3,2,308742,308742,308744,0,2,0
88167,4,1,308746,308746,308747,0,1,2
88168,3,1,308749,308749,308750,0,1,2
88169,1,1,308750,308750,308751,0,1,0
88170,5,1,308755,308755,308756,0,1,4
88171,6,1,308761,308761,308762,0,1,5
88172,5,2,308766,308766,308768,0,2,4
88173,1,3,308767,308768,308771,1,4,0
88174,3,3,308770,308771,308774,1,4,0
88175,6,1,308776,308776,308777,0,1,2
88176,4,2,308780,308780,308782,0,2,3
88177,5,3,308785,308785,308788,0,3,3
88178,2,3,308787,308788,308791,1,4,0
88179,6,2,308793,308793,308795,0,2,2
88180,1,3,308794,308795,308798,1,4,0
88181,3,3,308797,308798,308801,1,4,0
88182,1,3,308798,308801,308804,3,6,0
88183,4,1,308802,308804,308805,2,3,0
88184,6,3,308808,308808,308811,0,3,3
88185,3,1,308811,308811,308812,0,1,0
88186,5,1,308816,308816,308817,0,1,4
88187,4,1,308820,308820,308821,0,1,3
88188,3,1,308823,308823,308824,0,1,2
88189,3,3,308826,308826,308829,0,3,2
88190,6,3,308832,308832,308835,0,3,3
88191,1,2,308833,308835,308837,2,4,0
88192,3,1,308836,308837,308838,1,2,0
88193,1,1,308837,308838,308839,1,2,0
88194,4,1,308841,308841,308842,0,1,2
88195,4,1,308845,308845,308846,0,1,3
88196,4,2,308849,308849,308851,0,2,3
88197,4,2,308853,308853,308855,0,2,2
88198,2,2,308855,308855,308857,0,2,0
88199,3,1,308858,308858,308859,0,1,1
88200,1,3,308859,308859,308862,0,3,0
88201,6,3,308865,308865,308868,0,3,3
88202,4,3,308869,308869,308872,0,3,1
88203,5,1,308874,308874,308875,0,1,2
88204,6,3,308880,308880,308883,0,3,5
88205,3,1,308883,308883,308884,0,1,0
88206,6,3,308889,308889,308892,0,3,5
88207,3,1,308892,308892,308893,0,1,0
88208,4,1,308896,308896,308897,0,1,3
88209,5,3,308901,308901,308904,0,3,4
88210,3,3,308904,308904,308907,0,3,0
88211,2,2,308906,308907,308909,1,3,0
88212,5,3,308911,308911,308914,0,3,2
88213,5,1,308916,308916,308917,0,1,2
88214,2,1,308918,308918,308919,0,1,1
88215,1,1,308919,308919,308920,0,1,0
88216,1,3,308920,308920,308923,0,3,0
88217,4,2,308924,308924,308926,0,2,1
88218,3,2,308927,308927,308929,0,2,1
88219,6,1,308933,308933,308934,0,1,4
88220,6,1,308939,308939,308940,0,1,5
88221,2,3,308941,308941,308944,0,3,1
88222,1,2,308942,308944,308946,2,4,0
88223,1,2,308943,308946,308948,3,5,0
88224,1,3,308944,308948,308951,4,7,0
88225,3,1,308947,308951,308952,4,5,0
88226,6,2,308953,308953,308955,0,2,1
88227,5,2,308958,308958,308960,0,2,3
88228,1,2,308959,308960,308962,1,3,0
88229,1,3,308960,308962,308965,2,5,0
88230,4,3,308964,308965,308968,1,4,0
88231,5,3,308969,308969,308972,0,3,1
88232,5,2,308974,308974,308976,0,2,2
88233,5,2,308979,308979,308981,0,2,3
88234,6,3,308985,308985,308988,0,3,4
88235,4,2,308989,308989,308991,0,2,1
88236,3,1,308992,308992,308993,0,1,1
88237,4,2,308996,308996,308998,0,2,3
88238,6,3,309002,309002,309005,0,3,4
88239,3,2,309005,309005,309007,0,2,0
88240,3,1,309008,309008,309009,0,1,1
88241,2,1,309010,309010,309011,0,1,1
88242,1,1,309011,309011,309012,0,1,0
88243,3,1,309014,309014,309015,0,1,2
88244,5,3,309019,309019,309022,0,3,4
88245,1,3,309020,309022,309025,2,5,0
88246,3,1,309023,309025,309026,2,3,0
88247,1,1,309024,309026,309027,2,3,0
88248,1,1,309025,309027,309028,2,3,0
88249,1,3,309026,309028,309031,2,5,0
88250,5,2,309031,309031,309033,0,2,0
88251,1,3,309032,309033,309036,1,4,0
88252,6,3,309038,309038,309041,0,3,2
88253,2,2,309040,309041,309043,1,3,0
88254,2,1,309042,309043,309044,1,2,0
88255,2,1,309044,309044,309045,0,1,0
88256,6,3,309050,309050,309053,0,3,5
88257,5,3,309055,309055,309058,0,3,2
88258,1,1,309056,309058,309059,2,3,0
88259,2,3,309058,309059,309062,1,4,0
88260,1,3,309059,309062,309065,3,6,0
88261,4,2,309063,309065,309067,2,4,0
88262,3,1,309066,309067,309068,1,2,0
88263,5,2,309071,309071,309073,0,2,3
88264,4,1,309075,309075,309076,0,1,2
88265,1,1,309076,309076,309077,0,1,0
88266,2,2,309078,309078,309080,0,2,1
88267,6,3,309084,309084,309087,0,3,4
88268,6,3,309090,309090,309093,0,3,3
88269,3,2,309093,309093,309095,0,2,0
88270,2,2,309095,309095,309097,0,2,0
88271,6,3,309101,309101,309104,0,3,4
88272,1,1,309102,309104,309105,2,3,0
88273,5,3,309107,309107,309110,0,3,2
88274,4,1,309111,309111,309112,0,1,1
88275,6,3,309117,309117,309120,0,3,5
88276,5,3,309122,309122,309125,0,3,2
88277,3,2,309125,309125,309127,0,2,0
88278,2,2,309127,309127,309129,0,2,0
88279,1,1,309128,309129,309130,1,2,0
88280,6,1,309134,309134,309135,0,1,4
88281,2,3,309136,309136,309139,0,3,1
88282,3,2,309139,309139,309141,0,2,0
88283,4,2,309143,309143,309145,0,2,2
88284,6,2,309149,309149,309151,0,2,4
88285,5,3,309154,309154,309157,0,3,3
88286,4,2,309158,309158,309160,0,2,1
88287,5,1,309163,309163,309164,0,1,3
88288,2,3,309165,309165,309168,0,3,1
88289,4,2,309169,309169,309171,0,2,1
88290,4,1,309173,309173,309174,0,1,2
88291,1,1,309174,309174,309175,0,1,0
88292,5,3,309179,309179,309182,0,3,4
88293,1,3,309180,309182,309185,2,5,0
88294,1,3,309181,309185,309188,4,7,0
88295,6,2,309187,309188,309190,1,3,0
88296,4,1,309191,309191,309192,0,1,1
88297,4,2,309195,309195,309197,0,2,3
88298,6,2,309201,309201,309203,0,2,4
88299,1,1,309202,309203,309204,1,2,0
88300,1,1,309203,309204,309205,1,2,0
88301,1,2,309204,309205,309207,1,3,0
88302,5,2,309209,309209,309211,0,2,2
88303,4,3,309213,309213,309216,0,3,2
88304,5,1,309218,309218,309219,0,1,2
88305,3,2,309221,309221,309223,0,2,2
88306,1,3,309222,309223,309226,1,4,0
88307,2,2,309224,309226,309228,2,4,0
88308,2,3,309226,309228,309231,2,5,0
88309,1,1,309227,309231,309232,4,5,0
88310,6,2,309233,309233,309235,0,2,1
88311,4,1,309237,309237,309238,0,1,2
88312,2,3,309239,309239,309242,0,3,1
88313,2,2,309241,309242,309244,1,3,0
88314,1,3,309242,309244,309247,2,5,0
88315,5,1,309247,309247,309248,0,1,0
88316,2,1,309249,309249,309250,0,1,1
88317,5,1,309254,309254,309255,0,1,4
88318,5,3,309259,309259,309262,0,3,4
88319,5,1,309264,309264,309265,0,1,2
88320,3,3,309267,309267,309270,0,3,2
88321,6,1,309273,309273,309274,0,1,3
88322,4,1,309277,309277,309278,0,1,3
88323,3,1,309280,309280,309281,0,1,2
88324,3,3,309283,309283,309286,0,3,2
88325,3,1,309286,309286,309287,0,1,0
88326,6,1,309292,309292,309293,0,1,5
88327,5,1,309297,309297,309298,0,1,4
88328,2,2,309299,309299,309301,0,2,1
88329,1,1,309300,309301,309302,1,2,0
88330,3,1,309303,309303,309304,0,1,1
88331,3,2,309306,309306,309308,0,2,2
88332,1,3,309307,309308,309311,1,4,0
88333,2,1,309309,309311,309312,2,3,0
88334,5,2,309314,309314,309316,0,2,2
88335,6,3,309320,309320,309323,0,3,4
88336,1,2,309321,309323,309325,2,4,0
88337,1,1,309322,309325,309326,3,4,0
88338,6,3,309328,309328,309331,0,3,2
88339,3,3,309331,309331,309334,0,3,0
88340,2,3,309333,309334,309337,1,4,0
88341,4,2,309337,309337,309339,0,2,0
88342,4,2,309341,309341,309343,0,2,2
88343,6,1,309347,309347,309348,0,1,4
88344,3,1,309350,309350,309351,0,1,2
88345,4,1,309354,309354,309355,0,1,3
88346,5,3,309359,309359,309362,0,3,4
88347,6,3,309365,309365,309368,0,3,3
88348,5,1,309370,309370,309371,0,1,2
88349,3,3,309373,309373,309376,0,3,2
88350,5,2,309378,309378,309380,0,2,2
88351,2,3,309380,309380,309383,0,3,0
88352,4,2,309384,309384,309386,0,2,1
88353,6,1,309390,309390,309391,0,1,4
88354,2,1,309392,309392,309393,0,1,1
88355,5,1,309397,309397,309398,0,1,4
88356,3,3,309400,309400,309403,0,3,2
88357,3,3,309403,309403,309406,0,3,0
88358,6,1,309409,309409,309410,0,1,3
88359,3,3,309412,309412,309415,0,3,2
88360,2,2,309414,309415,309417,1,3,0
88361,3,1,309417,309417,309418,0,1,0
88362,6,2,309423,309423,309425,0,2,5
88363,2,3,309425,309425,309428,0,3,0
88364,3,2,309428,309428,309430,0,2,0
88365,5,2,309433,309433,309435,0,2,3
88366,6,2,309439,309439,309441,0,2,4
88367,3,1,309442,309442,309443,0,1,1
88368,4,3,309446,309446,309449,0,3,3
88369,6,3,309452,309452,309455,0,3,3
88370,2,2,309454,309455,309457,1,3,0
88371,1,1,309455,309457,309458,2,3,0
88372,1,1,309456,309458,309459,2,3,0
88373,5,2,309461,309461,309463,0,2,2
88374,6,2,309467,309467,309469,0,2,4
88375,4,2,309471,309471,309473,0,2,2
88376,4,3,309475,309475,309478,0,3,2
88377,2,1,309477,309478,309479,1,2,0
88378,5,2,309482,309482,309484,0,2,3
88379,3,1,309485,309485,309486,0,1,1
88380,5,2,309490,309490,309492,0,2,4
88381,2,3,309492,309492,309495,0,3,0
88382,3,3,309495,309495,309498,0,3,0
88383,3,2,309498,309498,309500,0,2,0
88384,2,2,309500,309500,309502,0,2,0
88385,2,2,309502,309502,309504,0,2,0
88386,2,3,309504,309504,309507,0,3,0
88387,3,3,309507,309507,309510,0,3,0
88388,5,1,309512,309512,309513,0,1,2
88389,6,1,309518,309518,309519,0,1,5
88390,2,1,309520,309520,309521,0,1,1
88391,3,3,309523,309523,309526,0,3,2
88392,3,1,309526,309526,309527,0,1,0
88393,5,3,309531,309531,309534,0,3,4
88394,5,2,309536,309536,309538,0,2,2
88395,5,1,309541,309541,309542,0,1,3
88396,3,3,309544,309544,309547,0,3,2
88397,5,2,309549,309549,309551,0,2,2
88398,6,2,309555,309555,309557,0,2,4
88399,1,2,309556,309557,309559,1,3,0
88400,4,1,309560,309560,309561,0,1,1
88401,3,2,309563,309563,309565,0,2,2
88402,1,1,309564,309565,309566,1,2,0
88403,4,2,309568,309568,309570,0,2,2
88404,4,3,309572,309572,309575,0,3,2
88405,2,3,309574,309575,309578,1,4,0
88406,6,2,309580,309580,309582,0,2,2
88407,6,3,309586,309586,309589,0,3,4
88408,4,3,309590,309590,309593,0,3,1
88409,2,2,309592,309593,309595,1,3,0
88410,6,3,309598,309598,309601,0,3,3
88411,3,3,309601,309601,309604,0,3,0
88412,3,2,309604,309604,309606,0,2,0
88413,1,3,309605,309606,309609,1,4,0
88414,3,2,309608,309609,309611,1,3,0
88415,1,3,309609,309611,309614,2,5,0
88416,4,2,309613,309614,309616,1,3,0
88417,1,2,309614,309616,309618,2,4,0
88418,5,2,309619,309619,309621,0,2,1
88419,6,1,309625,309625,309626,0,1,4
88420,1,2,309626,309626,309628,0,2,0
88421,5,1,309631,309631,309632,0,1,3
88422,2,3,309633,309633,309636,0,3,1
88423,2,2,309635,309636,309638,1,3,0
88424,6,2,309641,309641,309643,0,2,3
88425,3,1,309644,309644,309645,0,1,1
88426,4,3,309648,309648,309651,0,3,3
88427,5,1,309653,309653,309654,0,1,2
88428,2,1,309655,309655,309656,0,1,1
88429,6,3,309661,309661,309664,0,3,5
88430,4,1,309665,309665,309666,0,1,1
88431,1,3,309666,309666,309669,0,3,0
88432,5,2,309671,309671,309673,0,2,2
88433,2,3,309673,309673,309676,0,3,0
88434,4,2,309677,309677,309679,0,2,1
88435,5,2,309682,309682,309684,0,2,3
88436,4,2,309686,309686,309688,0,2,2
88437,3,2,309689,309689,309691,0,2,1
88438,1,1,309690,309691,309692,1,2,0
88439,4,2,309694,309694,309696,0,2,2
88440,2,3,309696,309696,309699,0,3,0
88441,2,2,309698,309699,309701,1,3,0
88442,5,2,309703,309703,309705,0,2,2
88443,1,2,309704,309705,309707,1,3,0
88444,5,2,309709,309709,309711,0,2,2
88445,2,2,309711,309711,309713,0,2,0
88446,4,3,309715,309715,309718,0,3,2
88447,4,1,309719,309719,309720,0,1,1
88448,4,3,309723,309723,309726,0,3,3
88449,3,1,309726,309726,309727,0,1,0
88450,4,1,309730,309730,309731,0,1,3
88451,3,2,309733,309733,309735,0,2,2
88452,4,3,309737,309737,309740,0,3,2
88453,3,2,309740,309740,309742,0,2,0
88454,3,2,309743,309743,309745,0,2,1
88455,2,1,309745,309745,309746,0,1,0
88456,2,3,309747,309747,309750,0,3,1
88457,2,2,309749,309750,309752,1,3,0
88458,1,2,309750,309752,309754,2,4,0
88459,6,1,309756,309756,309757,0,1,2
88460,4,1,309760,309760,309761,0,1,3
88461,5,3,309765,309765,309768,0,3,4
88462,1,2,309766,309768,309770,2,4,0
88463,1,2,309767,309770,309772,3,5,0
88464,2,1,309769,309772,309773,3,4,0
88465,1,1,309770,309773,309774,3,4,0
88466,3,3,309773,309774,309777,1,4,0
88467,3,3,309776,309777,309780,1,4,0
88468,2,3,309778,309780,309783,2,5,0
88469,5,2,309783,309783,309785,0,2,0
88470,5,3,309788,309788,309791,0,3,3
88471,3,1,309791,309791,309792,0,1,0
88472,4,1,309795,309795,309796,0,1,3
88473,3,2,309798,309798,309800,0,2,2
88474,4,3,309802,309802,309805,0,3,2
88475,2,3,309804,309805,309808,1,4,0
88476,2,3,309806,309808,309811,2,5,0
88477,5,2,309811,309811,309813,0,2,0
88478,4,2,309815,309815,309817,0,2,2
88479,2,2,309817,309817,309819,0,2,0
88480,1,2,309818,309819,309821,1,3,0
88481,6,1,309824,309824,309825,0,1,3
88482,4,1,309828,309828,309829,0,1,3
88483,6,1,309834,309834,309835,0,1,5
88484,6,3,309840,309840,309843,0,3,5
88485,2,1,309842,309843,309844,1,2,0
88486,3,1,309845,309845,309846,0,1,1
88487,6,2,309851,309851,309853,0,2,5
88488,4,3,309855,309855,309858,0,3,2
88489,2,2,309857,309858,309860,1,3,0
88490,3,2,309860,309860,309862,0,2,0
88491,4,1,309864,309864,309865,0,1,2
88492,5,3,309869,309869,309872,0,3,4
88493,2,1,309871,309872,309873,1,2,0
88494,5,2,309876,309876,309878,0,2,3
88495,2,2,309878,309878,309880,0,2,0
88496,5,3,309883,309883,309886,0,3,3
88497,6,2,309889,309889,309891,0,2,3
88498,1,1,309890,309891,309892,1,2,0
88499,2,1,309892,309892,309893,0,1,0
88500,6,1,309898,309898,309899,0,1,5
88501,3,3,309901,309901,309904,0,3,2
88502,4,2,309905,309905,309907,0,2,1
88503,6,2,309911,309911,309913,0,2,4
88504,5,2,309916,309916,309918,0,2,3
88505,2,2,309918,309918,309920,0,2,0
88506,6,1,309924,309924,309925,0,1,4
88507,2,3,309926,309926,309929,0,3,1
88508,5,2,309931,309931,309933,0,2,2
88509,6,2,309937,309937,309939,0,2,4
88510,4,3,309941,309941,309944,0,3,2
88511,2,3,309943,309944,309947,1,4,0
88512,5,2,309948,309948,309950,0,2,1
88513,3,2,309951,309951,309953,0,2,1
88514,6,2,309957,309957,309959,0,2,4
88515,4,2,309961,309961,309963,0,2,2
88516,2,3,309963,309963,309966,0,3,0
88517,6,1,309969,309969,309970,0,1,3
88518,4,3,309973,309973,309976,0,3,3
88519,3,1,309976,309976,309977,0,1,0
88520,3,3,309979,309979,309982,0,3,2
88521,1,2,309980,309982,309984,2,4,0
88522,4,3,309984,309984,309987,0,3,0
88523,2,1,309986,309987,309988,1,2,0
88524,1,3,309987,309988,309991,1,4,0
88525,1,1,309988,309991,309992,3,4,0
88526,5,3,309993,309993,309996,0,3,1
88527,1,2,309994,309996,309998,2,4,0
88528,1,2,309995,309998,310000,3,5,0
88529,5,3,310000,310000,310003,0,3,0
88530,5,1,310005,310005,310006,0,1,2
88531,2,1,310007,310007,310008,0,1,1
88532,6,3,310013,310013,310016,0,3,5
88533,5,3,310018,310018,310021,0,3,2
88534,3,3,310021,310021,310024,0,3,0
88535,2,1,310023,310024,310025,1,2,0
88536,4,2,310027,310027,310029,0,2,2
88537,6,3,310033,310033,310036,0,3,4
88538,2,1,310035,310036,310037,1,2,0
88539,2,1,310037,310037,310038,0,1,0
88540,1,1,310038,310038,310039,0,1,0
88541,2,2,310040,310040,310042,0,2,1
88542,2,2,310042,310042,310044,0,2,0
88543,1,2,310043,310044,310046,1,3,0
88544,2,2,310045,310046,310048,1,3,0
88545,1,3,310046,310048,310051,2,5,0
88546,3,1,310049,310051,310052,2,3,0
88547,1,1,310050,310052,310053,2,3,0
88548,6,1,310056,310056,310057,0,1,3
88549,5,2,310061,310061,310063,0,2,4
88550,1,3,310062,310063,310066,1,4,0
88551,2,2,310064,310066,310068,2,4,0
88552,6,3,310070,310070,310073,0,3,2
88553,2,3,310072,310073,310076,1,4,0
88554,1,2,310073,310076,310078,3,5,0
88555,4,2,310077,310078,310080,1,3,0
88556,5,1,310082,310082,310083,0,1,2
88557,2,3,310084,310084,310087,0,3,1
88558,3,2,310087,310087,310089,0,2,0
88559,3,2,310090,310090,310092,0,2,1
88560,3,1,310093,310093,310094,0,1,1
88561,4,1,310097,310097,310098,0,1,3
88562,4,3,310101,310101,310104,0,3,3
88563,5,3,310106,310106,310109,0,3,2
88564,2,3,310108,310109,310112,1,4,0
88565,5,2,310113,310113,310115,0,2,1
88566,2,2,310115,310115,310117,0,2,0
88567,2,1,310117,310117,310118,0,1,0
88568,3,2,310120,310120,310122,0,2,2
88569,2,1,310122,310122,310123,0,1,0
88570,3,3,310125,310125,310128,0,3,2
88571,5,1,310130,310130,310131,0,1,2
88572,3,1,310133,310133,310134,0,1,2
88573,5,1,310138,310138,310139,0,1,4
88574,4,1,310142,310142,310143,0,1,3
88575,1,3,310143,310143,310146,0,3,0
88576,6,3,310149,310149,310152,0,3,3
88577,4,3,310153,310153,310156,0,3,1
88578,6,3,310159,310159,310162,0,3,3
88579,3,1,310162,310162,310163,0,1,0
88580,6,3,310168,310168,310171,0,3,5
88581,1,1,310169,310171,310172,2,3,0
88582,1,1,310170,310172,310173,2,3,0
88583,1,3,310171,310173,310176,2,5,0
88584,5,2,310176,310176,310178,0,2,0
88585,5,1,310181,310181,310182,0,1,3
88586,4,3,310185,310185,310188,0,3,3
88587,3,3,310188,310188,310191,0,3,0
88588,2,2,310190,310191,310193,1,3,0
88589,6,2,310196,310196,310198,0,2,3
88590,2,1,310198,310198,310199,0,1,0
88591,5,3,310203,310203,310206,0,3,4
88592,5,1,310208,310208,310209,0,1,2
88593,2,3,310210,310210,310213,0,3,1
88594,3,1,310213,310213,310214,0,1,0
88595,1,3,310214,310214,310217,0,3,0
88596,2,3,310216,310217,310220,1,4,0
88597,2,3,310218,310220,310223,2,5,0
88598,5,2,310223,310223,310225,0,2,0
88599,6,1,310229,310229,310230,0,1,4
88600,4,2,310233,310233,310235,0,2,3
88601,6,2,310239,310239,310241,0,2,4
88602,3,1,310242,310242,310243,0,1,1
88603,2,1,310244,310244,310245,0,1,1
88604,6,2,310250,310250,310252,0,2,5
88605,5,2,310255,310255,310257,0,2,3
88606,4,2,310259,310259,310261,0,2,2
88607,4,2,310263,310263,310265,0,2,2
88608,5,3,310268,310268,310271,0,3,3
88609,1,3,310269,310271,310274,2,5,0
88610,4,1,310273,310274,310275,1,2,0
88611,3,3,310276,310276,310279,0,3,1
88612,4,2,310280,310280,310282,0,2,1
88613,1,1,310281,310282,310283,1,2,0
88614,4,3,310285,310285,310288,0,3,2
88615,3,1,310288,310288,310289,0,1,0
88616,6,3,310294,310294,310297,0,3,5
88617,3,1,310297,310297,310298,0,1,0
88618,4,1,310301,310301,310302,0,1,3
88619,5,1,310306,310306,310307,0,1,4
88620,2,3,310308,310308,310311,0,3,1
88621,2,2,310310,310311,310313,1,3,0
88622,5,3,310315,310315,310318,0,3,2
88623,1,2,310316,310318,310320,2,4,0
88624,5,2,310321,310321,310323,0,2,1
88625,6,1,310327,310327,310328,0,1,4
88626,5,1,310332,310332,310333,0,1,4
88627,2,3,310334,310334,310337,0,3,1
88628,6,3,310340,310340,310343,0,3,3
88629,5,2,310345,310345,310347,0,2,2
88630,6,2,310351,310351,310353,0,2,4
88631,4,2,310355,310355,310357,0,2,2
88632,6,1,310361,310361,310362,0,1,4
88633,5,3,310366,310366,310369,0,3,4
88634,5,2,310371,310371,310373,0,2,2
88635,1,3,310372,310373,310376,1,4,0
88636,4,3,310376,310376,310379,0,3,0
88637,4,1,310380,310380,310381,0,1,1
88638,3,1,310383,310383,310384,0,1,2
88639,2,2,310385,310385,310387,0,2,1
88640,2,1,310387,310387,310388,0,1,0
88641,6,1,310393,310393,310394,0,1,5
88642,2,1,310395,310395,310396,0,1,1
88643,5,2,310400,310400,310402,0,2,4
88644,5,1,310405,310405,310406,0,1,3
88645,3,3,310408,310408,310411,0,3,2
88646,3,2,310411,310411,310413,0,2,0
88647,1,3,310412,310413,310416,1,4,0
88648,2,1,310414,310416,310417,2,3,0
88649,2,1,310416,310417,310418,1,2,0
88650,2,1,310418,310418,310419,0,1,0
88651,4,3,310422,310422,310425,0,3,3
88652,4,3,310426,310426,310429,0,3,1
88653,3,1,310429,310429,310430,0,1,0
88654,2,1,310431,310431,310432,0,1,1
88655,4,2,310435,310435,310437,0,2,3
88656,1,3,310436,310437,310440,1,4,0
88657,3,3,310439,310440,310443,1,4,0
88658,4,1,310443,310443,310444,0,1,0
88659,6,1,310449,310449,310450,0,1,5
88660,4,3,310453,310453,310456,0,3,3
88661,6,3,310459,310459,310462,0,3,3
88662,6,1,310465,310465,310466,0,1,3
88663,3,2,310468,310468,310470,0,2,2
88664,4,2,310472,310472,310474,0,2,2
88665,1,3,310473,310474,310477,1,4,0
88666,6,2,310479,310479,310481,0,2,2
88667,6,2,310485,310485,310487,0,2,4
88668,5,1,310490,310490,310491,0,1,3
88669,2,1,310492,310492,310493,0,1,1
88670,2,3,310494,310494,310497,0,3,1
88671,1,3,310495,310497,310500,2,5,0
88672,5,1,310500,310500,310501,0,1,0
88673,2,2,310502,310502,310504,0,2,1
88674,5,3,310507,310507,310510,0,3,3
88675,1,1,310508,310510,310511,2,3,0
88676,6,1,310514,310514,310515,0,1,3
88677,4,3,310518,310518,310521,0,3,3
88678,2,2,310520,310521,310523,1,3,0
88679,6,3,310526,310526,310529,0,3,3
88680,1,2,310527,310529,310531,2,4,0
88681,3,1,310530,310531,310532,1,2,0
88682,2,1,310532,310532,310533,0,1,0
88683,2,1,310534,310534,310535,0,1,1
88684,6,3,310540,310540,310543,0,3,5
88685,6,1,310546,310546,310547,0,1,3
88686,3,3,310549,310549,310552,0,3,2
88687,1,2,310550,310552,310554,2,4,0
88688,5,2,310555,310555,310557,0,2,1
88689,1,2,310556,310557,310559,1,3,0
88690,6,1,310562,310562,310563,0,1,3
88691,5,1,310567,310567,310568,0,1,4
88692,5,2,310572,310572,310574,0,2,4
88693,4,1,310576,310576,310577,0,1,2
88694,6,2,310582,310582,310584,0,2,5
88695,4,3,310586,310586,310589,0,3,2
88696,5,3,310591,310591,310594,0,3,2
88697,1,1,310592,310594,310595,2,3,0
88698,3,1,310595,310595,310596,0,1,0
88699,6,2,310601,310601,310603,0,2,5
88700,1,1,310602,310603,310604,1,2,0
88701,1,1,310603,310604,310605,1,2,0
88702,3,2,310606,310606,310608,0,2,1
88703,5,2,310611,310611,310613,0,2,3
88704,2,3,310613,310613,310616,0,3,0
88705,5,1,310618,310618,310619,0,1,2
88706,4,1,310622,310622,310623,0,1,3
88707,5,3,310627,310627,310630,0,3,4
88708,4,2,310631,310631,310633,0,2,1
88709,4,1,310635,310635,310636,0,1,2
88710,3,2,310638,310638,310640,0,2,2
88711,3,2,310641,310641,310643,0,2,1
88712,6,2,310647,310647,310649,0,2,4
88713,2,1,310649,310649,310650,0,1,0
88714,6,2,310655,310655,310657,0,2,5
88715,2,2,310657,310657,310659,0,2,0
88716,1,1,310658,310659,310660,1,2,0
88717,6,2,310664,310664,310666,0,2,4
88718,2,3,310666,310666,310669,0,3,0
88719,5,3,310671,310671,310674,0,3,2
88720,3,2,310674,310674,310676,0,2,0
88721,3,1,310677,310677,310678,0,1,1
88722,1,3,310678,310678,310681,0,3,0
88723,3,3,310681,310681,310684,0,3,0
88724,1,3,310682,310684,310687,2,5,0
88725,4,3,310686,310687,310690,1,4,0
88726,4,2,310690,310690,310692,0,2,0
88727,4,2,310694,310694,310696,0,2,2
88728,1,3,310695,310696,310699,1,4,0
88729,4,2,310699,310699,310701,0,2,0
88730,6,1,310705,310705,310706,0,1,4
88731,1,1,310706,310706,310707,0,1,0
88732,6,3,310712,310712,310715,0,3,5
88733,5,2,310717,310717,310719,0,2,2
88734,6,1,310723,310723,310724,0,1,4
88735,3,2,310726,310726,310728,0,2,2
88736,3,3,310729,310729,310732,0,3,1
88737,5,2,310734,310734,310736,0,2,2
88738,1,3,310735,310736,310739,1,4,0
88739,2,3,310737,310739,310742,2,5,0
88740,3,3,310740,310742,310745,2,5,0
88741,1,1,310741,310745,310746,4,5,0
88742,6,2,310747,310747,310749,0,2,1
88743,5,3,310752,310752,310755,0,3,3
88744,5,3,310757,310757,310760,0,3,2
88745,3,3,310760,310760,310763,0,3,0
88746,4,3,310764,310764,310767,0,3,1
88747,2,2,310766,310767,310769,1,3,0
88748,6,3,310772,310772,310775,0,3,3
88749,3,3,310775,310775,310778,0,3,0
88750,1,1,310776,310778,310779,2,3,0
88751,3,1,310779,310779,310780,0,1,0
88752,3,1,310782,310782,310783,0,1,2
88753,6,3,310788,310788,310791,0,3,5
88754,1,1,310789,310791,310792,2,3,0
88755,2,3,310791,310792,310795,1,4,0
88756,5,1,310796,310796,310797,0,1,1
88757,2,1,310798,310798,310799,0,1,1
88758,6,2,310804,310804,310806,0,2,5
88759,3,1,310807,310807,310808,0,1,1
88760,3,1,310810,310810,310811,0,1,2
88761,6,1,310816,310816,310817,0,1,5
88762,3,3,310819,310819,310822,0,3,2
88763,2,2,310821,310822,310824,1,3,0
88764,3,1,310824,310824,310825,0,1,0
88765,4,1,310828,310828,310829,0,1,3
88766,3,1,310831,310831,310832,0,1,2
88767,4,2,310835,310835,310837,0,2,3
88768,2,1,310837,310837,310838,0,1,0
88769,4,1,310841,310841,310842,0,1,3
88770,6,2,310847,310847,310849,0,2,5
88771,1,3,310848,310849,310852,1,4,0
88772,2,1,310850,310852,310853,2,3,0
88773,1,2,310851,310853,310855,2,4,0
88774,5,1,310856,310856,310857,0,1,1
88775,1,1,310857,310857,310858,0,1,0
88776,2,1,310859,310859,310860,0,1,1
88777,3,3,310862,310862,310865,0,3,2
88778,1,3,310863,310865,310868,2,5,0
88779,3,2,310866,310868,310870,2,4,0
88780,4,1,310870,310870,310871,0,1,0
88781,5,3,310875,310875,310878,0,3,4
88782,3,2,310878,310878,310880,0,2,0
88783,2,2,310880,310880,310882,0,2,0
88784,1,2,310881,310882,310884,1,3,0
88785,2,2,310883,310884,310886,1,3,0
88786,2,3,310885,310886,310889,1,4,0
88787,3,3,310888,310889,310892,1,4,0
88788,2,1,310890,310892,310893,2,3,0
88789,3,1,310893,310893,310894,0,1,0
88790,3,1,310896,310896,310897,0,1,2
88791,1,1,310897,310897,310898,0,1,0
88792,6,3,310903,310903,310906,0,3,5
88793,5,2,310908,310908,310910,0,2,2
88794,2,1,310910,310910,310911,0,1,0
88795,5,3,310915,310915,310918,0,3,4
88796,3,1,310918,310918,310919,0,1,0
88797,4,3,310922,310922,310925,0,3,3
88798,1,1,310923,310925,310926,2,3,0
88799,3,2,310926,310926,310928,0,2,0
88800,5,3,310931,310931,310934,0,3,3
88801,1,1,310932,310934,310935,2,3,0
88802,4,3,310936,310936,310939,0,3,1
88803,3,1,310939,310939,310940,0,1,0
88804,2,2,310941,310941,310943,0,2,1
88805,2,3,310943,310943,310946,0,3,0
88806,4,1,310947,310947,310948,0,1,1
88807,2,3,310949,310949,310952,0,3,1
88808,2,3,310951,310952,310955,1,4,0
88809,6,2,310957,310957,310959,0,2,2
88810,6,2,310963,310963,310965,0,2,4
88811,3,1,310966,310966,310967,0,1,1
88812,5,3,310971,310971,310974,0,3,4
88813,1,1,310972,310974,310975,2,3,0
88814,4,1,310976,310976,310977,0,1,1
88815,6,1,310982,310982,310983,0,1,5
88816,5,2,310987,310987,310989,0,2,4
88817,2,2,310989,310989,310991,0,2,0
88818,6,3,310995,310995,310998,0,3,4
88819,6,2,311001,311001,311003,0,2,3
88820,4,1,311005,311005,311006,0,1,2
88821,1,2,311006,311006,311008,0,2,0
88822,3,1,311009,311009,311010,0,1,1
88823,2,2,311011,311011,311013,0,2,1
88824,2,3,311013,311013,311016,0,3,0
88825,6,1,311019,311019,311020,0,1,3
88826,4,2,311023,311023,311025,0,2,3
88827,6,2,311029,311029,311031,0,2,4
88828,6,1,311035,311035,311036,0,1,4
88829,1,1,311036,311036,311037,0,1,0
88830,1,2,311037,311037,311039,0,2,0
88831,2,2,311039,311039,311041,0,2,0
88832,3,1,311042,311042,311043,0,1,1
88833,3,3,311045,311045,311048,0,3,2
88834,6,1,311051,311051,311052,0,1,3
88835,1,2,311052,311052,311054,0,2,0
88836,1,2,311053,311054,311056,1,3,0
88837,1,2,311054,311056,311058,2,4,0
88838,3,3,311057,311058,311061,1,4,0
88839,3,3,311060,311061,311064,1,4,0
88840,5,1,311065,311065,311066,0,1,1
88841,3,3,311068,311068,311071,0,3,2
88842,3,1,311071,311071,311072,0,1,0
88843,3,3,311074,311074,311077,0,3,2
88844,4,2,311078,311078,311080,0,2,1
88845,6,2,311084,311084,311086,0,2,4
88846,3,3,311087,311087,311090,0,3,1
88847,5,3,311092,311092,311095,0,3,2
88848,6,1,311098,311098,311099,0,1,3
88849,4,1,311102,311102,311103,0,1,3
88850,3,3,311105,311105,311108,0,3,2
88851,6,1,311111,311111,311112,0,1,3
88852,3,1,311114,311114,311115,0,1,2
88853,4,1,311118,311118,311119,0,1,3
88854,6,1,311124,311124,311125,0,1,5
88855,6,3,311130,311130,311133,0,3,5
88856,4,2,311134,311134,311136,0,2,1
88857,2,2,311136,311136,311138,0,2,0
88858,2,3,311138,311138,311141,0,3,0
88859,3,3,311141,311141,311144,0,3,0
88860,5,1,311146,311146,311147,0,1,2
88861,6,3,311152,311152,311155,0,3,5
88862,5,3,311157,311157,311160,0,3,2
88863,2,3,311159,311160,311163,1,4,0
88864,2,1,311161,311163,311164,2,3,0
88865,4,3,311165,311165,311168,0,3,1
88866,4,3,311169,311169,311172,0,3,1
88867,2,2,311171,311172,311174,1,3,0
88868,4,3,311175,311175,311178,0,3,1
88869,4,3,311179,311179,311182,0,3,1
88870,2,2,311181,311182,311184,1,3,0
88871,4,2,311185,311185,311187,0,2,1
88872,1,3,311186,311187,311190,1,4,0
88873,5,1,311191,311191,311192,0,1,1
88874,5,2,311196,311196,311198,0,2,4
88875,5,2,311201,311201,311203,0,2,3
88876,1,1,311202,311203,311204,1,2,0
88877,1,3,311203,311204,311207,1,4,0
88878,4,2,311207,311207,311209,0,2,0
88879,5,3,311212,311212,311215,0,3,3
88880,2,1,311214,311215,311216,1,2,0
88881,3,2,311217,311217,311219,0,2,1
88882,1,3,311218,311219,311222,1,4,0
88883,2,1,311220,311222,311223,2,3,0
88884,5,2,311225,311225,311227,0,2,2
88885,6,1,311231,311231,311232,0,1,4
88886,2,1,311233,311233,311234,0,1,1
88887,3,2,311236,311236,311238,0,2,2
88888,2,3,311238,311238,311241,0,3,0
88889,6,3,311244,311244,311247,0,3,3
88890,5,1,311249,311249,311250,0,1,2
88891,1,2,311250,311250,311252,0,2,0
88892,3,2,311253,311253,311255,0,2,1
88893,6,1,311259,311259,311260,0,1,4
88894,2,1,311261,311261,311262,0,1,1
88895,3,3,311264,311264,311267,0,3,2
88896,3,3,311267,311267,311270,0,3,0
88897,6,3,311273,311273,311276,0,3,3
88898,3,2,311276,311276,311278,0,2,0
88899,5,1,311281,311281,311282,0,1,3
88900,6,3,311287,311287,311290,0,3,5
88901,1,2,311288,311290,311292,2,4,0
88902,2,2,311290,311292,311294,2,4,0
88903,2,2,311292,311294,311296,2,4,0
88904,2,1,311294,311296,311297,2,3,0
88905,5,1,311299,311299,311300,0,1,2
88906,3,2,311302,311302,311304,0,2,2
88907,4,1,311306,311306,311307,0,1,2
88908,2,3,311308,311308,311311,0,3,1
88909,2,1,311310,311311,311312,1,2,0
88910,5,3,311315,311315,311318,0,3,3
88911,2,1,311317,311318,311319,1,2,0
88912,5,3,311322,311322,311325,0,3,3
88913,3,1,311325,311325,311326,0,1,0
88914,3,3,311328,311328,311331,0,3,2
88915,5,3,311333,311333,311336,0,3,2
88916,3,1,311336,311336,311337,0,1,0
88917,2,2,311338,311338,311340,0,2,1
88918,4,3,311342,311342,311345,0,3,2
88919,3,2,311345,311345,311347,0,2,0
88920,4,3,311349,311349,311352,0,3,2
88921,3,1,311352,311352,311353,0,1,0
88922,5,1,311357,311357,311358,0,1,4
88923,5,1,311362,311362,311363,0,1,4
88924,2,2,311364,311364,311366,0,2,1
88925,3,1,311367,311367,311368,0,1,1
88926,6,1,311373,311373,311374,0,1,5
88927,1,1,311374,311374,311375,0,1,0
88928,1,2,311375,311375,311377,0,2,0
88929,5,3,311380,311380,311383,0,3,3
88930,5,2,311385,311385,311387,0,2,2
88931,3,3,311388,311388,311391,0,3,1
88932,3,3,311391,311391,311394,0,3,0
88933,4,3,311395,311395,311398,0,3,1
88934,5,1,311400,311400,311401,0,1,2
88935,6,3,311406,311406,311409,0,3,5
88936,1,1,311407,311409,311410,2,3,0
88937,1,3,311408,311410,311413,2,5,0
88938,6,2,311414,311414,311416,0,2,1
88939,3,3,311417,311417,311420,0,3,1
88940,1,1,311418,311420,311421,2,3,0
88941,5,1,311423,311423,311424,0,1,2
88942,5,1,311428,311428,311429,0,1,4
88943,4,3,311432,311432,311435,0,3,3
88944,5,2,311437,311437,311439,0,2,2
88945,6,3,311443,311443,311446,0,3,4
88946,6,1,311449,311449,311450,0,1,3
88947,4,3,311453,311453,311456,0,3,3
88948,4,2,311457,311457,311459,0,2,1
88949,5,3,311462,311462,311465,0,3,3
88950,6,2,311468,311468,311470,0,2,3
88951,2,3,311470,311470,311473,0,3,0
88952,1,3,311471,311473,311476,2,5,0
88953,1,1,311472,311476,311477,4,5,0
88954,1,3,311473,311477,311480,4,7,0
88955,5,2,311478,311480,311482,2,4,0
88956,4,1,311482,311482,311483,0,1,0
88957,3,3,311485,311485,311488,0,3,2
88958,1,2,311486,311488,311490,2,4,0
88959,5,1,311491,311491,311492,0,1,1
88960,4,1,311495,311495,311496,0,1,3
88961,4,2,311499,311499,311501,0,2,3
88962,1,3,311500,311501,311504,1,4,0
88963,5,3,311505,311505,311508,0,3,1
88964,4,2,311509,311509,311511,0,2,1
88965,3,1,311512,311512,311513,0,1,1
88966,5,1,311517,311517,311518,0,1,4
88967,1,3,311518,311518,311521,0,3,0
88968,4,2,311522,311522,311524,0,2,1
88969,6,1,311528,311528,311529,0,1,4
88970,6,1,311534,311534,311535,0,1,5
88971,4,2,311538,311538,311540,0,2,3
88972,5,3,311543,311543,311546,0,3,3
88973,5,3,311548,311548,311551,0,3,2
88974,4,2,311552,311552,311554,0,2,1
88975,4,1,311556,311556,311557,0,1,2
88976,1,3,311557,311557,311560,0,3,0
88977,2,2,311559,311560,311562,1,3,0
88978,5,1,311564,311564,311565,0,1,2
88979,5,1,311569,311569,311570,0,1,4
88980,5,2,311574,311574,311576,0,2,4
88981,3,2,311577,311577,311579,0,2,1
88982,4,3,311581,311581,311584,0,3,2
88983,3,3,311584,311584,311587,0,3,0
88984,1,2,311585,311587,311589,2,4,0
88985,1,3,311586,311589,311592,3,6,0
88986,2,2,311588,311592,311594,4,6,0
88987,5,2,311593,311594,311596,1,3,0
88988,3,2,311596,311596,311598,0,2,0
88989,2,2,311598,311598,311600,0,2,0
88990,4,1,311602,311602,311603,0,1,2
88991,2,3,311604,311604,311607,0,3,1
88992,4,2,311608,311608,311610,0,2,1
88993,1,1,311609,311610,311611,1,2,0
88994,2,1,311611,311611,311612,0,1,0
88995,1,1,311612,311612,311613,0,1,0
88996,2,1,311614,311614,311615,0,1,1
88997,6,1,311620,311620,311621,0,1,5
88998,1,2,311621,311621,311623,0,2,0
88999,4,1,311625,311625,311626,0,1,2
89000,6,1,311631,311631,311632,0,1,5
89001,1,3,311632,311632,311635,0,3,0
89002,4,2,311636,311636,311638,0,2,1
89003,1,1,311637,311638,311639,1,2,0
89004,4,1,311641,311641,311642,0,1,2
89005,5,3,311646,311646,311649,0,3,4
89006,1,3,311647,311649,311652,2,5,0
89007,2,1,311649,311652,311653,3,4,0
89008,4,3,311653,311653,311656,0,3,0
89009,2,2,311655,311656,311658,1,3,0
89010,5,3,311660,311660,311663,0,3,2
89011,5,3,311665,311665,311668,0,3,2
89012,6,3,311671,311671,311674,0,3,3
89013,2,3,311673,311674,311677,1,4,0
89014,3,1,311676,311677,311678,1,2,0
89015,1,1,311677,311678,311679,1,2,0
89016,5,2,311682,311682,311684,0,2,3
89017,6,2,311688,311688,311690,0,2,4
89018,5,3,311693,311693,311696,0,3,3
89019,2,2,311695,311696,311698,1,3,0
89020,6,1,311701,311701,311702,0,1,3
89021,3,1,311704,311704,311705,0,1,2
89022,6,2,311710,311710,311712,0,2,5
89023,5,3,311715,311715,311718,0,3,3
89024,5,1,311720,311720,311721,0,1,2
89025,5,1,311725,311725,311726,0,1,4
89026,6,2,311731,311731,311733,0,2,5
89027,1,1,311732,311733,311734,1,2,0
89028,6,2,311738,311738,311740,0,2,4
89029,4,1,311742,311742,311743,0,1,2
89030,4,2,311746,311746,311748,0,2,3
89031,2,2,311748,311748,311750,0,2,0
89032,1,3,311749,311750,311753,1,4,0
89033,5,2,311754,311754,311756,0,2,1
89034,5,1,311759,311759,311760,0,1,3
89035,6,1,311765,311765,311766,0,1,5
89036,2,3,311767,311767,311770,0,3,1
89037,1,1,311768,311770,311771,2,3,0
89038,1,2,311769,311771,311773,2,4,0
89039,1,3,311770,311773,311776,3,6,0
89040,4,3,311774,311776,311779,2,5,0
89041,5,1,311779,311779,311780,0,1,0
89042,1,3,311780,311780,311783,0,3,0
89043,5,2,311785,311785,311787,0,2,2
89044,1,1,311786,311787,311788,1,2,0
89045,4,2,311790,311790,311792,0,2,2
89046,1,3,311791,311792,311795,1,4,0
89047,2,3,311793,311795,311798,2,5,0
89048,3,2,311796,311798,311800,2,4,0
89049,5,2,311801,311801,311803,0,2,1
89050,1,3,311802,311803,311806,1,4,0
89051,3,3,311805,311806,311809,1,4,0
89052,1,2,311806,311809,311811,3,5,0
89053,4,2,311810,311811,311813,1,3,0
89054,3,3,311813,311813,311816,0,3,0
89055,5,1,311818,311818,311819,0,1,2
89056,6,3,311824,311824,311827,0,3,5
89057,6,2,311830,311830,311832,0,2,3
89058,1,1,311831,311832,311833,1,2,0
89059,3,1,311834,311834,311835,0,1,1
89060,5,1,311839,311839,311840,0,1,4
89061,2,2,311841,311841,311843,0,2,1
89062,1,2,311842,311843,311845,1,3,0
89063,1,2,311843,311845,311847,2,4,0
89064,6,2,311849,311849,311851,0,2,2
89065,3,1,311852,311852,311853,0,1,1
89066,6,3,311858,311858,311861,0,3,5
89067,2,3,311860,311861,311864,1,4,0
89068,1,1,311861,311864,311865,3,4,0
89069,6,2,311867,311867,311869,0,2,2
89070,3,2,311870,311870,311872,0,2,1
89071,6,2,311876,311876,311878,0,2,4
89072,3,3,311879,311879,311882,0,3,1
89073,3,3,311882,311882,311885,0,3,0
89074,3,3,311885,311885,311888,0,3,0
89075,3,3,311888,311888,311891,0,3,0
89076,6,1,311894,311894,311895,0,1,3
89077,3,3,311897,311897,311900,0,3,2
89078,4,2,311901,311901,311903,0,2,1
89079,4,1,311905,311905,311906,0,1,2
89080,6,2,311911,311911,311913,0,2,5
89081,6,2,311917,311917,311919,0,2,4
89082,4,2,311921,311921,311923,0,2,2
89083,2,2,311923,311923,311925,0,2,0
89084,5,2,311928,311928,311930,0,2,3
89085,1,2,311929,311930,311932,1,3,0
89086,3,1,311932,311932,311933,0,1,0
89087,6,1,311938,311938,311939,0,1,5
89088,2,2,311940,311940,311942,0,2,1
89089,6,3,311946,311946,311949,0,3,4
89090,3,3,311949,311949,311952,0,3,0
89091,4,1,311953,311953,311954,0,1,1
89092,6,1,311959,311959,311960,0,1,5
89093,4,1,311963,311963,311964,0,1,3
89094,4,3,311967,311967,311970,0,3,3
89095,1,3,311968,311970,311973,2,5,0
89096,4,2,311972,311973,311975,1,3,0
89097,1,2,311973,311975,311977,2,4,0
89098,5,3,311978,311978,311981,0,3,1
89099,4,1,311982,311982,311983,0,1,1
89100,3,2,311985,311985,311987,0,2,2
89101,6,2,311991,311991,311993,0,2,4
89102,2,2,311993,311993,311995,0,2,0
89103,2,1,311995,311995,311996,0,1,0
89104,2,1,311997,311997,311998,0,1,1
89105,1,1,311998,311998,311999,0,1,0
89106,4,2,312002,312002,312004,0,2,3
89107,4,2,312006,312006,312008,0,2,2
89108,2,2,312008,312008,312010,0,2,0
89109,5,2,312013,312013,312015,0,2,3
89110,4,1,312017,312017,312018,0,1,2
89111,2,3,312019,312019,312022,0,3,1
89112,4,3,312023,312023,312026,0,3,1
89113,1,1,312024,312026,312027,2,3,0
89114,5,1,312029,312029,312030,0,1,2
89115,4,3,312033,312033,312036,0,3,3
89116,2,2,312035,312036,312038,1,3,0
89117,3,3,312038,312038,312041,0,3,0
89118,5,3,312043,312043,312046,0,3,2
89119,2,3,312045,312046,312049,1,4,0
89120,2,2,312047,312049,312051,2,4,0
89121,5,1,312052,312052,312053,0,1,1
89122,1,1,312053,312053,312054,0,1,0
89123,4,2,312057,312057,312059,0,2,3
89124,6,3,312063,312063,312066,0,3,4
89125,6,2,312069,312069,312071,0,2,3
89126,1,3,312070,312071,312074,1,4,0
89127,5,2,312075,312075,312077,0,2,1
89128,2,3,312077,312077,312080,0,3,0
89129,1,1,312078,312080,312081,2,3,0
89130,3,1,312081,312081,312082,0,1,0
89131,5,1,312086,312086,312087,0,1,4
89132,1,2,312087,312087,312089,0,2,0
89133,6,3,312093,312093,312096,0,3,4
89134,4,2,312097,312097,312099,0,2,1
89135,1,3,312098,312099,312102,1,4,0
89136,4,3,312102,312102,312105,0,3,0
89137,4,3,312106,312106,312109,0,3,1
89138,4,1,312110,312110,312111,0,1,1
89139,2,2,312112,312112,312114,0,2,1
89140,4,1,312116,312116,312117,0,1,2
89141,6,3,312122,312122,312125,0,3,5
89142,3,3,312125,312125,312128,0,3,0
89143,3,1,312128,312128,312129,0,1,0
89144,2,1,312130,312130,312131,0,1,1
89145,2,3,312132,312132,312135,0,3,1
89146,2,1,312134,312135,312136,1,2,0
89147,3,2,312137,312137,312139,0,2,1
89148,1,1,312138,312139,312140,1,2,0
89149,1,2,312139,312140,312142,1,3,0
89150,2,2,312141,312142,312144,1,3,0
89151,4,1,312145,312145,312146,0,1,1
89152,4,1,312149,312149,312150,0,1,3
89153,6,3,312155,312155,312158,0,3,5
89154,2,3,312157,312158,312161,1,4,0
89155,2,3,312159,312161,312164,2,5,0
89156,2,1,312161,312164,312165,3,4,0
89157,1,1,312162,312165,312166,3,4,0
89158,2,2,312164,312166,312168,2,4,0
89159,4,3,312168,312168,312171,0,3,0
89160,6,1,312174,312174,312175,0,1,3
89161,4,2,312178,312178,312180,0,2,3
89162,1,2,312179,312180,312182,1,3,0
89163,3,1,312182,312182,312183,0,1,0
89164,1,1,312183,312183,312184,0,1,0
89165,4,1,312187,312187,312188,0,1,3
89166,4,3,312191,312191,312194,0,3,3
89167,2,1,312193,312194,312195,1,2,0
89168,1,2,312194,312195,312197,1,3,0
89169,1,1,312195,312197,312198,2,3,0
89170,3,1,312198,312198,312199,0,1,0
89171,2,1,312200,312200,312201,0,1,1
89172,3,3,312203,312203,312206,0,3,2
89173,2,1,312205,312206,312207,1,2,0
89174,2,1,312207,312207,312208,0,1,0
89175,6,2,312213,312213,312215,0,2,5
89176,1,3,312214,312215,312218,1,4,0
89177,5,3,312219,312219,312222,0,3,1
89178,4,2,312223,312223,312225,0,2,1
89179,2,1,312225,312225,312226,0,1,0
89180,3,1,312228,312228,312229,0,1,2
89181,1,1,312229,312229,312230,0,1,0
89182,3,1,312232,312232,312233,0,1,2
89183,4,3,312236,312236,312239,0,3,3
89184,4,2,312240,312240,312242,0,2,1
89185,2,3,312242,312242,312245,0,3,0
89186,1,3,312243,312245,312248,2,5,0
89187,3,3,312246,312248,312251,2,5,0
89188,4,2,312250,312251,312253,1,3,0
89189,1,1,312251,312253,312254,2,3,0
89190,2,1,312253,312254,312255,1,2,0
89191,2,1,312255,312255,312256,0,1,0
89192,1,3,312256,312256,312259,0,3,0
89193,2,1,312258,312259,312260,1,2,0
89194,3,2,312261,312261,312263,0,2,1
89195,3,1,312264,312264,312265,0,1,1
89196,2,1,312266,312266,312267,0,1,1
89197,5,3,312271,312271,312274,0,3,4
89198,1,2,312272,312274,312276,2,4,0
89199,3,2,312275,312276,312278,1,3,0
89200,4,1,312279,312279,312280,0,1,1
89201,4,2,312283,312283,312285,0,2,3
89202,6,1,312289,312289,312290,0,1,4
89203,2,1,312291,312291,312292,0,1,1
89204,5,1,312296,312296,312297,0,1,4
89205,2,2,312298,312298,312300,0,2,1
89206,4,1,312302,312302,312303,0,1,2
89207,2,1,312304,312304,312305,0,1,1
89208,4,1,312308,312308,312309,0,1,3
89209,3,3,312311,312311,312314,0,3,2
89210,4,1,312315,312315,312316,0,1,1
89211,5,1,312320,312320,312321,0,1,4
89212,5,2,312325,312325,312327,0,2,4
89213,6,3,312331,312331,312334,0,3,4
89214,4,3,312335,312335,312338,0,3,1
89215,5,1,312340,312340,312341,0,1,2
89216,4,3,312344,312344,312347,0,3,3
89217,4,2,312348,312348,312350,0,2,1
89218,5,2,312353,312353,312355,0,2,3
89219,2,3,312355,312355,312358,0,3,0
89220,1,2,312356,312358,312360,2,4,0
89221,2,1,312358,312360,312361,2,3,0
89222,3,3,312361,312361,312364,0,3,0
89223,2,1,312363,312364,312365,1,2,0
89224,3,3,312366,312366,312369,0,3,1
89225,5,3,312371,312371,312374,0,3,2
89226,6,2,312377,312377,312379,0,2,3
89227,1,1,312378,312379,312380,1,2,0
89228,5,1,312383,312383,312384,0,1,3
89229,2,2,312385,312385,312387,0,2,1
89230,2,3,312387,312387,312390,0,3,0
89231,2,1,312389,312390,312391,1,2,0
89232,2,1,312391,312391,312392,0,1,0
89233,6,1,312397,312397,312398,0,1,5
89234,2,1,312399,312399,312400,0,1,1
89235,4,1,312403,312403,312404,0,1,3
89236,3,3,312406,312406,312409,0,3,2
89237,2,2,312408,312409,312411,1,3,0
89238,3,2,312411,312411,312413,0,2,0
89239,5,1,312416,312416,312417,0,1,3
89240,6,1,312422,312422,312423,0,1,5
89241,4,3,312426,312426,312429,0,3,3
89242,4,1,312430,312430,312431,0,1,1
89243,6,2,312436,312436,312438,0,2,5
89244,3,2,312439,312439,312441,0,2,1
89245,1,2,312440,312441,312443,1,3,0
89246,1,2,312441,312443,312445,2,4,0
89247,3,2,312444,312445,312447,1,3,0
89248,4,2,312448,312448,312450,0,2,1
89249,6,2,312454,312454,312456,0,2,4
89250,5,3,312459,312459,312462,0,3,3
89251,2,1,312461,312462,312463,1,2,0
89252,5,2,312466,312466,312468,0,2,3
89253,2,3,312468,312468,312471,0,3,0
89254,6,2,312474,312474,312476,0,2,3
89255,3,2,312477,312477,312479,0,2,1
89256,3,1,312480,312480,312481,0,1,1
89257,5,3,312485,312485,312488,0,3,4
89258,4,2,312489,312489,312491,0,2,1
89259,5,2,312494,312494,312496,0,2,3
89260,6,3,312500,312500,312503,0,3,4
89261,6,3,312506,312506,312509,0,3,3
89262,3,1,312509,312509,312510,0,1,0
89263,5,1,312514,312514,312515,0,1,4
89264,4,3,312518,312518,312521,0,3,3
89265,6,2,312524,312524,312526,0,2,3
89266,5,1,312529,312529,312530,0,1,3
89267,2,1,312531,312531,312532,0,1,1
89268,5,2,312536,312536,312538,0,2,4
89269,5,1,312541,312541,312542,0,1,3
89270,5,1,312546,312546,312547,0,1,4
89271,1,3,312547,312547,312550,0,3,0
89272,2,1,312549,312550,312551,1,2,0
89273,4,1,312553,312553,312554,0,1,2
89274,2,3,312555,312555,312558,0,3,1
89275,1,3,312556,312558,312561,2,5,0
89276,2,3,312558,312561,312564,3,6,0
89277,2,3,312560,312564,312567,4,7,0
89278,4,2,312564,312567,312569,3,5,0
89279,2,1,312566,312569,312570,3,4,0
89280,6,3,312572,312572,312575,0,3,2
89281,1,1,312573,312575,312576,2,3,0
89282,1,2,312574,312576,312578,2,4,0
89283,4,1,312578,312578,312579,0,1,0
89284,2,2,312580,312580,312582,0,2,1
89285,5,1,312585,312585,312586,0,1,3
89286,2,3,312587,312587,312590,0,3,1
89287,6,1,312593,312593,312594,0,1,3
89288,4,1,312597,312597,312598,0,1,3
89289,6,3,312603,312603,312606,0,3,5
89290,4,1,312607,312607,312608,0,1,1
89291,2,2,312609,312609,312611,0,2,1
89292,1,2,312610,312611,312613,1,3,0
89293,1,2,312611,312613,312615,2,4,0
89294,5,3,312616,312616,312619,0,3,1
89295,4,2,312620,312620,312622,0,2,1
89296,2,1,312622,312622,312623,0,1,0
89297,6,3,312628,312628,312631,0,3,5
89298,4,2,312632,312632,312634,0,2,1
89299,1,1,312633,312634,312635,1,2,0
89300,5,2,312638,312638,312640,0,2,3
89301,4,3,312642,312642,312645,0,3,2
89302,6,3,312648,312648,312651,0,3,3
89303,1,1,312649,312651,312652,2,3,0
89304,3,2,312652,312652,312654,0,2,0
89305,2,1,312654,312654,312655,0,1,0
89306,1,2,312655,312655,312657,0,2,0
89307,2,1,312657,312657,312658,0,1,0
89308,5,2,312662,312662,312664,0,2,4
89309,2,1,312664,312664,312665,0,1,0
89310,2,2,312666,312666,312668,0,2,1
89311,3,2,312669,312669,312671,0,2,1
89312,6,2,312675,312675,312677,0,2,4
89313,2,3,312677,312677,312680,0,3,0
89314,4,2,312681,312681,312683,0,2,1
89315,5,3,312686,312686,312689,0,3,3
89316,6,1,312692,312692,312693,0,1,3
89317,6,2,312698,312698,312700,0,2,5
89318,5,3,312703,312703,312706,0,3,3
89319,2,2,312705,312706,312708,1,3,0
89320,6,1,312711,312711,312712,0,1,3
89321,3,3,312714,312714,312717,0,3,2
89322,4,3,312718,312718,312721,0,3,1
89323,4,2,312722,312722,312724,0,2,1
89324,5,1,312727,312727,312728,0,1,3
89325,6,1,312733,312733,312734,0,1,5
89326,6,1,312739,312739,312740,0,1,5
89327,4,3,312743,312743,312746,0,3,3
89328,4,2,312747,312747,312749,0,2,1
89329,6,2,312753,312753,312755,0,2,4
89330,3,3,312756,312756,312759,0,3,1
89331,2,3,312758,312759,312762,1,4,0
89332,4,1,312762,312762,312763,0,1,0
89333,1,3,312763,312763,312766,0,3,0
89334,5,3,312768,312768,312771,0,3,2
89335,4,1,312772,312772,312773,0,1,1
89336,4,1,312776,312776,312777,0,1,3
89337,5,3,312781,312781,312784,0,3,4
89338,4,2,312785,312785,312787,0,2,1
89339,2,2,312787,312787,312789,0,2,0
89340,4,2,312791,312791,312793,0,2,2
89341,2,1,312793,312793,312794,0,1,0
89342,6,1,312799,312799,312800,0,1,5
89343,4,2,312803,312803,312805,0,2,3
89344,4,2,312807,312807,312809,0,2,2
89345,3,2,312810,312810,312812,0,2,1
89346,3,2,312813,312813,312815,0,2,1
89347,6,1,312819,312819,312820,0,1,4
89348,2,3,312821,312821,312824,0,3,1
89349,1,1,312822,312824,312825,2,3,0
89350,6,1,312828,312828,312829,0,1,3
89351,4,1,312832,312832,312833,0,1,3
89352,6,2,312838,312838,312840,0,2,5
89353,1,1,312839,312840,312841,1,2,0
89354,4,1,312843,312843,312844,0,1,2
89355,3,1,312846,312846,312847,0,1,2
89356,2,3,312848,312848,312851,0,3,1
89357,2,3,312850,312851,312854,1,4,0
89358,3,2,312853,312854,312856,1,3,0
89359,5,3,312858,312858,312861,0,3,2
89360,4,1,312862,312862,312863,0,1,1
89361,4,1,312866,312866,312867,0,1,3
89362,2,2,312868,312868,312870,0,2,1
89363,5,2,312873,312873,312875,0,2,3
89364,2,1,312875,312875,312876,0,1,0
89365,6,2,312881,312881,312883,0,2,5
89366,5,2,312886,312886,312888,0,2,3
89367,1,2,312887,312888,312890,1,3,0
89368,5,1,312892,312892,312893,0,1,2
89369,5,2,312897,312897,312899,0,2,4
89370,5,2,312902,312902,312904,0,2,3
89371,4,1,312906,312906,312907,0,1,2
89372,4,3,312910,312910,312913,0,3,3
89373,3,1,312913,312913,312914,0,1,0
89374,2,1,312915,312915,312916,0,1,1
89375,2,1,312917,312917,312918,0,1,1
89376,5,1,312922,312922,312923,0,1,4
89377,4,1,312926,312926,312927,0,1,3
89378,4,3,312930,312930,312933,0,3,3
89379,4,1,312934,312934,312935,0,1,1
89380,4,2,312938,312938,312940,0,2,3
89381,1,1,312939,312940,312941,1,2,0
89382,3,2,312942,312942,312944,0,2,1
89383,2,2,312944,312944,312946,0,2,0
89384,4,3,312948,312948,312951,0,3,2
89385,6,3,312954,312954,312957,0,3,3
89386,5,2,312959,312959,312961,0,2,2
89387,4,1,312963,312963,312964,0,1,2
89388,5,3,312968,312968,312971,0,3,4
89389,3,3,312971,312971,312974,0,3,0
89390,3,1,312974,312974,312975,0,1,0
89391,2,3,312976,312976,312979,0,3,1
89392,6,3,312982,312982,312985,0,3,3
89393,1,1,312983,312985,312986,2,3,0
89394,5,2,312988,312988,312990,0,2,2
89395,2,1,312990,312990,312991,0,1,0
89396,2,3,312992,312992,312995,0,3,1
89397,4,3,312996,312996,312999,0,3,1
89398,6,3,313002,313002,313005,0,3,3
89399,4,3,313006,313006,313009,0,3,1
89400,1,1,313007,313009,313010,2,3,0
89401,6,1,313013,313013,313014,0,1,3
89402,2,2,313015,313015,313017,0,2,1
89403,4,1,313019,313019,313020,0,1,2
89404,3,3,313022,313022,313025,0,3,2
89405,6,1,313028,313028,313029,0,1,3
89406,4,2,313032,313032,313034,0,2,3
89407,6,1,313038,313038,313039,0,1,4
89408,3,3,313041,313041,313044,0,3,2
89409,3,1,313044,313044,313045,0,1,0
89410,5,2,313049,313049,313051,0,2,4
89411,6,1,313055,313055,313056,0,1,4
89412,5,1,313060,313060,313061,0,1,4
89413,2,1,313062,313062,313063,0,1,1
89414,5,1,313067,313067,313068,0,1,4
89415,4,1,313071,313071,313072,0,1,3
89416,2,1,313073,313073,313074,0,1,1
89417,4,2,313077,313077,313079,0,2,3
89418,2,3,313079,313079,313082,0,3,0
89419,4,1,313083,313083,313084,0,1,1
89420,5,3,313088,313088,313091,0,3,4
89421,5,3,313093,313093,313096,0,3,2
89422,6,2,313099,313099,313101,0,2,3
89423,2,2,313101,313101,313103,0,2,0
89424,6,2,313107,313107,313109,0,2,4
89425,2,2,313109,313109,313111,0,2,0
89426,1,1,313110,313111,313112,1,2,0
89427,1,2,313111,313112,313114,1,3,0
89428,4,3,313115,313115,313118,0,3,1
89429,1,3,313116,313118,313121,2,5,0
89430,6,3,313122,313122,313125,0,3,1
89431,2,3,313124,313125,313128,1,4,0
89432,1,2,313125,313128,313130,3,5,0
89433,6,1,313131,313131,313132,0,1,1
89434,5,3,313136,313136,313139,0,3,4
89435,6,3,313142,313142,313145,0,3,3
89436,1,1,313143,313145,313146,2,3,0
89437,6,3,313149,313149,313152,0,3,3
89438,4,1,313153,313153,313154,0,1,1
89439,4,3,313157,313157,313160,0,3,3
89440,3,3,313160,313160,313163,0,3,0
89441,3,2,313163,313163,313165,0,2,0
89442,1,1,313164,313165,313166,1,2,0
89443,3,1,313167,313167,313168,0,1,1
89444,1,2,313168,313168,313170,0,2,0
89445,3,2,313171,313171,313173,0,2,1
89446,4,3,313175,313175,313178,0,3,2
89447,6,2,313181,313181,313183,0,2,3
89448,5,3,313186,313186,313189,0,3,3
89449,3,3,313189,313189,313192,0,3,0
89450,1,1,313190,313192,313193,2,3,0
89451,5,2,313195,313195,313197,0,2,2
89452,4,3,313199,313199,313202,0,3,2
89453,6,1,313205,313205,313206,0,1,3
89454,6,1,313211,313211,313212,0,1,5
89455,4,3,313215,313215,313218,0,3,3
89456,3,2,313218,313218,313220,0,2,0
89457,3,1,313221,313221,313222,0,1,1
89458,5,3,313226,313226,313229,0,3,4
89459,3,3,313229,313229,313232,0,3,0
89460,5,2,313234,313234,313236,0,2,2
89461,2,1,313236,313236,313237,0,1,0
89462,4,1,313240,313240,313241,0,1,3
89463,6,1,313246,313246,313247,0,1,5
89464,4,2,313250,313250,313252,0,2,3
89465,1,2,313251,313252,313254,1,3,0
89466,2,1,313253,313254,313255,1,2,0
89467,5,3,313258,313258,313261,0,3,3
89468,2,2,313260,313261,313263,1,3,0
89469,2,2,313262,313263,313265,1,3,0
89470,1,3,313263,313265,313268,2,5,0
89471,2,1,313265,313268,313269,3,4,0
89472,5,3,313270,313270,313273,0,3,1
89473,2,2,313272,313273,313275,1,3,0
89474,5,1,313277,313277,313278,0,1,2
89475,4,2,313281,313281,313283,0,2,3
89476,4,2,313285,313285,313287,0,2,2
89477,4,2,313289,313289,313291,0,2,2
89478,4,2,313293,313293,313295,0,2,2
89479,6,1,313299,313299,313300,0,1,4
89480,3,2,313302,313302,313304,0,2,2
89481,1,1,313303,313304,313305,1,2,0
89482,2,3,313305,313305,313308,0,3,0
89483,2,1,313307,313308,313309,1,2,0
89484,1,1,313308,313309,313310,1,2,0
89485,4,2,313312,313312,313314,0,2,2
89486,5,3,313317,313317,313320,0,3,3
89487,3,2,313320,313320,313322,0,2,0
89488,3,1,313323,313323,313324,0,1,1
89489,5,2,313328,313328,313330,0,2,4
89490,2,3,313330,313330,313333,0,3,0
89491,5,3,313335,313335,313338,0,3,2
89492,3,2,313338,313338,313340,0,2,0
89493,1,1,313339,313340,313341,1,2,0
89494,4,1,313343,313343,313344,0,1,2
89495,4,1,313347,313347,313348,0,1,3
89496,1,3,313348,313348,313351,0,3,0
89497,3,1,313351,313351,313352,0,1,0
89498,5,2,313356,313356,313358,0,2,4
89499,3,1,313359,313359,313360,0,1,1
89500,1,3,313360,313360,313363,0,3,0
89501,4,2,313364,313364,313366,0,2,1
89502,3,3,313367,313367,313370,0,3,1
89503,2,2,313369,313370,313372,1,3,0
89504,4,3,313373,313373,313376,0,3,1
89505,5,3,313378,313378,313381,0,3,2
89506,2,2,313380,313381,313383,1,3,0
89507,2,2,313382,313383,313385,1,3,0
89508,5,1,313387,313387,313388,0,1,2
89509,1,1,313388,313388,313389,0,1,0
89510,3,3,313391,313391,313394,0,3,2
89511,3,2,313394,313394,313396,0,2,0
89512,6,3,313400,313400,313403,0,3,4
89513,6,3,313406,313406,313409,0,3,3
89514,6,1,313412,313412,313413,0,1,3
89515,5,2,313417,313417,313419,0,2,4
89516,6,3,313423,313423,313426,0,3,4
89517,4,1,313427,313427,313428,0,1,1
89518,6,2,313433,313433,313435,0,2,5
89519,4,3,313437,313437,313440,0,3,2
89520,6,1,313443,313443,313444,0,1,3
89521,6,2,313449,313449,313451,0,2,5
89522,1,1,313450,313451,313452,1,2,0
89523,1,1,313451,313452,313453,1,2,0
89524,2,3,313453,313453,313456,0,3,0
89525,3,2,313456,313456,313458,0,2,0
89526,5,3,313461,313461,313464,0,3,3
89527,3,1,313464,313464,313465,0,1,0
89528,6,1,313470,313470,313471,0,1,5
89529,3,2,313473,313473,313475,0,2,2
89530,6,2,313479,313479,313481,0,2,4
89531,1,1,313480,313481,313482,1,2,0
89532,4,3,313484,313484,313487,0,3,2
89533,2,2,313486,313487,313489,1,3,0
89534,4,2,313490,313490,313492,0,2,1
89535,2,3,313492,313492,313495,0,3,0
89536,1,1,313493,313495,313496,2,3,0
89537,4,1,313497,313497,313498,0,1,1
89538,2,3,313499,313499,313502,0,3,1
89539,6,3,313505,313505,313508,0,3,3
89540,1,3,313506,313508,313511,2,5,0
89541,5,3,313511,313511,313514,0,3,0
89542,5,1,313516,313516,313517,0,1,2
89543,4,3,313520,313520,313523,0,3,3
89544,3,1,313523,313523,313524,0,1,0
89545,5,2,313528,313528,313530,0,2,4
89546,1,2,313529,313530,313532,1,3,0
89547,1,2,313530,313532,313534,2,4,0
89548,1,2,313531,313534,313536,3,5,0
89549,1,2,313532,313536,313538,4,6,0
89550,4,3,313536,313538,313541,2,5,0
89551,2,2,313538,313541,313543,3,5,0
89552,5,1,313543,313543,313544,0,1,0
89553,3,1,313546,313546,313547,0,1,2
89554,1,1,313547,313547,313548,0,1,0
89555,1,1,313548,313548,313549,0,1,0
89556,3,2,313551,313551,313553,0,2,2
89557,2,3,313553,313553,313556,0,3,0
89558,4,2,313557,313557,313559,0,2,1
89559,6,1,313563,313563,313564,0,1,4
89560,2,3,313565,313565,313568,0,3,1
89561,3,2,313568,313568,313570,0,2,0
89562,3,1,313571,313571,313572,0,1,1
89563,1,1,313572,313572,313573,0,1,0
89564,6,3,313578,313578,313581,0,3,5
89565,5,2,313583,313583,313585,0,2,2
89566,6,2,313589,313589,313591,0,2,4
89567,3,1,313592,313592,313593,0,1,1
89568,3,3,313595,313595,313598,0,3,2
89569,4,2,313599,313599,313601,0,2,1
89570,5,1,313604,313604,313605,0,1,3
89571,4,1,313608,313608,313609,0,1,3
89572,2,2,313610,313610,313612,0,2,1
89573,6,3,313616,313616,313619,0,3,4
89574,6,3,313622,313622,313625,0,3,3
89575,4,2,313626,313626,313628,0,2,1
89576,5,2,313631,313631,313633,0,2,3
89577,1,3,313632,313633,313636,1,4,0
89578,6,1,313638,313638,313639,0,1,2
89579,3,3,313641,313641,313644,0,3,2
89580,4,2,313645,313645,313647,0,2,1
89581,6,2,313651,313651,313653,0,2,4
89582,3,3,313654,313654,313657,0,3,1
89583,2,2,313656,313657,313659,1,3,0
89584,2,2,313658,313659,313661,1,3,0
89585,3,3,313661,313661,313664,0,3,0
89586,1,1,313662,313664,313665,2,3,0
89587,6,3,313668,313668,313671,0,3,3
89588,6,3,313674,313674,313677,0,3,3
89589,1,3,313675,313677,313680,2,5,0
89590,6,2,313681,313681,313683,0,2,1
89591,2,1,313683,313683,313684,0,1,0
89592,2,3,313685,313685,313688,0,3,1
89593,5,1,313690,313690,313691,0,1,2
89594,5,3,313695,313695,313698,0,3,4
89595,4,2,313699,313699,313701,0,2,1
89596,4,1,313703,313703,313704,0,1,2
89597,1,3,313704,313704,313707,0,3,0
89598,1,3,313705,313707,313710,2,5,0
89599,5,2,313710,313710,313712,0,2,0
89600,5,3,313715,313715,313718,0,3,3
89601,4,1,313719,313719,313720,0,1,1
89602,6,3,313725,313725,313728,0,3,5
89603,1,3,313726,313728,313731,2,5,0
89604,1,1,313727,313731,313732,4,5,0
89605,1,2,313728,313732,313734,4,6,0
89606,6,1,313734,313734,313735,0,1,0
89607,3,1,313737,313737,313738,0,1,2
89608,3,1,313740,313740,313741,0,1,2
89609,5,2,313745,313745,313747,0,2,4
89610,6,2,313751,313751,313753,0,2,4
89611,4,3,313755,313755,313758,0,3,2
89612,4,2,313759,313759,313761,0,2,1
89613,5,2,313764,313764,313766,0,2,3
89614,6,2,313770,313770,313772,0,2,4
89615,3,2,313773,313773,313775,0,2,1
89616,3,3,313776,313776,313779,0,3,1
89617,4,3,313780,313780,313783,0,3,1
89618,3,3,313783,313783,313786,0,3,0
89619,1,2,313784,313786,313788,2,4,0
89620,2,1,313786,313788,313789,2,3,0
89621,2,3,313788,313789,313792,1,4,0
89622,1,2,313789,313792,313794,3,5,0
89623,2,1,313791,313794,313795,3,4,0
89624,4,1,313795,313795,313796,0,1,0
89625,4,1,313799,313799,313800,0,1,3
89626,5,2,313804,313804,313806,0,2,4
89627,6,2,313810,313810,313812,0,2,4
89628,1,2,313811,313812,313814,1,3,0
89629,2,3,313813,313814,313817,1,4,0
89630,5,2,313818,313818,313820,0,2,1
89631,4,1,313822,313822,313823,0,1,2
89632,1,2,313823,313823,313825,0,2,0
89633,1,3,313824,313825,313828,1,4,0
89634,1,2,313825,313828,313830,3,5,0
89635,2,2,313827,313830,313832,3,5,0
89636,1,1,313828,313832,313833,4,5,0
89637,1,3,313829,313833,313836,4,7,0
89638,3,2,313832,313836,313838,4,6,0
89639,5,3,313837,313838,313841,1,4,0
89640,2,3,313839,313841,313844,2,5,0
89641,3,1,313842,313844,313845,2,3,0
89642,5,3,313847,313847,313850,0,3,2
89643,6,2,313853,313853,313855,0,2,3
89644,5,3,313858,313858,313861,0,3,3
89645,3,1,313861,313861,313862,0,1,0
89646,6,3,313867,313867,313870,0,3,5
89647,2,3,313869,313870,313873,1,4,0
89648,3,3,313872,313873,313876,1,4,0
89649,4,1,313876,313876,313877,0,1,0
89650,4,2,313880,313880,313882,0,2,3
89651,3,1,313883,313883,313884,0,1,1
89652,5,2,313888,313888,313890,0,2,4
89653,2,1,313890,313890,313891,0,1,0
89654,5,1,313895,313895,313896,0,1,4
89655,1,1,313896,313896,313897,0,1,0
89656,3,3,313899,313899,313902,0,3,2
89657,6,3,313905,313905,313908,0,3,3
89658,1,2,313906,313908,313910,2,4,0
89659,4,3,313910,313910,313913,0,3,0
89660,1,2,313911,313913,313915,2,4,0
89661,6,2,313917,313917,313919,0,2,2
89662,6,1,313923,313923,313924,0,1,4
89663,4,1,313927,313927,313928,0,1,3
89664,2,2,313929,313929,313931,0,2,1
89665,1,3,313930,313931,313934,1,4,0
89666,4,2,313934,313934,313936,0,2,0
89667,2,1,313936,313936,313937,0,1,0
89668,5,2,313941,313941,313943,0,2,4
89669,4,1,313945,313945,313946,0,1,2
89670,5,1,313950,313950,313951,0,1,4
89671,6,2,313956,313956,313958,0,2,5
89672,5,1,313961,313961,313962,0,1,3
89673,2,1,313963,313963,313964,0,1,1
89674,5,1,313968,313968,313969,0,1,4
89675,3,3,313971,313971,313974,0,3,2
89676,4,1,313975,313975,313976,0,1,1
89677,1,1,313976,313976,313977,0,1,0
89678,5,3,313981,313981,313984,0,3,4
89679,5,3,313986,313986,313989,0,3,2
89680,1,2,313987,313989,313991,2,4,0
89681,2,2,313989,313991,313993,2,4,0
89682,3,3,313992,313993,313996,1,4,0
89683,4,2,313996,313996,313998,0,2,0
89684,6,2,314002,314002,314004,0,2,4
89685,5,2,314007,314007,314009,0,2,3
89686,2,1,314009,314009,314010,0,1,0
89687,2,1,314011,314011,314012,0,1,1
89688,1,3,314012,314012,314015,0,3,0
89689,3,1,314015,314015,314016,0,1,0
89690,1,3,314016,314016,314019,0,3,0
89691,2,1,314018,314019,314020,1,2,0
89692,5,2,314023,314023,314025,0,2,3
89693,1,3,314024,314025,314028,1,4,0
89694,4,2,314028,314028,314030,0,2,0
89695,2,2,314030,314030,314032,0,2,0
89696,3,2,314033,314033,314035,0,2,1
89697,6,1,314039,314039,314040,0,1,4
89698,3,2,314042,314042,314044,0,2,2
89699,4,3,314046,314046,314049,0,3,2
89700,6,3,314052,314052,314055,0,3,3
89701,4,2,314056,314056,314058,0,2,1
89702,4,1,314060,314060,314061,0,1,2
89703,2,2,314062,314062,314064,0,2,1
89704,1,2,314063,314064,314066,1,3,0
89705,4,1,314067,314067,314068,0,1,1
89706,4,1,314071,314071,314072,0,1,3
89707,1,3,314072,314072,314075,0,3,0
89708,2,2,314074,314075,314077,1,3,0
89709,2,1,314076,314077,314078,1,2,0
89710,1,2,314077,314078,314080,1,3,0
89711,1,3,314078,314080,314083,2,5,0
89712,1,2,314079,314083,314085,4,6,0
89713,5,2,314084,314085,314087,1,3,0
89714,1,1,314085,314087,314088,2,3,0
89715,2,2,314087,314088,314090,1,3,0
89716,3,2,314090,314090,314092,0,2,0
89717,3,3,314093,314093,314096,0,3,1
89718,2,3,314095,314096,314099,1,4,0
89719,6,1,314101,314101,314102,0,1,2
89720,4,2,314105,314105,314107,0,2,3
89721,5,2,314110,314110,314112,0,2,3
89722,1,3,314111,314112,314115,1,4,0
89723,1,3,314112,314115,314118,3,6,0
89724,4,1,314116,314118,314119,2,3,0
89725,2,3,314118,314119,314122,1,4,0
89726,4,3,314122,314122,314125,0,3,0
89727,5,3,314127,314127,314130,0,3,2
89728,3,3,314130,314130,314133,0,3,0
89729,1,3,314131,314133,314136,2,5,0
89730,3,2,314134,314136,314138,2,4,0
89731,3,3,314137,314138,314141,1,4,0
89732,1,3,314138,314141,314144,3,6,0
89733,1,1,314139,314144,314145,5,6,0
89734,5,3,314144,314145,314148,1,4,0
89735,6,1,314150,314150,314151,0,1,2
89736,5,2,314155,314155,314157,0,2,4
89737,1,1,314156,314157,314158,1,2,0
89738,5,3,314161,314161,314164,0,3,3
89739,5,1,314166,314166,314167,0,1,2
89740,3,1,314169,314169,314170,0,1,2
89741,3,3,314172,314172,314175,0,3,2
89742,2,2,314174,314175,314177,1,3,0
89743,2,3,314176,314177,314180,1,4,0
89744,2,2,314178,314180,314182,2,4,0
89745,3,1,314181,314182,314183,1,2,0
89746,6,1,314187,314187,314188,0,1,4
89747,3,1,314190,314190,314191,0,1,2
89748,6,2,314196,314196,314198,0,2,5
89749,3,1,314199,314199,314200,0,1,1
89750,5,2,314204,314204,314206,0,2,4
89751,5,1,314209,314209,314210,0,1,3
89752,4,2,314213,314213,314215,0,2,3
89753,4,1,314217,314217,314218,0,1,2
89754,5,3,314222,314222,314225,0,3,4
89755,4,2,314226,314226,314228,0,2,1
89756,1,1,314227,314228,314229,1,2,0
89757,6,3,314233,314233,314236,0,3,4
89758,3,1,314236,314236,314237,0,1,0
89759,2,1,314238,314238,314239,0,1,1
89760,1,2,314239,314239,314241,0,2,0
89761,4,3,314243,314243,314246,0,3,2
89762,3,2,314246,314246,314248,0,2,0
89763,5,2,314251,314251,314253,0,2,3
89764,1,2,314252,314253,314255,1,3,0
89765,6,3,314258,314258,314261,0,3,3
89766,3,3,314261,314261,314264,0,3,0
89767,1,3,314262,314264,314267,2,5,0
89768,2,1,314264,314267,314268,3,4,0
89769,3,3,314267,314268,314271,1,4,0
89770,6,3,314273,314273,314276,0,3,2
89771,4,3,314277,314277,314280,0,3,1
89772,4,1,314281,314281,314282,0,1,1
89773,4,3,314285,314285,314288,0,3,3
89774,1,2,314286,314288,314290,2,4,0
89775,2,3,314288,314290,314293,2,5,0
89776,1,2,314289,314293,314295,4,6,0
89777,3,3,314292,314295,314298,3,6,0
89778,1,2,314293,314298,314300,5,7,0
89779,3,1,314296,314300,314301,4,5,0
89780,2,2,314298,314301,314303,3,5,0
89781,1,1,314299,314303,314304,4,5,0
89782,4,2,314303,314304,314306,1,3,0
89783,2,1,314305,314306,314307,1,2,0
89784,3,2,314308,314308,314310,0,2,1
89785,4,1,314312,314312,314313,0,1,2
89786,5,3,314317,314317,314320,0,3,4
89787,2,1,314319,314320,314321,1,2,0
89788,3,1,314322,314322,314323,0,1,1
89789,2,2,314324,314324,314326,0,2,1
89790,2,3,314326,314326,314329,0,3,0
89791,4,2,314330,314330,314332,0,2,1
89792,6,2,314336,314336,314338,0,2,4
89793,1,3,314337,314338,314341,1,4,0
89794,3,1,314340,314341,314342,1,2,0
89795,1,1,314341,314342,314343,1,2,0
89796,6,1,314347,314347,314348,0,1,4
89797,6,3,314353,314353,314356,0,3,5
89798,1,1,314354,314356,314357,2,3,0
89799,4,2,314358,314358,314360,0,2,1
89800,1,2,314359,314360,314362,1,3,0
89801,4,2,314363,314363,314365,0,2,1
89802,3,2,314366,314366,314368,0,2,1
89803,6,1,314372,314372,314373,0,1,4
89804,1,2,314373,314373,314375,0,2,0
89805,1,2,314374,314375,314377,1,3,0
89806,6,3,314380,314380,314383,0,3,3
89807,5,3,314385,314385,314388,0,3,2
89808,6,3,314391,314391,314394,0,3,3
89809,5,1,314396,314396,314397,0,1,2
89810,3,2,314399,314399,314401,0,2,2
89811,6,2,314405,314405,314407,0,2,4
89812,4,2,314409,314409,314411,0,2,2
89813,6,3,314415,314415,314418,0,3,4
89814,4,2,314419,314419,314421,0,2,1
89815,5,1,314424,314424,314425,0,1,3
89816,5,1,314429,314429,314430,0,1,4
89817,2,3,314431,314431,314434,0,3,1
89818,2,2,314433,314434,314436,1,3,0
89819,3,1,314436,314436,314437,0,1,0
89820,2,2,314438,314438,314440,0,2,1
89821,6,2,314444,314444,314446,0,2,4
89822,2,2,314446,314446,314448,0,2,0
89823,3,2,314449,314449,314451,0,2,1
89824,4,2,314453,314453,314455,0,2,2
89825,2,3,314455,314455,314458,0,3,0
89826,6,1,314461,314461,314462,0,1,3
89827,5,1,314466,314466,314467,0,1,4
89828,4,2,314470,314470,314472,0,2,3
89829,3,2,314473,314473,314475,0,2,1
89830,3,2,314476,314476,314478,0,2,1
89831,2,2,314478,314478,314480,0,2,0
89832,1,2,314479,314480,314482,1,3,0
89833,1,1,314480,314482,314483,2,3,0
89834,6,3,314486,314486,314489,0,3,3
89835,2,2,314488,314489,314491,1,3,0
89836,2,3,314490,314491,314494,1,4,0
89837,5,2,314495,314495,314497,0,2,1
89838,1,2,314496,314497,314499,1,3,0
89839,1,2,314497,314499,314501,2,4,0
89840,2,3,314499,314501,314504,2,5,0
89841,2,2,314501,314504,314506,3,5,0
89842,4,2,314505,314506,314508,1,3,0
89843,5,1,314510,314510,314511,0,1,2
89844,2,1,314512,314512,314513,0,1,1
89845,4,1,314516,314516,314517,0,1,3
89846,5,3,314521,314521,314524,0,3,4
89847,2,1,314523,314524,314525,1,2,0
89848,1,1,314524,314525,314526,1,2,0
89849,4,3,314528,314528,314531,0,3,2
89850,1,3,314529,314531,314534,2,5,0
89851,4,3,314533,314534,314537,1,4,0
89852,1,1,314534,314537,314538,3,4,0
89853,3,2,314537,314538,314540,1,3,0
89854,3,1,314540,314540,314541,0,1,0
89855,6,1,314546,314546,314547,0,1,5
89856,4,3,314550,314550,314553,0,3,3
89857,5,2,314555,314555,314557,0,2,2
89858,6,1,314561,314561,314562,0,1,4
89859,6,3,314567,314567,314570,0,3,5
89860,5,1,314572,314572,314573,0,1,2
89861,3,3,314575,314575,314578,0,3,2
89862,6,3,314581,314581,314584,0,3,3
89863,4,3,314585,314585,314588,0,3,1
89864,2,2,314587,314588,314590,1,3,0
89865,6,3,314593,314593,314596,0,3,3
89866,1,1,314594,314596,314597,2,3,0
89867,1,1,314595,314597,314598,2,3,0
89868,6,3,314601,314601,314604,0,3,3
89869,5,2,314606,314606,314608,0,2,2
89870,1,3,314607,314608,314611,1,4,0
89871,6,3,314613,314613,314616,0,3,2
89872,5,1,314618,314618,314619,0,1,2
89873,2,2,314620,314620,314622,0,2,1
89874,3,2,314623,314623,314625,0,2,1
89875,4,3,314627,314627,314630,0,3,2
89876,6,2,314633,314633,314635,0,2,3
89877,5,1,314638,314638,314639,0,1,3
89878,6,2,314644,314644,314646,0,2,5
89879,3,2,314647,314647,314649,0,2,1
89880,3,2,314650,314650,314652,0,2,1
89881,2,2,314652,314652,314654,0,2,0
89882,2,1,314654,314654,314655,0,1,0
89883,4,1,314658,314658,314659,0,1,3
89884,5,1,314663,314663,314664,0,1,4
89885,5,3,314668,314668,314671,0,3,4
89886,5,1,314673,314673,314674,0,1,2
89887,6,2,314679,314679,314681,0,2,5
89888,5,2,314684,314684,314686,0,2,3
89889,3,2,314687,314687,314689,0,2,1
89890,2,1,314689,314689,314690,0,1,0
89891,2,1,314691,314691,314692,0,1,1
89892,1,3,314692,314692,314695,0,3,0
89893,6,3,314698,314698,314701,0,3,3
89894,2,3,314700,314701,314704,1,4,0
89895,3,2,314703,314704,314706,1,3,0
89896,3,2,314706,314706,314708,0,2,0
89897,1,2,314707,314708,314710,1,3,0
89898,5,3,314712,314712,314715,0,3,2
89899,5,1,314717,314717,314718,0,1,2
89900,4,1,314721,314721,314722,0,1,3
89901,3,2,314724,314724,314726,0,2,2
89902,3,2,314727,314727,314729,0,2,1
89903,1,2,314728,314729,314731,1,3,0
89904,1,3,314729,314731,314734,2,5,0
89905,3,2,314732,314734,314736,2,4,0
89906,1,1,314733,314736,314737,3,4,0
89907,4,1,314737,314737,314738,0,1,0
89908,4,3,314741,314741,314744,0,3,3
89909,6,2,314747,314747,314749,0,2,3
89910,1,1,314748,314749,314750,1,2,0
89911,4,1,314752,314752,314753,0,1,2
89912,2,3,314754,314754,314757,0,3,1
89913,2,3,314756,314757,314760,1,4,0
89914,4,1,314760,314760,314761,0,1,0
89915,1,3,314761,314761,314764,0,3,0
89916,4,2,314765,314765,314767,0,2,1
89917,1,1,314766,314767,314768,1,2,0
89918,2,2,314768,314768,314770,0,2,0
89919,2,1,314770,314770,314771,0,1,0
89920,2,3,314772,314772,314775,0,3,1
89921,5,2,314777,314777,314779,0,2,2
89922,5,3,314782,314782,314785,0,3,3
89923,6,1,314788,314788,314789,0,1,3
89924,3,1,314791,314791,314792,0,1,2
89925,4,2,314795,314795,314797,0,2,3
89926,1,2,314796,314797,314799,1,3,0
89927,3,1,314799,314799,314800,0,1,0
89928,4,3,314803,314803,314806,0,3,3
89929,2,3,314805,314806,314809,1,4,0
89930,3,1,314808,314809,314810,1,2,0
89931,5,2,314813,314813,314815,0,2,3
89932,3,1,314816,314816,314817,0,1,1
89933,4,2,314820,314820,314822,0,2,3
89934,6,1,314826,314826,314827,0,1,4
89935,2,1,314828,314828,314829,0,1,1
89936,1,1,314829,314829,314830,0,1,0
89937,1,1,314830,314830,314831,0,1,0
89938,4,2,314834,314834,314836,0,2,3
89939,1,3,314835,314836,314839,1,4,0
89940,3,2,314838,314839,314841,1,3,0
89941,3,2,314841,314841,314843,0,2,0
89942,6,1,314847,314847,314848,0,1,4
89943,3,1,314850,314850,314851,0,1,2
89944,1,2,314851,314851,314853,0,2,0
89945,4,2,314855,314855,314857,0,2,2
89946,4,3,314859,314859,314862,0,3,2
89947,1,1,314860,314862,314863,2,3,0
89948,1,3,314861,314863,314866,2,5,0
89949,6,2,314867,314867,314869,0,2,1
89950,2,3,314869,314869,314872,0,3,0
89951,1,2,314870,314872,314874,2,4,0
89952,2,3,314872,314874,314877,2,5,0
89953,1,3,314873,314877,314880,4,7,0
89954,2,2,314875,314880,314882,5,7,0
89955,5,2,314880,314882,314884,2,4,0
89956,3,1,314883,314884,314885,1,2,0
89957,3,1,314886,314886,314887,0,1,1
89958,2,1,314888,314888,314889,0,1,1
89959,3,2,314891,314891,314893,0,2,2
89960,2,3,314893,314893,314896,0,3,0
89961,5,3,314898,314898,314901,0,3,2
89962,5,3,314903,314903,314906,0,3,2
89963,5,2,314908,314908,314910,0,2,2
89964,2,1,314910,314910,314911,0,1,0
89965,6,1,314916,314916,314917,0,1,5
89966,3,1,314919,314919,314920,0,1,2
89967,2,1,314921,314921,314922,0,1,1
89968,3,2,314924,314924,314926,0,2,2
89969,6,2,314930,314930,314932,0,2,4
89970,3,3,314933,314933,314936,0,3,1
89971,2,2,314935,314936,314938,1,3,0
89972,5,3,314940,314940,314943,0,3,2
89973,2,1,314942,314943,314944,1,2,0
89974,3,2,314945,314945,314947,0,2,1
89975,2,2,314947,314947,314949,0,2,0
89976,3,3,314950,314950,314953,0,3,1
89977,2,1,314952,314953,314954,1,2,0
89978,4,2,314956,314956,314958,0,2,2
89979,2,1,314958,314958,314959,0,1,0
89980,1,1,314959,314959,314960,0,1,0
89981,2,1,314961,314961,314962,0,1,1
89982,4,2,314965,314965,314967,0,2,3
89983,3,1,314968,314968,314969,0,1,1
89984,3,1,314971,314971,314972,0,1,2
89985,3,2,314974,314974,314976,0,2,2
89986,4,1,314978,314978,314979,0,1,2
89987,5,2,314983,314983,314985,0,2,4
89988,1,3,314984,314985,314988,1,4,0
89989,1,2,314985,314988,314990,3,5,0
89990,3,1,314988,314990,314991,2,3,0
89991,3,1,314991,314991,314992,0,1,0
89992,2,3,314993,314993,314996,0,3,1
89993,3,1,314996,314996,314997,0,1,0
89994,2,3,314998,314998,315001,0,3,1
89995,2,2,315000,315001,315003,1,3,0
89996,1,2,315001,315003,315005,2,4,0
89997,1,1,315002,315005,315006,3,4,0
89998,6,3,315008,315008,315011,0,3,2
89999,1,3,315009,315011,315014,2,5,0
90000,2,1,315011,315014,315015,3,4,0
90001,1,3,315012,315015,315018,3,6,0
90002,6,2,315018,315018,315020,0,2,0
90003,4,3,315022,315022,315025,0,3,2
90004,2,2,315024,315025,315027,1,3,0
90005,4,3,315028,315028,315031,0,3,1
90006,5,3,315033,315033,315036,0,3,2
90007,5,2,315038,315038,315040,0,2,2
90008,6,3,315044,315044,315047,0,3,4
90009,1,2,315045,315047,315049,2,4,0
90010,4,3,315049,315049,315052,0,3,0
90011,6,1,315055,315055,315056,0,1,3
90012,1,1,315056,315056,315057,0,1,0
90013,5,3,315061,315061,315064,0,3,4
90014,3,1,315064,315064,315065,0,1,0
90015,5,1,315069,315069,315070,0,1,4
90016,1,3,315070,315070,315073,0,3,0
90017,3,3,315073,315073,315076,0,3,0
90018,6,2,315079,315079,315081,0,2,3
90019,3,2,315082,315082,315084,0,2,1
90020,4,3,315086,315086,315089,0,3,2
90021,6,1,315092,315092,315093,0,1,3
90022,5,1,315097,315097,315098,0,1,4
90023,6,2,315103,315103,315105,0,2,5
90024,2,1,315105,315105,315106,0,1,0
90025,6,1,315111,315111,315112,0,1,5
90026,3,2,315114,315114,315116,0,2,2
90027,4,3,315118,315118,315121,0,3,2
90028,6,3,315124,315124,315127,0,3,3
90029,6,3,315130,315130,315133,0,3,3
90030,4,1,315134,315134,315135,0,1,1
90031,5,1,315139,315139,315140,0,1,4
90032,2,1,315141,315141,315142,0,1,1
90033,1,2,315142,315142,315144,0,2,0
90034,1,3,315143,315144,315147,1,4,0
90035,3,1,315146,315147,315148,1,2,0
90036,4,3,315150,315150,315153,0,3,2
90037,2,2,315152,315153,315155,1,3,0
90038,3,1,315155,315155,315156,0,1,0
90039,2,3,315157,315157,315160,0,3,1
90040,3,1,315160,315160,315161,0,1,0
90041,5,3,315165,315165,315168,0,3,4
90042,3,1,315168,315168,315169,0,1,0
90043,6,2,315174,315174,315176,0,2,5
90044,3,2,315177,315177,315179,0,2,1
90045,3,3,315180,315180,315183,0,3,1
90046,1,2,315181,315183,315185,2,4,0
90047,2,1,315183,315185,315186,2,3,0
90048,3,3,315186,315186,315189,0,3,0
90049,5,1,315191,315191,315192,0,1,2
90050,6,2,315197,315197,315199,0,2,5
90051,3,1,315200,315200,315201,0,1,1
90052,2,2,315202,315202,315204,0,2,1
90053,3,2,315205,315205,315207,0,2,1
90054,2,1,315207,315207,315208,0,1,0
90055,1,3,315208,315208,315211,0,3,0
90056,2,1,315210,315211,315212,1,2,0
90057,5,2,315215,315215,315217,0,2,3
90058,1,2,315216,315217,315219,1,3,0
90059,5,1,315221,315221,315222,0,1,2
90060,1,3,315222,315222,315225,0,3,0
90061,5,2,315227,315227,315229,0,2,2
90062,5,2,315232,315232,315234,0,2,3
90063,4,2,315236,315236,315238,0,2,2
90064,6,3,315242,315242,315245,0,3,4
90065,5,3,315247,315247,315250,0,3,2
90066,1,2,315248,315250,315252,2,4,0
90067,6,3,315254,315254,315257,0,3,2
90068,3,3,315257,315257,315260,0,3,0
90069,5,2,315262,315262,315264,0,2,2
90070,6,3,315268,315268,315271,0,3,4
90071,4,1,315272,315272,315273,0,1,1
90072,4,2,315276,315276,315278,0,2,3
90073,5,1,315281,315281,315282,0,1,3
90074,1,2,315282,315282,315284,0,2,0
90075,4,1,315286,315286,315287,0,1,2
90076,1,1,315287,315287,315288,0,1,0
90077,5,1,315292,315292,315293,0,1,4
90078,4,2,315296,315296,315298,0,2,3
90079,2,1,315298,315298,315299,0,1,0
90080,2,2,315300,315300,315302,0,2,1
90081,1,2,315301,315302,315304,1,3,0
90082,3,3,315304,315304,315307,0,3,0
90083,5,3,315309,315309,315312,0,3,2
90084,4,3,315313,315313,315316,0,3,1
90085,5,3,315318,315318,315321,0,3,2
90086,3,1,315321,315321,315322,0,1,0
90087,2,2,315323,315323,315325,0,2,1
90088,6,1,315329,315329,315330,0,1,4
90089,6,1,315335,315335,315336,0,1,5
90090,5,2,315340,315340,315342,0,2,4
90091,1,3,315341,315342,315345,1,4,0
90092,2,3,315343,315345,315348,2,5,0
90093,1,3,315344,315348,315351,4,7,0
90094,2,1,315346,315351,315352,5,6,0
90095,5,1,315351,315352,315353,1,2,0
90096,1,3,315352,315353,315356,1,4,0
90097,1,1,315353,315356,315357,3,4,0
90098,4,3,315357,315357,315360,0,3,0
90099,3,1,315360,315360,315361,0,1,0
90100,5,2,315365,315365,315367,0,2,4
90101,1,3,315366,315367,315370,1,4,0
90102,3,1,315369,315370,315371,1,2,0
90103,2,1,315371,315371,315372,0,1,0
90104,5,3,315376,315376,315379,0,3,4
90105,6,2,315382,315382,315384,0,2,3
90106,1,2,315383,315384,315386,1,3,0
90107,2,1,315385,315386,315387,1,2,0
90108,2,3,315387,315387,315390,0,3,0
90109,6,3,315393,315393,315396,0,3,3
90110,3,1,315396,315396,315397,0,1,0
90111,2,1,315398,315398,315399,0,1,1
90112,3,3,315401,315401,315404,0,3,2
90113,2,1,315403,315404,315405,1,2,0
90114,1,2,315404,315405,315407,1,3,0
90115,3,3,315407,315407,315410,0,3,0
90116,6,3,315413,315413,315416,0,3,3
90117,1,1,315414,315416,315417,2,3,0
90118,6,1,315420,315420,315421,0,1,3
90119,1,2,315421,315421,315423,0,2,0
90120,6,1,315427,315427,315428,0,1,4
90121,4,2,315431,315431,315433,0,2,3
90122,5,3,315436,315436,315439,0,3,3
90123,5,2,315441,315441,315443,0,2,2
90124,1,2,315442,315443,315445,1,3,0
90125,5,3,315447,315447,315450,0,3,2
90126,3,3,315450,315450,315453,0,3,0
90127,6,1,315456,315456,315457,0,1,3
90128,5,1,315461,315461,315462,0,1,4
90129,4,3,315465,315465,315468,0,3,3
90130,1,1,315466,315468,315469,2,3,0
90131,1,2,315467,315469,315471,2,4,0
90132,2,3,315469,315471,315474,2,5,0
90133,1,1,315470,315474,315475,4,5,0
90134,3,3,315473,315475,315478,2,5,0
90135,1,2,315474,315478,315480,4,6,0
90136,4,1,315478,315480,315481,2,3,0
90137,2,2,315480,315481,315483,1,3,0
90138,5,1,315485,315485,315486,0,1,2
90139,6,2,315491,315491,315493,0,2,5
90140,2,3,315493,315493,315496,0,3,0
90141,1,3,315494,315496,315499,2,5,0
90142,5,2,315499,315499,315501,0,2,0
90143,2,2,315501,315501,315503,0,2,0
90144,1,2,315502,315503,315505,1,3,0
90145,5,2,315507,315507,315509,0,2,2
90146,3,1,315510,315510,315511,0,1,1
90147,1,1,315511,315511,315512,0,1,0
90148,1,1,315512,315512,315513,0,1,0
90149,2,1,315514,315514,315515,0,1,1
90150,3,2,315517,315517,315519,0,2,2
90151,2,2,315519,315519,315521,0,2,0
90152,3,2,315522,315522,315524,0,2,1
90153,2,2,315524,315524,315526,0,2,0
90154,4,3,315528,315528,315531,0,3,2
90155,2,1,315530,315531,315532,1,2,0
90156,5,2,315535,315535,315537,0,2,3
90157,6,3,315541,315541,315544,0,3,4
90158,2,1,315543,315544,315545,1,2,0
90159,4,1,315547,315547,315548,0,1,2
90160,6,2,315553,315553,315555,0,2,5
90161,4,3,315557,315557,315560,0,3,2
90162,2,3,315559,315560,315563,1,4,0
90163,5,3,315564,315564,315567,0,3,1
90164,6,2,315570,315570,315572,0,2,3
90165,1,1,315571,315572,315573,1,2,0
90166,1,3,315572,315573,315576,1,4,0
90167,5,2,315577,315577,315579,0,2,1
90168,4,2,315581,315581,315583,0,2,2
90169,3,1,315584,315584,315585,0,1,1
90170,5,3,315589,315589,315592,0,3,4
90171,5,2,315594,315594,315596,0,2,2
90172,5,1,315599,315599,315600,0,1,3
90173,3,1,315602,315602,315603,0,1,2
90174,1,3,315603,315603,315606,0,3,0
90175,3,3,315606,315606,315609,0,3,0
90176,4,3,315610,315610,315613,0,3,1
90177,4,3,315614,315614,315617,0,3,1
90178,5,3,315619,315619,315622,0,3,2
90179,6,2,315625,315625,315627,0,2,3
90180,4,3,315629,315629,315632,0,3,2
90181,2,3,315631,315632,315635,1,4,0
90182,6,3,315637,315637,315640,0,3,2
90183,1,3,315638,315640,315643,2,5,0
90184,4,2,315642,315643,315645,1,3,0
90185,3,1,315645,315645,315646,0,1,0
90186,5,2,315650,315650,315652,0,2,4
90187,6,3,315656,315656,315659,0,3,4
90188,6,3,315662,315662,315665,0,3,3
90189,3,3,315665,315665,315668,0,3,0
90190,2,2,315667,315668,315670,1,3,0
90191,2,2,315669,315670,315672,1,3,0
90192,2,3,315671,315672,315675,1,4,0
90193,4,1,315675,315675,315676,0,1,0
90194,1,2,315676,315676,315678,0,2,0
90195,4,1,315680,315680,315681,0,1,2
90196,6,2,315686,315686,315688,0,2,5
90197,6,2,315692,315692,315694,0,2,4
90198,1,3,315693,315694,315697,1,4,0
90199,6,3,315699,315699,315702,0,3,2
90200,3,2,315702,315702,315704,0,2,0
90201,2,2,315704,315704,315706,0,2,0
90202,5,2,315709,315709,315711,0,2,3
90203,2,2,315711,315711,315713,0,2,0
90204,6,3,315717,315717,315720,0,3,4
90205,5,1,315722,315722,315723,0,1,2
90206,3,2,315725,315725,315727,0,2,2
90207,5,2,315730,315730,315732,0,2,3
90208,2,1,315732,315732,315733,0,1,0
90209,2,2,315734,315734,315736,0,2,1
90210,5,2,315739,315739,315741,0,2,3
90211,1,2,315740,315741,315743,1,3,0
90212,6,1,315746,315746,315747,0,1,3
90213,4,2,315750,315750,315752,0,2,3
90214,5,3,315755,315755,315758,0,3,3
90215,6,3,315761,315761,315764,0,3,3
90216,3,1,315764,315764,315765,0,1,0
90217,2,2,315766,315766,315768,0,2,1
90218,2,2,315768,315768,315770,0,2,0
90219,1,2,315769,315770,315772,1,3,0
90220,3,3,315772,315772,315775,0,3,0
90221,4,3,315776,315776,315779,0,3,1
90222,6,3,315782,315782,315785,0,3,3
90223,3,1,315785,315785,315786,0,1,0
90224,5,3,315790,315790,315793,0,3,4
90225,3,3,315793,315793,315796,0,3,0
90226,1,2,315794,315796,315798,2,4,0
90227,4,2,315798,315798,315800,0,2,0
90228,6,2,315804,315804,315806,0,2,4
90229,6,3,315810,315810,315813,0,3,4
90230,5,2,315815,315815,315817,0,2,2
90231,2,2,315817,315817,315819,0,2,0
90232,1,2,315818,315819,315821,1,3,0
90233,5,3,315823,315823,315826,0,3,2
90234,4,1,315827,315827,315828,0,1,1
90235,1,2,315828,315828,315830,0,2,0
90236,6,2,315834,315834,315836,0,2,4
90237,5,1,315839,315839,315840,0,1,3
90238,2,3,315841,315841,315844,0,3,1
90239,2,1,315843,315844,315845,1,2,0
90240,1,2,315844,315845,315847,1,3,0
90241,3,1,315847,315847,315848,0,1,0
90242,5,1,315852,315852,315853,0,1,4
90243,5,3,315857,315857,315860,0,3,4
90244,6,3,315863,315863,315866,0,3,3
90245,5,2,315868,315868,315870,0,2,2
90246,4,1,315872,315872,315873,0,1,2
90247,6,3,315878,315878,315881,0,3,5
90248,1,3,315879,315881,315884,2,5,0
90249,4,2,315883,315884,315886,1,3,0
90250,5,1,315888,315888,315889,0,1,2
90251,3,2,315891,315891,315893,0,2,2
90252,4,3,315895,315895,315898,0,3,2
90253,3,1,315898,315898,315899,0,1,0
90254,5,2,315903,315903,315905,0,2,4
90255,2,2,315905,315905,315907,0,2,0
90256,5,1,315910,315910,315911,0,1,3
90257,6,2,315916,315916,315918,0,2,5
90258,1,1,315917,315918,315919,1,2,0
90259,2,3,315919,315919,315922,0,3,0
90260,6,3,315925,315925,315928,0,3,3
90261,1,2,315926,315928,315930,2,4,0
90262,4,2,315930,315930,315932,0,2,0
90263,3,3,315933,315933,315936,0,3,1
90264,3,3,315936,315936,315939,0,3,0
90265,5,3,315941,315941,315944,0,3,2
90266,4,2,315945,315945,315947,0,2,1
90267,3,3,315948,315948,315951,0,3,1
90268,2,2,315950,315951,315953,1,3,0
90269,5,3,315955,315955,315958,0,3,2
90270,2,2,315957,315958,315960,1,3,0
90271,3,2,315960,315960,315962,0,2,0
90272,6,1,315966,315966,315967,0,1,4
90273,6,1,315972,315972,315973,0,1,5
90274,6,3,315978,315978,315981,0,3,5
90275,4,2,315982,315982,315984,0,2,1
90276,2,3,315984,315984,315987,0,3,0
90277,2,2,315986,315987,315989,1,3,0
90278,2,2,315988,315989,315991,1,3,0
90279,5,2,315993,315993,315995,0,2,2
90280,2,1,315995,315995,315996,0,1,0
90281,6,3,316001,316001,316004,0,3,5
90282,2,1,316003,316004,316005,1,2,0
90283,3,2,316006,316006,316008,0,2,1
90284,6,3,316012,316012,316015,0,3,4
90285,3,2,316015,316015,316017,0,2,0
90286,5,2,316020,316020,316022,0,2,3
90287,3,1,316023,316023,316024,0,1,1
90288,4,1,316027,316027,316028,0,1,3
90289,4,1,316031,316031,316032,0,1,3
90290,3,3,316034,316034,316037,0,3,2
90291,2,2,316036,316037,316039,1,3,0
90292,4,2,316040,316040,316042,0,2,1
90293,6,3,316046,316046,316049,0,3,4
90294,3,2,316049,316049,316051,0,2,0
90295,3,2,316052,316052,316054,0,2,1
90296,2,1,316054,316054,316055,0,1,0
90297,2,1,316056,316056,316057,0,1,1
90298,2,3,316058,316058,316061,0,3,1
90299,3,3,316061,316061,316064,0,3,0
90300,6,2,316067,316067,316069,0,2,3
90301,6,1,316073,316073,316074,0,1,4
90302,1,1,316074,316074,316075,0,1,0
90303,2,2,316076,316076,316078,0,2,1
90304,6,2,316082,316082,316084,0,2,4
90305,1,1,316083,316084,316085,1,2,0
90306,5,3,316088,316088,316091,0,3,3
90307,4,3,316092,316092,316095,0,3,1
90308,5,2,316097,316097,316099,0,2,2
90309,6,3,316103,316103,316106,0,3,4
90310,4,1,316107,316107,316108,0,1,1
90311,3,3,316110,316110,316113,0,3,2
90312,3,3,316113,316113,316116,0,3,0
90313,3,3,316116,316116,316119,0,3,0
90314,4,2,316120,316120,316122,0,2,1
90315,5,3,316125,316125,316128,0,3,3
90316,4,3,316129,316129,316132,0,3,1
90317,6,2,316135,316135,316137,0,2,3
90318,2,2,316137,316137,316139,0,2,0
90319,1,3,316138,316139,316142,1,4,0
90320,2,2,316140,316142,316144,2,4,0
90321,3,3,316143,316144,316147,1,4,0
90322,4,1,316147,316147,316148,0,1,0
90323,4,3,316151,316151,316154,0,3,3
90324,4,1,316155,316155,316156,0,1,1
90325,4,1,316159,316159,316160,0,1,3
90326,6,2,316165,316165,316167,0,2,5
90327,6,3,316171,316171,316174,0,3,4
90328,1,3,316172,316174,316177,2,5,0
90329,1,1,316173,316177,316178,4,5,0
90330,6,3,316179,316179,316182,0,3,1
90331,2,3,316181,316182,316185,1,4,0
90332,3,2,316184,316185,316187,1,3,0
90333,6,3,316190,316190,316193,0,3,3
90334,2,3,316192,316193,316196,1,4,0
90335,4,1,316196,316196,316197,0,1,0
90336,5,1,316201,316201,316202,0,1,4
90337,3,3,316204,316204,316207,0,3,2
90338,3,3,316207,316207,316210,0,3,0
90339,1,2,316208,316210,316212,2,4,0
90340,5,3,316213,316213,316216,0,3,1
90341,6,3,316219,316219,316222,0,3,3
90342,3,1,316222,316222,316223,0,1,0
90343,6,3,316228,316228,316231,0,3,5
90344,4,3,316232,316232,316235,0,3,1
90345,2,3,316234,316235,316238,1,4,0
90346,4,1,316238,316238,316239,0,1,0
90347,5,2,316243,316243,316245,0,2,4
90348,2,3,316245,316245,316248,0,3,0
90349,3,1,316248,316248,316249,0,1,0
90350,4,3,316252,316252,316255,0,3,3
90351,6,1,316258,316258,316259,0,1,3
90352,1,1,316259,316259,316260,0,1,0
90353,5,3,316264,316264,316267,0,3,4
90354,6,2,316270,316270,316272,0,2,3
90355,2,2,316272,316272,316274,0,2,0
90356,6,2,316278,316278,316280,0,2,4
90357,4,2,316282,316282,316284,0,2,2
90358,3,1,316285,316285,316286,0,1,1
90359,2,2,316287,316287,316289,0,2,1
90360,5,2,316292,316292,316294,0,2,3
90361,2,1,316294,316294,316295,0,1,0
90362,2,2,316296,316296,316298,0,2,1
90363,4,2,316300,316300,316302,0,2,2
90364,4,3,316304,316304,316307,0,3,2
90365,6,2,316310,316310,316312,0,2,3
90366,5,1,316315,316315,316316,0,1,3
90367,5,3,316320,316320,316323,0,3,4
90368,4,3,316324,316324,316327,0,3,1
90369,4,1,316328,316328,316329,0,1,1
90370,4,2,316332,316332,316334,0,2,3
90371,1,3,316333,316334,316337,1,4,0
90372,4,1,316337,316337,316338,0,1,0
90373,5,2,316342,316342,316344,0,2,4
90374,5,1,316347,316347,316348,0,1,3
90375,2,2,316349,316349,316351,0,2,1
90376,5,3,316354,316354,316357,0,3,3
90377,6,1,316360,316360,316361,0,1,3
90378,3,1,316363,316363,316364,0,1,2
90379,1,3,316364,316364,316367,0,3,0
90380,6,2,316370,316370,316372,0,2,3
90381,4,1,316374,316374,316375,0,1,2
90382,5,1,316379,316379,316380,0,1,4
90383,4,2,316383,316383,316385,0,2,3
90384,6,1,316389,316389,316390,0,1,4
90385,1,3,316390,316390,316393,0,3,0
90386,6,1,316396,316396,316397,0,1,3
90387,5,1,316401,316401,316402,0,1,4
90388,6,3,316407,316407,316410,0,3,5
90389,2,2,316409,316410,316412,1,3,0
90390,4,2,316413,316413,316415,0,2,1
90391,2,1,316415,316415,316416,0,1,0
90392,5,1,316420,316420,316421,0,1,4
90393,6,3,316426,316426,316429,0,3,5
90394,6,1,316432,316432,316433,0,1,3
90395,3,1,316435,316435,316436,0,1,2
90396,1,2,316436,316436,316438,0,2,0
90397,5,1,316441,316441,316442,0,1,3
90398,5,2,316446,316446,316448,0,2,4
90399,6,1,316452,316452,316453,0,1,4
90400,5,1,316457,316457,316458,0,1,4
90401,3,2,316460,316460,316462,0,2,2
90402,2,1,316462,316462,316463,0,1,0
90403,4,1,316466,316466,316467,0,1,3
90404,6,1,316472,316472,316473,0,1,5
90405,4,2,316476,316476,316478,0,2,3
90406,1,1,316477,316478,316479,1,2,0
90407,3,2,316480,316480,316482,0,2,1
90408,4,3,316484,316484,316487,0,3,2
90409,3,3,316487,316487,316490,0,3,0
90410,4,3,316491,316491,316494,0,3,1
90411,3,1,316494,316494,316495,0,1,0
90412,2,3,316496,316496,316499,0,3,1
90413,4,1,316500,316500,316501,0,1,1
90414,2,1,316502,316502,316503,0,1,1
90415,3,3,316505,316505,316508,0,3,2
90416,1,1,316506,316508,316509,2,3,0
90417,3,2,316509,316509,316511,0,2,0
90418,1,1,316510,316511,316512,1,2,0
90419,6,3,316516,316516,316519,0,3,4
90420,5,1,316521,316521,316522,0,1,2
90421,1,2,316522,316522,316524,0,2,0
90422,3,1,316525,316525,316526,0,1,1
90423,4,3,316529,316529,316532,0,3,3
90424,4,3,316533,316533,316536,0,3,1
90425,2,3,316535,316536,316539,1,4,0
90426,3,2,316538,316539,316541,1,3,0
90427,1,2,316539,316541,316543,2,4,0
90428,1,3,316540,316543,316546,3,6,0
90429,4,3,316544,316546,316549,2,5,0
90430,1,3,316545,316549,316552,4,7,0
90431,3,1,316548,316552,316553,4,5,0
90432,1,3,316549,316553,316556,4,7,0
90433,2,1,316551,316556,316557,5,6,0
90434,1,3,316552,316557,316560,5,8,0
90435,2,3,316554,316560,316563,6,9,0
90436,2,2,316556,316563,316565,7,9,0
90437,3,3,316559,316565,316568,6,9,0
90438,5,2,316564,316568,316570,4,6,0
90439,4,1,316568,316570,316571,2,3,0
90440,2,3,316570,316571,316574,1,4,0
90441,4,2,316574,316574,316576,0,2,0
90442,5,2,316579,316579,316581,0,2,3
90443,1,1,316580,316581,316582,1,2,0
90444,6,2,316586,316586,316588,0,2,4
90445,2,3,316588,316588,316591,0,3,0
90446,1,1,316589,316591,316592,2,3,0
90447,5,2,316594,316594,316596,0,2,2
90448,4,3,316598,316598,316601,0,3,2
90449,5,2,316603,316603,316605,0,2,2
90450,1,1,316604,316605,316606,1,2,0
90451,3,3,316607,316607,316610,0,3,1
90452,4,2,316611,316611,316613,0,2,1
90453,6,1,316617,316617,316618,0,1,4
90454,6,1,316623,316623,316624,0,1,5
90455,1,2,316624,316624,316626,0,2,0
90456,5,1,316629,316629,316630,0,1,3
90457,5,3,316634,316634,316637,0,3,4
90458,4,2,316638,316638,316640,0,2,1
90459,5,3,316643,316643,316646,0,3,3
90460,3,3,316646,316646,316649,0,3,0
90461,6,2,316652,316652,316654,0,2,3
90462,3,3,316655,316655,316658,0,3,1
90463,6,2,316661,316661,316663,0,2,3
90464,4,1,316665,316665,316666,0,1,2
90465,1,3,316666,316666,316669,0,3,0
90466,3,2,316669,316669,316671,0,2,0
90467,3,1,316672,316672,316673,0,1,1
90468,5,3,316677,316677,316680,0,3,4
90469,6,3,316683,316683,316686,0,3,3
90470,2,3,316685,316686,316689,1,4,0
90471,1,3,316686,316689,316692,3,6,0
90472,6,1,316692,316692,316693,0,1,0
90473,3,3,316695,316695,316698,0,3,2
90474,1,1,316696,316698,316699,2,3,0
90475,3,3,316699,316699,316702,0,3,0
90476,5,1,316704,316704,316705,0,1,2
90477,2,3,316706,316706,316709,0,3,1
90478,6,3,316712,316712,316715,0,3,3
90479,2,3,316714,316715,316718,1,4,0
90480,6,2,316720,316720,316722,0,2,2
90481,1,1,316721,316722,316723,1,2,0
90482,2,2,316723,316723,316725,0,2,0
90483,1,1,316724,316725,316726,1,2,0
90484,4,3,316728,316728,316731,0,3,2
90485,3,2,316731,316731,316733,0,2,0
90486,6,2,316737,316737,316739,0,2,4
90487,2,2,316739,316739,316741,0,2,0
90488,3,2,316742,316742,316744,0,2,1
90489,4,1,316746,316746,316747,0,1,2
90490,3,2,316749,316749,316751,0,2,2
90491,2,2,316751,316751,316753,0,2,0
90492,4,3,316755,316755,316758,0,3,2
90493,4,1,316759,316759,316760,0,1,1
90494,1,3,316760,316760,316763,0,3,0
90495,2,2,316762,316763,316765,1,3,0
90496,2,1,316764,316765,316766,1,2,0
90497,1,1,316765,316766,316767,1,2,0
90498,4,2,316769,316769,316771,0,2,2
90499,2,1,316771,316771,316772,0,1,0
90500,3,1,316774,316774,316775,0,1,2
90501,2,3,316776,316776,316779,0,3,1
90502,4,1,316780,316780,316781,0,1,1
90503,3,3,316783,316783,316786,0,3,2
90504,2,1,316785,316786,316787,1,2,0
90505,5,3,316790,316790,316793,0,3,3
90506,6,3,316796,316796,316799,0,3,3
90507,3,3,316799,316799,316802,0,3,0
90508,1,2,316800,316802,316804,2,4,0
90509,2,3,316802,316804,316807,2,5,0
90510,2,1,316804,316807,316808,3,4,0
90511,4,2,316808,316808,316810,0,2,0
90512,4,1,316812,316812,316813,0,1,2
90513,4,1,316816,316816,316817,0,1,3
90514,1,2,316817,316817,316819,0,2,0
90515,3,3,316820,316820,316823,0,3,1
90516,2,3,316822,316823,316826,1,4,0
90517,5,1,316827,316827,316828,0,1,1
90518,1,1,316828,316828,316829,0,1,0
90519,4,3,316832,316832,316835,0,3,3
90520,1,2,316833,316835,316837,2,4,0
90521,4,1,316837,316837,316838,0,1,0
90522,1,1,316838,316838,316839,0,1,0
90523,6,3,316844,316844,316847,0,3,5
90524,3,1,316847,316847,316848,0,1,0
90525,5,1,316852,316852,316853,0,1,4
90526,3,2,316855,316855,316857,0,2,2
90527,6,1,316861,316861,316862,0,1,4
90528,2,1,316863,316863,316864,0,1,1
90529,6,2,316869,316869,316871,0,2,5
90530,4,1,316873,316873,316874,0,1,2
90531,4,3,316877,316877,316880,0,3,3
90532,6,2,316883,316883,316885,0,2,3
90533,5,3,316888,316888,316891,0,3,3
90534,1,3,316889,316891,316894,2,5,0
90535,3,1,316892,316894,316895,2,3,0
90536,1,1,316893,316895,316896,2,3,0
90537,3,2,316896,316896,316898,0,2,0
90538,4,2,316900,316900,316902,0,2,2
90539,4,1,316904,316904,316905,0,1,2
90540,3,2,316907,316907,316909,0,2,2
90541,6,1,316913,316913,316914,0,1,4
90542,3,3,316916,316916,316919,0,3,2
90543,2,2,316918,316919,316921,1,3,0
90544,3,1,316921,316921,316922,0,1,0
90545,4,3,316925,316925,316928,0,3,3
90546,6,2,316931,316931,316933,0,2,3
90547,5,2,316936,316936,316938,0,2,3
90548,6,3,316942,316942,316945,0,3,4
90549,6,1,316948,316948,316949,0,1,3
90550,1,2,316949,316949,316951,0,2,0
90551,3,1,316952,316952,316953,0,1,1
90552,5,2,316957,316957,316959,0,2,4
90553,5,1,316962,316962,316963,0,1,3
90554,5,3,316967,316967,316970,0,3,4
90555,1,2,316968,316970,316972,2,4,0
90556,5,2,316973,316973,316975,0,2,1
90557,4,1,316977,316977,316978,0,1,2
90558,2,2,316979,316979,316981,0,2,1
90559,5,1,316984,316984,316985,0,1,3
90560,4,1,316988,316988,316989,0,1,3
90561,6,2,316994,316994,316996,0,2,5
90562,2,3,316996,316996,316999,0,3,0
90563,4,2,317000,317000,317002,0,2,1
90564,1,3,317001,317002,317005,1,4,0
90565,6,3,317007,317007,317010,0,3,2
90566,6,1,317013,317013,317014,0,1,3
90567,4,2,317017,317017,317019,0,2,3
90568,4,3,317021,317021,317024,0,3,2
90569,5,1,317026,317026,317027,0,1,2
90570,6,2,317032,317032,317034,0,2,5
90571,6,1,317038,317038,317039,0,1,4
90572,2,1,317040,317040,317041,0,1,1
90573,4,2,317044,317044,317046,0,2,3
90574,2,3,317046,317046,317049,0,3,0
90575,2,1,317048,317049,317050,1,2,0
90576,6,2,317054,317054,317056,0,2,4
90577,1,1,317055,317056,317057,1,2,0
90578,1,2,317056,317057,317059,1,3,0
90579,3,3,317059,317059,317062,0,3,0
90580,6,1,317065,317065,317066,0,1,3
90581,3,2,317068,317068,317070,0,2,2
90582,2,3,317070,317070,317073,0,3,0
90583,5,3,317075,317075,317078,0,3,2
90584,3,1,317078,317078,317079,0,1,0
90585,1,1,317079,317079,317080,0,1,0
90586,3,2,317082,317082,317084,0,2,2
90587,3,1,317085,317085,317086,0,1,1
90588,4,1,317089,317089,317090,0,1,3
90589,1,1,317090,317090,317091,0,1,0
90590,3,3,317093,317093,317096,0,3,2
90591,2,1,317095,317096,317097,1,2,0
90592,2,2,317097,317097,317099,0,2,0
90593,6,2,317103,317103,317105,0,2,4
90594,1,1,317104,317105,317106,1,2,0
90595,1,3,317105,317106,317109,1,4,0
90596,5,1,317110,317110,317111,0,1,1
90597,3,3,317113,317113,317116,0,3,2
90598,3,3,317116,317116,317119,0,3,0
90599,3,2,317119,317119,317121,0,2,0
90600,5,3,317124,317124,317127,0,3,3
90601,1,1,317125,317127,317128,2,3,0
90602,5,1,317130,317130,317131,0,1,2
90603,1,1,317131,317131,317132,0,1,0
90604,2,2,317133,317133,317135,0,2,1
90605,4,2,317137,317137,317139,0,2,2
90606,4,1,317141,317141,317142,0,1,2
90607,4,3,317145,317145,317148,0,3,3
90608,2,3,317147,317148,317151,1,4,0
90609,5,1,317152,317152,317153,0,1,1
90610,5,1,317157,317157,317158,0,1,4
90611,2,1,317159,317159,317160,0,1,1
90612,4,3,317163,317163,317166,0,3,3
90613,1,3,317164,317166,317169,2,5,0
90614,3,3,317167,317169,317172,2,5,0
90615,6,1,317173,317173,317174,0,1,1
90616,3,1,317176,317176,317177,0,1,2
90617,2,1,317178,317178,317179,0,1,1
90618,4,2,317182,317182,317184,0,2,3
90619,1,3,317183,317184,317187,1,4,0
90620,4,2,317187,317187,317189,0,2,0
90621,4,3,317191,317191,317194,0,3,2
90622,3,1,317194,317194,317195,0,1,0
90623,6,1,317200,317200,317201,0,1,5
90624,4,1,317204,317204,317205,0,1,3
90625,5,3,317209,317209,317212,0,3,4
90626,4,1,317213,317213,317214,0,1,1
90627,5,1,317218,317218,317219,0,1,4
90628,4,3,317222,317222,317225,0,3,3
90629,2,3,317224,317225,317228,1,4,0
90630,2,3,317226,317228,317231,2,5,0
90631,5,3,317231,317231,317234,0,3,0
90632,5,1,317236,317236,317237,0,1,2
90633,2,3,317238,317238,317241,0,3,1
90634,3,1,317241,317241,317242,0,1,0
90635,2,1,317243,317243,317244,0,1,1
90636,4,2,317247,317247,317249,0,2,3
90637,3,3,317250,317250,317253,0,3,1
90638,3,2,317253,317253,317255,0,2,0
90639,6,1,317259,317259,317260,0,1,4
90640,2,2,317261,317261,317263,0,2,1
90641,1,1,317262,317263,317264,1,2,0
90642,4,1,317266,317266,317267,0,1,2
90643,6,2,317272,317272,317274,0,2,5
90644,3,3,317275,317275,317278,0,3,1
90645,5,1,317280,317280,317281,0,1,2
90646,1,1,317281,317281,317282,0,1,0
90647,4,1,317285,317285,317286,0,1,3
90648,5,1,317290,317290,317291,0,1,4
90649,1,3,317291,317291,317294,0,3,0
90650,6,1,317297,317297,317298,0,1,3
90651,1,3,317298,317298,317301,0,3,0
90652,6,3,317304,317304,317307,0,3,3
90653,3,3,317307,317307,317310,0,3,0
90654,5,2,317312,317312,317314,0,2,2
90655,6,2,317318,317318,317320,0,2,4
90656,5,1,317323,317323,317324,0,1,3
90657,4,1,317327,317327,317328,0,1,3
90658,4,3,317331,317331,317334,0,3,3
90659,2,3,317333,317334,317337,1,4,0
90660,4,1,317337,317337,317338,0,1,0
90661,5,3,317342,317342,317345,0,3,4
90662,2,2,317344,317345,317347,1,3,0
90663,2,3,317346,317347,317350,1,4,0
90664,4,3,317350,317350,317353,0,3,0
90665,1,1,317351,317353,317354,2,3,0
90666,3,1,317354,317354,317355,0,1,0
90667,3,1,317357,317357,317358,0,1,2
90668,2,2,317359,317359,317361,0,2,1
90669,5,1,317364,317364,317365,0,1,3
90670,1,2,317365,317365,317367,0,2,0
90671,2,2,317367,317367,317369,0,2,0
90672,2,2,317369,317369,317371,0,2,0
90673,5,1,317374,317374,317375,0,1,3
90674,1,1,317375,317375,317376,0,1,0
90675,5,3,317380,317380,317383,0,3,4
90676,4,3,317384,317384,317387,0,3,1
90677,4,1,317388,317388,317389,0,1,1
90678,3,3,317391,317391,317394,0,3,2
90679,6,3,317397,317397,317400,0,3,3
90680,5,2,317402,317402,317404,0,2,2
90681,1,2,317403,317404,317406,1,3,0
90682,6,1,317409,317409,317410,0,1,3
90683,5,3,317414,317414,317417,0,3,4
90684,1,2,317415,317417,317419,2,4,0
90685,2,1,317417,317419,317420,2,3,0
90686,4,3,317421,317421,317424,0,3,1
90687,6,2,317427,317427,317429,0,2,3
90688,3,3,317430,317430,317433,0,3,1
90689,4,1,317434,317434,317435,0,1,1
90690,1,1,317435,317435,317436,0,1,0
90691,1,2,317436,317436,317438,0,2,0
90692,6,1,317442,317442,317443,0,1,4
90693,6,2,317448,317448,317450,0,2,5
90694,4,3,317452,317452,317455,0,3,2
90695,4,2,317456,317456,317458,0,2,1
90696,5,2,317461,317461,317463,0,2,3
90697,4,1,317465,317465,317466,0,1,2
90698,6,1,317471,317471,317472,0,1,5
90699,3,2,317474,317474,317476,0,2,2
90700,6,2,317480,317480,317482,0,2,4
90701,3,2,317483,317483,317485,0,2,1
90702,1,2,317484,317485,317487,1,3,0
90703,4,1,317488,317488,317489,0,1,1
90704,4,1,317492,317492,317493,0,1,3
90705,6,3,317498,317498,317501,0,3,5
90706,5,3,317503,317503,317506,0,3,2
90707,4,3,317507,317507,317510,0,3,1
90708,2,3,317509,317510,317513,1,4,0
90709,6,2,317515,317515,317517,0,2,2
90710,2,2,317517,317517,317519,0,2,0
90711,2,3,317519,317519,317522,0,3,0
90712,6,1,317525,317525,317526,0,1,3
90713,1,2,317526,317526,317528,0,2,0
90714,6,2,317532,317532,317534,0,2,4
90715,5,1,317537,317537,317538,0,1,3
90716,4,1,317541,317541,317542,0,1,3
90717,5,2,317546,317546,317548,0,2,4
90718,5,1,317551,317551,317552,0,1,3
90719,3,1,317554,317554,317555,0,1,2
90720,4,2,317558,317558,317560,0,2,3
90721,3,2,317561,317561,317563,0,2,1
90722,3,1,317564,317564,317565,0,1,1
90723,3,3,317567,317567,317570,0,3,2
90724,4,1,317571,317571,317572,0,1,1
90725,6,3,317577,317577,317580,0,3,5
90726,6,2,317583,317583,317585,0,2,3
90727,6,3,317589,317589,317592,0,3,4
90728,3,1,317592,317592,317593,0,1,0
90729,6,2,317598,317598,317600,0,2,5
90730,2,1,317600,317600,317601,0,1,0
90731,1,3,317601,317601,317604,0,3,0
90732,3,3,317604,317604,317607,0,3,0
90733,3,2,317607,317607,317609,0,2,0
90734,3,2,317610,317610,317612,0,2,1
90735,5,2,317615,317615,317617,0,2,3
90736,2,3,317617,317617,317620,0,3,0
90737,6,1,317623,317623,317624,0,1,3
90738,6,1,317629,317629,317630,0,1,5
90739,2,1,317631,317631,317632,0,1,1
90740,2,3,317633,317633,317636,0,3,1
90741,1,3,317634,317636,317639,2,5,0
90742,3,1,317637,317639,317640,2,3,0
90743,3,1,317640,317640,317641,0,1,0
90744,1,1,317641,317641,317642,0,1,0
90745,5,2,317646,317646,317648,0,2,4
90746,4,2,317650,317650,317652,0,2,2
90747,5,2,317655,317655,317657,0,2,3
90748,2,2,317657,317657,317659,0,2,0
90749,5,3,317662,317662,317665,0,3,3
90750,2,1,317664,317665,317666,1,2,0
90751,2,2,317666,317666,317668,0,2,0
90752,6,2,317672,317672,317674,0,2,4
90753,1,2,317673,317674,317676,1,3,0
90754,4,1,317677,317677,317678,0,1,1
90755,4,1,317681,317681,317682,0,1,3
90756,4,3,317685,317685,317688,0,3,3
90757,4,2,317689,317689,317691,0,2,1
90758,2,2,317691,317691,317693,0,2,0
90759,4,1,317695,317695,317696,0,1,2
90760,1,3,317696,317696,317699,0,3,0
90761,4,2,317700,317700,317702,0,2,1
90762,1,2,317701,317702,317704,1,3,0
90763,6,2,317707,317707,317709,0,2,3
90764,1,3,317708,317709,317712,1,4,0
90765,2,3,317710,317712,317715,2,5,0
90766,5,1,317715,317715,317716,0,1,0
90767,5,1,317720,317720,317721,0,1,4
90768,6,3,317726,317726,317729,0,3,5
90769,1,3,317727,317729,317732,2,5,0
90770,5,2,317732,317732,317734,0,2,0
90771,5,1,317737,317737,317738,0,1,3
90772,5,3,317742,317742,317745,0,3,4
90773,4,1,317746,317746,317747,0,1,1
90774,3,2,317749,317749,317751,0,2,2
90775,1,2,317750,317751,317753,1,3,0
90776,5,3,317755,317755,317758,0,3,2
90777,1,1,317756,317758,317759,2,3,0
90778,2,3,317758,317759,317762,1,4,0
90779,1,1,317759,317762,317763,3,4,0
90780,6,3,317765,317765,317768,0,3,2
90781,2,1,317767,317768,317769,1,2,0
90782,4,2,317771,317771,317773,0,2,2
90783,5,3,317776,317776,317779,0,3,3
90784,3,3,317779,317779,317782,0,3,0
90785,1,3,317780,317782,317785,2,5,0
90786,3,3,317783,317785,317788,2,5,0
90787,1,1,317784,317788,317789,4,5,0
90788,3,3,317787,317789,317792,2,5,0
90789,3,2,317790,317792,317794,2,4,0
90790,6,1,317796,317796,317797,0,1,2
90791,4,3,317800,317800,317803,0,3,3
90792,1,1,317801,317803,317804,2,3,0
90793,6,1,317807,317807,317808,0,1,3
90794,5,3,317812,317812,317815,0,3,4
90795,2,1,317814,317815,317816,1,2,0
90796,6,3,317820,317820,317823,0,3,4
90797,5,3,317825,317825,317828,0,3,2
90798,1,3,317826,317828,317831,2,5,0
90799,2,1,317828,317831,317832,3,4,0
90800,1,1,317829,317832,317833,3,4,0
90801,3,3,317832,317833,317836,1,4,0
90802,6,2,317838,317838,317840,0,2,2
90803,3,3,317841,317841,317844,0,3,1
90804,6,1,317847,317847,317848,0,1,3
90805,2,2,317849,317849,317851,0,2,1
90806,5,1,317854,317854,317855,0,1,3
90807,4,2,317858,317858,317860,0,2,3
90808,2,2,317860,317860,317862,0,2,0
90809,6,2,317866,317866,317868,0,2,4
90810,4,2,317870,317870,317872,0,2,2
90811,6,2,317876,317876,317878,0,2,4
90812,3,3,317879,317879,317882,0,3,1
90813,2,1,317881,317882,317883,1,2,0
90814,1,3,317882,317883,317886,1,4,0
90815,4,1,317886,317886,317887,0,1,0
90816,6,1,317892,317892,317893,0,1,5
90817,1,2,317893,317893,317895,0,2,0
90818,3,1,317896,317896,317897,0,1,1
90819,4,1,317900,317900,317901,0,1,3
90820,3,2,317903,317903,317905,0,2,2
90821,5,2,317908,317908,317910,0,2,3
90822,5,1,317913,317913,317914,0,1,3
90823,1,3,317914,317914,317917,0,3,0
90824,6,2,317920,317920,317922,0,2,3
90825,3,3,317923,317923,317926,0,3,1
90826,2,2,317925,317926,317928,1,3,0
90827,2,2,317927,317928,317930,1,3,0
90828,3,2,317930,317930,317932,0,2,0
90829,5,2,317935,317935,317937,0,2,3
90830,1,3,317936,317937,317940,1,4,0
90831,1,3,317937,317940,317943,3,6,0
90832,1,2,317938,317943,317945,5,7,0
90833,6,3,317944,317945,317948,1,4,0
90834,2,1,317946,317948,317949,2,3,0
90835,2,3,317948,317949,317952,1,4,0
90836,4,1,317952,317952,317953,0,1,0
90837,6,3,317958,317958,317961,0,3,5
90838,3,2,317961,317961,317963,0,2,0
90839,2,2,317963,317963,317965,0,2,0
90840,4,1,317967,317967,317968,0,1,2
90841,6,3,317973,317973,317976,0,3,5
90842,5,2,317978,317978,317980,0,2,2
90843,6,3,317984,317984,317987,0,3,4
90844,1,2,317985,317987,317989,2,4,0
90845,5,2,317990,317990,317992,0,2,1
90846,3,1,317993,317993,317994,0,1,1
90847,2,1,317995,317995,317996,0,1,1
90848,5,2,318000,318000,318002,0,2,4
90849,2,1,318002,318002,318003,0,1,0
90850,2,2,318004,318004,318006,0,2,1
90851,6,2,318010,318010,318012,0,2,4
90852,1,3,318011,318012,318015,1,4,0
90853,5,1,318016,318016,318017,0,1,1
90854,4,1,318020,318020,318021,0,1,3
90855,6,3,318026,318026,318029,0,3,5
90856,3,2,318029,318029,318031,0,2,0
90857,2,3,318031,318031,318034,0,3,0
90858,2,1,318033,318034,318035,1,2,0
90859,6,2,318039,318039,318041,0,2,4
90860,5,1,318044,318044,318045,0,1,3
90861,5,2,318049,318049,318051,0,2,4
90862,4,1,318053,318053,318054,0,1,2
90863,3,3,318056,318056,318059,0,3,2
90864,1,2,318057,318059,318061,2,4,0
90865,1,2,318058,318061,318063,3,5,0
90866,3,3,318061,318063,318066,2,5,0
90867,5,3,318066,318066,318069,0,3,0
90868,6,3,318072,318072,318075,0,3,3
90869,2,1,318074,318075,318076,1,2,0
90870,6,3,318080,318080,318083,0,3,4
90871,5,3,318085,318085,318088,0,3,2
90872,6,3,318091,318091,318094,0,3,3
90873,2,1,318093,318094,318095,1,2,0
90874,1,1,318094,318095,318096,1,2,0
90875,1,3,318095,318096,318099,1,4,0
90876,1,2,318096,318099,318101,3,5,0
90877,1,1,318097,318101,318102,4,5,0
90878,3,2,318100,318102,318104,2,4,0
90879,4,1,318104,318104,318105,0,1,0
90880,3,1,318107,318107,318108,0,1,2
90881,1,3,318108,318108,318111,0,3,0
90882,2,3,318110,318111,318114,1,4,0
90883,3,3,318113,318114,318117,1,4,0
90884,5,2,318118,318118,318120,0,2,1
90885,6,1,318124,318124,318125,0,1,4
90886,2,2,318126,318126,318128,0,2,1
90887,5,1,318131,318131,318132,0,1,3
90888,5,1,318136,318136,318137,0,1,4
90889,6,3,318142,318142,318145,0,3,5
90890,5,2,318147,318147,318149,0,2,2
90891,4,1,318151,318151,318152,0,1,2
90892,5,3,318156,318156,318159,0,3,4
90893,6,3,318162,318162,318165,0,3,3
90894,1,2,318163,318165,318167,2,4,0
90895,6,2,318169,318169,318171,0,2,2
90896,1,1,318170,318171,318172,1,2,0
90897,6,2,318176,318176,318178,0,2,4
90898,5,2,318181,318181,318183,0,2,3
90899,3,3,318184,318184,318187,0,3,1
90900,5,1,318189,318189,318190,0,1,2
90901,6,3,318195,318195,318198,0,3,5
90902,6,2,318201,318201,318203,0,2,3
90903,6,3,318207,318207,318210,0,3,4
90904,5,3,318212,318212,318215,0,3,2
90905,2,3,318214,318215,318218,1,4,0
90906,4,2,318218,318218,318220,0,2,0
90907,1,1,318219,318220,318221,1,2,0
90908,1,1,318220,318221,318222,1,2,0
90909,6,2,318226,318226,318228,0,2,4
90910,1,3,318227,318228,318231,1,4,0
90911,2,1,318229,318231,318232,2,3,0
90912,3,1,318232,318232,318233,0,1,0
90913,2,1,318234,318234,318235,0,1,1
90914,5,3,318239,318239,318242,0,3,4
90915,6,2,318245,318245,318247,0,2,3
90916,2,2,318247,318247,318249,0,2,0
90917,6,1,318253,318253,318254,0,1,4
90918,1,1,318254,318254,318255,0,1,0
90919,4,2,318258,318258,318260,0,2,3
90920,2,2,318260,318260,318262,0,2,0
90921,5,1,318265,318265,318266,0,1,3
90922,6,3,318271,318271,318274,0,3,5
90923,3,1,318274,318274,318275,0,1,0
90924,1,1,318275,318275,318276,0,1,0
90925,6,3,318281,318281,318284,0,3,5
90926,1,3,318282,318284,318287,2,5,0
90927,4,3,318286,318287,318290,1,4,0
90928,1,3,318287,318290,318293,3,6,0
90929,5,1,318292,318293,318294,1,2,0
90930,5,3,318297,318297,318300,0,3,3
90931,3,3,318300,318300,318303,0,3,0
90932,6,3,318306,318306,318309,0,3,3
90933,4,1,318310,318310,318311,0,1,1
90934,4,3,318314,318314,318317,0,3,3
90935,3,2,318317,318317,318319,0,2,0
90936,2,2,318319,318319,318321,0,2,0
90937,3,2,318322,318322,318324,0,2,1
90938,1,2,318323,318324,318326,1,3,0
90939,5,2,318328,318328,318330,0,2,2
90940,4,3,318332,318332,318335,0,3,2
90941,5,1,318337,318337,318338,0,1,2
90942,1,1,318338,318338,318339,0,1,0
90943,1,1,318339,318339,318340,0,1,0
90944,1,2,318340,318340,318342,0,2,0
90945,5,3,318345,318345,318348,0,3,3
90946,4,3,318349,318349,318352,0,3,1
90947,4,1,318353,318353,318354,0,1,1
90948,2,3,318355,318355,318358,0,3,1
90949,3,3,318358,318358,318361,0,3,0
90950,3,3,318361,318361,318364,0,3,0
90951,4,1,318365,318365,318366,0,1,1
90952,3,2,318368,318368,318370,0,2,2
90953,6,1,318374,318374,318375,0,1,4
90954,3,3,318377,318377,318380,0,3,2
90955,3,2,318380,318380,318382,0,2,0
90956,4,2,318384,318384,318386,0,2,2
90957,1,1,318385,318386,318387,1,2,0
90958,1,2,318386,318387,318389,1,3,0
90959,3,1,318389,318389,318390,0,1,0
90960,6,1,318395,318395,318396,0,1,5
90961,4,2,318399,318399,318401,0,2,3
90962,4,2,318403,318403,318405,0,2,2
90963,1,3,318404,318405,318408,1,4,0
90964,6,3,318410,318410,318413,0,3,2
90965,5,2,318415,318415,318417,0,2,2
90966,2,1,318417,318417,318418,0,1,0
90967,6,1,318423,318423,318424,0,1,5
90968,4,3,318427,318427,318430,0,3,3
90969,4,3,318431,318431,318434,0,3,1
90970,3,3,318434,318434,318437,0,3,0
90971,6,1,318440,318440,318441,0,1,3
90972,2,1,318442,318442,318443,0,1,1
90973,6,2,318448,318448,318450,0,2,5
90974,3,2,318451,318451,318453,0,2,1
90975,1,2,318452,318453,318455,1,3,0
90976,4,2,318456,318456,318458,0,2,1
90977,2,3,318458,318458,318461,0,3,0
90978,5,1,318463,318463,318464,0,1,2
90979,4,2,318467,318467,318469,0,2,3
90980,1,1,318468,318469,318470,1,2,0
90981,4,2,318472,318472,318474,0,2,2
90982,4,2,318476,318476,318478,0,2,2
90983,4,3,318480,318480,318483,0,3,2
90984,5,1,318485,318485,318486,0,1,2
90985,3,1,318488,318488,318489,0,1,2
90986,3,3,318491,318491,318494,0,3,2
90987,6,2,318497,318497,318499,0,2,3
90988,4,3,318501,318501,318504,0,3,2
90989,3,1,318504,318504,318505,0,1,0
90990,2,3,318506,318506,318509,0,3,1
90991,4,2,318510,318510,318512,0,2,1
90992,3,2,318513,318513,318515,0,2,1
90993,3,1,318516,318516,318517,0,1,1
90994,1,3,318517,318517,318520,0,3,0
90995,6,2,318523,318523,318525,0,2,3
90996,6,3,318529,318529,318532,0,3,4
90997,4,1,318533,318533,318534,0,1,1
90998,1,3,318534,318534,318537,0,3,0
90999,6,2,318540,318540,318542,0,2,3
91000,5,3,318545,318545,318548,0,3,3
91001,3,3,318548,318548,318551,0,3,0
91002,3,2,318551,318551,318553,0,2,0
91003,2,2,318553,318553,318555,0,2,0
91004,1,1,318554,318555,318556,1,2,0
91005,5,2,318559,318559,318561,0,2,3
91006,1,1,318560,318561,318562,1,2,0
91007,6,2,318566,318566,318568,0,2,4
91008,2,1,318568,318568,318569,0,1,0
91009,2,1,318570,318570,318571,0,1,1
91010,5,2,318575,318575,318577,0,2,4
91011,5,3,318580,318580,318583,0,3,3
91012,2,3,318582,318583,318586,1,4,0
91013,5,3,318587,318587,318590,0,3,1
91014,3,3,318590,318590,318593,0,3,0
91015,2,1,318592,318593,318594,1,2,0
91016,6,1,318598,318598,318599,0,1,4
91017,2,3,318600,318600,318603,0,3,1
91018,3,3,318603,318603,318606,0,3,0
91019,6,1,318609,318609,318610,0,1,3
91020,5,3,318614,318614,318617,0,3,4
91021,1,2,318615,318617,318619,2,4,0
91022,6,1,318621,318621,318622,0,1,2
91023,6,1,318627,318627,318628,0,1,5
91024,4,2,318631,318631,318633,0,2,3
91025,4,1,318635,318635,318636,0,1,2
91026,4,3,318639,318639,318642,0,3,3
91027,1,2,318640,318642,318644,2,4,0
91028,6,1,318646,318646,318647,0,1,2
91029,5,1,318651,318651,318652,0,1,4
91030,2,3,318653,318653,318656,0,3,1
91031,4,2,318657,318657,318659,0,2,1
91032,6,3,318663,318663,318666,0,3,4
91033,5,1,318668,318668,318669,0,1,2
91034,4,2,318672,318672,318674,0,2,3
91035,6,3,318678,318678,318681,0,3,4
91036,2,2,318680,318681,318683,1,3,0
91037,3,2,318683,318683,318685,0,2,0
91038,3,1,318686,318686,318687,0,1,1
91039,2,3,318688,318688,318691,0,3,1
91040,4,2,318692,318692,318694,0,2,1
91041,6,3,318698,318698,318701,0,3,4
91042,3,2,318701,318701,318703,0,2,0
91043,2,2,318703,318703,318705,0,2,0
91044,2,1,318705,318705,318706,0,1,0
91045,4,2,318709,318709,318711,0,2,3
91046,5,3,318714,318714,318717,0,3,3
91047,4,1,318718,318718,318719,0,1,1
91048,3,2,318721,318721,318723,0,2,2
91049,5,2,318726,318726,318728,0,2,3
91050,6,3,318732,318732,318735,0,3,4
91051,1,3,318733,318735,318738,2,5,0
91052,2,3,318735,318738,318741,3,6,0
91053,2,3,318737,318741,318744,4,7,0
91054,6,2,318743,318744,318746,1,3,0
91055,3,2,318746,318746,318748,0,2,0
91056,4,2,318750,318750,318752,0,2,2
91057,6,2,318756,318756,318758,0,2,4
91058,5,1,318761,318761,318762,0,1,3
91059,2,2,318763,318763,318765,0,2,1
91060,1,2,318764,318765,318767,1,3,0
91061,6,2,318770,318770,318772,0,2,3
91062,1,3,318771,318772,318775,1,4,0
91063,2,1,318773,318775,318776,2,3,0
91064,2,3,318775,318776,318779,1,4,0
91065,2,3,318777,318779,318782,2,5,0
91066,4,1,318781,318782,318783,1,2,0
91067,1,2,318782,318783,318785,1,3,0
91068,6,2,318788,318788,318790,0,2,3
91069,5,2,318793,318793,318795,0,2,3
91070,2,1,318795,318795,318796,0,1,0
91071,3,3,318798,318798,318801,0,3,2
91072,2,1,318800,318801,318802,1,2,0
91073,2,2,318802,318802,318804,0,2,0
91074,4,1,318806,318806,318807,0,1,2
91075,4,1,318810,318810,318811,0,1,3
91076,3,1,318813,318813,318814,0,1,2
91077,2,1,318815,318815,318816,0,1,1
91078,2,1,318817,318817,318818,0,1,1
91079,5,3,318822,318822,318825,0,3,4
91080,4,3,318826,318826,318829,0,3,1
91081,1,3,318827,318829,318832,2,5,0
91082,6,1,318833,318833,318834,0,1,1
91083,4,3,318837,318837,318840,0,3,3
91084,1,3,318838,318840,318843,2,5,0
91085,3,1,318841,318843,318844,2,3,0
91086,1,2,318842,318844,318846,2,4,0
91087,3,3,318845,318846,318849,1,4,0
91088,5,1,318850,318850,318851,0,1,1
91089,1,1,318851,318851,318852,0,1,0
91090,3,3,318854,318854,318857,0,3,2
91091,3,2,318857,318857,318859,0,2,0
91092,1,2,318858,318859,318861,1,3,0
91093,5,2,318863,318863,318865,0,2,2
91094,1,1,318864,318865,318866,1,2,0
91095,4,2,318868,318868,318870,0,2,2
91096,3,1,318871,318871,318872,0,1,1
91097,6,1,318877,318877,318878,0,1,5
91098,5,2,318882,318882,318884,0,2,4
91099,5,1,318887,318887,318888,0,1,3
91100,4,2,318891,318891,318893,0,2,3
91101,3,3,318894,318894,318897,0,3,1
91102,3,3,318897,318897,318900,0,3,0
91103,1,3,318898,318900,318903,2,5,0
91104,3,3,318901,318903,318906,2,5,0
91105,5,1,318906,318906,318907,0,1,0
91106,3,3,318909,318909,318912,0,3,2
91107,5,3,318914,318914,318917,0,3,2
91108,6,3,318920,318920,318923,0,3,3
91109,1,2,318921,318923,318925,2,4,0
91110,6,1,318927,318927,318928,0,1,2
91111,2,3,318929,318929,318932,0,3,1
91112,1,2,318930,318932,318934,2,4,0
91113,1,2,318931,318934,318936,3,5,0
91114,3,3,318934,318936,318939,2,5,0
91115,1,3,318935,318939,318942,4,7,0
91116,3,3,318938,318942,318945,4,7,0
91117,3,2,318941,318945,318947,4,6,0
91118,4,1,318945,318947,318948,2,3,0
91119,4,1,318949,318949,318950,0,1,1
91120,3,2,318952,318952,318954,0,2,2
91121,2,1,318954,318954,318955,0,1,0
91122,6,3,318960,318960,318963,0,3,5
91123,2,3,318962,318963,318966,1,4,0
91124,3,3,318965,318966,318969,1,4,0
91125,5,1,318970,318970,318971,0,1,1
91126,6,1,318976,318976,318977,0,1,5
91127,4,3,318980,318980,318983,0,3,3
91128,5,2,318985,318985,318987,0,2,2
91129,6,2,318991,318991,318993,0,2,4
91130,6,1,318997,318997,318998,0,1,4
91131,4,2,319001,319001,319003,0,2,3
91132,6,2,319007,319007,319009,0,2,4
91133,6,2,319013,319013,319015,0,2,4
91134,5,3,319018,319018,319021,0,3,3
91135,2,3,319020,319021,319024,1,4,0
91136,4,2,319024,319024,319026,0,2,0
91137,4,2,319028,319028,319030,0,2,2
91138,3,1,319031,319031,319032,0,1,1
91139,4,2,319035,319035,319037,0,2,3
91140,4,2,319039,319039,319041,0,2,2
91141,5,3,319044,319044,319047,0,3,3
91142,4,1,319048,319048,319049,0,1,1
91143,3,2,319051,319051,319053,0,2,2
91144,6,3,319057,319057,319060,0,3,4
91145,2,1,319059,319060,319061,1,2,0
91146,3,1,319062,319062,319063,0,1,1
91147,1,3,319063,319063,319066,0,3,0
91148,4,3,319067,319067,319070,0,3,1
91149,1,1,319068,319070,319071,2,3,0
91150,2,1,319070,319071,319072,1,2,0
91151,4,2,319074,319074,319076,0,2,2
91152,2,2,319076,319076,319078,0,2,0
91153,2,2,319078,319078,319080,0,2,0
91154,2,3,319080,319080,319083,0,3,0
91155,1,1,319081,319083,319084,2,3,0
91156,6,3,319087,319087,319090,0,3,3
91157,4,1,319091,319091,319092,0,1,1
91158,5,3,319096,319096,319099,0,3,4
91159,6,1,319102,319102,319103,0,1,3
91160,1,2,319103,319103,319105,0,2,0
91161,6,2,319109,319109,319111,0,2,4
91162,3,3,319112,319112,319115,0,3,1
91163,4,2,319116,319116,319118,0,2,1
91164,4,2,319120,319120,319122,0,2,2
91165,5,1,319125,319125,319126,0,1,3
91166,1,1,319126,319126,319127,0,1,0
91167,4,1,319130,319130,319131,0,1,3
91168,6,1,319136,319136,319137,0,1,5
91169,4,1,319140,319140,319141,0,1,3
91170,5,2,319145,319145,319147,0,2,4
91171,2,1,319147,319147,319148,0,1,0
91172,6,3,319153,319153,319156,0,3,5
91173,1,1,319154,319156,319157,2,3,0
91174,4,1,319158,319158,319159,0,1,1
91175,2,2,319160,319160,319162,0,2,1
91176,6,1,319166,319166,319167,0,1,4
91177,5,2,319171,319171,319173,0,2,4
91178,1,3,319172,319173,319176,1,4,0
91179,6,2,319178,319178,319180,0,2,2
91180,1,2,319179,319180,319182,1,3,0
91181,4,1,319183,319183,319184,0,1,1
91182,3,3,319186,319186,319189,0,3,2
91183,4,2,319190,319190,319192,0,2,1
91184,3,1,319193,319193,319194,0,1,1
91185,6,2,319199,319199,319201,0,2,5
91186,1,1,319200,319201,319202,1,2,0
91187,3,3,319203,319203,319206,0,3,1
91188,5,2,319208,319208,319210,0,2,2
91189,6,3,319214,319214,319217,0,3,4
91190,6,3,319220,319220,319223,0,3,3
91191,5,3,319225,319225,319228,0,3,2
91192,4,1,319229,319229,319230,0,1,1
91193,4,3,319233,319233,319236,0,3,3
91194,4,1,319237,319237,319238,0,1,1
91195,5,2,319242,319242,319244,0,2,4
91196,4,3,319246,319246,319249,0,3,2
91197,3,2,319249,319249,319251,0,2,0
91198,2,2,319251,319251,319253,0,2,0
91199,4,1,319255,319255,319256,0,1,2
91200,2,1,319257,319257,319258,0,1,1
91201,5,2,319262,319262,319264,0,2,4
91202,4,1,319266,319266,319267,0,1,2
91203,5,3,319271,319271,319274,0,3,4
91204,2,3,319273,319274,319277,1,4,0
91205,4,3,319277,319277,319280,0,3,0
91206,5,3,319282,319282,319285,0,3,2
91207,6,3,319288,319288,319291,0,3,3
91208,6,3,319294,319294,319297,0,3,3
91209,1,1,319295,319297,319298,2,3,0
91210,5,2,319300,319300,319302,0,2,2
91211,2,2,319302,319302,319304,0,2,0
91212,1,2,319303,319304,319306,1,3,0
91213,4,2,319307,319307,319309,0,2,1
91214,4,1,319311,319311,319312,0,1,2
91215,3,1,319314,319314,319315,0,1,2
91216,2,2,319316,319316,319318,0,2,1
91217,5,1,319321,319321,319322,0,1,3
91218,4,2,319325,319325,319327,0,2,3
91219,4,1,319329,319329,319330,0,1,2
91220,6,2,319335,319335,319337,0,2,5
91221,2,3,319337,319337,319340,0,3,0
91222,6,2,319343,319343,319345,0,2,3
91223,5,1,319348,319348,319349,0,1,3
91224,6,2,319354,319354,319356,0,2,5
91225,4,3,319358,319358,319361,0,3,2
91226,2,2,319360,319361,319363,1,3,0
91227,5,2,319365,319365,319367,0,2,2
91228,5,2,319370,319370,319372,0,2,3
91229,6,2,319376,319376,319378,0,2,4
91230,6,3,319382,319382,319385,0,3,4
91231,4,3,319386,319386,319389,0,3,1
91232,2,1,319388,319389,319390,1,2,0
91233,3,2,319391,319391,319393,0,2,1
91234,5,3,319396,319396,319399,0,3,3
91235,3,2,319399,319399,319401,0,2,0
91236,2,3,319401,319401,319404,0,3,0
91237,4,3,319405,319405,319408,0,3,1
91238,1,1,319406,319408,319409,2,3,0
91239,4,3,319410,319410,319413,0,3,1
91240,6,1,319416,319416,319417,0,1,3
91241,1,1,319417,319417,319418,0,1,0
91242,3,3,319420,319420,319423,0,3,2
91243,2,3,319422,319423,319426,1,4,0
91244,3,2,319425,319426,319428,1,3,0
91245,4,3,319429,319429,319432,0,3,1
91246,5,3,319434,319434,319437,0,3,2
91247,3,2,319437,319437,319439,0,2,0
91248,2,3,319439,319439,319442,0,3,0
91249,5,1,319444,319444,319445,0,1,2
91250,5,1,319449,319449,319450,0,1,4
91251,5,2,319454,319454,319456,0,2,4
91252,1,2,319455,319456,319458,1,3,0
91253,3,1,319458,319458,319459,0,1,0
91254,5,1,319463,319463,319464,0,1,4
91255,6,1,319469,319469,319470,0,1,5
91256,6,3,319475,319475,319478,0,3,5
91257,3,2,319478,319478,319480,0,2,0
91258,6,1,319484,319484,319485,0,1,4
91259,2,2,319486,319486,319488,0,2,1
91260,1,3,319487,319488,319491,1,4,0
91261,5,2,319492,319492,319494,0,2,1
91262,6,3,319498,319498,319501,0,3,4
91263,1,1,319499,319501,319502,2,3,0
91264,1,1,319500,319502,319503,2,3,0
91265,5,3,319505,319505,319508,0,3,2
91266,2,3,319507,319508,319511,1,4,0
91267,1,3,319508,319511,319514,3,6,0
91268,4,2,319512,319514,319516,2,4,0
91269,4,2,319516,319516,319518,0,2,0
91270,6,3,319522,319522,319525,0,3,4
91271,3,3,319525,319525,319528,0,3,0
91272,5,1,319530,319530,319531,0,1,2
91273,2,2,319532,319532,319534,0,2,1
91274,1,1,319533,319534,319535,1,2,0
91275,4,2,319537,319537,319539,0,2,2
91276,1,3,319538,319539,319542,1,4,0
91277,4,1,319542,319542,319543,0,1,0
91278,4,1,319546,319546,319547,0,1,3
91279,1,2,319547,319547,319549,0,2,0
91280,1,2,319548,319549,319551,1,3,0
91281,2,2,319550,319551,319553,1,3,0
91282,4,1,319554,319554,319555,0,1,1
91283,4,1,319558,319558,319559,0,1,3
91284,3,3,319561,319561,319564,0,3,2
91285,4,1,319565,319565,319566,0,1,1
91286,6,3,319571,319571,319574,0,3,5
91287,5,3,319576,319576,319579,0,3,2
91288,6,1,319582,319582,319583,0,1,3
91289,4,1,319586,319586,319587,0,1,3
91290,1,2,319587,319587,319589,0,2,0
91291,5,3,319592,319592,319595,0,3,3
91292,1,2,319593,319595,319597,2,4,0
91293,5,3,319598,319598,319601,0,3,1
91294,2,2,319600,319601,319603,1,3,0
91295,6,3,319606,319606,319609,0,3,3
91296,4,3,319610,319610,319613,0,3,1
91297,2,1,319612,319613,319614,1,2,0
91298,3,3,319615,319615,319618,0,3,1
91299,6,3,319621,319621,319624,0,3,3
91300,6,3,319627,319627,319630,0,3,3
91301,2,3,319629,319630,319633,1,4,0
91302,4,1,319633,319633,319634,0,1,0
91303,1,2,319634,319634,319636,0,2,0
91304,6,3,319640,319640,319643,0,3,4
91305,2,2,319642,319643,319645,1,3,0
91306,3,2,319645,319645,319647,0,2,0
91307,2,1,319647,319647,319648,0,1,0
91308,1,2,319648,319648,319650,0,2,0
91309,2,2,319650,319650,319652,0,2,0
91310,4,1,319654,319654,319655,0,1,2
91311,2,1,319656,319656,319657,0,1,1
91312,5,1,319661,319661,319662,0,1,4
91313,4,3,319665,319665,319668,0,3,3
91314,5,3,319670,319670,319673,0,3,2
91315,3,3,319673,319673,319676,0,3,0
91316,1,1,319674,319676,319677,2,3,0
91317,3,2,319677,319677,319679,0,2,0
91318,1,1,319678,319679,319680,1,2,0
91319,1,1,319679,319680,319681,1,2,0
91320,6,3,319685,319685,319688,0,3,4
91321,5,2,319690,319690,319692,0,2,2
91322,6,1,319696,319696,319697,0,1,4
91323,5,2,319701,319701,319703,0,2,4
91324,2,2,319703,319703,319705,0,2,0
91325,4,3,319707,319707,319710,0,3,2
91326,3,3,319710,319710,319713,0,3,0
91327,2,1,319712,319713,319714,1,2,0
91328,4,3,319716,319716,319719,0,3,2
91329,1,2,319717,319719,319721,2,4,0
91330,4,3,319721,319721,319724,0,3,0
91331,2,1,319723,319724,319725,1,2,0
91332,1,1,319724,319725,319726,1,2,0
91333,3,3,319727,319727,319730,0,3,1
91334,1,1,319728,319730,319731,2,3,0
91335,1,2,319729,319731,319733,2,4,0
91336,3,1,319732,319733,319734,1,2,0
91337,4,2,319736,319736,319738,0,2,2
91338,4,2,319740,319740,319742,0,2,2
91339,3,3,319743,319743,319746,0,3,1
91340,1,2,319744,319746,319748,2,4,0
91341,1,3,319745,319748,319751,3,6,0
91342,6,2,319751,319751,319753,0,2,0
91343,3,3,319754,319754,319757,0,3,1
91344,5,1,319759,319759,319760,0,1,2
91345,6,2,319765,319765,319767,0,2,5
91346,1,2,319766,319767,319769,1,3,0
91347,1,1,319767,319769,319770,2,3,0
91348,1,1,319768,319770,319771,2,3,0
91349,6,1,319774,319774,319775,0,1,3
91350,3,2,319777,319777,319779,0,2,2
91351,3,2,319780,319780,319782,0,2,1
91352,3,3,319783,319783,319786,0,3,1
91353,5,1,319788,319788,319789,0,1,2
91354,2,1,319790,319790,319791,0,1,1
91355,1,3,319791,319791,319794,0,3,0
91356,5,1,319796,319796,319797,0,1,2
91357,2,3,319798,319798,319801,0,3,1
91358,3,2,319801,319801,319803,0,2,0
91359,6,3,319807,319807,319810,0,3,4
91360,5,3,319812,319812,319815,0,3,2
91361,6,3,319818,319818,319821,0,3,3
91362,4,2,319822,319822,319824,0,2,1
91363,5,2,319827,319827,319829,0,2,3
91364,2,2,319829,319829,319831,0,2,0
91365,4,1,319833,319833,319834,0,1,2
91366,2,2,319835,319835,319837,0,2,1
91367,6,3,319841,319841,319844,0,3,4
91368,3,3,319844,319844,319847,0,3,0
91369,4,2,319848,319848,319850,0,2,1
91370,1,3,319849,319850,319853,1,4,0
91371,3,3,319852,319853,319856,1,4,0
91372,2,1,319854,319856,319857,2,3,0
91373,3,3,319857,319857,319860,0,3,0
91374,2,3,319859,319860,319863,1,4,0
91375,4,3,319863,319863,319866,0,3,0
91376,1,2,319864,319866,319868,2,4,0
91377,1,1,319865,319868,319869,3,4,0
91378,1,3,319866,319869,319872,3,6,0
91379,3,2,319869,319872,319874,3,5,0
91380,3,2,319872,319874,319876,2,4,0
91381,3,1,319875,319876,319877,1,2,0
91382,1,3,319876,319877,319880,1,4,0
91383,2,3,319878,319880,319883,2,5,0
91384,4,2,319882,319883,319885,1,3,0
91385,1,1,319883,319885,319886,2,3,0
91386,4,1,319887,319887,319888,0,1,1
91387,3,2,319890,319890,319892,0,2,2
91388,2,3,319892,319892,319895,0,3,0
91389,6,2,319898,319898,319900,0,2,3
91390,2,3,319900,319900,319903,0,3,0
91391,4,1,319904,319904,319905,0,1,1
91392,2,2,319906,319906,319908,0,2,1
91393,5,1,319911,319911,319912,0,1,3
91394,5,1,319916,319916,319917,0,1,4
91395,3,2,319919,319919,319921,0,2,2
91396,3,2,319922,319922,319924,0,2,1
91397,3,2,319925,319925,319927,0,2,1
91398,2,2,319927,319927,319929,0,2,0
91399,5,2,319932,319932,319934,0,2,3
91400,4,1,319936,319936,319937,0,1,2
91401,2,2,319938,319938,319940,0,2,1
91402,3,2,319941,319941,319943,0,2,1
91403,4,3,319945,319945,319948,0,3,2
91404,3,2,319948,319948,319950,0,2,0
91405,4,3,319952,319952,319955,0,3,2
91406,1,3,319953,319955,319958,2,5,0
91407,1,2,319954,319958,319960,4,6,0
91408,4,3,319958,319960,319963,2,5,0
91409,4,2,319962,319963,319965,1,3,0
91410,2,2,319964,319965,319967,1,3,0
91411,2,2,319966,319967,319969,1,3,0
91412,3,1,319969,319969,319970,0,1,0
91413,3,2,319972,319972,319974,0,2,2
91414,4,2,319976,319976,319978,0,2,2
91415,2,1,319978,319978,319979,0,1,0
91416,5,1,319983,319983,319984,0,1,4
91417,6,1,319989,319989,319990,0,1,5
91418,5,1,319994,319994,319995,0,1,4
91419,5,1,319999,319999,320000,0,1,4
91420,1,3,320000,320000,320003,0,3,0
91421,5,2,320005,320005,320007,0,2,2
91422,4,1,320009,320009,320010,0,1,2
91423,5,2,320014,320014,320016,0,2,4
91424,5,3,320019,320019,320022,0,3,3
91425,1,1,320020,320022,320023,2,3,0
91426,2,1,320022,320023,320024,1,2,0
91427,5,2,320027,320027,320029,0,2,3
91428,1,1,320028,320029,320030,1,2,0
91429,6,1,320034,320034,320035,0,1,4
91430,2,3,320036,320036,320039,0,3,1
91431,2,3,320038,320039,320042,1,4,0
91432,6,3,320044,320044,320047,0,3,2
91433,5,3,320049,320049,320052,0,3,2
91434,1,3,320050,320052,320055,2,5,0
91435,2,2,320052,320055,320057,3,5,0
91436,1,3,320053,320057,320060,4,7,0
91437,4,1,320057,320060,320061,3,4,0
91438,4,3,320061,320061,320064,0,3,0
91439,5,1,320066,320066,320067,0,1,2
91440,3,2,320069,320069,320071,0,2,2
91441,2,3,320071,320071,320074,0,3,0
91442,2,1,320073,320074,320075,1,2,0
91443,6,1,320079,320079,320080,0,1,4
91444,4,2,320083,320083,320085,0,2,3
91445,6,2,320089,320089,320091,0,2,4
91446,3,3,320092,320092,320095,0,3,1
91447,1,3,320093,320095,320098,2,5,0
91448,2,1,320095,320098,320099,3,4,0
91449,2,2,320097,320099,320101,2,4,0
91450,4,2,320101,320101,320103,0,2,0
91451,5,3,320106,320106,320109,0,3,3
91452,3,2,320109,320109,320111,0,2,0
91453,6,2,320115,320115,320117,0,2,4
91454,6,2,320121,320121,320123,0,2,4
91455,3,1,320124,320124,320125,0,1,1
91456,4,3,320128,320128,320131,0,3,3
91457,4,1,320132,320132,320133,0,1,1
91458,2,3,320134,320134,320137,0,3,1
91459,6,3,320140,320140,320143,0,3,3
91460,4,2,320144,320144,320146,0,2,1
91461,3,1,320147,320147,320148,0,1,1
91462,2,1,320149,320149,320150,0,1,1
91463,4,1,320153,320153,320154,0,1,3
91464,1,2,320154,320154,320156,0,2,0
91465,3,1,320157,320157,320158,0,1,1
91466,4,2,320161,320161,320163,0,2,3
91467,2,3,320163,320163,320166,0,3,0
91468,6,1,320169,320169,320170,0,1,3
91469,6,2,320175,320175,320177,0,2,5
91470,6,2,320181,320181,320183,0,2,4
91471,5,2,320186,320186,320188,0,2,3
91472,6,2,320192,320192,320194,0,2,4
91473,4,1,320196,320196,320197,0,1,2
91474,2,1,320198,320198,320199,0,1,1
91475,2,2,320200,320200,320202,0,2,1
91476,2,2,320202,320202,320204,0,2,0
91477,6,3,320208,320208,320211,0,3,4
91478,2,3,320210,320211,320214,1,4,0
91479,3,2,320213,320214,320216,1,3,0
91480,6,1,320219,320219,320220,0,1,3
91481,2,3,320221,320221,320224,0,3,1
91482,1,2,320222,320224,320226,2,4,0
91483,6,2,320228,320228,320230,0,2,2
91484,6,3,320234,320234,320237,0,3,4
91485,2,3,320236,320237,320240,1,4,0
91486,5,2,320241,320241,320243,0,2,1
91487,5,1,320246,320246,320247,0,1,3
91488,1,1,320247,320247,320248,0,1,0
91489,3,2,320250,320250,320252,0,2,2
91490,5,2,320255,320255,320257,0,2,3
91491,6,2,320261,320261,320263,0,2,4
91492,4,3,320265,320265,320268,0,3,2
91493,4,3,320269,320269,320272,0,3,1
91494,1,2,320270,320272,320274,2,4,0
91495,4,2,320274,320274,320276,0,2,0
91496,1,1,320275,320276,320277,1,2,0
91497,1,1,320276,320277,320278,1,2,0
91498,3,3,320279,320279,320282,0,3,1
91499,2,1,320281,320282,320283,1,2,0
91500,4,1,320285,320285,320286,0,1,2
91501,2,2,320287,320287,320289,0,2,1
91502,5,1,320292,320292,320293,0,1,3
91503,6,3,320298,320298,320301,0,3,5
91504,2,3,320300,320301,320304,1,4,0
91505,5,3,320305,320305,320308,0,3,1
91506,1,3,320306,320308,320311,2,5,0
91507,3,3,320309,320311,320314,2,5,0
91508,5,2,320314,320314,320316,0,2,0
91509,2,3,320316,320316,320319,0,3,0
91510,6,3,320322,320322,320325,0,3,3
91511,4,3,320326,320326,320329,0,3,1
91512,6,3,320332,320332,320335,0,3,3
91513,5,3,320337,320337,320340,0,3,2
91514,1,1,320338,320340,320341,2,3,0
91515,2,2,320340,320341,320343,1,3,0
91516,4,3,320344,320344,320347,0,3,1
91517,2,2,320346,320347,320349,1,3,0
91518,4,3,320350,320350,320353,0,3,1
91519,1,3,320351,320353,320356,2,5,0
91520,2,2,320353,320356,320358,3,5,0
91521,2,2,320355,320358,320360,3,5,0
91522,3,3,320358,320360,320363,2,5,0
91523,6,2,320364,320364,320366,0,2,1
91524,6,3,320370,320370,320373,0,3,4
91525,5,1,320375,320375,320376,0,1,2
91526,5,1,320380,320380,320381,0,1,4
91527,5,1,320385,320385,320386,0,1,4
91528,3,1,320388,320388,320389,0,1,2
91529,4,3,320392,320392,320395,0,3,3
91530,6,3,320398,320398,320401,0,3,3
91531,6,2,320404,320404,320406,0,2,3
91532,4,1,320408,320408,320409,0,1,2
91533,1,2,320409,320409,320411,0,2,0
91534,6,2,320415,320415,320417,0,2,4
91535,5,2,320420,320420,320422,0,2,3
91536,6,3,320426,320426,320429,0,3,4
91537,1,3,320427,320429,320432,2,5,0
91538,2,3,320429,320432,320435,3,6,0
91539,1,1,320430,320435,320436,5,6,0
91540,2,3,320432,320436,320439,4,7,0
91541,1,1,320433,320439,320440,6,7,0
91542,3,1,320436,320440,320441,4,5,0
91543,2,2,320438,320441,320443,3,5,0
91544,1,2,320439,320443,320445,4,6,0
91545,6,2,320445,320445,320447,0,2,0
91546,1,1,320446,320447,320448,1,2,0
91547,1,1,320447,320448,320449,1,2,0
91548,5,1,320452,320452,320453,0,1,3
91549,1,3,320453,320453,320456,0,3,0
91550,4,2,320457,320457,320459,0,2,1
91551,1,2,320458,320459,320461,1,3,0
91552,2,2,320460,320461,320463,1,3,0
91553,5,2,320465,320465,320467,0,2,2
91554,5,2,320470,320470,320472,0,2,3
91555,2,3,320472,320472,320475,0,3,0
91556,2,2,320474,320475,320477,1,3,0
91557,1,1,320475,320477,320478,2,3,0
91558,1,3,320476,320478,320481,2,5,0
91559,1,2,320477,320481,320483,4,6,0
91560,3,2,320480,320483,320485,3,5,0
91561,3,2,320483,320485,320487,2,4,0
91562,2,3,320485,320487,320490,2,5,0
91563,2,3,320487,320490,320493,3,6,0
91564,2,3,320489,320493,320496,4,7,0
91565,2,1,320491,320496,320497,5,6,0
91566,4,1,320495,320497,320498,2,3,0
91567,2,2,320497,320498,320500,1,3,0
91568,3,1,320500,320500,320501,0,1,0
91569,4,1,320504,320504,320505,0,1,3
91570,6,3,320510,320510,320513,0,3,5
91571,5,2,320515,320515,320517,0,2,2
91572,1,2,320516,320517,320519,1,3,0
91573,5,3,320521,320521,320524,0,3,2
91574,6,3,320527,320527,320530,0,3,3
91575,1,3,320528,320530,320533,2,5,0
91576,1,3,320529,320533,320536,4,7,0
91577,3,1,320532,320536,320537,4,5,0
91578,1,1,320533,320537,320538,4,5,0
91579,1,3,320534,320538,320541,4,7,0
91580,2,2,320536,320541,320543,5,7,0
91581,3,1,320539,320543,320544,4,5,0
91582,2,2,320541,320544,320546,3,5,0
91583,2,2,320543,320546,320548,3,5,0
91584,3,2,320546,320548,320550,2,4,0
91585,6,2,320552,320552,320554,0,2,2
91586,2,2,320554,320554,320556,0,2,0
91587,3,3,320557,320557,320560,0,3,1
91588,3,1,320560,320560,320561,0,1,0
91589,2,3,320562,320562,320565,0,3,1
91590,4,3,320566,320566,320569,0,3,1
91591,3,2,320569,320569,320571,0,2,0
91592,1,3,320570,320571,320574,1,4,0
91593,3,2,320573,320574,320576,1,3,0
91594,6,3,320579,320579,320582,0,3,3
91595,5,3,320584,320584,320587,0,3,2
91596,4,1,320588,320588,320589,0,1,1
91597,6,1,320594,320594,320595,0,1,5
91598,2,3,320596,320596,320599,0,3,1
91599,5,1,320601,320601,320602,0,1,2
91600,5,1,320606,320606,320607,0,1,4
91601,1,2,320607,320607,320609,0,2,0
91602,2,2,320609,320609,320611,0,2,0
91603,2,2,320611,320611,320613,0,2,0
91604,4,3,320615,320615,320618,0,3,2
91605,5,1,320620,320620,320621,0,1,2
91606,6,3,320626,320626,320629,0,3,5
91607,1,1,320627,320629,320630,2,3,0
91608,2,3,320629,320630,320633,1,4,0
91609,3,2,320632,320633,320635,1,3,0
91610,4,3,320636,320636,320639,0,3,1
91611,2,2,320638,320639,320641,1,3,0
91612,5,2,320643,320643,320645,0,2,2
91613,4,1,320647,320647,320648,0,1,2
91614,2,1,320649,320649,320650,0,1,1
91615,3,3,320652,320652,320655,0,3,2
91616,5,3,320657,320657,320660,0,3,2
91617,4,1,320661,320661,320662,0,1,1
91618,1,3,320662,320662,320665,0,3,0
91619,5,1,320667,320667,320668,0,1,2
91620,2,1,320669,320669,320670,0,1,1
91621,1,3,320670,320670,320673,0,3,0
91622,1,2,320671,320673,320675,2,4,0
91623,3,1,320674,320675,320676,1,2,0
91624,5,2,320679,320679,320681,0,2,3
91625,4,3,320683,320683,320686,0,3,2
91626,2,1,320685,320686,320687,1,2,0
91627,6,3,320691,320691,320694,0,3,4
91628,3,1,320694,320694,320695,0,1,0
91629,2,1,320696,320696,320697,0,1,1
91630,6,2,320702,320702,320704,0,2,5
91631,5,3,320707,320707,320710,0,3,3
91632,4,1,320711,320711,320712,0,1,1
91633,6,2,320717,320717,320719,0,2,5
91634,3,2,320720,320720,320722,0,2,1
91635,2,1,320722,320722,320723,0,1,0
91636,3,2,320725,320725,320727,0,2,2
91637,5,1,320730,320730,320731,0,1,3
91638,6,2,320736,320736,320738,0,2,5
91639,2,1,320738,320738,320739,0,1,0
91640,4,3,320742,320742,320745,0,3,3
91641,5,3,320747,320747,320750,0,3,2
91642,2,2,320749,320750,320752,1,3,0
91643,2,1,320751,320752,320753,1,2,0
91644,6,3,320757,320757,320760,0,3,4
91645,5,1,320762,320762,320763,0,1,2
91646,3,1,320765,320765,320766,0,1,2
91647,6,2,320771,320771,320773,0,2,5
91648,4,1,320775,320775,320776,0,1,2
91649,6,1,320781,320781,320782,0,1,5
91650,4,3,320785,320785,320788,0,3,3
91651,1,2,320786,320788,320790,2,4,0
91652,3,3,320789,320790,320793,1,4,0
91653,3,1,320792,320793,320794,1,2,0
91654,6,2,320798,320798,320800,0,2,4
91655,5,2,320803,320803,320805,0,2,3
91656,2,1,320805,320805,320806,0,1,0
91657,6,3,320811,320811,320814,0,3,5
91658,3,3,320814,320814,320817,0,3,0
91659,1,3,320815,320817,320820,2,5,0
91660,6,2,320821,320821,320823,0,2,1
91661,2,2,320823,320823,320825,0,2,0
91662,2,3,320825,320825,320828,0,3,0
91663,4,3,320829,320829,320832,0,3,1
91664,1,2,320830,320832,320834,2,4,0
91665,4,3,320834,320834,320837,0,3,0
91666,6,2,320840,320840,320842,0,2,3
91667,5,1,320845,320845,320846,0,1,3
91668,2,2,320847,320847,320849,0,2,1
91669,1,2,320848,320849,320851,1,3,0
91670,6,1,320854,320854,320855,0,1,3
91671,5,1,320859,320859,320860,0,1,4
91672,1,1,320860,320860,320861,0,1,0
91673,3,2,320863,320863,320865,0,2,2
91674,5,2,320868,320868,320870,0,2,3
91675,5,1,320873,320873,320874,0,1,3
91676,5,1,320878,320878,320879,0,1,4
91677,4,1,320882,320882,320883,0,1,3
91678,4,3,320886,320886,320889,0,3,3
91679,4,2,320890,320890,320892,0,2,1
91680,6,1,320896,320896,320897,0,1,4
91681,2,2,320898,320898,320900,0,2,1
91682,1,1,320899,320900,320901,1,2,0
91683,3,1,320902,320902,320903,0,1,1
91684,1,2,320903,320903,320905,0,2,0
91685,6,2,320909,320909,320911,0,2,4
91686,4,1,320913,320913,320914,0,1,2
91687,2,3,320915,320915,320918,0,3,1
91688,1,3,320916,320918,320921,2,5,0
91689,3,2,320919,320921,320923,2,4,0
91690,2,1,320921,320923,320924,2,3,0
91691,6,3,320927,320927,320930,0,3,3
91692,6,2,320933,320933,320935,0,2,3
91693,4,2,320937,320937,320939,0,2,2
91694,4,1,320941,320941,320942,0,1,2
91695,1,1,320942,320942,320943,0,1,0
91696,5,3,320947,320947,320950,0,3,4
91697,3,1,320950,320950,320951,0,1,0
91698,6,2,320956,320956,320958,0,2,5
91699,6,1,320962,320962,320963,0,1,4
91700,5,2,320967,320967,320969,0,2,4
91701,3,3,320970,320970,320973,0,3,1
91702,3,2,320973,320973,320975,0,2,0
91703,4,2,320977,320977,320979,0,2,2
91704,4,1,320981,320981,320982,0,1,2
91705,4,3,320985,320985,320988,0,3,3
91706,4,3,320989,320989,320992,0,3,1
91707,1,2,320990,320992,320994,2,4,0
91708,5,3,320995,320995,320998,0,3,1
91709,4,2,320999,320999,321001,0,2,1
91710,6,3,321005,321005,321008,0,3,4
91711,5,2,321010,321010,321012,0,2,2
91712,2,3,321012,321012,321015,0,3,0
91713,5,3,321017,321017,321020,0,3,2
91714,3,3,321020,321020,321023,0,3,0
91715,5,1,321025,321025,321026,0,1,2
91716,1,1,321026,321026,321027,0,1,0
91717,4,3,321030,321030,321033,0,3,3
91718,4,3,321034,321034,321037,0,3,1
91719,2,2,321036,321037,321039,1,3,0
91720,3,1,321039,321039,321040,0,1,0
91721,6,2,321045,321045,321047,0,2,5
91722,6,1,321051,321051,321052,0,1,4
91723,2,1,321053,321053,321054,0,1,1
91724,4,2,321057,321057,321059,0,2,3
91725,3,1,321060,321060,321061,0,1,1
91726,4,1,321064,321064,321065,0,1,3
91727,2,2,321066,321066,321068,0,2,1
91728,3,1,321069,321069,321070,0,1,1
91729,4,2,321073,321073,321075,0,2,3
91730,1,3,321074,321075,321078,1,4,0
91731,4,2,321078,321078,321080,0,2,0
91732,5,1,321083,321083,321084,0,1,3
91733,2,2,321085,321085,321087,0,2,1
91734,5,3,321090,321090,321093,0,3,3
91735,3,3,321093,321093,321096,0,3,0
91736,6,2,321099,321099,321101,0,2,3
91737,1,3,321100,321101,321104,1,4,0
91738,1,2,321101,321104,321106,3,5,0
91739,1,2,321102,321106,321108,4,6,0
91740,5,1,321107,321108,321109,1,2,0
91741,6,3,321113,321113,321116,0,3,4
91742,5,3,321118,321118,321121,0,3,2
91743,2,3,321120,321121,321124,1,4,0
91744,2,2,321122,321124,321126,2,4,0
91745,6,1,321128,321128,321129,0,1,2
91746,2,1,321130,321130,321131,0,1,1
91747,2,3,321132,321132,321135,0,3,1
91748,4,3,321136,321136,321139,0,3,1
91749,6,2,321142,321142,321144,0,2,3
91750,2,1,321144,321144,321145,0,1,0
91751,3,1,321147,321147,321148,0,1,2
91752,5,1,321152,321152,321153,0,1,4
91753,1,2,321153,321153,321155,0,2,0
91754,1,1,321154,321155,321156,1,2,0
91755,5,3,321159,321159,321162,0,3,3
91756,4,3,321163,321163,321166,0,3,1
91757,1,2,321164,321166,321168,2,4,0
91758,6,2,321170,321170,321172,0,2,2
91759,1,2,321171,321172,321174,1,3,0
91760,3,3,321174,321174,321177,0,3,0
91761,5,1,321179,321179,321180,0,1,2
91762,1,3,321180,321180,321183,0,3,0
91763,4,3,321184,321184,321187,0,3,1
91764,2,3,321186,321187,321190,1,4,0
91765,5,2,321191,321191,321193,0,2,1
91766,2,2,321193,321193,321195,0,2,0
91767,2,1,321195,321195,321196,0,1,0
91768,5,1,321200,321200,321201,0,1,4
91769,4,2,321204,321204,321206,0,2,3
91770,1,2,321205,321206,321208,1,3,0
91771,6,3,321211,321211,321214,0,3,3
91772,6,3,321217,321217,321220,0,3,3
91773,1,3,321218,321220,321223,2,5,0
91774,6,3,321224,321224,321227,0,3,1
91775,1,1,321225,321227,321228,2,3,0
91776,2,2,321227,321228,321230,1,3,0
91777,1,1,321228,321230,321231,2,3,0
91778,4,2,321232,321232,321234,0,2,1
91779,6,3,321238,321238,321241,0,3,4
91780,3,2,321241,321241,321243,0,2,0
91781,3,3,321244,321244,321247,0,3,1
91782,3,2,321247,321247,321249,0,2,0
91783,3,3,321250,321250,321253,0,3,1
91784,3,3,321253,321253,321256,0,3,0
91785,2,2,321255,321256,321258,1,3,0
91786,6,3,321261,321261,321264,0,3,3
91787,6,3,321267,321267,321270,0,3,3
91788,4,3,321271,321271,321274,0,3,1
91789,2,2,321273,321274,321276,1,3,0
91790,6,1,321279,321279,321280,0,1,3
91791,4,2,321283,321283,321285,0,2,3
91792,6,1,321289,321289,321290,0,1,4
91793,4,3,321293,321293,321296,0,3,3
91794,4,2,321297,321297,321299,0,2,1
91795,2,2,321299,321299,321301,0,2,0
91796,3,1,321302,321302,321303,0,1,1
91797,6,1,321308,321308,321309,0,1,5
91798,2,1,321310,321310,321311,0,1,1
91799,3,1,321313,321313,321314,0,1,2
91800,4,2,321317,321317,321319,0,2,3
91801,3,3,321320,321320,321323,0,3,1
91802,2,3,321322,321323,321326,1,4,0
91803,3,2,321325,321326,321328,1,3,0
91804,5,2,321330,321330,321332,0,2,2
91805,6,2,321336,321336,321338,0,2,4
91806,3,2,321339,321339,321341,0,2,1
91807,4,3,321343,321343,321346,0,3,2
91808,1,1,321344,321346,321347,2,3,0
91809,1,1,321345,321347,321348,2,3,0
91810,5,2,321350,321350,321352,0,2,2
91811,3,3,321353,321353,321356,0,3,1
91812,1,2,321354,321356,321358,2,4,0
91813,5,2,321359,321359,321361,0,2,1
91814,2,2,321361,321361,321363,0,2,0
91815,5,1,321366,321366,321367,0,1,3
91816,3,2,321369,321369,321371,0,2,2
91817,3,2,321372,321372,321374,0,2,1
91818,2,2,321374,321374,321376,0,2,0
91819,3,2,321377,321377,321379,0,2,1
91820,3,2,321380,321380,321382,0,2,1
91821,4,3,321384,321384,321387,0,3,2
91822,3,3,321387,321387,321390,0,3,0
91823,4,3,321391,321391,321394,0,3,1
91824,6,3,321397,321397,321400,0,3,3
91825,2,2,321399,321400,321402,1,3,0
91826,6,1,321405,321405,321406,0,1,3
91827,4,2,321409,321409,321411,0,2,3
91828,5,2,321414,321414,321416,0,2,3
91829,4,3,321418,321418,321421,0,3,2
91830,6,2,321424,321424,321426,0,2,3
91831,3,3,321427,321427,321430,0,3,1
91832,3,1,321430,321430,321431,0,1,0
91833,6,2,321436,321436,321438,0,2,5
91834,1,1,321437,321438,321439,1,2,0
91835,1,2,321438,321439,321441,1,3,0
91836,6,2,321444,321444,321446,0,2,3
91837,5,3,321449,321449,321452,0,3,3
91838,3,3,321452,321452,321455,0,3,0
91839,6,3,321458,321458,321461,0,3,3
91840,6,2,321464,321464,321466,0,2,3
91841,6,2,321470,321470,321472,0,2,4
91842,6,3,321476,321476,321479,0,3,4
91843,1,1,321477,321479,321480,2,3,0
91844,1,2,321478,321480,321482,2,4,0
91845,5,1,321483,321483,321484,0,1,1
91846,1,2,321484,321484,321486,0,2,0
91847,6,1,321490,321490,321491,0,1,4
91848,3,1,321493,321493,321494,0,1,2
91849,1,1,321494,321494,321495,0,1,0
91850,1,2,321495,321495,321497,0,2,0
91851,2,2,321497,321497,321499,0,2,0
91852,3,2,321500,321500,321502,0,2,1
91853,3,2,321503,321503,321505,0,2,1
91854,3,1,321506,321506,321507,0,1,1
91855,6,2,321512,321512,321514,0,2,5
91856,1,2,321513,321514,321516,1,3,0
91857,3,2,321516,321516,321518,0,2,0
91858,1,3,321517,321518,321521,1,4,0
91859,1,1,321518,321521,321522,3,4,0
91860,4,3,321522,321522,321525,0,3,0
91861,5,2,321527,321527,321529,0,2,2
91862,1,2,321528,321529,321531,1,3,0
91863,2,2,321530,321531,321533,1,3,0
91864,6,1,321536,321536,321537,0,1,3
91865,4,3,321540,321540,321543,0,3,3
91866,4,2,321544,321544,321546,0,2,1
91867,3,3,321547,321547,321550,0,3,1
91868,3,3,321550,321550,321553,0,3,0
91869,3,2,321553,321553,321555,0,2,0
91870,3,3,321556,321556,321559,0,3,1
91871,5,1,321561,321561,321562,0,1,2
91872,3,3,321564,321564,321567,0,3,2
91873,6,2,321570,321570,321572,0,2,3
91874,6,2,321576,321576,321578,0,2,4
91875,6,2,321582,321582,321584,0,2,4
91876,3,1,321585,321585,321586,0,1,1
91877,5,2,321590,321590,321592,0,2,4
91878,2,2,321592,321592,321594,0,2,0
91879,6,1,321598,321598,321599,0,1,4
91880,2,3,321600,321600,321603,0,3,1
91881,3,1,321603,321603,321604,0,1,0
91882,3,3,321606,321606,321609,0,3,2
91883,3,2,321609,321609,321611,0,2,0
91884,5,2,321614,321614,321616,0,2,3
91885,2,3,321616,321616,321619,0,3,0
91886,4,2,321620,321620,321622,0,2,1
91887,4,1,321624,321624,321625,0,1,2
91888,5,1,321629,321629,321630,0,1,4
91889,1,3,321630,321630,321633,0,3,0
91890,5,2,321635,321635,321637,0,2,2
91891,1,3,321636,321637,321640,1,4,0
91892,1,2,321637,321640,321642,3,5,0
91893,5,1,321642,321642,321643,0,1,0
91894,5,1,321647,321647,321648,0,1,4
91895,3,3,321650,321650,321653,0,3,2
91896,1,2,321651,321653,321655,2,4,0
91897,1,3,321652,321655,321658,3,6,0
91898,1,3,321653,321658,321661,5,8,0
91899,5,2,321658,321661,321663,3,5,0
91900,5,3,321663,321663,321666,0,3,0
91901,4,1,321667,321667,321668,0,1,1
91902,1,2,321668,321668,321670,0,2,0
91903,2,1,321670,321670,321671,0,1,0
91904,6,3,321676,321676,321679,0,3,5
91905,1,1,321677,321679,321680,2,3,0
91906,2,1,321679,321680,321681,1,2,0
91907,1,2,321680,321681,321683,1,3,0
91908,6,3,321686,321686,321689,0,3,3
91909,3,3,321689,321689,321692,0,3,0
91910,1,3,321690,321692,321695,2,5,0
91911,5,1,321695,321695,321696,0,1,0
91912,2,3,321697,321697,321700,0,3,1
91913,4,2,321701,321701,321703,0,2,1
91914,4,1,321705,321705,321706,0,1,2
91915,2,2,321707,321707,321709,0,2,1
91916,1,1,321708,321709,321710,1,2,0
91917,2,1,321710,321710,321711,0,1,0
91918,3,3,321713,321713,321716,0,3,2
91919,3,2,321716,321716,321718,0,2,0
91920,1,1,321717,321718,321719,1,2,0
91921,5,3,321722,321722,321725,0,3,3
91922,5,3,321727,321727,321730,0,3,2
91923,5,3,321732,321732,321735,0,3,2
91924,5,2,321737,321737,321739,0,2,2
91925,1,2,321738,321739,321741,1,3,0
91926,4,3,321742,321742,321745,0,3,1
91927,2,3,321744,321745,321748,1,4,0
91928,6,1,321750,321750,321751,0,1,2
91929,5,3,321755,321755,321758,0,3,4
91930,2,1,321757,321758,321759,1,2,0
91931,6,1,321763,321763,321764,0,1,4
91932,4,1,321767,321767,321768,0,1,3
91933,4,1,321771,321771,321772,0,1,3
91934,3,2,321774,321774,321776,0,2,2
91935,3,1,321777,321777,321778,0,1,1
91936,2,2,321779,321779,321781,0,2,1
91937,5,3,321784,321784,321787,0,3,3
91938,2,2,321786,321787,321789,1,3,0
91939,6,2,321792,321792,321794,0,2,3
91940,3,1,321795,321795,321796,0,1,1
91941,6,2,321801,321801,321803,0,2,5
91942,3,1,321804,321804,321805,0,1,1
91943,3,1,321807,321807,321808,0,1,2
91944,4,2,321811,321811,321813,0,2,3
91945,5,1,321816,321816,321817,0,1,3
91946,3,3,321819,321819,321822,0,3,2
91947,2,3,321821,321822,321825,1,4,0
91948,5,2,321826,321826,321828,0,2,1
91949,1,1,321827,321828,321829,1,2,0
91950,2,3,321829,321829,321832,0,3,0
91951,3,2,321832,321832,321834,0,2,0
91952,2,1,321834,321834,321835,0,1,0
91953,6,2,321840,321840,321842,0,2,5
91954,2,3,321842,321842,321845,0,3,0
91955,1,3,321843,321845,321848,2,5,0
91956,1,2,321844,321848,321850,4,6,0
91957,4,3,321848,321850,321853,2,5,0
91958,3,1,321851,321853,321854,2,3,0
91959,6,3,321857,321857,321860,0,3,3
91960,3,1,321860,321860,321861,0,1,0
91961,3,3,321863,321863,321866,0,3,2
91962,2,1,321865,321866,321867,1,2,0
91963,5,2,321870,321870,321872,0,2,3
91964,6,3,321876,321876,321879,0,3,4
91965,2,3,321878,321879,321882,1,4,0
91966,6,2,321884,321884,321886,0,2,2
91967,4,1,321888,321888,321889,0,1,2
91968,6,2,321894,321894,321896,0,2,5
91969,5,2,321899,321899,321901,0,2,3
91970,2,2,321901,321901,321903,0,2,0
91971,4,1,321905,321905,321906,0,1,2
91972,1,3,321906,321906,321909,0,3,0
91973,3,1,321909,321909,321910,0,1,0
91974,5,3,321914,321914,321917,0,3,4
91975,2,3,321916,321917,321920,1,4,0
91976,3,1,321919,321920,321921,1,2,0
91977,5,3,321924,321924,321927,0,3,3
91978,6,2,321930,321930,321932,0,2,3
91979,5,3,321935,321935,321938,0,3,3
91980,1,2,321936,321938,321940,2,4,0
91981,6,2,321942,321942,321944,0,2,2
91982,2,3,321944,321944,321947,0,3,0
91983,1,3,321945,321947,321950,2,5,0
91984,6,3,321951,321951,321954,0,3,1
91985,6,1,321957,321957,321958,0,1,3
91986,4,3,321961,321961,321964,0,3,3
91987,5,3,321966,321966,321969,0,3,2
91988,4,2,321970,321970,321972,0,2,1
91989,3,1,321973,321973,321974,0,1,1
91990,3,3,321976,321976,321979,0,3,2
91991,2,3,321978,321979,321982,1,4,0
91992,3,1,321981,321982,321983,1,2,0
91993,4,2,321985,321985,321987,0,2,2
91994,6,1,321991,321991,321992,0,1,4
91995,6,1,321997,321997,321998,0,1,5
91996,5,2,322002,322002,322004,0,2,4
91997,5,3,322007,322007,322010,0,3,3
91998,5,2,322012,322012,322014,0,2,2
91999,4,3,322016,322016,322019,0,3,2
92000,1,3,322017,322019,322022,2,5,0
92001,6,3,322023,322023,322026,0,3,1
92002,2,1,322025,322026,322027,1,2,0
92003,3,2,322028,322028,322030,0,2,1
92004,5,2,322033,322033,322035,0,2,3
92005,2,1,322035,322035,322036,0,1,0
92006,5,1,322040,322040,322041,0,1,4
92007,5,3,322045,322045,322048,0,3,4
92008,5,3,322050,322050,322053,0,3,2
92009,2,3,322052,322053,322056,1,4,0
92010,5,1,322057,322057,322058,0,1,1
92011,2,3,322059,322059,322062,0,3,1
92012,5,2,322064,322064,322066,0,2,2
92013,2,3,322066,322066,322069,0,3,0
92014,1,3,322067,322069,322072,2,5,0
92015,3,3,322070,322072,322075,2,5,0
92016,2,1,322072,322075,322076,3,4,0
92017,4,1,322076,322076,322077,0,1,0
92018,6,3,322082,322082,322085,0,3,5
92019,4,3,322086,322086,322089,0,3,1
92020,1,1,322087,322089,322090,2,3,0
92021,2,2,322089,322090,322092,1,3,0
92022,4,3,322093,322093,322096,0,3,1
92023,6,1,322099,322099,322100,0,1,3
92024,2,1,322101,322101,322102,0,1,1
92025,6,3,322107,322107,322110,0,3,5
92026,4,2,322111,322111,322113,0,2,1
92027,4,2,322115,322115,322117,0,2,2
92028,5,2,322120,322120,322122,0,2,3
92029,5,3,322125,322125,322128,0,3,3
92030,5,2,322130,322130,322132,0,2,2
92031,4,1,322134,322134,322135,0,1,2
92032,2,1,322136,322136,322137,0,1,1
92033,6,1,322142,322142,322143,0,1,5
92034,6,3,322148,322148,322151,0,3,5
92035,5,3,322153,322153,322156,0,3,2
92036,2,2,322155,322156,322158,1,3,0
92037,6,3,322161,322161,322164,0,3,3
92038,3,1,322164,322164,322165,0,1,0
92039,2,1,322166,322166,322167,0,1,1
92040,4,3,322170,322170,322173,0,3,3
92041,6,3,322176,322176,322179,0,3,3
92042,2,1,322178,322179,322180,1,2,0
92043,2,3,322180,322180,322183,0,3,0
92044,4,3,322184,322184,322187,0,3,1
92045,2,1,322186,322187,322188,1,2,0
92046,6,2,322192,322192,322194,0,2,4
92047,4,3,322196,322196,322199,0,3,2
92048,3,3,322199,322199,322202,0,3,0
92049,2,2,322201,322202,322204,1,3,0
92050,4,2,322205,322205,322207,0,2,1
92051,3,3,322208,322208,322211,0,3,1
92052,1,3,322209,322211,322214,2,5,0
92053,3,3,322212,322214,322217,2,5,0
92054,6,1,322218,322218,322219,0,1,1
92055,1,1,322219,322219,322220,0,1,0
92056,5,3,322224,322224,322227,0,3,4
92057,3,3,322227,322227,322230,0,3,0
92058,2,1,322229,322230,322231,1,2,0
92059,6,3,322235,322235,322238,0,3,4
92060,5,3,322240,322240,322243,0,3,2
92061,2,1,322242,322243,322244,1,2,0
92062,4,1,322246,322246,322247,0,1,2
92063,1,2,322247,322247,322249,0,2,0
92064,2,3,322249,322249,322252,0,3,0
92065,1,2,322250,322252,322254,2,4,0
92066,3,1,322253,322254,322255,1,2,0
92067,4,3,322257,322257,322260,0,3,2
92068,5,3,322262,322262,322265,0,3,2
92069,2,1,322264,322265,322266,1,2,0
92070,3,2,322267,322267,322269,0,2,1
92071,4,2,322271,322271,322273,0,2,2
92072,6,2,322277,322277,322279,0,2,4
92073,4,3,322281,322281,322284,0,3,2
92074,1,3,322282,322284,322287,2,5,0
92075,2,3,322284,322287,322290,3,6,0
92076,6,2,322290,322290,322292,0,2,0
92077,6,2,322296,322296,322298,0,2,4
92078,5,1,322301,322301,322302,0,1,3
92079,3,2,322304,322304,322306,0,2,2
92080,1,3,322305,322306,322309,1,4,0
92081,6,3,322311,322311,322314,0,3,2
92082,1,2,322312,322314,322316,2,4,0
92083,3,3,322315,322316,322319,1,4,0
92084,3,1,322318,322319,322320,1,2,0
92085,2,2,322320,322320,322322,0,2,0
92086,6,3,322326,322326,322329,0,3,4
92087,3,3,322329,322329,322332,0,3,0
92088,5,3,322334,322334,322337,0,3,2
92089,5,2,322339,322339,322341,0,2,2
92090,4,2,322343,322343,322345,0,2,2
92091,5,3,322348,322348,322351,0,3,3
92092,6,1,322354,322354,322355,0,1,3
92093,3,3,322357,322357,322360,0,3,2
92094,4,1,322361,322361,322362,0,1,1
92095,5,1,322366,322366,322367,0,1,4
92096,1,2,322367,322367,322369,0,2,0
92097,3,1,322370,322370,322371,0,1,1
92098,4,2,322374,322374,322376,0,2,3
92099,5,3,322379,322379,322382,0,3,3
92100,6,3,322385,322385,322388,0,3,3
92101,6,1,322391,322391,322392,0,1,3
92102,6,1,322397,322397,322398,0,1,5
92103,5,3,322402,322402,322405,0,3,4
92104,3,3,322405,322405,322408,0,3,0
92105,1,1,322406,322408,322409,2,3,0
92106,3,3,322409,322409,322412,0,3,0
92107,3,3,322412,322412,322415,0,3,0
92108,1,2,322413,322415,322417,2,4,0
92109,1,2,322414,322417,322419,3,5,0
92110,6,1,322420,322420,322421,0,1,1
92111,4,2,322424,322424,322426,0,2,3
92112,3,1,322427,322427,322428,0,1,1
92113,3,2,322430,322430,322432,0,2,2
92114,4,2,322434,322434,322436,0,2,2
92115,2,1,322436,322436,322437,0,1,0
92116,3,1,322439,322439,322440,0,1,2
92117,6,1,322445,322445,322446,0,1,5
92118,6,1,322451,322451,322452,0,1,5
92119,6,1,322457,322457,322458,0,1,5
92120,6,1,322463,322463,322464,0,1,5
92121,4,2,322467,322467,322469,0,2,3
92122,4,3,322471,322471,322474,0,3,2
92123,5,1,322476,322476,322477,0,1,2
92124,5,1,322481,322481,322482,0,1,4
92125,6,3,322487,322487,322490,0,3,5
92126,1,1,322488,322490,322491,2,3,0
92127,4,3,322492,322492,322495,0,3,1
92128,5,2,322497,322497,322499,0,2,2
92129,5,2,322502,322502,322504,0,2,3
92130,2,3,322504,322504,322507,0,3,0
92131,4,3,322508,322508,322511,0,3,1
92132,2,1,322510,322511,322512,1,2,0
92133,6,1,322516,322516,322517,0,1,4
92134,1,2,322517,322517,322519,0,2,0
92135,3,3,322520,322520,322523,0,3,1
92136,1,3,322521,322523,322526,2,5,0
92137,5,1,322526,322526,322527,0,1,0
92138,5,1,322531,322531,322532,0,1,4
92139,3,1,322534,322534,322535,0,1,2
92140,3,2,322537,322537,322539,0,2,2
92141,3,1,322540,322540,322541,0,1,1
92142,3,3,322543,322543,322546,0,3,2
92143,4,2,322547,322547,322549,0,2,1
92144,3,1,322550,322550,322551,0,1,1
92145,2,2,322552,322552,322554,0,2,1
92146,3,1,322555,322555,322556,0,1,1
92147,3,1,322558,322558,322559,0,1,2
92148,5,1,322563,322563,322564,0,1,4
92149,5,2,322568,322568,322570,0,2,4
92150,3,3,322571,322571,322574,0,3,1
92151,4,2,322575,322575,322577,0,2,1
92152,2,1,322577,322577,322578,0,1,0
92153,4,2,322581,322581,322583,0,2,3
92154,2,1,322583,322583,322584,0,1,0
92155,2,2,322585,322585,322587,0,2,1
92156,6,2,322591,322591,322593,0,2,4
92157,5,1,322596,322596,322597,0,1,3
92158,4,1,322600,322600,322601,0,1,3
92159,3,2,322603,322603,322605,0,2,2
92160,2,1,322605,322605,322606,0,1,0
92161,2,3,322607,322607,322610,0,3,1
92162,3,2,322610,322610,322612,0,2,0
92163,5,1,322615,322615,322616,0,1,3
92164,4,1,322619,322619,322620,0,1,3
92165,4,1,322623,322623,322624,0,1,3
92166,6,2,322629,322629,322631,0,2,5
92167,6,1,322635,322635,322636,0,1,4
92168,2,3,322637,322637,322640,0,3,1
92169,4,1,322641,322641,322642,0,1,1
92170,6,1,322647,322647,322648,0,1,5
92171,1,3,322648,322648,322651,0,3,0
92172,5,1,322653,322653,322654,0,1,2
92173,3,1,322656,322656,322657,0,1,2
92174,1,1,322657,322657,322658,0,1,0
92175,5,1,322662,322662,322663,0,1,4
92176,4,2,322666,322666,322668,0,2,3
92177,3,3,322669,322669,322672,0,3,1
92178,3,3,322672,322672,322675,0,3,0
92179,6,3,322678,322678,322681,0,3,3
92180,6,3,322684,322684,322687,0,3,3
92181,5,3,322689,322689,322692,0,3,2
92182,4,2,322693,322693,322695,0,2,1
92183,5,2,322698,322698,322700,0,2,3
92184,4,1,322702,322702,322703,0,1,2
92185,2,1,322704,322704,322705,0,1,1
92186,1,3,322705,322705,322708,0,3,0
92187,2,3,322707,322708,322711,1,4,0
92188,5,3,322712,322712,322715,0,3,1
92189,3,2,322715,322715,322717,0,2,0
92190,3,3,322718,322718,322721,0,3,1
92191,2,3,322720,322721,322724,1,4,0
92192,3,1,322723,322724,322725,1,2,0
92193,4,3,322727,322727,322730,0,3,2
92194,2,2,322729,322730,322732,1,3,0
92195,4,3,322733,322733,322736,0,3,1
92196,1,2,322734,322736,322738,2,4,0
92197,6,3,322740,322740,322743,0,3,2
92198,1,2,322741,322743,322745,2,4,0
92199,4,1,322745,322745,322746,0,1,0
92200,3,2,322748,322748,322750,0,2,2
92201,4,3,322752,322752,322755,0,3,2
92202,4,1,322756,322756,322757,0,1,1
92203,5,2,322761,322761,322763,0,2,4
92204,6,1,322767,322767,322768,0,1,4
92205,1,2,322768,322768,322770,0,2,0
92206,5,2,322773,322773,322775,0,2,3
92207,6,3,322779,322779,322782,0,3,4
92208,3,1,322782,322782,322783,0,1,0
92209,3,3,322785,322785,322788,0,3,2
92210,4,3,322789,322789,322792,0,3,1
92211,5,2,322794,322794,322796,0,2,2
92212,3,3,322797,322797,322800,0,3,1
92213,5,1,322802,322802,322803,0,1,2
92214,2,2,322804,322804,322806,0,2,1
92215,4,3,322808,322808,322811,0,3,2
92216,3,1,322811,322811,322812,0,1,0
92217,4,2,322815,322815,322817,0,2,3
92218,5,3,322820,322820,322823,0,3,3
92219,1,1,322821,322823,322824,2,3,0
92220,4,2,322825,322825,322827,0,2,1
92221,6,3,322831,322831,322834,0,3,4
92222,3,3,322834,322834,322837,0,3,0
92223,5,2,322839,322839,322841,0,2,2
92224,4,2,322843,322843,322845,0,2,2
92225,3,3,322846,322846,322849,0,3,1
92226,5,1,322851,322851,322852,0,1,2
92227,1,2,322852,322852,322854,0,2,0
92228,2,1,322854,322854,322855,0,1,0
92229,5,2,322859,322859,322861,0,2,4
92230,1,2,322860,322861,322863,1,3,0
92231,4,2,322864,322864,322866,0,2,1
92232,4,1,322868,322868,322869,0,1,2
92233,3,3,322871,322871,322874,0,3,2
92234,4,1,322875,322875,322876,0,1,1
92235,5,3,322880,322880,322883,0,3,4
92236,3,3,322883,322883,322886,0,3,0
92237,6,1,322889,322889,322890,0,1,3
92238,1,2,322890,322890,322892,0,2,0
92239,2,3,322892,322892,322895,0,3,0
92240,3,2,322895,322895,322897,0,2,0
92241,1,2,322896,322897,322899,1,3,0
92242,2,2,322898,322899,322901,1,3,0
92243,2,2,322900,322901,322903,1,3,0
92244,2,3,322902,322903,322906,1,4,0
92245,5,2,322907,322907,322909,0,2,1
92246,4,1,322911,322911,322912,0,1,2
92247,1,2,322912,322912,322914,0,2,0
92248,1,2,322913,322914,322916,1,3,0
92249,1,1,322914,322916,322917,2,3,0
92250,3,2,322917,322917,322919,0,2,0
92251,3,1,322920,322920,322921,0,1,1
92252,4,1,322924,322924,322925,0,1,3
92253,2,2,322926,322926,322928,0,2,1
92254,4,1,322930,322930,322931,0,1,2
92255,6,2,322936,322936,322938,0,2,5
92256,3,2,322939,322939,322941,0,2,1
92257,1,2,322940,322941,322943,1,3,0
92258,3,2,322943,322943,322945,0,2,0
92259,5,2,322948,322948,322950,0,2,3
92260,5,1,322953,322953,322954,0,1,3
92261,5,1,322958,322958,322959,0,1,4
92262,2,1,322960,322960,322961,0,1,1
92263,2,3,322962,322962,322965,0,3,1
92264,3,3,322965,322965,322968,0,3,0
92265,2,2,322967,322968,322970,1,3,0
92266,6,1,322973,322973,322974,0,1,3
92267,5,2,322978,322978,322980,0,2,4
92268,6,3,322984,322984,322987,0,3,4
92269,4,3,322988,322988,322991,0,3,1
92270,4,1,322992,322992,322993,0,1,1
92271,3,3,322995,322995,322998,0,3,2
92272,6,3,323001,323001,323004,0,3,3
92273,4,1,323005,323005,323006,0,1,1
92274,3,1,323008,323008,323009,0,1,2
92275,4,1,323012,323012,323013,0,1,3
92276,5,1,323017,323017,323018,0,1,4
92277,5,3,323022,323022,323025,0,3,4
92278,6,3,323028,323028,323031,0,3,3
92279,2,2,323030,323031,323033,1,3,0
92280,4,3,323034,323034,323037,0,3,1
92281,4,1,323038,323038,323039,0,1,1
92282,6,3,323044,323044,323047,0,3,5
92283,3,1,323047,323047,323048,0,1,0
92284,5,2,323052,323052,323054,0,2,4
92285,4,2,323056,323056,323058,0,2,2
92286,2,2,323058,323058,323060,0,2,0
92287,4,3,323062,323062,323065,0,3,2
92288,6,1,323068,323068,323069,0,1,3
92289,2,3,323070,323070,323073,0,3,1
92290,3,1,323073,323073,323074,0,1,0
92291,2,3,323075,323075,323078,0,3,1
92292,3,1,323078,323078,323079,0,1,0
92293,6,2,323084,323084,323086,0,2,5
92294,3,2,323087,323087,323089,0,2,1
92295,4,2,323091,323091,323093,0,2,2
92296,1,1,323092,323093,323094,1,2,0
92297,4,1,323096,323096,323097,0,1,2
92298,1,3,323097,323097,323100,0,3,0
92299,3,2,323100,323100,323102,0,2,0
92300,1,1,323101,323102,323103,1,2,0
92301,6,1,323107,323107,323108,0,1,4
92302,3,3,323110,323110,323113,0,3,2
92303,4,1,323114,323114,323115,0,1,1
92304,4,3,323118,323118,323121,0,3,3
92305,6,3,323124,323124,323127,0,3,3
92306,1,3,323125,323127,323130,2,5,0
92307,2,2,323127,323130,323132,3,5,0
92308,2,2,323129,323132,323134,3,5,0
92309,5,3,323134,323134,323137,0,3,0
92310,3,3,323137,323137,323140,0,3,0
92311,1,1,323138,323140,323141,2,3,0
92312,5,3,323143,323143,323146,0,3,2
92313,3,2,323146,323146,323148,0,2,0
92314,3,2,323149,323149,323151,0,2,1
92315,4,1,323153,323153,323154,0,1,2
92316,3,3,323156,323156,323159,0,3,2
92317,1,3,323157,323159,323162,2,5,0
92318,4,1,323161,323162,323163,1,2,0
92319,4,3,323165,323165,323168,0,3,2
92320,4,3,323169,323169,323172,0,3,1
92321,5,3,323174,323174,323177,0,3,2
92322,5,1,323179,323179,323180,0,1,2
92323,2,2,323181,323181,323183,0,2,1
92324,6,3,323187,323187,323190,0,3,4
92325,1,3,323188,323190,323193,2,5,0
92326,4,3,323192,323193,323196,1,4,0
92327,1,1,323193,323196,323197,3,4,0
92328,1,3,323194,323197,323200,3,6,0
92329,1,1,323195,323200,323201,5,6,0
92330,4,1,323199,323201,323202,2,3,0
92331,1,3,323200,323202,323205,2,5,0
92332,5,2,323205,323205,323207,0,2,0
92333,1,2,323206,323207,323209,1,3,0
92334,3,2,323209,323209,323211,0,2,0
92335,5,1,323214,323214,323215,0,1,3
92336,1,1,323215,323215,323216,0,1,0
92337,1,1,323216,323216,323217,0,1,0
92338,3,2,323219,323219,323221,0,2,2
92339,1,3,323220,323221,323224,1,4,0
92340,1,3,323221,323224,323227,3,6,0
92341,6,1,323227,323227,323228,0,1,0
92342,5,3,323232,323232,323235,0,3,4
92343,6,2,323238,323238,323240,0,2,3
92344,2,1,323240,323240,323241,0,1,0
92345,4,3,323244,323244,323247,0,3,3
92346,2,1,323246,323247,323248,1,2,0
92347,2,3,323248,323248,323251,0,3,0
92348,3,1,323251,323251,323252,0,1,0
92349,2,1,323253,323253,323254,0,1,1
92350,4,3,323257,323257,323260,0,3,3
92351,5,1,323262,323262,323263,0,1,2
92352,6,2,323268,323268,323270,0,2,5
92353,4,3,323272,323272,323275,0,3,2
92354,2,2,323274,323275,323277,1,3,0
92355,3,2,323277,323277,323279,0,2,0
92356,3,2,323280,323280,323282,0,2,1
92357,1,1,323281,323282,323283,1,2,0
92358,2,1,323283,323283,323284,0,1,0
92359,2,2,323285,323285,323287,0,2,1
92360,4,2,323289,323289,323291,0,2,2
92361,2,1,323291,323291,323292,0,1,0
92362,5,1,323296,323296,323297,0,1,4
92363,4,1,323300,323300,323301,0,1,3
92364,3,1,323303,323303,323304,0,1,2
92365,1,1,323304,323304,323305,0,1,0
92366,2,1,323306,323306,323307,0,1,1
92367,1,3,323307,323307,323310,0,3,0
92368,3,1,323310,323310,323311,0,1,0
92369,5,3,323315,323315,323318,0,3,4
92370,6,1,323321,323321,323322,0,1,3
92371,1,1,323322,323322,323323,0,1,0
92372,5,3,323327,323327,323330,0,3,4
92373,4,2,323331,323331,323333,0,2,1
92374,1,3,323332,323333,323336,1,4,0
92375,5,2,323337,323337,323339,0,2,1
92376,5,2,323342,323342,323344,0,2,3
92377,4,3,323346,323346,323349,0,3,2
92378,4,3,323350,323350,323353,0,3,1
92379,4,2,323354,323354,323356,0,2,1
92380,5,3,323359,323359,323362,0,3,3
92381,4,1,323363,323363,323364,0,1,1
92382,5,3,323368,323368,323371,0,3,4
92383,3,2,323371,323371,323373,0,2,0
92384,4,1,323375,323375,323376,0,1,2
92385,1,3,323376,323376,323379,0,3,0
92386,4,3,323380,323380,323383,0,3,1
92387,2,1,323382,323383,323384,1,2,0
92388,2,1,323384,323384,323385,0,1,0
92389,1,2,323385,323385,323387,0,2,0
92390,1,2,323386,323387,323389,1,3,0
92391,1,2,323387,323389,323391,2,4,0
92392,3,2,323390,323391,323393,1,3,0
92393,5,1,323395,323395,323396,0,1,2
92394,6,2,323401,323401,323403,0,2,5
92395,6,2,323407,323407,323409,0,2,4
92396,4,3,323411,323411,323414,0,3,2
92397,5,1,323416,323416,323417,0,1,2
92398,1,2,323417,323417,323419,0,2,0
92399,2,1,323419,323419,323420,0,1,0
92400,1,3,323420,323420,323423,0,3,0
92401,3,1,323423,323423,323424,0,1,0
92402,2,3,323425,323425,323428,0,3,1
92403,6,1,323431,323431,323432,0,1,3
92404,5,2,323436,323436,323438,0,2,4
92405,2,1,323438,323438,323439,0,1,0
92406,5,1,323443,323443,323444,0,1,4
92407,2,1,323445,323445,323446,0,1,1
92408,2,2,323447,323447,323449,0,2,1
92409,4,2,323451,323451,323453,0,2,2
92410,2,1,323453,323453,323454,0,1,0
92411,3,1,323456,323456,323457,0,1,2
92412,5,3,323461,323461,323464,0,3,4
92413,5,2,323466,323466,323468,0,2,2
92414,5,1,323471,323471,323472,0,1,3
92415,1,1,323472,323472,323473,0,1,0
92416,6,1,323478,323478,323479,0,1,5
92417,6,2,323484,323484,323486,0,2,5
92418,4,2,323488,323488,323490,0,2,2
92419,6,2,323494,323494,323496,0,2,4
92420,4,1,323498,323498,323499,0,1,2
92421,1,2,323499,323499,323501,0,2,0
92422,4,2,323503,323503,323505,0,2,2
92423,2,3,323505,323505,323508,0,3,0
92424,2,1,323507,323508,323509,1,2,0
92425,5,2,323512,323512,323514,0,2,3
92426,6,2,323518,323518,323520,0,2,4
92427,3,2,323521,323521,323523,0,2,1
92428,4,1,323525,323525,323526,0,1,2
92429,6,3,323531,323531,323534,0,3,5
92430,6,3,323537,323537,323540,0,3,3
92431,1,1,323538,323540,323541,2,3,0
92432,3,2,323541,323541,323543,0,2,0
92433,2,3,323543,323543,323546,0,3,0
92434,1,3,323544,323546,323549,2,5,0
92435,4,3,323548,323549,323552,1,4,0
92436,5,2,323553,323553,323555,0,2,1
92437,1,1,323554,323555,323556,1,2,0
92438,2,1,323556,323556,323557,0,1,0
92439,2,1,323558,323558,323559,0,1,1
92440,5,1,323563,323563,323564,0,1,4
92441,2,2,323565,323565,323567,0,2,1
92442,4,3,323569,323569,323572,0,3,2
92443,1,3,323570,323572,323575,2,5,0
92444,3,3,323573,323575,323578,2,5,0
92445,1,2,323574,323578,323580,4,6,0
92446,1,1,323575,323580,323581,5,6,0
92447,4,3,323579,323581,323584,2,5,0
92448,6,1,323585,323585,323586,0,1,1
92449,1,1,323586,323586,323587,0,1,0
92450,1,2,323587,323587,323589,0,2,0
92451,1,3,323588,323589,323592,1,4,0
92452,1,2,323589,323592,323594,3,5,0
92453,2,3,323591,323594,323597,3,6,0
92454,5,1,323596,323597,323598,1,2,0
92455,1,2,323597,323598,323600,1,3,0
92456,1,3,323598,323600,323603,2,5,0
92457,4,1,323602,323603,323604,1,2,0
92458,6,3,323608,323608,323611,0,3,4
92459,5,1,323613,323613,323614,0,1,2
92460,1,3,323614,323614,323617,0,3,0
92461,1,1,323615,323617,323618,2,3,0
92462,2,3,323617,323618,323621,1,4,0
92463,4,3,323621,323621,323624,0,3,0
92464,1,3,323622,323624,323627,2,5,0
92465,6,3,323628,323628,323631,0,3,1
92466,4,2,323632,323632,323634,0,2,1
92467,3,2,323635,323635,323637,0,2,1
92468,5,3,323640,323640,323643,0,3,3
92469,5,1,323645,323645,323646,0,1,2
92470,1,1,323646,323646,323647,0,1,0
92471,4,3,323650,323650,323653,0,3,3
92472,3,3,323653,323653,323656,0,3,0
92473,2,3,323655,323656,323659,1,4,0
92474,2,1,323657,323659,323660,2,3,0
92475,6,1,323663,323663,323664,0,1,3
92476,3,1,323666,323666,323667,0,1,2
92477,2,3,323668,323668,323671,0,3,1
92478,6,3,323674,323674,323677,0,3,3
92479,6,2,323680,323680,323682,0,2,3
92480,2,3,323682,323682,323685,0,3,0
92481,3,1,323685,323685,323686,0,1,0
92482,2,3,323687,323687,323690,0,3,1
92483,1,1,323688,323690,323691,2,3,0
92484,4,2,323692,323692,323694,0,2,1
92485,3,2,323695,323695,323697,0,2,1
92486,1,2,323696,323697,323699,1,3,0
92487,2,3,323698,323699,323702,1,4,0
92488,6,3,323704,323704,323707,0,3,2
92489,5,1,323709,323709,323710,0,1,2
92490,1,2,323710,323710,323712,0,2,0
92491,3,2,323713,323713,323715,0,2,1
92492,3,2,323716,323716,323718,0,2,1
92493,6,3,323722,323722,323725,0,3,4
92494,5,1,323727,323727,323728,0,1,2
92495,4,1,323731,323731,323732,0,1,3
92496,6,3,323737,323737,323740,0,3,5
92497,5,2,323742,323742,323744,0,2,2
92498,1,1,323743,323744,323745,1,2,0
92499,1,1,323744,323745,323746,1,2,0
92500,2,2,323746,323746,323748,0,2,0
92501,1,3,323747,323748,323751,1,4,0
92502,1,1,323748,323751,323752,3,4,0
92503,3,1,323751,323752,323753,1,2,0
92504,1,3,323752,323753,323756,1,4,0
92505,2,2,323754,323756,323758,2,4,0
92506,6,2,323760,323760,323762,0,2,2
92507,6,3,323766,323766,323769,0,3,4
92508,6,2,323772,323772,323774,0,2,3
92509,5,3,323777,323777,323780,0,3,3
92510,5,2,323782,323782,323784,0,2,2
92511,5,3,323787,323787,323790,0,3,3
92512,3,3,323790,323790,323793,0,3,0
92513,4,1,323794,323794,323795,0,1,1
92514,5,3,323799,323799,323802,0,3,4
92515,4,2,323803,323803,323805,0,2,1
92516,5,3,323808,323808,323811,0,3,3
92517,5,1,323813,323813,323814,0,1,2
92518,4,3,323817,323817,323820,0,3,3
92519,2,3,323819,323820,323823,1,4,0
92520,1,1,323820,323823,323824,3,4,0
92521,5,1,323825,323825,323826,0,1,1
92522,5,2,323830,323830,323832,0,2,4
92523,2,3,323832,323832,323835,0,3,0
92524,5,2,323837,323837,323839,0,2,2
92525,5,3,323842,323842,323845,0,3,3
92526,6,1,323848,323848,323849,0,1,3
92527,6,1,323854,323854,323855,0,1,5
92528,1,3,323855,323855,323858,0,3,0
92529,6,1,323861,323861,323862,0,1,3
92530,6,2,323867,323867,323869,0,2,5
92531,4,3,323871,323871,323874,0,3,2
92532,4,3,323875,323875,323878,0,3,1
92533,5,3,323880,323880,323883,0,3,2
92534,2,1,323882,323883,323884,1,2,0
92535,6,3,323888,323888,323891,0,3,4
92536,4,3,323892,323892,323895,0,3,1
92537,6,3,323898,323898,323901,0,3,3
92538,4,3,323902,323902,323905,0,3,1
92539,3,2,323905,323905,323907,0,2,0
92540,2,1,323907,323907,323908,0,1,0
92541,5,3,323912,323912,323915,0,3,4
92542,1,1,323913,323915,323916,2,3,0
92543,2,1,323915,323916,323917,1,2,0
92544,2,1,323917,323917,323918,0,1,0
92545,5,2,323922,323922,323924,0,2,4
92546,1,2,323923,323924,323926,1,3,0
92547,2,2,323925,323926,323928,1,3,0
92548,4,1,323929,323929,323930,0,1,1
92549,1,2,323930,323930,323932,0,2,0
92550,1,3,323931,323932,323935,1,4,0
92551,4,1,323935,323935,323936,0,1,0
92552,3,3,323938,323938,323941,0,3,2
92553,6,3,323944,323944,323947,0,3,3
92554,2,2,323946,323947,323949,1,3,0
92555,1,2,323947,323949,323951,2,4,0
92556,5,3,323952,323952,323955,0,3,1
92557,6,3,323958,323958,323961,0,3,3
92558,6,2,323964,323964,323966,0,2,3
92559,2,3,323966,323966,323969,0,3,0
92560,6,3,323972,323972,323975,0,3,3
92561,2,3,323974,323975,323978,1,4,0
92562,6,2,323980,323980,323982,0,2,2
92563,2,2,323982,323982,323984,0,2,0
92564,3,3,323985,323985,323988,0,3,1
92565,1,1,323986,323988,323989,2,3,0
92566,2,2,323988,323989,323991,1,3,0
92567,5,1,323993,323993,323994,0,1,2
92568,1,3,323994,323994,323997,0,3,0
92569,6,3,324000,324000,324003,0,3,3
92570,4,1,324004,324004,324005,0,1,1
92571,4,2,324008,324008,324010,0,2,3
92572,2,3,324010,324010,324013,0,3,0
92573,6,1,324016,324016,324017,0,1,3
92574,3,2,324019,324019,324021,0,2,2
92575,1,2,324020,324021,324023,1,3,0
92576,2,1,324022,324023,324024,1,2,0
92577,2,3,324024,324024,324027,0,3,0
92578,1,1,324025,324027,324028,2,3,0
92579,3,2,324028,324028,324030,0,2,0
92580,4,1,324032,324032,324033,0,1,2
92581,4,2,324036,324036,324038,0,2,3
92582,5,1,324041,324041,324042,0,1,3
92583,5,1,324046,324046,324047,0,1,4
92584,6,2,324052,324052,324054,0,2,5
92585,4,3,324056,324056,324059,0,3,2
92586,2,1,324058,324059,324060,1,2,0
92587,4,2,324062,324062,324064,0,2,2
92588,2,1,324064,324064,324065,0,1,0
92589,6,3,324070,324070,324073,0,3,5
92590,4,3,324074,324074,324077,0,3,1
92591,5,1,324079,324079,324080,0,1,2
92592,3,1,324082,324082,324083,0,1,2
92593,2,3,324084,324084,324087,0,3,1
92594,2,1,324086,324087,324088,1,2,0
92595,5,3,324091,324091,324094,0,3,3
92596,2,2,324093,324094,324096,1,3,0
92597,5,2,324098,324098,324100,0,2,2
92598,4,2,324102,324102,324104,0,2,2
92599,3,2,324105,324105,324107,0,2,1
92600,5,2,324110,324110,324112,0,2,3
92601,5,2,324115,324115,324117,0,2,3
92602,4,1,324119,324119,324120,0,1,2
92603,3,1,324122,324122,324123,0,1,2
92604,5,3,324127,324127,324130,0,3,4
92605,6,1,324133,324133,324134,0,1,3
92606,2,2,324135,324135,324137,0,2,1
92607,3,3,324138,324138,324141,0,3,1
92608,1,3,324139,324141,324144,2,5,0
92609,3,3,324142,324144,324147,2,5,0
92610,1,1,324143,324147,324148,4,5,0
92611,2,2,324145,324148,324150,3,5,0
92612,1,3,324146,324150,324153,4,7,0
92613,4,3,324150,324153,324156,3,6,0
92614,1,1,324151,324156,324157,5,6,0
92615,1,2,324152,324157,324159,5,7,0
92616,5,2,324157,324159,324161,2,4,0
92617,1,3,324158,324161,324164,3,6,0
92618,4,1,324162,324164,324165,2,3,0
92619,6,2,324168,324168,324170,0,2,3
92620,5,1,324173,324173,324174,0,1,3
92621,2,1,324175,324175,324176,0,1,1
92622,4,3,324179,324179,324182,0,3,3
92623,1,2,324180,324182,324184,2,4,0
92624,2,1,324182,324184,324185,2,3,0
92625,6,2,324188,324188,324190,0,2,3
92626,1,1,324189,324190,324191,1,2,0
92627,1,3,324190,324191,324194,1,4,0
92628,1,3,324191,324194,324197,3,6,0
92629,3,1,324194,324197,324198,3,4,0
92630,2,2,324196,324198,324200,2,4,0
92631,3,3,324199,324200,324203,1,4,0
92632,5,2,324204,324204,324206,0,2,1
92633,1,2,324205,324206,324208,1,3,0
92634,2,1,324207,324208,324209,1,2,0
92635,6,2,324213,324213,324215,0,2,4
92636,4,2,324217,324217,324219,0,2,2
92637,5,2,324222,324222,324224,0,2,3
92638,3,3,324225,324225,324228,0,3,1
92639,3,2,324228,324228,324230,0,2,0
92640,5,1,324233,324233,324234,0,1,3
92641,3,1,324236,324236,324237,0,1,2
92642,4,3,324240,324240,324243,0,3,3
92643,1,1,324241,324243,324244,2,3,0
92644,1,2,324242,324244,324246,2,4,0
92645,5,2,324247,324247,324249,0,2,1
92646,2,3,324249,324249,324252,0,3,0
92647,2,2,324251,324252,324254,1,3,0
92648,6,1,324257,324257,324258,0,1,3
92649,4,2,324261,324261,324263,0,2,3
92650,2,1,324263,324263,324264,0,1,0
92651,3,1,324266,324266,324267,0,1,2
92652,2,3,324268,324268,324271,0,3,1
92653,4,1,324272,324272,324273,0,1,1
92654,4,1,324276,324276,324277,0,1,3
92655,5,3,324281,324281,324284,0,3,4
92656,1,2,324282,324284,324286,2,4,0
92657,6,2,324288,324288,324290,0,2,2
92658,5,2,324293,324293,324295,0,2,3
92659,6,1,324299,324299,324300,0,1,4
92660,3,2,324302,324302,324304,0,2,2
92661,5,3,324307,324307,324310,0,3,3
92662,1,1,324308,324310,324311,2,3,0
92663,2,1,324310,324311,324312,1,2,0
92664,2,3,324312,324312,324315,0,3,0
92665,1,2,324313,324315,324317,2,4,0
92666,3,1,324316,324317,324318,1,2,0
92667,5,3,324321,324321,324324,0,3,3
92668,1,1,324322,324324,324325,2,3,0
92669,6,2,324328,324328,324330,0,2,3
92670,2,3,324330,324330,324333,0,3,0
92671,5,2,324335,324335,324337,0,2,2
92672,4,2,324339,324339,324341,0,2,2
92673,4,2,324343,324343,324345,0,2,2
92674,4,1,324347,324347,324348,0,1,2
92675,1,2,324348,324348,324350,0,2,0
92676,6,1,324354,324354,324355,0,1,4
92677,4,2,324358,324358,324360,0,2,3
92678,5,1,324363,324363,324364,0,1,3
92679,6,2,324369,324369,324371,0,2,5
92680,6,1,324375,324375,324376,0,1,4
92681,2,2,324377,324377,324379,0,2,1
92682,6,2,324383,324383,324385,0,2,4
92683,2,1,324385,324385,324386,0,1,0
92684,6,2,324391,324391,324393,0,2,5
92685,5,3,324396,324396,324399,0,3,3
92686,6,3,324402,324402,324405,0,3,3
92687,6,3,324408,324408,324411,0,3,3
92688,3,3,324411,324411,324414,0,3,0
92689,3,3,324414,324414,324417,0,3,0
92690,5,2,324419,324419,324421,0,2,2
92691,4,1,324423,324423,324424,0,1,2
92692,6,2,324429,324429,324431,0,2,5
92693,6,3,324435,324435,324438,0,3,4
92694,2,2,324437,324438,324440,1,3,0
92695,5,1,324442,324442,324443,0,1,2
92696,2,2,324444,324444,324446,0,2,1
92697,2,3,324446,324446,324449,0,3,0
92698,3,2,324449,324449,324451,0,2,0
92699,6,3,324455,324455,324458,0,3,4
92700,6,3,324461,324461,324464,0,3,3
92701,2,1,324463,324464,324465,1,2,0
92702,1,2,324464,324465,324467,1,3,0
92703,5,3,324469,324469,324472,0,3,2
92704,3,1,324472,324472,324473,0,1,0
92705,1,2,324473,324473,324475,0,2,0
92706,3,2,324476,324476,324478,0,2,1
92707,4,1,324480,324480,324481,0,1,2
92708,6,2,324486,324486,324488,0,2,5
92709,4,1,324490,324490,324491,0,1,2
92710,4,1,324494,324494,324495,0,1,3
92711,4,3,324498,324498,324501,0,3,3
92712,6,1,324504,324504,324505,0,1,3
92713,5,3,324509,324509,324512,0,3,4
92714,3,1,324512,324512,324513,0,1,0
92715,2,1,324514,324514,324515,0,1,1
92716,2,3,324516,324516,324519,0,3,1
92717,5,2,324521,324521,324523,0,2,2
92718,3,3,324524,324524,324527,0,3,1
92719,3,3,324527,324527,324530,0,3,0
92720,6,3,324533,324533,324536,0,3,3
92721,5,2,324538,324538,324540,0,2,2
92722,4,3,324542,324542,324545,0,3,2
92723,4,1,324546,324546,324547,0,1,1
92724,3,2,324549,324549,324551,0,2,2
92725,1,2,324550,324551,324553,1,3,0
92726,1,3,324551,324553,324556,2,5,0
92727,3,2,324554,324556,324558,2,4,0
92728,6,3,324560,324560,324563,0,3,2
92729,6,2,324566,324566,324568,0,2,3
92730,1,3,324567,324568,324571,1,4,0
92731,6,3,324573,324573,324576,0,3,2
92732,3,2,324576,324576,324578,0,2,0
92733,1,2,324577,324578,324580,1,3,0
92734,4,1,324581,324581,324582,0,1,1
92735,1,3,324582,324582,324585,0,3,0
92736,5,2,324587,324587,324589,0,2,2
92737,5,1,324592,324592,324593,0,1,3
92738,4,3,324596,324596,324599,0,3,3
92739,2,3,324598,324599,324602,1,4,0
92740,4,1,324602,324602,324603,0,1,0
92741,1,2,324603,324603,324605,0,2,0
92742,4,2,324607,324607,324609,0,2,2
92743,1,2,324608,324609,324611,1,3,0
92744,5,3,324613,324613,324616,0,3,2
92745,4,2,324617,324617,324619,0,2,1
92746,3,2,324620,324620,324622,0,2,1
92747,3,3,324623,324623,324626,0,3,1
92748,5,3,324628,324628,324631,0,3,2
92749,1,3,324629,324631,324634,2,5,0
92750,3,1,324632,324634,324635,2,3,0
92751,3,3,324635,324635,324638,0,3,0
92752,3,1,324638,324638,324639,0,1,0
92753,5,2,324643,324643,324645,0,2,4
92754,1,2,324644,324645,324647,1,3,0
92755,4,2,324648,324648,324650,0,2,1
92756,5,3,324653,324653,324656,0,3,3
92757,4,3,324657,324657,324660,0,3,1
92758,3,3,324660,324660,324663,0,3,0
92759,2,2,324662,324663,324665,1,3,0
92760,5,3,324667,324667,324670,0,3,2
92761,1,3,324668,324670,324673,2,5,0
92762,1,1,324669,324673,324674,4,5,0
92763,1,2,324670,324674,324676,4,6,0
92764,5,2,324675,324676,324678,1,3,0
92765,3,3,324678,324678,324681,0,3,0
92766,4,1,324682,324682,324683,0,1,1
92767,3,1,324685,324685,324686,0,1,2
92768,1,2,324686,324686,324688,0,2,0
92769,2,3,324688,324688,324691,0,3,0
92770,5,2,324693,324693,324695,0,2,2
92771,4,3,324697,324697,324700,0,3,2
92772,1,3,324698,324700,324703,2,5,0
92773,2,3,324700,324703,324706,3,6,0
92774,2,2,324702,324706,324708,4,6,0
92775,2,2,324704,324708,324710,4,6,0
92776,2,1,324706,324710,324711,4,5,0
92777,6,1,324712,324712,324713,0,1,1
92778,6,2,324718,324718,324720,0,2,5
92779,5,3,324723,324723,324726,0,3,3
92780,1,3,324724,324726,324729,2,5,0
92781,1,3,324725,324729,324732,4,7,0
92782,1,1,324726,324732,324733,6,7,0
92783,6,1,324732,324733,324734,1,2,0
92784,6,3,324738,324738,324741,0,3,4
92785,3,1,324741,324741,324742,0,1,0
92786,1,1,324742,324742,324743,0,1,0
92787,1,2,324743,324743,324745,0,2,0
92788,1,3,324744,324745,324748,1,4,0
92789,6,3,324750,324750,324753,0,3,2
92790,4,3,324754,324754,324757,0,3,1
92791,3,2,324757,324757,324759,0,2,0
92792,5,2,324762,324762,324764,0,2,3
92793,5,2,324767,324767,324769,0,2,3
92794,4,2,324771,324771,324773,0,2,2
92795,1,2,324772,324773,324775,1,3,0
92796,5,2,324777,324777,324779,0,2,2
92797,4,3,324781,324781,324784,0,3,2
92798,2,1,324783,324784,324785,1,2,0
92799,6,2,324789,324789,324791,0,2,4
92800,3,1,324792,324792,324793,0,1,1
92801,1,3,324793,324793,324796,0,3,0
92802,4,1,324797,324797,324798,0,1,1
92803,2,2,324799,324799,324801,0,2,1
92804,2,3,324801,324801,324804,0,3,0
92805,2,2,324803,324804,324806,1,3,0
92806,5,3,324808,324808,324811,0,3,2
92807,4,1,324812,324812,324813,0,1,1
92808,1,3,324813,324813,324816,0,3,0
92809,6,2,324819,324819,324821,0,2,3
92810,2,3,324821,324821,324824,0,3,0
92811,3,2,324824,324824,324826,0,2,0
92812,3,3,324827,324827,324830,0,3,1
92813,5,1,324832,324832,324833,0,1,2
92814,1,1,324833,324833,324834,0,1,0
92815,2,3,324835,324835,324838,0,3,1
92816,5,1,324840,324840,324841,0,1,2
92817,5,3,324845,324845,324848,0,3,4
92818,6,2,324851,324851,324853,0,2,3
92819,4,1,324855,324855,324856,0,1,2
92820,5,1,324860,324860,324861,0,1,4
92821,2,1,324862,324862,324863,0,1,1
92822,2,1,324864,324864,324865,0,1,1
92823,5,2,324869,324869,324871,0,2,4
92824,4,3,324873,324873,324876,0,3,2
92825,3,1,324876,324876,324877,0,1,0
92826,5,1,324881,324881,324882,0,1,4
92827,2,1,324883,324883,324884,0,1,1
92828,5,3,324888,324888,324891,0,3,4
92829,1,2,324889,324891,324893,2,4,0
92830,2,1,324891,324893,324894,2,3,0
92831,6,3,324897,324897,324900,0,3,3
92832,4,2,324901,324901,324903,0,2,1
92833,3,1,324904,324904,324905,0,1,1
92834,5,3,324909,324909,324912,0,3,4
92835,6,2,324915,324915,324917,0,2,3
92836,2,1,324917,324917,324918,0,1,0
92837,6,3,324923,324923,324926,0,3,5
92838,3,1,324926,324926,324927,0,1,0
92839,4,3,324930,324930,324933,0,3,3
92840,2,3,324932,324933,324936,1,4,0
92841,6,3,324938,324938,324941,0,3,2
92842,5,3,324943,324943,324946,0,3,2
92843,4,2,324947,324947,324949,0,2,1
92844,5,2,324952,324952,324954,0,2,3
92845,2,3,324954,324954,324957,0,3,0
92846,3,3,324957,324957,324960,0,3,0
92847,1,3,324958,324960,324963,2,5,0
92848,3,2,324961,324963,324965,2,4,0
92849,3,2,324964,324965,324967,1,3,0
92850,4,3,324968,324968,324971,0,3,1
92851,3,1,324971,324971,324972,0,1,0
92852,6,2,324977,324977,324979,0,2,5
92853,1,1,324978,324979,324980,1,2,0
92854,3,1,324981,324981,324982,0,1,1
92855,1,2,324982,324982,324984,0,2,0
92856,6,1,324988,324988,324989,0,1,4
92857,3,3,324991,324991,324994,0,3,2
92858,4,1,324995,324995,324996,0,1,1
92859,4,1,324999,324999,325000,0,1,3
92860,1,1,325000,325000,325001,0,1,0
92861,6,3,325006,325006,325009,0,3,5
92862,1,2,325007,325009,325011,2,4,0
92863,6,3,325013,325013,325016,0,3,2
92864,1,3,325014,325016,325019,2,5,0
92865,6,1,325020,325020,325021,0,1,1
92866,5,2,325025,325025,325027,0,2,4
92867,1,1,325026,325027,325028,1,2,0
92868,2,2,325028,325028,325030,0,2,0
92869,3,3,325031,325031,325034,0,3,1
92870,3,1,325034,325034,325035,0,1,0
92871,3,3,325037,325037,325040,0,3,2
92872,3,2,325040,325040,325042,0,2,0
92873,1,1,325041,325042,325043,1,2,0
92874,4,3,325045,325045,325048,0,3,2
92875,4,3,325049,325049,325052,0,3,1
92876,5,3,325054,325054,325057,0,3,2
92877,1,2,325055,325057,325059,2,4,0
92878,4,2,325059,325059,325061,0,2,0
92879,4,3,325063,325063,325066,0,3,2
92880,4,3,325067,325067,325070,0,3,1
92881,2,3,325069,325070,325073,1,4,0
92882,3,3,325072,325073,325076,1,4,0
92883,4,1,325076,325076,325077,0,1,0
92884,6,3,325082,325082,325085,0,3,5
92885,1,3,325083,325085,325088,2,5,0
92886,4,2,325087,325088,325090,1,3,0
92887,2,2,325089,325090,325092,1,3,0
92888,3,3,325092,325092,325095,0,3,0
92889,4,1,325096,325096,325097,0,1,1
92890,1,3,325097,325097,325100,0,3,0
92891,5,3,325102,325102,325105,0,3,2
92892,1,2,325103,325105,325107,2,4,0
92893,1,2,325104,325107,325109,3,5,0
92894,4,3,325108,325109,325112,1,4,0
92895,6,1,325114,325114,325115,0,1,2
92896,2,2,325116,325116,325118,0,2,1
92897,4,1,325120,325120,325121,0,1,2
92898,1,3,325121,325121,325124,0,3,0
92899,3,3,325124,325124,325127,0,3,0
92900,1,2,325125,325127,325129,2,4,0
92901,3,3,325128,325129,325132,1,4,0
92902,4,2,325132,325132,325134,0,2,0
92903,5,1,325137,325137,325138,0,1,3
92904,2,1,325139,325139,325140,0,1,1
92905,6,2,325145,325145,325147,0,2,5
92906,1,2,325146,325147,325149,1,3,0
92907,6,3,325152,325152,325155,0,3,3
92908,1,2,325153,325155,325157,2,4,0
92909,4,1,325157,325157,325158,0,1,0
92910,1,1,325158,325158,325159,0,1,0
92911,3,2,325161,325161,325163,0,2,2
92912,4,3,325165,325165,325168,0,3,2
92913,3,2,325168,325168,325170,0,2,0
92914,6,1,325174,325174,325175,0,1,4
92915,2,3,325176,325176,325179,0,3,1
92916,6,1,325182,325182,325183,0,1,3
92917,4,1,325186,325186,325187,0,1,3
92918,6,2,325192,325192,325194,0,2,5
92919,2,1,325194,325194,325195,0,1,0
92920,3,2,325197,325197,325199,0,2,2
92921,2,3,325199,325199,325202,0,3,0
92922,3,3,325202,325202,325205,0,3,0
92923,3,1,325205,325205,325206,0,1,0
92924,5,1,325210,325210,325211,0,1,4
92925,1,2,325211,325211,325213,0,2,0
92926,5,2,325216,325216,325218,0,2,3
92927,1,2,325217,325218,325220,1,3,0
92928,2,1,325219,325220,325221,1,2,0
92929,2,1,325221,325221,325222,0,1,0
92930,3,2,325224,325224,325226,0,2,2
92931,4,3,325228,325228,325231,0,3,2
92932,2,3,325230,325231,325234,1,4,0
92933,2,3,325232,325234,325237,2,5,0
92934,5,2,325237,325237,325239,0,2,0
92935,3,3,325240,325240,325243,0,3,1
92936,5,3,325245,325245,325248,0,3,2
92937,3,2,325248,325248,325250,0,2,0
92938,4,3,325252,325252,325255,0,3,2
92939,4,1,325256,325256,325257,0,1,1
92940,2,3,325258,325258,325261,0,3,1
92941,6,1,325264,325264,325265,0,1,3
92942,3,3,325267,325267,325270,0,3,2
92943,4,2,325271,325271,325273,0,2,1
92944,6,1,325277,325277,325278,0,1,4
92945,4,3,325281,325281,325284,0,3,3
92946,6,3,325287,325287,325290,0,3,3
92947,6,3,325293,325293,325296,0,3,3
92948,4,2,325297,325297,325299,0,2,1
92949,1,2,325298,325299,325301,1,3,0
92950,4,1,325302,325302,325303,0,1,1
92951,5,1,325307,325307,325308,0,1,4
92952,6,3,325313,325313,325316,0,3,5
92953,5,1,325318,325318,325319,0,1,2
92954,5,2,325323,325323,325325,0,2,4
92955,6,1,325329,325329,325330,0,1,4
92956,4,3,325333,325333,325336,0,3,3
92957,4,3,325337,325337,325340,0,3,1
92958,2,2,325339,325340,325342,1,3,0
92959,4,2,325343,325343,325345,0,2,1
92960,1,3,325344,325345,325348,1,4,0
92961,5,3,325349,325349,325352,0,3,1
92962,4,3,325353,325353,325356,0,3,1
92963,6,3,325359,325359,325362,0,3,3
92964,6,1,325365,325365,325366,0,1,3
92965,1,3,325366,325366,325369,0,3,0
92966,6,1,325372,325372,325373,0,1,3
92967,1,2,325373,325373,325375,0,2,0
92968,4,3,325377,325377,325380,0,3,2
92969,4,2,325381,325381,325383,0,2,1
92970,4,2,325385,325385,325387,0,2,2
92971,6,2,325391,325391,325393,0,2,4
92972,4,1,325395,325395,325396,0,1,2
92973,2,3,325397,325397,325400,0,3,1
92974,5,1,325402,325402,325403,0,1,2
92975,4,1,325406,325406,325407,0,1,3
92976,5,2,325411,325411,325413,0,2,4
92977,1,2,325412,325413,325415,1,3,0
92978,5,1,325417,325417,325418,0,1,2
92979,3,2,325420,325420,325422,0,2,2
92980,5,3,325425,325425,325428,0,3,3
92981,3,2,325428,325428,325430,0,2,0
92982,2,2,325430,325430,325432,0,2,0
92983,6,1,325436,325436,325437,0,1,4
92984,6,2,325442,325442,325444,0,2,5
92985,3,1,325445,325445,325446,0,1,1
92986,6,3,325451,325451,325454,0,3,5
92987,5,2,325456,325456,325458,0,2,2
92988,2,3,325458,325458,325461,0,3,0
92989,6,2,325464,325464,325466,0,2,3
92990,1,1,325465,325466,325467,1,2,0
92991,2,2,325467,325467,325469,0,2,0
92992,2,2,325469,325469,325471,0,2,0
92993,6,3,325475,325475,325478,0,3,4
92994,5,1,325480,325480,325481,0,1,2
92995,3,3,325483,325483,325486,0,3,2
92996,1,1,325484,325486,325487,2,3,0
92997,5,3,325489,325489,325492,0,3,2
92998,4,1,325493,325493,325494,0,1,1
92999,5,2,325498,325498,325500,0,2,4
93000,4,2,325502,325502,325504,0,2,2
93001,6,1,325508,325508,325509,0,1,4
93002,5,3,325513,325513,325516,0,3,4
93003,1,2,325514,325516,325518,2,4,0
93004,1,3,325515,325518,325521,3,6,0
93005,3,1,325518,325521,325522,3,4,0
93006,5,1,325523,325523,325524,0,1,1
93007,4,1,325527,325527,325528,0,1,3
93008,4,2,325531,325531,325533,0,2,3
93009,2,2,325533,325533,325535,0,2,0
93010,4,3,325537,325537,325540,0,3,2
93011,5,3,325542,325542,325545,0,3,2
93012,4,3,325546,325546,325549,0,3,1
93013,5,3,325551,325551,325554,0,3,2
93014,4,1,325555,325555,325556,0,1,1
93015,2,3,325557,325557,325560,0,3,1
93016,3,1,325560,325560,325561,0,1,0
93017,1,2,325561,325561,325563,0,2,0
93018,2,1,325563,325563,325564,0,1,0
93019,5,1,325568,325568,325569,0,1,4
93020,5,1,325573,325573,325574,0,1,4
93021,2,3,325575,325575,325578,0,3,1
93022,4,3,325579,325579,325582,0,3,1
93023,5,2,325584,325584,325586,0,2,2
93024,5,1,325589,325589,325590,0,1,3
93025,1,1,325590,325590,325591,0,1,0
93026,2,3,325592,325592,325595,0,3,1
93027,5,1,325597,325597,325598,0,1,2
93028,5,3,325602,325602,325605,0,3,4
93029,5,3,325607,325607,325610,0,3,2
93030,6,1,325613,325613,325614,0,1,3
93031,4,3,325617,325617,325620,0,3,3
93032,5,2,325622,325622,325624,0,2,2
93033,1,1,325623,325624,325625,1,2,0
93034,2,2,325625,325625,325627,0,2,0
93035,3,1,325628,325628,325629,0,1,1
93036,5,1,325633,325633,325634,0,1,4
93037,4,2,325637,325637,325639,0,2,3
93038,3,2,325640,325640,325642,0,2,1
93039,5,1,325645,325645,325646,0,1,3
93040,6,3,325651,325651,325654,0,3,5
93041,5,2,325656,325656,325658,0,2,2
93042,3,2,325659,325659,325661,0,2,1
93043,4,2,325663,325663,325665,0,2,2
93044,1,2,325664,325665,325667,1,3,0
93045,3,3,325667,325667,325670,0,3,0
93046,2,2,325669,325670,325672,1,3,0
93047,5,1,325674,325674,325675,0,1,2
93048,3,3,325677,325677,325680,0,3,2
93049,3,2,325680,325680,325682,0,2,0
93050,1,2,325681,325682,325684,1,3,0
93051,4,1,325685,325685,325686,0,1,1
93052,4,3,325689,325689,325692,0,3,3
93053,4,2,325693,325693,325695,0,2,1
93054,4,1,325697,325697,325698,0,1,2
93055,1,1,325698,325698,325699,0,1,0
93056,5,2,325703,325703,325705,0,2,4
93057,5,2,325708,325708,325710,0,2,3
93058,5,1,325713,325713,325714,0,1,3
93059,2,1,325715,325715,325716,0,1,1
93060,5,2,325720,325720,325722,0,2,4
93061,4,2,325724,325724,325726,0,2,2
93062,3,1,325727,325727,325728,0,1,1
93063,4,1,325731,325731,325732,0,1,3
93064,4,2,325735,325735,325737,0,2,3
93065,1,1,325736,325737,325738,1,2,0
93066,4,2,325740,325740,325742,0,2,2
93067,6,1,325746,325746,325747,0,1,4
93068,4,3,325750,325750,325753,0,3,3
93069,2,2,325752,325753,325755,1,3,0
93070,4,2,325756,325756,325758,0,2,1
93071,2,3,325758,325758,325761,0,3,0
93072,6,2,325764,325764,325766,0,2,3
93073,5,2,325769,325769,325771,0,2,3
93074,3,3,325772,325772,325775,0,3,1
93075,4,3,325776,325776,325779,0,3,1
93076,2,1,325778,325779,325780,1,2,0
93077,4,1,325782,325782,325783,0,1,2
93078,6,2,325788,325788,325790,0,2,5
93079,2,2,325790,325790,325792,0,2,0
93080,3,3,325793,325793,325796,0,3,1
93081,6,3,325799,325799,325802,0,3,3
93082,4,2,325803,325803,325805,0,2,1
93083,1,2,325804,325805,325807,1,3,0
93084,3,1,325807,325807,325808,0,1,0
93085,2,2,325809,325809,325811,0,2,1
93086,2,2,325811,325811,325813,0,2,0
93087,1,2,325812,325813,325815,1,3,0
93088,6,2,325818,325818,325820,0,2,3
93089,2,1,325820,325820,325821,0,1,0
93090,1,3,325821,325821,325824,0,3,0
93091,3,1,325824,325824,325825,0,1,0
93092,3,2,325827,325827,325829,0,2,2
93093,4,1,325831,325831,325832,0,1,2
93094,6,2,325837,325837,325839,0,2,5
93095,3,2,325840,325840,325842,0,2,1
93096,3,2,325843,325843,325845,0,2,1
93097,3,2,325846,325846,325848,0,2,1
93098,5,1,325851,325851,325852,0,1,3
93099,4,3,325855,325855,325858,0,3,3
93100,6,1,325861,325861,325862,0,1,3
93101,6,3,325867,325867,325870,0,3,5
93102,4,3,325871,325871,325874,0,3,1
93103,2,1,325873,325874,325875,1,2,0
93104,6,3,325879,325879,325882,0,3,4
93105,3,1,325882,325882,325883,0,1,0
93106,6,1,325888,325888,325889,0,1,5
93107,1,3,325889,325889,325892,0,3,0
93108,5,1,325894,325894,325895,0,1,2
93109,4,1,325898,325898,325899,0,1,3
93110,2,1,325900,325900,325901,0,1,1
93111,1,1,325901,325901,325902,0,1,0
93112,1,2,325902,325902,325904,0,2,0
93113,5,1,325907,325907,325908,0,1,3
93114,1,1,325908,325908,325909,0,1,0
93115,5,1,325913,325913,325914,0,1,4
93116,2,3,325915,325915,325918,0,3,1
93117,4,3,325919,325919,325922,0,3,1
93118,1,3,325920,325922,325925,2,5,0
93119,2,3,325922,325925,325928,3,6,0
93120,2,3,325924,325928,325931,4,7,0
93121,3,3,325927,325931,325934,4,7,0
93122,6,1,325933,325934,325935,1,2,0
93123,4,3,325937,325937,325940,0,3,2
93124,4,3,325941,325941,325944,0,3,1
93125,2,3,325943,325944,325947,1,4,0
93126,1,1,325944,325947,325948,3,4,0
93127,2,3,325946,325948,325951,2,5,0
93128,5,3,325951,325951,325954,0,3,0
93129,1,1,325952,325954,325955,2,3,0
93130,3,1,325955,325955,325956,0,1,0
93131,2,3,325957,325957,325960,0,3,1
93132,3,2,325960,325960,325962,0,2,0
93133,6,3,325966,325966,325969,0,3,4
93134,2,1,325968,325969,325970,1,2,0
93135,6,3,325974,325974,325977,0,3,4
93136,6,1,325980,325980,325981,0,1,3
93137,4,2,325984,325984,325986,0,2,3
93138,2,1,325986,325986,325987,0,1,0
93139,6,2,325992,325992,325994,0,2,5
93140,5,1,325997,325997,325998,0,1,3
93141,6,1,326003,326003,326004,0,1,5
93142,3,1,326006,326006,326007,0,1,2
93143,5,3,326011,326011,326014,0,3,4
93144,3,1,326014,326014,326015,0,1,0
93145,4,3,326018,326018,326021,0,3,3
93146,4,2,326022,326022,326024,0,2,1
93147,2,2,326024,326024,326026,0,2,0
93148,1,1,326025,326026,326027,1,2,0
93149,6,3,326031,326031,326034,0,3,4
93150,2,2,326033,326034,326036,1,3,0
93151,5,1,326038,326038,326039,0,1,2
93152,6,1,326044,326044,326045,0,1,5
93153,3,3,326047,326047,326050,0,3,2
93154,6,1,326053,326053,326054,0,1,3
93155,2,3,326055,326055,326058,0,3,1
93156,4,3,326059,326059,326062,0,3,1
93157,6,1,326065,326065,326066,0,1,3
93158,4,1,326069,326069,326070,0,1,3
93159,4,2,326073,326073,326075,0,2,3
93160,5,1,326078,326078,326079,0,1,3
93161,6,2,326084,326084,326086,0,2,5
93162,5,2,326089,326089,326091,0,2,3
93163,5,2,326094,326094,326096,0,2,3
93164,3,1,326097,326097,326098,0,1,1
93165,6,3,326103,326103,326106,0,3,5
93166,1,1,326104,326106,326107,2,3,0
93167,6,3,326110,326110,326113,0,3,3
93168,4,3,326114,326114,326117,0,3,1
93169,3,1,326117,326117,326118,0,1,0
93170,3,2,326120,326120,326122,0,2,2
93171,4,2,326124,326124,326126,0,2,2
93172,2,1,326126,326126,326127,0,1,0
93173,1,2,326127,326127,326129,0,2,0
93174,3,3,326130,326130,326133,0,3,1
93175,4,3,326134,326134,326137,0,3,1
93176,2,3,326136,326137,326140,1,4,0
93177,4,3,326140,326140,326143,0,3,0
93178,3,3,326143,326143,326146,0,3,0
93179,2,2,326145,326146,326148,1,3,0
93180,1,3,326146,326148,326151,2,5,0
93181,2,3,326148,326151,326154,3,6,0
93182,6,1,326154,326154,326155,0,1,0
93183,4,3,326158,326158,326161,0,3,3
93184,5,3,326163,326163,326166,0,3,2
93185,5,2,326168,326168,326170,0,2,2
93186,1,1,326169,326170,326171,1,2,0
93187,3,1,326172,326172,326173,0,1,1
93188,4,1,326176,326176,326177,0,1,3
93189,2,3,326178,326178,326181,0,3,1
93190,5,3,326183,326183,326186,0,3,2
93191,6,3,326189,326189,326192,0,3,3
93192,4,2,326193,326193,326195,0,2,1
93193,5,1,326198,326198,326199,0,1,3
93194,2,3,326200,326200,326203,0,3,1
93195,1,2,326201,326203,326205,2,4,0
93196,4,1,326205,326205,326206,0,1,0
93197,6,1,326211,326211,326212,0,1,5
93198,5,1,326216,326216,326217,0,1,4
93199,2,3,326218,326218,326221,0,3,1
93200,5,2,326223,326223,326225,0,2,2
93201,2,2,326225,326225,326227,0,2,0
93202,2,1,326227,326227,326228,0,1,0
93203,2,3,326229,326229,326232,0,3,1
93204,6,3,326235,326235,326238,0,3,3
93205,4,2,326239,326239,326241,0,2,1
93206,6,1,326245,326245,326246,0,1,4
93207,1,1,326246,326246,326247,0,1,0
93208,2,1,326248,326248,326249,0,1,1
93209,3,1,326251,326251,326252,0,1,2
93210,6,2,326257,326257,326259,0,2,5
93211,6,1,326263,326263,326264,0,1,4
93212,4,1,326267,326267,326268,0,1,3
93213,1,1,326268,326268,326269,0,1,0
93214,6,3,326274,326274,326277,0,3,5
93215,1,2,326275,326277,326279,2,4,0
93216,4,1,326279,326279,326280,0,1,0
93217,1,1,326280,326280,326281,0,1,0
93218,3,3,326283,326283,326286,0,3,2
93219,3,3,326286,326286,326289,0,3,0
93220,6,2,326292,326292,326294,0,2,3
93221,1,1,326293,326294,326295,1,2,0
93222,1,3,326294,326295,326298,1,4,0
93223,2,2,326296,326298,326300,2,4,0
93224,4,1,326300,326300,326301,0,1,0
93225,1,1,326301,326301,326302,0,1,0
93226,2,1,326303,326303,326304,0,1,1
93227,4,2,326307,326307,326309,0,2,3
93228,2,2,326309,326309,326311,0,2,0
93229,5,3,326314,326314,326317,0,3,3
93230,5,3,326319,326319,326322,0,3,2
93231,2,2,326321,326322,326324,1,3,0
93232,2,2,326323,326324,326326,1,3,0
93233,3,2,326326,326326,326328,0,2,0
93234,2,3,326328,326328,326331,0,3,0
93235,3,1,326331,326331,326332,0,1,0
93236,4,2,326335,326335,326337,0,2,3
93237,1,3,326336,326337,326340,1,4,0
93238,2,1,326338,326340,326341,2,3,0
93239,1,1,326339,326341,326342,2,3,0
93240,3,2,326342,326342,326344,0,2,0
93241,5,1,326347,326347,326348,0,1,3
93242,3,1,326350,326350,326351,0,1,2
93243,2,2,326352,326352,326354,0,2,1
93244,2,2,326354,326354,326356,0,2,0
93245,3,1,326357,326357,326358,0,1,1
93246,6,3,326363,326363,326366,0,3,5
93247,3,3,326366,326366,326369,0,3,0
93248,4,3,326370,326370,326373,0,3,1
93249,4,1,326374,326374,326375,0,1,1
93250,2,3,326376,326376,326379,0,3,1
93251,5,3,326381,326381,326384,0,3,2
93252,6,3,326387,326387,326390,0,3,3
93253,3,3,326390,326390,326393,0,3,0
93254,5,2,326395,326395,326397,0,2,2
93255,5,1,326400,326400,326401,0,1,3
93256,3,1,326403,326403,326404,0,1,2
93257,3,2,326406,326406,326408,0,2,2
93258,5,3,326411,326411,326414,0,3,3
93259,5,2,326416,326416,326418,0,2,2
93260,5,1,326421,326421,326422,0,1,3
93261,5,1,326426,326426,326427,0,1,4
93262,2,3,326428,326428,326431,0,3,1
93263,4,2,326432,326432,326434,0,2,1
93264,1,3,326433,326434,326437,1,4,0
93265,6,2,326439,326439,326441,0,2,2
93266,6,2,326445,326445,326447,0,2,4
93267,1,3,326446,326447,326450,1,4,0
93268,5,1,326451,326451,326452,0,1,1
93269,2,1,326453,326453,326454,0,1,1
93270,5,2,326458,326458,326460,0,2,4
93271,3,2,326461,326461,326463,0,2,1
93272,3,1,326464,326464,326465,0,1,1
93273,6,3,326470,326470,326473,0,3,5
93274,4,1,326474,326474,326475,0,1,1
93275,5,2,326479,326479,326481,0,2,4
93276,6,2,326485,326485,326487,0,2,4
93277,1,2,326486,326487,326489,1,3,0
93278,6,1,326492,326492,326493,0,1,3
93279,3,3,326495,326495,326498,0,3,2
93280,4,3,326499,326499,326502,0,3,1
93281,5,3,326504,326504,326507,0,3,2
93282,6,1,326510,326510,326511,0,1,3
93283,1,1,326511,326511,326512,0,1,0
93284,3,3,326514,326514,326517,0,3,2
93285,6,3,326520,326520,326523,0,3,3
93286,5,2,326525,326525,326527,0,2,2
93287,6,1,326531,326531,326532,0,1,4
93288,1,1,326532,326532,326533,0,1,0
93289,6,2,326538,326538,326540,0,2,5
93290,1,3,326539,326540,326543,1,4,0
93291,4,3,326543,326543,326546,0,3,0
93292,6,1,326549,326549,326550,0,1,3
93293,2,3,326551,326551,326554,0,3,1
93294,6,2,326557,326557,326559,0,2,3
93295,3,1,326560,326560,326561,0,1,1
93296,4,2,326564,326564,326566,0,2,3
93297,4,3,326568,326568,326571,0,3,2
93298,1,1,326569,326571,326572,2,3,0
93299,5,3,326574,326574,326577,0,3,2
93300,2,2,326576,326577,326579,1,3,0
93301,5,1,326581,326581,326582,0,1,2
93302,2,1,326583,326583,326584,0,1,1
93303,2,3,326585,326585,326588,0,3,1
93304,6,3,326591,326591,326594,0,3,3
93305,3,3,326594,326594,326597,0,3,0
93306,4,2,326598,326598,326600,0,2,1
93307,6,1,326604,326604,326605,0,1,4
93308,1,2,326605,326605,326607,0,2,0
93309,6,3,326611,326611,326614,0,3,4
93310,5,1,326616,326616,326617,0,1,2
93311,4,2,326620,326620,326622,0,2,3
93312,5,2,326625,326625,326627,0,2,3
93313,4,3,326629,326629,326632,0,3,2
93314,6,3,326635,326635,326638,0,3,3
93315,6,1,326641,326641,326642,0,1,3
93316,5,1,326646,326646,326647,0,1,4
93317,1,3,326647,326647,326650,0,3,0
93318,6,2,326653,326653,326655,0,2,3
93319,4,3,326657,326657,326660,0,3,2
93320,5,1,326662,326662,326663,0,1,2
93321,5,1,326667,326667,326668,0,1,4
93322,4,2,326671,326671,326673,0,2,3
93323,6,3,326677,326677,326680,0,3,4
93324,1,1,326678,326680,326681,2,3,0
93325,5,2,326683,326683,326685,0,2,2
93326,2,3,326685,326685,326688,0,3,0
93327,5,1,326690,326690,326691,0,1,2
93328,6,1,326696,326696,326697,0,1,5
93329,3,2,326699,326699,326701,0,2,2
93330,4,2,326703,326703,326705,0,2,2
93331,3,1,326706,326706,326707,0,1,1
93332,2,1,326708,326708,326709,0,1,1
93333,6,1,326714,326714,326715,0,1,5
93334,4,1,326718,326718,326719,0,1,3
93335,2,3,326720,326720,326723,0,3,1
93336,5,3,326725,326725,326728,0,3,2
93337,4,2,326729,326729,326731,0,2,1
93338,5,1,326734,326734,326735,0,1,3
93339,3,1,326737,326737,326738,0,1,2
93340,1,1,326738,326738,326739,0,1,0
93341,4,1,326742,326742,326743,0,1,3
93342,1,1,326743,326743,326744,0,1,0
93343,1,3,326744,326744,326747,0,3,0
93344,4,1,326748,326748,326749,0,1,1
93345,2,2,326750,326750,326752,0,2,1
93346,2,1,326752,326752,326753,0,1,0
93347,4,1,326756,326756,326757,0,1,3
93348,6,3,326762,326762,326765,0,3,5
93349,4,3,326766,326766,326769,0,3,1
93350,2,3,326768,326769,326772,1,4,0
93351,5,2,326773,326773,326775,0,2,1
93352,5,1,326778,326778,326779,0,1,3
93353,5,3,326783,326783,326786,0,3,4
93354,2,2,326785,326786,326788,1,3,0
93355,4,3,326789,326789,326792,0,3,1
93356,3,2,326792,326792,326794,0,2,0
93357,4,2,326796,326796,326798,0,2,2
93358,3,2,326799,326799,326801,0,2,1
93359,5,1,326804,326804,326805,0,1,3
93360,3,2,326807,326807,326809,0,2,2
93361,3,2,326810,326810,326812,0,2,1
93362,5,3,326815,326815,326818,0,3,3
93363,3,2,326818,326818,326820,0,2,0
93364,2,2,326820,326820,326822,0,2,0
93365,1,2,326821,326822,326824,1,3,0
93366,3,1,326824,326824,326825,0,1,0
93367,6,2,326830,326830,326832,0,2,5
93368,3,2,326833,326833,326835,0,2,1
93369,4,3,326837,326837,326840,0,3,2
93370,4,2,326841,326841,326843,0,2,1
93371,3,1,326844,326844,326845,0,1,1
93372,1,3,326845,326845,326848,0,3,0
93373,6,2,326851,326851,326853,0,2,3
93374,2,2,326853,326853,326855,0,2,0
93375,1,1,326854,326855,326856,1,2,0
93376,5,1,326859,326859,326860,0,1,3
93377,1,1,326860,326860,326861,0,1,0
93378,5,2,326865,326865,326867,0,2,4
93379,2,2,326867,326867,326869,0,2,0
93380,5,1,326872,326872,326873,0,1,3
93381,6,3,326878,326878,326881,0,3,5
93382,5,1,326883,326883,326884,0,1,2
93383,5,1,326888,326888,326889,0,1,4
93384,3,3,326891,326891,326894,0,3,2
93385,3,3,326894,326894,326897,0,3,0
93386,2,2,326896,326897,326899,1,3,0
93387,3,1,326899,326899,326900,0,1,0
93388,6,2,326905,326905,326907,0,2,5
93389,4,3,326909,326909,326912,0,3,2
93390,2,3,326911,326912,326915,1,4,0
93391,4,3,326915,326915,326918,0,3,0
93392,3,2,326918,326918,326920,0,2,0
93393,4,1,326922,326922,326923,0,1,2
93394,1,1,326923,326923,326924,0,1,0
93395,6,3,326929,326929,326932,0,3,5
93396,4,2,326933,326933,326935,0,2,1
93397,1,3,326934,326935,326938,1,4,0
93398,5,2,326939,326939,326941,0,2,1
93399,4,1,326943,326943,326944,0,1,2
93400,3,1,326946,326946,326947,0,1,2
93401,4,3,326950,326950,326953,0,3,3
93402,2,2,326952,326953,326955,1,3,0
93403,2,1,326954,326955,326956,1,2,0
93404,5,3,326959,326959,326962,0,3,3
93405,6,3,326965,326965,326968,0,3,3
93406,1,2,326966,326968,326970,2,4,0
93407,1,2,326967,326970,326972,3,5,0
93408,2,2,326969,326972,326974,3,5,0
93409,3,3,326972,326974,326977,2,5,0
93410,2,3,326974,326977,326980,3,6,0
93411,6,1,326980,326980,326981,0,1,0
93412,1,1,326981,326981,326982,0,1,0
93413,4,2,326985,326985,326987,0,2,3
93414,1,1,326986,326987,326988,1,2,0
93415,3,3,326989,326989,326992,0,3,1
93416,5,1,326994,326994,326995,0,1,2
93417,4,1,326998,326998,326999,0,1,3
93418,3,3,327001,327001,327004,0,3,2
93419,1,2,327002,327004,327006,2,4,0
93420,3,1,327005,327006,327007,1,2,0
93421,3,2,327008,327008,327010,0,2,1
93422,6,3,327014,327014,327017,0,3,4
93423,2,1,327016,327017,327018,1,2,0
93424,4,3,327020,327020,327023,0,3,2
93425,4,2,327024,327024,327026,0,2,1
93426,4,1,327028,327028,327029,0,1,2
93427,6,2,327034,327034,327036,0,2,5
93428,6,2,327040,327040,327042,0,2,4
93429,5,3,327045,327045,327048,0,3,3
93430,4,2,327049,327049,327051,0,2,1
93431,3,3,327052,327052,327055,0,3,1
93432,2,1,327054,327055,327056,1,2,0
93433,2,1,327056,327056,327057,0,1,0
93434,5,2,327061,327061,327063,0,2,4
93435,4,2,327065,327065,327067,0,2,2
93436,2,2,327067,327067,327069,0,2,0
93437,3,2,327070,327070,327072,0,2,1
93438,3,2,327073,327073,327075,0,2,1
93439,6,2,327079,327079,327081,0,2,4
93440,4,2,327083,327083,327085,0,2,2
93441,1,3,327084,327085,327088,1,4,0
93442,3,1,327087,327088,327089,1,2,0
93443,4,1,327091,327091,327092,0,1,2
93444,1,2,327092,327092,327094,0,2,0
93445,2,2,327094,327094,327096,0,2,0
93446,3,3,327097,327097,327100,0,3,1
93447,4,1,327101,327101,327102,0,1,1
93448,3,2,327104,327104,327106,0,2,2
93449,2,2,327106,327106,327108,0,2,0
93450,3,1,327109,327109,327110,0,1,1
93451,1,3,327110,327110,327113,0,3,0
93452,1,2,327111,327113,327115,2,4,0
93453,1,3,327112,327115,327118,3,6,0
93454,6,3,327118,327118,327121,0,3,0
93455,5,3,327123,327123,327126,0,3,2
93456,2,2,327125,327126,327128,1,3,0
93457,1,2,327126,327128,327130,2,4,0
93458,6,1,327132,327132,327133,0,1,2
93459,3,1,327135,327135,327136,0,1,2
93460,1,2,327136,327136,327138,0,2,0
93461,2,3,327138,327138,327141,0,3,0
93462,1,3,327139,327141,327144,2,5,0
93463,5,3,327144,327144,327147,0,3,0
93464,3,1,327147,327147,327148,0,1,0
93465,4,2,327151,327151,327153,0,2,3
93466,3,2,327154,327154,327156,0,2,1
93467,1,3,327155,327156,327159,1,4,0
93468,1,3,327156,327159,327162,3,6,0
93469,4,3,327160,327162,327165,2,5,0
93470,6,2,327166,327166,327168,0,2,1
93471,6,3,327172,327172,327175,0,3,4
93472,2,1,327174,327175,327176,1,2,0
93473,3,3,327177,327177,327180,0,3,1
93474,3,1,327180,327180,327181,0,1,0
93475,6,1,327186,327186,327187,0,1,5
93476,5,1,327191,327191,327192,0,1,4
93477,4,2,327195,327195,327197,0,2,3
93478,1,2,327196,327197,327199,1,3,0
93479,1,3,327197,327199,327202,2,5,0
93480,4,1,327201,327202,327203,1,2,0
93481,2,2,327203,327203,327205,0,2,0
93482,2,3,327205,327205,327208,0,3,0
93483,5,1,327210,327210,327211,0,1,2
93484,2,3,327212,327212,327215,0,3,1
93485,4,1,327216,327216,327217,0,1,1
93486,1,2,327217,327217,327219,0,2,0
93487,6,1,327223,327223,327224,0,1,4
93488,2,1,327225,327225,327226,0,1,1
93489,1,1,327226,327226,327227,0,1,0
93490,4,2,327230,327230,327232,0,2,3
93491,2,3,327232,327232,327235,0,3,0
93492,2,1,327234,327235,327236,1,2,0
93493,2,2,327236,327236,327238,0,2,0
93494,2,3,327238,327238,327241,0,3,0
93495,3,1,327241,327241,327242,0,1,0
93496,6,1,327247,327247,327248,0,1,5
93497,1,1,327248,327248,327249,0,1,0
93498,2,2,327250,327250,327252,0,2,1
93499,2,3,327252,327252,327255,0,3,0
93500,5,3,327257,327257,327260,0,3,2
93501,3,1,327260,327260,327261,0,1,0
93502,4,1,327264,327264,327265,0,1,3
93503,6,1,327270,327270,327271,0,1,5
93504,6,2,327276,327276,327278,0,2,5
93505,1,1,327277,327278,327279,1,2,0
93506,5,3,327282,327282,327285,0,3,3
93507,2,2,327284,327285,327287,1,3,0
93508,1,2,327285,327287,327289,2,4,0
93509,5,2,327290,327290,327292,0,2,1
93510,6,3,327296,327296,327299,0,3,4
93511,6,3,327302,327302,327305,0,3,3
93512,3,2,327305,327305,327307,0,2,0
93513,5,1,327310,327310,327311,0,1,3
93514,5,2,327315,327315,327317,0,2,4
93515,1,1,327316,327317,327318,1,2,0
93516,1,3,327317,327318,327321,1,4,0
93517,4,3,327321,327321,327324,0,3,0
93518,4,1,327325,327325,327326,0,1,1
93519,2,3,327327,327327,327330,0,3,1
93520,4,1,327331,327331,327332,0,1,1
93521,4,3,327335,327335,327338,0,3,3
93522,1,2,327336,327338,327340,2,4,0
93523,2,2,327338,327340,327342,2,4,0
93524,4,1,327342,327342,327343,0,1,0
93525,3,1,327345,327345,327346,0,1,2
93526,4,1,327349,327349,327350,0,1,3
93527,1,1,327350,327350,327351,0,1,0
93528,4,3,327354,327354,327357,0,3,3
93529,2,1,327356,327357,327358,1,2,0
93530,6,3,327362,327362,327365,0,3,4
93531,1,2,327363,327365,327367,2,4,0
93532,3,1,327366,327367,327368,1,2,0
93533,3,3,327369,327369,327372,0,3,1
93534,6,1,327375,327375,327376,0,1,3
93535,2,3,327377,327377,327380,0,3,1
93536,1,3,327378,327380,327383,2,5,0
93537,1,1,327379,327383,327384,4,5,0
93538,4,2,327383,327384,327386,1,3,0
93539,1,3,327384,327386,327389,2,5,0
93540,2,1,327386,327389,327390,3,4,0
93541,5,3,327391,327391,327394,0,3,1
93542,6,2,327397,327397,327399,0,2,3
93543,2,3,327399,327399,327402,0,3,0
93544,1,1,327400,327402,327403,2,3,0
93545,5,1,327405,327405,327406,0,1,2
93546,3,1,327408,327408,327409,0,1,2
93547,3,1,327411,327411,327412,0,1,2
93548,6,3,327417,327417,327420,0,3,5
93549,1,3,327418,327420,327423,2,5,0
93550,6,3,327424,327424,327427,0,3,1
93551,4,1,327428,327428,327429,0,1,1
93552,5,3,327433,327433,327436,0,3,4
93553,6,3,327439,327439,327442,0,3,3
93554,3,3,327442,327442,327445,0,3,0
93555,4,2,327446,327446,327448,0,2,1
93556,2,2,327448,327448,327450,0,2,0
93557,1,2,327449,327450,327452,1,3,0
93558,2,1,327451,327452,327453,1,2,0
93559,5,1,327456,327456,327457,0,1,3
93560,4,3,327460,327460,327463,0,3,3
93561,6,3,327466,327466,327469,0,3,3
93562,6,3,327472,327472,327475,0,3,3
93563,3,2,327475,327475,327477,0,2,0
93564,5,3,327480,327480,327483,0,3,3
93565,4,1,327484,327484,327485,0,1,1
93566,4,3,327488,327488,327491,0,3,3
93567,2,2,327490,327491,327493,1,3,0
93568,2,3,327492,327493,327496,1,4,0
93569,3,2,327495,327496,327498,1,3,0
93570,3,3,327498,327498,327501,0,3,0
93571,6,2,327504,327504,327506,0,2,3
93572,1,2,327505,327506,327508,1,3,0
93573,4,2,327509,327509,327511,0,2,1
93574,6,1,327515,327515,327516,0,1,4
93575,4,3,327519,327519,327522,0,3,3
93576,6,3,327525,327525,327528,0,3,3
93577,6,2,327531,327531,327533,0,2,3
93578,6,3,327537,327537,327540,0,3,4
93579,5,3,327542,327542,327545,0,3,2
93580,6,3,327548,327548,327551,0,3,3
93581,2,3,327550,327551,327554,1,4,0
93582,6,1,327556,327556,327557,0,1,2
93583,4,2,327560,327560,327562,0,2,3
93584,1,2,327561,327562,327564,1,3,0
93585,3,3,327564,327564,327567,0,3,0
93586,3,3,327567,327567,327570,0,3,0
93587,4,2,327571,327571,327573,0,2,1
93588,5,2,327576,327576,327578,0,2,3
93589,2,3,327578,327578,327581,0,3,0
93590,4,2,327582,327582,327584,0,2,1
93591,4,1,327586,327586,327587,0,1,2
93592,3,1,327589,327589,327590,0,1,2
93593,6,1,327595,327595,327596,0,1,5
93594,6,3,327601,327601,327604,0,3,5
93595,2,2,327603,327604,327606,1,3,0
93596,2,3,327605,327606,327609,1,4,0
93597,4,2,327609,327609,327611,0,2,0
93598,3,3,327612,327612,327615,0,3,1
93599,6,1,327618,327618,327619,0,1,3
93600,4,2,327622,327622,327624,0,2,3
93601,2,1,327624,327624,327625,0,1,0
93602,2,2,327626,327626,327628,0,2,1
93603,4,2,327630,327630,327632,0,2,2
93604,3,1,327633,327633,327634,0,1,1
93605,4,3,327637,327637,327640,0,3,3
93606,3,1,327640,327640,327641,0,1,0
93607,1,3,327641,327641,327644,0,3,0
93608,4,2,327645,327645,327647,0,2,1
93609,1,1,327646,327647,327648,1,2,0
93610,1,3,327647,327648,327651,1,4,0
93611,4,1,327651,327651,327652,0,1,0
93612,1,1,327652,327652,327653,0,1,0
93613,6,2,327658,327658,327660,0,2,5
93614,3,3,327661,327661,327664,0,3,1
93615,4,2,327665,327665,327667,0,2,1
93616,1,3,327666,327667,327670,1,4,0
93617,4,2,327670,327670,327672,0,2,0
93618,4,3,327674,327674,327677,0,3,2
93619,4,3,327678,327678,327681,0,3,1
93620,3,3,327681,327681,327684,0,3,0
93621,4,1,327685,327685,327686,0,1,1
93622,6,3,327691,327691,327694,0,3,5
93623,3,3,327694,327694,327697,0,3,0
93624,3,1,327697,327697,327698,0,1,0
93625,3,1,327700,327700,327701,0,1,2
93626,4,3,327704,327704,327707,0,3,3
93627,3,1,327707,327707,327708,0,1,0
93628,2,2,327709,327709,327711,0,2,1
93629,1,2,327710,327711,327713,1,3,0
93630,3,3,327713,327713,327716,0,3,0
93631,3,2,327716,327716,327718,0,2,0
93632,4,1,327720,327720,327721,0,1,2
93633,4,3,327724,327724,327727,0,3,3
93634,1,2,327725,327727,327729,2,4,0
93635,4,2,327729,327729,327731,0,2,0
93636,1,3,327730,327731,327734,1,4,0
93637,6,1,327736,327736,327737,0,1,2
93638,1,2,327737,327737,327739,0,2,0
93639,5,2,327742,327742,327744,0,2,3
93640,1,1,327743,327744,327745,1,2,0
93641,6,1,327749,327749,327750,0,1,4
93642,2,3,327751,327751,327754,0,3,1
93643,5,2,327756,327756,327758,0,2,2
93644,3,2,327759,327759,327761,0,2,1
93645,5,3,327764,327764,327767,0,3,3
93646,2,1,327766,327767,327768,1,2,0
93647,4,2,327770,327770,327772,0,2,2
93648,2,2,327772,327772,327774,0,2,0
93649,1,2,327773,327774,327776,1,3,0
93650,2,3,327775,327776,327779,1,4,0
93651,3,3,327778,327779,327782,1,4,0
93652,4,3,327782,327782,327785,0,3,0
93653,5,1,327787,327787,327788,0,1,2
93654,1,2,327788,327788,327790,0,2,0
93655,2,3,327790,327790,327793,0,3,0
93656,4,1,327794,327794,327795,0,1,1
93657,1,3,327795,327795,327798,0,3,0
93658,4,2,327799,327799,327801,0,2,1
93659,2,1,327801,327801,327802,0,1,0
93660,1,1,327802,327802,327803,0,1,0
93661,6,1,327808,327808,327809,0,1,5
93662,3,3,327811,327811,327814,0,3,2
93663,2,1,327813,327814,327815,1,2,0
93664,1,3,327814,327815,327818,1,4,0
93665,1,3,327815,327818,327821,3,6,0
93666,5,1,327820,327821,327822,1,2,0
93667,3,3,327823,327823,327826,0,3,1
93668,6,2,327829,327829,327831,0,2,3
93669,2,3,327831,327831,327834,0,3,0
93670,4,1,327835,327835,327836,0,1,1
93671,5,2,327840,327840,327842,0,2,4
93672,6,1,327846,327846,327847,0,1,4
93673,5,3,327851,327851,327854,0,3,4
93674,1,3,327852,327854,327857,2,5,0
93675,4,1,327856,327857,327858,1,2,0
93676,4,1,327860,327860,327861,0,1,2
93677,3,1,327863,327863,327864,0,1,2
93678,2,3,327865,327865,327868,0,3,1
93679,3,2,327868,327868,327870,0,2,0
93680,1,1,327869,327870,327871,1,2,0
93681,1,3,327870,327871,327874,1,4,0
93682,4,2,327874,327874,327876,0,2,0
93683,2,3,327876,327876,327879,0,3,0
93684,6,2,327882,327882,327884,0,2,3
93685,2,2,327884,327884,327886,0,2,0
93686,5,3,327889,327889,327892,0,3,3
93687,5,1,327894,327894,327895,0,1,2
93688,1,2,327895,327895,327897,0,2,0
93689,2,1,327897,327897,327898,0,1,0
93690,3,3,327900,327900,327903,0,3,2
93691,1,3,327901,327903,327906,2,5,0
93692,3,1,327904,327906,327907,2,3,0
93693,1,3,327905,327907,327910,2,5,0
93694,4,3,327909,327910,327913,1,4,0
93695,5,1,327914,327914,327915,0,1,1
93696,3,1,327917,327917,327918,0,1,2
93697,1,1,327918,327918,327919,0,1,0
93698,6,1,327924,327924,327925,0,1,5
93699,1,1,327925,327925,327926,0,1,0
93700,2,1,327927,327927,327928,0,1,1
93701,4,2,327931,327931,327933,0,2,3
93702,1,2,327932,327933,327935,1,3,0
93703,4,3,327936,327936,327939,0,3,1
93704,3,3,327939,327939,327942,0,3,0
93705,3,1,327942,327942,327943,0,1,0
93706,6,1,327948,327948,327949,0,1,5
93707,1,3,327949,327949,327952,0,3,0
93708,2,3,327951,327952,327955,1,4,0
93709,3,3,327954,327955,327958,1,4,0
93710,6,2,327960,327960,327962,0,2,2
93711,4,1,327964,327964,327965,0,1,2
93712,2,3,327966,327966,327969,0,3,1
93713,5,1,327971,327971,327972,0,1,2
93714,3,1,327974,327974,327975,0,1,2
93715,2,2,327976,327976,327978,0,2,1
93716,3,1,327979,327979,327980,0,1,1
93717,5,1,327984,327984,327985,0,1,4
93718,3,3,327987,327987,327990,0,3,2
93719,4,2,327991,327991,327993,0,2,1
93720,4,1,327995,327995,327996,0,1,2
93721,1,3,327996,327996,327999,0,3,0
93722,6,2,328002,328002,328004,0,2,3
93723,6,1,328008,328008,328009,0,1,4
93724,4,1,328012,328012,328013,0,1,3
93725,6,1,328018,328018,328019,0,1,5
93726,6,3,328024,328024,328027,0,3,5
93727,2,3,328026,328027,328030,1,4,0
93728,3,1,328029,328030,328031,1,2,0
93729,6,3,328035,328035,328038,0,3,4
93730,5,3,328040,328040,328043,0,3,2
93731,2,2,328042,328043,328045,1,3,0
93732,6,3,328048,328048,328051,0,3,3
93733,1,2,328049,328051,328053,2,4,0
93734,5,3,328054,328054,328057,0,3,1
93735,1,1,328055,328057,328058,2,3,0
93736,5,3,328060,328060,328063,0,3,2
93737,3,1,328063,328063,328064,0,1,0
93738,4,3,328067,328067,328070,0,3,3
93739,4,3,328071,328071,328074,0,3,1
93740,6,2,328077,328077,328079,0,2,3
93741,2,2,328079,328079,328081,0,2,0
93742,3,3,328082,328082,328085,0,3,1
93743,5,1,328087,328087,328088,0,1,2
93744,6,2,328093,328093,328095,0,2,5
93745,6,3,328099,328099,328102,0,3,4
93746,4,2,328103,328103,328105,0,2,1
93747,1,1,328104,328105,328106,1,2,0
93748,2,2,328106,328106,328108,0,2,0
93749,1,3,328107,328108,328111,1,4,0
93750,3,2,328110,328111,328113,1,3,0
93751,1,2,328111,328113,328115,2,4,0
93752,3,2,328114,328115,328117,1,3,0
93753,3,2,328117,328117,328119,0,2,0
93754,3,3,328120,328120,328123,0,3,1
93755,2,1,328122,328123,328124,1,2,0
93756,1,3,328123,328124,328127,1,4,0
93757,4,3,328127,328127,328130,0,3,0
93758,5,1,328132,328132,328133,0,1,2
93759,3,2,328135,328135,328137,0,2,2
93760,6,3,328141,328141,328144,0,3,4
93761,3,1,328144,328144,328145,0,1,0
93762,5,1,328149,328149,328150,0,1,4
93763,4,3,328153,328153,328156,0,3,3
93764,1,1,328154,328156,328157,2,3,0
93765,1,3,328155,328157,328160,2,5,0
93766,3,1,328158,328160,328161,2,3,0
93767,5,1,328163,328163,328164,0,1,2
93768,4,3,328167,328167,328170,0,3,3
93769,3,3,328170,328170,328173,0,3,0
93770,1,1,328171,328173,328174,2,3,0
93771,2,2,328173,328174,328176,1,3,0
93772,5,2,328178,328178,328180,0,2,2
93773,3,2,328181,328181,328183,0,2,1
93774,5,2,328186,328186,328188,0,2,3
93775,3,2,328189,328189,328191,0,2,1
93776,1,1,328190,328191,328192,1,2,0
93777,6,1,328196,328196,328197,0,1,4
93778,5,3,328201,328201,328204,0,3,4
93779,1,1,328202,328204,328205,2,3,0
93780,4,3,328206,328206,328209,0,3,1
93781,5,1,328211,328211,328212,0,1,2
93782,4,3,328215,328215,328218,0,3,3
93783,5,3,328220,328220,328223,0,3,2
93784,6,2,328226,328226,328228,0,2,3
93785,3,2,328229,328229,328231,0,2,1
93786,4,2,328233,328233,328235,0,2,2
93787,3,1,328236,328236,328237,0,1,1
93788,2,2,328238,328238,328240,0,2,1
93789,3,3,328241,328241,328244,0,3,1
93790,4,1,328245,328245,328246,0,1,1
93791,1,1,328246,328246,328247,0,1,0
93792,3,1,328249,328249,328250,0,1,2
93793,3,2,328252,328252,328254,0,2,2
93794,2,3,328254,328254,328257,0,3,0
93795,3,1,328257,328257,328258,0,1,0
93796,4,1,328261,328261,328262,0,1,3
93797,2,3,328263,328263,328266,0,3,1
93798,6,2,328269,328269,328271,0,2,3
93799,3,1,328272,328272,328273,0,1,1
93800,5,3,328277,328277,328280,0,3,4
93801,5,1,328282,328282,328283,0,1,2
93802,4,3,328286,328286,328289,0,3,3
93803,3,2,328289,328289,328291,0,2,0
93804,3,3,328292,328292,328295,0,3,1
93805,2,2,328294,328295,328297,1,3,0
93806,1,1,328295,328297,328298,2,3,0
93807,4,3,328299,328299,328302,0,3,1
93808,6,1,328305,328305,328306,0,1,3
93809,6,2,328311,328311,328313,0,2,5
93810,3,1,328314,328314,328315,0,1,1
93811,1,3,328315,328315,328318,0,3,0
93812,6,3,328321,328321,328324,0,3,3
93813,6,3,328327,328327,328330,0,3,3
93814,1,2,328328,328330,328332,2,4,0
93815,2,3,328330,328332,328335,2,5,0
93816,5,1,328335,328335,328336,0,1,0
93817,4,1,328339,328339,328340,0,1,3
93818,3,2,328342,328342,328344,0,2,2
93819,2,1,328344,328344,328345,0,1,0
93820,6,1,328350,328350,328351,0,1,5
93821,6,1,328356,328356,328357,0,1,5
93822,4,3,328360,328360,328363,0,3,3
93823,2,2,328362,328363,328365,1,3,0
93824,2,2,328364,328365,328367,1,3,0
93825,3,1,328367,328367,328368,0,1,0
93826,5,3,328372,328372,328375,0,3,4
93827,3,1,328375,328375,328376,0,1,0
93828,2,3,328377,328377,328380,0,3,1
93829,2,3,328379,328380,328383,1,4,0
93830,3,2,328382,328383,328385,1,3,0
93831,1,3,328383,328385,328388,2,5,0
93832,4,1,328387,328388,328389,1,2,0
93833,2,1,328389,328389,328390,0,1,0
93834,2,2,328391,328391,328393,0,2,1
93835,3,1,328394,328394,328395,0,1,1
93836,1,1,328395,328395,328396,0,1,0
93837,5,3,328400,328400,328403,0,3,4
93838,1,3,328401,328403,328406,2,5,0
93839,3,2,328404,328406,328408,2,4,0
93840,2,1,328406,328408,328409,2,3,0
93841,6,2,328412,328412,328414,0,2,3
93842,3,3,328415,328415,328418,0,3,1
93843,4,2,328419,328419,328421,0,2,1
93844,1,2,328420,328421,328423,1,3,0
93845,6,3,328426,328426,328429,0,3,3
93846,5,1,328431,328431,328432,0,1,2
93847,5,3,328436,328436,328439,0,3,4
93848,6,3,328442,328442,328445,0,3,3
93849,4,3,328446,328446,328449,0,3,1
93850,3,1,328449,328449,328450,0,1,0
93851,6,1,328455,328455,328456,0,1,5
93852,6,2,328461,328461,328463,0,2,5
93853,2,1,328463,328463,328464,0,1,0
93854,1,1,328464,328464,328465,0,1,0
93855,2,1,328466,328466,328467,0,1,1
93856,2,1,328468,328468,328469,0,1,1
93857,1,3,328469,328469,328472,0,3,0
93858,3,1,328472,328472,328473,0,1,0
93859,4,2,328476,328476,328478,0,2,3
93860,6,2,328482,328482,328484,0,2,4
93861,1,1,328483,328484,328485,1,2,0
93862,6,3,328489,328489,328492,0,3,4
93863,3,3,328492,328492,328495,0,3,0
93864,3,1,328495,328495,328496,0,1,0
93865,5,3,328500,328500,328503,0,3,4
93866,2,2,328502,328503,328505,1,3,0
93867,1,3,328503,328505,328508,2,5,0
93868,6,2,328509,328509,328511,0,2,1
93869,4,1,328513,328513,328514,0,1,2
93870,6,3,328519,328519,328522,0,3,5
93871,4,1,328523,328523,328524,0,1,1
93872,1,2,328524,328524,328526,0,2,0
93873,3,1,328527,328527,328528,0,1,1
93874,6,2,328533,328533,328535,0,2,5
93875,1,1,328534,328535,328536,1,2,0
93876,3,2,328537,328537,328539,0,2,1
93877,4,2,328541,328541,328543,0,2,2
93878,4,1,328545,328545,328546,0,1,2
93879,3,3,328548,328548,328551,0,3,2
93880,5,1,328553,328553,328554,0,1,2
93881,4,1,328557,328557,328558,0,1,3
93882,2,1,328559,328559,328560,0,1,1
93883,3,3,328562,328562,328565,0,3,2
93884,5,2,328567,328567,328569,0,2,2
93885,6,2,328573,328573,328575,0,2,4
93886,5,1,328578,328578,328579,0,1,3
93887,4,3,328582,328582,328585,0,3,3
93888,5,1,328587,328587,328588,0,1,2
93889,5,1,328592,328592,328593,0,1,4
93890,2,3,328594,328594,328597,0,3,1
93891,3,2,328597,328597,328599,0,2,0
93892,1,3,328598,328599,328602,1,4,0
93893,3,1,328601,328602,328603,1,2,0
93894,1,3,328602,328603,328606,1,4,0
93895,2,3,328604,328606,328609,2,5,0
93896,3,2,328607,328609,328611,2,4,0
93897,5,1,328612,328612,328613,0,1,1
93898,5,3,328617,328617,328620,0,3,4
93899,2,3,328619,328620,328623,1,4,0
93900,5,3,328624,328624,328627,0,3,1
93901,3,3,328627,328627,328630,0,3,0
93902,2,2,328629,328630,328632,1,3,0
93903,6,3,328635,328635,328638,0,3,3
93904,4,3,328639,328639,328642,0,3,1
93905,4,2,328643,328643,328645,0,2,1
93906,1,2,328644,328645,328647,1,3,0
93907,4,3,328648,328648,328651,0,3,1
93908,5,2,328653,328653,328655,0,2,2
93909,3,1,328656,328656,328657,0,1,1
93910,1,2,328657,328657,328659,0,2,0
93911,4,2,328661,328661,328663,0,2,2
93912,5,1,328666,328666,328667,0,1,3
93913,5,2,328671,328671,328673,0,2,4
93914,5,2,328676,328676,328678,0,2,3
93915,3,1,328679,328679,328680,0,1,1
93916,6,2,328685,328685,328687,0,2,5
93917,6,3,328691,328691,328694,0,3,4
93918,3,2,328694,328694,328696,0,2,0
93919,1,2,328695,328696,328698,1,3,0
93920,5,1,328700,328700,328701,0,1,2
93921,1,2,328701,328701,328703,0,2,0
93922,1,2,328702,328703,328705,1,3,0
93923,6,1,328708,328708,328709,0,1,3
93924,6,1,328714,328714,328715,0,1,5
93925,6,2,328720,328720,328722,0,2,5
93926,2,1,328722,328722,328723,0,1,0
93927,1,3,328723,328723,328726,0,3,0
93928,6,1,328729,328729,328730,0,1,3
93929,4,3,328733,328733,328736,0,3,3
93930,3,2,328736,328736,328738,0,2,0
93931,1,2,328737,328738,328740,1,3,0
93932,1,1,328738,328740,328741,2,3,0
93933,2,2,328740,328741,328743,1,3,0
93934,5,2,328745,328745,328747,0,2,2
93935,1,3,328746,328747,328750,1,4,0
93936,4,3,328750,328750,328753,0,3,0
93937,3,2,328753,328753,328755,0,2,0
93938,6,3,328759,328759,328762,0,3,4
93939,6,3,328765,328765,328768,0,3,3
93940,5,3,328770,328770,328773,0,3,2
93941,6,3,328776,328776,328779,0,3,3
93942,1,2,328777,328779,328781,2,4,0
93943,2,1,328779,328781,328782,2,3,0
93944,5,2,328784,328784,328786,0,2,2
93945,4,3,328788,328788,328791,0,3,2
93946,1,1,328789,328791,328792,2,3,0
93947,6,3,328795,328795,328798,0,3,3
93948,5,2,328800,328800,328802,0,2,2
93949,1,2,328801,328802,328804,1,3,0
93950,1,3,328802,328804,328807,2,5,0
93951,3,1,328805,328807,328808,2,3,0
93952,5,3,328810,328810,328813,0,3,2
93953,1,3,328811,328813,328816,2,5,0
93954,1,1,328812,328816,328817,4,5,0
93955,4,3,328816,328817,328820,1,4,0
93956,2,2,328818,328820,328822,2,4,0
93957,4,3,328822,328822,328825,0,3,0
93958,6,3,328828,328828,328831,0,3,3
93959,5,1,328833,328833,328834,0,1,2
93960,6,2,328839,328839,328841,0,2,5
93961,1,2,328840,328841,328843,1,3,0
93962,4,2,328844,328844,328846,0,2,1
93963,1,2,328845,328846,328848,1,3,0
93964,4,2,328849,328849,328851,0,2,1
93965,2,3,328851,328851,328854,0,3,0
93966,6,2,328857,328857,328859,0,2,3
93967,3,2,328860,328860,328862,0,2,1
93968,2,3,328862,328862,328865,0,3,0
93969,4,3,328866,328866,328869,0,3,1
93970,4,3,328870,328870,328873,0,3,1
93971,5,1,328875,328875,328876,0,1,2
93972,5,2,328880,328880,328882,0,2,4
93973,1,3,328881,328882,328885,1,4,0
93974,2,3,328883,328885,328888,2,5,0
93975,3,1,328886,328888,328889,2,3,0
93976,5,1,328891,328891,328892,0,1,2
93977,2,2,328893,328893,328895,0,2,1
93978,2,3,328895,328895,328898,0,3,0
93979,2,2,328897,328898,328900,1,3,0
93980,5,1,328902,328902,328903,0,1,2
93981,1,1,328903,328903,328904,0,1,0
93982,2,1,328905,328905,328906,0,1,1
93983,3,2,328908,328908,328910,0,2,2
93984,2,1,328910,328910,328911,0,1,0
93985,6,2,328916,328916,328918,0,2,5
93986,4,1,328920,328920,328921,0,1,2
93987,4,2,328924,328924,328926,0,2,3
93988,4,2,328928,328928,328930,0,2,2
93989,3,1,328931,328931,328932,0,1,1
93990,4,3,328935,328935,328938,0,3,3
93991,3,2,328938,328938,328940,0,2,0
93992,4,2,328942,328942,328944,0,2,2
93993,5,3,328947,328947,328950,0,3,3
93994,2,2,328949,328950,328952,1,3,0
93995,1,2,328950,328952,328954,2,4,0
93996,6,1,328956,328956,328957,0,1,2
93997,5,2,328961,328961,328963,0,2,4
93998,1,1,328962,328963,328964,1,2,0
93999,4,2,328966,328966,328968,0,2,2
94000,2,3,328968,328968,328971,0,3,0
94001,6,1,328974,328974,328975,0,1,3
94002,2,3,328976,328976,328979,0,3,1
94003,1,2,328977,328979,328981,2,4,0
94004,2,2,328979,328981,328983,2,4,0
94005,4,3,328983,328983,328986,0,3,0
94006,6,2,328989,328989,328991,0,2,3
94007,3,1,328992,328992,328993,0,1,1
94008,3,1,328995,328995,328996,0,1,2
94009,6,3,329001,329001,329004,0,3,5
94010,6,3,329007,329007,329010,0,3,3
94011,2,2,329009,329010,329012,1,3,0
94012,5,1,329014,329014,329015,0,1,2
94013,2,3,329016,329016,329019,0,3,1
94014,6,2,329022,329022,329024,0,2,3
94015,6,3,329028,329028,329031,0,3,4
94016,3,3,329031,329031,329034,0,3,0
94017,4,1,329035,329035,329036,0,1,1
94018,5,2,329040,329040,329042,0,2,4
94019,3,3,329043,329043,329046,0,3,1
94020,4,3,329047,329047,329050,0,3,1
94021,2,2,329049,329050,329052,1,3,0
94022,5,3,329054,329054,329057,0,3,2
94023,4,1,329058,329058,329059,0,1,1
94024,2,2,329060,329060,329062,0,2,1
94025,1,2,329061,329062,329064,1,3,0
94026,6,2,329067,329067,329069,0,2,3
94027,4,1,329071,329071,329072,0,1,2
94028,6,2,329077,329077,329079,0,2,5
94029,4,3,329081,329081,329084,0,3,2
94030,3,1,329084,329084,329085,0,1,0
94031,1,2,329085,329085,329087,0,2,0
94032,1,1,329086,329087,329088,1,2,0
94033,3,1,329089,329089,329090,0,1,1
94034,6,1,329095,329095,329096,0,1,5
94035,2,3,329097,329097,329100,0,3,1
94036,6,2,329103,329103,329105,0,2,3
94037,6,1,329109,329109,329110,0,1,4
94038,4,3,329113,329113,329116,0,3,3
94039,1,1,329114,329116,329117,2,3,0
94040,2,2,329116,329117,329119,1,3,0
94041,6,3,329122,329122,329125,0,3,3
94042,1,1,329123,329125,329126,2,3,0
94043,3,1,329126,329126,329127,0,1,0
94044,1,3,329127,329127,329130,0,3,0
94045,2,1,329129,329130,329131,1,2,0
94046,4,1,329133,329133,329134,0,1,2
94047,2,1,329135,329135,329136,0,1,1
94048,4,3,329139,329139,329142,0,3,3
94049,3,1,329142,329142,329143,0,1,0
94050,6,3,329148,329148,329151,0,3,5
94051,6,2,329154,329154,329156,0,2,3
94052,2,1,329156,329156,329157,0,1,0
94053,3,1,329159,329159,329160,0,1,2
94054,4,2,329163,329163,329165,0,2,3
94055,6,1,329169,329169,329170,0,1,4
94056,5,1,329174,329174,329175,0,1,4
94057,3,2,329177,329177,329179,0,2,2
94058,1,1,329178,329179,329180,1,2,0
94059,5,2,329183,329183,329185,0,2,3
94060,3,1,329186,329186,329187,0,1,1
94061,1,3,329187,329187,329190,0,3,0
94062,6,2,329193,329193,329195,0,2,3
94063,3,1,329196,329196,329197,0,1,1
94064,4,2,329200,329200,329202,0,2,3
94065,4,2,329204,329204,329206,0,2,2
94066,1,1,329205,329206,329207,1,2,0
94067,4,2,329209,329209,329211,0,2,2
94068,3,1,329212,329212,329213,0,1,1
94069,2,2,329214,329214,329216,0,2,1
94070,6,2,329220,329220,329222,0,2,4
94071,6,1,329226,329226,329227,0,1,4
94072,3,3,329229,329229,329232,0,3,2
94073,1,3,329230,329232,329235,2,5,0
94074,5,3,329235,329235,329238,0,3,0
94075,3,2,329238,329238,329240,0,2,0
94076,2,1,329240,329240,329241,0,1,0
94077,2,2,329242,329242,329244,0,2,1
94078,6,2,329248,329248,329250,0,2,4
94079,4,3,329252,329252,329255,0,3,2
94080,1,2,329253,329255,329257,2,4,0
94081,3,1,329256,329257,329258,1,2,0
94082,3,3,329259,329259,329262,0,3,1
94083,3,3,329262,329262,329265,0,3,0
94084,1,1,329263,329265,329266,2,3,0
94085,3,3,329266,329266,329269,0,3,0
94086,3,2,329269,329269,329271,0,2,0
94087,4,2,329273,329273,329275,0,2,2
94088,4,3,329277,329277,329280,0,3,2
94089,1,3,329278,329280,329283,2,5,0
94090,3,1,329281,329283,329284,2,3,0
94091,3,1,329284,329284,329285,0,1,0
94092,4,1,329288,329288,329289,0,1,3
94093,6,1,329294,329294,329295,0,1,5
94094,4,3,329298,329298,329301,0,3,3
94095,3,3,329301,329301,329304,0,3,0
94096,1,2,329302,329304,329306,2,4,0
94097,3,2,329305,329306,329308,1,3,0
94098,3,3,329308,329308,329311,0,3,0
94099,4,3,329312,329312,329315,0,3,1
94100,5,2,329317,329317,329319,0,2,2
94101,4,3,329321,329321,329324,0,3,2
94102,1,1,329322,329324,329325,2,3,0
94103,2,3,329324,329325,329328,1,4,0
94104,2,1,329326,329328,329329,2,3,0
94105,2,2,329328,329329,329331,1,3,0
94106,1,2,329329,329331,329333,2,4,0
94107,4,1,329333,329333,329334,0,1,0
94108,4,3,329337,329337,329340,0,3,3
94109,2,3,329339,329340,329343,1,4,0
94110,6,2,329345,329345,329347,0,2,2
94111,5,1,329350,329350,329351,0,1,3
94112,4,2,329354,329354,329356,0,2,3
94113,3,1,329357,329357,329358,0,1,1
94114,5,3,329362,329362,329365,0,3,4
94115,4,1,329366,329366,329367,0,1,1
94116,5,2,329371,329371,329373,0,2,4
94117,1,1,329372,329373,329374,1,2,0
94118,1,2,329373,329374,329376,1,3,0
94119,5,2,329378,329378,329380,0,2,2
94120,2,2,329380,329380,329382,0,2,0
94121,1,3,329381,329382,329385,1,4,0
94122,2,3,329383,329385,329388,2,5,0
94123,1,3,329384,329388,329391,4,7,0
94124,4,2,329388,329391,329393,3,5,0
94125,6,2,329394,329394,329396,0,2,1
94126,5,3,329399,329399,329402,0,3,3
94127,2,1,329401,329402,329403,1,2,0
94128,2,3,329403,329403,329406,0,3,0
94129,5,1,329408,329408,329409,0,1,2
94130,3,1,329411,329411,329412,0,1,2
94131,1,1,329412,329412,329413,0,1,0
94132,4,3,329416,329416,329419,0,3,3
94133,3,3,329419,329419,329422,0,3,0
94134,6,1,329425,329425,329426,0,1,3
94135,1,2,329426,329426,329428,0,2,0
94136,2,1,329428,329428,329429,0,1,0
94137,5,1,329433,329433,329434,0,1,4
94138,1,1,329434,329434,329435,0,1,0
94139,6,2,329440,329440,329442,0,2,5
94140,6,1,329446,329446,329447,0,1,4
94141,1,2,329447,329447,329449,0,2,0
94142,6,3,329453,329453,329456,0,3,4
94143,3,3,329456,329456,329459,0,3,0
94144,2,2,329458,329459,329461,1,3,0
94145,5,3,329463,329463,329466,0,3,2
94146,2,1,329465,329466,329467,1,2,0
94147,5,3,329470,329470,329473,0,3,3
94148,5,3,329475,329475,329478,0,3,2
94149,3,1,329478,329478,329479,0,1,0
94150,6,2,329484,329484,329486,0,2,5
94151,1,2,329485,329486,329488,1,3,0
94152,1,1,329486,329488,329489,2,3,0
94153,4,3,329490,329490,329493,0,3,1
94154,5,1,329495,329495,329496,0,1,2
94155,2,2,329497,329497,329499,0,2,1
94156,3,2,329500,329500,329502,0,2,1
94157,4,3,329504,329504,329507,0,3,2
94158,5,2,329509,329509,329511,0,2,2
94159,3,3,329512,329512,329515,0,3,1
94160,3,3,329515,329515,329518,0,3,0
94161,4,2,329519,329519,329521,0,2,1
94162,3,3,329522,329522,329525,0,3,1
94163,2,2,329524,329525,329527,1,3,0
94164,2,1,329526,329527,329528,1,2,0
94165,2,1,329528,329528,329529,0,1,0
94166,4,2,329532,329532,329534,0,2,3
94167,3,2,329535,329535,329537,0,2,1
94168,1,2,329536,329537,329539,1,3,0
94169,2,3,329538,329539,329542,1,4,0
94170,5,3,329543,329543,329546,0,3,1
94171,2,2,329545,329546,329548,1,3,0
94172,5,2,329550,329550,329552,0,2,2
94173,5,3,329555,329555,329558,0,3,3
94174,3,2,329558,329558,329560,0,2,0
94175,2,1,329560,329560,329561,0,1,0
94176,5,3,329565,329565,329568,0,3,4
94177,1,2,329566,329568,329570,2,4,0
94178,6,3,329572,329572,329575,0,3,2
94179,2,2,329574,329575,329577,1,3,0
94180,3,3,329577,329577,329580,0,3,0
94181,1,3,329578,329580,329583,2,5,0
94182,5,3,329583,329583,329586,0,3,0
94183,3,2,329586,329586,329588,0,2,0
94184,2,1,329588,329588,329589,0,1,0
94185,4,1,329592,329592,329593,0,1,3
94186,5,2,329597,329597,329599,0,2,4
94187,6,2,329603,329603,329605,0,2,4
94188,4,1,329607,329607,329608,0,1,2
94189,6,1,329613,329613,329614,0,1,5
94190,1,1,329614,329614,329615,0,1,0
94191,3,2,329617,329617,329619,0,2,2
94192,3,2,329620,329620,329622,0,2,1
94193,1,1,329621,329622,329623,1,2,0
94194,3,2,329624,329624,329626,0,2,1
94195,5,1,329629,329629,329630,0,1,3
94196,1,1,329630,329630,329631,0,1,0
94197,4,2,329634,329634,329636,0,2,3
94198,5,1,329639,329639,329640,0,1,3
94199,5,3,329644,329644,329647,0,3,4
94200,1,2,329645,329647,329649,2,4,0
94201,5,3,329650,329650,329653,0,3,1
94202,2,1,329652,329653,329654,1,2,0
94203,3,3,329655,329655,329658,0,3,1
94204,2,1,329657,329658,329659,1,2,0
94205,1,3,329658,329659,329662,1,4,0
94206,1,1,329659,329662,329663,3,4,0
94207,3,3,329662,329663,329666,1,4,0
94208,6,1,329668,329668,329669,0,1,2
94209,2,2,329670,329670,329672,0,2,1
94210,2,3,329672,329672,329675,0,3,0
94211,2,3,329674,329675,329678,1,4,0
94212,5,3,329679,329679,329682,0,3,1
94213,5,1,329684,329684,329685,0,1,2
94214,2,3,329686,329686,329689,0,3,1
94215,1,2,329687,329689,329691,2,4,0
94216,3,2,329690,329691,329693,1,3,0
94217,1,2,329691,329693,329695,2,4,0
94218,2,3,329693,329695,329698,2,5,0
94219,6,1,329699,329699,329700,0,1,1
94220,3,3,329702,329702,329705,0,3,2
94221,6,2,329708,329708,329710,0,2,3
94222,6,2,329714,329714,329716,0,2,4
94223,3,1,329717,329717,329718,0,1,1
94224,4,1,329721,329721,329722,0,1,3
94225,5,3,329726,329726,329729,0,3,4
94226,1,2,329727,329729,329731,2,4,0
94227,1,3,329728,329731,329734,3,6,0
94228,3,2,329731,329734,329736,3,5,0
94229,6,1,329737,329737,329738,0,1,1
94230,4,2,329741,329741,329743,0,2,3
94231,3,3,329744,329744,329747,0,3,1
94232,5,3,329749,329749,329752,0,3,2
94233,3,2,329752,329752,329754,0,2,0
94234,4,2,329756,329756,329758,0,2,2
94235,1,2,329757,329758,329760,1,3,0
94236,4,3,329761,329761,329764,0,3,1
94237,5,1,329766,329766,329767,0,1,2
94238,3,1,329769,329769,329770,0,1,2
94239,1,3,329770,329770,329773,0,3,0
94240,2,2,329772,329773,329775,1,3,0
94241,2,1,329774,329775,329776,1,2,0
94242,3,1,329777,329777,329778,0,1,1
94243,5,1,329782,329782,329783,0,1,4
94244,6,2,329788,329788,329790,0,2,5
94245,2,3,329790,329790,329793,0,3,0
94246,2,2,329792,329793,329795,1,3,0
94247,6,1,329798,329798,329799,0,1,3
94248,5,1,329803,329803,329804,0,1,4
94249,6,3,329809,329809,329812,0,3,5
94250,6,1,329815,329815,329816,0,1,3
94251,4,2,329819,329819,329821,0,2,3
94252,5,3,329824,329824,329827,0,3,3
94253,5,2,329829,329829,329831,0,2,2
94254,1,2,329830,329831,329833,1,3,0
94255,3,1,329833,329833,329834,0,1,0
94256,2,2,329835,329835,329837,0,2,1
94257,1,1,329836,329837,329838,1,2,0
94258,5,2,329841,329841,329843,0,2,3
94259,5,2,329846,329846,329848,0,2,3
94260,1,2,329847,329848,329850,1,3,0
94261,5,3,329852,329852,329855,0,3,2
94262,2,2,329854,329855,329857,1,3,0
94263,4,2,329858,329858,329860,0,2,1
94264,2,3,329860,329860,329863,0,3,0
94265,3,1,329863,329863,329864,0,1,0
94266,6,2,329869,329869,329871,0,2,5
94267,5,3,329874,329874,329877,0,3,3
94268,3,2,329877,329877,329879,0,2,0
94269,6,3,329883,329883,329886,0,3,4
94270,5,1,329888,329888,329889,0,1,2
94271,4,1,329892,329892,329893,0,1,3
94272,3,3,329895,329895,329898,0,3,2
94273,2,3,329897,329898,329901,1,4,0
94274,2,1,329899,329901,329902,2,3,0
94275,2,1,329901,329902,329903,1,2,0
94276,2,2,329903,329903,329905,0,2,0
94277,1,1,329904,329905,329906,1,2,0
94278,5,1,329909,329909,329910,0,1,3
94279,5,1,329914,329914,329915,0,1,4
94280,4,3,329918,329918,329921,0,3,3
94281,3,3,329921,329921,329924,0,3,0
94282,2,1,329923,329924,329925,1,2,0
94283,4,3,329927,329927,329930,0,3,2
94284,5,3,329932,329932,329935,0,3,2
94285,5,2,329937,329937,329939,0,2,2
94286,2,1,329939,329939,329940,0,1,0
94287,6,1,329945,329945,329946,0,1,5
94288,4,3,329949,329949,329952,0,3,3
94289,1,2,329950,329952,329954,2,4,0
94290,1,3,329951,329954,329957,3,6,0
94291,6,2,329957,329957,329959,0,2,0
94292,4,1,329961,329961,329962,0,1,2
94293,3,2,329964,329964,329966,0,2,2
94294,6,2,329970,329970,329972,0,2,4
94295,1,3,329971,329972,329975,1,4,0
94296,3,1,329974,329975,329976,1,2,0
94297,5,2,329979,329979,329981,0,2,3
94298,1,2,329980,329981,329983,1,3,0
94299,6,3,329986,329986,329989,0,3,3
94300,2,3,329988,329989,329992,1,4,0
94301,1,2,329989,329992,329994,3,5,0
94302,1,2,329990,329994,329996,4,6,0
94303,3,2,329993,329996,329998,3,5,0
94304,2,2,329995,329998,330000,3,5,0
94305,6,1,330001,330001,330002,0,1,1
94306,4,3,330005,330005,330008,0,3,3
94307,5,1,330010,330010,330011,0,1,2
94308,5,2,330015,330015,330017,0,2,4
94309,4,1,330019,330019,330020,0,1,2
94310,4,2,330023,330023,330025,0,2,3
94311,2,1,330025,330025,330026,0,1,0
94312,2,1,330027,330027,330028,0,1,1
94313,4,3,330031,330031,330034,0,3,3
94314,3,2,330034,330034,330036,0,2,0
94315,6,1,330040,330040,330041,0,1,4
94316,6,3,330046,330046,330049,0,3,5
94317,3,3,330049,330049,330052,0,3,0
94318,6,2,330055,330055,330057,0,2,3
94319,1,1,330056,330057,330058,1,2,0
94320,2,3,330058,330058,330061,0,3,0
94321,1,2,330059,330061,330063,2,4,0
94322,1,3,330060,330063,330066,3,6,0
94323,2,1,330062,330066,330067,4,5,0
94324,5,3,330067,330067,330070,0,3,0
94325,2,3,330069,330070,330073,1,4,0
94326,4,1,330073,330073,330074,0,1,0
94327,1,1,330074,330074,330075,0,1,0
94328,6,1,330080,330080,330081,0,1,5
94329,1,1,330081,330081,330082,0,1,0
94330,6,3,330087,330087,330090,0,3,5
94331,4,1,330091,330091,330092,0,1,1
94332,2,3,330093,330093,330096,0,3,1
94333,2,3,330095,330096,330099,1,4,0
94334,1,3,330096,330099,330102,3,6,0
94335,5,2,330101,330102,330104,1,3,0
94336,3,3,330104,330104,330107,0,3,0
94337,2,2,330106,330107,330109,1,3,0
94338,6,3,330112,330112,330115,0,3,3
94339,5,3,330117,330117,330120,0,3,2
94340,1,3,330118,330120,330123,2,5,0
94341,4,3,330122,330123,330126,1,4,0
94342,2,2,330124,330126,330128,2,4,0
94343,4,2,330128,330128,330130,0,2,0
94344,4,2,330132,330132,330134,0,2,2
94345,1,1,330133,330134,330135,1,2,0
94346,2,3,330135,330135,330138,0,3,0
94347,5,1,330140,330140,330141,0,1,2
94348,6,2,330146,330146,330148,0,2,5
94349,2,2,330148,330148,330150,0,2,0
94350,2,2,330150,330150,330152,0,2,0
94351,2,1,330152,330152,330153,0,1,0
94352,5,3,330157,330157,330160,0,3,4
94353,1,3,330158,330160,330163,2,5,0
94354,2,1,330160,330163,330164,3,4,0
94355,2,3,330162,330164,330167,2,5,0
94356,1,1,330163,330167,330168,4,5,0
94357,3,3,330166,330168,330171,2,5,0
94358,6,2,330172,330172,330174,0,2,1
94359,1,2,330173,330174,330176,1,3,0
94360,5,1,330178,330178,330179,0,1,2
94361,4,3,330182,330182,330185,0,3,3
94362,6,2,330188,330188,330190,0,2,3
94363,2,3,330190,330190,330193,0,3,0
94364,6,2,330196,330196,330198,0,2,3
94365,6,3,330202,330202,330205,0,3,4
94366,1,2,330203,330205,330207,2,4,0
94367,6,1,330209,330209,330210,0,1,2
94368,1,3,330210,330210,330213,0,3,0
94369,5,2,330215,330215,330217,0,2,2
94370,6,2,330221,330221,330223,0,2,4
94371,4,1,330225,330225,330226,0,1,2
94372,6,1,330231,330231,330232,0,1,5
94373,5,2,330236,330236,330238,0,2,4
94374,1,2,330237,330238,330240,1,3,0
94375,2,2,330239,330240,330242,1,3,0
94376,6,1,330245,330245,330246,0,1,3
94377,4,1,330249,330249,330250,0,1,3
94378,6,1,330255,330255,330256,0,1,5
94379,1,3,330256,330256,330259,0,3,0
94380,5,1,330261,330261,330262,0,1,2
94381,2,1,330263,330263,330264,0,1,1
94382,4,3,330267,330267,330270,0,3,3
94383,2,1,330269,330270,330271,1,2,0
94384,4,3,330273,330273,330276,0,3,2
94385,5,1,330278,330278,330279,0,1,2
94386,2,2,330280,330280,330282,0,2,1
94387,5,2,330285,330285,330287,0,2,3
94388,5,1,330290,330290,330291,0,1,3
94389,5,3,330295,330295,330298,0,3,4
94390,3,2,330298,330298,330300,0,2,0
94391,5,3,330303,330303,330306,0,3,3
94392,6,3,330309,330309,330312,0,3,3
94393,6,1,330315,330315,330316,0,1,3
94394,4,1,330319,330319,330320,0,1,3
94395,5,3,330324,330324,330327,0,3,4
94396,4,2,330328,330328,330330,0,2,1
94397,5,3,330333,330333,330336,0,3,3
94398,2,1,330335,330336,330337,1,2,0
94399,1,3,330336,330337,330340,1,4,0
94400,5,1,330341,330341,330342,0,1,1
94401,5,3,330346,330346,330349,0,3,4
94402,1,3,330347,330349,330352,2,5,0
94403,5,2,330352,330352,330354,0,2,0
94404,3,1,330355,330355,330356,0,1,1
94405,4,3,330359,330359,330362,0,3,3
94406,1,1,330360,330362,330363,2,3,0
94407,5,1,330365,330365,330366,0,1,2
94408,5,1,330370,330370,330371,0,1,4
94409,2,1,330372,330372,330373,0,1,1
94410,6,2,330378,330378,330380,0,2,5
94411,4,1,330382,330382,330383,0,1,2
94412,5,2,330387,330387,330389,0,2,4
94413,5,3,330392,330392,330395,0,3,3
94414,4,1,330396,330396,330397,0,1,1
94415,6,1,330402,330402,330403,0,1,5
94416,3,3,330405,330405,330408,0,3,2
94417,6,2,330411,330411,330413,0,2,3
94418,4,3,330415,330415,330418,0,3,2
94419,4,3,330419,330419,330422,0,3,1
94420,5,2,330424,330424,330426,0,2,2
94421,6,2,330430,330430,330432,0,2,4
94422,6,3,330436,330436,330439,0,3,4
94423,2,2,330438,330439,330441,1,3,0
94424,2,1,330440,330441,330442,1,2,0
94425,1,2,330441,330442,330444,1,3,0
94426,1,2,330442,330444,330446,2,4,0
94427,2,3,330444,330446,330449,2,5,0
94428,6,3,330450,330450,330453,0,3,1
94429,3,3,330453,330453,330456,0,3,0
94430,4,1,330457,330457,330458,0,1,1
94431,2,3,330459,330459,330462,0,3,1
94432,4,1,330463,330463,330464,0,1,1
94433,3,3,330466,330466,330469,0,3,2
94434,1,3,330467,330469,330472,2,5,0
94435,6,3,330473,330473,330476,0,3,1
94436,1,1,330474,330476,330477,2,3,0
94437,1,3,330475,330477,330480,2,5,0
94438,5,3,330480,330480,330483,0,3,0
94439,1,2,330481,330483,330485,2,4,0
94440,3,3,330484,330485,330488,1,4,0
94441,1,1,330485,330488,330489,3,4,0
94442,6,3,330491,330491,330494,0,3,2
94443,4,3,330495,330495,330498,0,3,1
94444,5,1,330500,330500,330501,0,1,2
94445,6,2,330506,330506,330508,0,2,5
94446,6,2,330512,330512,330514,0,2,4
94447,1,2,330513,330514,330516,1,3,0
94448,3,1,330516,330516,330517,0,1,0
94449,6,2,330522,330522,330524,0,2,5
94450,3,3,330525,330525,330528,0,3,1
94451,1,2,330526,330528,330530,2,4,0
94452,1,3,330527,330530,330533,3,6,0
94453,5,2,330532,330533,330535,1,3,0
94454,2,1,330534,330535,330536,1,2,0
94455,1,2,330535,330536,330538,1,3,0
94456,5,3,330540,330540,330543,0,3,2
94457,4,3,330544,330544,330547,0,3,1
94458,6,2,330550,330550,330552,0,2,3
94459,1,3,330551,330552,330555,1,4,0
94460,1,2,330552,330555,330557,3,5,0
94461,2,2,330554,330557,330559,3,5,0
94462,6,3,330560,330560,330563,0,3,1
94463,6,1,330566,330566,330567,0,1,3
94464,5,2,330571,330571,330573,0,2,4
94465,4,3,330575,330575,330578,0,3,2
94466,5,2,330580,330580,330582,0,2,2
94467,5,1,330585,330585,330586,0,1,3
94468,6,2,330591,330591,330593,0,2,5
94469,3,3,330594,330594,330597,0,3,1
94470,6,2,330600,330600,330602,0,2,3
94471,4,2,330604,330604,330606,0,2,2
94472,5,2,330609,330609,330611,0,2,3
94473,3,3,330612,330612,330615,0,3,1
94474,6,3,330618,330618,330621,0,3,3
94475,2,2,330620,330621,330623,1,3,0
94476,1,2,330621,330623,330625,2,4,0
94477,1,2,330622,330625,330627,3,5,0
94478,3,1,330625,330627,330628,2,3,0
94479,4,1,330629,330629,330630,0,1,1
94480,2,3,330631,330631,330634,0,3,1
94481,5,1,330636,330636,330637,0,1,2
94482,4,1,330640,330640,330641,0,1,3
94483,2,1,330642,330642,330643,0,1,1
94484,1,3,330643,330643,330646,0,3,0
94485,6,3,330649,330649,330652,0,3,3
94486,4,1,330653,330653,330654,0,1,1
94487,6,1,330659,330659,330660,0,1,5
94488,3,2,330662,330662,330664,0,2,2
94489,6,2,330668,330668,330670,0,2,4
94490,3,2,330671,330671,330673,0,2,1
94491,3,1,330674,330674,330675,0,1,1
94492,5,3,330679,330679,330682,0,3,4
94493,4,2,330683,330683,330685,0,2,1
94494,1,1,330684,330685,330686,1,2,0
94495,6,2,330690,330690,330692,0,2,4
94496,6,1,330696,330696,330697,0,1,4
94497,6,1,330702,330702,330703,0,1,5
94498,1,1,330703,330703,330704,0,1,0
94499,4,2,330707,330707,330709,0,2,3
94500,6,3,330713,330713,330716,0,3,4
94501,5,1,330718,330718,330719,0,1,2
94502,5,2,330723,330723,330725,0,2,4
94503,3,3,330726,330726,330729,0,3,1
94504,1,1,330727,330729,330730,2,3,0
94505,1,3,330728,330730,330733,2,5,0
94506,5,1,330733,330733,330734,0,1,0
94507,2,2,330735,330735,330737,0,2,1
94508,3,2,330738,330738,330740,0,2,1
94509,2,3,330740,330740,330743,0,3,0
94510,2,1,330742,330743,330744,1,2,0
94511,4,3,330746,330746,330749,0,3,2
94512,2,2,330748,330749,330751,1,3,0
94513,5,2,330753,330753,330755,0,2,2
94514,6,1,330759,330759,330760,0,1,4
94515,6,1,330765,330765,330766,0,1,5
94516,4,1,330769,330769,330770,0,1,3
94517,4,3,330773,330773,330776,0,3,3
94518,3,1,330776,330776,330777,0,1,0
94519,1,3,330777,330777,330780,0,3,0
94520,6,3,330783,330783,330786,0,3,3
94521,1,3,330784,330786,330789,2,5,0
94522,2,1,330786,330789,330790,3,4,0
94523,6,2,330792,330792,330794,0,2,2
94524,2,2,330794,330794,330796,0,2,0
94525,5,2,330799,330799,330801,0,2,3
94526,2,1,330801,330801,330802,0,1,0
94527,4,3,330805,330805,330808,0,3,3
94528,1,2,330806,330808,330810,2,4,0
94529,6,2,330812,330812,330814,0,2,2
94530,4,2,330816,330816,330818,0,2,2
94531,6,2,330822,330822,330824,0,2,4
94532,3,1,330825,330825,330826,0,1,1
94533,6,2,330831,330831,330833,0,2,5
94534,5,1,330836,330836,330837,0,1,3
94535,6,3,330842,330842,330845,0,3,5
94536,6,3,330848,330848,330851,0,3,3
94537,6,1,330854,330854,330855,0,1,3
94538,2,1,330856,330856,330857,0,1,1
94539,2,2,330858,330858,330860,0,2,1
94540,5,2,330863,330863,330865,0,2,3
94541,3,1,330866,330866,330867,0,1,1
94542,3,3,330869,330869,330872,0,3,2
94543,6,2,330875,330875,330877,0,2,3
94544,2,1,330877,330877,330878,0,1,0
94545,6,1,330883,330883,330884,0,1,5
94546,4,1,330887,330887,330888,0,1,3
94547,2,2,330889,330889,330891,0,2,1
94548,4,3,330893,330893,330896,0,3,2
94549,5,2,330898,330898,330900,0,2,2
94550,5,2,330903,330903,330905,0,2,3
94551,5,2,330908,330908,330910,0,2,3
94552,1,3,330909,330910,330913,1,4,0
94553,6,3,330915,330915,330918,0,3,2
94554,6,1,330921,330921,330922,0,1,3
94555,4,3,330925,330925,330928,0,3,3
94556,6,3,330931,330931,330934,0,3,3
94557,4,2,330935,330935,330937,0,2,1
94558,6,1,330941,330941,330942,0,1,4
94559,2,3,330943,330943,330946,0,3,1
94560,1,3,330944,330946,330949,2,5,0
94561,5,1,330949,330949,330950,0,1,0
94562,4,1,330953,330953,330954,0,1,3
94563,5,1,330958,330958,330959,0,1,4
94564,2,3,330960,330960,330963,0,3,1
94565,3,2,330963,330963,330965,0,2,0
94566,2,3,330965,330965,330968,0,3,0
94567,5,3,330970,330970,330973,0,3,2
94568,5,3,330975,330975,330978,0,3,2
94569,6,2,330981,330981,330983,0,2,3
94570,2,2,330983,330983,330985,0,2,0
94571,4,2,330987,330987,330989,0,2,2
94572,4,2,330991,330991,330993,0,2,2
94573,5,1,330996,330996,330997,0,1,3
94574,1,2,330997,330997,330999,0,2,0
94575,4,3,331001,331001,331004,0,3,2
94576,5,2,331006,331006,331008,0,2,2
94577,2,2,331008,331008,331010,0,2,0
94578,5,1,331013,331013,331014,0,1,3
94579,2,2,331015,331015,331017,0,2,1
94580,5,2,331020,331020,331022,0,2,3
94581,1,2,331021,331022,331024,1,3,0
94582,5,1,331026,331026,331027,0,1,2
94583,5,1,331031,331031,331032,0,1,4
94584,6,2,331037,331037,331039,0,2,5
94585,6,3,331043,331043,331046,0,3,4
94586,5,2,331048,331048,331050,0,2,2
94587,3,1,331051,331051,331052,0,1,1
94588,3,1,331054,331054,331055,0,1,2
94589,4,3,331058,331058,331061,0,3,3
94590,2,2,331060,331061,331063,1,3,0
94591,4,1,331064,331064,331065,0,1,1
94592,2,2,331066,331066,331068,0,2,1
94593,5,1,331071,331071,331072,0,1,3
94594,1,1,331072,331072,331073,0,1,0
94595,2,1,331074,331074,331075,0,1,1
94596,2,2,331076,331076,331078,0,2,1
94597,3,3,331079,331079,331082,0,3,1
94598,6,2,331085,331085,331087,0,2,3
94599,3,3,331088,331088,331091,0,3,1
94600,6,2,331094,331094,331096,0,2,3
94601,5,2,331099,331099,331101,0,2,3
94602,4,2,331103,331103,331105,0,2,2
94603,3,1,331106,331106,331107,0,1,1
94604,1,1,331107,331107,331108,0,1,0
94605,4,3,331111,331111,331114,0,3,3
94606,2,2,331113,331114,331116,1,3,0
94607,2,2,331115,331116,331118,1,3,0
94608,3,1,331118,331118,331119,0,1,0
94609,4,1,331122,331122,331123,0,1,3
94610,6,3,331128,331128,331131,0,3,5
94611,6,3,331134,331134,331137,0,3,3
94612,5,3,331139,331139,331142,0,3,2
94613,4,2,331143,331143,331145,0,2,1
94614,6,3,331149,331149,331152,0,3,4
94615,3,1,331152,331152,331153,0,1,0
94616,5,3,331157,331157,331160,0,3,4
94617,5,3,331162,331162,331165,0,3,2
94618,2,3,331164,331165,331168,1,4,0
94619,1,3,331165,331168,331171,3,6,0
94620,6,2,331171,331171,331173,0,2,0
94621,1,1,331172,331173,331174,1,2,0
94622,2,3,331174,331174,331177,0,3,0
94623,1,2,331175,331177,331179,2,4,0
94624,6,2,331181,331181,331183,0,2,2
94625,4,3,331185,331185,331188,0,3,2
94626,3,3,331188,331188,331191,0,3,0
94627,6,2,331194,331194,331196,0,2,3
94628,4,3,331198,331198,331201,0,3,2
94629,2,2,331200,331201,331203,1,3,0
94630,1,1,331201,331203,331204,2,3,0
94631,2,3,331203,331204,331207,1,4,0
94632,4,1,331207,331207,331208,0,1,0
94633,5,3,331212,331212,331215,0,3,4
94634,2,2,331214,331215,331217,1,3,0
94635,1,1,331215,331217,331218,2,3,0
94636,1,1,331216,331218,331219,2,3,0
94637,1,1,331217,331219,331220,2,3,0
94638,2,2,331219,331220,331222,1,3,0
94639,5,1,331224,331224,331225,0,1,2
94640,1,3,331225,331225,331228,0,3,0
94641,4,2,331229,331229,331231,0,2,1
94642,1,3,331230,331231,331234,1,4,0
94643,5,2,331235,331235,331237,0,2,1
94644,6,3,331241,331241,331244,0,3,4
94645,2,3,331243,331244,331247,1,4,0
94646,2,1,331245,331247,331248,2,3,0
94647,6,2,331251,331251,331253,0,2,3
94648,6,1,331257,331257,331258,0,1,4
94649,1,3,331258,331258,331261,0,3,0
94650,4,3,331262,331262,331265,0,3,1
94651,1,2,331263,331265,331267,2,4,0
94652,2,1,331265,331267,331268,2,3,0
94653,4,1,331269,331269,331270,0,1,1
94654,3,1,331272,331272,331273,0,1,2
94655,1,2,331273,331273,331275,0,2,0
94656,2,2,331275,331275,331277,0,2,0
94657,5,1,331280,331280,331281,0,1,3
94658,4,3,331284,331284,331287,0,3,3
94659,2,1,331286,331287,331288,1,2,0
94660,5,1,331291,331291,331292,0,1,3
94661,6,3,331297,331297,331300,0,3,5
94662,2,2,331299,331300,331302,1,3,0
94663,5,3,331304,331304,331307,0,3,2
94664,6,2,331310,331310,331312,0,2,3
94665,5,3,331315,331315,331318,0,3,3
94666,1,1,331316,331318,331319,2,3,0
94667,1,1,331317,331319,331320,2,3,0
94668,6,3,331323,331323,331326,0,3,3
94669,4,3,331327,331327,331330,0,3,1
94670,4,3,331331,331331,331334,0,3,1
94671,5,2,331336,331336,331338,0,2,2
94672,6,1,331342,331342,331343,0,1,4
94673,5,3,331347,331347,331350,0,3,4
94674,2,1,331349,331350,331351,1,2,0
94675,5,1,331354,331354,331355,0,1,3
94676,1,1,331355,331355,331356,0,1,0
94677,4,3,331359,331359,331362,0,3,3
94678,1,2,331360,331362,331364,2,4,0
94679,5,1,331365,331365,331366,0,1,1
94680,4,2,331369,331369,331371,0,2,3
94681,2,2,331371,331371,331373,0,2,0
94682,3,2,331374,331374,331376,0,2,1
94683,4,3,331378,331378,331381,0,3,2
94684,1,1,331379,331381,331382,2,3,0
94685,2,3,331381,331382,331385,1,4,0
94686,5,2,331386,331386,331388,0,2,1
94687,6,1,331392,331392,331393,0,1,4
94688,3,3,331395,331395,331398,0,3,2
94689,4,1,331399,331399,331400,0,1,1
94690,2,3,331401,331401,331404,0,3,1
94691,1,3,331402,331404,331407,2,5,0
94692,6,1,331408,331408,331409,0,1,1
94693,2,1,331410,331410,331411,0,1,1
94694,3,1,331413,331413,331414,0,1,2
94695,4,2,331417,331417,331419,0,2,3
94696,5,3,331422,331422,331425,0,3,3
94697,2,2,331424,331425,331427,1,3,0
94698,4,3,331428,331428,331431,0,3,1
94699,5,2,331433,331433,331435,0,2,2
94700,5,3,331438,331438,331441,0,3,3
94701,1,3,331439,331441,331444,2,5,0
94702,2,3,331441,331444,331447,3,6,0
94703,4,3,331445,331447,331450,2,5,0
94704,4,1,331449,331450,331451,1,2,0
94705,2,2,331451,331451,331453,0,2,0
94706,5,1,331456,331456,331457,0,1,3
94707,4,1,331460,331460,331461,0,1,3
94708,1,1,331461,331461,331462,0,1,0
94709,3,1,331464,331464,331465,0,1,2
94710,4,3,331468,331468,331471,0,3,3
94711,4,2,331472,331472,331474,0,2,1
94712,6,2,331478,331478,331480,0,2,4
94713,6,2,331484,331484,331486,0,2,4
94714,3,2,331487,331487,331489,0,2,1
94715,2,2,331489,331489,331491,0,2,0
94716,2,3,331491,331491,331494,0,3,0
94717,2,2,331493,331494,331496,1,3,0
94718,3,1,331496,331496,331497,0,1,0
94719,2,2,331498,331498,331500,0,2,1
94720,4,2,331502,331502,331504,0,2,2
94721,6,2,331508,331508,331510,0,2,4
94722,2,1,331510,331510,331511,0,1,0
94723,2,2,331512,331512,331514,0,2,1
94724,1,2,331513,331514,331516,1,3,0
94725,4,3,331517,331517,331520,0,3,1
94726,3,3,331520,331520,331523,0,3,0
94727,6,1,331526,331526,331527,0,1,3
94728,3,2,331529,331529,331531,0,2,2
94729,3,2,331532,331532,331534,0,2,1
94730,1,3,331533,331534,331537,1,4,0
94731,5,3,331538,331538,331541,0,3,1
94732,1,2,331539,331541,331543,2,4,0
94733,6,1,331545,331545,331546,0,1,2
94734,4,3,331549,331549,331552,0,3,3
94735,2,2,331551,331552,331554,1,3,0
94736,4,3,331555,331555,331558,0,3,1
94737,1,2,331556,331558,331560,2,4,0
94738,5,1,331561,331561,331562,0,1,1
94739,4,2,331565,331565,331567,0,2,3
94740,2,2,331567,331567,331569,0,2,0
94741,1,3,331568,331569,331572,1,4,0
94742,1,1,331569,331572,331573,3,4,0
94743,6,1,331575,331575,331576,0,1,2
94744,2,1,331577,331577,331578,0,1,1
94745,4,2,331581,331581,331583,0,2,3
94746,1,1,331582,331583,331584,1,2,0
94747,3,3,331585,331585,331588,0,3,1
94748,1,1,331586,331588,331589,2,3,0
94749,1,2,331587,331589,331591,2,4,0
94750,5,3,331592,331592,331595,0,3,1
94751,6,1,331598,331598,331599,0,1,3
94752,5,1,331603,331603,331604,0,1,4
94753,4,3,331607,331607,331610,0,3,3
94754,1,3,331608,331610,331613,2,5,0
94755,4,3,331612,331613,331616,1,4,0
94756,5,2,331617,331617,331619,0,2,1
94757,5,2,331622,331622,331624,0,2,3
94758,4,1,331626,331626,331627,0,1,2
94759,6,3,331632,331632,331635,0,3,5
94760,3,1,331635,331635,331636,0,1,0
94761,3,1,331638,331638,331639,0,1,2
94762,5,2,331643,331643,331645,0,2,4
94763,3,3,331646,331646,331649,0,3,1
94764,4,2,331650,331650,331652,0,2,1
94765,6,1,331656,331656,331657,0,1,4
94766,1,3,331657,331657,331660,0,3,0
94767,1,2,331658,331660,331662,2,4,0
94768,2,1,331660,331662,331663,2,3,0
94769,2,1,331662,331663,331664,1,2,0
94770,3,3,331665,331665,331668,0,3,1
94771,2,3,331667,331668,331671,1,4,0
94772,4,3,331671,331671,331674,0,3,0
94773,2,2,331673,331674,331676,1,3,0
94774,1,3,331674,331676,331679,2,5,0
94775,2,2,331676,331679,331681,3,5,0
94776,6,3,331682,331682,331685,0,3,1
94777,4,3,331686,331686,331689,0,3,1
94778,4,2,331690,331690,331692,0,2,1
94779,5,2,331695,331695,331697,0,2,3
94780,5,3,331700,331700,331703,0,3,3
94781,5,3,331705,331705,331708,0,3,2
94782,6,2,331711,331711,331713,0,2,3
94783,1,3,331712,331713,331716,1,4,0
94784,5,2,331717,331717,331719,0,2,1
94785,4,2,331721,331721,331723,0,2,2
94786,5,2,331726,331726,331728,0,2,3
94787,6,3,331732,331732,331735,0,3,4
94788,1,3,331733,331735,331738,2,5,0
94789,3,2,331736,331738,331740,2,4,0
94790,2,2,331738,331740,331742,2,4,0
94791,3,2,331741,331742,331744,1,3,0
94792,2,2,331743,331744,331746,1,3,0
94793,3,3,331746,331746,331749,0,3,0
94794,2,3,331748,331749,331752,1,4,0
94795,4,1,331752,331752,331753,0,1,0
94796,5,2,331757,331757,331759,0,2,4
94797,5,1,331762,331762,331763,0,1,3
94798,5,2,331767,331767,331769,0,2,4
94799,2,1,331769,331769,331770,0,1,0
94800,3,3,331772,331772,331775,0,3,2
94801,2,3,331774,331775,331778,1,4,0
94802,5,2,331779,331779,331781,0,2,1
94803,3,3,331782,331782,331785,0,3,1
94804,5,3,331787,331787,331790,0,3,2
94805,5,2,331792,331792,331794,0,2,2
94806,1,2,331793,331794,331796,1,3,0
94807,5,3,331798,331798,331801,0,3,2
94808,6,1,331804,331804,331805,0,1,3
94809,6,2,331810,331810,331812,0,2,5
94810,5,1,331815,331815,331816,0,1,3
94811,3,1,331818,331818,331819,0,1,2
94812,5,2,331823,331823,331825,0,2,4
94813,6,1,331829,331829,331830,0,1,4
94814,1,3,331830,331830,331833,0,3,0
94815,2,2,331832,331833,331835,1,3,0
94816,6,2,331838,331838,331840,0,2,3
94817,5,1,331843,331843,331844,0,1,3
94818,3,1,331846,331846,331847,0,1,2
94819,3,3,331849,331849,331852,0,3,2
94820,1,2,331850,331852,331854,2,4,0
94821,2,3,331852,331854,331857,2,5,0
94822,6,3,331858,331858,331861,0,3,1
94823,5,2,331863,331863,331865,0,2,2
94824,2,3,331865,331865,331868,0,3,0
94825,1,1,331866,331868,331869,2,3,0
94826,3,3,331869,331869,331872,0,3,0
94827,1,3,331870,331872,331875,2,5,0
94828,6,3,331876,331876,331879,0,3,1
94829,6,2,331882,331882,331884,0,2,3
94830,1,2,331883,331884,331886,1,3,0
94831,1,2,331884,331886,331888,2,4,0
94832,1,1,331885,331888,331889,3,4,0
94833,1,1,331886,331889,331890,3,4,0
94834,5,2,331891,331891,331893,0,2,1
94835,2,1,331893,331893,331894,0,1,0
94836,4,1,331897,331897,331898,0,1,3
94837,4,2,331901,331901,331903,0,2,3
94838,3,2,331904,331904,331906,0,2,1
94839,3,3,331907,331907,331910,0,3,1
94840,6,1,331913,331913,331914,0,1,3
94841,2,3,331915,331915,331918,0,3,1
94842,2,1,331917,331918,331919,1,2,0
94843,3,2,331920,331920,331922,0,2,1
94844,1,1,331921,331922,331923,1,2,0
94845,4,1,331925,331925,331926,0,1,2
94846,3,2,331928,331928,331930,0,2,2
94847,2,2,331930,331930,331932,0,2,0
94848,2,1,331932,331932,331933,0,1,0
94849,4,3,331936,331936,331939,0,3,3
94850,6,1,331942,331942,331943,0,1,3
94851,3,3,331945,331945,331948,0,3,2
94852,6,2,331951,331951,331953,0,2,3
94853,1,2,331952,331953,331955,1,3,0
94854,6,2,331958,331958,331960,0,2,3
94855,4,1,331962,331962,331963,0,1,2
94856,2,2,331964,331964,331966,0,2,1
94857,6,3,331970,331970,331973,0,3,4
94858,5,1,331975,331975,331976,0,1,2
94859,3,1,331978,331978,331979,0,1,2
94860,2,3,331980,331980,331983,0,3,1
94861,6,2,331986,331986,331988,0,2,3
94862,3,3,331989,331989,331992,0,3,1
94863,2,3,331991,331992,331995,1,4,0
94864,4,1,331995,331995,331996,0,1,0
94865,4,1,331999,331999,332000,0,1,3
94866,4,1,332003,332003,332004,0,1,3
94867,4,1,332007,332007,332008,0,1,3
94868,3,2,332010,332010,332012,0,2,2
94869,4,3,332014,332014,332017,0,3,2
94870,4,1,332018,332018,332019,0,1,1
94871,3,2,332021,332021,332023,0,2,2
94872,3,3,332024,332024,332027,0,3,1
94873,5,3,332029,332029,332032,0,3,2
94874,2,3,332031,332032,332035,1,4,0
94875,2,3,332033,332035,332038,2,5,0
94876,3,3,332036,332038,332041,2,5,0
94877,4,2,332040,332041,332043,1,3,0
94878,2,1,332042,332043,332044,1,2,0
94879,6,2,332048,332048,332050,0,2,4
94880,1,3,332049,332050,332053,1,4,0
94881,3,3,332052,332053,332056,1,4,0
94882,3,1,332055,332056,332057,1,2,0
94883,4,1,332059,332059,332060,0,1,2
94884,1,2,332060,332060,332062,0,2,0
94885,6,3,332066,332066,332069,0,3,4
94886,5,1,332071,332071,332072,0,1,2
94887,2,1,332073,332073,332074,0,1,1
94888,3,3,332076,332076,332079,0,3,2
94889,5,2,332081,332081,332083,0,2,2
94890,5,1,332086,332086,332087,0,1,3
94891,6,3,332092,332092,332095,0,3,5
94892,1,2,332093,332095,332097,2,4,0
94893,2,2,332095,332097,332099,2,4,0
94894,6,1,332101,332101,332102,0,1,2
94895,4,2,332105,332105,332107,0,2,3
94896,6,3,332111,332111,332114,0,3,4
94897,5,2,332116,332116,332118,0,2,2
94898,4,1,332120,332120,332121,0,1,2
94899,2,2,332122,332122,332124,0,2,1
94900,6,2,332128,332128,332130,0,2,4
94901,6,3,332134,332134,332137,0,3,4
94902,4,2,332138,332138,332140,0,2,1
94903,6,1,332144,332144,332145,0,1,4
94904,1,3,332145,332145,332148,0,3,0
94905,6,3,332151,332151,332154,0,3,3
94906,4,2,332155,332155,332157,0,2,1
94907,1,2,332156,332157,332159,1,3,0
94908,2,3,332158,332159,332162,1,4,0
94909,3,3,332161,332162,332165,1,4,0
94910,5,3,332166,332166,332169,0,3,1
94911,1,1,332167,332169,332170,2,3,0
94912,5,1,332172,332172,332173,0,1,2
94913,1,1,332173,332173,332174,0,1,0
94914,2,2,332175,332175,332177,0,2,1
94915,6,1,332181,332181,332182,0,1,4
94916,5,3,332186,332186,332189,0,3,4
94917,6,2,332192,332192,332194,0,2,3
94918,4,1,332196,332196,332197,0,1,2
94919,3,1,332199,332199,332200,0,1,2
94920,4,1,332203,332203,332204,0,1,3
94921,6,2,332209,332209,332211,0,2,5
94922,6,1,332215,332215,332216,0,1,4
94923,6,1,332221,332221,332222,0,1,5
94924,4,2,332225,332225,332227,0,2,3
94925,6,1,332231,332231,332232,0,1,4
94926,6,3,332237,332237,332240,0,3,5
94927,4,3,332241,332241,332244,0,3,1
94928,1,1,332242,332244,332245,2,3,0
94929,4,2,332246,332246,332248,0,2,1
94930,2,1,332248,332248,332249,0,1,0
94931,1,1,332249,332249,332250,0,1,0
94932,2,3,332251,332251,332254,0,3,1
94933,4,2,332255,332255,332257,0,2,1
94934,1,3,332256,332257,332260,1,4,0
94935,2,3,332258,332260,332263,2,5,0
94936,6,1,332264,332264,332265,0,1,1
94937,2,2,332266,332266,332268,0,2,1
94938,5,2,332271,332271,332273,0,2,3
94939,5,1,332276,332276,332277,0,1,3
94940,4,3,332280,332280,332283,0,3,3
94941,4,1,332284,332284,332285,0,1,1
94942,5,2,332289,332289,332291,0,2,4
94943,1,3,332290,332291,332294,1,4,0
94944,5,3,332295,332295,332298,0,3,1
94945,4,1,332299,332299,332300,0,1,1
94946,2,3,332301,332301,332304,0,3,1
94947,3,1,332304,332304,332305,0,1,0
94948,3,1,332307,332307,332308,0,1,2
94949,2,1,332309,332309,332310,0,1,1
94950,5,1,332314,332314,332315,0,1,4
94951,3,1,332317,332317,332318,0,1,2
94952,4,3,332321,332321,332324,0,3,3
94953,6,3,332327,332327,332330,0,3,3
94954,3,2,332330,332330,332332,0,2,0
94955,6,3,332336,332336,332339,0,3,4
94956,2,2,332338,332339,332341,1,3,0
94957,2,2,332340,332341,332343,1,3,0
94958,6,1,332346,332346,332347,0,1,3
94959,1,2,332347,332347,332349,0,2,0
94960,4,3,332351,332351,332354,0,3,2
94961,3,2,332354,332354,332356,0,2,0
94962,3,1,332357,332357,332358,0,1,1
94963,3,3,332360,332360,332363,0,3,2
94964,4,3,332364,332364,332367,0,3,1
94965,6,2,332370,332370,332372,0,2,3
94966,3,1,332373,332373,332374,0,1,1
94967,5,1,332378,332378,332379,0,1,4
94968,3,3,332381,332381,332384,0,3,2
94969,1,3,332382,332384,332387,2,5,0
94970,2,1,332384,332387,332388,3,4,0
94971,4,2,332388,332388,332390,0,2,0
94972,5,1,332393,332393,332394,0,1,3
94973,6,3,332399,332399,332402,0,3,5
94974,4,3,332403,332403,332406,0,3,1
94975,1,2,332404,332406,332408,2,4,0
94976,2,3,332406,332408,332411,2,5,0
94977,6,2,332412,332412,332414,0,2,1
94978,6,1,332418,332418,332419,0,1,4
94979,1,2,332419,332419,332421,0,2,0
94980,5,2,332424,332424,332426,0,2,3
94981,5,2,332429,332429,332431,0,2,3
94982,1,1,332430,332431,332432,1,2,0
94983,2,2,332432,332432,332434,0,2,0
94984,3,1,332435,332435,332436,0,1,1
94985,6,3,332441,332441,332444,0,3,5
94986,3,3,332444,332444,332447,0,3,0
94987,3,3,332447,332447,332450,0,3,0
94988,4,2,332451,332451,332453,0,2,1
94989,5,1,332456,332456,332457,0,1,3
94990,4,3,332460,332460,332463,0,3,3
94991,5,3,332465,332465,332468,0,3,2
94992,3,3,332468,332468,332471,0,3,0
94993,5,1,332473,332473,332474,0,1,2
94994,2,3,332475,332475,332478,0,3,1
94995,3,2,332478,332478,332480,0,2,0
94996,6,1,332484,332484,332485,0,1,4
94997,3,3,332487,332487,332490,0,3,2
94998,2,3,332489,332490,332493,1,4,0
94999,6,1,332495,332495,332496,0,1,2
95000,2,1,332497,332497,332498,0,1,1
95001,6,2,332503,332503,332505,0,2,5
95002,5,2,332508,332508,332510,0,2,3
95003,1,1,332509,332510,332511,1,2,0
95004,5,1,332514,332514,332515,0,1,3
95005,6,2,332520,332520,332522,0,2,5
95006,4,2,332524,332524,332526,0,2,2
95007,4,2,332528,332528,332530,0,2,2
95008,6,2,332534,332534,332536,0,2,4
95009,6,2,332540,332540,332542,0,2,4
95010,2,1,332542,332542,332543,0,1,0
95011,4,3,332546,332546,332549,0,3,3
95012,1,2,332547,332549,332551,2,4,0
95013,6,2,332553,332553,332555,0,2,2
95014,5,1,332558,332558,332559,0,1,3
95015,6,1,332564,332564,332565,0,1,5
95016,2,2,332566,332566,332568,0,2,1
95017,4,2,332570,332570,332572,0,2,2
95018,1,1,332571,332572,332573,1,2,0
95019,1,3,332572,332573,332576,1,4,0
95020,5,2,332577,332577,332579,0,2,1
95021,1,2,332578,332579,332581,1,3,0
95022,4,1,332582,332582,332583,0,1,1
95023,1,3,332583,332583,332586,0,3,0
95024,6,1,332589,332589,332590,0,1,3
95025,1,1,332590,332590,332591,0,1,0
95026,1,2,332591,332591,332593,0,2,0
95027,2,3,332593,332593,332596,0,3,0
95028,6,3,332599,332599,332602,0,3,3
95029,1,2,332600,332602,332604,2,4,0
95030,5,3,332605,332605,332608,0,3,1
95031,4,2,332609,332609,332611,0,2,1
95032,2,1,332611,332611,332612,0,1,0
95033,5,2,332616,332616,332618,0,2,4
95034,5,1,332621,332621,332622,0,1,3
95035,5,1,332626,332626,332627,0,1,4
95036,5,1,332631,332631,332632,0,1,4
95037,3,3,332634,332634,332637,0,3,2
95038,6,3,332640,332640,332643,0,3,3
95039,5,2,332645,332645,332647,0,2,2
95040,6,1,332651,332651,332652,0,1,4
95041,6,2,332657,332657,332659,0,2,5
95042,4,3,332661,332661,332664,0,3,2
95043,5,2,332666,332666,332668,0,2,2
95044,4,3,332670,332670,332673,0,3,2
95045,5,1,332675,332675,332676,0,1,2
95046,6,3,332681,332681,332684,0,3,5
95047,5,1,332686,332686,332687,0,1,2
95048,5,2,332691,332691,332693,0,2,4
95049,4,1,332695,332695,332696,0,1,2
95050,2,1,332697,332697,332698,0,1,1
95051,5,2,332702,332702,332704,0,2,4
95052,2,3,332704,332704,332707,0,3,0
95053,5,3,332709,332709,332712,0,3,2
95054,2,1,332711,332712,332713,1,2,0
95055,3,1,332714,332714,332715,0,1,1
95056,5,3,332719,332719,332722,0,3,4
95057,3,3,332722,332722,332725,0,3,0
95058,1,3,332723,332725,332728,2,5,0
95059,4,3,332727,332728,332731,1,4,0
95060,5,1,332732,332732,332733,0,1,1
95061,3,3,332735,332735,332738,0,3,2
95062,1,1,332736,332738,332739,2,3,0
95063,4,1,332740,332740,332741,0,1,1
95064,5,3,332745,332745,332748,0,3,4
95065,6,3,332751,332751,332754,0,3,3
95066,5,1,332756,332756,332757,0,1,2
95067,5,2,332761,332761,332763,0,2,4
95068,1,3,332762,332763,332766,1,4,0
95069,3,2,332765,332766,332768,1,3,0
95070,3,3,332768,332768,332771,0,3,0
95071,6,2,332774,332774,332776,0,2,3
95072,6,3,332780,332780,332783,0,3,4
95073,6,2,332786,332786,332788,0,2,3
95074,1,2,332787,332788,332790,1,3,0
95075,3,1,332790,332790,332791,0,1,0
95076,1,1,332791,332791,332792,0,1,0
95077,5,2,332796,332796,332798,0,2,4
95078,3,3,332799,332799,332802,0,3,1
95079,6,3,332805,332805,332808,0,3,3
95080,2,2,332807,332808,332810,1,3,0
95081,6,2,332813,332813,332815,0,2,3
95082,6,2,332819,332819,332821,0,2,4
95083,5,2,332824,332824,332826,0,2,3
95084,2,1,332826,332826,332827,0,1,0
95085,3,2,332829,332829,332831,0,2,2
95086,6,1,332835,332835,332836,0,1,4
95087,4,2,332839,332839,332841,0,2,3
95088,4,2,332843,332843,332845,0,2,2
95089,6,2,332849,332849,332851,0,2,4
95090,3,3,332852,332852,332855,0,3,1
95091,3,1,332855,332855,332856,0,1,0
95092,5,2,332860,332860,332862,0,2,4
95093,2,1,332862,332862,332863,0,1,0
95094,6,3,332868,332868,332871,0,3,5
95095,4,2,332872,332872,332874,0,2,1
95096,4,3,332876,332876,332879,0,3,2
95097,6,3,332882,332882,332885,0,3,3
95098,1,2,332883,332885,332887,2,4,0
95099,2,2,332885,332887,332889,2,4,0
95100,6,3,332891,332891,332894,0,3,2
95101,6,1,332897,332897,332898,0,1,3
95102,6,3,332903,332903,332906,0,3,5
95103,3,3,332906,332906,332909,0,3,0
95104,1,3,332907,332909,332912,2,5,0
95105,6,1,332913,332913,332914,0,1,1
95106,5,2,332918,332918,332920,0,2,4
95107,2,3,332920,332920,332923,0,3,0
95108,6,3,332926,332926,332929,0,3,3
95109,4,1,332930,332930,332931,0,1,1
95110,6,3,332936,332936,332939,0,3,5
95111,1,3,332937,332939,332942,2,5,0
95112,1,1,332938,332942,332943,4,5,0
95113,1,2,332939,332943,332945,4,6,0
95114,6,2,332945,332945,332947,0,2,0
95115,2,3,332947,332947,332950,0,3,0
95116,2,1,332949,332950,332951,1,2,0
95117,1,2,332950,332951,332953,1,3,0
95118,4,3,332954,332954,332957,0,3,1
95119,4,1,332958,332958,332959,0,1,1
95120,4,1,332962,332962,332963,0,1,3
95121,2,1,332964,332964,332965,0,1,1
95122,2,1,332966,332966,332967,0,1,1
95123,4,3,332970,332970,332973,0,3,3
95124,2,3,332972,332973,332976,1,4,0
95125,2,3,332974,332976,332979,2,5,0
95126,3,2,332977,332979,332981,2,4,0
95127,3,1,332980,332981,332982,1,2,0
95128,5,3,332985,332985,332988,0,3,3
95129,1,1,332986,332988,332989,2,3,0
95130,3,2,332989,332989,332991,0,2,0
95131,2,2,332991,332991,332993,0,2,0
95132,5,3,332996,332996,332999,0,3,3
95133,2,2,332998,332999,333001,1,3,0
95134,4,3,333002,333002,333005,0,3,1
95135,1,2,333003,333005,333007,2,4,0
95136,4,1,333007,333007,333008,0,1,0
95137,2,1,333009,333009,333010,0,1,1
95138,4,2,333013,333013,333015,0,2,3
95139,6,1,333019,333019,333020,0,1,4
95140,2,1,333021,333021,333022,0,1,1
95141,3,3,333024,333024,333027,0,3,2
95142,4,2,333028,333028,333030,0,2,1
95143,1,3,333029,333030,333033,1,4,0
95144,6,2,333035,333035,333037,0,2,2
95145,1,3,333036,333037,333040,1,4,0
95146,2,1,333038,333040,333041,2,3,0
95147,2,3,333040,333041,333044,1,4,0
95148,3,3,333043,333044,333047,1,4,0
95149,4,1,333047,333047,333048,0,1,0
95150,4,3,333051,333051,333054,0,3,3
95151,4,2,333055,333055,333057,0,2,1
95152,6,2,333061,333061,333063,0,2,4
95153,2,3,333063,333063,333066,0,3,0
95154,1,2,333064,333066,333068,2,4,0
95155,6,1,333070,333070,333071,0,1,2
95156,2,1,333072,333072,333073,0,1,1
95157,4,3,333076,333076,333079,0,3,3
95158,4,1,333080,333080,333081,0,1,1
95159,2,3,333082,333082,333085,0,3,1
95160,1,1,333083,333085,333086,2,3,0
95161,2,3,333085,333086,333089,1,4,0
95162,4,3,333089,333089,333092,0,3,0
95163,5,1,333094,333094,333095,0,1,2
95164,2,1,333096,333096,333097,0,1,1
95165,3,2,333099,333099,333101,0,2,2
95166,1,1,333100,333101,333102,1,2,0
95167,1,1,333101,333102,333103,1,2,0
95168,4,3,333105,333105,333108,0,3,2
95169,1,3,333106,333108,333111,2,5,0
95170,4,3,333110,333111,333114,1,4,0
95171,2,3,333112,333114,333117,2,5,0
95172,5,3,333117,333117,333120,0,3,0
95173,5,3,333122,333122,333125,0,3,2
95174,2,1,333124,333125,333126,1,2,0
95175,1,2,333125,333126,333128,1,3,0
95176,1,1,333126,333128,333129,2,3,0
95177,6,2,333132,333132,333134,0,2,3
95178,6,2,333138,333138,333140,0,2,4
95179,4,2,333142,333142,333144,0,2,2
95180,5,3,333147,333147,333150,0,3,3
95181,2,1,333149,333150,333151,1,2,0
95182,2,3,333151,333151,333154,0,3,0
95183,1,3,333152,333154,333157,2,5,0
95184,6,3,333158,333158,333161,0,3,1
95185,4,1,333162,333162,333163,0,1,1
95186,4,3,333166,333166,333169,0,3,3
95187,5,3,333171,333171,333174,0,3,2
95188,6,1,333177,333177,333178,0,1,3
95189,3,3,333180,333180,333183,0,3,2
95190,4,1,333184,333184,333185,0,1,1
95191,4,2,333188,333188,333190,0,2,3
95192,2,3,333190,333190,333193,0,3,0
95193,3,2,333193,333193,333195,0,2,0
95194,1,1,333194,333195,333196,1,2,0
95195,6,2,333200,333200,333202,0,2,4
95196,5,2,333205,333205,333207,0,2,3
95197,3,1,333208,333208,333209,0,1,1
95198,4,3,333212,333212,333215,0,3,3
95199,6,2,333218,333218,333220,0,2,3
95200,3,2,333221,333221,333223,0,2,1
95201,1,3,333222,333223,333226,1,4,0
95202,1,2,333223,333226,333228,3,5,0
95203,4,1,333227,333228,333229,1,2,0
95204,3,1,333230,333230,333231,0,1,1
95205,4,2,333234,333234,333236,0,2,3
95206,1,1,333235,333236,333237,1,2,0
95207,5,2,333240,333240,333242,0,2,3
95208,2,1,333242,333242,333243,0,1,0
95209,4,3,333246,333246,333249,0,3,3
95210,4,2,333250,333250,333252,0,2,1
95211,4,2,333254,333254,333256,0,2,2
95212,2,1,333256,333256,333257,0,1,0
95213,1,2,333257,333257,333259,0,2,0
95214,3,3,333260,333260,333263,0,3,1
95215,2,3,333262,333263,333266,1,4,0
95216,1,1,333263,333266,333267,3,4,0
95217,1,1,333264,333267,333268,3,4,0
95218,3,2,333267,333268,333270,1,3,0
95219,5,3,333272,333272,333275,0,3,2
95220,4,2,333276,333276,333278,0,2,1
95221,3,2,333279,333279,333281,0,2,1
95222,5,1,333284,333284,333285,0,1,3
95223,1,2,333285,333285,333287,0,2,0
95224,5,1,333290,333290,333291,0,1,3
95225,4,1,333294,333294,333295,0,1,3
95226,1,1,333295,333295,333296,0,1,0
95227,1,3,333296,333296,333299,0,3,0
95228,5,2,333301,333301,333303,0,2,2
95229,5,1,333306,333306,333307,0,1,3
95230,5,2,333311,333311,333313,0,2,4
95231,6,3,333317,333317,333320,0,3,4
95232,3,2,333320,333320,333322,0,2,0
95233,3,1,333323,333323,333324,0,1,1
95234,3,1,333326,333326,333327,0,1,2
95235,4,2,333330,333330,333332,0,2,3
95236,4,1,333334,333334,333335,0,1,2
95237,1,3,333335,333335,333338,0,3,0
95238,6,1,333341,333341,333342,0,1,3
95239,6,2,333347,333347,333349,0,2,5
95240,4,2,333351,333351,333353,0,2,2
95241,3,1,333354,333354,333355,0,1,1
95242,6,2,333360,333360,333362,0,2,5
95243,6,3,333366,333366,333369,0,3,4
95244,6,2,333372,333372,333374,0,2,3
95245,3,1,333375,333375,333376,0,1,1
95246,2,2,333377,333377,333379,0,2,1
95247,2,1,333379,333379,333380,0,1,0
95248,4,3,333383,333383,333386,0,3,3
95249,4,3,333387,333387,333390,0,3,1
95250,2,2,333389,333390,333392,1,3,0
95251,4,1,333393,333393,333394,0,1,1
95252,6,1,333399,333399,333400,0,1,5
95253,2,1,333401,333401,333402,0,1,1
95254,1,2,333402,333402,333404,0,2,0
95255,4,1,333406,333406,333407,0,1,2
95256,4,3,333410,333410,333413,0,3,3
95257,1,2,333411,333413,333415,2,4,0
95258,4,3,333415,333415,333418,0,3,0
95259,4,1,333419,333419,333420,0,1,1
95260,5,3,333424,333424,333427,0,3,4
95261,1,1,333425,333427,333428,2,3,0
95262,3,3,333428,333428,333431,0,3,0
95263,1,1,333429,333431,333432,2,3,0
95264,5,1,333434,333434,333435,0,1,2
95265,6,3,333440,333440,333443,0,3,5
95266,5,1,333445,333445,333446,0,1,2
95267,1,2,333446,333446,333448,0,2,0
95268,4,3,333450,333450,333453,0,3,2
95269,3,1,333453,333453,333454,0,1,0
95270,6,2,333459,333459,333461,0,2,5
95271,3,3,333462,333462,333465,0,3,1
95272,5,1,333467,333467,333468,0,1,2
95273,2,2,333469,333469,333471,0,2,1
95274,1,3,333470,333471,333474,1,4,0
95275,5,2,333475,333475,333477,0,2,1
95276,4,2,333479,333479,333481,0,2,2
95277,3,1,333482,333482,333483,0,1,1
95278,1,3,333483,333483,333486,0,3,0
95279,3,3,333486,333486,333489,0,3,0
95280,5,3,333491,333491,333494,0,3,2
95281,5,3,333496,333496,333499,0,3,2
95282,2,1,333498,333499,333500,1,2,0
95283,2,2,333500,333500,333502,0,2,0
95284,6,2,333506,333506,333508,0,2,4
95285,3,3,333509,333509,333512,0,3,1
95286,1,2,333510,333512,333514,2,4,0
95287,1,3,333511,333514,333517,3,6,0
95288,5,3,333516,333517,333520,1,4,0
95289,1,2,333517,333520,333522,3,5,0
95290,2,1,333519,333522,333523,3,4,0
95291,4,1,333523,333523,333524,0,1,0
95292,6,3,333529,333529,333532,0,3,5
95293,3,2,333532,333532,333534,0,2,0
95294,1,1,333533,333534,333535,1,2,0
95295,5,1,333538,333538,333539,0,1,3
95296,6,3,333544,333544,333547,0,3,5
95297,4,2,333548,333548,333550,0,2,1
95298,5,2,333553,333553,333555,0,2,3
95299,1,3,333554,333555,333558,1,4,0
95300,2,3,333556,333558,333561,2,5,0
95301,4,1,333560,333561,333562,1,2,0
95302,4,2,333564,333564,333566,0,2,2
95303,3,3,333567,333567,333570,0,3,1
95304,6,3,333573,333573,333576,0,3,3
95305,2,1,333575,333576,333577,1,2,0
95306,4,1,333579,333579,333580,0,1,2
95307,6,3,333585,333585,333588,0,3,5
95308,6,1,333591,333591,333592,0,1,3
95309,5,2,333596,333596,333598,0,2,4
95310,1,3,333597,333598,333601,1,4,0
95311,1,2,333598,333601,333603,3,5,0
95312,6,1,333604,333604,333605,0,1,1
95313,6,2,333610,333610,333612,0,2,5
95314,4,3,333614,333614,333617,0,3,2
95315,2,2,333616,333617,333619,1,3,0
95316,6,3,333622,333622,333625,0,3,3
95317,2,3,333624,333625,333628,1,4,0
95318,5,2,333629,333629,333631,0,2,1
95319,2,2,333631,333631,333633,0,2,0
95320,5,1,333636,333636,333637,0,1,3
95321,2,2,333638,333638,333640,0,2,1
95322,5,3,333643,333643,333646,0,3,3
95323,6,2,333649,333649,333651,0,2,3
95324,5,3,333654,333654,333657,0,3,3
95325,6,2,333660,333660,333662,0,2,3
95326,3,2,333663,333663,333665,0,2,1
95327,4,1,333667,333667,333668,0,1,2
95328,5,1,333672,333672,333673,0,1,4
95329,6,1,333678,333678,333679,0,1,5
95330,3,3,333681,333681,333684,0,3,2
95331,1,2,333682,333684,333686,2,4,0
95332,2,1,333684,333686,333687,2,3,0
95333,3,3,333687,333687,333690,0,3,0
95334,3,3,333690,333690,333693,0,3,0
95335,2,3,333692,333693,333696,1,4,0
95336,2,2,333694,333696,333698,2,4,0
95337,5,3,333699,333699,333702,0,3,1
95338,4,3,333703,333703,333706,0,3,1
95339,4,3,333707,333707,333710,0,3,1
95340,6,2,333713,333713,333715,0,2,3
95341,6,2,333719,333719,333721,0,2,4
95342,2,1,333721,333721,333722,0,1,0
95343,3,3,333724,333724,333727,0,3,2
95344,2,2,333726,333727,333729,1,3,0
95345,2,1,333728,333729,333730,1,2,0
95346,2,3,333730,333730,333733,0,3,0
95347,4,3,333734,333734,333737,0,3,1
95348,5,1,333739,333739,333740,0,1,2
95349,5,3,333744,333744,333747,0,3,4
95350,1,1,333745,333747,333748,2,3,0
95351,6,2,333751,333751,333753,0,2,3
95352,3,1,333754,333754,333755,0,1,1
95353,3,3,333757,333757,333760,0,3,2
95354,2,1,333759,333760,333761,1,2,0
95355,2,2,333761,333761,333763,0,2,0
95356,3,1,333764,333764,333765,0,1,1
95357,4,1,333768,333768,333769,0,1,3
95358,3,2,333771,333771,333773,0,2,2
95359,1,2,333772,333773,333775,1,3,0
95360,4,3,333776,333776,333779,0,3,1
95361,2,1,333778,333779,333780,1,2,0
95362,3,1,333781,333781,333782,0,1,1
95363,5,3,333786,333786,333789,0,3,4
95364,2,1,333788,333789,333790,1,2,0
95365,3,2,333791,333791,333793,0,2,1
95366,3,1,333794,333794,333795,0,1,1
95367,2,1,333796,333796,333797,0,1,1
95368,3,2,333799,333799,333801,0,2,2
95369,6,3,333805,333805,333808,0,3,4
95370,3,1,333808,333808,333809,0,1,0
95371,4,1,333812,333812,333813,0,1,3
95372,4,3,333816,333816,333819,0,3,3
95373,1,1,333817,333819,333820,2,3,0
95374,5,1,333822,333822,333823,0,1,2
95375,1,3,333823,333823,333826,0,3,0
95376,4,3,333827,333827,333830,0,3,1
95377,4,3,333831,333831,333834,0,3,1
95378,4,3,333835,333835,333838,0,3,1
95379,5,3,333840,333840,333843,0,3,2
95380,4,3,333844,333844,333847,0,3,1
95381,3,3,333847,333847,333850,0,3,0
95382,4,3,333851,333851,333854,0,3,1
95383,6,1,333857,333857,333858,0,1,3
95384,5,3,333862,333862,333865,0,3,4
95385,1,3,333863,333865,333868,2,5,0
95386,5,2,333868,333868,333870,0,2,0
95387,2,1,333870,333870,333871,0,1,0
95388,3,1,333873,333873,333874,0,1,2
95389,2,2,333875,333875,333877,0,2,1
95390,3,3,333878,333878,333881,0,3,1
95391,2,2,333880,333881,333883,1,3,0
95392,5,1,333885,333885,333886,0,1,2
95393,3,1,333888,333888,333889,0,1,2
95394,2,3,333890,333890,333893,0,3,1
95395,3,3,333893,333893,333896,0,3,0
95396,3,3,333896,333896,333899,0,3,0
95397,3,3,333899,333899,333902,0,3,0
95398,3,2,333902,333902,333904,0,2,0
95399,6,3,333908,333908,333911,0,3,4
95400,1,1,333909,333911,333912,2,3,0
95401,6,3,333915,333915,333918,0,3,3
95402,1,1,333916,333918,333919,2,3,0
95403,4,3,333920,333920,333923,0,3,1
95404,4,2,333924,333924,333926,0,2,1
95405,6,2,333930,333930,333932,0,2,4
95406,6,3,333936,333936,333939,0,3,4
95407,1,1,333937,333939,333940,2,3,0
95408,3,3,333940,333940,333943,0,3,0
95409,2,1,333942,333943,333944,1,2,0
95410,1,1,333943,333944,333945,1,2,0
95411,6,3,333949,333949,333952,0,3,4
95412,2,1,333951,333952,333953,1,2,0
95413,1,2,333952,333953,333955,1,3,0
95414,4,1,333956,333956,333957,0,1,1
95415,4,3,333960,333960,333963,0,3,3
95416,6,2,333966,333966,333968,0,2,3
95417,3,2,333969,333969,333971,0,2,1
95418,2,1,333971,333971,333972,0,1,0
95419,6,3,333977,333977,333980,0,3,5
95420,3,1,333980,333980,333981,0,1,0
95421,2,3,333982,333982,333985,0,3,1
95422,6,2,333988,333988,333990,0,2,3
95423,6,2,333994,333994,333996,0,2,4
95424,4,2,333998,333998,334000,0,2,2
95425,2,1,334000,334000,334001,0,1,0
95426,2,2,334002,334002,334004,0,2,1
95427,4,1,334006,334006,334007,0,1,2
95428,6,2,334012,334012,334014,0,2,5
95429,6,1,334018,334018,334019,0,1,4
95430,2,3,334020,334020,334023,0,3,1
95431,5,2,334025,334025,334027,0,2,2
95432,6,1,334031,334031,334032,0,1,4
95433,3,1,334034,334034,334035,0,1,2
95434,6,3,334040,334040,334043,0,3,5
95435,4,1,334044,334044,334045,0,1,1
95436,5,2,334049,334049,334051,0,2,4
95437,5,2,334054,334054,334056,0,2,3
95438,5,3,334059,334059,334062,0,3,3
95439,3,3,334062,334062,334065,0,3,0
95440,2,2,334064,334065,334067,1,3,0
95441,2,3,334066,334067,334070,1,4,0
95442,5,2,334071,334071,334073,0,2,1
95443,3,2,334074,334074,334076,0,2,1
95444,4,3,334078,334078,334081,0,3,2
95445,5,3,334083,334083,334086,0,3,2
95446,1,2,334084,334086,334088,2,4,0
95447,2,3,334086,334088,334091,2,5,0
95448,6,1,334092,334092,334093,0,1,1
95449,4,3,334096,334096,334099,0,3,3
95450,2,2,334098,334099,334101,1,3,0
95451,2,2,334100,334101,334103,1,3,0
95452,1,3,334101,334103,334106,2,5,0
95453,3,1,334104,334106,334107,2,3,0
95454,3,1,334107,334107,334108,0,1,0
95455,1,1,334108,334108,334109,0,1,0
95456,2,2,334110,334110,334112,0,2,1
95457,5,2,334115,334115,334117,0,2,3
95458,2,2,334117,334117,334119,0,2,0
95459,3,1,334120,334120,334121,0,1,1
95460,5,1,334125,334125,334126,0,1,4
95461,5,2,334130,334130,334132,0,2,4
95462,6,3,334136,334136,334139,0,3,4
95463,5,1,334141,334141,334142,0,1,2
95464,1,2,334142,334142,334144,0,2,0
95465,3,3,334145,334145,334148,0,3,1
95466,5,1,334150,334150,334151,0,1,2
95467,1,2,334151,334151,334153,0,2,0
95468,4,1,334155,334155,334156,0,1,2
95469,1,1,334156,334156,334157,0,1,0
95470,1,2,334157,334157,334159,0,2,0
95471,3,3,334160,334160,334163,0,3,1
95472,3,2,334163,334163,334165,0,2,0
95473,5,1,334168,334168,334169,0,1,3
95474,1,3,334169,334169,334172,0,3,0
95475,3,1,334172,334172,334173,0,1,0
95476,1,1,334173,334173,334174,0,1,0
95477,2,2,334175,334175,334177,0,2,1
95478,3,3,334178,334178,334181,0,3,1
95479,2,2,334180,334181,334183,1,3,0
95480,6,1,334186,334186,334187,0,1,3
95481,4,1,334190,334190,334191,0,1,3
95482,2,3,334192,334192,334195,0,3,1
95483,4,2,334196,334196,334198,0,2,1
95484,5,1,334201,334201,334202,0,1,3
95485,2,3,334203,334203,334206,0,3,1
95486,6,2,334209,334209,334211,0,2,3
95487,1,1,334210,334211,334212,1,2,0
95488,6,3,334216,334216,334219,0,3,4
95489,3,1,334219,334219,334220,0,1,0
95490,3,3,334222,334222,334225,0,3,2
95491,5,3,334227,334227,334230,0,3,2
95492,4,3,334231,334231,334234,0,3,1
95493,6,1,334237,334237,334238,0,1,3
95494,3,2,334240,334240,334242,0,2,2
95495,3,1,334243,334243,334244,0,1,1
95496,6,3,334249,334249,334252,0,3,5
95497,2,2,334251,334252,334254,1,3,0
95498,4,2,334255,334255,334257,0,2,1
95499,2,2,334257,334257,334259,0,2,0
95500,1,2,334258,334259,334261,1,3,0
95501,1,3,334259,334261,334264,2,5,0
95502,3,2,334262,334264,334266,2,4,0
95503,2,3,334264,334266,334269,2,5,0
95504,5,2,334269,334269,334271,0,2,0
95505,6,2,334275,334275,334277,0,2,4
95506,5,1,334280,334280,334281,0,1,3
95507,3,3,334283,334283,334286,0,3,2
95508,1,1,334284,334286,334287,2,3,0
95509,1,2,334285,334287,334289,2,4,0
95510,5,2,334290,334290,334292,0,2,1
95511,4,2,334294,334294,334296,0,2,2
95512,5,1,334299,334299,334300,0,1,3
95513,3,1,334302,334302,334303,0,1,2
95514,5,3,334307,334307,334310,0,3,4
95515,1,3,334308,334310,334313,2,5,0
95516,4,1,334312,334313,334314,1,2,0
95517,2,2,334314,334314,334316,0,2,0
95518,6,2,334320,334320,334322,0,2,4
95519,2,3,334322,334322,334325,0,3,0
95520,6,3,334328,334328,334331,0,3,3
95521,3,2,334331,334331,334333,0,2,0
95522,2,2,334333,334333,334335,0,2,0
95523,2,3,334335,334335,334338,0,3,0
95524,3,1,334338,334338,334339,0,1,0
95525,2,2,334340,334340,334342,0,2,1
95526,3,1,334343,334343,334344,0,1,1
95527,6,1,334349,334349,334350,0,1,5
95528,1,1,334350,334350,334351,0,1,0
95529,1,3,334351,334351,334354,0,3,0
95530,4,3,334355,334355,334358,0,3,1
95531,3,3,334358,334358,334361,0,3,0
95532,5,1,334363,334363,334364,0,1,2
95533,1,2,334364,334364,334366,0,2,0
95534,6,2,334370,334370,334372,0,2,4
95535,3,3,334373,334373,334376,0,3,1
95536,1,2,334374,334376,334378,2,4,0
95537,2,1,334376,334378,334379,2,3,0
95538,4,1,334380,334380,334381,0,1,1
95539,3,1,334383,334383,334384,0,1,2
95540,5,2,334388,334388,334390,0,2,4
95541,2,2,334390,334390,334392,0,2,0
95542,2,3,334392,334392,334395,0,3,0
95543,6,2,334398,334398,334400,0,2,3
95544,6,2,334404,334404,334406,0,2,4
95545,4,1,334408,334408,334409,0,1,2
95546,6,2,334414,334414,334416,0,2,5
95547,5,1,334419,334419,334420,0,1,3
95548,4,3,334423,334423,334426,0,3,3
95549,6,1,334429,334429,334430,0,1,3
95550,5,1,334434,334434,334435,0,1,4
95551,4,1,334438,334438,334439,0,1,3
95552,3,3,334441,334441,334444,0,3,2
95553,1,3,334442,334444,334447,2,5,0
95554,2,2,334444,334447,334449,3,5,0
95555,2,3,334446,334449,334452,3,6,0
95556,1,1,334447,334452,334453,5,6,0
95557,2,1,334449,334453,334454,4,5,0
95558,1,2,334450,334454,334456,4,6,0
95559,2,1,334452,334456,334457,4,5,0
95560,3,1,334455,334457,334458,2,3,0
95561,3,3,334458,334458,334461,0,3,0
95562,4,2,334462,334462,334464,0,2,1
95563,6,1,334468,334468,334469,0,1,4
95564,4,3,334472,334472,334475,0,3,3
95565,1,1,334473,334475,334476,2,3,0
95566,5,1,334478,334478,334479,0,1,2
95567,1,3,334479,334479,334482,0,3,0
95568,2,1,334481,334482,334483,1,2,0
95569,2,3,334483,334483,334486,0,3,0
95570,3,1,334486,334486,334487,0,1,0
95571,1,3,334487,334487,334490,0,3,0
95572,5,1,334492,334492,334493,0,1,2
95573,2,3,334494,334494,334497,0,3,1
95574,6,1,334500,334500,334501,0,1,3
95575,5,2,334505,334505,334507,0,2,4
95576,6,2,334511,334511,334513,0,2,4
95577,3,3,334514,334514,334517,0,3,1
95578,1,1,334515,334517,334518,2,3,0
95579,2,3,334517,334518,334521,1,4,0
95580,3,1,334520,334521,334522,1,2,0
95581,5,2,334525,334525,334527,0,2,3
95582,5,2,334530,334530,334532,0,2,3
95583,6,1,334536,334536,334537,0,1,4
95584,3,1,334539,334539,334540,0,1,2
95585,6,1,334545,334545,334546,0,1,5
95586,3,2,334548,334548,334550,0,2,2
95587,3,3,334551,334551,334554,0,3,1
95588,1,2,334552,334554,334556,2,4,0
95589,6,2,334558,334558,334560,0,2,2
95590,1,1,334559,334560,334561,1,2,0
95591,2,2,334561,334561,334563,0,2,0
95592,6,1,334567,334567,334568,0,1,4
95593,2,2,334569,334569,334571,0,2,1
95594,2,2,334571,334571,334573,0,2,0
95595,5,3,334576,334576,334579,0,3,3
95596,5,1,334581,334581,334582,0,1,2
95597,2,2,334583,334583,334585,0,2,1
95598,3,1,334586,334586,334587,0,1,1
95599,1,2,334587,334587,334589,0,2,0
95600,5,3,334592,334592,334595,0,3,3
95601,1,1,334593,334595,334596,2,3,0
95602,4,3,334597,334597,334600,0,3,1
95603,6,1,334603,334603,334604,0,1,3
95604,3,1,334606,334606,334607,0,1,2
95605,6,1,334612,334612,334613,0,1,5
95606,6,1,334618,334618,334619,0,1,5
95607,6,2,334624,334624,334626,0,2,5
95608,6,1,334630,334630,334631,0,1,4
95609,2,1,334632,334632,334633,0,1,1
95610,5,2,334637,334637,334639,0,2,4
95611,6,2,334643,334643,334645,0,2,4
95612,1,3,334644,334645,334648,1,4,0
95613,6,3,334650,334650,334653,0,3,2
95614,3,2,334653,334653,334655,0,2,0
95615,5,1,334658,334658,334659,0,1,3
95616,1,2,334659,334659,334661,0,2,0
95617,3,1,334662,334662,334663,0,1,1
95618,5,3,334667,334667,334670,0,3,4
95619,6,2,334673,334673,334675,0,2,3
95620,5,2,334678,334678,334680,0,2,3
95621,1,1,334679,334680,334681,1,2,0
95622,6,1,334685,334685,334686,0,1,4
95623,4,3,334689,334689,334692,0,3,3
95624,1,2,334690,334692,334694,2,4,0
95625,5,3,334695,334695,334698,0,3,1
95626,4,2,334699,334699,334701,0,2,1
95627,1,1,334700,334701,334702,1,2,0
95628,1,2,334701,334702,334704,1,3,0
95629,1,1,334702,334704,334705,2,3,0
95630,6,2,334708,334708,334710,0,2,3
95631,5,1,334713,334713,334714,0,1,3
95632,4,2,334717,334717,334719,0,2,3
95633,3,3,334720,334720,334723,0,3,1
95634,1,2,334721,334723,334725,2,4,0
95635,4,3,334725,334725,334728,0,3,0
95636,6,1,334731,334731,334732,0,1,3
95637,5,1,334736,334736,334737,0,1,4
95638,1,3,334737,334737,334740,0,3,0
95639,2,2,334739,334740,334742,1,3,0
95640,6,2,334745,334745,334747,0,2,3
95641,3,3,334748,334748,334751,0,3,1
95642,3,2,334751,334751,334753,0,2,0
95643,6,3,334757,334757,334760,0,3,4
95644,6,1,334763,334763,334764,0,1,3
95645,6,1,334769,334769,334770,0,1,5
95646,2,1,334771,334771,334772,0,1,1
95647,5,2,334776,334776,334778,0,2,4
95648,2,2,334778,334778,334780,0,2,0
95649,4,1,334782,334782,334783,0,1,2
95650,3,1,334785,334785,334786,0,1,2
95651,3,1,334788,334788,334789,0,1,2
95652,6,1,334794,334794,334795,0,1,5
95653,1,3,334795,334795,334798,0,3,0
95654,6,2,334801,334801,334803,0,2,3
95655,1,3,334802,334803,334806,1,4,0
95656,2,1,334804,334806,334807,2,3,0
95657,1,1,334805,334807,334808,2,3,0
95658,2,2,334807,334808,334810,1,3,0
95659,4,1,334811,334811,334812,0,1,1
95660,4,1,334815,334815,334816,0,1,3
95661,2,1,334817,334817,334818,0,1,1
95662,2,2,334819,334819,334821,0,2,1
95663,3,3,334822,334822,334825,0,3,1
95664,1,3,334823,334825,334828,2,5,0
95665,4,3,334827,334828,334831,1,4,0
95666,3,3,334830,334831,334834,1,4,0
95667,1,1,334831,334834,334835,3,4,0
95668,2,2,334833,334835,334837,2,4,0
95669,1,1,334834,334837,334838,3,4,0
95670,4,3,334838,334838,334841,0,3,0
95671,4,1,334842,334842,334843,0,1,1
95672,3,3,334845,334845,334848,0,3,2
95673,5,2,334850,334850,334852,0,2,2
95674,6,3,334856,334856,334859,0,3,4
95675,4,3,334860,334860,334863,0,3,1
95676,4,2,334864,334864,334866,0,2,1
95677,2,2,334866,334866,334868,0,2,0
95678,6,3,334872,334872,334875,0,3,4
95679,2,2,334874,334875,334877,1,3,0
95680,6,2,334880,334880,334882,0,2,3
95681,2,1,334882,334882,334883,0,1,0
95682,5,1,334887,334887,334888,0,1,4
95683,5,2,334892,334892,334894,0,2,4
95684,1,2,334893,334894,334896,1,3,0
95685,2,3,334895,334896,334899,1,4,0
95686,1,2,334896,334899,334901,3,5,0
95687,4,1,334900,334901,334902,1,2,0
95688,1,2,334901,334902,334904,1,3,0
95689,5,2,334906,334906,334908,0,2,2
95690,2,1,334908,334908,334909,0,1,0
95691,6,3,334914,334914,334917,0,3,5
95692,6,2,334920,334920,334922,0,2,3
95693,1,3,334921,334922,334925,1,4,0
95694,2,3,334923,334925,334928,2,5,0
95695,3,3,334926,334928,334931,2,5,0
95696,4,2,334930,334931,334933,1,3,0
95697,6,2,334936,334936,334938,0,2,3
95698,1,1,334937,334938,334939,1,2,0
95699,2,3,334939,334939,334942,0,3,0
95700,2,3,334941,334942,334945,1,4,0
95701,3,2,334944,334945,334947,1,3,0
95702,1,1,334945,334947,334948,2,3,0
95703,3,3,334948,334948,334951,0,3,0
95704,4,2,334952,334952,334954,0,2,1
95705,4,2,334956,334956,334958,0,2,2
95706,3,2,334959,334959,334961,0,2,1
95707,3,3,334962,334962,334965,0,3,1
95708,5,1,334967,334967,334968,0,1,2
95709,1,1,334968,334968,334969,0,1,0
95710,3,3,334971,334971,334974,0,3,2
95711,6,2,334977,334977,334979,0,2,3
95712,5,3,334982,334982,334985,0,3,3
95713,4,2,334986,334986,334988,0,2,1
95714,1,1,334987,334988,334989,1,2,0
95715,3,1,334990,334990,334991,0,1,1
95716,5,3,334995,334995,334998,0,3,4
95717,1,3,334996,334998,335001,2,5,0
95718,1,1,334997,335001,335002,4,5,0
95719,6,3,335003,335003,335006,0,3,1
95720,2,2,335005,335006,335008,1,3,0
95721,5,1,335010,335010,335011,0,1,2
95722,1,3,335011,335011,335014,0,3,0
95723,3,1,335014,335014,335015,0,1,0
95724,5,3,335019,335019,335022,0,3,4
95725,6,3,335025,335025,335028,0,3,3
95726,3,2,335028,335028,335030,0,2,0
95727,1,3,335029,335030,335033,1,4,0
95728,1,3,335030,335033,335036,3,6,0
95729,4,2,335034,335036,335038,2,4,0
95730,5,3,335039,335039,335042,0,3,1
95731,3,2,335042,335042,335044,0,2,0
95732,1,1,335043,335044,335045,1,2,0
95733,4,2,335047,335047,335049,0,2,2
95734,3,1,335050,335050,335051,0,1,1
95735,1,1,335051,335051,335052,0,1,0
95736,5,3,335056,335056,335059,0,3,4
95737,1,1,335057,335059,335060,2,3,0
95738,5,2,335062,335062,335064,0,2,2
95739,2,3,335064,335064,335067,0,3,0
95740,1,3,335065,335067,335070,2,5,0
95741,1,2,335066,335070,335072,4,6,0
95742,4,2,335070,335072,335074,2,4,0
95743,6,1,335076,335076,335077,0,1,2
95744,6,3,335082,335082,335085,0,3,5
95745,5,1,335087,335087,335088,0,1,2
95746,2,2,335089,335089,335091,0,2,1
95747,5,2,335094,335094,335096,0,2,3
95748,1,1,335095,335096,335097,1,2,0
95749,1,2,335096,335097,335099,1,3,0
95750,5,3,335101,335101,335104,0,3,2
95751,1,1,335102,335104,335105,2,3,0
95752,4,1,335106,335106,335107,0,1,1
95753,4,2,335110,335110,335112,0,2,3
95754,3,2,335113,335113,335115,0,2,1
95755,2,3,335115,335115,335118,0,3,0
95756,3,3,335118,335118,335121,0,3,0
95757,4,2,335122,335122,335124,0,2,1
95758,1,1,335123,335124,335125,1,2,0
95759,2,2,335125,335125,335127,0,2,0
95760,1,3,335126,335127,335130,1,4,0
95761,4,1,335130,335130,335131,0,1,0
95762,1,1,335131,335131,335132,0,1,0
95763,2,2,335133,335133,335135,0,2,1
95764,4,3,335137,335137,335140,0,3,2
95765,4,1,335141,335141,335142,0,1,1
95766,3,2,335144,335144,335146,0,2,2
95767,2,2,335146,335146,335148,0,2,0
95768,3,1,335149,335149,335150,0,1,1
95769,3,3,335152,335152,335155,0,3,2
95770,5,3,335157,335157,335160,0,3,2
95771,1,1,335158,335160,335161,2,3,0
95772,2,3,335160,335161,335164,1,4,0
95773,3,3,335163,335164,335167,1,4,0
95774,5,2,335168,335168,335170,0,2,1
95775,6,3,335174,335174,335177,0,3,4
95776,3,3,335177,335177,335180,0,3,0
95777,5,2,335182,335182,335184,0,2,2
95778,6,3,335188,335188,335191,0,3,4
95779,5,2,335193,335193,335195,0,2,2
95780,6,2,335199,335199,335201,0,2,4
95781,6,2,335205,335205,335207,0,2,4
95782,4,1,335209,335209,335210,0,1,2
95783,5,3,335214,335214,335217,0,3,4
95784,4,1,335218,335218,335219,0,1,1
95785,3,3,335221,335221,335224,0,3,2
95786,6,2,335227,335227,335229,0,2,3
95787,4,3,335231,335231,335234,0,3,2
95788,1,2,335232,335234,335236,2,4,0
95789,4,3,335236,335236,335239,0,3,0
95790,6,2,335242,335242,335244,0,2,3
95791,6,1,335248,335248,335249,0,1,4
95792,1,3,335249,335249,335252,0,3,0
95793,4,1,335253,335253,335254,0,1,1
95794,5,2,335258,335258,335260,0,2,4
95795,3,2,335261,335261,335263,0,2,1
95796,4,1,335265,335265,335266,0,1,2
95797,6,3,335271,335271,335274,0,3,5
95798,2,2,335273,335274,335276,1,3,0
95799,5,2,335278,335278,335280,0,2,2
95800,2,1,335280,335280,335281,0,1,0
95801,4,3,335284,335284,335287,0,3,3
95802,5,3,335289,335289,335292,0,3,2
95803,5,3,335294,335294,335297,0,3,2
95804,6,3,335300,335300,335303,0,3,3
95805,3,2,335303,335303,335305,0,2,0
95806,3,3,335306,335306,335309,0,3,1
95807,4,3,335310,335310,335313,0,3,1
95808,5,2,335315,335315,335317,0,2,2
95809,6,1,335321,335321,335322,0,1,4
95810,6,2,335327,335327,335329,0,2,5
95811,5,1,335332,335332,335333,0,1,3
95812,4,2,335336,335336,335338,0,2,3
95813,2,3,335338,335338,335341,0,3,0
95814,4,1,335342,335342,335343,0,1,1
95815,6,1,335348,335348,335349,0,1,5
95816,2,1,335350,335350,335351,0,1,1
95817,2,2,335352,335352,335354,0,2,1
95818,1,1,335353,335354,335355,1,2,0
95819,5,2,335358,335358,335360,0,2,3
95820,5,2,335363,335363,335365,0,2,3
95821,6,1,335369,335369,335370,0,1,4
95822,3,3,335372,335372,335375,0,3,2
95823,6,3,335378,335378,335381,0,3,3
95824,4,3,335382,335382,335385,0,3,1
95825,5,1,335387,335387,335388,0,1,2
95826,2,2,335389,335389,335391,0,2,1
95827,2,1,335391,335391,335392,0,1,0
95828,3,1,335394,335394,335395,0,1,2
95829,5,1,335399,335399,335400,0,1,4
95830,1,2,335400,335400,335402,0,2,0
95831,5,2,335405,335405,335407,0,2,3
95832,4,2,335409,335409,335411,0,2,2
95833,2,1,335411,335411,335412,0,1,0
95834,6,1,335417,335417,335418,0,1,5
95835,1,2,335418,335418,335420,0,2,0
95836,2,3,335420,335420,335423,0,3,0
95837,3,3,335423,335423,335426,0,3,0
95838,1,1,335424,335426,335427,2,3,0
95839,5,3,335429,335429,335432,0,3,2
95840,3,2,335432,335432,335434,0,2,0
95841,3,2,335435,335435,335437,0,2,1
95842,4,3,335439,335439,335442,0,3,2
95843,6,3,335445,335445,335448,0,3,3
95844,1,2,335446,335448,335450,2,4,0
95845,6,1,335452,335452,335453,0,1,2
95846,6,1,335458,335458,335459,0,1,5
95847,5,2,335463,335463,335465,0,2,4
95848,2,3,335465,335465,335468,0,3,0
95849,6,3,335471,335471,335474,0,3,3
95850,3,2,335474,335474,335476,0,2,0
95851,3,1,335477,335477,335478,0,1,1
95852,6,3,335483,335483,335486,0,3,5
95853,4,1,335487,335487,335488,0,1,1
95854,2,2,335489,335489,335491,0,2,1
95855,4,3,335493,335493,335496,0,3,2
95856,4,1,335497,335497,335498,0,1,1
95857,6,2,335503,335503,335505,0,2,5
95858,1,2,335504,335505,335507,1,3,0
95859,1,1,335505,335507,335508,2,3,0
95860,6,3,335511,335511,335514,0,3,3
95861,1,2,335512,335514,335516,2,4,0
95862,3,3,335515,335516,335519,1,4,0
95863,5,3,335520,335520,335523,0,3,1
95864,4,2,335524,335524,335526,0,2,1
95865,6,1,335530,335530,335531,0,1,4
95866,2,3,335532,335532,335535,0,3,1
95867,4,3,335536,335536,335539,0,3,1
95868,4,2,335540,335540,335542,0,2,1
95869,6,1,335546,335546,335547,0,1,4
95870,5,1,335551,335551,335552,0,1,4
95871,3,3,335554,335554,335557,0,3,2
95872,3,3,335557,335557,335560,0,3,0
95873,4,2,335561,335561,335563,0,2,1
95874,4,3,335565,335565,335568,0,3,2
95875,6,3,335571,335571,335574,0,3,3
95876,6,3,335577,335577,335580,0,3,3
95877,4,1,335581,335581,335582,0,1,1
95878,6,3,335587,335587,335590,0,3,5
95879,1,3,335588,335590,335593,2,5,0
95880,2,3,335590,335593,335596,3,6,0
95881,1,1,335591,335596,335597,5,6,0
95882,5,2,335596,335597,335599,1,3,0
95883,1,1,335597,335599,335600,2,3,0
95884,6,1,335603,335603,335604,0,1,3
95885,5,3,335608,335608,335611,0,3,4
95886,6,2,335614,335614,335616,0,2,3
95887,1,1,335615,335616,335617,1,2,0
95888,5,2,335620,335620,335622,0,2,3
95889,2,2,335622,335622,335624,0,2,0
95890,4,2,335626,335626,335628,0,2,2
95891,3,1,335629,335629,335630,0,1,1
95892,3,3,335632,335632,335635,0,3,2
95893,3,2,335635,335635,335637,0,2,0
95894,4,1,335639,335639,335640,0,1,2
95895,4,2,335643,335643,335645,0,2,3
95896,1,2,335644,335645,335647,1,3,0
95897,5,2,335649,335649,335651,0,2,2
95898,5,3,335654,335654,335657,0,3,3
95899,4,3,335658,335658,335661,0,3,1
95900,5,1,335663,335663,335664,0,1,2
95901,5,2,335668,335668,335670,0,2,4
95902,6,2,335674,335674,335676,0,2,4
95903,6,3,335680,335680,335683,0,3,4
95904,2,3,335682,335683,335686,1,4,0
95905,3,3,335685,335686,335689,1,4,0
95906,4,1,335689,335689,335690,0,1,0
95907,3,1,335692,335692,335693,0,1,2
95908,1,2,335693,335693,335695,0,2,0
95909,3,2,335696,335696,335698,0,2,1
95910,5,3,335701,335701,335704,0,3,3
95911,1,3,335702,335704,335707,2,5,0
95912,1,2,335703,335707,335709,4,6,0
95913,2,3,335705,335709,335712,4,7,0
95914,6,3,335711,335712,335715,1,4,0
95915,2,3,335713,335715,335718,2,5,0
95916,5,2,335718,335718,335720,0,2,0
95917,1,3,335719,335720,335723,1,4,0
95918,4,3,335723,335723,335726,0,3,0
95919,5,3,335728,335728,335731,0,3,2
95920,5,3,335733,335733,335736,0,3,2
95921,2,3,335735,335736,335739,1,4,0
95922,2,2,335737,335739,335741,2,4,0
95923,3,2,335740,335741,335743,1,3,0
95924,1,1,335741,335743,335744,2,3,0
95925,4,1,335745,335745,335746,0,1,1
95926,1,1,335746,335746,335747,0,1,0
95927,4,2,335750,335750,335752,0,2,3
95928,6,1,335756,335756,335757,0,1,4
95929,2,3,335758,335758,335761,0,3,1
95930,3,2,335761,335761,335763,0,2,0
95931,2,2,335763,335763,335765,0,2,0
95932,2,1,335765,335765,335766,0,1,0
95933,5,2,335770,335770,335772,0,2,4
95934,3,1,335773,335773,335774,0,1,1
95935,2,1,335775,335775,335776,0,1,1
95936,2,3,335777,335777,335780,0,3,1
95937,1,1,335778,335780,335781,2,3,0
95938,2,2,335780,335781,335783,1,3,0
95939,3,3,335783,335783,335786,0,3,0
95940,3,3,335786,335786,335789,0,3,0
95941,1,1,335787,335789,335790,2,3,0
95942,5,1,335792,335792,335793,0,1,2
95943,6,2,335798,335798,335800,0,2,5
95944,4,1,335802,335802,335803,0,1,2
95945,4,3,335806,335806,335809,0,3,3
95946,2,1,335808,335809,335810,1,2,0
95947,6,2,335814,335814,335816,0,2,4
95948,3,2,335817,335817,335819,0,2,1
95949,6,2,335823,335823,335825,0,2,4
95950,1,3,335824,335825,335828,1,4,0
95951,3,2,335827,335828,335830,1,3,0
95952,6,2,335833,335833,335835,0,2,3
95953,5,1,335838,335838,335839,0,1,3
95954,3,2,335841,335841,335843,0,2,2
95955,3,2,335844,335844,335846,0,2,1
95956,6,1,335850,335850,335851,0,1,4
95957,4,2,335854,335854,335856,0,2,3
95958,1,1,335855,335856,335857,1,2,0
95959,3,1,335858,335858,335859,0,1,1
95960,2,3,335860,335860,335863,0,3,1
95961,6,3,335866,335866,335869,0,3,3
95962,6,2,335872,335872,335874,0,2,3
95963,1,2,335873,335874,335876,1,3,0
95964,2,3,335875,335876,335879,1,4,0
95965,5,2,335880,335880,335882,0,2,1
95966,5,1,335885,335885,335886,0,1,3
95967,2,1,335887,335887,335888,0,1,1
95968,1,1,335888,335888,335889,0,1,0
95969,6,1,335894,335894,335895,0,1,5
95970,5,1,335899,335899,335900,0,1,4
95971,6,1,335905,335905,335906,0,1,5
95972,2,3,335907,335907,335910,0,3,1
95973,1,3,335908,335910,335913,2,5,0
95974,2,2,335910,335913,335915,3,5,0
95975,1,1,335911,335915,335916,4,5,0
95976,5,1,335916,335916,335917,0,1,0
95977,4,2,335920,335920,335922,0,2,3
95978,3,3,335923,335923,335926,0,3,1
95979,2,3,335925,335926,335929,1,4,0
95980,6,1,335931,335931,335932,0,1,2
95981,1,2,335932,335932,335934,0,2,0
95982,2,3,335934,335934,335937,0,3,0
95983,5,3,335939,335939,335942,0,3,2
95984,1,2,335940,335942,335944,2,4,0
95985,6,3,335946,335946,335949,0,3,2
95986,3,1,335949,335949,335950,0,1,0
95987,6,3,335955,335955,335958,0,3,5
95988,4,2,335959,335959,335961,0,2,1
95989,5,3,335964,335964,335967,0,3,3
95990,2,2,335966,335967,335969,1,3,0
95991,3,2,335969,335969,335971,0,2,0
95992,3,2,335972,335972,335974,0,2,1
95993,2,2,335974,335974,335976,0,2,0
95994,5,2,335979,335979,335981,0,2,3
95995,4,3,335983,335983,335986,0,3,2
95996,1,3,335984,335986,335989,2,5,0
95997,1,1,335985,335989,335990,4,5,0
95998,1,2,335986,335990,335992,4,6,0
95999,4,2,335990,335992,335994,2,4,0
96000,4,3,335994,335994,335997,0,3,0
96001,4,3,335998,335998,336001,0,3,1
96002,3,2,336001,336001,336003,0,2,0
96003,2,3,336003,336003,336006,0,3,0
96004,6,1,336009,336009,336010,0,1,3
96005,2,2,336011,336011,336013,0,2,1
96006,6,2,336017,336017,336019,0,2,4
96007,2,3,336019,336019,336022,0,3,0
96008,5,2,336024,336024,336026,0,2,2
96009,5,2,336029,336029,336031,0,2,3
96010,4,1,336033,336033,336034,0,1,2
96011,5,2,336038,336038,336040,0,2,4
96012,2,3,336040,336040,336043,0,3,0
96013,2,3,336042,336043,336046,1,4,0
96014,4,3,336046,336046,336049,0,3,0
96015,3,3,336049,336049,336052,0,3,0
96016,4,1,336053,336053,336054,0,1,1
96017,6,3,336059,336059,336062,0,3,5
96018,3,3,336062,336062,336065,0,3,0
96019,4,3,336066,336066,336069,0,3,1
96020,1,3,336067,336069,336072,2,5,0
96021,1,3,336068,336072,336075,4,7,0
96022,4,1,336072,336075,336076,3,4,0
96023,5,1,336077,336077,336078,0,1,1
96024,4,2,336081,336081,336083,0,2,3
96025,3,3,336084,336084,336087,0,3,1
96026,2,1,336086,336087,336088,1,2,0
96027,5,2,336091,336091,336093,0,2,3
96028,5,1,336096,336096,336097,0,1,3
96029,3,2,336099,336099,336101,0,2,2
96030,2,1,336101,336101,336102,0,1,0
96031,3,3,336104,336104,336107,0,3,2
96032,1,1,336105,336107,336108,2,3,0
96033,6,1,336111,336111,336112,0,1,3
96034,6,1,336117,336117,336118,0,1,5
96035,4,1,336121,336121,336122,0,1,3
96036,3,1,336124,336124,336125,0,1,2
96037,1,3,336125,336125,336128,0,3,0
96038,2,2,336127,336128,336130,1,3,0
96039,6,2,336133,336133,336135,0,2,3
96040,4,3,336137,336137,336140,0,3,2
96041,5,3,336142,336142,336145,0,3,2
96042,6,3,336148,336148,336151,0,3,3
96043,6,3,336154,336154,336157,0,3,3
96044,4,1,336158,336158,336159,0,1,1
96045,5,1,336163,336163,336164,0,1,4
96046,3,1,336166,336166,336167,0,1,2
96047,1,3,336167,336167,336170,0,3,0
96048,4,1,336171,336171,336172,0,1,1
96049,1,1,336172,336172,336173,0,1,0
96050,6,1,336178,336178,336179,0,1,5
96051,3,3,336181,336181,336184,0,3,2
96052,6,1,336187,336187,336188,0,1,3
96053,3,3,336190,336190,336193,0,3,2
96054,6,1,336196,336196,336197,0,1,3
96055,1,2,336197,336197,336199,0,2,0
96056,3,1,336200,336200,336201,0,1,1
96057,5,1,336205,336205,336206,0,1,4
96058,1,3,336206,336206,336209,0,3,0
96059,5,3,336211,336211,336214,0,3,2
96060,4,2,336215,336215,336217,0,2,1
96061,6,3,336221,336221,336224,0,3,4
96062,3,1,336224,336224,336225,0,1,0
96063,3,3,336227,336227,336230,0,3,2
96064,1,1,336228,336230,336231,2,3,0
96065,6,2,336234,336234,336236,0,2,3
96066,3,2,336237,336237,336239,0,2,1
96067,6,3,336243,336243,336246,0,3,4
96068,2,3,336245,336246,336249,1,4,0
96069,1,3,336246,336249,336252,3,6,0
96070,1,3,336247,336252,336255,5,8,0
96071,5,3,336252,336255,336258,3,6,0
96072,1,2,336253,336258,336260,5,7,0
96073,5,3,336258,336260,336263,2,5,0
96074,4,1,336262,336263,336264,1,2,0
96075,6,1,336268,336268,336269,0,1,4
96076,4,2,336272,336272,336274,0,2,3
96077,2,1,336274,336274,336275,0,1,0
96078,3,3,336277,336277,336280,0,3,2
96079,6,2,336283,336283,336285,0,2,3
96080,2,3,336285,336285,336288,0,3,0
96081,2,1,336287,336288,336289,1,2,0
96082,4,2,336291,336291,336293,0,2,2
96083,4,1,336295,336295,336296,0,1,2
96084,4,2,336299,336299,336301,0,2,3
96085,2,3,336301,336301,336304,0,3,0
96086,3,3,336304,336304,336307,0,3,0
96087,2,1,336306,336307,336308,1,2,0
96088,3,2,336309,336309,336311,0,2,1
96089,6,2,336315,336315,336317,0,2,4
96090,3,3,336318,336318,336321,0,3,1
96091,5,1,336323,336323,336324,0,1,2
96092,2,1,336325,336325,336326,0,1,1
96093,5,3,336330,336330,336333,0,3,4
96094,4,3,336334,336334,336337,0,3,1
96095,2,1,336336,336337,336338,1,2,0
96096,3,2,336339,336339,336341,0,2,1
96097,1,2,336340,336341,336343,1,3,0
96098,5,2,336345,336345,336347,0,2,2
96099,3,2,336348,336348,336350,0,2,1
96100,3,1,336351,336351,336352,0,1,1
96101,5,1,336356,336356,336357,0,1,4
96102,5,1,336361,336361,336362,0,1,4
96103,1,2,336362,336362,336364,0,2,0
96104,4,1,336366,336366,336367,0,1,2
96105,2,3,336368,336368,336371,0,3,1
96106,6,2,336374,336374,336376,0,2,3
96107,1,2,336375,336376,336378,1,3,0
96108,2,3,336377,336378,336381,1,4,0
96109,4,3,336381,336381,336384,0,3,0
96110,4,2,336385,336385,336387,0,2,1
96111,6,3,336391,336391,336394,0,3,4
96112,4,1,336395,336395,336396,0,1,1
96113,6,2,336401,336401,336403,0,2,5
96114,3,1,336404,336404,336405,0,1,1
96115,1,3,336405,336405,336408,0,3,0
96116,1,3,336406,336408,336411,2,5,0
96117,3,2,336409,336411,336413,2,4,0
96118,3,2,336412,336413,336415,1,3,0
96119,3,3,336415,336415,336418,0,3,0
96120,5,3,336420,336420,336423,0,3,2
96121,5,3,336425,336425,336428,0,3,2
96122,2,2,336427,336428,336430,1,3,0
96123,1,1,336428,336430,336431,2,3,0
96124,3,3,336431,336431,336434,0,3,0
96125,1,1,336432,336434,336435,2,3,0
96126,1,2,336433,336435,336437,2,4,0
96127,2,2,336435,336437,336439,2,4,0
96128,3,1,336438,336439,336440,1,2,0
96129,1,3,336439,336440,336443,1,4,0
96130,3,1,336442,336443,336444,1,2,0
96131,5,3,336447,336447,336450,0,3,3
96132,5,3,336452,336452,336455,0,3,2
96133,1,3,336453,336455,336458,2,5,0
96134,3,1,336456,336458,336459,2,3,0
96135,2,2,336458,336459,336461,1,3,0
96136,6,1,336464,336464,336465,0,1,3
96137,5,2,336469,336469,336471,0,2,4
96138,4,3,336473,336473,336476,0,3,2
96139,4,1,336477,336477,336478,0,1,1
96140,6,1,336483,336483,336484,0,1,5
96141,4,1,336487,336487,336488,0,1,3
96142,3,3,336490,336490,336493,0,3,2
96143,1,1,336491,336493,336494,2,3,0
96144,2,2,336493,336494,336496,1,3,0
96145,4,3,336497,336497,336500,0,3,1
96146,5,2,336502,336502,336504,0,2,2
96147,2,1,336504,336504,336505,0,1,0
96148,3,2,336507,336507,336509,0,2,2
96149,6,3,336513,336513,336516,0,3,4
96150,1,1,336514,336516,336517,2,3,0
96151,4,1,336518,336518,336519,0,1,1
96152,6,3,336524,336524,336527,0,3,5
96153,6,1,336530,336530,336531,0,1,3
96154,4,3,336534,336534,336537,0,3,3
96155,1,2,336535,336537,336539,2,4,0
96156,3,1,336538,336539,336540,1,2,0
96157,4,3,336542,336542,336545,0,3,2
96158,1,1,336543,336545,336546,2,3,0
96159,3,1,336546,336546,336547,0,1,0
96160,4,3,336550,336550,336553,0,3,3
96161,3,1,336553,336553,336554,0,1,0
96162,6,3,336559,336559,336562,0,3,5
96163,5,1,336564,336564,336565,0,1,2
96164,4,2,336568,336568,336570,0,2,3
96165,1,3,336569,336570,336573,1,4,0
96166,1,2,336570,336573,336575,3,5,0
96167,3,1,336573,336575,336576,2,3,0
96168,5,2,336578,336578,336580,0,2,2
96169,5,3,336583,336583,336586,0,3,3
96170,5,3,336588,336588,336591,0,3,2
96171,6,3,336594,336594,336597,0,3,3
96172,1,1,336595,336597,336598,2,3,0
96173,5,2,336600,336600,336602,0,2,2
96174,1,3,336601,336602,336605,1,4,0
96175,4,1,336605,336605,336606,0,1,0
96176,1,1,336606,336606,336607,0,1,0
96177,1,2,336607,336607,336609,0,2,0
96178,3,3,336610,336610,336613,0,3,1
96179,1,2,336611,336613,336615,2,4,0
96180,4,2,336615,336615,336617,0,2,0
96181,2,2,336617,336617,336619,0,2,0
96182,1,2,336618,336619,336621,1,3,0
96183,6,1,336624,336624,336625,0,1,3
96184,4,1,336628,336628,336629,0,1,3
96185,5,3,336633,336633,336636,0,3,4
96186,6,1,336639,336639,336640,0,1,3
96187,4,3,336643,336643,336646,0,3,3
96188,6,1,336649,336649,336650,0,1,3
96189,2,2,336651,336651,336653,0,2,1
96190,2,3,336653,336653,336656,0,3,0
96191,3,1,336656,336656,336657,0,1,0
96192,1,3,336657,336657,336660,0,3,0
96193,1,1,336658,336660,336661,2,3,0
96194,6,1,336664,336664,336665,0,1,3
96195,3,1,336667,336667,336668,0,1,2
96196,5,3,336672,336672,336675,0,3,4
96197,4,3,336676,336676,336679,0,3,1
96198,3,2,336679,336679,336681,0,2,0
96199,1,1,336680,336681,336682,1,2,0
96200,1,2,336681,336682,336684,1,3,0
96201,3,3,336684,336684,336687,0,3,0
96202,1,3,336685,336687,336690,2,5,0
96203,4,3,336689,336690,336693,1,4,0
96204,5,2,336694,336694,336696,0,2,1
96205,3,1,336697,336697,336698,0,1,1
96206,2,2,336699,336699,336701,0,2,1
96207,6,1,336705,336705,336706,0,1,4
96208,6,3,336711,336711,336714,0,3,5
96209,6,1,336717,336717,336718,0,1,3
96210,1,2,336718,336718,336720,0,2,0
96211,1,2,336719,336720,336722,1,3,0
96212,6,1,336725,336725,336726,0,1,3
96213,5,1,336730,336730,336731,0,1,4
96214,2,1,336732,336732,336733,0,1,1
96215,3,1,336735,336735,336736,0,1,2
96216,3,3,336738,336738,336741,0,3,2
96217,6,2,336744,336744,336746,0,2,3
96218,6,3,336750,336750,336753,0,3,4
96219,2,1,336752,336753,336754,1,2,0
96220,4,2,336756,336756,336758,0,2,2
96221,5,3,336761,336761,336764,0,3,3
96222,2,3,336763,336764,336767,1,4,0
96223,1,2,336764,336767,336769,3,5,0
96224,4,2,336768,336769,336771,1,3,0
96225,4,3,336772,336772,336775,0,3,1
96226,2,3,336774,336775,336778,1,4,0
96227,3,3,336777,336778,336781,1,4,0
96228,3,2,336780,336781,336783,1,3,0
96229,2,1,336782,336783,336784,1,2,0
96230,6,3,336788,336788,336791,0,3,4
96231,4,1,336792,336792,336793,0,1,1
96232,5,3,336797,336797,336800,0,3,4
96233,4,2,336801,336801,336803,0,2,1
96234,5,2,336806,336806,336808,0,2,3
96235,6,3,336812,336812,336815,0,3,4
96236,3,2,336815,336815,336817,0,2,0
96237,4,3,336819,336819,336822,0,3,2
96238,1,2,336820,336822,336824,2,4,0
96239,3,3,336823,336824,336827,1,4,0
96240,3,1,336826,336827,336828,1,2,0
96241,5,3,336831,336831,336834,0,3,3
96242,6,3,336837,336837,336840,0,3,3
96243,6,1,336843,336843,336844,0,1,3
96244,3,1,336846,336846,336847,0,1,2
96245,1,1,336847,336847,336848,0,1,0
96246,1,3,336848,336848,336851,0,3,0
96247,2,2,336850,336851,336853,1,3,0
96248,6,3,336856,336856,336859,0,3,3
96249,3,1,336859,336859,336860,0,1,0
96250,3,1,336862,336862,336863,0,1,2
96251,6,2,336868,336868,336870,0,2,5
96252,1,1,336869,336870,336871,1,2,0
96253,1,3,336870,336871,336874,1,4,0
96254,1,1,336871,336874,336875,3,4,0
96255,4,3,336875,336875,336878,0,3,0
96256,6,2,336881,336881,336883,0,2,3
96257,6,2,336887,336887,336889,0,2,4
96258,1,2,336888,336889,336891,1,3,0
96259,5,3,336893,336893,336896,0,3,2
96260,5,1,336898,336898,336899,0,1,2
96261,2,1,336900,336900,336901,0,1,1
96262,3,1,336903,336903,336904,0,1,2
96263,1,2,336904,336904,336906,0,2,0
96264,2,2,336906,336906,336908,0,2,0
96265,2,2,336908,336908,336910,0,2,0
96266,3,1,336911,336911,336912,0,1,1
96267,4,3,336915,336915,336918,0,3,3
96268,2,1,336917,336918,336919,1,2,0
96269,2,2,336919,336919,336921,0,2,0
96270,4,2,336923,336923,336925,0,2,2
96271,1,1,336924,336925,336926,1,2,0
96272,1,3,336925,336926,336929,1,4,0
96273,4,3,336929,336929,336932,0,3,0
96274,4,2,336933,336933,336935,0,2,1
96275,4,1,336937,336937,336938,0,1,2
96276,4,2,336941,336941,336943,0,2,3
96277,3,2,336944,336944,336946,0,2,1
96278,4,1,336948,336948,336949,0,1,2
96279,4,1,336952,336952,336953,0,1,3
96280,2,2,336954,336954,336956,0,2,1
96281,6,3,336960,336960,336963,0,3,4
96282,3,2,336963,336963,336965,0,2,0
96283,4,2,336967,336967,336969,0,2,2
96284,1,2,336968,336969,336971,1,3,0
96285,4,3,336972,336972,336975,0,3,1
96286,1,1,336973,336975,336976,2,3,0
96287,6,2,336979,336979,336981,0,2,3
96288,6,3,336985,336985,336988,0,3,4
96289,4,2,336989,336989,336991,0,2,1
96290,2,3,336991,336991,336994,0,3,0
96291,2,3,336993,336994,336997,1,4,0
96292,3,2,336996,336997,336999,1,3,0
96293,4,2,337000,337000,337002,0,2,1
96294,2,2,337002,337002,337004,0,2,0
96295,6,3,337008,337008,337011,0,3,4
96296,4,2,337012,337012,337014,0,2,1
96297,3,3,337015,337015,337018,0,3,1
96298,6,2,337021,337021,337023,0,2,3
96299,3,3,337024,337024,337027,0,3,1
96300,2,2,337026,337027,337029,1,3,0
96301,1,2,337027,337029,337031,2,4,0
96302,4,1,337031,337031,337032,0,1,0
96303,6,3,337037,337037,337040,0,3,5
96304,2,1,337039,337040,337041,1,2,0
96305,2,1,337041,337041,337042,0,1,0
96306,6,1,337047,337047,337048,0,1,5
96307,3,3,337050,337050,337053,0,3,2
96308,3,1,337053,337053,337054,0,1,0
96309,6,3,337059,337059,337062,0,3,5
96310,2,2,337061,337062,337064,1,3,0
96311,5,1,337066,337066,337067,0,1,2
96312,2,1,337068,337068,337069,0,1,1
96313,4,3,337072,337072,337075,0,3,3
96314,5,1,337077,337077,337078,0,1,2
96315,4,2,337081,337081,337083,0,2,3
96316,4,3,337085,337085,337088,0,3,2
96317,3,1,337088,337088,337089,0,1,0
96318,3,2,337091,337091,337093,0,2,2
96319,6,1,337097,337097,337098,0,1,4
96320,2,3,337099,337099,337102,0,3,1
96321,2,2,337101,337102,337104,1,3,0
96322,1,1,337102,337104,337105,2,3,0
96323,6,2,337108,337108,337110,0,2,3
96324,1,2,337109,337110,337112,1,3,0
96325,4,1,337113,337113,337114,0,1,1
96326,2,1,337115,337115,337116,0,1,1
96327,1,2,337116,337116,337118,0,2,0
96328,3,2,337119,337119,337121,0,2,1
96329,6,1,337125,337125,337126,0,1,4
96330,1,3,337126,337126,337129,0,3,0
96331,2,1,337128,337129,337130,1,2,0
96332,1,3,337129,337130,337133,1,4,0
96333,2,3,337131,337133,337136,2,5,0
96334,1,3,337132,337136,337139,4,7,0
96335,6,1,337138,337139,337140,1,2,0
96336,5,1,337143,337143,337144,0,1,3
96337,5,3,337148,337148,337151,0,3,4
96338,6,1,337154,337154,337155,0,1,3
96339,1,3,337155,337155,337158,0,3,0
96340,1,1,337156,337158,337159,2,3,0
96341,4,2,337160,337160,337162,0,2,1
96342,2,2,337162,337162,337164,0,2,0
96343,4,3,337166,337166,337169,0,3,2
96344,2,2,337168,337169,337171,1,3,0
96345,5,3,337173,337173,337176,0,3,2
96346,1,3,337174,337176,337179,2,5,0
96347,6,2,337180,337180,337182,0,2,1
96348,1,3,337181,337182,337185,1,4,0
96349,1,2,337182,337185,337187,3,5,0
96350,3,3,337185,337187,337190,2,5,0
96351,2,2,337187,337190,337192,3,5,0
96352,3,2,337190,337192,337194,2,4,0
96353,1,1,337191,337194,337195,3,4,0
96354,6,1,337197,337197,337198,0,1,2
96355,4,2,337201,337201,337203,0,2,3
96356,6,3,337207,337207,337210,0,3,4
96357,4,3,337211,337211,337214,0,3,1
96358,6,2,337217,337217,337219,0,2,3
96359,2,1,337219,337219,337220,0,1,0
96360,2,3,337221,337221,337224,0,3,1
96361,5,3,337226,337226,337229,0,3,2
96362,1,1,337227,337229,337230,2,3,0
96363,2,2,337229,337230,337232,1,3,0
96364,5,2,337234,337234,337236,0,2,2
96365,6,3,337240,337240,337243,0,3,4
96366,4,2,337244,337244,337246,0,2,1
96367,6,2,337250,337250,337252,0,2,4
96368,5,2,337255,337255,337257,0,2,3
96369,5,1,337260,337260,337261,0,1,3
96370,1,3,337261,337261,337264,0,3,0
96371,5,2,337266,337266,337268,0,2,2
96372,5,2,337271,337271,337273,0,2,3
96373,5,1,337276,337276,337277,0,1,3
96374,2,2,337278,337278,337280,0,2,1
96375,3,2,337281,337281,337283,0,2,1
96376,5,1,337286,337286,337287,0,1,3
96377,5,2,337291,337291,337293,0,2,4
96378,4,3,337295,337295,337298,0,3,2
96379,6,2,337301,337301,337303,0,2,3
96380,5,3,337306,337306,337309,0,3,3
96381,3,1,337309,337309,337310,0,1,0
96382,6,2,337315,337315,337317,0,2,5
96383,4,1,337319,337319,337320,0,1,2
96384,5,2,337324,337324,337326,0,2,4
96385,2,2,337326,337326,337328,0,2,0
96386,1,2,337327,337328,337330,1,3,0
96387,2,1,337329,337330,337331,1,2,0
96388,1,3,337330,337331,337334,1,4,0
96389,5,1,337335,337335,337336,0,1,1
96390,3,1,337338,337338,337339,0,1,2
96391,3,1,337341,337341,337342,0,1,2
96392,4,1,337345,337345,337346,0,1,3
96393,4,3,337349,337349,337352,0,3,3
96394,4,2,337353,337353,337355,0,2,1
96395,4,2,337357,337357,337359,0,2,2
96396,5,3,337362,337362,337365,0,3,3
96397,2,1,337364,337365,337366,1,2,0
96398,6,2,337370,337370,337372,0,2,4
96399,2,2,337372,337372,337374,0,2,0
96400,5,2,337377,337377,337379,0,2,3
96401,4,2,337381,337381,337383,0,2,2
96402,2,2,337383,337383,337385,0,2,0
96403,3,3,337386,337386,337389,0,3,1
96404,6,2,337392,337392,337394,0,2,3
96405,6,1,337398,337398,337399,0,1,4
96406,3,3,337401,337401,337404,0,3,2
96407,2,1,337403,337404,337405,1,2,0
96408,4,2,337407,337407,337409,0,2,2
96409,4,3,337411,337411,337414,0,3,2
96410,6,2,337417,337417,337419,0,2,3
96411,3,3,337420,337420,337423,0,3,1
96412,1,2,337421,337423,337425,2,4,0
96413,2,2,337423,337425,337427,2,4,0
96414,6,2,337429,337429,337431,0,2,2
96415,4,3,337433,337433,337436,0,3,2
96416,5,3,337438,337438,337441,0,3,2
96417,6,3,337444,337444,337447,0,3,3
96418,3,3,337447,337447,337450,0,3,0
96419,1,3,337448,337450,337453,2,5,0
96420,5,3,337453,337453,337456,0,3,0
96421,6,2,337459,337459,337461,0,2,3
96422,5,2,337464,337464,337466,0,2,3
96423,2,3,337466,337466,337469,0,3,0
96424,6,1,337472,337472,337473,0,1,3
96425,1,3,337473,337473,337476,0,3,0
96426,6,1,337479,337479,337480,0,1,3
96427,4,1,337483,337483,337484,0,1,3
96428,3,3,337486,337486,337489,0,3,2
96429,2,3,337488,337489,337492,1,4,0
96430,4,1,337492,337492,337493,0,1,0
96431,4,3,337496,337496,337499,0,3,3
96432,2,1,337498,337499,337500,1,2,0
96433,3,1,337501,337501,337502,0,1,1
96434,3,2,337504,337504,337506,0,2,2
96435,5,2,337509,337509,337511,0,2,3
96436,5,3,337514,337514,337517,0,3,3
96437,5,3,337519,337519,337522,0,3,2
96438,5,3,337524,337524,337527,0,3,2
96439,6,1,337530,337530,337531,0,1,3
96440,6,3,337536,337536,337539,0,3,5
96441,1,2,337537,337539,337541,2,4,0
96442,2,3,337539,337541,337544,2,5,0
96443,5,3,337544,337544,337547,0,3,0
96444,6,1,337550,337550,337551,0,1,3
96445,4,3,337554,337554,337557,0,3,3
96446,5,2,337559,337559,337561,0,2,2
96447,2,1,337561,337561,337562,0,1,0
96448,3,2,337564,337564,337566,0,2,2
96449,1,1,337565,337566,337567,1,2,0
96450,4,1,337569,337569,337570,0,1,2
96451,2,1,337571,337571,337572,0,1,1
96452,6,1,337577,337577,337578,0,1,5
96453,2,1,337579,337579,337580,0,1,1
96454,6,2,337585,337585,337587,0,2,5
96455,2,3,337587,337587,337590,0,3,0
96456,1,1,337588,337590,337591,2,3,0
96457,6,1,337594,337594,337595,0,1,3
96458,4,3,337598,337598,337601,0,3,3
96459,6,2,337604,337604,337606,0,2,3
96460,4,1,337608,337608,337609,0,1,2
96461,2,1,337610,337610,337611,0,1,1
96462,4,2,337614,337614,337616,0,2,3
96463,2,3,337616,337616,337619,0,3,0
96464,2,3,337618,337619,337622,1,4,0
96465,4,1,337622,337622,337623,0,1,0
96466,3,2,337625,337625,337627,0,2,2
96467,6,1,337631,337631,337632,0,1,4
96468,1,2,337632,337632,337634,0,2,0
96469,3,3,337635,337635,337638,0,3,1
96470,1,2,337636,337638,337640,2,4,0
96471,6,2,337642,337642,337644,0,2,2
96472,1,2,337643,337644,337646,1,3,0
96473,4,3,337647,337647,337650,0,3,1
96474,4,2,337651,337651,337653,0,2,1
96475,3,3,337654,337654,337657,0,3,1
96476,4,2,337658,337658,337660,0,2,1
96477,3,2,337661,337661,337663,0,2,1
96478,1,2,337662,337663,337665,1,3,0
96479,2,1,337664,337665,337666,1,2,0
96480,5,2,337669,337669,337671,0,2,3
96481,5,3,337674,337674,337677,0,3,3
96482,5,3,337679,337679,337682,0,3,2
96483,6,3,337685,337685,337688,0,3,3
96484,3,1,337688,337688,337689,0,1,0
96485,3,1,337691,337691,337692,0,1,2
96486,2,2,337693,337693,337695,0,2,1
96487,1,1,337694,337695,337696,1,2,0
96488,3,2,337697,337697,337699,0,2,1
96489,2,3,337699,337699,337702,0,3,0
96490,2,2,337701,337702,337704,1,3,0
96491,1,1,337702,337704,337705,2,3,0
96492,5,3,337707,337707,337710,0,3,2
96493,6,2,337713,337713,337715,0,2,3
96494,1,2,337714,337715,337717,1,3,0
96495,1,2,337715,337717,337719,2,4,0
96496,2,2,337717,337719,337721,2,4,0
96497,2,3,337719,337721,337724,2,5,0
96498,6,1,337725,337725,337726,0,1,1
96499,6,1,337731,337731,337732,0,1,5
96500,5,2,337736,337736,337738,0,2,4
96501,4,2,337740,337740,337742,0,2,2
96502,3,3,337743,337743,337746,0,3,1
96503,3,3,337746,337746,337749,0,3,0
96504,2,2,337748,337749,337751,1,3,0
96505,3,1,337751,337751,337752,0,1,0
96506,4,1,337755,337755,337756,0,1,3
96507,6,3,337761,337761,337764,0,3,5
96508,1,3,337762,337764,337767,2,5,0
96509,5,2,337767,337767,337769,0,2,0
96510,3,1,337770,337770,337771,0,1,1
96511,5,1,337775,337775,337776,0,1,4
96512,4,3,337779,337779,337782,0,3,3
96513,1,1,337780,337782,337783,2,3,0
96514,2,3,337782,337783,337786,1,4,0
96515,2,2,337784,337786,337788,2,4,0
96516,5,3,337789,337789,337792,0,3,1
96517,3,3,337792,337792,337795,0,3,0
96518,3,2,337795,337795,337797,0,2,0
96519,2,3,337797,337797,337800,0,3,0
96520,4,2,337801,337801,337803,0,2,1
96521,3,3,337804,337804,337807,0,3,1
96522,3,2,337807,337807,337809,0,2,0
96523,5,2,337812,337812,337814,0,2,3
96524,4,3,337816,337816,337819,0,3,2
96525,4,3,337820,337820,337823,0,3,1
96526,3,1,337823,337823,337824,0,1,0
96527,1,2,337824,337824,337826,0,2,0
96528,3,3,337827,337827,337830,0,3,1
96529,6,3,337833,337833,337836,0,3,3
96530,4,2,337837,337837,337839,0,2,1
96531,1,2,337838,337839,337841,1,3,0
96532,3,3,337841,337841,337844,0,3,0
96533,6,2,337847,337847,337849,0,2,3
96534,5,1,337852,337852,337853,0,1,3
96535,3,3,337855,337855,337858,0,3,2
96536,2,1,337857,337858,337859,1,2,0
96537,2,1,337859,337859,337860,0,1,0
96538,3,2,337862,337862,337864,0,2,2
96539,6,3,337868,337868,337871,0,3,4
96540,2,2,337870,337871,337873,1,3,0
96541,2,2,337872,337873,337875,1,3,0
96542,3,3,337875,337875,337878,0,3,0
96543,3,3,337878,337878,337881,0,3,0
96544,6,2,337884,337884,337886,0,2,3
96545,3,2,337887,337887,337889,0,2,1
96546,3,1,337890,337890,337891,0,1,1
96547,2,3,337892,337892,337895,0,3,1
96548,1,2,337893,337895,337897,2,4,0
96549,3,2,337896,337897,337899,1,3,0
96550,1,2,337897,337899,337901,2,4,0
96551,1,3,337898,337901,337904,3,6,0
96552,5,3,337903,337904,337907,1,4,0
96553,2,1,337905,337907,337908,2,3,0
96554,1,1,337906,337908,337909,2,3,0
96555,1,2,337907,337909,337911,2,4,0
96556,6,3,337913,337913,337916,0,3,2
96557,5,2,337918,337918,337920,0,2,2
96558,2,3,337920,337920,337923,0,3,0
96559,1,2,337921,337923,337925,2,4,0
96560,6,2,337927,337927,337929,0,2,2
96561,2,3,337929,337929,337932,0,3,0
96562,2,2,337931,337932,337934,1,3,0
96563,2,1,337933,337934,337935,1,2,0
96564,3,2,337936,337936,337938,0,2,1
96565,2,1,337938,337938,337939,0,1,0
96566,3,3,337941,337941,337944,0,3,2
96567,5,3,337946,337946,337949,0,3,2
96568,5,3,337951,337951,337954,0,3,2
96569,4,1,337955,337955,337956,0,1,1
96570,1,3,337956,337956,337959,0,3,0
96571,6,3,337962,337962,337965,0,3,3
96572,1,1,337963,337965,337966,2,3,0
96573,2,2,337965,337966,337968,1,3,0
96574,5,3,337970,337970,337973,0,3,2
96575,3,3,337973,337973,337976,0,3,0
96576,1,1,337974,337976,337977,2,3,0
96577,5,3,337979,337979,337982,0,3,2
96578,4,1,337983,337983,337984,0,1,1
96579,2,2,337985,337985,337987,0,2,1
96580,1,2,337986,337987,337989,1,3,0
96581,6,3,337992,337992,337995,0,3,3
96582,2,3,337994,337995,337998,1,4,0
96583,3,1,337997,337998,337999,1,2,0
96584,2,3,337999,337999,338002,0,3,0
96585,1,2,338000,338002,338004,2,4,0
96586,6,3,338006,338006,338009,0,3,2
96587,4,1,338010,338010,338011,0,1,1
96588,3,2,338013,338013,338015,0,2,2
96589,4,3,338017,338017,338020,0,3,2
96590,2,1,338019,338020,338021,1,2,0
96591,4,1,338023,338023,338024,0,1,2
96592,3,3,338026,338026,338029,0,3,2
96593,6,2,338032,338032,338034,0,2,3
96594,6,3,338038,338038,338041,0,3,4
96595,4,1,338042,338042,338043,0,1,1
96596,6,1,338048,338048,338049,0,1,5
96597,6,2,338054,338054,338056,0,2,5
96598,2,1,338056,338056,338057,0,1,0
96599,5,2,338061,338061,338063,0,2,4
96600,4,1,338065,338065,338066,0,1,2
96601,6,3,338071,338071,338074,0,3,5
96602,5,2,338076,338076,338078,0,2,2
96603,1,3,338077,338078,338081,1,4,0
96604,6,2,338083,338083,338085,0,2,2
96605,5,3,338088,338088,338091,0,3,3
96606,6,1,338094,338094,338095,0,1,3
96607,6,2,338100,338100,338102,0,2,5
96608,3,1,338103,338103,338104,0,1,1
96609,6,2,338109,338109,338111,0,2,5
96610,2,1,338111,338111,338112,0,1,0
96611,6,2,338117,338117,338119,0,2,5
96612,5,1,338122,338122,338123,0,1,3
96613,2,1,338124,338124,338125,0,1,1
96614,6,1,338130,338130,338131,0,1,5
96615,6,3,338136,338136,338139,0,3,5
96616,2,3,338138,338139,338142,1,4,0
96617,6,2,338144,338144,338146,0,2,2
96618,4,1,338148,338148,338149,0,1,2
96619,3,3,338151,338151,338154,0,3,2
96620,1,3,338152,338154,338157,2,5,0
96621,1,1,338153,338157,338158,4,5,0
96622,6,1,338159,338159,338160,0,1,1
96623,5,3,338164,338164,338167,0,3,4
96624,6,1,338170,338170,338171,0,1,3
96625,5,2,338175,338175,338177,0,2,4
96626,4,2,338179,338179,338181,0,2,2
96627,3,2,338182,338182,338184,0,2,1
96628,3,2,338185,338185,338187,0,2,1
96629,4,1,338189,338189,338190,0,1,2
96630,2,2,338191,338191,338193,0,2,1
96631,5,2,338196,338196,338198,0,2,3
96632,5,2,338201,338201,338203,0,2,3
96633,6,3,338207,338207,338210,0,3,4
96634,2,3,338209,338210,338213,1,4,0
96635,3,2,338212,338213,338215,1,3,0
96636,5,1,338217,338217,338218,0,1,2
96637,4,1,338221,338221,338222,0,1,3
96638,5,2,338226,338226,338228,0,2,4
96639,6,1,338232,338232,338233,0,1,4
96640,2,2,338234,338234,338236,0,2,1
96641,1,2,338235,338236,338238,1,3,0
96642,2,2,338237,338238,338240,1,3,0
96643,2,3,338239,338240,338243,1,4,0
96644,6,2,338245,338245,338247,0,2,2
96645,4,2,338249,338249,338251,0,2,2
96646,2,3,338251,338251,338254,0,3,0
96647,3,2,338254,338254,338256,0,2,0
96648,5,3,338259,338259,338262,0,3,3
96649,2,2,338261,338262,338264,1,3,0
96650,1,1,338262,338264,338265,2,3,0
96651,2,3,338264,338265,338268,1,4,0
96652,6,2,338270,338270,338272,0,2,2
96653,3,1,338273,338273,338274,0,1,1
96654,1,3,338274,338274,338277,0,3,0
96655,2,2,338276,338277,338279,1,3,0
96656,2,2,338278,338279,338281,1,3,0
96657,4,1,338282,338282,338283,0,1,1
96658,1,2,338283,338283,338285,0,2,0
96659,4,2,338287,338287,338289,0,2,2
96660,5,1,338292,338292,338293,0,1,3
96661,3,3,338295,338295,338298,0,3,2
96662,1,1,338296,338298,338299,2,3,0
96663,6,3,338302,338302,338305,0,3,3
96664,4,2,338306,338306,338308,0,2,1
96665,6,2,338312,338312,338314,0,2,4
96666,1,1,338313,338314,338315,1,2,0
96667,2,3,338315,338315,338318,0,3,0
96668,4,3,338319,338319,338322,0,3,1
96669,1,2,338320,338322,338324,2,4,0
96670,6,1,338326,338326,338327,0,1,2
96671,1,3,338327,338327,338330,0,3,0
96672,1,3,338328,338330,338333,2,5,0
96673,5,3,338333,338333,338336,0,3,0
96674,3,2,338336,338336,338338,0,2,0
96675,1,1,338337,338338,338339,1,2,0
96676,2,3,338339,338339,338342,0,3,0
96677,2,2,338341,338342,338344,1,3,0
96678,6,3,338347,338347,338350,0,3,3
96679,5,2,338352,338352,338354,0,2,2
96680,6,2,338358,338358,338360,0,2,4
96681,2,2,338360,338360,338362,0,2,0
96682,3,1,338363,338363,338364,0,1,1
96683,5,1,338368,338368,338369,0,1,4
96684,2,3,338370,338370,338373,0,3,1
96685,2,2,338372,338373,338375,1,3,0
96686,6,2,338378,338378,338380,0,2,3
96687,3,1,338381,338381,338382,0,1,1
96688,4,2,338385,338385,338387,0,2,3
96689,5,1,338390,338390,338391,0,1,3
96690,6,1,338396,338396,338397,0,1,5
96691,2,1,338398,338398,338399,0,1,1
96692,5,3,338403,338403,338406,0,3,4
96693,2,2,338405,338406,338408,1,3,0
96694,6,2,338411,338411,338413,0,2,3
96695,3,2,338414,338414,338416,0,2,1
96696,2,3,338416,338416,338419,0,3,0
96697,3,3,338419,338419,338422,0,3,0
96698,1,2,338420,338422,338424,2,4,0
96699,3,2,338423,338424,338426,1,3,0
96700,6,1,338429,338429,338430,0,1,3
96701,5,2,338434,338434,338436,0,2,4
96702,5,2,338439,338439,338441,0,2,3
96703,6,2,338445,338445,338447,0,2,4
96704,3,3,338448,338448,338451,0,3,1
96705,4,1,338452,338452,338453,0,1,1
96706,5,3,338457,338457,338460,0,3,4
96707,6,1,338463,338463,338464,0,1,3
96708,2,2,338465,338465,338467,0,2,1
96709,5,3,338470,338470,338473,0,3,3
96710,3,3,338473,338473,338476,0,3,0
96711,5,3,338478,338478,338481,0,3,2
96712,6,3,338484,338484,338487,0,3,3
96713,5,3,338489,338489,338492,0,3,2
96714,4,1,338493,338493,338494,0,1,1
96715,2,2,338495,338495,338497,0,2,1
96716,6,1,338501,338501,338502,0,1,4
96717,1,1,338502,338502,338503,0,1,0
96718,2,2,338504,338504,338506,0,2,1
96719,3,2,338507,338507,338509,0,2,1
96720,4,3,338511,338511,338514,0,3,2
96721,2,1,338513,338514,338515,1,2,0
96722,5,1,338518,338518,338519,0,1,3
96723,3,3,338521,338521,338524,0,3,2
96724,3,2,338524,338524,338526,0,2,0
96725,4,3,338528,338528,338531,0,3,2
96726,1,3,338529,338531,338534,2,5,0
96727,2,1,338531,338534,338535,3,4,0
96728,4,3,338535,338535,338538,0,3,0
96729,4,2,338539,338539,338541,0,2,1
96730,4,1,338543,338543,338544,0,1,2
96731,3,2,338546,338546,338548,0,2,2
96732,6,2,338552,338552,338554,0,2,4
96733,6,2,338558,338558,338560,0,2,4
96734,5,2,338563,338563,338565,0,2,3
96735,6,2,338569,338569,338571,0,2,4
96736,4,3,338573,338573,338576,0,3,2
96737,1,3,338574,338576,338579,2,5,0
96738,2,2,338576,338579,338581,3,5,0
96739,3,3,338579,338581,338584,2,5,0
96740,4,2,338583,338584,338586,1,3,0
96741,1,2,338584,338586,338588,2,4,0
96742,5,3,338589,338589,338592,0,3,1
96743,4,3,338593,338593,338596,0,3,1
96744,1,2,338594,338596,338598,2,4,0
96745,2,1,338596,338598,338599,2,3,0
96746,6,3,338602,338602,338605,0,3,3
96747,1,1,338603,338605,338606,2,3,0
96748,6,3,338609,338609,338612,0,3,3
96749,1,1,338610,338612,338613,2,3,0
96750,5,3,338615,338615,338618,0,3,2
96751,5,1,338620,338620,338621,0,1,2
96752,4,2,338624,338624,338626,0,2,3
96753,6,2,338630,338630,338632,0,2,4
96754,3,2,338633,338633,338635,0,2,1
96755,6,2,338639,338639,338641,0,2,4
96756,6,1,338645,338645,338646,0,1,4
96757,6,1,338651,338651,338652,0,1,5
96758,1,3,338652,338652,338655,0,3,0
96759,6,1,338658,338658,338659,0,1,3
96760,6,3,338664,338664,338667,0,3,5
96761,6,2,338670,338670,338672,0,2,3
96762,6,2,338676,338676,338678,0,2,4
96763,4,1,338680,338680,338681,0,1,2
96764,6,3,338686,338686,338689,0,3,5
96765,2,3,338688,338689,338692,1,4,0
96766,3,2,338691,338692,338694,1,3,0
96767,5,1,338696,338696,338697,0,1,2
96768,1,3,338697,338697,338700,0,3,0
96769,2,1,338699,338700,338701,1,2,0
96770,1,1,338700,338701,338702,1,2,0
96771,6,2,338706,338706,338708,0,2,4
96772,5,1,338711,338711,338712,0,1,3
96773,2,3,338713,338713,338716,0,3,1
96774,3,1,338716,338716,338717,0,1,0
96775,2,3,338718,338718,338721,0,3,1
96776,3,2,338721,338721,338723,0,2,0
96777,6,1,338727,338727,338728,0,1,4
96778,5,2,338732,338732,338734,0,2,4
96779,5,1,338737,338737,338738,0,1,3
96780,1,2,338738,338738,338740,0,2,0
96781,2,2,338740,338740,338742,0,2,0
96782,5,1,338745,338745,338746,0,1,3
96783,2,1,338747,338747,338748,0,1,1
96784,4,1,338751,338751,338752,0,1,3
96785,2,3,338753,338753,338756,0,3,1
96786,6,3,338759,338759,338762,0,3,3
96787,4,1,338763,338763,338764,0,1,1
96788,1,3,338764,338764,338767,0,3,0
96789,3,1,338767,338767,338768,0,1,0
96790,3,2,338770,338770,338772,0,2,2
96791,4,3,338774,338774,338777,0,3,2
96792,2,3,338776,338777,338780,1,4,0
96793,2,1,338778,338780,338781,2,3,0
96794,4,1,338782,338782,338783,0,1,1
96795,5,3,338787,338787,338790,0,3,4
96796,3,1,338790,338790,338791,0,1,0
96797,1,1,338791,338791,338792,0,1,0
96798,6,2,338797,338797,338799,0,2,5
96799,5,3,338802,338802,338805,0,3,3
96800,2,2,338804,338805,338807,1,3,0
96801,3,1,338807,338807,338808,0,1,0
96802,6,2,338813,338813,338815,0,2,5
96803,3,2,338816,338816,338818,0,2,1
96804,6,2,338822,338822,338824,0,2,4
96805,1,2,338823,338824,338826,1,3,0
96806,4,1,338827,338827,338828,0,1,1
96807,3,2,338830,338830,338832,0,2,2
96808,4,1,338834,338834,338835,0,1,2
96809,2,2,338836,338836,338838,0,2,1
96810,5,3,338841,338841,338844,0,3,3
96811,3,1,338844,338844,338845,0,1,0
96812,5,1,338849,338849,338850,0,1,4
96813,4,2,338853,338853,338855,0,2,3
96814,6,3,338859,338859,338862,0,3,4
96815,6,2,338865,338865,338867,0,2,3
96816,5,1,338870,338870,338871,0,1,3
96817,3,1,338873,338873,338874,0,1,2
96818,5,2,338878,338878,338880,0,2,4
96819,2,2,338880,338880,338882,0,2,0
96820,1,3,338881,338882,338885,1,4,0
96821,5,1,338886,338886,338887,0,1,1
96822,3,1,338889,338889,338890,0,1,2
96823,1,1,338890,338890,338891,0,1,0
96824,6,3,338896,338896,338899,0,3,5
96825,6,1,338902,338902,338903,0,1,3
96826,1,2,338903,338903,338905,0,2,0
96827,2,3,338905,338905,338908,0,3,0
96828,5,1,338910,338910,338911,0,1,2
96829,6,2,338916,338916,338918,0,2,5
96830,3,3,338919,338919,338922,0,3,1
96831,5,2,338924,338924,338926,0,2,2
96832,6,1,338930,338930,338931,0,1,4
96833,1,3,338931,338931,338934,0,3,0
96834,6,1,338937,338937,338938,0,1,3
96835,3,3,338940,338940,338943,0,3,2
96836,1,2,338941,338943,338945,2,4,0
96837,5,2,338946,338946,338948,0,2,1
96838,3,1,338949,338949,338950,0,1,1
96839,5,2,338954,338954,338956,0,2,4
96840,3,2,338957,338957,338959,0,2,1
96841,2,2,338959,338959,338961,0,2,0
96842,2,2,338961,338961,338963,0,2,0
96843,3,3,338964,338964,338967,0,3,1
96844,4,3,338968,338968,338971,0,3,1
96845,5,2,338973,338973,338975,0,2,2
96846,1,3,338974,338975,338978,1,4,0
96847,1,3,338975,338978,338981,3,6,0
96848,2,2,338977,338981,338983,4,6,0
96849,4,1,338981,338983,338984,2,3,0
96850,6,1,338987,338987,338988,0,1,3
96851,3,2,338990,338990,338992,0,2,2
96852,5,2,338995,338995,338997,0,2,3
96853,5,3,339000,339000,339003,0,3,3
96854,3,3,339003,339003,339006,0,3,0
96855,1,3,339004,339006,339009,2,5,0
96856,1,3,339005,339009,339012,4,7,0
96857,6,3,339011,339012,339015,1,4,0
96858,6,2,339017,339017,339019,0,2,2
96859,1,2,339018,339019,339021,1,3,0
96860,4,2,339022,339022,339024,0,2,1
96861,4,2,339026,339026,339028,0,2,2
96862,5,2,339031,339031,339033,0,2,3
96863,5,1,339036,339036,339037,0,1,3
96864,4,3,339040,339040,339043,0,3,3
96865,5,1,339045,339045,339046,0,1,2
96866,5,3,339050,339050,339053,0,3,4
96867,4,1,339054,339054,339055,0,1,1
96868,5,1,339059,339059,339060,0,1,4
96869,5,2,339064,339064,339066,0,2,4
96870,5,1,339069,339069,339070,0,1,3
96871,3,2,339072,339072,339074,0,2,2
96872,2,1,339074,339074,339075,0,1,0
96873,2,2,339076,339076,339078,0,2,1
96874,4,1,339080,339080,339081,0,1,2
96875,6,2,339086,339086,339088,0,2,5
96876,5,2,339091,339091,339093,0,2,3
96877,2,3,339093,339093,339096,0,3,0
96878,4,3,339097,339097,339100,0,3,1
96879,3,3,339100,339100,339103,0,3,0
96880,5,1,339105,339105,339106,0,1,2
96881,1,3,339106,339106,339109,0,3,0
96882,4,2,339110,339110,339112,0,2,1
96883,3,3,339113,339113,339116,0,3,1
96884,2,2,339115,339116,339118,1,3,0
96885,1,2,339116,339118,339120,2,4,0
96886,2,1,339118,339120,339121,2,3,0
96887,4,1,339122,339122,339123,0,1,1
96888,5,3,339127,339127,339130,0,3,4
96889,5,2,339132,339132,339134,0,2,2
96890,4,3,339136,339136,339139,0,3,2
96891,3,1,339139,339139,339140,0,1,0
96892,1,3,339140,339140,339143,0,3,0
96893,3,2,339143,339143,339145,0,2,0
96894,3,2,339146,339146,339148,0,2,1
96895,3,3,339149,339149,339152,0,3,1
96896,5,2,339154,339154,339156,0,2,2
96897,2,1,339156,339156,339157,0,1,0
96898,6,1,339162,339162,339163,0,1,5
96899,6,1,339168,339168,339169,0,1,5
96900,3,1,339171,339171,339172,0,1,2
96901,1,3,339172,339172,339175,0,3,0
96902,5,1,339177,339177,339178,0,1,2
96903,4,1,339181,339181,339182,0,1,3
96904,1,2,339182,339182,339184,0,2,0
96905,1,3,339183,339184,339187,1,4,0
96906,2,2,339185,339187,339189,2,4,0
96907,3,3,339188,339189,339192,1,4,0
96908,2,1,339190,339192,339193,2,3,0
96909,6,3,339196,339196,339199,0,3,3
96910,6,3,339202,339202,339205,0,3,3
96911,1,3,339203,339205,339208,2,5,0
96912,4,3,339207,339208,339211,1,4,0
96913,3,3,339210,339211,339214,1,4,0
96914,2,1,339212,339214,339215,2,3,0
96915,3,1,339215,339215,339216,0,1,0
96916,5,2,339220,339220,339222,0,2,4
96917,5,2,339225,339225,339227,0,2,3
96918,3,1,339228,339228,339229,0,1,1
96919,1,3,339229,339229,339232,0,3,0
96920,1,3,339230,339232,339235,2,5,0
96921,1,3,339231,339235,339238,4,7,0
96922,1,2,339232,339238,339240,6,8,0
96923,4,1,339236,339240,339241,4,5,0
96924,2,3,339238,339241,339244,3,6,0
96925,1,2,339239,339244,339246,5,7,0
96926,4,1,339243,339246,339247,3,4,0
96927,3,2,339246,339247,339249,1,3,0
96928,6,3,339252,339252,339255,0,3,3
96929,3,1,339255,339255,339256,0,1,0
96930,5,1,339260,339260,339261,0,1,4
96931,5,3,339265,339265,339268,0,3,4
96932,1,1,339266,339268,339269,2,3,0
96933,1,2,339267,339269,339271,2,4,0
96934,2,1,339269,339271,339272,2,3,0
96935,5,1,339274,339274,339275,0,1,2
96936,5,2,339279,339279,339281,0,2,4
96937,6,1,339285,339285,339286,0,1,4
96938,1,3,339286,339286,339289,0,3,0
96939,1,1,339287,339289,339290,2,3,0
96940,6,1,339293,339293,339294,0,1,3
96941,1,1,339294,339294,339295,0,1,0
96942,2,2,339296,339296,339298,0,2,1
96943,4,1,339300,339300,339301,0,1,2
96944,3,2,339303,339303,339305,0,2,2
96945,3,2,339306,339306,339308,0,2,1
96946,3,2,339309,339309,339311,0,2,1
96947,6,3,339315,339315,339318,0,3,4
96948,6,2,339321,339321,339323,0,2,3
96949,3,1,339324,339324,339325,0,1,1
96950,6,2,339330,339330,339332,0,2,5
96951,2,1,339332,339332,339333,0,1,0
96952,4,2,339336,339336,339338,0,2,3
96953,3,3,339339,339339,339342,0,3,1
96954,5,3,339344,339344,339347,0,3,2
96955,2,1,339346,339347,339348,1,2,0
96956,1,3,339347,339348,339351,1,4,0
96957,1,2,339348,339351,339353,3,5,0
96958,3,2,339351,339353,339355,2,4,0
96959,2,3,339353,339355,339358,2,5,0
96960,6,2,339359,339359,339361,0,2,1
96961,2,2,339361,339361,339363,0,2,0
96962,2,3,339363,339363,339366,0,3,0
96963,6,1,339369,339369,339370,0,1,3
96964,3,1,339372,339372,339373,0,1,2
96965,1,2,339373,339373,339375,0,2,0
96966,1,2,339374,339375,339377,1,3,0
96967,2,1,339376,339377,339378,1,2,0
96968,1,2,339377,339378,339380,1,3,0
96969,5,3,339382,339382,339385,0,3,2
96970,6,2,339388,339388,339390,0,2,3
96971,3,3,339391,339391,339394,0,3,1
96972,3,3,339394,339394,339397,0,3,0
96973,1,3,339395,339397,339400,2,5,0
96974,3,1,339398,339400,339401,2,3,0
96975,3,3,339401,339401,339404,0,3,0
96976,5,1,339406,339406,339407,0,1,2
96977,3,2,339409,339409,339411,0,2,2
96978,3,3,339412,339412,339415,0,3,1
96979,6,1,339418,339418,339419,0,1,3
96980,4,2,339422,339422,339424,0,2,3
96981,5,3,339427,339427,339430,0,3,3
96982,4,3,339431,339431,339434,0,3,1
96983,1,1,339432,339434,339435,2,3,0
96984,6,2,339438,339438,339440,0,2,3
96985,1,1,339439,339440,339441,1,2,0
96986,3,2,339442,339442,339444,0,2,1
96987,2,1,339444,339444,339445,0,1,0
96988,3,2,339447,339447,339449,0,2,2
96989,2,2,339449,339449,339451,0,2,0
96990,4,1,339453,339453,339454,0,1,2
96991,1,1,339454,339454,339455,0,1,0
96992,4,3,339458,339458,339461,0,3,3
96993,2,1,339460,339461,339462,1,2,0
96994,5,2,339465,339465,339467,0,2,3
96995,6,2,339471,339471,339473,0,2,4
96996,2,2,339473,339473,339475,0,2,0
96997,6,2,339479,339479,339481,0,2,4
96998,6,1,339485,339485,339486,0,1,4
96999,5,1,339490,339490,339491,0,1,4
97000,5,1,339495,339495,339496,0,1,4
97001,6,2,339501,339501,339503,0,2,5
97002,6,3,339507,339507,339510,0,3,4
97003,3,1,339510,339510,339511,0,1,0
97004,5,2,339515,339515,339517,0,2,4
97005,5,1,339520,339520,339521,0,1,3
97006,4,1,339524,339524,339525,0,1,3
97007,6,1,339530,339530,339531,0,1,5
97008,3,3,339533,339533,339536,0,3,2
97009,4,3,339537,339537,339540,0,3,1
97010,3,2,339540,339540,339542,0,2,0
97011,5,1,339545,339545,339546,0,1,3
97012,4,3,339549,339549,339552,0,3,3
97013,3,2,339552,339552,339554,0,2,0
97014,4,1,339556,339556,339557,0,1,2
97015,6,2,339562,339562,339564,0,2,5
97016,5,1,339567,339567,339568,0,1,3
97017,5,1,339572,339572,339573,0,1,4
97018,5,3,339577,339577,339580,0,3,4
97019,1,3,339578,339580,339583,2,5,0
97020,3,1,339581,339583,339584,2,3,0
97021,5,3,339586,339586,339589,0,3,2
97022,2,3,339588,339589,339592,1,4,0
97023,1,2,339589,339592,339594,3,5,0
97024,1,2,339590,339594,339596,4,6,0
97025,2,3,339592,339596,339599,4,7,0
97026,4,1,339596,339599,339600,3,4,0
97027,5,3,339601,339601,339604,0,3,1
97028,2,3,339603,339604,339607,1,4,0
97029,6,3,339609,339609,339612,0,3,2
97030,6,3,339615,339615,339618,0,3,3
97031,3,1,339618,339618,339619,0,1,0
97032,5,2,339623,339623,339625,0,2,4
97033,6,2,339629,339629,339631,0,2,4
97034,1,3,339630,339631,339634,1,4,0
97035,3,2,339633,339634,339636,1,3,0
97036,4,2,339637,339637,339639,0,2,1
97037,6,2,339643,339643,339645,0,2,4
97038,6,1,339649,339649,339650,0,1,4
97039,2,3,339651,339651,339654,0,3,1
97040,5,3,339656,339656,339659,0,3,2
97041,6,2,339662,339662,339664,0,2,3
97042,3,3,339665,339665,339668,0,3,1
97043,6,2,339671,339671,339673,0,2,3
97044,5,3,339676,339676,339679,0,3,3
97045,1,3,339677,339679,339682,2,5,0
97046,3,1,339680,339682,339683,2,3,0
97047,2,1,339682,339683,339684,1,2,0
97048,4,3,339686,339686,339689,0,3,2
97049,4,3,339690,339690,339693,0,3,1
97050,4,1,339694,339694,339695,0,1,1
97051,6,1,339700,339700,339701,0,1,5
97052,5,1,339705,339705,339706,0,1,4
97053,2,1,339707,339707,339708,0,1,1
97054,4,1,339711,339711,339712,0,1,3
97055,6,1,339717,339717,339718,0,1,5
97056,5,2,339722,339722,339724,0,2,4
97057,3,2,339725,339725,339727,0,2,1
97058,2,2,339727,339727,339729,0,2,0
97059,2,3,339729,339729,339732,0,3,0
97060,4,3,339733,339733,339736,0,3,1
97061,4,3,339737,339737,339740,0,3,1
97062,3,3,339740,339740,339743,0,3,0
97063,4,2,339744,339744,339746,0,2,1
97064,5,2,339749,339749,339751,0,2,3
97065,1,1,339750,339751,339752,1,2,0
97066,1,1,339751,339752,339753,1,2,0
97067,1,2,339752,339753,339755,1,3,0
97068,2,1,339754,339755,339756,1,2,0
97069,6,2,339760,339760,339762,0,2,4
97070,1,1,339761,339762,339763,1,2,0
97071,6,3,339767,339767,339770,0,3,4
97072,6,2,339773,339773,339775,0,2,3
97073,2,1,339775,339775,339776,0,1,0
97074,5,3,339780,339780,339783,0,3,4
97075,1,3,339781,339783,339786,2,5,0
97076,5,2,339786,339786,339788,0,2,0
97077,6,2,339792,339792,339794,0,2,4
97078,5,3,339797,339797,339800,0,3,3
97079,4,3,339801,339801,339804,0,3,1
97080,3,1,339804,339804,339805,0,1,0
97081,4,2,339808,339808,339810,0,2,3
97082,6,1,339814,339814,339815,0,1,4
97083,2,1,339816,339816,339817,0,1,1
97084,1,1,339817,339817,339818,0,1,0
97085,3,1,339820,339820,339821,0,1,2
97086,5,1,339825,339825,339826,0,1,4
97087,4,3,339829,339829,339832,0,3,3
97088,4,2,339833,339833,339835,0,2,1
97089,6,3,339839,339839,339842,0,3,4
97090,5,1,339844,339844,339845,0,1,2
97091,1,1,339845,339845,339846,0,1,0
97092,1,1,339846,339846,339847,0,1,0
97093,6,3,339852,339852,339855,0,3,5
97094,3,3,339855,339855,339858,0,3,0
97095,3,3,339858,339858,339861,0,3,0
97096,1,2,339859,339861,339863,2,4,0
97097,5,2,339864,339864,339866,0,2,1
97098,2,2,339866,339866,339868,0,2,0
97099,6,2,339872,339872,339874,0,2,4
97100,6,2,339878,339878,339880,0,2,4
97101,2,3,339880,339880,339883,0,3,0
97102,3,2,339883,339883,339885,0,2,0
97103,4,2,339887,339887,339889,0,2,2
97104,6,1,339893,339893,339894,0,1,4
97105,5,3,339898,339898,339901,0,3,4
97106,1,3,339899,339901,339904,2,5,0
97107,5,1,339904,339904,339905,0,1,0
97108,1,1,339905,339905,339906,0,1,0
97109,1,2,339906,339906,339908,0,2,0
97110,1,3,339907,339908,339911,1,4,0
97111,2,3,339909,339911,339914,2,5,0
97112,2,3,339911,339914,339917,3,6,0
97113,4,1,339915,339917,339918,2,3,0
97114,3,1,339918,339918,339919,0,1,0
97115,6,3,339924,339924,339927,0,3,5
97116,2,3,339926,339927,339930,1,4,0
97117,1,2,339927,339930,339932,3,5,0
97118,2,2,339929,339932,339934,3,5,0
97119,4,3,339933,339934,339937,1,4,0
97120,4,2,339937,339937,339939,0,2,0
97121,2,1,339939,339939,339940,0,1,0
97122,1,1,339940,339940,339941,0,1,0
97123,5,1,339945,339945,339946,0,1,4
97124,5,2,339950,339950,339952,0,2,4
97125,3,3,339953,339953,339956,0,3,1
97126,3,3,339956,339956,339959,0,3,0
97127,1,2,339957,339959,339961,2,4,0
97128,6,1,339963,339963,339964,0,1,2
97129,3,3,339966,339966,339969,0,3,2
97130,2,2,339968,339969,339971,1,3,0
97131,6,1,339974,339974,339975,0,1,3
97132,5,1,339979,339979,339980,0,1,4
97133,1,2,339980,339980,339982,0,2,0
97134,2,3,339982,339982,339985,0,3,0
97135,5,3,339987,339987,339990,0,3,2
97136,3,3,339990,339990,339993,0,3,0
97137,1,2,339991,339993,339995,2,4,0
97138,4,3,339995,339995,339998,0,3,0
97139,2,1,339997,339998,339999,1,2,0
97140,5,3,340002,340002,340005,0,3,3
97141,1,1,340003,340005,340006,2,3,0
97142,6,3,340009,340009,340012,0,3,3
97143,5,1,340014,340014,340015,0,1,2
97144,6,3,340020,340020,340023,0,3,5
97145,2,2,340022,340023,340025,1,3,0
97146,6,3,340028,340028,340031,0,3,3
97147,1,2,340029,340031,340033,2,4,0
97148,1,3,340030,340033,340036,3,6,0
97149,6,1,340036,340036,340037,0,1,0
97150,3,3,340039,340039,340042,0,3,2
97151,6,3,340045,340045,340048,0,3,3
97152,3,1,340048,340048,340049,0,1,0
97153,1,1,340049,340049,340050,0,1,0
97154,2,1,340051,340051,340052,0,1,1
97155,3,3,340054,340054,340057,0,3,2
97156,3,3,340057,340057,340060,0,3,0
97157,1,2,340058,340060,340062,2,4,0
97158,6,2,340064,340064,340066,0,2,2
97159,4,1,340068,340068,340069,0,1,2
97160,5,2,340073,340073,340075,0,2,4
97161,4,2,340077,340077,340079,0,2,2
97162,3,2,340080,340080,340082,0,2,1
97163,4,3,340084,340084,340087,0,3,2
97164,3,2,340087,340087,340089,0,2,0
97165,4,2,340091,340091,340093,0,2,2
97166,1,1,340092,340093,340094,1,2,0
97167,6,3,340098,340098,340101,0,3,4
97168,4,2,340102,340102,340104,0,2,1
97169,6,2,340108,340108,340110,0,2,4
97170,3,1,340111,340111,340112,0,1,1
97171,6,2,340117,340117,340119,0,2,5
97172,5,3,340122,340122,340125,0,3,3
97173,2,3,340124,340125,340128,1,4,0
97174,6,1,340130,340130,340131,0,1,2
97175,6,3,340136,340136,340139,0,3,5
97176,1,2,340137,340139,340141,2,4,0
97177,5,3,340142,340142,340145,0,3,1
97178,1,1,340143,340145,340146,2,3,0
97179,3,2,340146,340146,340148,0,2,0
97180,1,1,340147,340148,340149,1,2,0
97181,5,2,340152,340152,340154,0,2,3
97182,3,3,340155,340155,340158,0,3,1
97183,3,3,340158,340158,340161,0,3,0
97184,3,1,340161,340161,340162,0,1,0
97185,1,3,340162,340162,340165,0,3,0
97186,3,3,340165,340165,340168,0,3,0
97187,2,1,340167,340168,340169,1,2,0
97188,1,2,340168,340169,340171,1,3,0
97189,3,3,340171,340171,340174,0,3,0
97190,6,2,340177,340177,340179,0,2,3
97191,4,1,340181,340181,340182,0,1,2
97192,6,2,340187,340187,340189,0,2,5
97193,6,3,340193,340193,340196,0,3,4
97194,6,2,340199,340199,340201,0,2,3
97195,4,3,340203,340203,340206,0,3,2
97196,5,2,340208,340208,340210,0,2,2
97197,1,3,340209,340210,340213,1,4,0
97198,4,3,340213,340213,340216,0,3,0
97199,5,3,340218,340218,340221,0,3,2
97200,1,3,340219,340221,340224,2,5,0
97201,5,3,340224,340224,340227,0,3,0
97202,1,3,340225,340227,340230,2,5,0
97203,3,3,340228,340230,340233,2,5,0
97204,2,1,340230,340233,340234,3,4,0
97205,1,3,340231,340234,340237,3,6,0
97206,3,1,340234,340237,340238,3,4,0
97207,6,1,340240,340240,340241,0,1,2
97208,4,2,340244,340244,340246,0,2,3
97209,4,2,340248,340248,340250,0,2,2
97210,6,3,340254,340254,340257,0,3,4
97211,3,1,340257,340257,340258,0,1,0
97212,2,1,340259,340259,340260,0,1,1
97213,2,1,340261,340261,340262,0,1,1
97214,2,3,340263,340263,340266,0,3,1
97215,6,3,340269,340269,340272,0,3,3
97216,4,3,340273,340273,340276,0,3,1
97217,2,3,340275,340276,340279,1,4,0
97218,1,3,340276,340279,340282,3,6,0
97219,2,2,340278,340282,340284,4,6,0
97220,6,1,340284,340284,340285,0,1,0
97221,4,1,340288,340288,340289,0,1,3
97222,6,1,340294,340294,340295,0,1,5
97223,4,2,340298,340298,340300,0,2,3
97224,1,1,340299,340300,340301,1,2,0
97225,2,1,340301,340301,340302,0,1,0
97226,1,3,340302,340302,340305,0,3,0
97227,2,2,340304,340305,340307,1,3,0
97228,6,3,340310,340310,340313,0,3,3
97229,6,2,340316,340316,340318,0,2,3
97230,4,3,340320,340320,340323,0,3,2
97231,2,2,340322,340323,340325,1,3,0
97232,2,1,340324,340325,340326,1,2,0
97233,3,1,340327,340327,340328,0,1,1
97234,4,1,340331,340331,340332,0,1,3
97235,5,2,340336,340336,340338,0,2,4
97236,4,3,340340,340340,340343,0,3,2
97237,4,2,340344,340344,340346,0,2,1
97238,2,3,340346,340346,340349,0,3,0
97239,1,2,340347,340349,340351,2,4,0
97240,5,2,340352,340352,340354,0,2,1
97241,2,3,340354,340354,340357,0,3,0
97242,4,3,340358,340358,340361,0,3,1
97243,4,2,340362,340362,340364,0,2,1
97244,3,1,340365,340365,340366,0,1,1
97245,3,1,340368,340368,340369,0,1,2
97246,3,3,340371,340371,340374,0,3,2
97247,1,1,340372,340374,340375,2,3,0
97248,2,3,340374,340375,340378,1,4,0
97249,6,3,340380,340380,340383,0,3,2
97250,6,2,340386,340386,340388,0,2,3
97251,1,3,340387,340388,340391,1,4,0
97252,1,1,340388,340391,340392,3,4,0
97253,2,3,340390,340392,340395,2,5,0
97254,6,2,340396,340396,340398,0,2,1
97255,4,3,340400,340400,340403,0,3,2
97256,6,3,340406,340406,340409,0,3,3
97257,4,3,340410,340410,340413,0,3,1
97258,5,1,340415,340415,340416,0,1,2
97259,2,1,340417,340417,340418,0,1,1
97260,5,1,340422,340422,340423,0,1,4
97261,3,1,340425,340425,340426,0,1,2
97262,2,2,340427,340427,340429,0,2,1
97263,3,1,340430,340430,340431,0,1,1
97264,3,1,340433,340433,340434,0,1,2
97265,5,1,340438,340438,340439,0,1,4
97266,2,1,340440,340440,340441,0,1,1
97267,4,1,340444,340444,340445,0,1,3
97268,2,3,340446,340446,340449,0,3,1
97269,6,1,340452,340452,340453,0,1,3
97270,5,3,340457,340457,340460,0,3,4
97271,5,1,340462,340462,340463,0,1,2
97272,1,1,340463,340463,340464,0,1,0
97273,3,2,340466,340466,340468,0,2,2
97274,4,3,340470,340470,340473,0,3,2
97275,4,3,340474,340474,340477,0,3,1
97276,6,2,340480,340480,340482,0,2,3
97277,1,1,340481,340482,340483,1,2,0
97278,3,2,340484,340484,340486,0,2,1
97279,4,3,340488,340488,340491,0,3,2
97280,6,3,340494,340494,340497,0,3,3
97281,5,2,340499,340499,340501,0,2,2
97282,4,1,340503,340503,340504,0,1,2
97283,2,1,340505,340505,340506,0,1,1
97284,1,2,340506,340506,340508,0,2,0
97285,3,3,340509,340509,340512,0,3,1
97286,4,3,340513,340513,340516,0,3,1
97287,5,1,340518,340518,340519,0,1,2
97288,4,3,340522,340522,340525,0,3,3
97289,6,2,340528,340528,340530,0,2,3
97290,4,1,340532,340532,340533,0,1,2
97291,4,1,340536,340536,340537,0,1,3
97292,4,2,340540,340540,340542,0,2,3
97293,3,3,340543,340543,340546,0,3,1
97294,2,3,340545,340546,340549,1,4,0
97295,1,3,340546,340549,340552,3,6,0
97296,3,2,340549,340552,340554,3,5,0
97297,3,1,340552,340554,340555,2,3,0
97298,6,1,340558,340558,340559,0,1,3
97299,4,3,340562,340562,340565,0,3,3
97300,3,1,340565,340565,340566,0,1,0
97301,5,3,340570,340570,340573,0,3,4
97302,5,2,340575,340575,340577,0,2,2
97303,5,3,340580,340580,340583,0,3,3
97304,3,2,340583,340583,340585,0,2,0
97305,5,3,340588,340588,340591,0,3,3
97306,5,3,340593,340593,340596,0,3,2
97307,1,1,340594,340596,340597,2,3,0
97308,6,2,340600,340600,340602,0,2,3
97309,5,1,340605,340605,340606,0,1,3
97310,6,1,340611,340611,340612,0,1,5
97311,5,3,340616,340616,340619,0,3,4
97312,2,2,340618,340619,340621,1,3,0
97313,5,1,340623,340623,340624,0,1,2
97314,5,1,340628,340628,340629,0,1,4
97315,6,2,340634,340634,340636,0,2,5
97316,5,1,340639,340639,340640,0,1,3
97317,3,1,340642,340642,340643,0,1,2
97318,5,3,340647,340647,340650,0,3,4
97319,4,2,340651,340651,340653,0,2,1
97320,3,2,340654,340654,340656,0,2,1
97321,2,3,340656,340656,340659,0,3,0
97322,5,3,340661,340661,340664,0,3,2
97323,4,1,340665,340665,340666,0,1,1
97324,3,1,340668,340668,340669,0,1,2
97325,2,3,340670,340670,340673,0,3,1
97326,6,2,340676,340676,340678,0,2,3
97327,4,1,340680,340680,340681,0,1,2
97328,5,2,340685,340685,340687,0,2,4
97329,2,3,340687,340687,340690,0,3,0
97330,6,3,340693,340693,340696,0,3,3
97331,5,2,340698,340698,340700,0,2,2
97332,6,3,340704,340704,340707,0,3,4
97333,2,2,340706,340707,340709,1,3,0
97334,1,1,340707,340709,340710,2,3,0
97335,4,3,340711,340711,340714,0,3,1
97336,2,3,340713,340714,340717,1,4,0
97337,4,2,340717,340717,340719,0,2,0
97338,1,2,340718,340719,340721,1,3,0
97339,5,1,340723,340723,340724,0,1,2
97340,1,2,340724,340724,340726,0,2,0
97341,4,3,340728,340728,340731,0,3,2
97342,2,3,340730,340731,340734,1,4,0
97343,4,2,340734,340734,340736,0,2,0
97344,5,1,340739,340739,340740,0,1,3
97345,6,1,340745,340745,340746,0,1,5
97346,3,1,340748,340748,340749,0,1,2
97347,4,1,340752,340752,340753,0,1,3
97348,3,2,340755,340755,340757,0,2,2
97349,5,1,340760,340760,340761,0,1,3
97350,3,2,340763,340763,340765,0,2,2
97351,3,2,340766,340766,340768,0,2,1
97352,4,1,340770,340770,340771,0,1,2
97353,1,3,340771,340771,340774,0,3,0
97354,3,1,340774,340774,340775,0,1,0
97355,3,3,340777,340777,340780,0,3,2
97356,6,2,340783,340783,340785,0,2,3
97357,4,3,340787,340787,340790,0,3,2
97358,6,3,340793,340793,340796,0,3,3
97359,1,1,340794,340796,340797,2,3,0
97360,2,3,340796,340797,340800,1,4,0
97361,1,3,340797,340800,340803,3,6,0
97362,4,2,340801,340803,340805,2,4,0
97363,2,2,340803,340805,340807,2,4,0
97364,5,1,340808,340808,340809,0,1,1
97365,5,1,340813,340813,340814,0,1,4
97366,4,1,340817,340817,340818,0,1,3
97367,6,2,340823,340823,340825,0,2,5
97368,4,3,340827,340827,340830,0,3,2
97369,6,1,340833,340833,340834,0,1,3
97370,3,1,340836,340836,340837,0,1,2
97371,4,2,340840,340840,340842,0,2,3
97372,2,1,340842,340842,340843,0,1,0
97373,4,1,340846,340846,340847,0,1,3
97374,1,3,340847,340847,340850,0,3,0
97375,6,1,340853,340853,340854,0,1,3
97376,3,2,340856,340856,340858,0,2,2
97377,6,2,340862,340862,340864,0,2,4
97378,1,1,340863,340864,340865,1,2,0
97379,4,2,340867,340867,340869,0,2,2
97380,6,2,340873,340873,340875,0,2,4
97381,6,3,340879,340879,340882,0,3,4
97382,1,1,340880,340882,340883,2,3,0
97383,5,2,340885,340885,340887,0,2,2
97384,5,1,340890,340890,340891,0,1,3
97385,3,2,340893,340893,340895,0,2,2
97386,1,3,340894,340895,340898,1,4,0
97387,3,1,340897,340898,340899,1,2,0
97388,5,3,340902,340902,340905,0,3,3
97389,2,2,340904,340905,340907,1,3,0
97390,6,1,340910,340910,340911,0,1,3
97391,5,3,340915,340915,340918,0,3,4
97392,1,3,340916,340918,340921,2,5,0
97393,5,2,340921,340921,340923,0,2,0
97394,6,3,340927,340927,340930,0,3,4
97395,3,2,340930,340930,340932,0,2,0
97396,4,3,340934,340934,340937,0,3,2
97397,5,2,340939,340939,340941,0,2,2
97398,2,2,340941,340941,340943,0,2,0
97399,4,2,340945,340945,340947,0,2,2
97400,4,1,340949,340949,340950,0,1,2
97401,1,1,340950,340950,340951,0,1,0
97402,3,3,340953,340953,340956,0,3,2
97403,1,2,340954,340956,340958,2,4,0
97404,6,1,340960,340960,340961,0,1,2
97405,6,3,340966,340966,340969,0,3,5
97406,1,3,340967,340969,340972,2,5,0
97407,3,3,340970,340972,340975,2,5,0
97408,5,2,340975,340975,340977,0,2,0
97409,4,2,340979,340979,340981,0,2,2
97410,5,3,340984,340984,340987,0,3,3
97411,4,2,340988,340988,340990,0,2,1
97412,6,3,340994,340994,340997,0,3,4
97413,2,2,340996,340997,340999,1,3,0
97414,3,1,340999,340999,341000,0,1,0
97415,2,1,341001,341001,341002,0,1,1
97416,3,2,341004,341004,341006,0,2,2
97417,3,3,341007,341007,341010,0,3,1
97418,6,1,341013,341013,341014,0,1,3
97419,6,2,341019,341019,341021,0,2,5
97420,6,3,341025,341025,341028,0,3,4
97421,1,3,341026,341028,341031,2,5,0
97422,5,2,341031,341031,341033,0,2,0
97423,3,1,341034,341034,341035,0,1,1
97424,1,3,341035,341035,341038,0,3,0
97425,3,2,341038,341038,341040,0,2,0
97426,1,3,341039,341040,341043,1,4,0
97427,6,1,341045,341045,341046,0,1,2
97428,5,3,341050,341050,341053,0,3,4
97429,4,2,341054,341054,341056,0,2,1
97430,6,2,341060,341060,341062,0,2,4
97431,6,1,341066,341066,341067,0,1,4
97432,2,1,341068,341068,341069,0,1,1
97433,6,3,341074,341074,341077,0,3,5
97434,6,3,341080,341080,341083,0,3,3
97435,6,3,341086,341086,341089,0,3,3
97436,6,3,341092,341092,341095,0,3,3
97437,6,3,341098,341098,341101,0,3,3
97438,3,1,341101,341101,341102,0,1,0
97439,1,3,341102,341102,341105,0,3,0
97440,6,2,341108,341108,341110,0,2,3
97441,6,2,341114,341114,341116,0,2,4
97442,2,2,341116,341116,341118,0,2,0
97443,4,2,341120,341120,341122,0,2,2
97444,1,1,341121,341122,341123,1,2,0
97445,4,2,341125,341125,341127,0,2,2
97446,4,2,341129,341129,341131,0,2,2
97447,5,1,341134,341134,341135,0,1,3
97448,4,1,341138,341138,341139,0,1,3
97449,6,2,341144,341144,341146,0,2,5
97450,6,2,341150,341150,341152,0,2,4
97451,6,1,341156,341156,341157,0,1,4
97452,5,3,341161,341161,341164,0,3,4
97453,1,3,341162,341164,341167,2,5,0
97454,2,2,341164,341167,341169,3,5,0
97455,2,3,341166,341169,341172,3,6,0
97456,4,1,341170,341172,341173,2,3,0
97457,1,1,341171,341173,341174,2,3,0
97458,6,1,341177,341177,341178,0,1,3
97459,2,3,341179,341179,341182,0,3,1
97460,1,2,341180,341182,341184,2,4,0
97461,1,3,341181,341184,341187,3,6,0
97462,1,2,341182,341187,341189,5,7,0
97463,5,3,341187,341189,341192,2,5,0
97464,2,1,341189,341192,341193,3,4,0
97465,6,1,341195,341195,341196,0,1,2
97466,4,2,341199,341199,341201,0,2,3
97467,3,1,341202,341202,341203,0,1,1
97468,5,1,341207,341207,341208,0,1,4
97469,3,2,341210,341210,341212,0,2,2
97470,3,1,341213,341213,341214,0,1,1
97471,1,1,341214,341214,341215,0,1,0
97472,5,2,341219,341219,341221,0,2,4
97473,6,2,341225,341225,341227,0,2,4
97474,2,3,341227,341227,341230,0,3,0
97475,3,3,341230,341230,341233,0,3,0
97476,3,3,341233,341233,341236,0,3,0
97477,1,3,341234,341236,341239,2,5,0
97478,2,3,341236,341239,341242,3,6,0
97479,6,1,341242,341242,341243,0,1,0
97480,3,3,341245,341245,341248,0,3,2
97481,5,2,341250,341250,341252,0,2,2
97482,2,2,341252,341252,341254,0,2,0
97483,1,3,341253,341254,341257,1,4,0
97484,4,2,341257,341257,341259,0,2,0
97485,4,3,341261,341261,341264,0,3,2
97486,2,2,341263,341264,341266,1,3,0
97487,6,1,341269,341269,341270,0,1,3
97488,3,2,341272,341272,341274,0,2,2
97489,1,1,341273,341274,341275,1,2,0
97490,3,3,341276,341276,341279,0,3,1
97491,3,2,341279,341279,341281,0,2,0
97492,5,3,341284,341284,341287,0,3,3
97493,6,3,341290,341290,341293,0,3,3
97494,4,3,341294,341294,341297,0,3,1
97495,3,3,341297,341297,341300,0,3,0
97496,1,1,341298,341300,341301,2,3,0
97497,2,1,341300,341301,341302,1,2,0
97498,6,3,341306,341306,341309,0,3,4
97499,3,1,341309,341309,341310,0,1,0
97500,2,2,341311,341311,341313,0,2,1
97501,6,3,341317,341317,341320,0,3,4
97502,3,3,341320,341320,341323,0,3,0
97503,6,2,341326,341326,341328,0,2,3
97504,4,2,341330,341330,341332,0,2,2
97505,4,1,341334,341334,341335,0,1,2
97506,6,3,341340,341340,341343,0,3,5
97507,5,2,341345,341345,341347,0,2,2
97508,5,1,341350,341350,341351,0,1,3
97509,2,3,341352,341352,341355,0,3,1
97510,4,3,341356,341356,341359,0,3,1
97511,2,1,341358,341359,341360,1,2,0
97512,6,2,341364,341364,341366,0,2,4
97513,2,2,341366,341366,341368,0,2,0
97514,2,1,341368,341368,341369,0,1,0
97515,3,3,341371,341371,341374,0,3,2
97516,5,3,341376,341376,341379,0,3,2
97517,5,3,341381,341381,341384,0,3,2
97518,1,2,341382,341384,341386,2,4,0
97519,5,1,341387,341387,341388,0,1,1
97520,4,3,341391,341391,341394,0,3,3
97521,3,1,341394,341394,341395,0,1,0
97522,2,2,341396,341396,341398,0,2,1
97523,5,2,341401,341401,341403,0,2,3
97524,3,3,341404,341404,341407,0,3,1
97525,3,3,341407,341407,341410,0,3,0
97526,3,2,341410,341410,341412,0,2,0
97527,6,2,341416,341416,341418,0,2,4
97528,6,3,341422,341422,341425,0,3,4
97529,2,1,341424,341425,341426,1,2,0
97530,6,3,341430,341430,341433,0,3,4
97531,3,1,341433,341433,341434,0,1,0
97532,6,3,341439,341439,341442,0,3,5
97533,3,3,341442,341442,341445,0,3,0
97534,6,2,341448,341448,341450,0,2,3
97535,5,1,341453,341453,341454,0,1,3
97536,2,3,341455,341455,341458,0,3,1
97537,4,2,341459,341459,341461,0,2,1
97538,2,2,341461,341461,341463,0,2,0
97539,3,3,341464,341464,341467,0,3,1
97540,1,2,341465,341467,341469,2,4,0
97541,1,1,341466,341469,341470,3,4,0
97542,3,1,341469,341470,341471,1,2,0
97543,5,2,341474,341474,341476,0,2,3
97544,4,2,341478,341478,341480,0,2,2
97545,2,3,341480,341480,341483,0,3,0
97546,1,1,341481,341483,341484,2,3,0
97547,2,3,341483,341484,341487,1,4,0
97548,3,1,341486,341487,341488,1,2,0
97549,2,1,341488,341488,341489,0,1,0
97550,5,2,341493,341493,341495,0,2,4
97551,6,2,341499,341499,341501,0,2,4
97552,1,2,341500,341501,341503,1,3,0
97553,6,1,341506,341506,341507,0,1,3
97554,3,3,341509,341509,341512,0,3,2
97555,1,3,341510,341512,341515,2,5,0
97556,1,2,341511,341515,341517,4,6,0
97557,5,1,341516,341517,341518,1,2,0
97558,4,3,341520,341520,341523,0,3,2
97559,5,3,341525,341525,341528,0,3,2
97560,4,3,341529,341529,341532,0,3,1
97561,5,1,341534,341534,341535,0,1,2
97562,4,2,341538,341538,341540,0,2,3
97563,2,2,341540,341540,341542,0,2,0
97564,5,2,341545,341545,341547,0,2,3
97565,6,2,341551,341551,341553,0,2,4
97566,5,3,341556,341556,341559,0,3,3
97567,4,2,341560,341560,341562,0,2,1
97568,5,2,341565,341565,341567,0,2,3
97569,3,3,341568,341568,341571,0,3,1
97570,5,2,341573,341573,341575,0,2,2
97571,2,3,341575,341575,341578,0,3,0
97572,6,2,341581,341581,341583,0,2,3
97573,2,2,341583,341583,341585,0,2,0
97574,2,1,341585,341585,341586,0,1,0
97575,1,3,341586,341586,341589,0,3,0
97576,1,1,341587,341589,341590,2,3,0
97577,5,2,341592,341592,341594,0,2,2
97578,5,2,341597,341597,341599,0,2,3
97579,6,3,341603,341603,341606,0,3,4
97580,1,1,341604,341606,341607,2,3,0
97581,1,3,341605,341607,341610,2,5,0
97582,6,2,341611,341611,341613,0,2,1
97583,4,2,341615,341615,341617,0,2,2
97584,6,2,341621,341621,341623,0,2,4
97585,6,3,341627,341627,341630,0,3,4
97586,4,1,341631,341631,341632,0,1,1
97587,4,3,341635,341635,341638,0,3,3
97588,2,2,341637,341638,341640,1,3,0
97589,2,1,341639,341640,341641,1,2,0
97590,1,2,341640,341641,341643,1,3,0
97591,6,3,341646,341646,341649,0,3,3
97592,4,2,341650,341650,341652,0,2,1
97593,1,1,341651,341652,341653,1,2,0
97594,2,2,341653,341653,341655,0,2,0
97595,4,2,341657,341657,341659,0,2,2
97596,1,3,341658,341659,341662,1,4,0
97597,5,3,341663,341663,341666,0,3,1
97598,2,2,341665,341666,341668,1,3,0
97599,1,1,341666,341668,341669,2,3,0
97600,1,2,341667,341669,341671,2,4,0
97601,5,3,341672,341672,341675,0,3,1
97602,3,3,341675,341675,341678,0,3,0
97603,2,1,341677,341678,341679,1,2,0
97604,2,1,341679,341679,341680,0,1,0
97605,1,1,341680,341680,341681,0,1,0
97606,3,1,341683,341683,341684,0,1,2
97607,6,2,341689,341689,341691,0,2,5
97608,4,1,341693,341693,341694,0,1,2
97609,4,1,341697,341697,341698,0,1,3
97610,6,2,341703,341703,341705,0,2,5
97611,5,2,341708,341708,341710,0,2,3
97612,5,2,341713,341713,341715,0,2,3
97613,2,3,341715,341715,341718,0,3,0
97614,5,2,341720,341720,341722,0,2,2
97615,4,2,341724,341724,341726,0,2,2
97616,2,3,341726,341726,341729,0,3,0
97617,5,1,341731,341731,341732,0,1,2
97618,3,1,341734,341734,341735,0,1,2
97619,5,2,341739,341739,341741,0,2,4
97620,6,2,341745,341745,341747,0,2,4
97621,3,3,341748,341748,341751,0,3,1
97622,2,2,341750,341751,341753,1,3,0
97623,4,1,341754,341754,341755,0,1,1
97624,5,3,341759,341759,341762,0,3,4
97625,6,1,341765,341765,341766,0,1,3
97626,3,2,341768,341768,341770,0,2,2
97627,1,2,341769,341770,341772,1,3,0
97628,6,1,341775,341775,341776,0,1,3
97629,6,1,341781,341781,341782,0,1,5
97630,4,1,341785,341785,341786,0,1,3
97631,5,2,341790,341790,341792,0,2,4
97632,6,1,341796,341796,341797,0,1,4
97633,4,1,341800,341800,341801,0,1,3
97634,2,3,341802,341802,341805,0,3,1
97635,6,2,341808,341808,341810,0,2,3
97636,6,1,341814,341814,341815,0,1,4
97637,6,2,341820,341820,341822,0,2,5
97638,3,3,341823,341823,341826,0,3,1
97639,1,2,341824,341826,341828,2,4,0
97640,4,1,341828,341828,341829,0,1,0
97641,4,2,341832,341832,341834,0,2,3
97642,6,3,341838,341838,341841,0,3,4
97643,2,2,341840,341841,341843,1,3,0
97644,3,2,341843,341843,341845,0,2,0
97645,3,3,341846,341846,341849,0,3,1
97646,5,2,341851,341851,341853,0,2,2
97647,2,1,341853,341853,341854,0,1,0
97648,4,1,341857,341857,341858,0,1,3
97649,4,2,341861,341861,341863,0,2,3
97650,4,1,341865,341865,341866,0,1,2
97651,5,3,341870,341870,341873,0,3,4
97652,1,1,341871,341873,341874,2,3,0
97653,2,1,341873,341874,341875,1,2,0
97654,3,3,341876,341876,341879,0,3,1
97655,3,2,341879,341879,341881,0,2,0
97656,2,1,341881,341881,341882,0,1,0
97657,6,2,341887,341887,341889,0,2,5
97658,3,3,341890,341890,341893,0,3,1
97659,4,2,341894,341894,341896,0,2,1
97660,3,3,341897,341897,341900,0,3,1
97661,3,1,341900,341900,341901,0,1,0
97662,1,2,341901,341901,341903,0,2,0
97663,3,2,341904,341904,341906,0,2,1
97664,6,3,341910,341910,341913,0,3,4
97665,4,1,341914,341914,341915,0,1,1
97666,3,1,341917,341917,341918,0,1,2
97667,4,3,341921,341921,341924,0,3,3
97668,5,2,341926,341926,341928,0,2,2
97669,3,3,341929,341929,341932,0,3,1
97670,4,2,341933,341933,341935,0,2,1
97671,3,3,341936,341936,341939,0,3,1
97672,3,1,341939,341939,341940,0,1,0
97673,3,2,341942,341942,341944,0,2,2
97674,6,1,341948,341948,341949,0,1,4
97675,4,1,341952,341952,341953,0,1,3
97676,2,2,341954,341954,341956,0,2,1
97677,5,3,341959,341959,341962,0,3,3
97678,5,2,341964,341964,341966,0,2,2
97679,5,2,341969,341969,341971,0,2,3
97680,5,2,341974,341974,341976,0,2,3
97681,3,1,341977,341977,341978,0,1,1
97682,1,3,341978,341978,341981,0,3,0
97683,3,1,341981,341981,341982,0,1,0
97684,6,2,341987,341987,341989,0,2,5
97685,4,1,341991,341991,341992,0,1,2
97686,4,2,341995,341995,341997,0,2,3
97687,4,1,341999,341999,342000,0,1,2
97688,6,2,342005,342005,342007,0,2,5
97689,4,3,342009,342009,342012,0,3,2
97690,3,2,342012,342012,342014,0,2,0
97691,5,2,342017,342017,342019,0,2,3
97692,3,2,342020,342020,342022,0,2,1
97693,4,1,342024,342024,342025,0,1,2
97694,6,1,342030,342030,342031,0,1,5
97695,2,1,342032,342032,342033,0,1,1
97696,2,1,342034,342034,342035,0,1,1
97697,5,1,342039,342039,342040,0,1,4
97698,2,3,342041,342041,342044,0,3,1
97699,3,3,342044,342044,342047,0,3,0
97700,2,1,342046,342047,342048,1,2,0
97701,3,1,342049,342049,342050,0,1,1
97702,4,1,342053,342053,342054,0,1,3
97703,1,1,342054,342054,342055,0,1,0
97704,2,2,342056,342056,342058,0,2,1
97705,3,3,342059,342059,342062,0,3,1
97706,3,3,342062,342062,342065,0,3,0
97707,4,3,342066,342066,342069,0,3,1
97708,2,1,342068,342069,342070,1,2,0
97709,5,3,342073,342073,342076,0,3,3
97710,5,1,342078,342078,342079,0,1,2
97711,2,2,342080,342080,342082,0,2,1
97712,1,2,342081,342082,342084,1,3,0
97713,5,2,342086,342086,342088,0,2,2
97714,6,3,342092,342092,342095,0,3,4
97715,6,3,342098,342098,342101,0,3,3
97716,6,2,342104,342104,342106,0,2,3
97717,2,3,342106,342106,342109,0,3,0
97718,5,3,342111,342111,342114,0,3,2
97719,1,2,342112,342114,342116,2,4,0
97720,4,1,342116,342116,342117,0,1,0
97721,6,1,342122,342122,342123,0,1,5
97722,5,2,342127,342127,342129,0,2,4
97723,1,1,342128,342129,342130,1,2,0
97724,3,1,342131,342131,342132,0,1,1
97725,1,3,342132,342132,342135,0,3,0
97726,4,3,342136,342136,342139,0,3,1
97727,6,1,342142,342142,342143,0,1,3
97728,3,2,342145,342145,342147,0,2,2
97729,4,2,342149,342149,342151,0,2,2
97730,6,1,342155,342155,342156,0,1,4
97731,6,1,342161,342161,342162,0,1,5
97732,6,3,342167,342167,342170,0,3,5
97733,5,1,342172,342172,342173,0,1,2
97734,1,3,342173,342173,342176,0,3,0
97735,6,1,342179,342179,342180,0,1,3
97736,5,1,342184,342184,342185,0,1,4
97737,2,3,342186,342186,342189,0,3,1
97738,3,2,342189,342189,342191,0,2,0
97739,1,1,342190,342191,342192,1,2,0
97740,6,1,342196,342196,342197,0,1,4
97741,5,3,342201,342201,342204,0,3,4
97742,3,3,342204,342204,342207,0,3,0
97743,6,1,342210,342210,342211,0,1,3
97744,5,2,342215,342215,342217,0,2,4
97745,2,1,342217,342217,342218,0,1,0
97746,5,1,342222,342222,342223,0,1,4
97747,4,1,342226,342226,342227,0,1,3
97748,6,2,342232,342232,342234,0,2,5
97749,1,2,342233,342234,342236,1,3,0
97750,5,3,342238,342238,342241,0,3,2
97751,3,3,342241,342241,342244,0,3,0
97752,2,2,342243,342244,342246,1,3,0
97753,5,2,342248,342248,342250,0,2,2
97754,3,2,342251,342251,342253,0,2,1
97755,3,1,342254,342254,342255,0,1,1
97756,6,3,342260,342260,342263,0,3,5
97757,5,1,342265,342265,342266,0,1,2
97758,5,1,342270,342270,342271,0,1,4
97759,4,2,342274,342274,342276,0,2,3
97760,3,1,342277,342277,342278,0,1,1
97761,5,2,342282,342282,342284,0,2,4
97762,6,1,342288,342288,342289,0,1,4
97763,5,1,342293,342293,342294,0,1,4
97764,6,1,342299,342299,342300,0,1,5
97765,5,1,342304,342304,342305,0,1,4
97766,3,2,342307,342307,342309,0,2,2
97767,4,3,342311,342311,342314,0,3,2
97768,2,3,342313,342314,342317,1,4,0
97769,3,1,342316,342317,342318,1,2,0
97770,4,3,342320,342320,342323,0,3,2
97771,6,2,342326,342326,342328,0,2,3
97772,5,3,342331,342331,342334,0,3,3
97773,2,2,342333,342334,342336,1,3,0
97774,5,1,342338,342338,342339,0,1,2
97775,4,1,342342,342342,342343,0,1,3
97776,2,2,342344,342344,342346,0,2,1
97777,2,2,342346,342346,342348,0,2,0
97778,6,1,342352,342352,342353,0,1,4
97779,6,2,342358,342358,342360,0,2,5
97780,4,2,342362,342362,342364,0,2,2
97781,6,3,342368,342368,342371,0,3,4
97782,5,2,342373,342373,342375,0,2,2
97783,2,3,342375,342375,342378,0,3,0
97784,6,3,342381,342381,342384,0,3,3
97785,6,2,342387,342387,342389,0,2,3
97786,1,2,342388,342389,342391,1,3,0
97787,4,2,342392,342392,342394,0,2,1
97788,1,3,342393,342394,342397,1,4,0
97789,1,3,342394,342397,342400,3,6,0
97790,3,3,342397,342400,342403,3,6,0
97791,2,3,342399,342403,342406,4,7,0
97792,5,1,342404,342406,342407,2,3,0
97793,4,1,342408,342408,342409,0,1,1
97794,4,1,342412,342412,342413,0,1,3
97795,5,2,342417,342417,342419,0,2,4
97796,3,2,342420,342420,342422,0,2,1
97797,1,2,342421,342422,342424,1,3,0
97798,5,3,342426,342426,342429,0,3,2
97799,4,2,342430,342430,342432,0,2,1
97800,2,2,342432,342432,342434,0,2,0
97801,2,3,342434,342434,342437,0,3,0
97802,5,3,342439,342439,342442,0,3,2
97803,5,2,342444,342444,342446,0,2,2
97804,3,2,342447,342447,342449,0,2,1
97805,3,2,342450,342450,342452,0,2,1
97806,5,3,342455,342455,342458,0,3,3
97807,2,3,342457,342458,342461,1,4,0
97808,2,1,342459,342461,342462,2,3,0
97809,2,2,342461,342462,342464,1,3,0
97810,3,3,342464,342464,342467,0,3,0
97811,2,1,342466,342467,342468,1,2,0
97812,5,3,342471,342471,342474,0,3,3
97813,6,2,342477,342477,342479,0,2,3
97814,3,3,342480,342480,342483,0,3,1
97815,6,2,342486,342486,342488,0,2,3
97816,6,1,342492,342492,342493,0,1,4
97817,5,1,342497,342497,342498,0,1,4
97818,6,3,342503,342503,342506,0,3,5
97819,2,1,342505,342506,342507,1,2,0
97820,6,2,342511,342511,342513,0,2,4
97821,4,2,342515,342515,342517,0,2,2
97822,5,2,342520,342520,342522,0,2,3
97823,6,1,342526,342526,342527,0,1,4
97824,3,1,342529,342529,342530,0,1,2
97825,5,3,342534,342534,342537,0,3,4
97826,2,3,342536,342537,342540,1,4,0
97827,1,3,342537,342540,342543,3,6,0
97828,1,1,342538,342543,342544,5,6,0
97829,3,1,342541,342544,342545,3,4,0
97830,5,3,342546,342546,342549,0,3,1
97831,4,2,342550,342550,342552,0,2,1
97832,6,1,342556,342556,342557,0,1,4
97833,4,2,342560,342560,342562,0,2,3
97834,4,3,342564,342564,342567,0,3,2
97835,6,1,342570,342570,342571,0,1,3
97836,6,2,342576,342576,342578,0,2,5
97837,4,3,342580,342580,342583,0,3,2
97838,5,3,342585,342585,342588,0,3,2
97839,6,2,342591,342591,342593,0,2,3
97840,1,1,342592,342593,342594,1,2,0
97841,5,2,342597,342597,342599,0,2,3
97842,2,1,342599,342599,342600,0,1,0
97843,4,1,342603,342603,342604,0,1,3
97844,3,3,342606,342606,342609,0,3,2
97845,5,3,342611,342611,342614,0,3,2
97846,4,2,342615,342615,342617,0,2,1
97847,4,3,342619,342619,342622,0,3,2
97848,6,3,342625,342625,342628,0,3,3
97849,5,3,342630,342630,342633,0,3,2
97850,1,3,342631,342633,342636,2,5,0
97851,2,2,342633,342636,342638,3,5,0
97852,4,2,342637,342638,342640,1,3,0
97853,3,3,342640,342640,342643,0,3,0
97854,5,1,342645,342645,342646,0,1,2
97855,3,2,342648,342648,342650,0,2,2
97856,3,3,342651,342651,342654,0,3,1
97857,2,2,342653,342654,342656,1,3,0
97858,5,1,342658,342658,342659,0,1,2
97859,1,1,342659,342659,342660,0,1,0
97860,3,1,342662,342662,342663,0,1,2
97861,2,3,342664,342664,342667,0,3,1
97862,3,3,342667,342667,342670,0,3,0
97863,3,3,342670,342670,342673,0,3,0
97864,1,1,342671,342673,342674,2,3,0
97865,1,2,342672,342674,342676,2,4,0
97866,1,3,342673,342676,342679,3,6,0
97867,4,3,342677,342679,342682,2,5,0
97868,4,1,342681,342682,342683,1,2,0
97869,3,2,342684,342684,342686,0,2,1
97870,2,1,342686,342686,342687,0,1,0
97871,3,3,342689,342689,342692,0,3,2
97872,4,3,342693,342693,342696,0,3,1
97873,4,2,342697,342697,342699,0,2,1
97874,3,2,342700,342700,342702,0,2,1
97875,4,3,342704,342704,342707,0,3,2
97876,5,3,342709,342709,342712,0,3,2
97877,2,3,342711,342712,342715,1,4,0
97878,2,3,342713,342715,342718,2,5,0
97879,6,3,342719,342719,342722,0,3,1
97880,1,1,342720,342722,342723,2,3,0
97881,2,3,342722,342723,342726,1,4,0
97882,2,3,342724,342726,342729,2,5,0
97883,1,2,342725,342729,342731,4,6,0
97884,2,2,342727,342731,342733,4,6,0
97885,6,1,342733,342733,342734,0,1,0
97886,6,1,342739,342739,342740,0,1,5
97887,1,3,342740,342740,342743,0,3,0
97888,3,1,342743,342743,342744,0,1,0
97889,3,1,342746,342746,342747,0,1,2
97890,2,2,342748,342748,342750,0,2,1
97891,2,1,342750,342750,342751,0,1,0
97892,4,2,342754,342754,342756,0,2,3
97893,4,2,342758,342758,342760,0,2,2
97894,3,1,342761,342761,342762,0,1,1
97895,3,2,342764,342764,342766,0,2,2
97896,5,1,342769,342769,342770,0,1,3
97897,3,1,342772,342772,342773,0,1,2
97898,1,1,342773,342773,342774,0,1,0
97899,3,3,342776,342776,342779,0,3,2
97900,1,1,342777,342779,342780,2,3,0
97901,6,2,342783,342783,342785,0,2,3
97902,1,2,342784,342785,342787,1,3,0
97903,3,1,342787,342787,342788,0,1,0
97904,5,3,342792,342792,342795,0,3,4
97905,6,1,342798,342798,342799,0,1,3
97906,1,2,342799,342799,342801,0,2,0
97907,6,2,342805,342805,342807,0,2,4
97908,3,3,342808,342808,342811,0,3,1
97909,4,3,342812,342812,342815,0,3,1
97910,1,1,342813,342815,342816,2,3,0
97911,6,3,342819,342819,342822,0,3,3
97912,5,1,342824,342824,342825,0,1,2
97913,1,1,342825,342825,342826,0,1,0
97914,5,2,342830,342830,342832,0,2,4
97915,2,2,342832,342832,342834,0,2,0
97916,1,1,342833,342834,342835,1,2,0
97917,6,1,342839,342839,342840,0,1,4
97918,1,1,342840,342840,342841,0,1,0
97919,5,3,342845,342845,342848,0,3,4
97920,3,2,342848,342848,342850,0,2,0
97921,2,2,342850,342850,342852,0,2,0
97922,1,2,342851,342852,342854,1,3,0
97923,2,2,342853,342854,342856,1,3,0
97924,2,2,342855,342856,342858,1,3,0
97925,5,1,342860,342860,342861,0,1,2
97926,4,2,342864,342864,342866,0,2,3
97927,2,3,342866,342866,342869,0,3,0
97928,3,1,342869,342869,342870,0,1,0
97929,4,3,342873,342873,342876,0,3,3
97930,2,2,342875,342876,342878,1,3,0
97931,5,2,342880,342880,342882,0,2,2
97932,2,2,342882,342882,342884,0,2,0
97933,2,3,342884,342884,342887,0,3,0
97934,1,3,342885,342887,342890,2,5,0
97935,4,2,342889,342890,342892,1,3,0
97936,4,1,342893,342893,342894,0,1,1
97937,5,1,342898,342898,342899,0,1,4
97938,1,2,342899,342899,342901,0,2,0
97939,2,2,342901,342901,342903,0,2,0
97940,2,3,342903,342903,342906,0,3,0
97941,2,1,342905,342906,342907,1,2,0
97942,1,3,342906,342907,342910,1,4,0
97943,6,2,342912,342912,342914,0,2,2
97944,6,3,342918,342918,342921,0,3,4
97945,1,3,342919,342921,342924,2,5,0
97946,4,1,342923,342924,342925,1,2,0
97947,3,3,342926,342926,342929,0,3,1
97948,1,2,342927,342929,342931,2,4,0
97949,2,2,342929,342931,342933,2,4,0
97950,5,1,342934,342934,342935,0,1,1
97951,3,1,342937,342937,342938,0,1,2
97952,2,1,342939,342939,342940,0,1,1
97953,6,3,342945,342945,342948,0,3,5
97954,3,3,342948,342948,342951,0,3,0
97955,6,2,342954,342954,342956,0,2,3
97956,1,2,342955,342956,342958,1,3,0
97957,2,3,342957,342958,342961,1,4,0
97958,1,1,342958,342961,342962,3,4,0
97959,3,1,342961,342962,342963,1,2,0
97960,6,2,342967,342967,342969,0,2,4
97961,2,3,342969,342969,342972,0,3,0
97962,6,3,342975,342975,342978,0,3,3
97963,2,1,342977,342978,342979,1,2,0
97964,1,3,342978,342979,342982,1,4,0
97965,1,2,342979,342982,342984,3,5,0
97966,6,1,342985,342985,342986,0,1,1
97967,2,1,342987,342987,342988,0,1,1
97968,5,2,342992,342992,342994,0,2,4
97969,2,2,342994,342994,342996,0,2,0
97970,3,3,342997,342997,343000,0,3,1
97971,6,3,343003,343003,343006,0,3,3
97972,3,2,343006,343006,343008,0,2,0
97973,4,1,343010,343010,343011,0,1,2
97974,3,2,343013,343013,343015,0,2,2
97975,1,3,343014,343015,343018,1,4,0
97976,5,3,343019,343019,343022,0,3,1
97977,2,3,343021,343022,343025,1,4,0
97978,1,1,343022,343025,343026,3,4,0
97979,6,1,343028,343028,343029,0,1,2
97980,2,3,343030,343030,343033,0,3,1
97981,2,1,343032,343033,343034,1,2,0
97982,5,3,343037,343037,343040,0,3,3
97983,4,2,343041,343041,343043,0,2,1
97984,3,1,343044,343044,343045,0,1,1
97985,4,1,343048,343048,343049,0,1,3
97986,6,2,343054,343054,343056,0,2,5
97987,3,3,343057,343057,343060,0,3,1
97988,2,2,343059,343060,343062,1,3,0
97989,1,1,343060,343062,343063,2,3,0
97990,2,3,343062,343063,343066,1,4,0
97991,2,1,343064,343066,343067,2,3,0
97992,6,3,343070,343070,343073,0,3,3
97993,2,2,343072,343073,343075,1,3,0
97994,2,3,343074,343075,343078,1,4,0
97995,4,2,343078,343078,343080,0,2,0
97996,2,2,343080,343080,343082,0,2,0
97997,5,3,343085,343085,343088,0,3,3
97998,1,2,343086,343088,343090,2,4,0
97999,3,3,343089,343090,343093,1,4,0
98000,4,1,343093,343093,343094,0,1,0
98001,6,1,343099,343099,343100,0,1,5
98002,5,3,343104,343104,343107,0,3,4
98003,2,1,343106,343107,343108,1,2,0
98004,2,2,343108,343108,343110,0,2,0
98005,4,1,343112,343112,343113,0,1,2
98006,4,2,343116,343116,343118,0,2,3
98007,1,1,343117,343118,343119,1,2,0
98008,5,3,343122,343122,343125,0,3,3
98009,1,3,343123,343125,343128,2,5,0
98010,5,3,343128,343128,343131,0,3,0
98011,6,3,343134,343134,343137,0,3,3
98012,2,3,343136,343137,343140,1,4,0
98013,6,1,343142,343142,343143,0,1,2
98014,1,3,343143,343143,343146,0,3,0
98015,3,2,343146,343146,343148,0,2,0
98016,4,1,343150,343150,343151,0,1,2
98017,1,3,343151,343151,343154,0,3,0
98018,1,3,343152,343154,343157,2,5,0
98019,2,3,343154,343157,343160,3,6,0
98020,3,3,343157,343160,343163,3,6,0
98021,6,1,343163,343163,343164,0,1,0
98022,4,1,343167,343167,343168,0,1,3
98023,1,2,343168,343168,343170,0,2,0
98024,6,1,343174,343174,343175,0,1,4
98025,5,3,343179,343179,343182,0,3,4
98026,6,3,343185,343185,343188,0,3,3
98027,1,2,343186,343188,343190,2,4,0
98028,6,2,343192,343192,343194,0,2,2
98029,4,1,343196,343196,343197,0,1,2
98030,4,2,343200,343200,343202,0,2,3
98031,6,3,343206,343206,343209,0,3,4
98032,4,1,343210,343210,343211,0,1,1
98033,4,3,343214,343214,343217,0,3,3
98034,5,3,343219,343219,343222,0,3,2
98035,4,1,343223,343223,343224,0,1,1
98036,2,1,343225,343225,343226,0,1,1
98037,3,3,343228,343228,343231,0,3,2
98038,4,1,343232,343232,343233,0,1,1
98039,2,3,343234,343234,343237,0,3,1
98040,2,1,343236,343237,343238,1,2,0
98041,1,2,343237,343238,343240,1,3,0
98042,2,1,343239,343240,343241,1,2,0
98043,3,1,343242,343242,343243,0,1,1
98044,2,3,343244,343244,343247,0,3,1
98045,1,2,343245,343247,343249,2,4,0
98046,6,3,343251,343251,343254,0,3,2
98047,1,2,343252,343254,343256,2,4,0
98048,5,2,343257,343257,343259,0,2,1
98049,4,2,343261,343261,343263,0,2,2
98050,3,1,343264,343264,343265,0,1,1
98051,6,2,343270,343270,343272,0,2,5
98052,4,2,343274,343274,343276,0,2,2
98053,4,2,343278,343278,343280,0,2,2
98054,2,1,343280,343280,343281,0,1,0
98055,5,2,343285,343285,343287,0,2,4
98056,6,2,343291,343291,343293,0,2,4
98057,1,3,343292,343293,343296,1,4,0
98058,3,3,343295,343296,343299,1,4,0
98059,3,1,343298,343299,343300,1,2,0
98060,4,1,343302,343302,343303,0,1,2
98061,4,1,343306,343306,343307,0,1,3
98062,3,1,343309,343309,343310,0,1,2
98063,1,1,343310,343310,343311,0,1,0
98064,1,1,343311,343311,343312,0,1,0
98065,1,3,343312,343312,343315,0,3,0
98066,3,1,343315,343315,343316,0,1,0
98067,2,3,343317,343317,343320,0,3,1
98068,2,1,343319,343320,343321,1,2,0
98069,1,2,343320,343321,343323,1,3,0
98070,6,2,343326,343326,343328,0,2,3
98071,3,1,343329,343329,343330,0,1,1
98072,1,1,343330,343330,343331,0,1,0
98073,1,2,343331,343331,343333,0,2,0
98074,3,2,343334,343334,343336,0,2,1
98075,1,2,343335,343336,343338,1,3,0
98076,5,2,343340,343340,343342,0,2,2
98077,2,2,343342,343342,343344,0,2,0
98078,5,1,343347,343347,343348,0,1,3
98079,5,1,343352,343352,343353,0,1,4
98080,2,1,343354,343354,343355,0,1,1
98081,5,3,343359,343359,343362,0,3,4
98082,4,3,343363,343363,343366,0,3,1
98083,1,1,343364,343366,343367,2,3,0
98084,5,3,343369,343369,343372,0,3,2
98085,4,3,343373,343373,343376,0,3,1
98086,5,3,343378,343378,343381,0,3,2
98087,2,2,343380,343381,343383,1,3,0
98088,1,1,343381,343383,343384,2,3,0
98089,1,2,343382,343384,343386,2,4,0
98090,1,2,343383,343386,343388,3,5,0
98091,5,3,343388,343388,343391,0,3,0
98092,3,1,343391,343391,343392,0,1,0
98093,3,2,343394,343394,343396,0,2,2
98094,3,1,343397,343397,343398,0,1,1
98095,3,3,343400,343400,343403,0,3,2
98096,4,3,343404,343404,343407,0,3,1
98097,2,2,343406,343407,343409,1,3,0
98098,1,2,343407,343409,343411,2,4,0
98099,6,2,343413,343413,343415,0,2,2
98100,4,1,343417,343417,343418,0,1,2
98101,3,3,343420,343420,343423,0,3,2
98102,6,1,343426,343426,343427,0,1,3
98103,6,3,343432,343432,343435,0,3,5
98104,1,1,343433,343435,343436,2,3,0
98105,5,3,343438,343438,343441,0,3,2
98106,4,2,343442,343442,343444,0,2,1
98107,5,3,343447,343447,343450,0,3,3
98108,4,2,343451,343451,343453,0,2,1
98109,5,3,343456,343456,343459,0,3,3
98110,2,2,343458,343459,343461,1,3,0
98111,6,1,343464,343464,343465,0,1,3
98112,4,3,343468,343468,343471,0,3,3
98113,4,1,343472,343472,343473,0,1,1
98114,1,3,343473,343473,343476,0,3,0
98115,6,1,343479,343479,343480,0,1,3
98116,5,1,343484,343484,343485,0,1,4
98117,6,3,343490,343490,343493,0,3,5
98118,5,1,343495,343495,343496,0,1,2
98119,2,1,343497,343497,343498,0,1,1
98120,5,2,343502,343502,343504,0,2,4
98121,2,3,343504,343504,343507,0,3,0
98122,4,1,343508,343508,343509,0,1,1
98123,4,3,343512,343512,343515,0,3,3
98124,3,2,343515,343515,343517,0,2,0
98125,5,2,343520,343520,343522,0,2,3
98126,5,1,343525,343525,343526,0,1,3
98127,3,2,343528,343528,343530,0,2,2
98128,1,2,343529,343530,343532,1,3,0
98129,1,2,343530,343532,343534,2,4,0
98130,2,1,343532,343534,343535,2,3,0
98131,1,3,343533,343535,343538,2,5,0
98132,6,2,343539,343539,343541,0,2,1
98133,2,3,343541,343541,343544,0,3,0
98134,5,2,343546,343546,343548,0,2,2
98135,3,2,343549,343549,343551,0,2,1
98136,4,3,343553,343553,343556,0,3,2
98137,4,1,343557,343557,343558,0,1,1
98138,4,3,343561,343561,343564,0,3,3
98139,6,2,343567,343567,343569,0,2,3
98140,4,1,343571,343571,343572,0,1,2
98141,6,1,343577,343577,343578,0,1,5
98142,3,3,343580,343580,343583,0,3,2
98143,5,1,343585,343585,343586,0,1,2
98144,5,2,343590,343590,343592,0,2,4
98145,2,3,343592,343592,343595,0,3,0
98146,1,2,343593,343595,343597,2,4,0
98147,2,2,343595,343597,343599,2,4,0
98148,2,3,343597,343599,343602,2,5,0
98149,2,2,343599,343602,343604,3,5,0
98150,2,1,343601,343604,343605,3,4,0
98151,2,2,343603,343605,343607,2,4,0
98152,6,3,343609,343609,343612,0,3,2
98153,1,1,343610,343612,343613,2,3,0
98154,3,1,343613,343613,343614,0,1,0
98155,4,3,343617,343617,343620,0,3,3
98156,3,1,343620,343620,343621,0,1,0
98157,6,3,343626,343626,343629,0,3,5
98158,6,1,343632,343632,343633,0,1,3
98159,3,1,343635,343635,343636,0,1,2
98160,5,2,343640,343640,343642,0,2,4
98161,6,1,343646,343646,343647,0,1,4
98162,5,1,343651,343651,343652,0,1,4
98163,5,3,343656,343656,343659,0,3,4
98164,2,1,343658,343659,343660,1,2,0
98165,1,3,343659,343660,343663,1,4,0
98166,5,2,343664,343664,343666,0,2,1
98167,2,2,343666,343666,343668,0,2,0
98168,6,2,343672,343672,343674,0,2,4
98169,4,1,343676,343676,343677,0,1,2
98170,5,3,343681,343681,343684,0,3,4
98171,6,3,343687,343687,343690,0,3,3
98172,4,1,343691,343691,343692,0,1,1
98173,6,1,343697,343697,343698,0,1,5
98174,2,1,343699,343699,343700,0,1,1
98175,6,3,343705,343705,343708,0,3,5
98176,5,1,343710,343710,343711,0,1,2
98177,2,3,343712,343712,343715,0,3,1
98178,1,1,343713,343715,343716,2,3,0
98179,3,3,343716,343716,343719,0,3,0
98180,1,1,343717,343719,343720,2,3,0
98181,2,2,343719,343720,343722,1,3,0
98182,5,3,343724,343724,343727,0,3,2
98183,2,2,343726,343727,343729,1,3,0
98184,2,1,343728,343729,343730,1,2,0
98185,5,1,343733,343733,343734,0,1,3
98186,4,1,343737,343737,343738,0,1,3
98187,2,2,343739,343739,343741,0,2,1
98188,5,1,343744,343744,343745,0,1,3
98189,6,2,343750,343750,343752,0,2,5
98190,4,3,343754,343754,343757,0,3,2
98191,2,2,343756,343757,343759,1,3,0
98192,6,2,343762,343762,343764,0,2,3
98193,3,2,343765,343765,343767,0,2,1
98194,1,1,343766,343767,343768,1,2,0
98195,4,3,343770,343770,343773,0,3,2
98196,2,2,343772,343773,343775,1,3,0
98197,5,1,343777,343777,343778,0,1,2
98198,3,2,343780,343780,343782,0,2,2
98199,1,3,343781,343782,343785,1,4,0
98200,5,1,343786,343786,343787,0,1,1
98201,3,1,343789,343789,343790,0,1,2
98202,3,3,343792,343792,343795,0,3,2
98203,2,3,343794,343795,343798,1,4,0
98204,2,2,343796,343798,343800,2,4,0
98205,6,2,343802,343802,343804,0,2,2
98206,4,1,343806,343806,343807,0,1,2
98207,5,3,343811,343811,343814,0,3,4
98208,6,1,343817,343817,343818,0,1,3
98209,3,2,343820,343820,343822,0,2,2
98210,2,2,343822,343822,343824,0,2,0
98211,3,3,343825,343825,343828,0,3,1
98212,5,2,343830,343830,343832,0,2,2
98213,4,2,343834,343834,343836,0,2,2
98214,3,2,343837,343837,343839,0,2,1
98215,5,2,343842,343842,343844,0,2,3
98216,3,1,343845,343845,343846,0,1,1
98217,2,1,343847,343847,343848,0,1,1
98218,4,1,343851,343851,343852,0,1,3
98219,5,2,343856,343856,343858,0,2,4
98220,5,3,343861,343861,343864,0,3,3
98221,5,1,343866,343866,343867,0,1,2
98222,4,2,343870,343870,343872,0,2,3
98223,2,2,343872,343872,343874,0,2,0
98224,5,3,343877,343877,343880,0,3,3
98225,6,3,343883,343883,343886,0,3,3
98226,1,1,343884,343886,343887,2,3,0
98227,6,1,343890,343890,343891,0,1,3
98228,3,1,343893,343893,343894,0,1,2
98229,2,3,343895,343895,343898,0,3,1
98230,4,3,343899,343899,343902,0,3,1
98231,5,3,343904,343904,343907,0,3,2
98232,3,1,343907,343907,343908,0,1,0
98233,1,1,343908,343908,343909,0,1,0
98234,5,1,343913,343913,343914,0,1,4
98235,2,3,343915,343915,343918,0,3,1
98236,4,1,343919,343919,343920,0,1,1
98237,5,3,343924,343924,343927,0,3,4
98238,5,3,343929,343929,343932,0,3,2
98239,5,2,343934,343934,343936,0,2,2
98240,2,2,343936,343936,343938,0,2,0
98241,4,3,343940,343940,343943,0,3,2
98242,3,1,343943,343943,343944,0,1,0
98243,4,3,343947,343947,343950,0,3,3
98244,6,2,343953,343953,343955,0,2,3
98245,3,1,343956,343956,343957,0,1,1
98246,3,1,343959,343959,343960,0,1,2
98247,5,2,343964,343964,343966,0,2,4
98248,1,1,343965,343966,343967,1,2,0
98249,4,1,343969,343969,343970,0,1,2
98250,6,2,343975,343975,343977,0,2,5
98251,3,1,343978,343978,343979,0,1,1
98252,3,3,343981,343981,343984,0,3,2
98253,3,1,343984,343984,343985,0,1,0
98254,2,1,343986,343986,343987,0,1,1
98255,3,2,343989,343989,343991,0,2,2
98256,1,3,343990,343991,343994,1,4,0
98257,5,2,343995,343995,343997,0,2,1
98258,6,3,344001,344001,344004,0,3,4
98259,5,2,344006,344006,344008,0,2,2
98260,4,3,344010,344010,344013,0,3,2
98261,4,2,344014,344014,344016,0,2,1
98262,1,2,344015,344016,344018,1,3,0
98263,5,1,344020,344020,344021,0,1,2
98264,5,3,344025,344025,344028,0,3,4
98265,6,1,344031,344031,344032,0,1,3
98266,5,1,344036,344036,344037,0,1,4
98267,5,1,344041,344041,344042,0,1,4
98268,6,1,344047,344047,344048,0,1,5
98269,6,3,344053,344053,344056,0,3,5
98270,3,2,344056,344056,344058,0,2,0
98271,6,3,344062,344062,344065,0,3,4
98272,5,2,344067,344067,344069,0,2,2
98273,5,2,344072,344072,344074,0,2,3
98274,3,3,344075,344075,344078,0,3,1
98275,5,2,344080,344080,344082,0,2,2
98276,5,3,344085,344085,344088,0,3,3
98277,4,2,344089,344089,344091,0,2,1
98278,3,1,344092,344092,344093,0,1,1
98279,3,2,344095,344095,344097,0,2,2
98280,2,2,344097,344097,344099,0,2,0
98281,1,2,344098,344099,344101,1,3,0
98282,3,1,344101,344101,344102,0,1,0
98283,2,3,344103,344103,344106,0,3,1
98284,5,2,344108,344108,344110,0,2,2
98285,4,1,344112,344112,344113,0,1,2
98286,2,2,344114,344114,344116,0,2,1
98287,3,3,344117,344117,344120,0,3,1
98288,6,1,344123,344123,344124,0,1,3
98289,6,1,344129,344129,344130,0,1,5
98290,3,3,344132,344132,344135,0,3,2
98291,2,1,344134,344135,344136,1,2,0
98292,5,3,344139,344139,344142,0,3,3
98293,5,1,344144,344144,344145,0,1,2
98294,5,2,344149,344149,344151,0,2,4
98295,2,3,344151,344151,344154,0,3,0
98296,3,1,344154,344154,344155,0,1,0
98297,1,2,344155,344155,344157,0,2,0
98298,6,2,344161,344161,344163,0,2,4
98299,1,1,344162,344163,344164,1,2,0
98300,5,2,344167,344167,344169,0,2,3
98301,2,1,344169,344169,344170,0,1,0
98302,4,3,344173,344173,344176,0,3,3
98303,5,1,344178,344178,344179,0,1,2
98304,6,1,344184,344184,344185,0,1,5
98305,2,3,344186,344186,344189,0,3,1
98306,1,3,344187,344189,344192,2,5,0
98307,2,3,344189,344192,344195,3,6,0
98308,1,3,344190,344195,344198,5,8,0
98309,1,2,344191,344198,344200,7,9,0
98310,2,1,344193,344200,344201,7,8,0
98311,3,3,344196,344201,344204,5,8,0
98312,2,3,344198,344204,344207,6,9,0
98313,6,2,344204,344207,344209,3,5,0
98314,4,2,344208,344209,344211,1,3,0
98315,6,2,344214,344214,344216,0,2,3
98316,6,1,344220,344220,344221,0,1,4
98317,6,2,344226,344226,344228,0,2,5
98318,2,2,344228,344228,344230,0,2,0
98319,2,1,344230,344230,344231,0,1,0
98320,3,3,344233,344233,344236,0,3,2
98321,6,2,344239,344239,344241,0,2,3
98322,3,3,344242,344242,344245,0,3,1
98323,5,1,344247,344247,344248,0,1,2
98324,5,1,344252,344252,344253,0,1,4
98325,1,3,344253,344253,344256,0,3,0
98326,1,3,344254,344256,344259,2,5,0
98327,6,3,344260,344260,344263,0,3,1
98328,1,3,344261,344263,344266,2,5,0
98329,3,2,344264,344266,344268,2,4,0
98330,3,2,344267,344268,344270,1,3,0
98331,5,3,344272,344272,344275,0,3,2
98332,6,3,344278,344278,344281,0,3,3
98333,4,1,344282,344282,344283,0,1,1
98334,2,2,344284,344284,344286,0,2,1
98335,4,3,344288,344288,344291,0,3,2
98336,2,3,344290,344291,344294,1,4,0
98337,6,3,344296,344296,344299,0,3,2
98338,5,1,344301,344301,344302,0,1,2
98339,5,3,344306,344306,344309,0,3,4
98340,3,3,344309,344309,344312,0,3,0
98341,2,1,344311,344312,344313,1,2,0
98342,4,1,344315,344315,344316,0,1,2
98343,6,3,344321,344321,344324,0,3,5
98344,1,1,344322,344324,344325,2,3,0
98345,3,3,344325,344325,344328,0,3,0
98346,2,3,344327,344328,344331,1,4,0
98347,1,2,344328,344331,344333,3,5,0
98348,2,2,344330,344333,344335,3,5,0
98349,6,3,344336,344336,344339,0,3,1
98350,1,2,344337,344339,344341,2,4,0
98351,1,3,344338,344341,344344,3,6,0
98352,6,1,344344,344344,344345,0,1,0
98353,6,1,344350,344350,344351,0,1,5
98354,3,3,344353,344353,344356,0,3,2
98355,2,1,344355,344356,344357,1,2,0
98356,5,1,344360,344360,344361,0,1,3
98357,2,3,344362,344362,344365,0,3,1
98358,5,3,344367,344367,344370,0,3,2
98359,6,3,344373,344373,344376,0,3,3
98360,6,3,344379,344379,344382,0,3,3
98361,1,1,344380,344382,344383,2,3,0
98362,2,1,344382,344383,344384,1,2,0
98363,6,1,344388,344388,344389,0,1,4
98364,4,1,344392,344392,344393,0,1,3
98365,5,3,344397,344397,344400,0,3,4
98366,2,1,344399,344400,344401,1,2,0
98367,1,1,344400,344401,344402,1,2,0
98368,5,2,344405,344405,344407,0,2,3
98369,2,1,344407,344407,344408,0,1,0
98370,2,2,344409,344409,344411,0,2,1
98371,5,2,344414,344414,344416,0,2,3
98372,1,2,344415,344416,344418,1,3,0
98373,5,2,344420,344420,344422,0,2,2
98374,6,1,344426,344426,344427,0,1,4
98375,6,2,344432,344432,344434,0,2,5
98376,6,3,344438,344438,344441,0,3,4
98377,4,1,344442,344442,344443,0,1,1
98378,2,2,344444,344444,344446,0,2,1
98379,2,1,344446,344446,344447,0,1,0
98380,4,3,344450,344450,344453,0,3,3
98381,6,3,344456,344456,344459,0,3,3
98382,6,2,344462,344462,344464,0,2,3
98383,6,3,344468,344468,344471,0,3,4
98384,3,1,344471,344471,344472,0,1,0
98385,3,1,344474,344474,344475,0,1,2
98386,6,1,344480,344480,344481,0,1,5
98387,5,1,344485,344485,344486,0,1,4
98388,1,1,344486,344486,344487,0,1,0
98389,1,2,344487,344487,344489,0,2,0
98390,2,1,344489,344489,344490,0,1,0
98391,3,2,344492,344492,344494,0,2,2
98392,2,3,344494,344494,344497,0,3,0
98393,4,1,344498,344498,344499,0,1,1
98394,1,2,344499,344499,344501,0,2,0
98395,4,3,344503,344503,344506,0,3,2
98396,6,1,344509,344509,344510,0,1,3
98397,5,3,344514,344514,344517,0,3,4
98398,5,3,344519,344519,344522,0,3,2
98399,2,3,344521,344522,344525,1,4,0
98400,3,1,344524,344525,344526,1,2,0
98401,5,1,344529,344529,344530,0,1,3
98402,3,1,344532,344532,344533,0,1,2
98403,2,3,344534,344534,344537,0,3,1
98404,3,3,344537,344537,344540,0,3,0
98405,6,2,344543,344543,344545,0,2,3
98406,6,3,344549,344549,344552,0,3,4
98407,2,2,344551,344552,344554,1,3,0
98408,3,2,344554,344554,344556,0,2,0
98409,5,1,344559,344559,344560,0,1,3
98410,3,3,344562,344562,344565,0,3,2
98411,5,1,344567,344567,344568,0,1,2
98412,5,1,344572,344572,344573,0,1,4
98413,5,2,344577,344577,344579,0,2,4
98414,5,3,344582,344582,344585,0,3,3
98415,1,2,344583,344585,344587,2,4,0
98416,6,1,344589,344589,344590,0,1,2
98417,3,1,344592,344592,344593,0,1,2
98418,6,2,344598,344598,344600,0,2,5
98419,3,1,344601,344601,344602,0,1,1
98420,5,1,344606,344606,344607,0,1,4
98421,2,3,344608,344608,344611,0,3,1
98422,3,3,344611,344611,344614,0,3,0
98423,4,1,344615,344615,344616,0,1,1
98424,2,2,344617,344617,344619,0,2,1
98425,5,1,344622,344622,344623,0,1,3
98426,4,2,344626,344626,344628,0,2,3
98427,5,3,344631,344631,344634,0,3,3
98428,6,2,344637,344637,344639,0,2,3
98429,3,3,344640,344640,344643,0,3,1
98430,4,2,344644,344644,344646,0,2,1
98431,3,2,344647,344647,344649,0,2,1
98432,5,1,344652,344652,344653,0,1,3
98433,6,2,344658,344658,344660,0,2,5
98434,2,2,344660,344660,344662,0,2,0
98435,5,2,344665,344665,344667,0,2,3
98436,4,3,344669,344669,344672,0,3,2
98437,6,2,344675,344675,344677,0,2,3
98438,1,2,344676,344677,344679,1,3,0
98439,1,2,344677,344679,344681,2,4,0
98440,2,1,344679,344681,344682,2,3,0
98441,2,3,344681,344682,344685,1,4,0
98442,6,2,344687,344687,344689,0,2,2
98443,4,1,344691,344691,344692,0,1,2
98444,6,1,344697,344697,344698,0,1,5
98445,6,3,344703,344703,344706,0,3,5
98446,3,2,344706,344706,344708,0,2,0
98447,2,1,344708,344708,344709,0,1,0
98448,3,1,344711,344711,344712,0,1,2
98449,4,2,344715,344715,344717,0,2,3
98450,4,1,344719,344719,344720,0,1,2
98451,2,1,344721,344721,344722,0,1,1
98452,4,3,344725,344725,344728,0,3,3
98453,3,3,344728,344728,344731,0,3,0
98454,6,2,344734,344734,344736,0,2,3
98455,2,3,344736,344736,344739,0,3,0
98456,6,3,344742,344742,344745,0,3,3
98457,3,2,344745,344745,344747,0,2,0
98458,5,1,344750,344750,344751,0,1,3
98459,4,2,344754,344754,344756,0,2,3
98460,5,2,344759,344759,344761,0,2,3
98461,1,1,344760,344761,344762,1,2,0
98462,4,1,344764,344764,344765,0,1,2
98463,3,2,344767,344767,344769,0,2,2
98464,2,3,344769,344769,344772,0,3,0
98465,5,2,344774,344774,344776,0,2,2
98466,4,1,344778,344778,344779,0,1,2
98467,2,2,344780,344780,344782,0,2,1
98468,2,1,344782,344782,344783,0,1,0
98469,4,3,344786,344786,344789,0,3,3
98470,6,1,344792,344792,344793,0,1,3
98471,5,1,344797,344797,344798,0,1,4
98472,4,2,344801,344801,344803,0,2,3
98473,5,3,344806,344806,344809,0,3,3
98474,2,1,344808,344809,344810,1,2,0
98475,1,1,344809,344810,344811,1,2,0
98476,3,2,344812,344812,344814,0,2,1
98477,6,3,344818,344818,344821,0,3,4
98478,5,1,344823,344823,344824,0,1,2
98479,1,2,344824,344824,344826,0,2,0
98480,6,1,344830,344830,344831,0,1,4
98481,4,2,344834,344834,344836,0,2,3
98482,6,1,344840,344840,344841,0,1,4
98483,4,2,344844,344844,344846,0,2,3
98484,3,3,344847,344847,344850,0,3,1
98485,5,3,344852,344852,344855,0,3,2
98486,1,3,344853,344855,344858,2,5,0
98487,2,1,344855,344858,344859,3,4,0
98488,3,1,344858,344859,344860,1,2,0
98489,6,3,344864,344864,344867,0,3,4
98490,2,3,344866,344867,344870,1,4,0
98491,2,1,344868,344870,344871,2,3,0
98492,2,3,344870,344871,344874,1,4,0
98493,4,1,344874,344874,344875,0,1,0
98494,6,1,344880,344880,344881,0,1,5
98495,6,3,344886,344886,344889,0,3,5
98496,1,2,344887,344889,344891,2,4,0
98497,3,2,344890,344891,344893,1,3,0
98498,6,1,344896,344896,344897,0,1,3
98499,5,3,344901,344901,344904,0,3,4
98500,2,1,344903,344904,344905,1,2,0
98501,4,1,344907,344907,344908,0,1,2
98502,6,3,344913,344913,344916,0,3,5
98503,3,2,344916,344916,344918,0,2,0
98504,1,3,344917,344918,344921,1,4,0
98505,4,3,344921,344921,344924,0,3,0
98506,1,3,344922,344924,344927,2,5,0
98507,4,2,344926,344927,344929,1,3,0
98508,4,3,344930,344930,344933,0,3,1
98509,1,3,344931,344933,344936,2,5,0
98510,4,2,344935,344936,344938,1,3,0
98511,4,1,344939,344939,344940,0,1,1
98512,2,3,344941,344941,344944,0,3,1
98513,5,3,344946,344946,344949,0,3,2
98514,4,3,344950,344950,344953,0,3,1
98515,2,2,344952,344953,344955,1,3,0
98516,3,1,344955,344955,344956,0,1,0
98517,2,2,344957,344957,344959,0,2,1
98518,2,3,344959,344959,344962,0,3,0
98519,5,2,344964,344964,344966,0,2,2
98520,4,2,344968,344968,344970,0,2,2
98521,2,1,344970,344970,344971,0,1,0
98522,4,1,344974,344974,344975,0,1,3
98523,6,2,344980,344980,344982,0,2,5
98524,5,3,344985,344985,344988,0,3,3
98525,6,2,344991,344991,344993,0,2,3
98526,6,3,344997,344997,345000,0,3,4
98527,1,3,344998,345000,345003,2,5,0
98528,6,2,345004,345004,345006,0,2,1
98529,6,2,345010,345010,345012,0,2,4
98530,5,3,345015,345015,345018,0,3,3
98531,3,3,345018,345018,345021,0,3,0
98532,1,3,345019,345021,345024,2,5,0
98533,1,1,345020,345024,345025,4,5,0
98534,4,1,345024,345025,345026,1,2,0
98535,5,2,345029,345029,345031,0,2,3
98536,2,1,345031,345031,345032,0,1,0
98537,4,1,345035,345035,345036,0,1,3
98538,2,2,345037,345037,345039,0,2,1
98539,5,1,345042,345042,345043,0,1,3
98540,4,2,345046,345046,345048,0,2,3
98541,5,1,345051,345051,345052,0,1,3
98542,3,2,345054,345054,345056,0,2,2
98543,6,3,345060,345060,345063,0,3,4
98544,6,1,345066,345066,345067,0,1,3
98545,1,2,345067,345067,345069,0,2,0
98546,6,2,345073,345073,345075,0,2,4
98547,6,3,345079,345079,345082,0,3,4
98548,5,3,345084,345084,345087,0,3,2
98549,4,1,345088,345088,345089,0,1,1
98550,6,2,345094,345094,345096,0,2,5
98551,1,1,345095,345096,345097,1,2,0
98552,1,3,345096,345097,345100,1,4,0
98553,6,2,345102,345102,345104,0,2,2
98554,2,1,345104,345104,345105,0,1,0
98555,5,1,345109,345109,345110,0,1,4
98556,2,2,345111,345111,345113,0,2,1
98557,4,3,345115,345115,345118,0,3,2
98558,3,3,345118,345118,345121,0,3,0
98559,1,2,345119,345121,345123,2,4,0
98560,3,2,345122,345123,345125,1,3,0
98561,6,3,345128,345128,345131,0,3,3
98562,3,1,345131,345131,345132,0,1,0
98563,3,2,345134,345134,345136,0,2,2
98564,1,2,345135,345136,345138,1,3,0
98565,4,2,345139,345139,345141,0,2,1
98566,1,1,345140,345141,345142,1,2,0
98567,2,3,345142,345142,345145,0,3,0
98568,6,3,345148,345148,345151,0,3,3
98569,1,1,345149,345151,345152,2,3,0
98570,4,1,345153,345153,345154,0,1,1
98571,2,1,345155,345155,345156,0,1,1
98572,5,3,345160,345160,345163,0,3,4
98573,6,3,345166,345166,345169,0,3,3
98574,2,2,345168,345169,345171,1,3,0
98575,1,1,345169,345171,345172,2,3,0
98576,2,2,345171,345172,345174,1,3,0
98577,3,1,345174,345174,345175,0,1,0
98578,6,3,345180,345180,345183,0,3,5
98579,6,2,345186,345186,345188,0,2,3
98580,2,1,345188,345188,345189,0,1,0
98581,1,1,345189,345189,345190,0,1,0
98582,4,2,345193,345193,345195,0,2,3
98583,3,1,345196,345196,345197,0,1,1
98584,5,1,345201,345201,345202,0,1,4
98585,4,1,345205,345205,345206,0,1,3
98586,1,1,345206,345206,345207,0,1,0
98587,4,2,345210,345210,345212,0,2,3
98588,2,2,345212,345212,345214,0,2,0
98589,2,2,345214,345214,345216,0,2,0
98590,4,2,345218,345218,345220,0,2,2
98591,2,2,345220,345220,345222,0,2,0
98592,2,2,345222,345222,345224,0,2,0
98593,3,3,345225,345225,345228,0,3,1
98594,1,3,345226,345228,345231,2,5,0
98595,3,2,345229,345231,345233,2,4,0
98596,3,3,345232,345233,345236,1,4,0
98597,6,2,345238,345238,345240,0,2,2
98598,5,3,345243,345243,345246,0,3,3
98599,1,1,345244,345246,345247,2,3,0
98600,4,3,345248,345248,345251,0,3,1
98601,2,1,345250,345251,345252,1,2,0
98602,1,1,345251,345252,345253,1,2,0
98603,6,2,345257,345257,345259,0,2,4
98604,2,3,345259,345259,345262,0,3,0
98605,5,2,345264,345264,345266,0,2,2
98606,1,2,345265,345266,345268,1,3,0
98607,4,3,345269,345269,345272,0,3,1
98608,6,3,345275,345275,345278,0,3,3
98609,6,1,345281,345281,345282,0,1,3
98610,4,3,345285,345285,345288,0,3,3
98611,4,2,345289,345289,345291,0,2,1
98612,4,1,345293,345293,345294,0,1,2
98613,1,2,345294,345294,345296,0,2,0
98614,2,3,345296,345296,345299,0,3,0
98615,5,3,345301,345301,345304,0,3,2
98616,5,3,345306,345306,345309,0,3,2
98617,5,3,345311,345311,345314,0,3,2
98618,6,3,345317,345317,345320,0,3,3
98619,2,1,345319,345320,345321,1,2,0
98620,4,1,345323,345323,345324,0,1,2
98621,3,2,345326,345326,345328,0,2,2
98622,2,1,345328,345328,345329,0,1,0
98623,3,2,345331,345331,345333,0,2,2
98624,2,3,345333,345333,345336,0,3,0
98625,4,3,345337,345337,345340,0,3,1
98626,4,3,345341,345341,345344,0,3,1
98627,3,3,345344,345344,345347,0,3,0
98628,4,2,345348,345348,345350,0,2,1
98629,1,3,345349,345350,345353,1,4,0
98630,6,3,345355,345355,345358,0,3,2
98631,1,1,345356,345358,345359,2,3,0
98632,4,3,345360,345360,345363,0,3,1
98633,4,1,345364,345364,345365,0,1,1
98634,6,2,345370,345370,345372,0,2,5
98635,3,3,345373,345373,345376,0,3,1
98636,5,2,345378,345378,345380,0,2,2
98637,2,3,345380,345380,345383,0,3,0
98638,5,3,345385,345385,345388,0,3,2
98639,1,2,345386,345388,345390,2,4,0
98640,6,2,345392,345392,345394,0,2,2
98641,1,1,345393,345394,345395,1,2,0
98642,2,2,345395,345395,345397,0,2,0
98643,1,1,345396,345397,345398,1,2,0
98644,1,2,345397,345398,345400,1,3,0
98645,6,3,345403,345403,345406,0,3,3
98646,6,1,345409,345409,345410,0,1,3
98647,5,2,345414,345414,345416,0,2,4
98648,4,2,345418,345418,345420,0,2,2
98649,1,2,345419,345420,345422,1,3,0
98650,4,3,345423,345423,345426,0,3,1
98651,2,3,345425,345426,345429,1,4,0
98652,6,3,345431,345431,345434,0,3,2
98653,1,3,345432,345434,345437,2,5,0
98654,6,3,345438,345438,345441,0,3,1
98655,6,2,345444,345444,345446,0,2,3
98656,2,3,345446,345446,345449,0,3,0
98657,3,2,345449,345449,345451,0,2,0
98658,4,3,345453,345453,345456,0,3,2
98659,3,3,345456,345456,345459,0,3,0
98660,4,1,345460,345460,345461,0,1,1
98661,5,3,345465,345465,345468,0,3,4
98662,4,1,345469,345469,345470,0,1,1
98663,6,2,345475,345475,345477,0,2,5
98664,5,2,345480,345480,345482,0,2,3
98665,6,3,345486,345486,345489,0,3,4
98666,6,1,345492,345492,345493,0,1,3
98667,1,2,345493,345493,345495,0,2,0
98668,2,1,345495,345495,345496,0,1,0
98669,1,3,345496,345496,345499,0,3,0
98670,2,3,345498,345499,345502,1,4,0
98671,1,3,345499,345502,345505,3,6,0
98672,6,1,345505,345505,345506,0,1,0
98673,2,1,345507,345507,345508,0,1,1
98674,2,3,345509,345509,345512,0,3,1
98675,1,3,345510,345512,345515,2,5,0
98676,2,2,345512,345515,345517,3,5,0
98677,5,2,345517,345517,345519,0,2,0
98678,3,3,345520,345520,345523,0,3,1
98679,1,2,345521,345523,345525,2,4,0
98680,2,3,345523,345525,345528,2,5,0
98681,2,1,345525,345528,345529,3,4,0
98682,2,1,345527,345529,345530,2,3,0
98683,2,3,345529,345530,345533,1,4,0
98684,4,2,345533,345533,345535,0,2,0
98685,1,2,345534,345535,345537,1,3,0
98686,6,3,345540,345540,345543,0,3,3
98687,2,2,345542,345543,345545,1,3,0
98688,4,1,345546,345546,345547,0,1,1
98689,2,1,345548,345548,345549,0,1,1
98690,2,2,345550,345550,345552,0,2,1
98691,4,3,345554,345554,345557,0,3,2
98692,3,1,345557,345557,345558,0,1,0
98693,6,2,345563,345563,345565,0,2,5
98694,1,1,345564,345565,345566,1,2,0
98695,6,1,345570,345570,345571,0,1,4
98696,4,3,345574,345574,345577,0,3,3
98697,4,3,345578,345578,345581,0,3,1
98698,3,2,345581,345581,345583,0,2,0
98699,1,3,345582,345583,345586,1,4,0
98700,3,3,345585,345586,345589,1,4,0
98701,2,2,345587,345589,345591,2,4,0
98702,3,3,345590,345591,345594,1,4,0
98703,1,1,345591,345594,345595,3,4,0
98704,3,2,345594,345595,345597,1,3,0
98705,2,1,345596,345597,345598,1,2,0
98706,3,3,345599,345599,345602,0,3,1
98707,2,1,345601,345602,345603,1,2,0
98708,1,1,345602,345603,345604,1,2,0
98709,3,2,345605,345605,345607,0,2,1
98710,1,3,345606,345607,345610,1,4,0
98711,1,2,345607,345610,345612,3,5,0
98712,6,2,345613,345613,345615,0,2,1
98713,5,1,345618,345618,345619,0,1,3
98714,5,2,345623,345623,345625,0,2,4
98715,4,1,345627,345627,345628,0,1,2
98716,1,3,345628,345628,345631,0,3,0
98717,5,1,345633,345633,345634,0,1,2
98718,3,2,345636,345636,345638,0,2,2
98719,1,2,345637,345638,345640,1,3,0
98720,1,3,345638,345640,345643,2,5,0
98721,3,1,345641,345643,345644,2,3,0
98722,5,3,345646,345646,345649,0,3,2
98723,6,1,345652,345652,345653,0,1,3
98724,5,3,345657,345657,345660,0,3,4
98725,1,1,345658,345660,345661,2,3,0
98726,6,1,345664,345664,345665,0,1,3
98727,6,1,345670,345670,345671,0,1,5
98728,5,1,345675,345675,345676,0,1,4
98729,5,1,345680,345680,345681,0,1,4
98730,1,1,345681,345681,345682,0,1,0
98731,2,1,345683,345683,345684,0,1,1
98732,5,2,345688,345688,345690,0,2,4
98733,3,1,345691,345691,345692,0,1,1
98734,6,1,345697,345697,345698,0,1,5
98735,5,3,345702,345702,345705,0,3,4
98736,3,1,345705,345705,345706,0,1,0
98737,6,1,345711,345711,345712,0,1,5
98738,6,2,345717,345717,345719,0,2,5
98739,1,3,345718,345719,345722,1,4,0
98740,1,1,345719,345722,345723,3,4,0
98741,5,2,345724,345724,345726,0,2,1
98742,1,2,345725,345726,345728,1,3,0
98743,6,1,345731,345731,345732,0,1,3
98744,2,3,345733,345733,345736,0,3,1
98745,4,2,345737,345737,345739,0,2,1
98746,3,1,345740,345740,345741,0,1,1
98747,6,1,345746,345746,345747,0,1,5
98748,4,3,345750,345750,345753,0,3,3
98749,5,1,345755,345755,345756,0,1,2
98750,2,2,345757,345757,345759,0,2,1
98751,5,3,345762,345762,345765,0,3,3
98752,6,1,345768,345768,345769,0,1,3
98753,6,1,345774,345774,345775,0,1,5
98754,3,2,345777,345777,345779,0,2,2
98755,3,2,345780,345780,345782,0,2,1
98756,6,3,345786,345786,345789,0,3,4
98757,1,3,345787,345789,345792,2,5,0
98758,2,3,345789,345792,345795,3,6,0
98759,2,2,345791,345795,345797,4,6,0
98760,2,3,345793,345797,345800,4,7,0
98761,6,2,345799,345800,345802,1,3,0
98762,5,3,345804,345804,345807,0,3,2
98763,1,1,345805,345807,345808,2,3,0
98764,4,3,345809,345809,345812,0,3,1
98765,2,2,345811,345812,345814,1,3,0
98766,3,3,345814,345814,345817,0,3,0
98767,5,3,345819,345819,345822,0,3,2
98768,3,2,345822,345822,345824,0,2,0
98769,2,1,345824,345824,345825,0,1,0
98770,5,3,345829,345829,345832,0,3,4
98771,2,1,345831,345832,345833,1,2,0
98772,2,3,345833,345833,345836,0,3,0
98773,1,3,345834,345836,345839,2,5,0
98774,6,1,345840,345840,345841,0,1,1
98775,2,2,345842,345842,345844,0,2,1
98776,4,2,345846,345846,345848,0,2,2
98777,3,1,345849,345849,345850,0,1,1
98778,2,2,345851,345851,345853,0,2,1
98779,6,1,345857,345857,345858,0,1,4
98780,1,2,345858,345858,345860,0,2,0
98781,6,1,345864,345864,345865,0,1,4
98782,2,2,345866,345866,345868,0,2,1
98783,5,1,345871,345871,345872,0,1,3
98784,5,2,345876,345876,345878,0,2,4
98785,4,2,345880,345880,345882,0,2,2
98786,6,2,345886,345886,345888,0,2,4
98787,3,1,345889,345889,345890,0,1,1
98788,6,2,345895,345895,345897,0,2,5
98789,2,1,345897,345897,345898,0,1,0
98790,5,3,345902,345902,345905,0,3,4
98791,1,2,345903,345905,345907,2,4,0
98792,2,2,345905,345907,345909,2,4,0
98793,1,1,345906,345909,345910,3,4,0
98794,2,2,345908,345910,345912,2,4,0
98795,1,3,345909,345912,345915,3,6,0
98796,1,1,345910,345915,345916,5,6,0
98797,2,2,345912,345916,345918,4,6,0
98798,4,1,345916,345918,345919,2,3,0
98799,2,3,345918,345919,345922,1,4,0
98800,6,2,345924,345924,345926,0,2,2
98801,3,2,345927,345927,345929,0,2,1
98802,2,2,345929,345929,345931,0,2,0
98803,6,3,345935,345935,345938,0,3,4
98804,2,1,345937,345938,345939,1,2,0
98805,2,3,345939,345939,345942,0,3,0
98806,6,2,345945,345945,345947,0,2,3
98807,3,3,345948,345948,345951,0,3,1
98808,4,3,345952,345952,345955,0,3,1
98809,5,1,345957,345957,345958,0,1,2
98810,1,1,345958,345958,345959,0,1,0
98811,5,3,345963,345963,345966,0,3,4
98812,6,1,345969,345969,345970,0,1,3
98813,6,2,345975,345975,345977,0,2,5
98814,6,2,345981,345981,345983,0,2,4
98815,5,1,345986,345986,345987,0,1,3
98816,2,2,345988,345988,345990,0,2,1
98817,6,3,345994,345994,345997,0,3,4
98818,6,1,346000,346000,346001,0,1,3
98819,5,3,346005,346005,346008,0,3,4
98820,4,2,346009,346009,346011,0,2,1
98821,4,2,346013,346013,346015,0,2,2
98822,3,3,346016,346016,346019,0,3,1
98823,2,2,346018,346019,346021,1,3,0
98824,2,2,346020,346021,346023,1,3,0
98825,4,1,346024,346024,346025,0,1,1
98826,1,1,346025,346025,346026,0,1,0
98827,3,2,346028,346028,346030,0,2,2
98828,6,1,346034,346034,346035,0,1,4
98829,1,2,346035,346035,346037,0,2,0
98830,5,3,346040,346040,346043,0,3,3
98831,4,1,346044,346044,346045,0,1,1
98832,4,1,346048,346048,346049,0,1,3
98833,4,3,346052,346052,346055,0,3,3
98834,5,2,346057,346057,346059,0,2,2
98835,1,2,346058,346059,346061,1,3,0
98836,4,3,346062,346062,346065,0,3,1
98837,2,1,346064,346065,346066,1,2,0
98838,4,1,346068,346068,346069,0,1,2
98839,1,1,346069,346069,346070,0,1,0
98840,2,3,346071,346071,346074,0,3,1
98841,2,3,346073,346074,346077,1,4,0
98842,1,3,346074,346077,346080,3,6,0
98843,6,1,346080,346080,346081,0,1,0
98844,5,2,346085,346085,346087,0,2,4
98845,5,2,346090,346090,346092,0,2,3
98846,3,3,346093,346093,346096,0,3,1
98847,1,2,346094,346096,346098,2,4,0
98848,4,1,346098,346098,346099,0,1,0
98849,1,1,346099,346099,346100,0,1,0
98850,3,1,346102,346102,346103,0,1,2
98851,1,1,346103,346103,346104,0,1,0
98852,1,3,346104,346104,346107,0,3,0
98853,3,3,346107,346107,346110,0,3,0
98854,4,2,346111,346111,346113,0,2,1
98855,4,2,346115,346115,346117,0,2,2
98856,4,1,346119,346119,346120,0,1,2
98857,3,1,346122,346122,346123,0,1,2
98858,3,1,346125,346125,346126,0,1,2
98859,6,3,346131,346131,346134,0,3,5
98860,6,2,346137,346137,346139,0,2,3
98861,2,2,346139,346139,346141,0,2,0
98862,2,1,346141,346141,346142,0,1,0
98863,2,3,346143,346143,346146,0,3,1
98864,5,2,346148,346148,346150,0,2,2
98865,6,2,346154,346154,346156,0,2,4
98866,2,2,346156,346156,346158,0,2,0
98867,5,2,346161,346161,346163,0,2,3
98868,1,3,346162,346163,346166,1,4,0
98869,3,3,346165,346166,346169,1,4,0
98870,4,3,346169,346169,346172,0,3,0
98871,6,3,346175,346175,346178,0,3,3
98872,4,1,346179,346179,346180,0,1,1
98873,3,3,346182,346182,346185,0,3,2
98874,6,3,346188,346188,346191,0,3,3
98875,2,1,346190,346191,346192,1,2,0
98876,6,2,346196,346196,346198,0,2,4
98877,4,2,346200,346200,346202,0,2,2
98878,4,1,346204,346204,346205,0,1,2
98879,4,1,346208,346208,346209,0,1,3
98880,3,1,346211,346211,346212,0,1,2
98881,5,2,346216,346216,346218,0,2,4
98882,2,1,346218,346218,346219,0,1,0
98883,1,2,346219,346219,346221,0,2,0
98884,4,3,346223,346223,346226,0,3,2
98885,2,2,346225,346226,346228,1,3,0
98886,3,2,346228,346228,346230,0,2,0
98887,5,1,346233,346233,346234,0,1,3
98888,3,2,346236,346236,346238,0,2,2
98889,6,2,346242,346242,346244,0,2,4
98890,4,3,346246,346246,346249,0,3,2
98891,6,3,346252,346252,346255,0,3,3
98892,2,2,346254,346255,346257,1,3,0
98893,6,1,346260,346260,346261,0,1,3
98894,3,1,346263,346263,346264,0,1,2
98895,1,1,346264,346264,346265,0,1,0
98896,4,2,346268,346268,346270,0,2,3
98897,5,2,346273,346273,346275,0,2,3
98898,5,1,346278,346278,346279,0,1,3
98899,2,3,346280,346280,346283,0,3,1
98900,2,1,346282,346283,346284,1,2,0
98901,3,1,346285,346285,346286,0,1,1
98902,1,2,346286,346286,346288,0,2,0
98903,4,3,346290,346290,346293,0,3,2
98904,1,2,346291,346293,346295,2,4,0
98905,5,3,346296,346296,346299,0,3,1
98906,6,2,346302,346302,346304,0,2,3
98907,4,3,346306,346306,346309,0,3,2
98908,6,3,346312,346312,346315,0,3,3
98909,3,2,346315,346315,346317,0,2,0
98910,1,1,346316,346317,346318,1,2,0
98911,6,1,346322,346322,346323,0,1,4
98912,5,2,346327,346327,346329,0,2,4
98913,2,1,346329,346329,346330,0,1,0
98914,1,1,346330,346330,346331,0,1,0
98915,5,1,346335,346335,346336,0,1,4
98916,1,3,346336,346336,346339,0,3,0
98917,5,1,346341,346341,346342,0,1,2
98918,1,1,346342,346342,346343,0,1,0
98919,2,3,346344,346344,346347,0,3,1
98920,2,3,346346,346347,346350,1,4,0
98921,2,1,346348,346350,346351,2,3,0
98922,6,3,346354,346354,346357,0,3,3
98923,3,1,346357,346357,346358,0,1,0
98924,4,1,346361,346361,346362,0,1,3
98925,4,2,346365,346365,346367,0,2,3
98926,2,1,346367,346367,346368,0,1,0
98927,5,1,346372,346372,346373,0,1,4
98928,1,1,346373,346373,346374,0,1,0
98929,2,2,346375,346375,346377,0,2,1
98930,5,3,346380,346380,346383,0,3,3
98931,1,3,346381,346383,346386,2,5,0
98932,1,1,346382,346386,346387,4,5,0
98933,5,1,346387,346387,346388,0,1,0
98934,5,1,346392,346392,346393,0,1,4
98935,4,2,346396,346396,346398,0,2,3
98936,1,1,346397,346398,346399,1,2,0
98937,5,2,346402,346402,346404,0,2,3
98938,5,1,346407,346407,346408,0,1,3
98939,3,2,346410,346410,346412,0,2,2
98940,2,3,346412,346412,346415,0,3,0
98941,1,1,346413,346415,346416,2,3,0
98942,1,3,346414,346416,346419,2,5,0
98943,4,2,346418,346419,346421,1,3,0
98944,2,1,346420,346421,346422,1,2,0
98945,2,1,346422,346422,346423,0,1,0
98946,4,3,346426,346426,346429,0,3,3
98947,5,1,346431,346431,346432,0,1,2
98948,1,2,346432,346432,346434,0,2,0
98949,3,1,346435,346435,346436,0,1,1
98950,5,2,346440,346440,346442,0,2,4
98951,1,2,346441,346442,346444,1,3,0
98952,5,1,346446,346446,346447,0,1,2
98953,2,1,346448,346448,346449,0,1,1
98954,4,2,346452,346452,346454,0,2,3
98955,4,3,346456,346456,346459,0,3,2
98956,1,2,346457,346459,346461,2,4,0
98957,1,3,346458,346461,346464,3,6,0
98958,4,2,346462,346464,346466,2,4,0
98959,6,1,346468,346468,346469,0,1,2
98960,2,1,346470,346470,346471,0,1,1
98961,6,1,346476,346476,346477,0,1,5
98962,4,3,346480,346480,346483,0,3,3
98963,6,3,346486,346486,346489,0,3,3
98964,2,3,346488,346489,346492,1,4,0
98965,2,2,346490,346492,346494,2,4,0
98966,2,3,346492,346494,346497,2,5,0
98967,1,1,346493,346497,346498,4,5,0
98968,2,3,346495,346498,346501,3,6,0
98969,1,3,346496,346501,346504,5,8,0
98970,2,2,346498,346504,346506,6,8,0
98971,3,2,346501,346506,346508,5,7,0
98972,2,3,346503,346508,346511,5,8,0
98973,6,3,346509,346511,346514,2,5,0
98974,2,2,346511,346514,346516,3,5,0
98975,3,2,346514,346516,346518,2,4,0
98976,3,1,346517,346518,346519,1,2,0
98977,1,2,346518,346519,346521,1,3,0
98978,1,2,346519,346521,346523,2,4,0
98979,6,2,346525,346525,346527,0,2,2
98980,5,3,346530,346530,346533,0,3,3
98981,6,1,346536,346536,346537,0,1,3
98982,2,3,346538,346538,346541,0,3,1
98983,1,1,346539,346541,346542,2,3,0
98984,4,2,346543,346543,346545,0,2,1
98985,3,3,346546,346546,346549,0,3,1
98986,2,2,346548,346549,346551,1,3,0
98987,3,2,346551,346551,346553,0,2,0
98988,4,1,346555,346555,346556,0,1,2
98989,6,2,346561,346561,346563,0,2,5
98990,3,1,346564,346564,346565,0,1,1
98991,1,1,346565,346565,346566,0,1,0
98992,6,2,346571,346571,346573,0,2,5
98993,5,3,346576,346576,346579,0,3,3
98994,3,2,346579,346579,346581,0,2,0
98995,3,1,346582,346582,346583,0,1,1
98996,1,1,346583,346583,346584,0,1,0
98997,5,2,346588,346588,346590,0,2,4
98998,6,3,346594,346594,346597,0,3,4
98999,4,2,346598,346598,346600,0,2,1
99000,5,2,346603,346603,346605,0,2,3
99001,5,3,346608,346608,346611,0,3,3
99002,2,1,346610,346611,346612,1,2,0
99003,3,3,346613,346613,346616,0,3,1
99004,3,3,346616,346616,346619,0,3,0
99005,6,2,346622,346622,346624,0,2,3
99006,4,3,346626,346626,346629,0,3,2
99007,6,2,346632,346632,346634,0,2,3
99008,2,2,346634,346634,346636,0,2,0
99009,5,1,346639,346639,346640,0,1,3
99010,3,1,346642,346642,346643,0,1,2
99011,2,3,346644,346644,346647,0,3,1
99012,3,3,346647,346647,346650,0,3,0
99013,1,3,346648,346650,346653,2,5,0
99014,2,2,346650,346653,346655,3,5,0
99015,4,3,346654,346655,346658,1,4,0
99016,6,2,346660,346660,346662,0,2,2
99017,4,1,346664,346664,346665,0,1,2
99018,5,2,346669,346669,346671,0,2,4
99019,6,3,346675,346675,346678,0,3,4
99020,3,1,346678,346678,346679,0,1,0
99021,4,2,346682,346682,346684,0,2,3
99022,5,3,346687,346687,346690,0,3,3
99023,3,1,346690,346690,346691,0,1,0
99024,6,2,346696,346696,346698,0,2,5
99025,3,1,346699,346699,346700,0,1,1
99026,1,3,346700,346700,346703,0,3,0
99027,4,1,346704,346704,346705,0,1,1
99028,6,2,346710,346710,346712,0,2,5
99029,3,2,346713,346713,346715,0,2,1
99030,5,2,346718,346718,346720,0,2,3
99031,3,3,346721,346721,346724,0,3,1
99032,4,1,346725,346725,346726,0,1,1
99033,3,3,346728,346728,346731,0,3,2
99034,4,3,346732,346732,346735,0,3,1
99035,2,1,346734,346735,346736,1,2,0
99036,3,3,346737,346737,346740,0,3,1
99037,3,3,346740,346740,346743,0,3,0
99038,4,2,346744,346744,346746,0,2,1
99039,2,1,346746,346746,346747,0,1,0
99040,3,3,346749,346749,346752,0,3,2
99041,1,1,346750,346752,346753,2,3,0
99042,2,1,346752,346753,346754,1,2,0
99043,3,3,346755,346755,346758,0,3,1
99044,3,2,346758,346758,346760,0,2,0
99045,4,2,346762,346762,346764,0,2,2
99046,5,3,346767,346767,346770,0,3,3
99047,2,3,346769,346770,346773,1,4,0
99048,3,2,346772,346773,346775,1,3,0
99049,4,3,346776,346776,346779,0,3,1
99050,6,2,346782,346782,346784,0,2,3
99051,6,2,346788,346788,346790,0,2,4
99052,2,2,346790,346790,346792,0,2,0
99053,4,1,346794,346794,346795,0,1,2
99054,1,1,346795,346795,346796,0,1,0
99055,2,2,346797,346797,346799,0,2,1
99056,2,3,346799,346799,346802,0,3,0
99057,5,2,346804,346804,346806,0,2,2
99058,1,2,346805,346806,346808,1,3,0
99059,2,3,346807,346808,346811,1,4,0
99060,3,2,346810,346811,346813,1,3,0
99061,3,2,346813,346813,346815,0,2,0
99062,2,1,346815,346815,346816,0,1,0
99063,5,3,346820,346820,346823,0,3,4
99064,6,1,346826,346826,346827,0,1,3
99065,5,2,346831,346831,346833,0,2,4
99066,5,1,346836,346836,346837,0,1,3
99067,4,3,346840,346840,346843,0,3,3
99068,3,3,346843,346843,346846,0,3,0
99069,5,1,346848,346848,346849,0,1,2
99070,4,2,346852,346852,346854,0,2,3
99071,5,3,346857,346857,346860,0,3,3
99072,3,1,346860,346860,346861,0,1,0
99073,4,1,346864,346864,346865,0,1,3
99074,1,3,346865,346865,346868,0,3,0
99075,3,3,346868,346868,346871,0,3,0
99076,6,1,346874,346874,346875,0,1,3
99077,6,2,346880,346880,346882,0,2,5
99078,2,3,346882,346882,346885,0,3,0
99079,6,2,346888,346888,346890,0,2,3
99080,6,3,346894,346894,346897,0,3,4
99081,3,3,346897,346897,346900,0,3,0
99082,2,2,346899,346900,346902,1,3,0
99083,3,2,346902,346902,346904,0,2,0
99084,2,1,346904,346904,346905,0,1,0
99085,6,3,346910,346910,346913,0,3,5
99086,4,2,346914,346914,346916,0,2,1
99087,6,3,346920,346920,346923,0,3,4
99088,2,3,346922,346923,346926,1,4,0
99089,1,2,346923,346926,346928,3,5,0
99090,4,3,346927,346928,346931,1,4,0
99091,4,3,346931,346931,346934,0,3,0
99092,1,2,346932,346934,346936,2,4,0
99093,4,3,346936,346936,346939,0,3,0
99094,3,2,346939,346939,346941,0,2,0
99095,4,2,346943,346943,346945,0,2,2
99096,6,2,346949,346949,346951,0,2,4
99097,1,3,346950,346951,346954,1,4,0
99098,1,1,346951,346954,346955,3,4,0
99099,3,2,346954,346955,346957,1,3,0
99100,6,1,346960,346960,346961,0,1,3
99101,4,2,346964,346964,346966,0,2,3
99102,3,3,346967,346967,346970,0,3,1
99103,1,3,346968,346970,346973,2,5,0
99104,1,3,346969,346973,346976,4,7,0
99105,1,2,346970,346976,346978,6,8,0
99106,6,2,346976,346978,346980,2,4,0
99107,6,1,346982,346982,346983,0,1,2
99108,1,2,346983,346983,346985,0,2,0
99109,1,3,346984,346985,346988,1,4,0
99110,2,3,346986,346988,346991,2,5,0
99111,5,3,346991,346991,346994,0,3,0
99112,1,3,346992,346994,346997,2,5,0
99113,3,1,346995,346997,346998,2,3,0
99114,2,2,346997,346998,347000,1,3,0
99115,2,3,346999,347000,347003,1,4,0
99116,6,1,347005,347005,347006,0,1,2
99117,1,1,347006,347006,347007,0,1,0
99118,2,3,347008,347008,347011,0,3,1
99119,3,2,347011,347011,347013,0,2,0
99120,4,1,347015,347015,347016,0,1,2
99121,3,3,347018,347018,347021,0,3,2
99122,1,2,347019,347021,347023,2,4,0
99123,3,2,347022,347023,347025,1,3,0
99124,5,1,347027,347027,347028,0,1,2
99125,2,3,347029,347029,347032,0,3,1
99126,4,3,347033,347033,347036,0,3,1
99127,5,1,347038,347038,347039,0,1,2
99128,4,3,347042,347042,347045,0,3,3
99129,5,2,347047,347047,347049,0,2,2
99130,6,2,347053,347053,347055,0,2,4
99131,1,3,347054,347055,347058,1,4,0
99132,5,2,347059,347059,347061,0,2,1
99133,1,3,347060,347061,347064,1,4,0
99134,1,1,347061,347064,347065,3,4,0
99135,4,1,347065,347065,347066,0,1,0
99136,3,1,347068,347068,347069,0,1,2
99137,5,1,347073,347073,347074,0,1,4
99138,3,3,347076,347076,347079,0,3,2
99139,1,2,347077,347079,347081,2,4,0
99140,6,3,347083,347083,347086,0,3,2
99141,3,2,347086,347086,347088,0,2,0
99142,6,1,347092,347092,347093,0,1,4
99143,6,3,347098,347098,347101,0,3,5
99144,4,1,347102,347102,347103,0,1,1
99145,2,3,347104,347104,347107,0,3,1
99146,2,1,347106,347107,347108,1,2,0
99147,2,2,347108,347108,347110,0,2,0
99148,5,1,347113,347113,347114,0,1,3
99149,5,2,347118,347118,347120,0,2,4
99150,2,1,347120,347120,347121,0,1,0
99151,5,2,347125,347125,347127,0,2,4
99152,3,1,347128,347128,347129,0,1,1
99153,3,1,347131,347131,347132,0,1,2
99154,4,3,347135,347135,347138,0,3,3
99155,1,3,347136,347138,347141,2,5,0
99156,1,2,347137,347141,347143,4,6,0
99157,2,1,347139,347143,347144,4,5,0
99158,2,3,347141,347144,347147,3,6,0
99159,5,3,347146,347147,347150,1,4,0
99160,5,3,347151,347151,347154,0,3,1
99161,5,2,347156,347156,347158,0,2,2
99162,3,3,347159,347159,347162,0,3,1
99163,2,2,347161,347162,347164,1,3,0
99164,1,3,347162,347164,347167,2,5,0
99165,2,3,347164,347167,347170,3,6,0
99166,4,1,347168,347170,347171,2,3,0
99167,6,3,347174,347174,347177,0,3,3
99168,4,2,347178,347178,347180,0,2,1
99169,1,2,347179,347180,347182,1,3,0
99170,6,1,347185,347185,347186,0,1,3
99171,1,2,347186,347186,347188,0,2,0
99172,2,1,347188,347188,347189,0,1,0
99173,2,1,347190,347190,347191,0,1,1
99174,3,1,347193,347193,347194,0,1,2
99175,6,1,347199,347199,347200,0,1,5
99176,2,1,347201,347201,347202,0,1,1
99177,5,1,347206,347206,347207,0,1,4
99178,6,1,347212,347212,347213,0,1,5
99179,5,1,347217,347217,347218,0,1,4
99180,6,2,347223,347223,347225,0,2,5
99181,6,3,347229,347229,347232,0,3,4
99182,3,3,347232,347232,347235,0,3,0
99183,4,2,347236,347236,347238,0,2,1
99184,2,2,347238,347238,347240,0,2,0
99185,2,3,347240,347240,347243,0,3,0
99186,3,3,347243,347243,347246,0,3,0
99187,5,1,347248,347248,347249,0,1,2
99188,2,3,347250,347250,347253,0,3,1
99189,1,2,347251,347253,347255,2,4,0
99190,5,2,347256,347256,347258,0,2,1
99191,5,1,347261,347261,347262,0,1,3
99192,5,3,347266,347266,347269,0,3,4
99193,6,1,347272,347272,347273,0,1,3
99194,2,2,347274,347274,347276,0,2,1
99195,2,1,347276,347276,347277,0,1,0
99196,1,2,347277,347277,347279,0,2,0
99197,1,3,347278,347279,347282,1,4,0
99198,1,2,347279,347282,347284,3,5,0
99199,4,3,347283,347284,347287,1,4,0
99200,6,1,347289,347289,347290,0,1,2
99201,2,3,347291,347291,347294,0,3,1
99202,4,3,347295,347295,347298,0,3,1
99203,2,2,347297,347298,347300,1,3,0
99204,6,2,347303,347303,347305,0,2,3
99205,4,3,347307,347307,347310,0,3,2
99206,2,2,347309,347310,347312,1,3,0
99207,1,2,347310,347312,347314,2,4,0
99208,4,1,347314,347314,347315,0,1,0
99209,2,1,347316,347316,347317,0,1,1
99210,3,1,347319,347319,347320,0,1,2
99211,5,2,347324,347324,347326,0,2,4
99212,5,1,347329,347329,347330,0,1,3
99213,3,3,347332,347332,347335,0,3,2
99214,6,1,347338,347338,347339,0,1,3
99215,2,2,347340,347340,347342,0,2,1
99216,3,3,347343,347343,347346,0,3,1
99217,4,1,347347,347347,347348,0,1,1
99218,4,1,347351,347351,347352,0,1,3
99219,6,3,347357,347357,347360,0,3,5
99220,4,1,347361,347361,347362,0,1,1
99221,6,2,347367,347367,347369,0,2,5
99222,4,3,347371,347371,347374,0,3,2
99223,6,3,347377,347377,347380,0,3,3
99224,4,1,347381,347381,347382,0,1,1
99225,3,2,347384,347384,347386,0,2,2
99226,3,1,347387,347387,347388,0,1,1
99227,4,2,347391,347391,347393,0,2,3
99228,6,1,347397,347397,347398,0,1,4
99229,4,1,347401,347401,347402,0,1,3
99230,5,1,347406,347406,347407,0,1,4
99231,3,3,347409,347409,347412,0,3,2
99232,5,3,347414,347414,347417,0,3,2
99233,6,1,347420,347420,347421,0,1,3
99234,3,2,347423,347423,347425,0,2,2
99235,2,1,347425,347425,347426,0,1,0
99236,3,3,347428,347428,347431,0,3,2
99237,1,2,347429,347431,347433,2,4,0
99238,3,1,347432,347433,347434,1,2,0
99239,2,3,347434,347434,347437,0,3,0
99240,4,2,347438,347438,347440,0,2,1
99241,4,2,347442,347442,347444,0,2,2
99242,1,1,347443,347444,347445,1,2,0
99243,3,1,347446,347446,347447,0,1,1
99244,1,2,347447,347447,347449,0,2,0
99245,5,1,347452,347452,347453,0,1,3
99246,2,2,347454,347454,347456,0,2,1
99247,2,3,347456,347456,347459,0,3,0
99248,6,1,347462,347462,347463,0,1,3
99249,5,2,347467,347467,347469,0,2,4
99250,1,3,347468,347469,347472,1,4,0
99251,2,3,347470,347472,347475,2,5,0
99252,4,2,347474,347475,347477,1,3,0
99253,2,3,347476,347477,347480,1,4,0
99254,2,2,347478,347480,347482,2,4,0
99255,2,3,347480,347482,347485,2,5,0
99256,1,3,347481,347485,347488,4,7,0
99257,4,3,347485,347488,347491,3,6,0
99258,5,3,347490,347491,347494,1,4,0
99259,2,2,347492,347494,347496,2,4,0
99260,3,2,347495,347496,347498,1,3,0
99261,3,2,347498,347498,347500,0,2,0
99262,6,2,347504,347504,347506,0,2,4
99263,3,3,347507,347507,347510,0,3,1
99264,2,1,347509,347510,347511,1,2,0
99265,5,3,347514,347514,347517,0,3,3
99266,1,3,347515,347517,347520,2,5,0
99267,6,3,347521,347521,347524,0,3,1
99268,4,3,347525,347525,347528,0,3,1
99269,4,1,347529,347529,347530,0,1,1
99270,4,2,347533,347533,347535,0,2,3
99271,6,3,347539,347539,347542,0,3,4
99272,2,1,347541,347542,347543,1,2,0
99273,2,3,347543,347543,347546,0,3,0
99274,5,3,347548,347548,347551,0,3,2
99275,3,1,347551,347551,347552,0,1,0
99276,2,3,347553,347553,347556,0,3,1
99277,2,1,347555,347556,347557,1,2,0
99278,4,1,347559,347559,347560,0,1,2
99279,6,1,347565,347565,347566,0,1,5
99280,3,1,347568,347568,347569,0,1,2
99281,3,2,347571,347571,347573,0,2,2
99282,6,1,347577,347577,347578,0,1,4
99283,2,1,347579,347579,347580,0,1,1
99284,5,3,347584,347584,347587,0,3,4
99285,2,3,347586,347587,347590,1,4,0
99286,1,1,347587,347590,347591,3,4,0
99287,6,3,347593,347593,347596,0,3,2
99288,4,1,347597,347597,347598,0,1,1
99289,2,3,347599,347599,347602,0,3,1
99290,1,3,347600,347602,347605,2,5,0
99291,4,2,347604,347605,347607,1,3,0
99292,2,1,347606,347607,347608,1,2,0
99293,1,3,347607,347608,347611,1,4,0
99294,3,3,347610,347611,347614,1,4,0
99295,4,1,347614,347614,347615,0,1,0
99296,6,1,347620,347620,347621,0,1,5
99297,4,1,347624,347624,347625,0,1,3
99298,2,1,347626,347626,347627,0,1,1
99299,1,3,347627,347627,347630,0,3,0
99300,4,2,347631,347631,347633,0,2,1
99301,1,2,347632,347633,347635,1,3,0
99302,1,1,347633,347635,347636,2,3,0
99303,2,2,347635,347636,347638,1,3,0
99304,5,2,347640,347640,347642,0,2,2
99305,1,3,347641,347642,347645,1,4,0
99306,6,1,347647,347647,347648,0,1,2
99307,3,2,347650,347650,347652,0,2,2
99308,1,1,347651,347652,347653,1,2,0
99309,6,2,347657,347657,347659,0,2,4
99310,6,2,347663,347663,347665,0,2,4
99311,3,2,347666,347666,347668,0,2,1
99312,5,2,347671,347671,347673,0,2,3
99313,1,3,347672,347673,347676,1,4,0
99314,6,2,347678,347678,347680,0,2,2
99315,5,1,347683,347683,347684,0,1,3
99316,4,2,347687,347687,347689,0,2,3
99317,1,1,347688,347689,347690,1,2,0
99318,3,2,347691,347691,347693,0,2,1
99319,5,2,347696,347696,347698,0,2,3
99320,6,2,347702,347702,347704,0,2,4
99321,5,1,347707,347707,347708,0,1,3
99322,3,2,347710,347710,347712,0,2,2
99323,2,2,347712,347712,347714,0,2,0
99324,1,1,347713,347714,347715,1,2,0
99325,3,2,347716,347716,347718,0,2,1
99326,5,2,347721,347721,347723,0,2,3
99327,2,3,347723,347723,347726,0,3,0
99328,1,3,347724,347726,347729,2,5,0
99329,2,3,347726,347729,347732,3,6,0
99330,6,1,347732,347732,347733,0,1,0
99331,5,3,347737,347737,347740,0,3,4
99332,5,3,347742,347742,347745,0,3,2
99333,1,3,347743,347745,347748,2,5,0
99334,3,2,347746,347748,347750,2,4,0
99335,6,2,347752,347752,347754,0,2,2
99336,1,1,347753,347754,347755,1,2,0
99337,4,3,347757,347757,347760,0,3,2
99338,3,1,347760,347760,347761,0,1,0
99339,5,1,347765,347765,347766,0,1,4
99340,1,3,347766,347766,347769,0,3,0
99341,6,2,347772,347772,347774,0,2,3
99342,1,3,347773,347774,347777,1,4,0
99343,3,1,347776,347777,347778,1,2,0
99344,1,3,347777,347778,347781,1,4,0
99345,6,1,347783,347783,347784,0,1,2
99346,1,2,347784,347784,347786,0,2,0
99347,4,1,347788,347788,347789,0,1,2
99348,3,3,347791,347791,347794,0,3,2
99349,1,1,347792,347794,347795,2,3,0
99350,4,2,347796,347796,347798,0,2,1
99351,6,3,347802,347802,347805,0,3,4
99352,5,2,347807,347807,347809,0,2,2
99353,5,3,347812,347812,347815,0,3,3
99354,3,2,347815,347815,347817,0,2,0
99355,3,1,347818,347818,347819,0,1,1
99356,6,3,347824,347824,347827,0,3,5
99357,5,1,347829,347829,347830,0,1,2
99358,2,2,347831,347831,347833,0,2,1
99359,6,3,347837,347837,347840,0,3,4
99360,5,1,347842,347842,347843,0,1,2
99361,1,3,347843,347843,347846,0,3,0
99362,1,3,347844,347846,347849,2,5,0
99363,2,2,347846,347849,347851,3,5,0
99364,3,3,347849,347851,347854,2,5,0
99365,3,1,347852,347854,347855,2,3,0
99366,4,3,347856,347856,347859,0,3,1
99367,1,1,347857,347859,347860,2,3,0
99368,3,2,347860,347860,347862,0,2,0
99369,5,2,347865,347865,347867,0,2,3
99370,3,3,347868,347868,347871,0,3,1
99371,4,2,347872,347872,347874,0,2,1
99372,5,3,347877,347877,347880,0,3,3
99373,1,2,347878,347880,347882,2,4,0
99374,3,2,347881,347882,347884,1,3,0
99375,1,1,347882,347884,347885,2,3,0
99376,2,1,347884,347885,347886,1,2,0
99377,1,3,347885,347886,347889,1,4,0
99378,2,3,347887,347889,347892,2,5,0
99379,3,2,347890,347892,347894,2,4,0
99380,3,3,347893,347894,347897,1,4,0
99381,5,3,347898,347898,347901,0,3,1
99382,4,2,347902,347902,347904,0,2,1
99383,2,3,347904,347904,347907,0,3,0
99384,5,2,347909,347909,347911,0,2,2
99385,2,3,347911,347911,347914,0,3,0
99386,1,3,347912,347914,347917,2,5,0
99387,5,2,347917,347917,347919,0,2,0
99388,4,2,347921,347921,347923,0,2,2
99389,1,2,347922,347923,347925,1,3,0
99390,5,3,347927,347927,347930,0,3,2
99391,6,3,347933,347933,347936,0,3,3
99392,4,1,347937,347937,347938,0,1,1
99393,1,3,347938,347938,347941,0,3,0
99394,4,3,347942,347942,347945,0,3,1
99395,6,2,347948,347948,347950,0,2,3
99396,2,3,347950,347950,347953,0,3,0
99397,4,2,347954,347954,347956,0,2,1
99398,5,2,347959,347959,347961,0,2,3
99399,2,3,347961,347961,347964,0,3,0
99400,2,3,347963,347964,347967,1,4,0
99401,4,3,347967,347967,347970,0,3,0
99402,6,2,347973,347973,347975,0,2,3
99403,4,1,347977,347977,347978,0,1,2
99404,6,2,347983,347983,347985,0,2,5
99405,4,3,347987,347987,347990,0,3,2
99406,6,1,347993,347993,347994,0,1,3
99407,4,2,347997,347997,347999,0,2,3
99408,1,3,347998,347999,348002,1,4,0
99409,1,2,347999,348002,348004,3,5,0
99410,6,2,348005,348005,348007,0,2,1
99411,6,1,348011,348011,348012,0,1,4
99412,1,3,348012,348012,348015,0,3,0
99413,1,1,348013,348015,348016,2,3,0
99414,3,1,348016,348016,348017,0,1,0
99415,4,1,348020,348020,348021,0,1,3
99416,2,1,348022,348022,348023,0,1,1
99417,3,2,348025,348025,348027,0,2,2
99418,4,3,348029,348029,348032,0,3,2
99419,5,2,348034,348034,348036,0,2,2
99420,2,1,348036,348036,348037,0,1,0
99421,6,2,348042,348042,348044,0,2,5
99422,3,3,348045,348045,348048,0,3,1
99423,1,2,348046,348048,348050,2,4,0
99424,5,3,348051,348051,348054,0,3,1
99425,1,3,348052,348054,348057,2,5,0
99426,5,1,348057,348057,348058,0,1,0
99427,4,3,348061,348061,348064,0,3,3
99428,1,3,348062,348064,348067,2,5,0
99429,2,3,348064,348067,348070,3,6,0
99430,5,1,348069,348070,348071,1,2,0
99431,6,2,348075,348075,348077,0,2,4
99432,2,1,348077,348077,348078,0,1,0
99433,2,3,348079,348079,348082,0,3,1
99434,2,1,348081,348082,348083,1,2,0
99435,2,1,348083,348083,348084,0,1,0
99436,4,1,348087,348087,348088,0,1,3
99437,3,2,348090,348090,348092,0,2,2
99438,4,1,348094,348094,348095,0,1,2
99439,4,1,348098,348098,348099,0,1,3
99440,5,1,348103,348103,348104,0,1,4
99441,4,1,348107,348107,348108,0,1,3
99442,6,1,348113,348113,348114,0,1,5
99443,4,1,348117,348117,348118,0,1,3
99444,6,1,348123,348123,348124,0,1,5
99445,5,2,348128,348128,348130,0,2,4
99446,3,1,348131,348131,348132,0,1,1
99447,5,3,348136,348136,348139,0,3,4
99448,1,3,348137,348139,348142,2,5,0
99449,6,3,348143,348143,348146,0,3,1
99450,6,3,348149,348149,348152,0,3,3
99451,4,3,348153,348153,348156,0,3,1
99452,4,1,348157,348157,348158,0,1,1
99453,5,3,348162,348162,348165,0,3,4
99454,3,2,348165,348165,348167,0,2,0
99455,2,1,348167,348167,348168,0,1,0
99456,6,1,348173,348173,348174,0,1,5
99457,4,2,348177,348177,348179,0,2,3
99458,5,1,348182,348182,348183,0,1,3
99459,6,2,348188,348188,348190,0,2,5
99460,4,2,348192,348192,348194,0,2,2
99461,2,1,348194,348194,348195,0,1,0
99462,5,2,348199,348199,348201,0,2,4
99463,4,3,348203,348203,348206,0,3,2
99464,6,3,348209,348209,348212,0,3,3
99465,6,1,348215,348215,348216,0,1,3
99466,3,2,348218,348218,348220,0,2,2
99467,6,3,348224,348224,348227,0,3,4
99468,5,3,348229,348229,348232,0,3,2
99469,4,1,348233,348233,348234,0,1,1
99470,2,1,348235,348235,348236,0,1,1
99471,6,3,348241,348241,348244,0,3,5
99472,2,3,348243,348244,348247,1,4,0
99473,3,3,348246,348247,348250,1,4,0
99474,6,1,348252,348252,348253,0,1,2
99475,1,1,348253,348253,348254,0,1,0
99476,1,2,348254,348254,348256,0,2,0
99477,3,3,348257,348257,348260,0,3,1
99478,2,1,348259,348260,348261,1,2,0
99479,4,3,348263,348263,348266,0,3,2
99480,1,2,348264,348266,348268,2,4,0
99481,2,3,348266,348268,348271,2,5,0
99482,5,2,348271,348271,348273,0,2,0
99483,6,3,348277,348277,348280,0,3,4
99484,1,1,348278,348280,348281,2,3,0
99485,4,2,348282,348282,348284,0,2,1
99486,5,3,348287,348287,348290,0,3,3
99487,6,1,348293,348293,348294,0,1,3
99488,5,1,348298,348298,348299,0,1,4
99489,5,3,348303,348303,348306,0,3,4
99490,2,1,348305,348306,348307,1,2,0
99491,3,3,348308,348308,348311,0,3,1
99492,1,2,348309,348311,348313,2,4,0
99493,2,1,348311,348313,348314,2,3,0
99494,3,2,348314,348314,348316,0,2,0
99495,3,2,348317,348317,348319,0,2,1
99496,4,1,348321,348321,348322,0,1,2
99497,2,1,348323,348323,348324,0,1,1
99498,4,1,348327,348327,348328,0,1,3
99499,2,1,348329,348329,348330,0,1,1
99500,5,2,348334,348334,348336,0,2,4
99501,6,3,348340,348340,348343,0,3,4
99502,3,1,348343,348343,348344,0,1,0
99503,2,1,348345,348345,348346,0,1,1
99504,2,3,348347,348347,348350,0,3,1
99505,6,1,348353,348353,348354,0,1,3
99506,3,2,348356,348356,348358,0,2,2
99507,1,1,348357,348358,348359,1,2,0
99508,6,3,348363,348363,348366,0,3,4
99509,2,2,348365,348366,348368,1,3,0
99510,2,1,348367,348368,348369,1,2,0
99511,3,1,348370,348370,348371,0,1,1
99512,1,1,348371,348371,348372,0,1,0
99513,4,1,348375,348375,348376,0,1,3
99514,3,3,348378,348378,348381,0,3,2
99515,5,3,348383,348383,348386,0,3,2
99516,3,1,348386,348386,348387,0,1,0
99517,1,2,348387,348387,348389,0,2,0
99518,2,2,348389,348389,348391,0,2,0
99519,3,2,348392,348392,348394,0,2,1
99520,6,2,348398,348398,348400,0,2,4
99521,6,1,348404,348404,348405,0,1,4
99522,3,3,348407,348407,348410,0,3,2
99523,1,2,348408,348410,348412,2,4,0
99524,4,2,348412,348412,348414,0,2,0
99525,4,2,348416,348416,348418,0,2,2
99526,5,2,348421,348421,348423,0,2,3
99527,4,3,348425,348425,348428,0,3,2
99528,2,3,348427,348428,348431,1,4,0
99529,6,2,348433,348433,348435,0,2,2
99530,4,3,348437,348437,348440,0,3,2
99531,5,1,348442,348442,348443,0,1,2
99532,6,2,348448,348448,348450,0,2,5
99533,2,3,348450,348450,348453,0,3,0
99534,1,3,348451,348453,348456,2,5,0
99535,3,1,348454,348456,348457,2,3,0
99536,1,1,348455,348457,348458,2,3,0
99537,1,3,348456,348458,348461,2,5,0
99538,1,1,348457,348461,348462,4,5,0
99539,6,3,348463,348463,348466,0,3,1
99540,2,2,348465,348466,348468,1,3,0
99541,4,1,348469,348469,348470,0,1,1
99542,1,1,348470,348470,348471,0,1,0
99543,4,1,348474,348474,348475,0,1,3
99544,1,1,348475,348475,348476,0,1,0
99545,3,1,348478,348478,348479,0,1,2
99546,4,2,348482,348482,348484,0,2,3
99547,1,3,348483,348484,348487,1,4,0
99548,5,2,348488,348488,348490,0,2,1
99549,6,1,348494,348494,348495,0,1,4
99550,3,1,348497,348497,348498,0,1,2
99551,1,3,348498,348498,348501,0,3,0
99552,3,2,348501,348501,348503,0,2,0
99553,4,3,348505,348505,348508,0,3,2
99554,2,3,348507,348508,348511,1,4,0
99555,3,2,348510,348511,348513,1,3,0
99556,4,3,348514,348514,348517,0,3,1
99557,6,3,348520,348520,348523,0,3,3
99558,6,1,348526,348526,348527,0,1,3
99559,1,3,348527,348527,348530,0,3,0
99560,5,3,348532,348532,348535,0,3,2
99561,3,3,348535,348535,348538,0,3,0
99562,4,3,348539,348539,348542,0,3,1
99563,3,1,348542,348542,348543,0,1,0
99564,4,1,348546,348546,348547,0,1,3
99565,4,1,348550,348550,348551,0,1,3
99566,2,3,348552,348552,348555,0,3,1
99567,5,3,348557,348557,348560,0,3,2
99568,3,3,348560,348560,348563,0,3,0
99569,6,1,348566,348566,348567,0,1,3
99570,2,3,348568,348568,348571,0,3,1
99571,2,2,348570,348571,348573,1,3,0
99572,1,3,348571,348573,348576,2,5,0
99573,3,1,348574,348576,348577,2,3,0
99574,5,2,348579,348579,348581,0,2,2
99575,4,1,348583,348583,348584,0,1,2
99576,2,2,348585,348585,348587,0,2,1
99577,1,2,348586,348587,348589,1,3,0
99578,6,3,348592,348592,348595,0,3,3
99579,2,2,348594,348595,348597,1,3,0
99580,1,2,348595,348597,348599,2,4,0
99581,2,1,348597,348599,348600,2,3,0
99582,1,3,348598,348600,348603,2,5,0
99583,2,1,348600,348603,348604,3,4,0
99584,4,2,348604,348604,348606,0,2,0
99585,3,3,348607,348607,348610,0,3,1
99586,3,2,348610,348610,348612,0,2,0
99587,4,1,348614,348614,348615,0,1,2
99588,6,3,348620,348620,348623,0,3,5
99589,6,2,348626,348626,348628,0,2,3
99590,3,1,348629,348629,348630,0,1,1
99591,6,3,348635,348635,348638,0,3,5
99592,4,2,348639,348639,348641,0,2,1
99593,6,3,348645,348645,348648,0,3,4
99594,1,1,348646,348648,348649,2,3,0
99595,6,3,348652,348652,348655,0,3,3
99596,1,3,348653,348655,348658,2,5,0
99597,5,1,348658,348658,348659,0,1,0
99598,6,2,348664,348664,348666,0,2,5
99599,4,1,348668,348668,348669,0,1,2
99600,6,1,348674,348674,348675,0,1,5
99601,4,1,348678,348678,348679,0,1,3
99602,3,2,348681,348681,348683,0,2,2
99603,1,1,348682,348683,348684,1,2,0
99604,6,1,348688,348688,348689,0,1,4
99605,5,2,348693,348693,348695,0,2,4
99606,4,1,348697,348697,348698,0,1,2
99607,2,2,348699,348699,348701,0,2,1
99608,3,2,348702,348702,348704,0,2,1
99609,5,2,348707,348707,348709,0,2,3
99610,5,1,348712,348712,348713,0,1,3
99611,3,3,348715,348715,348718,0,3,2
99612,5,3,348720,348720,348723,0,3,2
99613,6,1,348726,348726,348727,0,1,3
99614,6,1,348732,348732,348733,0,1,5
99615,3,1,348735,348735,348736,0,1,2
99616,2,2,348737,348737,348739,0,2,1
99617,6,2,348743,348743,348745,0,2,4
99618,3,1,348746,348746,348747,0,1,1
99619,4,3,348750,348750,348753,0,3,3
99620,6,1,348756,348756,348757,0,1,3
99621,3,2,348759,348759,348761,0,2,2
99622,4,2,348763,348763,348765,0,2,2
99623,1,1,348764,348765,348766,1,2,0
99624,3,2,348767,348767,348769,0,2,1
99625,5,2,348772,348772,348774,0,2,3
99626,2,2,348774,348774,348776,0,2,0
99627,2,3,348776,348776,348779,0,3,0
99628,5,2,348781,348781,348783,0,2,2
99629,3,3,348784,348784,348787,0,3,1
99630,6,3,348790,348790,348793,0,3,3
99631,1,2,348791,348793,348795,2,4,0
99632,4,3,348795,348795,348798,0,3,0
99633,5,2,348800,348800,348802,0,2,2
99634,1,2,348801,348802,348804,1,3,0
99635,2,1,348803,348804,348805,1,2,0
99636,5,1,348808,348808,348809,0,1,3
99637,5,1,348813,348813,348814,0,1,4
99638,1,1,348814,348814,348815,0,1,0
99639,6,1,348820,348820,348821,0,1,5
99640,5,1,348825,348825,348826,0,1,4
99641,4,2,348829,348829,348831,0,2,3
99642,1,3,348830,348831,348834,1,4,0
99643,5,3,348835,348835,348838,0,3,1
99644,5,3,348840,348840,348843,0,3,2
99645,1,2,348841,348843,348845,2,4,0
99646,1,2,348842,348845,348847,3,5,0
99647,3,1,348845,348847,348848,2,3,0
99648,3,3,348848,348848,348851,0,3,0
99649,2,1,348850,348851,348852,1,2,0
99650,2,1,348852,348852,348853,0,1,0
99651,4,2,348856,348856,348858,0,2,3
99652,6,2,348862,348862,348864,0,2,4
99653,1,3,348863,348864,348867,1,4,0
99654,3,1,348866,348867,348868,1,2,0
99655,5,2,348871,348871,348873,0,2,3
99656,6,1,348877,348877,348878,0,1,4
99657,6,1,348883,348883,348884,0,1,5
99658,1,1,348884,348884,348885,0,1,0
99659,2,1,348886,348886,348887,0,1,1
99660,3,2,348889,348889,348891,0,2,2
99661,2,1,348891,348891,348892,0,1,0
99662,5,2,348896,348896,348898,0,2,4
99663,3,2,348899,348899,348901,0,2,1
99664,3,1,348902,348902,348903,0,1,1
99665,5,1,348907,348907,348908,0,1,4
99666,6,2,348913,348913,348915,0,2,5
99667,3,2,348916,348916,348918,0,2,1
99668,1,1,348917,348918,348919,1,2,0
99669,5,3,348922,348922,348925,0,3,3
99670,2,1,348924,348925,348926,1,2,0
99671,5,3,348929,348929,348932,0,3,3
99672,3,3,348932,348932,348935,0,3,0
99673,1,2,348933,348935,348937,2,4,0
99674,1,2,348934,348937,348939,3,5,0
99675,2,2,348936,348939,348941,3,5,0
99676,5,1,348941,348941,348942,0,1,0
99677,2,1,348943,348943,348944,0,1,1
99678,6,3,348949,348949,348952,0,3,5
99679,5,3,348954,348954,348957,0,3,2
99680,4,2,348958,348958,348960,0,2,1
99681,2,3,348960,348960,348963,0,3,0
99682,2,2,348962,348963,348965,1,3,0
99683,5,2,348967,348967,348969,0,2,2
99684,5,1,348972,348972,348973,0,1,3
99685,3,2,348975,348975,348977,0,2,2
99686,2,2,348977,348977,348979,0,2,0
99687,4,1,348981,348981,348982,0,1,2
99688,1,2,348982,348982,348984,0,2,0
99689,5,2,348987,348987,348989,0,2,3
99690,6,3,348993,348993,348996,0,3,4
99691,2,3,348995,348996,348999,1,4,0
99692,5,3,349000,349000,349003,0,3,1
99693,2,1,349002,349003,349004,1,2,0
99694,1,3,349003,349004,349007,1,4,0
99695,3,3,349006,349007,349010,1,4,0
99696,6,3,349012,349012,349015,0,3,2
99697,3,2,349015,349015,349017,0,2,0
99698,3,1,349018,349018,349019,0,1,1
99699,1,1,349019,349019,349020,0,1,0
99700,3,1,349022,349022,349023,0,1,2
99701,1,1,349023,349023,349024,0,1,0
99702,3,1,349026,349026,349027,0,1,2
99703,5,1,349031,349031,349032,0,1,4
99704,6,1,349037,349037,349038,0,1,5
99705,5,1,349042,349042,349043,0,1,4
99706,3,2,349045,349045,349047,0,2,2
99707,3,2,349048,349048,349050,0,2,1
99708,2,3,349050,349050,349053,0,3,0
99709,1,3,349051,349053,349056,2,5,0
99710,6,1,349057,349057,349058,0,1,1
99711,3,2,349060,349060,349062,0,2,2
99712,6,1,349066,349066,349067,0,1,4
99713,5,3,349071,349071,349074,0,3,4
99714,4,3,349075,349075,349078,0,3,1
99715,5,3,349080,349080,349083,0,3,2
99716,1,2,349081,349083,349085,2,4,0
99717,3,3,349084,349085,349088,1,4,0
99718,1,3,349085,349088,349091,3,6,0
99719,4,3,349089,349091,349094,2,5,0
99720,3,1,349092,349094,349095,2,3,0
99721,3,2,349095,349095,349097,0,2,0
99722,5,3,349100,349100,349103,0,3,3
99723,4,2,349104,349104,349106,0,2,1
99724,5,1,349109,349109,349110,0,1,3
99725,1,2,349110,349110,349112,0,2,0
99726,6,2,349116,349116,349118,0,2,4
99727,6,3,349122,349122,349125,0,3,4
99728,4,2,349126,349126,349128,0,2,1
99729,3,2,349129,349129,349131,0,2,1
99730,3,1,349132,349132,349133,0,1,1
99731,5,2,349137,349137,349139,0,2,4
99732,1,2,349138,349139,349141,1,3,0
99733,5,3,349143,349143,349146,0,3,2
99734,3,1,349146,349146,349147,0,1,0
99735,2,1,349148,349148,349149,0,1,1
99736,3,3,349151,349151,349154,0,3,2
99737,1,1,349152,349154,349155,2,3,0
99738,5,1,349157,349157,349158,0,1,2
99739,2,2,349159,349159,349161,0,2,1
99740,6,1,349165,349165,349166,0,1,4
99741,5,3,349170,349170,349173,0,3,4
99742,2,3,349172,349173,349176,1,4,0
99743,4,2,349176,349176,349178,0,2,0
99744,1,2,349177,349178,349180,1,3,0
99745,1,3,349178,349180,349183,2,5,0
99746,4,3,349182,349183,349186,1,4,0
99747,2,3,349184,349186,349189,2,5,0
99748,6,2,349190,349190,349192,0,2,1
99749,2,2,349192,349192,349194,0,2,0
99750,6,3,349198,349198,349201,0,3,4
99751,6,1,349204,349204,349205,0,1,3
99752,6,1,349210,349210,349211,0,1,5
99753,1,3,349211,349211,349214,0,3,0
99754,5,2,349216,349216,349218,0,2,2
99755,5,1,349221,349221,349222,0,1,3
99756,5,1,349226,349226,349227,0,1,4
99757,3,1,349229,349229,349230,0,1,2
99758,5,3,349234,349234,349237,0,3,4
99759,4,1,349238,349238,349239,0,1,1
99760,5,2,349243,349243,349245,0,2,4
99761,1,2,349244,349245,349247,1,3,0
99762,6,3,349250,349250,349253,0,3,3
99763,4,2,349254,349254,349256,0,2,1
99764,1,2,349255,349256,349258,1,3,0
99765,4,1,349259,349259,349260,0,1,1
99766,2,2,349261,349261,349263,0,2,1
99767,4,2,349265,349265,349267,0,2,2
99768,3,2,349268,349268,349270,0,2,1
99769,4,1,349272,349272,349273,0,1,2
99770,1,2,349273,349273,349275,0,2,0
99771,5,3,349278,349278,349281,0,3,3
99772,4,3,349282,349282,349285,0,3,1
99773,1,2,349283,349285,349287,2,4,0
99774,4,3,349287,349287,349290,0,3,0
99775,3,1,349290,349290,349291,0,1,0
99776,5,2,349295,349295,349297,0,2,4
99777,4,3,349299,349299,349302,0,3,2
99778,4,1,349303,349303,349304,0,1,1
99779,1,3,349304,349304,349307,0,3,0
99780,3,1,349307,349307,349308,0,1,0
99781,1,3,349308,349308,349311,0,3,0
99782,1,3,349309,349311,349314,2,5,0
99783,5,2,349314,349314,349316,0,2,0
99784,2,3,349316,349316,349319,0,3,0
99785,2,1,349318,349319,349320,1,2,0
99786,2,2,349320,349320,349322,0,2,0
99787,2,3,349322,349322,349325,0,3,0
99788,1,2,349323,349325,349327,2,4,0
99789,1,3,349324,349327,349330,3,6,0
99790,6,2,349330,349330,349332,0,2,0
99791,6,3,349336,349336,349339,0,3,4
99792,1,3,349337,349339,349342,2,5,0
99793,4,1,349341,349342,349343,1,2,0
99794,6,1,349347,349347,349348,0,1,4
99795,5,1,349352,349352,349353,0,1,4
99796,6,2,349358,349358,349360,0,2,5
99797,4,1,349362,349362,349363,0,1,2
99798,4,2,349366,349366,349368,0,2,3
99799,5,2,349371,349371,349373,0,2,3
99800,1,3,349372,349373,349376,1,4,0
99801,6,2,349378,349378,349380,0,2,2
99802,4,1,349382,349382,349383,0,1,2
99803,6,1,349388,349388,349389,0,1,5
99804,2,1,349390,349390,349391,0,1,1
99805,1,2,349391,349391,349393,0,2,0
99806,2,2,349393,349393,349395,0,2,0
99807,5,2,349398,349398,349400,0,2,3
99808,4,3,349402,349402,349405,0,3,2
99809,1,1,349403,349405,349406,2,3,0
99810,4,1,349407,349407,349408,0,1,1
99811,1,1,349408,349408,349409,0,1,0
99812,6,2,349414,349414,349416,0,2,5
99813,2,1,349416,349416,349417,0,1,0
99814,5,2,349421,349421,349423,0,2,4
99815,1,2,349422,349423,349425,1,3,0
99816,6,1,349428,349428,349429,0,1,3
99817,2,2,349430,349430,349432,0,2,1
99818,6,2,349436,349436,349438,0,2,4
99819,5,3,349441,349441,349444,0,3,3
99820,5,2,349446,349446,349448,0,2,2
99821,4,1,349450,349450,349451,0,1,2
99822,6,2,349456,349456,349458,0,2,5
99823,4,3,349460,349460,349463,0,3,2
99824,3,2,349463,349463,349465,0,2,0
99825,2,1,349465,349465,349466,0,1,0
99826,4,1,349469,349469,349470,0,1,3
99827,3,2,349472,349472,349474,0,2,2
99828,4,3,349476,349476,349479,0,3,2
99829,5,1,349481,349481,349482,0,1,2
99830,1,3,349482,349482,349485,0,3,0
99831,3,2,349485,349485,349487,0,2,0
99832,4,3,349489,349489,349492,0,3,2
99833,3,1,349492,349492,349493,0,1,0
99834,5,2,349497,349497,349499,0,2,4
99835,1,2,349498,349499,349501,1,3,0
99836,2,1,349500,349501,349502,1,2,0
99837,5,2,349505,349505,349507,0,2,3
99838,2,1,349507,349507,349508,0,1,0
99839,2,2,349509,349509,349511,0,2,1
99840,2,1,349511,349511,349512,0,1,0
99841,6,1,349517,349517,349518,0,1,5
99842,4,1,349521,349521,349522,0,1,3
99843,3,1,349524,349524,349525,0,1,2
99844,1,2,349525,349525,349527,0,2,0
99845,2,2,349527,349527,349529,0,2,0
99846,2,3,349529,349529,349532,0,3,0
99847,5,2,349534,349534,349536,0,2,2
99848,5,1,349539,349539,349540,0,1,3
99849,6,2,349545,349545,349547,0,2,5
99850,2,3,349547,349547,349550,0,3,0
99851,3,3,349550,349550,349553,0,3,0
99852,5,3,349555,349555,349558,0,3,2
99853,1,2,349556,349558,349560,2,4,0
99854,4,2,349560,349560,349562,0,2,0
99855,5,2,349565,349565,349567,0,2,3
99856,4,3,349569,349569,349572,0,3,2
99857,6,2,349575,349575,349577,0,2,3
99858,5,2,349580,349580,349582,0,2,3
99859,3,1,349583,349583,349584,0,1,1
99860,4,3,349587,349587,349590,0,3,3
99861,3,3,349590,349590,349593,0,3,0
99862,1,1,349591,349593,349594,2,3,0
99863,3,1,349594,349594,349595,0,1,0
99864,6,2,349600,349600,349602,0,2,5
99865,4,3,349604,349604,349607,0,3,2
99866,6,3,349610,349610,349613,0,3,3
99867,4,2,349614,349614,349616,0,2,1
99868,1,3,349615,349616,349619,1,4,0
99869,6,2,349621,349621,349623,0,2,2
99870,3,3,349624,349624,349627,0,3,1
99871,2,3,349626,349627,349630,1,4,0
99872,4,3,349630,349630,349633,0,3,0
99873,4,2,349634,349634,349636,0,2,1
99874,1,2,349635,349636,349638,1,3,0
99875,1,3,349636,349638,349641,2,5,0
99876,1,2,349637,349641,349643,4,6,0
99877,1,2,349638,349643,349645,5,7,0
99878,6,2,349644,349645,349647,1,3,0
99879,6,1,349650,349650,349651,0,1,3
99880,6,3,349656,349656,349659,0,3,5
99881,1,2,349657,349659,349661,2,4,0
99882,2,3,349659,349661,349664,2,5,0
99883,6,1,349665,349665,349666,0,1,1
99884,1,3,349666,349666,349669,0,3,0
99885,5,3,349671,349671,349674,0,3,2
99886,6,2,349677,349677,349679,0,2,3
99887,1,1,349678,349679,349680,1,2,0
99888,4,3,349682,349682,349685,0,3,2
99889,5,1,349687,349687,349688,0,1,2
99890,2,1,349689,349689,349690,0,1,1
99891,2,1,349691,349691,349692,0,1,1
99892,4,2,349695,349695,349697,0,2,3
99893,4,2,349699,349699,349701,0,2,2
99894,2,1,349701,349701,349702,0,1,0
99895,6,3,349707,349707,349710,0,3,5
99896,2,3,349709,349710,349713,1,4,0
99897,1,1,349710,349713,349714,3,4,0
99898,4,3,349714,349714,349717,0,3,0
99899,3,3,349717,349717,349720,0,3,0
99900,3,1,349720,349720,349721,0,1,0
99901,3,2,349723,349723,349725,0,2,2
99902,6,1,349729,349729,349730,0,1,4
99903,5,1,349734,349734,349735,0,1,4
99904,3,2,349737,349737,349739,0,2,2
99905,6,3,349743,349743,349746,0,3,4
99906,4,1,349747,349747,349748,0,1,1
99907,6,3,349753,349753,349756,0,3,5
99908,5,2,349758,349758,349760,0,2,2
99909,6,1,349764,349764,349765,0,1,4
99910,3,1,349767,349767,349768,0,1,2
99911,2,3,349769,349769,349772,0,3,1
99912,4,1,349773,349773,349774,0,1,1
99913,2,2,349775,349775,349777,0,2,1
99914,5,3,349780,349780,349783,0,3,3
99915,3,2,349783,349783,349785,0,2,0
99916,3,2,349786,349786,349788,0,2,1
99917,1,3,349787,349788,349791,1,4,0
99918,2,2,349789,349791,349793,2,4,0
99919,1,3,349790,349793,349796,3,6,0
99920,3,2,349793,349796,349798,3,5,0
99921,6,1,349799,349799,349800,0,1,1
99922,3,3,349802,349802,349805,0,3,2
99923,4,2,349806,349806,349808,0,2,1
99924,6,2,349812,349812,349814,0,2,4
99925,4,3,349816,349816,349819,0,3,2
99926,3,2,349819,349819,349821,0,2,0
99927,4,2,349823,349823,349825,0,2,2
99928,3,2,349826,349826,349828,0,2,1
99929,3,2,349829,349829,349831,0,2,1
99930,5,1,349834,349834,349835,0,1,3
99931,2,1,349836,349836,349837,0,1,1
99932,2,3,349838,349838,349841,0,3,1
99933,1,3,349839,349841,349844,2,5,0
99934,4,3,349843,349844,349847,1,4,0
99935,5,3,349848,349848,349851,0,3,1
99936,6,2,349854,349854,349856,0,2,3
99937,5,3,349859,349859,349862,0,3,3
99938,4,1,349863,349863,349864,0,1,1
99939,1,1,349864,349864,349865,0,1,0
99940,3,3,349867,349867,349870,0,3,2
99941,4,2,349871,349871,349873,0,2,1
99942,1,2,349872,349873,349875,1,3,0
99943,6,3,349878,349878,349881,0,3,3
99944,1,1,349879,349881,349882,2,3,0
99945,4,1,349883,349883,349884,0,1,1
99946,1,2,349884,349884,349886,0,2,0
99947,2,2,349886,349886,349888,0,2,0
99948,2,3,349888,349888,349891,0,3,0
99949,3,3,349891,349891,349894,0,3,0
99950,5,1,349896,349896,349897,0,1,2
99951,2,1,349898,349898,349899,0,1,1
99952,1,2,349899,349899,349901,0,2,0
99953,4,1,349903,349903,349904,0,1,2
99954,5,3,349908,349908,349911,0,3,4
99955,5,2,349913,349913,349915,0,2,2
99956,1,1,349914,349915,349916,1,2,0
99957,1,1,349915,349916,349917,1,2,0
99958,3,1,349918,349918,349919,0,1,1
99959,2,1,349920,349920,349921,0,1,1
99960,3,3,349923,349923,349926,0,3,2
99961,6,2,349929,349929,349931,0,2,3
99962,1,1,349930,349931,349932,1,2,0
99963,3,3,349933,349933,349936,0,3,1
99964,2,2,349935,349936,349938,1,3,0
99965,4,1,349939,349939,349940,0,1,1
99966,5,2,349944,349944,349946,0,2,4
99967,1,1,349945,349946,349947,1,2,0
99968,6,3,349951,349951,349954,0,3,4
99969,5,2,349956,349956,349958,0,2,2
99970,6,1,349962,349962,349963,0,1,4
99971,6,2,349968,349968,349970,0,2,5
99972,6,1,349974,349974,349975,0,1,4
99973,4,1,349978,349978,349979,0,1,3
99974,6,3,349984,349984,349987,0,3,5
99975,6,3,349990,349990,349993,0,3,3
99976,2,1,349992,349993,349994,1,2,0
99977,5,2,349997,349997,349999,0,2,3
99978,3,1,350000,350000,350001,0,1,1
99979,6,1,350006,350006,350007,0,1,5
99980,1,3,350007,350007,350010,0,3,0
99981,5,3,350012,350012,350015,0,3,2
99982,2,1,350014,350015,350016,1,2,0
99983,2,3,350016,350016,350019,0,3,0
99984,3,2,350019,350019,350021,0,2,0
99985,6,1,350025,350025,350026,0,1,4
99986,6,3,350031,350031,350034,0,3,5
99987,5,2,350036,350036,350038,0,2,2
99988,4,3,350040,350040,350043,0,3,2
99989,4,1,350044,350044,350045,0,1,1
99990,1,2,350045,350045,350047,0,2,0
99991,1,3,350046,350047,350050,1,4,0
99992,4,2,350050,350050,350052,0,2,0
99993,2,3,350052,350052,350055,0,3,0
99994,3,3,350055,350055,350058,0,3,0
99995,2,3,350057,350058,350061,1,4,0
99996,1,1,350058,350061,350062,3,4,0
99997,2,3,350060,350062,350065,2,5,0
99998,1,3,350061,350065,350068,4,7,0
99999,5,2,350066,350068,350070,2,4,0
